ABIM,2015,1950,2030,3980,0
ABIM,2016,2050,2130,4180,0
ABIM,2017,2150,2240,4390,0
ABIM,2018,2260,2350,4610,0
ABIM,2019,2370,2460,4830,0
ABIM,2020,2480,2560,5040,0
ABIM,2021,2600,2680,5280,0
ABIM,2022,2720,2800,5520,0
ABIM,2023,2840,2910,5750,0
ABIM,2024,2960,3040,6000,0
ABIM,2025,3070,3150,6220,0
ADJUMANI,2015,4630,4170,8800,0
ADJUMANI,2016,4670,4220,8890,0
ADJUMANI,2017,4700,4250,8950,0
ADJUMANI,2018,4730,4300,9030,0
ADJUMANI,2019,4770,4340,9110,0
ADJUMANI,2020,4790,4370,9160,0
ADJUMANI,2021,4820,4400,9220,0
ADJUMANI,2022,4840,4430,9270,0
ADJUMANI,2023,4850,4460,9310,0
ADJUMANI,2024,4870,4490,9360,0
ADJUMANI,2025,4880,4510,9390,0
AGAGO,2015,4700,4200,8900,0
AGAGO,2016,4780,4270,9050,0
AGAGO,2017,4860,4350,9210,0
AGAGO,2018,4950,4420,9370,0
AGAGO,2019,5030,4500,9530,0
AGAGO,2020,5110,4570,9680,0
AGAGO,2021,5190,4640,9830,0
AGAGO,2022,5260,4710,9970,0
AGAGO,2023,5340,4780,10120,0
AGAGO,2024,5410,4840,10250,0
AGAGO,2025,5470,4900,10370,0
ALEBTONG,2015,4680,4540,9220,0
ALEBTONG,2016,4750,4600,9350,0
ALEBTONG,2017,4820,4670,9490,0
ALEBTONG,2018,4890,4750,9640,0
ALEBTONG,2019,4960,4810,9770,0
ALEBTONG,2020,5010,4860,9870,0
ALEBTONG,2021,5070,4920,9990,0
ALEBTONG,2022,5130,4980,10110,0
ALEBTONG,2023,5180,5020,10200,0
ALEBTONG,2024,5210,5050,10260,0
ALEBTONG,2025,5230,5070,10300,0
AMOLATAR,2015,2720,2720,5440,0
AMOLATAR,2016,2710,2630,5340,0
AMOLATAR,2017,2740,2720,5460,0
AMOLATAR,2018,2740,2740,5480,0
AMOLATAR,2019,2740,2770,5510,0
AMOLATAR,2020,2770,2760,5530,0
AMOLATAR,2021,2830,2910,5740,0
AMOLATAR,2022,2940,2940,5880,0
AMOLATAR,2023,2980,2970,5950,0
AMOLATAR,2024,2950,2940,5890,0
AMOLATAR,2025,2930,2960,5890,0
AMUDAT,2015,1800,1910,3710,0
AMUDAT,2016,1850,1980,3830,0
AMUDAT,2017,1890,2040,3930,0
AMUDAT,2018,1940,2110,4050,0
AMUDAT,2019,1990,2180,4170,0
AMUDAT,2020,2040,2240,4280,0
AMUDAT,2021,2080,2310,4390,0
AMUDAT,2022,2130,2380,4510,0
AMUDAT,2023,2170,2450,4620,0
AMUDAT,2024,2210,2510,4720,0
AMUDAT,2025,2240,2570,4810,0
AMURIA,2015,4140,5050,9190,0
AMURIA,2016,4260,5230,9490,0
AMURIA,2017,4400,5350,9750,0
AMURIA,2018,4490,5550,10040,0
AMURIA,2019,4780,5750,10530,0
AMURIA,2020,4940,5860,10800,0
AMURIA,2021,5190,6110,11300,0
AMURIA,2022,5430,6380,11810,0
AMURIA,2023,5760,6570,12330,0
AMURIA,2024,6120,6900,13020,0
AMURIA,2025,6340,7050,13390,0
AMURU,2015,3950,3720,7670,0
AMURU,2016,4010,3780,7790,0
AMURU,2017,4070,3830,7900,0
AMURU,2018,4110,3880,7990,0
AMURU,2019,4150,3920,8070,0
AMURU,2020,4200,3980,8180,0
AMURU,2021,4240,4010,8250,0
AMURU,2022,4280,4060,8340,0
AMURU,2023,4310,4090,8400,0
AMURU,2024,4320,4110,8430,0
AMURU,2025,4340,4130,8470,0
APAC,2015,3120,2940,6060,0
APAC,2016,3240,3040,6280,0
APAC,2017,3360,3150,6510,0
APAC,2018,3480,3260,6740,0
APAC,2019,3600,3370,6970,0
APAC,2020,3730,3480,7210,0
APAC,2021,3860,3590,7450,0
APAC,2022,3990,3710,7700,0
APAC,2023,4120,3820,7940,0
APAC,2024,4260,3940,8200,0
APAC,2025,4390,4060,8450,0
ARUA,2015,12540,11580,24120,0
ARUA,2016,12920,11890,24810,0
ARUA,2017,13280,12220,25500,0
ARUA,2018,13660,12540,26200,0
ARUA,2019,14040,12880,26920,0
ARUA,2020,14420,13200,27620,0
ARUA,2021,14820,13530,28350,0
ARUA,2022,15190,13860,29050,0
ARUA,2023,15580,14200,29780,0
ARUA,2024,15960,14530,30490,0
ARUA,2025,16340,14850,31190,0
BUDAKA,2015,4820,4700,9520,0
BUDAKA,2016,4920,4810,9730,0
BUDAKA,2017,5040,4910,9950,0
BUDAKA,2018,5160,5010,10170,0
BUDAKA,2019,5260,5110,10370,0
BUDAKA,2020,5360,5210,10570,0
BUDAKA,2021,5470,5310,10780,0
BUDAKA,2022,5570,5400,10970,0
BUDAKA,2023,5660,5490,11150,0
BUDAKA,2024,5740,5550,11290,0
BUDAKA,2025,5810,5620,11430,0
BUDUDA,2015,3590,3650,7240,0
BUDUDA,2016,3700,3770,7470,0
BUDUDA,2017,3820,3890,7710,0
BUDUDA,2018,3940,4020,7960,0
BUDUDA,2019,4060,4140,8200,0
BUDUDA,2020,4180,4260,8440,0
BUDUDA,2021,4300,4380,8680,0
BUDUDA,2022,4410,4500,8910,0
BUDUDA,2023,4530,4620,9150,0
BUDUDA,2024,4640,4730,9370,0
BUDUDA,2025,4740,4830,9570,0
BUGIRI,2015,8740,8650,17390,0
BUGIRI,2016,8980,8890,17870,0
BUGIRI,2017,9230,9130,18360,0
BUGIRI,2018,9480,9370,18850,0
BUGIRI,2019,9730,9590,19320,0
BUGIRI,2020,9970,9820,19790,0
BUGIRI,2021,10220,10050,20270,0
BUGIRI,2022,10460,10270,20730,0
BUGIRI,2023,10680,10480,21160,0
BUGIRI,2024,10900,10680,21580,0
BUGIRI,2025,11080,10860,21940,0
BUGWERI,2015,3120,3090,6210,0
BUGWERI,2016,3180,3130,6310,0
BUGWERI,2017,3220,3170,6390,0
BUGWERI,2018,3260,3210,6470,0
BUGWERI,2019,3310,3240,6550,0
BUGWERI,2020,3340,3280,6620,0
BUGWERI,2021,3380,3320,6700,0
BUGWERI,2022,3410,3350,6760,0
BUGWERI,2023,3430,3370,6800,0
BUGWERI,2024,3460,3390,6850,0
BUGWERI,2025,3470,3400,6870,0
BUHWEJU,2015,2290,2110,4400,0
BUHWEJU,2016,2360,2170,4530,0
BUHWEJU,2017,2440,2240,4680,0
BUHWEJU,2018,2520,2300,4820,0
BUHWEJU,2019,2590,2370,4960,0
BUHWEJU,2020,2680,2440,5120,0
BUHWEJU,2021,2760,2510,5270,0
BUHWEJU,2022,2840,2580,5420,0
BUHWEJU,2023,2920,2650,5570,0
BUHWEJU,2024,3000,2720,5720,0
BUHWEJU,2025,3080,2790,5870,0
BUIKWE,2015,7820,7290,15110,0
BUIKWE,2016,7890,7370,15260,0
BUIKWE,2017,7950,7430,15380,0
BUIKWE,2018,8000,7480,15480,0
BUIKWE,2019,8030,7520,15550,0
BUIKWE,2020,8070,7560,15630,0
BUIKWE,2021,8100,7610,15710,0
BUIKWE,2022,8120,7630,15750,0
BUIKWE,2023,8140,7650,15790,0
BUIKWE,2024,8130,7650,15780,0
BUIKWE,2025,8100,7630,15730,0
BUKEDEA,2015,4820,4720,9540,0
BUKEDEA,2016,4980,4860,9840,0
BUKEDEA,2017,5130,4990,10120,0
BUKEDEA,2018,5280,5140,10420,0
BUKEDEA,2019,5430,5280,10710,0
BUKEDEA,2020,5580,5420,11000,0
BUKEDEA,2021,5730,5560,11290,0
BUKEDEA,2022,5890,5690,11580,0
BUKEDEA,2023,6040,5810,11850,0
BUKEDEA,2024,6170,5930,12100,0
BUKEDEA,2025,6300,6040,12340,0
BUKOMANSIMBI,2015,2600,2460,5060,0
BUKOMANSIMBI,2016,2590,2450,5040,0
BUKOMANSIMBI,2017,2580,2430,5010,0
BUKOMANSIMBI,2018,2570,2410,4980,0
BUKOMANSIMBI,2019,2540,2390,4930,0
BUKOMANSIMBI,2020,2520,2360,4880,0
BUKOMANSIMBI,2021,2500,2340,4840,0
BUKOMANSIMBI,2022,2490,2310,4800,0
BUKOMANSIMBI,2023,2460,2280,4740,0
BUKOMANSIMBI,2024,2420,2240,4660,0
BUKOMANSIMBI,2025,2390,2200,4590,0
BUKWO,2015,2140,1830,3970,0
BUKWO,2016,2250,1920,4170,0
BUKWO,2017,2370,2020,4390,0
BUKWO,2018,2500,2120,4620,0
BUKWO,2019,2630,2220,4850,0
BUKWO,2020,2760,2320,5080,0
BUKWO,2021,2900,2430,5330,0
BUKWO,2022,3050,2540,5590,0
BUKWO,2023,3200,2660,5860,0
BUKWO,2024,3360,2780,6140,0
BUKWO,2025,3520,2900,6420,0
BULAMBULI,2015,2970,3010,5980,0
BULAMBULI,2016,3080,3120,6200,0
BULAMBULI,2017,3200,3240,6440,0
BULAMBULI,2018,3300,3350,6650,0
BULAMBULI,2019,3420,3460,6880,0
BULAMBULI,2020,3520,3590,7110,0
BULAMBULI,2021,3650,3700,7350,0
BULAMBULI,2022,3760,3830,7590,0
BULAMBULI,2023,3870,3930,7800,0
BULAMBULI,2024,3980,4050,8030,0
BULAMBULI,2025,4080,4150,8230,0
BULIISA,2015,2450,2260,4710,0
BULIISA,2016,2590,2360,4950,0
BULIISA,2017,2730,2460,5190,0
BULIISA,2018,2880,2570,5450,0
BULIISA,2019,3030,2680,5710,0
BULIISA,2020,3190,2800,5990,0
BULIISA,2021,3350,2920,6270,0
BULIISA,2022,3530,3040,6570,0
BULIISA,2023,3700,3170,6870,0
BULIISA,2024,3890,3290,7180,0
BULIISA,2025,4070,3420,7490,0
BUNDIBUGYO,2015,4680,4660,9340,0
BUNDIBUGYO,2016,4770,4730,9500,0
BUNDIBUGYO,2017,4850,4810,9660,0
BUNDIBUGYO,2018,4920,4870,9790,0
BUNDIBUGYO,2019,4990,4940,9930,0
BUNDIBUGYO,2020,5060,4990,10050,0
BUNDIBUGYO,2021,5130,5050,10180,0
BUNDIBUGYO,2022,5190,5110,10300,0
BUNDIBUGYO,2023,5240,5160,10400,0
BUNDIBUGYO,2024,5290,5190,10480,0
BUNDIBUGYO,2025,5320,5220,10540,0
BUNYANGABU,2015,3370,3220,6590,0
BUNYANGABU,2016,3410,3260,6670,0
BUNYANGABU,2017,3460,3290,6750,0
BUNYANGABU,2018,3490,3330,6820,0
BUNYANGABU,2019,3530,3350,6880,0
BUNYANGABU,2020,3560,3380,6940,0
BUNYANGABU,2021,3590,3400,6990,0
BUNYANGABU,2022,3620,3430,7050,0
BUNYANGABU,2023,3640,3440,7080,0
BUNYANGABU,2024,3660,3450,7110,0
BUNYANGABU,2025,3670,3450,7120,0
BUSHENYI,2015,3130,2900,6030,0
BUSHENYI,2016,3170,2930,6100,0
BUSHENYI,2017,3210,2960,6170,0
BUSHENYI,2018,3250,2980,6230,0
BUSHENYI,2019,3280,3010,6290,0
BUSHENYI,2020,3320,3030,6350,0
BUSHENYI,2021,3350,3050,6400,0
BUSHENYI,2022,3390,3070,6460,0
BUSHENYI,2023,3420,3090,6510,0
BUSHENYI,2024,3440,3100,6540,0
BUSHENYI,2025,3460,3110,6570,0
BUSIA,2015,6660,6170,12830,0
BUSIA,2016,6730,6570,13300,0
BUSIA,2017,6860,6690,13550,0
BUSIA,2018,6990,6810,13800,0
BUSIA,2019,7120,6920,14040,0
BUSIA,2020,7230,7020,14250,0
BUSIA,2021,7350,7120,14470,0
BUSIA,2022,7460,7220,14680,0
BUSIA,2023,7570,7310,14880,0
BUSIA,2024,7670,7390,15060,0
BUSIA,2025,7740,7460,15200,0
BUTALEJA,2015,6420,6050,12470,0
BUTALEJA,2016,6510,6100,12610,0
BUTALEJA,2017,6940,6370,13310,0
BUTALEJA,2018,7280,6530,13810,0
BUTALEJA,2019,7600,6760,14360,0
BUTALEJA,2020,7960,6970,14930,0
BUTALEJA,2021,8380,7250,15630,0
BUTALEJA,2022,8820,7420,16240,0
BUTALEJA,2023,9250,7580,16830,0
BUTALEJA,2024,9670,7850,17520,0
BUTALEJA,2025,10090,8000,18090,0
BUTAMBALA,2015,1720,1630,3350,0
BUTAMBALA,2016,1710,1630,3340,0
BUTAMBALA,2017,1710,1620,3330,0
BUTAMBALA,2018,1720,1630,3350,0
BUTAMBALA,2019,1710,1620,3330,0
BUTAMBALA,2020,1710,1610,3320,0
BUTAMBALA,2021,1700,1610,3310,0
BUTAMBALA,2022,1700,1600,3300,0
BUTAMBALA,2023,1690,1580,3270,0
BUTAMBALA,2024,1680,1570,3250,0
BUTAMBALA,2025,1660,1550,3210,0
BUTEBO,2015,2560,2530,5090,0
BUTEBO,2016,2570,2540,5110,0
BUTEBO,2017,2570,2540,5110,0
BUTEBO,2018,2580,2540,5120,0
BUTEBO,2019,2580,2540,5120,0
BUTEBO,2020,2580,2540,5120,0
BUTEBO,2021,2580,2530,5110,0
BUTEBO,2022,2570,2530,5100,0
BUTEBO,2023,2570,2510,5080,0
BUTEBO,2024,2550,2500,5050,0
BUTEBO,2025,2530,2480,5010,0
BUVUMA,2015,2110,1900,4010,0
BUVUMA,2016,2240,2030,4270,0
BUVUMA,2017,2380,2170,4550,0
BUVUMA,2018,2530,2310,4840,0
BUVUMA,2019,2680,2470,5150,0
BUVUMA,2020,2840,2630,5470,0
BUVUMA,2021,3010,2800,5810,0
BUVUMA,2022,3190,2980,6170,0
BUVUMA,2023,3370,3170,6540,0
BUVUMA,2024,3560,3380,6940,0
BUVUMA,2025,3760,3590,7350,0
BUYENDE,2015,8430,8430,16860,0
BUYENDE,2016,8700,8710,17410,0
BUYENDE,2017,8970,8970,17940,0
BUYENDE,2018,9250,9250,18500,0
BUYENDE,2019,9520,9510,19030,0
BUYENDE,2020,9790,9780,19570,0
BUYENDE,2021,10070,10050,20120,0
BUYENDE,2022,10340,10330,20670,0
BUYENDE,2023,10600,10570,21170,0
BUYENDE,2024,10850,10810,21660,0
BUYENDE,2025,11080,11030,22110,0
DOKOLO,2015,3360,3070,6430,0
DOKOLO,2016,3470,3150,6620,0
DOKOLO,2017,3570,3240,6810,0
DOKOLO,2018,3680,3330,7010,0
DOKOLO,2019,3790,3420,7210,0
DOKOLO,2020,3900,3510,7410,0
DOKOLO,2021,4010,3600,7610,0
DOKOLO,2022,4120,3680,7800,0
DOKOLO,2023,4230,3770,8000,0
DOKOLO,2024,4340,3860,8200,0
DOKOLO,2025,4450,3950,8400,0
GOMBA,2015,3170,2930,6100,0
GOMBA,2016,3180,2930,6110,0
GOMBA,2017,3200,2930,6130,0
GOMBA,2018,3210,2930,6140,0
GOMBA,2019,3220,2920,6140,0
GOMBA,2020,3220,2920,6140,0
GOMBA,2021,3230,2900,6130,0
GOMBA,2022,3230,2890,6120,0
GOMBA,2023,3210,2870,6080,0
GOMBA,2024,3210,2850,6060,0
GOMBA,2025,3190,2820,6010,0
GULU,2015,4650,4240,8890,0
GULU,2016,4790,4370,9160,0
GULU,2017,4940,4490,9430,0
GULU,2018,5090,4620,9710,0
GULU,2019,5230,4750,9980,0
GULU,2020,5390,4880,10270,0
GULU,2021,5530,5020,10550,0
GULU,2022,5690,5150,10840,0
GULU,2023,5830,5280,11110,0
GULU,2024,5990,5420,11410,0
GULU,2025,6140,5550,11690,0
HOIMA,2015,6180,5560,11740,0
HOIMA,2016,6420,5750,12170,0
HOIMA,2017,6660,5950,12610,0
HOIMA,2018,6910,6160,13070,0
HOIMA,2019,7160,6360,13520,0
HOIMA,2020,7420,6580,14000,0
HOIMA,2021,7680,6790,14470,0
HOIMA,2022,7940,7010,14950,0
HOIMA,2023,8210,7230,15440,0
HOIMA,2024,8490,7450,15940,0
HOIMA,2025,8760,7670,16430,0
IBANDA,2015,3820,3590,7410,0
IBANDA,2016,3890,3660,7550,0
IBANDA,2017,3970,3720,7690,0
IBANDA,2018,4050,3790,7840,0
IBANDA,2019,4120,3860,7980,0
IBANDA,2020,4200,3920,8120,0
IBANDA,2021,4270,3980,8250,0
IBANDA,2022,4340,4040,8380,0
IBANDA,2023,4410,4100,8510,0
IBANDA,2024,4480,4160,8640,0
IBANDA,2025,4540,4220,8760,0
IGANGA,2015,6590,6220,12810,0
IGANGA,2016,6720,6310,13030,0
IGANGA,2017,6840,6430,13270,0
IGANGA,2018,6960,6530,13490,0
IGANGA,2019,7080,6630,13710,0
IGANGA,2020,7180,6710,13890,0
IGANGA,2021,7290,6810,14100,0
IGANGA,2022,7390,6890,14280,0
IGANGA,2023,7480,6970,14450,0
IGANGA,2024,7560,7030,14590,0
IGANGA,2025,7620,7070,14690,0
ISINGIRO,2015,8790,8460,17250,0
ISINGIRO,2016,9120,8760,17880,0
ISINGIRO,2017,9460,9070,18530,0
ISINGIRO,2018,9810,9380,19190,0
ISINGIRO,2019,10160,9700,19860,0
ISINGIRO,2020,10530,10030,20560,0
ISINGIRO,2021,10900,10360,21260,0
ISINGIRO,2022,11270,10700,21970,0
ISINGIRO,2023,11650,11040,22690,0
ISINGIRO,2024,12040,11380,23420,0
ISINGIRO,2025,12420,11730,24150,0
JINJA,2015,8060,7540,15600,0
JINJA,2016,8190,7660,15850,0
JINJA,2017,8330,7780,16110,0
JINJA,2018,8470,7890,16360,0
JINJA,2019,8600,8010,16610,0
JINJA,2020,8730,8120,16850,0
JINJA,2021,8860,8230,17090,0
JINJA,2022,8980,8330,17310,0
JINJA,2023,9100,8430,17530,0
JINJA,2024,9210,8530,17740,0
JINJA,2025,9320,8620,17940,0
KAABONG,2015,1740,1110,2850,0
KAABONG,2016,1810,1170,2980,0
KAABONG,2017,1900,1080,2980,0
KAABONG,2018,1920,1210,3130,0
KAABONG,2019,1980,1300,3280,0
KAABONG,2020,1990,1260,3250,0
KAABONG,2021,2040,1330,3370,0
KAABONG,2022,2130,1340,3470,0
KAABONG,2023,2180,1410,3590,0
KAABONG,2024,2170,1400,3570,0
KAABONG,2025,2230,1440,3670,0
KABALE,2015,3620,3450,7070,0
KABALE,2016,3680,3500,7180,0
KABALE,2017,3740,3540,7280,0
KABALE,2018,3800,3580,7380,0
KABALE,2019,3850,3620,7470,0
KABALE,2020,3910,3660,7570,0
KABALE,2021,3960,3700,7660,0
KABALE,2022,4010,3730,7740,0
KABALE,2023,4060,3760,7820,0
KABALE,2024,4100,3790,7890,0
KABALE,2025,4140,3820,7960,0
KABAROLE,2015,4980,4660,9640,0
KABAROLE,2016,5100,4760,9860,0
KABAROLE,2017,5210,4860,10070,0
KABAROLE,2018,5320,4970,10290,0
KABAROLE,2019,5430,5070,10500,0
KABAROLE,2020,5540,5170,10710,0
KABAROLE,2021,5650,5280,10930,0
KABAROLE,2022,5760,5370,11130,0
KABAROLE,2023,5870,5470,11340,0
KABAROLE,2024,5970,5570,11540,0
KABAROLE,2025,6070,5670,11740,0
KABERAMAIDO,2015,2210,2400,4610,0
KABERAMAIDO,2016,2320,2410,4730,0
KABERAMAIDO,2017,2510,2670,5180,0
KABERAMAIDO,2018,2540,2800,5340,0
KABERAMAIDO,2019,2650,3120,5770,0
KABERAMAIDO,2020,2770,3180,5950,0
KABERAMAIDO,2021,2960,3350,6310,0
KABERAMAIDO,2022,3020,3450,6470,0
KABERAMAIDO,2023,3200,3500,6700,0
KABERAMAIDO,2024,3420,3610,7030,0
KABERAMAIDO,2025,3570,3640,7210,0
KAGADI,2015,7850,7520,15370,0
KAGADI,2016,8140,7780,15920,0
KAGADI,2017,8440,8060,16500,0
KAGADI,2018,8750,8340,17090,0
KAGADI,2019,9070,8630,17700,0
KAGADI,2020,9390,8920,18310,0
KAGADI,2021,9720,9220,18940,0
KAGADI,2022,10050,9520,19570,0
KAGADI,2023,10380,9820,20200,0
KAGADI,2024,10720,10130,20850,0
KAGADI,2025,11060,10440,21500,0
KAKUMIRO,2015,7230,6980,14210,0
KAKUMIRO,2016,7880,7570,15450,0
KAKUMIRO,2017,8570,8210,16780,0
KAKUMIRO,2018,9330,8900,18230,0
KAKUMIRO,2019,10140,9640,19780,0
KAKUMIRO,2020,11030,10430,21460,0
KAKUMIRO,2021,11970,11290,23260,0
KAKUMIRO,2022,13000,12210,25210,0
KAKUMIRO,2023,14090,13190,27280,0
KAKUMIRO,2024,15270,14250,29520,0
KAKUMIRO,2025,16540,15370,31910,0
KALAKI,2015,2350,2120,4470,0
KALAKI,2016,2450,2200,4650,0
KALAKI,2017,2560,2290,4850,0
KALAKI,2018,2670,2380,5050,0
KALAKI,2019,2780,2470,5250,0
KALAKI,2020,2890,2560,5450,0
KALAKI,2021,3010,2660,5670,0
KALAKI,2022,3130,2750,5880,0
KALAKI,2023,3260,2860,6120,0
KALAKI,2024,3380,2960,6340,0
KALAKI,2025,3510,3060,6570,0
KALANGALA,2015,1150,940,2090,0
KALANGALA,2016,1190,980,2170,0
KALANGALA,2017,1230,1020,2250,0
KALANGALA,2018,1280,1060,2340,0
KALANGALA,2019,1320,1100,2420,0
KALANGALA,2020,1360,1150,2510,0
KALANGALA,2021,1410,1190,2600,0
KALANGALA,2022,1450,1240,2690,0
KALANGALA,2023,1500,1290,2790,0
KALANGALA,2024,1550,1330,2880,0
KALANGALA,2025,1590,1380,2970,0
KALIRO,2015,5230,5060,10290,0
KALIRO,2016,5350,5190,10540,0
KALIRO,2017,5470,5300,10770,0
KALIRO,2018,5600,5420,11020,0
KALIRO,2019,5710,5530,11240,0
KALIRO,2020,5820,5640,11460,0
KALIRO,2021,5930,5750,11680,0
KALIRO,2022,6040,5860,11900,0
KALIRO,2023,6140,5950,12090,0
KALIRO,2024,6230,6030,12260,0
KALIRO,2025,6300,6110,12410,0
KALUNGU,2015,3180,3050,6230,0
KALUNGU,2016,3180,3050,6230,0
KALUNGU,2017,3160,3040,6200,0
KALUNGU,2018,3160,3040,6200,0
KALUNGU,2019,3150,3020,6170,0
KALUNGU,2020,3130,3000,6130,0
KALUNGU,2021,3120,2980,6100,0
KALUNGU,2022,3090,2960,6050,0
KALUNGU,2023,3070,2940,6010,0
KALUNGU,2024,3040,2910,5950,0
KALUNGU,2025,3010,2880,5890,0
KAMPALA,2015,25620,22670,48290,0
KAMPALA,2016,26140,23110,49250,0
KAMPALA,2017,26650,23560,50210,0
KAMPALA,2018,27170,24010,51180,0
KAMPALA,2019,27680,24450,52130,0
KAMPALA,2020,28180,24890,53070,0
KAMPALA,2021,28680,25320,54000,0
KAMPALA,2022,29160,25740,54900,0
KAMPALA,2023,29620,26160,55780,0
KAMPALA,2024,30080,26560,56640,0
KAMPALA,2025,30510,26950,57460,0
KAMULI,2015,9730,9370,19100,0
KAMULI,2016,9860,9470,19330,0
KAMULI,2017,9990,9570,19560,0
KAMULI,2018,10120,9670,19790,0
KAMULI,2019,10220,9760,19980,0
KAMULI,2020,10320,9830,20150,0
KAMULI,2021,10430,9910,20340,0
KAMULI,2022,10510,9960,20470,0
KAMULI,2023,10590,10010,20600,0
KAMULI,2024,10640,10040,20680,0
KAMULI,2025,10670,10040,20710,0
KAMWENGE,2015,6070,5740,11810,0
KAMWENGE,2016,6310,5950,12260,0
KAMWENGE,2017,6570,6160,12730,0
KAMWENGE,2018,6830,6380,13210,0
KAMWENGE,2019,7110,6600,13710,0
KAMWENGE,2020,7380,6820,14200,0
KAMWENGE,2021,7670,7050,14720,0
KAMWENGE,2022,7950,7280,15230,0
KAMWENGE,2023,8240,7520,15760,0
KAMWENGE,2024,8550,7760,16310,0
KAMWENGE,2025,8850,8000,16850,0
KANUNGU,2015,4100,3760,7860,0
KANUNGU,2016,4180,3820,8000,0
KANUNGU,2017,4250,3880,8130,0
KANUNGU,2018,4330,3950,8280,0
KANUNGU,2019,4400,4010,8410,0
KANUNGU,2020,4470,4070,8540,0
KANUNGU,2021,4540,4120,8660,0
KANUNGU,2022,4610,4180,8790,0
KANUNGU,2023,4680,4230,8910,0
KANUNGU,2024,4740,4290,9030,0
KANUNGU,2025,4800,4340,9140,0
KAPCHORWA,2015,1730,1650,3380,0
KAPCHORWA,2016,1780,1690,3470,0
KAPCHORWA,2017,1840,1740,3580,0
KAPCHORWA,2018,1890,1780,3670,0
KAPCHORWA,2019,1950,1830,3780,0
KAPCHORWA,2020,2010,1880,3890,0
KAPCHORWA,2021,2060,1930,3990,0
KAPCHORWA,2022,2120,1980,4100,0
KAPCHORWA,2023,2180,2030,4210,0
KAPCHORWA,2024,2230,2080,4310,0
KAPCHORWA,2025,2290,2120,4410,0
KAPELEBYONG,2015,2290,2070,4360,0
KAPELEBYONG,2016,2340,2100,4440,0
KAPELEBYONG,2017,2390,2140,4530,0
KAPELEBYONG,2018,2420,2170,4590,0
KAPELEBYONG,2019,2470,2200,4670,0
KAPELEBYONG,2020,2500,2220,4720,0
KAPELEBYONG,2021,2540,2260,4800,0
KAPELEBYONG,2022,2580,2280,4860,0
KAPELEBYONG,2023,2610,2310,4920,0
KAPELEBYONG,2024,2650,2320,4970,0
KAPELEBYONG,2025,2660,2330,4990,0
KASESE,2015,14580,13990,28570,0
KASESE,2016,14760,14150,28910,0
KASESE,2017,14930,14300,29230,0
KASESE,2018,15090,14430,29520,0
KASESE,2019,15230,14540,29770,0
KASESE,2020,15360,14650,30010,0
KASESE,2021,15490,14760,30250,0
KASESE,2022,15590,14830,30420,0
KASESE,2023,15680,14900,30580,0
KASESE,2024,15730,14930,30660,0
KASESE,2025,15750,14930,30680,0
KASSANDA,2015,5210,4710,9920,0
KASSANDA,2016,5360,4820,10180,0
KASSANDA,2017,5520,4920,10440,0
KASSANDA,2018,5670,5020,10690,0
KASSANDA,2019,5830,5120,10950,0
KASSANDA,2020,5990,5230,11220,0
KASSANDA,2021,6140,5330,11470,0
KASSANDA,2022,6300,5430,11730,0
KASSANDA,2023,6450,5530,11980,0
KASSANDA,2024,6610,5620,12230,0
KASSANDA,2025,6770,5720,12490,0
KATAKWI,2015,3280,3130,6410,0
KATAKWI,2016,3340,3170,6510,0
KATAKWI,2017,3390,3220,6610,0
KATAKWI,2018,3450,3260,6710,0
KATAKWI,2019,3500,3300,6800,0
KATAKWI,2020,3540,3340,6880,0
KATAKWI,2021,3590,3370,6960,0
KATAKWI,2022,3630,3400,7030,0
KATAKWI,2023,3680,3420,7100,0
KATAKWI,2024,3710,3440,7150,0
KATAKWI,2025,3730,3460,7190,0
KAYUNGA,2015,6980,6930,13910,0
KAYUNGA,2016,7040,6960,14000,0
KAYUNGA,2017,7090,6990,14080,0
KAYUNGA,2018,7120,7020,14140,0
KAYUNGA,2019,7160,7040,14200,0
KAYUNGA,2020,7180,7050,14230,0
KAYUNGA,2021,7200,7060,14260,0
KAYUNGA,2022,7220,7070,14290,0
KAYUNGA,2023,7230,7060,14290,0
KAYUNGA,2024,7210,7030,14240,0
KAYUNGA,2025,7190,6990,14180,0
KAZO,2015,3180,2870,6050,0
KAZO,2016,3290,2970,6260,0
KAZO,2017,3420,3080,6500,0
KAZO,2018,3550,3190,6740,0
KAZO,2019,3680,3300,6980,0
KAZO,2020,3810,3410,7220,0
KAZO,2021,3950,3520,7470,0
KAZO,2022,4080,3640,7720,0
KAZO,2023,4220,3760,7980,0
KAZO,2024,4370,3880,8250,0
KAZO,2025,4510,4000,8510,0
KIBAALE,2015,3510,3250,6760,0
KIBAALE,2016,3740,3440,7180,0
KIBAALE,2017,3980,3630,7610,0
KIBAALE,2018,4230,3840,8070,0
KIBAALE,2019,4500,4060,8560,0
KIBAALE,2020,4770,4290,9060,0
KIBAALE,2021,5070,4530,9600,0
KIBAALE,2022,5370,4780,10150,0
KIBAALE,2023,5700,5040,10740,0
KIBAALE,2024,6030,5310,11340,0
KIBAALE,2025,6380,5590,11970,0
KIBOGA,2015,3920,3700,7620,0
KIBOGA,2016,3870,3790,7660,0
KIBOGA,2017,3890,3850,7740,0
KIBOGA,2018,3850,3900,7750,0
KIBOGA,2019,3930,3960,7890,0
KIBOGA,2020,3900,4050,7950,0
KIBOGA,2021,3850,4060,7910,0
KIBOGA,2022,3840,4070,7910,0
KIBOGA,2023,3880,4110,7990,0
KIBOGA,2024,3970,4090,8060,0
KIBOGA,2025,3910,4030,7940,0
KIBUKU,2015,4850,4870,9720,0
KIBUKU,2016,4980,5000,9980,0
KIBUKU,2017,5100,5120,10220,0
KIBUKU,2018,5240,5240,10480,0
KIBUKU,2019,5360,5360,10720,0
KIBUKU,2020,5470,5480,10950,0
KIBUKU,2021,5600,5600,11200,0
KIBUKU,2022,5720,5710,11430,0
KIBUKU,2023,5830,5810,11640,0
KIBUKU,2024,5940,5910,11850,0
KIBUKU,2025,6020,6000,12020,0
KIKUUBE,2015,6010,5430,11440,0
KIKUUBE,2016,6330,5710,12040,0
KIKUUBE,2017,6670,6000,12670,0
KIKUUBE,2018,7030,6310,13340,0
KIKUUBE,2019,7390,6620,14010,0
KIKUUBE,2020,7780,6950,14730,0
KIKUUBE,2021,8180,7290,15470,0
KIKUUBE,2022,8590,7640,16230,0
KIKUUBE,2023,9020,8000,17020,0
KIKUUBE,2024,9460,8380,17840,0
KIKUUBE,2025,9910,8760,18670,0
KIRUHURA,2015,2750,2510,5260,0
KIRUHURA,2016,2860,2600,5460,0
KIRUHURA,2017,2960,2690,5650,0
KIRUHURA,2018,3080,2780,5860,0
KIRUHURA,2019,3190,2880,6070,0
KIRUHURA,2020,3310,2980,6290,0
KIRUHURA,2021,3430,3080,6510,0
KIRUHURA,2022,3550,3180,6730,0
KIRUHURA,2023,3670,3280,6950,0
KIRUHURA,2024,3780,3380,7160,0
KIRUHURA,2025,3910,3480,7390,0
KIRYANDONGO,2015,6030,5870,11900,0
KIRYANDONGO,2016,6130,5960,12090,0
KIRYANDONGO,2017,6250,6060,12310,0
KIRYANDONGO,2018,6340,6140,12480,0
KIRYANDONGO,2019,6440,6220,12660,0
KIRYANDONGO,2020,6540,6300,12840,0
KIRYANDONGO,2021,6630,6380,13010,0
KIRYANDONGO,2022,6720,6450,13170,0
KIRYANDONGO,2023,6790,6500,13290,0
KIRYANDONGO,2024,6850,6550,13400,0
KIRYANDONGO,2025,6900,6580,13480,0
KISORO,2015,6000,5890,11890,0
KISORO,2016,6050,5950,12000,0
KISORO,2017,6090,5990,12080,0
KISORO,2018,6120,6040,12160,0
KISORO,2019,6150,6070,12220,0
KISORO,2020,6170,6110,12280,0
KISORO,2021,6200,6140,12340,0
KISORO,2022,6220,6160,12380,0
KISORO,2023,6220,6170,12390,0
KISORO,2024,6210,6170,12380,0
KISORO,2025,6190,6160,12350,0
KITAGWENDA,2015,2510,2410,4920,0
KITAGWENDA,2016,2620,2500,5120,0
KITAGWENDA,2017,2730,2590,5320,0
KITAGWENDA,2018,2840,2680,5520,0
KITAGWENDA,2019,2940,2780,5720,0
KITAGWENDA,2020,3070,2870,5940,0
KITAGWENDA,2021,3180,2970,6150,0
KITAGWENDA,2022,3300,3070,6370,0
KITAGWENDA,2023,3420,3160,6580,0
KITAGWENDA,2024,3540,3260,6800,0
KITAGWENDA,2025,3670,3360,7030,0
KITGUM,2015,4150,3830,7980,0
KITGUM,2016,4170,3860,8030,0
KITGUM,2017,4180,3870,8050,0
KITGUM,2018,4190,3880,8070,0
KITGUM,2019,4190,3890,8080,0
KITGUM,2020,4200,3890,8090,0
KITGUM,2021,4200,3900,8100,0
KITGUM,2022,4190,3900,8090,0
KITGUM,2023,4180,3880,8060,0
KITGUM,2024,4170,3870,8040,0
KITGUM,2025,4130,3850,7980,0
KOBOKO,2015,4500,4160,8660,0
KOBOKO,2016,4620,4270,8890,0
KOBOKO,2017,4740,4380,9120,0
KOBOKO,2018,4870,4490,9360,0
KOBOKO,2019,4990,4600,9590,0
KOBOKO,2020,5100,4700,9800,0
KOBOKO,2021,5220,4810,10030,0
KOBOKO,2022,5350,4920,10270,0
KOBOKO,2023,5450,5020,10470,0
KOBOKO,2024,5550,5110,10660,0
KOBOKO,2025,5640,5190,10830,0
KOLE,2015,4530,4040,8570,0
KOLE,2016,4680,4160,8840,0
KOLE,2017,4840,4280,9120,0
KOLE,2018,4990,4400,9390,0
KOLE,2019,5150,4520,9670,0
KOLE,2020,5310,4640,9950,0
KOLE,2021,5470,4770,10240,0
KOLE,2022,5630,4890,10520,0
KOLE,2023,5800,5020,10820,0
KOLE,2024,5960,5140,11100,0
KOLE,2025,6130,5260,11390,0
KOTIDO,2015,3110,3160,6270,0
KOTIDO,2016,3150,3200,6350,0
KOTIDO,2017,3190,3240,6430,0
KOTIDO,2018,3220,3260,6480,0
KOTIDO,2019,3250,3290,6540,0
KOTIDO,2020,3280,3310,6590,0
KOTIDO,2021,3310,3330,6640,0
KOTIDO,2022,3320,3350,6670,0
KOTIDO,2023,3350,3360,6710,0
KOTIDO,2024,3360,3370,6730,0
KOTIDO,2025,3370,3370,6740,0
KUMI,2015,5040,4800,9840,0
KUMI,2016,5140,4880,10020,0
KUMI,2017,5240,4970,10210,0
KUMI,2018,5340,5050,10390,0
KUMI,2019,5430,5130,10560,0
KUMI,2020,5520,5200,10720,0
KUMI,2021,5610,5270,10880,0
KUMI,2022,5700,5340,11040,0
KUMI,2023,5770,5390,11160,0
KUMI,2024,5830,5440,11270,0
KUMI,2025,5870,5480,11350,0
KWANIA,2015,3110,2980,6090,0
KWANIA,2016,3210,3060,6270,0
KWANIA,2017,3310,3150,6460,0
KWANIA,2018,3410,3240,6650,0
KWANIA,2019,3510,3330,6840,0
KWANIA,2020,3620,3420,7040,0
KWANIA,2021,3720,3510,7230,0
KWANIA,2022,3830,3600,7430,0
KWANIA,2023,3930,3690,7620,0
KWANIA,2024,4030,3780,7810,0
KWANIA,2025,4140,3870,8010,0
KWEEN,2015,1730,1600,3330,0
KWEEN,2016,1780,1640,3420,0
KWEEN,2017,1840,1680,3520,0
KWEEN,2018,1890,1720,3610,0
KWEEN,2019,1950,1760,3710,0
KWEEN,2020,2010,1800,3810,0
KWEEN,2021,2070,1850,3920,0
KWEEN,2022,2130,1890,4020,0
KWEEN,2023,2180,1930,4110,0
KWEEN,2024,2240,1970,4210,0
KWEEN,2025,2300,2000,4300,0
KYANKWANZI,2015,4630,4150,8780,0
KYANKWANZI,2016,4870,4350,9220,0
KYANKWANZI,2017,5120,4550,9670,0
KYANKWANZI,2018,5380,4760,10140,0
KYANKWANZI,2019,5650,4970,10620,0
KYANKWANZI,2020,5930,5200,11130,0
KYANKWANZI,2021,6220,5430,11650,0
KYANKWANZI,2022,6520,5670,12190,0
KYANKWANZI,2023,6830,5920,12750,0
KYANKWANZI,2024,7150,6160,13310,0
KYANKWANZI,2025,7480,6420,13900,0
KYEGEGWA,2015,6490,6250,12740,0
KYEGEGWA,2016,7020,6740,13760,0
KYEGEGWA,2017,7600,7280,14880,0
KYEGEGWA,2018,8220,7850,16070,0
KYEGEGWA,2019,8890,8460,17350,0
KYEGEGWA,2020,9600,9120,18720,0
KYEGEGWA,2021,10370,9820,20190,0
KYEGEGWA,2022,11180,10570,21750,0
KYEGEGWA,2023,12060,11370,23430,0
KYEGEGWA,2024,13000,12210,25210,0
KYEGEGWA,2025,13990,13110,27100,0
KYENJOJO,2015,9030,8220,17250,0
KYENJOJO,2016,9400,8530,17930,0
KYENJOJO,2017,9790,8840,18630,0
KYENJOJO,2018,10190,9160,19350,0
KYENJOJO,2019,10600,9490,20090,0
KYENJOJO,2020,11010,9820,20830,0
KYENJOJO,2021,11440,10170,21610,0
KYENJOJO,2022,11870,10520,22390,0
KYENJOJO,2023,12310,10870,23180,0
KYENJOJO,2024,12760,11220,23980,0
KYENJOJO,2025,13220,11580,24800,0
KYOTERA,2015,4240,3990,8230,0
KYOTERA,2016,4260,4000,8260,0
KYOTERA,2017,4270,4010,8280,0
KYOTERA,2018,4290,4010,8300,0
KYOTERA,2019,4290,4010,8300,0
KYOTERA,2020,4300,4000,8300,0
KYOTERA,2021,4310,4000,8310,0
KYOTERA,2022,4300,3990,8290,0
KYOTERA,2023,4290,3970,8260,0
KYOTERA,2024,4270,3950,8220,0
KYOTERA,2025,4240,3920,8160,0
KARENGA,2015,1040,1130,2170,0
KARENGA,2016,1070,1150,2220,0
KARENGA,2017,1090,1180,2270,0
KARENGA,2018,1130,1210,2340,0
KARENGA,2019,1160,1240,2400,0
KARENGA,2020,1190,1270,2460,0
KARENGA,2021,1220,1290,2510,0
KARENGA,2022,1250,1320,2570,0
KARENGA,2023,1280,1350,2630,0
KARENGA,2024,1310,1380,2690,0
KARENGA,2025,1330,1400,2730,0
LAMWO,2015,2790,2660,5450,0
LAMWO,2016,2780,2660,5440,0
LAMWO,2017,2770,2670,5440,0
LAMWO,2018,2760,2670,5430,0
LAMWO,2019,2740,2670,5410,0
LAMWO,2020,2730,2670,5400,0
LAMWO,2021,2710,2680,5390,0
LAMWO,2022,2690,2670,5360,0
LAMWO,2023,2660,2660,5320,0
LAMWO,2024,2640,2650,5290,0
LAMWO,2025,2600,2630,5230,0
LIRA,2015,7130,6710,13840,0
LIRA,2016,7340,6900,14240,0
LIRA,2017,7550,7100,14650,0
LIRA,2018,7760,7300,15060,0
LIRA,2019,7960,7500,15460,0
LIRA,2020,8180,7700,15880,0
LIRA,2021,8390,7910,16300,0
LIRA,2022,8600,8110,16710,0
LIRA,2023,8810,8320,17130,0
LIRA,2024,9020,8520,17540,0
LIRA,2025,9220,8720,17940,0
LUUKA,2015,4750,4770,9520,0
LUUKA,2016,4790,4810,9600,0
LUUKA,2017,4820,4850,9670,0
LUUKA,2018,4860,4880,9740,0
LUUKA,2019,4890,4920,9810,0
LUUKA,2020,4910,4940,9850,0
LUUKA,2021,4930,4960,9890,0
LUUKA,2022,4940,4980,9920,0
LUUKA,2023,4960,4990,9950,0
LUUKA,2024,4960,4990,9950,0
LUUKA,2025,4940,4970,9910,0
LUWERO,2015,8610,8150,16760,0
LUWERO,2016,8730,8250,16980,0
LUWERO,2017,8830,8330,17160,0
LUWERO,2018,8930,8420,17350,0
LUWERO,2019,9020,8490,17510,0
LUWERO,2020,9100,8550,17650,0
LUWERO,2021,9190,8630,17820,0
LUWERO,2022,9260,8680,17940,0
LUWERO,2023,9320,8720,18040,0
LUWERO,2024,9360,8730,18090,0
LUWERO,2025,9380,8740,18120,0
LWENGO,2015,5150,5110,10260,0
LWENGO,2016,5140,5100,10240,0
LWENGO,2017,5130,5080,10210,0
LWENGO,2018,5100,5070,10170,0
LWENGO,2019,5090,5050,10140,0
LWENGO,2020,5050,5010,10060,0
LWENGO,2021,5030,4990,10020,0
LWENGO,2022,5000,4960,9960,0
LWENGO,2023,4960,4910,9870,0
LWENGO,2024,4900,4860,9760,0
LWENGO,2025,4850,4790,9640,0
LYANTONDE,2015,2740,3030,5770,0
LYANTONDE,2016,2820,3060,5880,0
LYANTONDE,2017,2890,3070,5960,0
LYANTONDE,2018,2920,3190,6110,0
LYANTONDE,2019,2960,3120,6080,0
LYANTONDE,2020,3010,3120,6130,0
LYANTONDE,2021,2990,3100,6090,0
LYANTONDE,2022,3180,3040,6220,0
LYANTONDE,2023,3170,3140,6310,0
LYANTONDE,2024,3290,3180,6470,0
LYANTONDE,2025,3370,3240,6610,0
MANAFWA,2015,2910,2680,5590,0
MANAFWA,2016,2980,2750,5730,0
MANAFWA,2017,3060,2810,5870,0
MANAFWA,2018,3130,2870,6000,0
MANAFWA,2019,3210,2930,6140,0
MANAFWA,2020,3280,2990,6270,0
MANAFWA,2021,3360,3050,6410,0
MANAFWA,2022,3430,3110,6540,0
MANAFWA,2023,3500,3170,6670,0
MANAFWA,2024,3570,3230,6800,0
MANAFWA,2025,3650,3290,6940,0
MARACHA,2015,3820,3560,7380,0
MARACHA,2016,3910,3630,7540,0
MARACHA,2017,3990,3700,7690,0
MARACHA,2018,4070,3780,7850,0
MARACHA,2019,4150,3840,7990,0
MARACHA,2020,4230,3910,8140,0
MARACHA,2021,4310,3980,8290,0
MARACHA,2022,4390,4050,8440,0
MARACHA,2023,4470,4110,8580,0
MARACHA,2024,4540,4180,8720,0
MARACHA,2025,4610,4240,8850,0
MASAKA,2015,7270,6480,13750,0
MASAKA,2016,7350,6330,13680,0
MASAKA,2017,7250,6390,13640,0
MASAKA,2018,7200,6250,13450,0
MASAKA,2019,7100,6300,13400,0
MASAKA,2020,7090,6290,13380,0
MASAKA,2021,7070,6340,13410,0
MASAKA,2022,7030,6200,13230,0
MASAKA,2023,6980,6190,13170,0
MASAKA,2024,6840,6150,12990,0
MASAKA,2025,6780,6110,12890,0
MASINDI,2015,5320,5200,10520,0
MASINDI,2016,5480,5340,10820,0
MASINDI,2017,5640,5490,11130,0
MASINDI,2018,5800,5630,11430,0
MASINDI,2019,5960,5780,11740,0
MASINDI,2020,6120,5920,12040,0
MASINDI,2021,6290,6070,12360,0
MASINDI,2022,6450,6210,12660,0
MASINDI,2023,6620,6360,12980,0
MASINDI,2024,6780,6500,13280,0
MASINDI,2025,6950,6640,13590,0
MAYUGE,2015,10360,10270,20630,0
MAYUGE,2016,10560,10470,21030,0
MAYUGE,2017,10760,10670,21430,0
MAYUGE,2018,10950,10860,21810,0
MAYUGE,2019,11130,11050,22180,0
MAYUGE,2020,11300,11220,22520,0
MAYUGE,2021,11480,11400,22880,0
MAYUGE,2022,11630,11560,23190,0
MAYUGE,2023,11780,11700,23480,0
MAYUGE,2024,11900,11830,23730,0
MAYUGE,2025,12000,11920,23920,0
MBALE,2015,9250,9480,18730,0
MBALE,2016,9190,9360,18550,0
MBALE,2017,9120,9410,18530,0
MBALE,2018,8970,9440,18410,0
MBALE,2019,8960,9300,18260,0
MBALE,2020,8810,9280,18090,0
MBALE,2021,8750,9230,17980,0
MBALE,2022,8690,9340,18030,0
MBALE,2023,8600,9440,18040,0
MBALE,2024,8570,9530,18100,0
MBALE,2025,8500,9540,18040,0
MBARARA,2015,5470,4960,10430,0
MBARARA,2016,5600,5070,10670,0
MBARARA,2017,5730,5180,10910,0
MBARARA,2018,5860,5290,11150,0
MBARARA,2019,5990,5400,11390,0
MBARARA,2020,6120,5510,11630,0
MBARARA,2021,6250,5610,11860,0
MBARARA,2022,6370,5720,12090,0
MBARARA,2023,6500,5820,12320,0
MBARARA,2024,6610,5920,12530,0
MBARARA,2025,6730,6020,12750,0
MITOOMA,2015,3200,2820,6020,0
MITOOMA,2016,3240,2850,6090,0
MITOOMA,2017,3280,2880,6160,0
MITOOMA,2018,3320,2900,6220,0
MITOOMA,2019,3360,2930,6290,0
MITOOMA,2020,3390,2950,6340,0
MITOOMA,2021,3420,2970,6390,0
MITOOMA,2022,3460,2990,6450,0
MITOOMA,2023,3490,3010,6500,0
MITOOMA,2024,3510,3020,6530,0
MITOOMA,2025,3540,3040,6580,0
MITYANA,2015,6220,5740,11960,0
MITYANA,2016,6270,5770,12040,0
MITYANA,2017,6300,5790,12090,0
MITYANA,2018,6330,5810,12140,0
MITYANA,2019,6350,5820,12170,0
MITYANA,2020,6360,5820,12180,0
MITYANA,2021,6380,5830,12210,0
MITYANA,2022,6390,5830,12220,0
MITYANA,2023,6380,5810,12190,0
MITYANA,2024,6370,5790,12160,0
MITYANA,2025,6330,5750,12080,0
MOROTO,2015,1900,1900,3800,0
MOROTO,2016,1920,1920,3840,0
MOROTO,2017,1940,1940,3880,0
MOROTO,2018,1950,1970,3920,0
MOROTO,2019,1970,1990,3960,0
MOROTO,2020,1990,2010,4000,0
MOROTO,2021,2000,2040,4040,0
MOROTO,2022,2000,2050,4050,0
MOROTO,2023,2010,2060,4070,0
MOROTO,2024,2010,2070,4080,0
MOROTO,2025,2010,2080,4090,0
MOYO,2015,1470,1360,2830,0
MOYO,2016,1500,1390,2890,0
MOYO,2017,1540,1420,2960,0
MOYO,2018,1580,1450,3030,0
MOYO,2019,1620,1480,3100,0
MOYO,2020,1660,1510,3170,0
MOYO,2021,1700,1540,3240,0
MOYO,2022,1740,1570,3310,0
MOYO,2023,1780,1600,3380,0
MOYO,2024,1810,1630,3440,0
MOYO,2025,1850,1660,3510,0
MPIGI,2015,4630,4510,9140,0
MPIGI,2016,4680,4570,9250,0
MPIGI,2017,4730,4620,9350,0
MPIGI,2018,4780,4660,9440,0
MPIGI,2019,4830,4710,9540,0
MPIGI,2020,4860,4750,9610,0
MPIGI,2021,4900,4790,9690,0
MPIGI,2022,4930,4820,9750,0
MPIGI,2023,4960,4840,9800,0
MPIGI,2024,4980,4860,9840,0
MPIGI,2025,4980,4860,9840,0
MUBENDE,2015,9640,9490,19130,0
MUBENDE,2016,10020,9880,19900,0
MUBENDE,2017,10430,10270,20700,0
MUBENDE,2018,10830,10660,21490,0
MUBENDE,2019,11240,11060,22300,0
MUBENDE,2020,11650,11450,23100,0
MUBENDE,2021,12080,11870,23950,0
MUBENDE,2022,12510,12270,24780,0
MUBENDE,2023,12930,12680,25610,0
MUBENDE,2024,13330,13070,26400,0
MUBENDE,2025,13720,13440,27160,0
MUKONO,2015,10490,10210,20700,0
MUKONO,2016,10650,10380,21030,0
MUKONO,2017,10800,10580,21380,0
MUKONO,2018,10940,10740,21680,0
MUKONO,2019,11080,10910,21990,0
MUKONO,2020,11200,11070,22270,0
MUKONO,2021,11330,11230,22560,0
MUKONO,2022,11440,11370,22810,0
MUKONO,2023,11530,11500,23030,0
MUKONO,2024,11600,11610,23210,0
MUKONO,2025,11640,11690,23330,0
MADI OKOLLO,2015,2860,2620,5480,0
MADI OKOLLO,2016,2940,2700,5640,0
MADI OKOLLO,2017,3040,2760,5800,0
MADI OKOLLO,2018,3120,2840,5960,0
MADI OKOLLO,2019,3200,2910,6110,0
MADI OKOLLO,2020,3300,2990,6290,0
MADI OKOLLO,2021,3380,3070,6450,0
MADI OKOLLO,2022,3470,3150,6620,0
MADI OKOLLO,2023,3560,3210,6770,0
MADI OKOLLO,2024,3640,3290,6930,0
MADI OKOLLO,2025,3730,3360,7090,0
NABILATUK,2015,1010,1100,2110,0
NABILATUK,2016,1050,1140,2190,0
NABILATUK,2017,1090,1180,2270,0
NABILATUK,2018,1140,1210,2350,0
NABILATUK,2019,1180,1250,2430,0
NABILATUK,2020,1220,1290,2510,0
NABILATUK,2021,1260,1320,2580,0
NABILATUK,2022,1300,1370,2670,0
NABILATUK,2023,1340,1400,2740,0
NABILATUK,2024,1380,1440,2820,0
NABILATUK,2025,1420,1460,2880,0
NAKAPIRIPIRIT,2015,1520,1590,3110,0
NAKAPIRIPIRIT,2016,1570,1640,3210,0
NAKAPIRIPIRIT,2017,1620,1690,3310,0
NAKAPIRIPIRIT,2018,1670,1750,3420,0
NAKAPIRIPIRIT,2019,1720,1800,3520,0
NAKAPIRIPIRIT,2020,1770,1850,3620,0
NAKAPIRIPIRIT,2021,1820,1900,3720,0
NAKAPIRIPIRIT,2022,1870,1950,3820,0
NAKAPIRIPIRIT,2023,1920,2000,3920,0
NAKAPIRIPIRIT,2024,1960,2050,4010,0
NAKAPIRIPIRIT,2025,1990,2090,4080,0
NAKASEKE,2015,3510,3020,6530,0
NAKASEKE,2016,3640,3090,6730,0
NAKASEKE,2017,3770,3160,6930,0
NAKASEKE,2018,3900,3240,7140,0
NAKASEKE,2019,4040,3310,7350,0
NAKASEKE,2020,4190,3380,7570,0
NAKASEKE,2021,4330,3460,7790,0
NAKASEKE,2022,4480,3530,8010,0
NAKASEKE,2023,4620,3600,8220,0
NAKASEKE,2024,4770,3680,8450,0
NAKASEKE,2025,4920,3750,8670,0
NAKASONGOLA,2015,3840,3800,7640,0
NAKASONGOLA,2016,3880,3890,7770,0
NAKASONGOLA,2017,3860,3970,7830,0
NAKASONGOLA,2018,3890,4100,7990,0
NAKASONGOLA,2019,3950,4100,8050,0
NAKASONGOLA,2020,4030,4270,8300,0
NAKASONGOLA,2021,4010,4260,8270,0
NAKASONGOLA,2022,4020,4430,8450,0
NAKASONGOLA,2023,4030,4500,8530,0
NAKASONGOLA,2024,4000,4490,8490,0
NAKASONGOLA,2025,3910,4520,8430,0
NAMAYINGO,2015,4820,4500,9320,0
NAMAYINGO,2016,4860,4520,9380,0
NAMAYINGO,2017,4890,4530,9420,0
NAMAYINGO,2018,4910,4540,9450,0
NAMAYINGO,2019,4930,4550,9480,0
NAMAYINGO,2020,4930,4550,9480,0
NAMAYINGO,2021,4950,4550,9500,0
NAMAYINGO,2022,4960,4540,9500,0
NAMAYINGO,2023,4960,4530,9490,0
NAMAYINGO,2024,4950,4510,9460,0
NAMAYINGO,2025,4920,4480,9400,0
NAMISINDWA,2015,3920,3600,7520,0
NAMISINDWA,2016,4030,3690,7720,0
NAMISINDWA,2017,4150,3770,7920,0
NAMISINDWA,2018,4260,3860,8120,0
NAMISINDWA,2019,4380,3950,8330,0
NAMISINDWA,2020,4490,4040,8530,0
NAMISINDWA,2021,4610,4130,8740,0
NAMISINDWA,2022,4720,4210,8930,0
NAMISINDWA,2023,4840,4300,9140,0
NAMISINDWA,2024,4950,4380,9330,0
NAMISINDWA,2025,5060,4470,9530,0
NAMUTUMBA,2015,5440,5410,10850,0
NAMUTUMBA,2016,5550,5530,11080,0
NAMUTUMBA,2017,5690,5650,11340,0
NAMUTUMBA,2018,5800,5760,11560,0
NAMUTUMBA,2019,5930,5860,11790,0
NAMUTUMBA,2020,6040,5970,12010,0
NAMUTUMBA,2021,6150,6070,12220,0
NAMUTUMBA,2022,6260,6170,12430,0
NAMUTUMBA,2023,6360,6260,12620,0
NAMUTUMBA,2024,6450,6340,12790,0
NAMUTUMBA,2025,6530,6410,12940,0
NAPAK,2015,2640,2680,5320,0
NAPAK,2016,2650,2700,5350,0
NAPAK,2017,2670,2730,5400,0
NAPAK,2018,2670,2750,5420,0
NAPAK,2019,2670,2770,5440,0
NAPAK,2020,2670,2790,5460,0
NAPAK,2021,2670,2810,5480,0
NAPAK,2022,2670,2820,5490,0
NAPAK,2023,2660,2830,5490,0
NAPAK,2024,2660,2830,5490,0
NAPAK,2025,2630,2830,5460,0
NEBBI,2015,4750,4460,9210,0
NEBBI,2016,4910,4590,9500,0
NEBBI,2017,5060,4720,9780,0
NEBBI,2018,5220,4850,10070,0
NEBBI,2019,5380,4980,10360,0
NEBBI,2020,5540,5120,10660,0
NEBBI,2021,5710,5250,10960,0
NEBBI,2022,5870,5380,11250,0
NEBBI,2023,6040,5520,11560,0
NEBBI,2024,6200,5660,11860,0
NEBBI,2025,6360,5790,12150,0
NGORA,2015,2870,2870,5740,0
NGORA,2016,2910,2920,5830,0
NGORA,2017,2960,2950,5910,0
NGORA,2018,3010,2990,6000,0
NGORA,2019,3040,3030,6070,0
NGORA,2020,3080,3060,6140,0
NGORA,2021,3120,3100,6220,0
NGORA,2022,3150,3130,6280,0
NGORA,2023,3180,3160,6340,0
NGORA,2024,3210,3170,6380,0
NGORA,2025,3220,3180,6400,0
NTOROKO,2015,1390,1310,2700,0
NTOROKO,2016,1410,1330,2740,0
NTOROKO,2017,1430,1340,2770,0
NTOROKO,2018,1440,1340,2780,0
NTOROKO,2019,1460,1350,2810,0
NTOROKO,2020,1470,1350,2820,0
NTOROKO,2021,1490,1370,2860,0
NTOROKO,2022,1490,1370,2860,0
NTOROKO,2023,1510,1370,2880,0
NTOROKO,2024,1510,1370,2880,0
NTOROKO,2025,1510,1360,2870,0
NTUNGAMO,2015,8410,7900,16310,0
NTUNGAMO,2016,8590,8050,16640,0
NTUNGAMO,2017,8780,8200,16980,0
NTUNGAMO,2018,8960,8350,17310,0
NTUNGAMO,2019,9150,8500,17650,0
NTUNGAMO,2020,9330,8640,17970,0
NTUNGAMO,2021,9510,8780,18290,0
NTUNGAMO,2022,9680,8920,18600,0
NTUNGAMO,2023,9860,9060,18920,0
NTUNGAMO,2024,10020,9190,19210,0
NTUNGAMO,2025,10190,9320,19510,0
NWOYA,2015,3030,2870,5900,0
NWOYA,2016,3350,3160,6510,0
NWOYA,2017,3700,3480,7180,0
NWOYA,2018,4090,3830,7920,0
NWOYA,2019,4510,4220,8730,0
NWOYA,2020,4980,4640,9620,0
NWOYA,2021,5490,5110,10600,0
NWOYA,2022,6040,5610,11650,0
NWOYA,2023,6650,6170,12820,0
NWOYA,2024,7320,6770,14090,0
NWOYA,2025,8040,7420,15460,0
OBONGI,2015,920,830,1750,0
OBONGI,2016,940,830,1770,0
OBONGI,2017,940,840,1780,0
OBONGI,2018,960,840,1800,0
OBONGI,2019,960,850,1810,0
OBONGI,2020,970,850,1820,0
OBONGI,2021,980,860,1840,0
OBONGI,2022,980,870,1850,0
OBONGI,2023,990,870,1860,0
OBONGI,2024,990,880,1870,0
OBONGI,2025,1000,870,1870,0
OMORO,2015,3110,2930,6040,0
OMORO,2016,3190,3000,6190,0
OMORO,2017,3260,3060,6320,0
OMORO,2018,3320,3120,6440,0
OMORO,2019,3400,3190,6590,0
OMORO,2020,3460,3260,6720,0
OMORO,2021,3530,3320,6850,0
OMORO,2022,3590,3380,6970,0
OMORO,2023,3660,3430,7090,0
OMORO,2024,3710,3480,7190,0
OMORO,2025,3760,3530,7290,0
OTUKE,2015,2280,2010,4290,0
OTUKE,2016,2380,2100,4480,0
OTUKE,2017,2490,2190,4680,0
OTUKE,2018,2600,2280,4880,0
OTUKE,2019,2720,2380,5100,0
OTUKE,2020,2830,2480,5310,0
OTUKE,2021,2960,2580,5540,0
OTUKE,2022,3080,2680,5760,0
OTUKE,2023,3210,2790,6000,0
OTUKE,2024,3340,2900,6240,0
OTUKE,2025,3470,3010,6480,0
OYAM,2015,7290,6780,14070,0
OYAM,2016,7510,6980,14490,0
OYAM,2017,7740,7190,14930,0
OYAM,2018,7980,7390,15370,0
OYAM,2019,8210,7610,15820,0
OYAM,2020,8450,7810,16260,0
OYAM,2021,8690,8030,16720,0
OYAM,2022,8930,8240,17170,0
OYAM,2023,9170,8450,17620,0
OYAM,2024,9410,8670,18080,0
OYAM,2025,9650,8880,18530,0
PADER,2015,3490,3360,6850,0
PADER,2016,3490,3390,6880,0
PADER,2017,3510,3410,6920,0
PADER,2018,3530,3440,6970,0
PADER,2019,3530,3450,6980,0
PADER,2020,3530,3470,7000,0
PADER,2021,3540,3480,7020,0
PADER,2022,3540,3490,7030,0
PADER,2023,3540,3490,7030,0
PADER,2024,3510,3490,7000,0
PADER,2025,3490,3480,6970,0
PAKWACH,2015,3130,3100,6230,0
PAKWACH,2016,3270,3220,6490,0
PAKWACH,2017,3400,3330,6730,0
PAKWACH,2018,3550,3460,7010,0
PAKWACH,2019,3690,3580,7270,0
PAKWACH,2020,3840,3700,7540,0
PAKWACH,2021,3990,3830,7820,0
PAKWACH,2022,4150,3960,8110,0
PAKWACH,2023,4300,4090,8390,0
PAKWACH,2024,4460,4220,8680,0
PAKWACH,2025,4630,4360,8990,0
PALLISA,2015,6100,6240,12340,0
PALLISA,2016,6290,6440,12730,0
PALLISA,2017,6500,6630,13130,0
PALLISA,2018,6690,6830,13520,0
PALLISA,2019,6900,7040,13940,0
PALLISA,2020,7090,7230,14320,0
PALLISA,2021,7290,7440,14730,0
PALLISA,2022,7490,7630,15120,0
PALLISA,2023,7680,7830,15510,0
PALLISA,2024,7870,8010,15880,0
PALLISA,2025,8030,8170,16200,0
RAKAI,2015,5830,5660,11490,0
RAKAI,2016,5910,5730,11640,0
RAKAI,2017,5990,5790,11780,0
RAKAI,2018,6060,5850,11910,0
RAKAI,2019,6120,5910,12030,0
RAKAI,2020,6180,5950,12130,0
RAKAI,2021,6240,6000,12240,0
RAKAI,2022,6290,6040,12330,0
RAKAI,2023,6330,6070,12400,0
RAKAI,2024,6360,6080,12440,0
RAKAI,2025,6380,6090,12470,0
RUBANDA,2015,3590,3340,6930,0
RUBANDA,2016,3640,3360,7000,0
RUBANDA,2017,3690,3390,7080,0
RUBANDA,2018,3740,3420,7160,0
RUBANDA,2019,3780,3440,7220,0
RUBANDA,2020,3830,3460,7290,0
RUBANDA,2021,3870,3490,7360,0
RUBANDA,2022,3910,3500,7410,0
RUBANDA,2023,3950,3520,7470,0
RUBANDA,2024,3980,3540,7520,0
RUBANDA,2025,4020,3550,7570,0
RUBIRIZI,2015,2220,1960,4180,0
RUBIRIZI,2016,2260,2000,4260,0
RUBIRIZI,2017,2310,2040,4350,0
RUBIRIZI,2018,2360,2080,4440,0
RUBIRIZI,2019,2400,2110,4510,0
RUBIRIZI,2020,2450,2150,4600,0
RUBIRIZI,2021,2490,2190,4680,0
RUBIRIZI,2022,2530,2220,4750,0
RUBIRIZI,2023,2580,2260,4840,0
RUBIRIZI,2024,2620,2290,4910,0
RUBIRIZI,2025,2660,2320,4980,0
RUKIGA,2015,1530,1410,2940,0
RUKIGA,2016,1540,1420,2960,0
RUKIGA,2017,1560,1430,2990,0
RUKIGA,2018,1570,1440,3010,0
RUKIGA,2019,1590,1450,3040,0
RUKIGA,2020,1600,1460,3060,0
RUKIGA,2021,1620,1460,3080,0
RUKIGA,2022,1630,1470,3100,0
RUKIGA,2023,1640,1480,3120,0
RUKIGA,2024,1650,1480,3130,0
RUKIGA,2025,1650,1480,3130,0
RUKUNGIRI,2015,4810,4540,9350,0
RUKUNGIRI,2016,4860,4590,9450,0
RUKUNGIRI,2017,4920,4630,9550,0
RUKUNGIRI,2018,4980,4670,9650,0
RUKUNGIRI,2019,5040,4710,9750,0
RUKUNGIRI,2020,5090,4760,9850,0
RUKUNGIRI,2021,5140,4790,9930,0
RUKUNGIRI,2022,5190,4820,10010,0
RUKUNGIRI,2023,5230,4860,10090,0
RUKUNGIRI,2024,5270,4880,10150,0
RUKUNGIRI,2025,5310,4910,10220,0
RWAMPARA,2015,2210,1930,4140,0
RWAMPARA,2016,2260,1970,4230,0
RWAMPARA,2017,2310,2010,4320,0
RWAMPARA,2018,2360,2060,4420,0
RWAMPARA,2019,2410,2100,4510,0
RWAMPARA,2020,2460,2140,4600,0
RWAMPARA,2021,2510,2180,4690,0
RWAMPARA,2022,2560,2220,4780,0
RWAMPARA,2023,2610,2260,4870,0
RWAMPARA,2024,2660,2310,4970,0
RWAMPARA,2025,2700,2350,5050,0
SERERE,2015,5890,5790,11680,0
SERERE,2016,6060,5950,12010,0
SERERE,2017,6240,6110,12350,0
SERERE,2018,6400,6280,12680,0
SERERE,2019,6570,6440,13010,0
SERERE,2020,6730,6600,13330,0
SERERE,2021,6900,6760,13660,0
SERERE,2022,7060,6910,13970,0
SERERE,2023,7220,7060,14280,0
SERERE,2024,7350,7190,14540,0
SERERE,2025,7480,7320,14800,0
SHEEMA,2015,2790,2750,5540,0
SHEEMA,2016,2830,2780,5610,0
SHEEMA,2017,2860,2810,5670,0
SHEEMA,2018,2890,2840,5730,0
SHEEMA,2019,2930,2870,5800,0
SHEEMA,2020,2960,2890,5850,0
SHEEMA,2021,2990,2920,5910,0
SHEEMA,2022,3020,2940,5960,0
SHEEMA,2023,3040,2960,6000,0
SHEEMA,2024,3070,2980,6050,0
SHEEMA,2025,3090,3000,6090,0
SIRONKO,2015,4260,3820,8080,0
SIRONKO,2016,4360,3900,8260,0
SIRONKO,2017,4460,3980,8440,0
SIRONKO,2018,4570,4060,8630,0
SIRONKO,2019,4680,4140,8820,0
SIRONKO,2020,4780,4220,9000,0
SIRONKO,2021,4880,4290,9170,0
SIRONKO,2022,4980,4370,9350,0
SIRONKO,2023,5080,4440,9520,0
SIRONKO,2024,5180,4520,9700,0
SIRONKO,2025,5280,4590,9870,0
SOROTI,2015,6080,7240,13320,0
SOROTI,2016,6180,7310,13490,0
SOROTI,2017,6170,7390,13560,0
SOROTI,2018,6150,7490,13640,0
SOROTI,2019,6170,7510,13680,0
SOROTI,2020,6200,7690,13890,0
SOROTI,2021,6280,7960,14240,0
SOROTI,2022,6460,8210,14670,0
SOROTI,2023,6630,8590,15220,0
SOROTI,2024,6870,8920,15790,0
SOROTI,2025,7050,9220,16270,0
SSEMBABULE,2015,5180,5010,10190,0
SSEMBABULE,2016,5270,5090,10360,0
SSEMBABULE,2017,5350,5160,10510,0
SSEMBABULE,2018,5430,5230,10660,0
SSEMBABULE,2019,5510,5290,10800,0
SSEMBABULE,2020,5580,5360,10940,0
SSEMBABULE,2021,5660,5420,11080,0
SSEMBABULE,2022,5720,5480,11200,0
SSEMBABULE,2023,5780,5530,11310,0
SSEMBABULE,2024,5830,5560,11390,0
SSEMBABULE,2025,5850,5590,11440,0
TORORO,2015,10280,9430,19710,0
TORORO,2016,10560,9670,20230,0
TORORO,2017,10840,9910,20750,0
TORORO,2018,11130,10160,21290,0
TORORO,2019,11410,10400,21810,0
TORORO,2020,11700,10650,22350,0
TORORO,2021,11980,10890,22870,0
TORORO,2022,12270,11130,23400,0
TORORO,2023,12550,11380,23930,0
TORORO,2024,12820,11610,24430,0
TORORO,2025,13100,11850,24950,0
WAKISO,2015,38430,34770,73200,0
WAKISO,2016,41000,37140,78140,0
WAKISO,2017,43750,39690,83440,0
WAKISO,2018,46660,42370,89030,0
WAKISO,2019,49760,45220,94980,0
WAKISO,2020,53000,48220,101220,0
WAKISO,2021,56400,51420,107820,0
WAKISO,2022,60020,54820,114840,0
WAKISO,2023,63830,58340,122170,0
WAKISO,2024,67800,62060,129860,0
WAKISO,2025,71970,66000,137970,0
YUMBE,2015,8880,9050,17930,0
YUMBE,2016,9220,9480,18700,0
YUMBE,2017,9580,9930,19510,0
YUMBE,2018,9930,10390,20320,0
YUMBE,2019,10290,10860,21150,0
YUMBE,2020,10650,11330,21980,0
YUMBE,2021,11030,11830,22860,0
YUMBE,2022,11390,12330,23720,0
YUMBE,2023,11760,12820,24580,0
YUMBE,2024,12110,13320,25430,0
YUMBE,2025,12440,13800,26240,0
ZOMBO,2015,4940,4480,9420,0
ZOMBO,2016,5100,4610,9710,0
ZOMBO,2017,5250,4730,9980,0
ZOMBO,2018,5410,4860,10270,0
ZOMBO,2019,5570,4990,10560,0
ZOMBO,2020,5740,5130,10870,0
ZOMBO,2021,5900,5260,11160,0
ZOMBO,2022,6070,5390,11460,0
ZOMBO,2023,6230,5520,11750,0
ZOMBO,2024,6390,5660,12050,0
ZOMBO,2025,6560,5790,12350,0
ABIM,2015,1990,1890,3880,1
ABIM,2016,2080,2080,4160,1
ABIM,2017,2180,2180,4360,1
ABIM,2018,2290,2290,4580,1
ABIM,2019,2420,2400,4820,1
ABIM,2020,2530,2520,5050,1
ABIM,2021,2650,2630,5280,1
ABIM,2022,2780,2740,5520,1
ABIM,2023,2910,2870,5780,1
ABIM,2024,3040,3000,6040,1
ABIM,2025,3170,3120,6290,1
ADJUMANI,2015,4810,4200,9010,1
ADJUMANI,2016,4850,4240,9090,1
ADJUMANI,2017,4880,4280,9160,1
ADJUMANI,2018,4910,4320,9230,1
ADJUMANI,2019,4950,4360,9310,1
ADJUMANI,2020,4980,4400,9380,1
ADJUMANI,2021,5000,4430,9430,1
ADJUMANI,2022,5020,4460,9480,1
ADJUMANI,2023,5040,4490,9530,1
ADJUMANI,2024,5060,4520,9580,1
ADJUMANI,2025,5070,4540,9610,1
AGAGO,2015,4410,4170,8580,1
AGAGO,2016,4490,4250,8740,1
AGAGO,2017,4570,4320,8890,1
AGAGO,2018,4640,4400,9040,1
AGAGO,2019,4720,4470,9190,1
AGAGO,2020,4800,4540,9340,1
AGAGO,2021,4870,4610,9480,1
AGAGO,2022,4940,4680,9620,1
AGAGO,2023,5010,4750,9760,1
AGAGO,2024,5080,4810,9890,1
AGAGO,2025,5140,4880,10020,1
ALEBTONG,2015,4260,4010,8270,1
ALEBTONG,2016,4300,4250,8550,1
ALEBTONG,2017,4360,4320,8680,1
ALEBTONG,2018,4430,4390,8820,1
ALEBTONG,2019,4490,4450,8940,1
ALEBTONG,2020,4560,4510,9070,1
ALEBTONG,2021,4610,4570,9180,1
ALEBTONG,2022,4670,4630,9300,1
ALEBTONG,2023,4720,4680,9400,1
ALEBTONG,2024,4770,4720,9490,1
ALEBTONG,2025,4790,4750,9540,1
AMOLATAR,2015,2740,2580,5320,1
AMOLATAR,2016,2760,2730,5490,1
AMOLATAR,2017,2800,2770,5570,1
AMOLATAR,2018,2830,2810,5640,1
AMOLATAR,2019,2870,2840,5710,1
AMOLATAR,2020,2900,2870,5770,1
AMOLATAR,2021,2930,2890,5820,1
AMOLATAR,2022,2960,2930,5890,1
AMOLATAR,2023,2990,2950,5940,1
AMOLATAR,2024,3020,2980,6000,1
AMOLATAR,2025,3030,2980,6010,1
AMUDAT,2015,1360,1450,2810,1
AMUDAT,2016,1390,1570,2960,1
AMUDAT,2017,1420,1630,3050,1
AMUDAT,2018,1470,1680,3150,1
AMUDAT,2019,1500,1740,3240,1
AMUDAT,2020,1540,1800,3340,1
AMUDAT,2021,1580,1850,3430,1
AMUDAT,2022,1610,1910,3520,1
AMUDAT,2023,1650,1980,3630,1
AMUDAT,2024,1680,2030,3710,1
AMUDAT,2025,1720,2080,3800,1
AMURIA,2015,4010,3650,7660,1
AMURIA,2016,4080,3910,7990,1
AMURIA,2017,4180,4010,8190,1
AMURIA,2018,4280,4100,8380,1
AMURIA,2019,4390,4200,8590,1
AMURIA,2020,4480,4280,8760,1
AMURIA,2021,4590,4370,8960,1
AMURIA,2022,4690,4460,9150,1
AMURIA,2023,4780,4540,9320,1
AMURIA,2024,4870,4610,9480,1
AMURIA,2025,4940,4680,9620,1
AMURU,2015,4080,3810,7890,1
AMURU,2016,4110,4040,8150,1
AMURU,2017,4170,4100,8270,1
AMURU,2018,4220,4170,8390,1
AMURU,2019,4280,4220,8500,1
AMURU,2020,4330,4280,8610,1
AMURU,2021,4370,4330,8700,1
AMURU,2022,4420,4380,8800,1
AMURU,2023,4460,4420,8880,1
AMURU,2024,4490,4460,8950,1
AMURU,2025,4510,4480,8990,1
APAC,2015,2980,2840,5820,1
APAC,2016,3090,2940,6030,1
APAC,2017,3210,3050,6260,1
APAC,2018,3320,3150,6470,1
APAC,2019,3440,3250,6690,1
APAC,2020,3560,3360,6920,1
APAC,2021,3680,3470,7150,1
APAC,2022,3810,3580,7390,1
APAC,2023,3930,3700,7630,1
APAC,2024,4060,3810,7870,1
APAC,2025,4190,3920,8110,1
ARUA,2015,10910,10060,20970,1
ARUA,2016,11230,10330,21560,1
ARUA,2017,11540,10620,22160,1
ARUA,2018,11880,10900,22780,1
ARUA,2019,12210,11190,23400,1
ARUA,2020,12540,11470,24010,1
ARUA,2021,12880,11760,24640,1
ARUA,2022,13210,12040,25250,1
ARUA,2023,13540,12340,25880,1
ARUA,2024,13880,12620,26500,1
ARUA,2025,14210,12900,27110,1
BUDAKA,2015,4570,4310,8880,1
BUDAKA,2016,4640,4610,9250,1
BUDAKA,2017,4750,4720,9470,1
BUDAKA,2018,4870,4820,9690,1
BUDAKA,2019,4970,4920,9890,1
BUDAKA,2020,5070,5030,10100,1
BUDAKA,2021,5180,5120,10300,1
BUDAKA,2022,5280,5220,10500,1
BUDAKA,2023,5380,5320,10700,1
BUDAKA,2024,5470,5400,10870,1
BUDAKA,2025,5560,5480,11040,1
BUDUDA,2015,3620,3350,6970,1
BUDUDA,2016,3710,3620,7330,1
BUDUDA,2017,3830,3740,7570,1
BUDUDA,2018,3960,3870,7830,1
BUDUDA,2019,4080,3990,8070,1
BUDUDA,2020,4210,4120,8330,1
BUDUDA,2021,4330,4240,8570,1
BUDUDA,2022,4460,4360,8820,1
BUDUDA,2023,4590,4490,9080,1
BUDUDA,2024,4700,4600,9300,1
BUDUDA,2025,4810,4720,9530,1
BUGIRI,2015,8670,7920,16590,1
BUGIRI,2016,8840,8510,17350,1
BUGIRI,2017,9100,8750,17850,1
BUGIRI,2018,9360,8990,18350,1
BUGIRI,2019,9620,9230,18850,1
BUGIRI,2020,9870,9460,19330,1
BUGIRI,2021,10120,9690,19810,1
BUGIRI,2022,10380,9920,20300,1
BUGIRI,2023,10620,10150,20770,1
BUGIRI,2024,10850,10370,21220,1
BUGIRI,2025,11060,10560,21620,1
BUGWERI,2015,3370,3170,6540,1
BUGWERI,2016,3400,3370,6770,1
BUGWERI,2017,3450,3410,6860,1
BUGWERI,2018,3500,3460,6960,1
BUGWERI,2019,3560,3500,7060,1
BUGWERI,2020,3600,3550,7150,1
BUGWERI,2021,3640,3580,7220,1
BUGWERI,2022,3680,3630,7310,1
BUGWERI,2023,3720,3670,7390,1
BUGWERI,2024,3750,3690,7440,1
BUGWERI,2025,3770,3720,7490,1
BUHWEJU,2015,2140,2050,4190,1
BUHWEJU,2016,2210,2110,4320,1
BUHWEJU,2017,2280,2180,4460,1
BUHWEJU,2018,2350,2240,4590,1
BUHWEJU,2019,2420,2310,4730,1
BUHWEJU,2020,2500,2380,4880,1
BUHWEJU,2021,2580,2450,5030,1
BUHWEJU,2022,2650,2510,5160,1
BUHWEJU,2023,2730,2580,5310,1
BUHWEJU,2024,2800,2650,5450,1
BUHWEJU,2025,2880,2720,5600,1
BUIKWE,2015,7400,6750,14150,1
BUIKWE,2016,7410,7120,14530,1
BUIKWE,2017,7460,7180,14640,1
BUIKWE,2018,7520,7250,14770,1
BUIKWE,2019,7570,7300,14870,1
BUIKWE,2020,7620,7360,14980,1
BUIKWE,2021,7650,7400,15050,1
BUIKWE,2022,7690,7450,15140,1
BUIKWE,2023,7710,7470,15180,1
BUIKWE,2024,7730,7500,15230,1
BUIKWE,2025,7720,7500,15220,1
BUKEDEA,2015,4490,4170,8660,1
BUKEDEA,2016,4580,4480,9060,1
BUKEDEA,2017,4740,4620,9360,1
BUKEDEA,2018,4890,4760,9650,1
BUKEDEA,2019,5040,4890,9930,1
BUKEDEA,2020,5180,5030,10210,1
BUKEDEA,2021,5330,5160,10490,1
BUKEDEA,2022,5490,5300,10790,1
BUKEDEA,2023,5640,5420,11060,1
BUKEDEA,2024,5770,5560,11330,1
BUKEDEA,2025,5900,5670,11570,1
BUKOMANSIMBI,2015,2780,2500,5280,1
BUKOMANSIMBI,2016,2750,2590,5340,1
BUKOMANSIMBI,2017,2730,2580,5310,1
BUKOMANSIMBI,2018,2720,2560,5280,1
BUKOMANSIMBI,2019,2710,2550,5260,1
BUKOMANSIMBI,2020,2690,2530,5220,1
BUKOMANSIMBI,2021,2670,2500,5170,1
BUKOMANSIMBI,2022,2660,2480,5140,1
BUKOMANSIMBI,2023,2630,2450,5080,1
BUKOMANSIMBI,2024,2600,2420,5020,1
BUKOMANSIMBI,2025,2570,2380,4950,1
BUKWO,2015,1740,1590,3330,1
BUKWO,2016,1840,1670,3510,1
BUKWO,2017,1940,1750,3690,1
BUKWO,2018,2040,1840,3880,1
BUKWO,2019,2140,1930,4070,1
BUKWO,2020,2260,2020,4280,1
BUKWO,2021,2370,2110,4480,1
BUKWO,2022,2490,2210,4700,1
BUKWO,2023,2620,2310,4930,1
BUKWO,2024,2740,2410,5150,1
BUKWO,2025,2880,2520,5400,1
BULAMBULI,2015,2770,2770,5540,1
BULAMBULI,2016,2850,3010,5860,1
BULAMBULI,2017,2960,3130,6090,1
BULAMBULI,2018,3070,3240,6310,1
BULAMBULI,2019,3180,3360,6540,1
BULAMBULI,2020,3290,3480,6770,1
BULAMBULI,2021,3400,3600,7000,1
BULAMBULI,2022,3520,3720,7240,1
BULAMBULI,2023,3620,3850,7470,1
BULAMBULI,2024,3730,3970,7700,1
BULAMBULI,2025,3840,4080,7920,1
BULIISA,2015,2360,2080,4440,1
BULIISA,2016,2490,2170,4660,1
BULIISA,2017,2620,2270,4890,1
BULIISA,2018,2760,2370,5130,1
BULIISA,2019,2910,2470,5380,1
BULIISA,2020,3060,2580,5640,1
BULIISA,2021,3220,2690,5910,1
BULIISA,2022,3380,2800,6180,1
BULIISA,2023,3560,2920,6480,1
BULIISA,2024,3730,3030,6760,1
BULIISA,2025,3910,3150,7060,1
BUNDIBUGYO,2015,4550,4350,8900,1
BUNDIBUGYO,2016,4600,4620,9220,1
BUNDIBUGYO,2017,4680,4690,9370,1
BUNDIBUGYO,2018,4760,4770,9530,1
BUNDIBUGYO,2019,4840,4840,9680,1
BUNDIBUGYO,2020,4910,4910,9820,1
BUNDIBUGYO,2021,4980,4970,9950,1
BUNDIBUGYO,2022,5060,5030,10090,1
BUNDIBUGYO,2023,5120,5090,10210,1
BUNDIBUGYO,2024,5180,5130,10310,1
BUNDIBUGYO,2025,5220,5180,10400,1
BUNYANGABU,2015,3300,3090,6390,1
BUNYANGABU,2016,3310,3280,6590,1
BUNYANGABU,2017,3360,3310,6670,1
BUNYANGABU,2018,3400,3340,6740,1
BUNYANGABU,2019,3440,3380,6820,1
BUNYANGABU,2020,3480,3410,6890,1
BUNYANGABU,2021,3510,3440,6950,1
BUNYANGABU,2022,3540,3470,7010,1
BUNYANGABU,2023,3570,3490,7060,1
BUNYANGABU,2024,3600,3500,7100,1
BUNYANGABU,2025,3620,3510,7130,1
BUSHENYI,2015,3470,3030,6500,1
BUSHENYI,2016,3520,3060,6580,1
BUSHENYI,2017,3560,3090,6650,1
BUSHENYI,2018,3600,3120,6720,1
BUSHENYI,2019,3650,3140,6790,1
BUSHENYI,2020,3690,3160,6850,1
BUSHENYI,2021,3720,3190,6910,1
BUSHENYI,2022,3760,3210,6970,1
BUSHENYI,2023,3790,3220,7010,1
BUSHENYI,2024,3820,3240,7060,1
BUSHENYI,2025,3850,3250,7100,1
BUSIA,2015,6370,6300,12670,1
BUSIA,2016,6510,6310,12820,1
BUSIA,2017,6640,6410,13050,1
BUSIA,2018,6820,6440,13260,1
BUSIA,2019,7040,6660,13700,1
BUSIA,2020,7220,6750,13970,1
BUSIA,2021,7460,6960,14420,1
BUSIA,2022,7660,7100,14760,1
BUSIA,2023,7930,7250,15180,1
BUSIA,2024,8230,7340,15570,1
BUSIA,2025,8310,7370,15680,1
BUTALEJA,2015,5810,5300,11110,1
BUTALEJA,2016,5900,5690,11590,1
BUTALEJA,2017,6050,5820,11870,1
BUTALEJA,2018,6200,5960,12160,1
BUTALEJA,2019,6360,6100,12460,1
BUTALEJA,2020,6500,6230,12730,1
BUTALEJA,2021,6640,6360,13000,1
BUTALEJA,2022,6790,6500,13290,1
BUTALEJA,2023,6930,6620,13550,1
BUTALEJA,2024,7060,6740,13800,1
BUTALEJA,2025,7170,6840,14010,1
BUTAMBALA,2015,1860,1610,3470,1
BUTAMBALA,2016,1850,1670,3520,1
BUTAMBALA,2017,1850,1680,3530,1
BUTAMBALA,2018,1850,1670,3520,1
BUTAMBALA,2019,1850,1670,3520,1
BUTAMBALA,2020,1850,1670,3520,1
BUTAMBALA,2021,1850,1660,3510,1
BUTAMBALA,2022,1850,1650,3500,1
BUTAMBALA,2023,1840,1640,3480,1
BUTAMBALA,2024,1830,1630,3460,1
BUTAMBALA,2025,1820,1610,3430,1
BUTEBO,2015,2450,2340,4790,1
BUTEBO,2016,2430,2460,4890,1
BUTEBO,2017,2440,2450,4890,1
BUTEBO,2018,2450,2460,4910,1
BUTEBO,2019,2450,2470,4920,1
BUTEBO,2020,2460,2460,4920,1
BUTEBO,2021,2460,2460,4920,1
BUTEBO,2022,2460,2460,4920,1
BUTEBO,2023,2450,2460,4910,1
BUTEBO,2024,2440,2450,4890,1
BUTEBO,2025,2430,2430,4860,1
BUVUMA,2015,1970,1800,3770,1
BUVUMA,2016,2090,1920,4010,1
BUVUMA,2017,2220,2050,4270,1
BUVUMA,2018,2360,2190,4550,1
BUVUMA,2019,2500,2340,4840,1
BUVUMA,2020,2650,2490,5140,1
BUVUMA,2021,2810,2650,5460,1
BUVUMA,2022,2970,2820,5790,1
BUVUMA,2023,3150,3000,6150,1
BUVUMA,2024,3330,3200,6530,1
BUVUMA,2025,3510,3400,6910,1
BUYENDE,2015,7970,7450,15420,1
BUYENDE,2016,8160,8030,16190,1
BUYENDE,2017,8420,8290,16710,1
BUYENDE,2018,8700,8550,17250,1
BUYENDE,2019,8970,8810,17780,1
BUYENDE,2020,9230,9070,18300,1
BUYENDE,2021,9510,9340,18850,1
BUYENDE,2022,9780,9610,19390,1
BUYENDE,2023,10050,9860,19910,1
BUYENDE,2024,10310,10110,20420,1
BUYENDE,2025,10550,10340,20890,1
DOKOLO,2015,3120,2900,6020,1
DOKOLO,2016,3220,2980,6200,1
DOKOLO,2017,3310,3060,6370,1
DOKOLO,2018,3410,3140,6550,1
DOKOLO,2019,3520,3230,6750,1
DOKOLO,2020,3610,3310,6920,1
DOKOLO,2021,3720,3400,7120,1
DOKOLO,2022,3820,3480,7300,1
DOKOLO,2023,3920,3570,7490,1
DOKOLO,2024,4030,3650,7680,1
DOKOLO,2025,4130,3730,7860,1
GOMBA,2015,3200,2720,5920,1
GOMBA,2016,3180,2840,6020,1
GOMBA,2017,3210,2850,6060,1
GOMBA,2018,3220,2850,6070,1
GOMBA,2019,3230,2840,6070,1
GOMBA,2020,3250,2840,6090,1
GOMBA,2021,3250,2840,6090,1
GOMBA,2022,3260,2830,6090,1
GOMBA,2023,3250,2830,6080,1
GOMBA,2024,3250,2800,6050,1
GOMBA,2025,3240,2780,6020,1
GULU,2015,4560,4040,8600,1
GULU,2016,4700,4160,8860,1
GULU,2017,4850,4280,9130,1
GULU,2018,4990,4400,9390,1
GULU,2019,5130,4520,9650,1
GULU,2020,5280,4650,9930,1
GULU,2021,5430,4780,10210,1
GULU,2022,5580,4900,10480,1
GULU,2023,5720,5030,10750,1
GULU,2024,5870,5160,11030,1
GULU,2025,6020,5280,11300,1
HOIMA,2015,5710,5270,10980,1
HOIMA,2016,5930,5450,11380,1
HOIMA,2017,6150,5640,11790,1
HOIMA,2018,6380,5840,12220,1
HOIMA,2019,6610,6030,12640,1
HOIMA,2020,6850,6240,13090,1
HOIMA,2021,7090,6440,13530,1
HOIMA,2022,7340,6640,13980,1
HOIMA,2023,7590,6850,14440,1
HOIMA,2024,7840,7060,14900,1
HOIMA,2025,8090,7270,15360,1
IBANDA,2015,4030,3580,7610,1
IBANDA,2016,4110,3640,7750,1
IBANDA,2017,4190,3700,7890,1
IBANDA,2018,4270,3770,8040,1
IBANDA,2019,4350,3840,8190,1
IBANDA,2020,4430,3900,8330,1
IBANDA,2021,4510,3960,8470,1
IBANDA,2022,4580,4020,8600,1
IBANDA,2023,4660,4080,8740,1
IBANDA,2024,4730,4140,8870,1
IBANDA,2025,4800,4190,8990,1
IGANGA,2015,6550,5880,12430,1
IGANGA,2016,6630,6260,12890,1
IGANGA,2017,6740,6360,13100,1
IGANGA,2018,6880,6470,13350,1
IGANGA,2019,7000,6590,13590,1
IGANGA,2020,7120,6690,13810,1
IGANGA,2021,7230,6780,14010,1
IGANGA,2022,7350,6870,14220,1
IGANGA,2023,7450,6970,14420,1
IGANGA,2024,7550,7040,14590,1
IGANGA,2025,7620,7100,14720,1
ISINGIRO,2015,8900,8330,17230,1
ISINGIRO,2016,9240,8620,17860,1
ISINGIRO,2017,9580,8930,18510,1
ISINGIRO,2018,9940,9240,19180,1
ISINGIRO,2019,10300,9550,19850,1
ISINGIRO,2020,10670,9880,20550,1
ISINGIRO,2021,11040,10200,21240,1
ISINGIRO,2022,11420,10540,21960,1
ISINGIRO,2023,11810,10870,22680,1
ISINGIRO,2024,12190,11210,23400,1
ISINGIRO,2025,12580,11550,24130,1
JINJA,2015,7630,7010,14640,1
JINJA,2016,7760,7120,14880,1
JINJA,2017,7890,7220,15110,1
JINJA,2018,8020,7330,15350,1
JINJA,2019,8150,7440,15590,1
JINJA,2020,8270,7540,15810,1
JINJA,2021,8400,7640,16040,1
JINJA,2022,8510,7740,16250,1
JINJA,2023,8620,7830,16450,1
JINJA,2024,8730,7920,16650,1
JINJA,2025,8830,8010,16840,1
KAABONG,2015,1310,1050,2360,1
KAABONG,2016,1350,1080,2430,1
KAABONG,2017,1390,1100,2490,1
KAABONG,2018,1420,1130,2550,1
KAABONG,2019,1460,1150,2610,1
KAABONG,2020,1490,1180,2670,1
KAABONG,2021,1540,1210,2750,1
KAABONG,2022,1570,1230,2800,1
KAABONG,2023,1610,1260,2870,1
KAABONG,2024,1640,1280,2920,1
KAABONG,2025,1680,1310,2990,1
KABALE,2015,3320,3160,6480,1
KABALE,2016,3380,3200,6580,1
KABALE,2017,3430,3240,6670,1
KABALE,2018,3480,3270,6750,1
KABALE,2019,3530,3310,6840,1
KABALE,2020,3580,3350,6930,1
KABALE,2021,3630,3380,7010,1
KABALE,2022,3670,3410,7080,1
KABALE,2023,3720,3440,7160,1
KABALE,2024,3760,3470,7230,1
KABALE,2025,3800,3490,7290,1
KABAROLE,2015,4870,4460,9330,1
KABAROLE,2016,4980,4560,9540,1
KABAROLE,2017,5090,4660,9750,1
KABAROLE,2018,5200,4760,9960,1
KABAROLE,2019,5310,4860,10170,1
KABAROLE,2020,5410,4960,10370,1
KABAROLE,2021,5520,5050,10570,1
KABAROLE,2022,5630,5150,10780,1
KABAROLE,2023,5730,5240,10970,1
KABAROLE,2024,5830,5330,11160,1
KABAROLE,2025,5930,5430,11360,1
KABERAMAIDO,2015,2240,2080,4320,1
KABERAMAIDO,2016,2290,2240,4530,1
KABERAMAIDO,2017,2350,2300,4650,1
KABERAMAIDO,2018,2430,2370,4800,1
KABERAMAIDO,2019,2500,2430,4930,1
KABERAMAIDO,2020,2570,2490,5060,1
KABERAMAIDO,2021,2630,2550,5180,1
KABERAMAIDO,2022,2710,2620,5330,1
KABERAMAIDO,2023,2770,2680,5450,1
KABERAMAIDO,2024,2850,2740,5590,1
KABERAMAIDO,2025,2900,2790,5690,1
KAGADI,2015,7500,7290,14790,1
KAGADI,2016,7780,7540,15320,1
KAGADI,2017,8070,7810,15880,1
KAGADI,2018,8370,8090,16460,1
KAGADI,2019,8670,8360,17030,1
KAGADI,2020,8980,8650,17630,1
KAGADI,2021,9290,8940,18230,1
KAGADI,2022,9610,9230,18840,1
KAGADI,2023,9930,9520,19450,1
KAGADI,2024,10250,9820,20070,1
KAGADI,2025,10580,10120,20700,1
KAKUMIRO,2015,6740,6350,13090,1
KAKUMIRO,2016,7340,6890,14230,1
KAKUMIRO,2017,7990,7470,15460,1
KAKUMIRO,2018,8700,8090,16790,1
KAKUMIRO,2019,9460,8770,18230,1
KAKUMIRO,2020,10280,9490,19770,1
KAKUMIRO,2021,11160,10270,21430,1
KAKUMIRO,2022,12110,11100,23210,1
KAKUMIRO,2023,13140,12000,25140,1
KAKUMIRO,2024,14240,12960,27200,1
KAKUMIRO,2025,15420,13980,29400,1
KALAKI,2015,2090,1920,4010,1
KALAKI,2016,2180,2000,4180,1
KALAKI,2017,2280,2080,4360,1
KALAKI,2018,2380,2160,4540,1
KALAKI,2019,2470,2240,4710,1
KALAKI,2020,2580,2330,4910,1
KALAKI,2021,2690,2410,5100,1
KALAKI,2022,2790,2500,5290,1
KALAKI,2023,2900,2600,5500,1
KALAKI,2024,3010,2690,5700,1
KALAKI,2025,3130,2780,5910,1
KALANGALA,2015,1030,920,1950,1
KALANGALA,2016,1070,960,2030,1
KALANGALA,2017,1100,1000,2100,1
KALANGALA,2018,1140,1040,2180,1
KALANGALA,2019,1180,1080,2260,1
KALANGALA,2020,1220,1130,2350,1
KALANGALA,2021,1260,1170,2430,1
KALANGALA,2022,1300,1220,2520,1
KALANGALA,2023,1340,1260,2600,1
KALANGALA,2024,1380,1310,2690,1
KALANGALA,2025,1430,1360,2790,1
KALIRO,2015,4900,4750,9650,1
KALIRO,2016,4970,5100,10070,1
KALIRO,2017,5090,5210,10300,1
KALIRO,2018,5210,5340,10550,1
KALIRO,2019,5330,5450,10780,1
KALIRO,2020,5440,5560,11000,1
KALIRO,2021,5540,5680,11220,1
KALIRO,2022,5660,5800,11460,1
KALIRO,2023,5760,5910,11670,1
KALIRO,2024,5860,6000,11860,1
KALIRO,2025,5940,6090,12030,1
KALUNGU,2015,3300,2870,6170,1
KALUNGU,2016,3270,2990,6260,1
KALUNGU,2017,3270,2990,6260,1
KALUNGU,2018,3260,2990,6250,1
KALUNGU,2019,3260,2990,6250,1
KALUNGU,2020,3250,2970,6220,1
KALUNGU,2021,3230,2960,6190,1
KALUNGU,2022,3220,2950,6170,1
KALUNGU,2023,3200,2920,6120,1
KALUNGU,2024,3170,2900,6070,1
KALUNGU,2025,3140,2870,6010,1
KAMPALA,2015,22580,20150,42730,1
KAMPALA,2016,23030,20540,43570,1
KAMPALA,2017,23480,20940,44420,1
KAMPALA,2018,23940,21340,45280,1
KAMPALA,2019,24390,21740,46130,1
KAMPALA,2020,24830,22130,46960,1
KAMPALA,2021,25270,22510,47780,1
KAMPALA,2022,25690,22890,48580,1
KAMPALA,2023,26100,23250,49350,1
KAMPALA,2024,26500,23610,50110,1
KAMPALA,2025,26880,23960,50840,1
KAMULI,2015,9640,9160,18800,1
KAMULI,2016,9690,9680,19370,1
KAMULI,2017,9840,9790,19630,1
KAMULI,2018,9970,9900,19870,1
KAMULI,2019,10100,10010,20110,1
KAMULI,2020,10210,10110,20320,1
KAMULI,2021,10320,10190,20510,1
KAMULI,2022,10430,10280,20710,1
KAMULI,2023,10520,10340,20860,1
KAMULI,2024,10590,10400,20990,1
KAMULI,2025,10650,10420,21070,1
KAMWENGE,2015,5410,5080,10490,1
KAMWENGE,2016,5630,5260,10890,1
KAMWENGE,2017,5860,5450,11310,1
KAMWENGE,2018,6100,5640,11740,1
KAMWENGE,2019,6340,5840,12180,1
KAMWENGE,2020,6580,6030,12610,1
KAMWENGE,2021,6840,6230,13070,1
KAMWENGE,2022,7100,6440,13540,1
KAMWENGE,2023,7350,6650,14000,1
KAMWENGE,2024,7630,6860,14490,1
KAMWENGE,2025,7900,7070,14970,1
KANUNGU,2015,4030,3670,7700,1
KANUNGU,2016,4100,3730,7830,1
KANUNGU,2017,4180,3790,7970,1
KANUNGU,2018,4250,3850,8100,1
KANUNGU,2019,4320,3910,8230,1
KANUNGU,2020,4390,3960,8350,1
KANUNGU,2021,4460,4020,8480,1
KANUNGU,2022,4530,4070,8600,1
KANUNGU,2023,4600,4130,8730,1
KANUNGU,2024,4660,4180,8840,1
KANUNGU,2025,4720,4230,8950,1
KAPCHORWA,2015,1590,1440,3030,1
KAPCHORWA,2016,1630,1480,3110,1
KAPCHORWA,2017,1680,1520,3200,1
KAPCHORWA,2018,1740,1560,3300,1
KAPCHORWA,2019,1790,1610,3400,1
KAPCHORWA,2020,1840,1650,3490,1
KAPCHORWA,2021,1890,1690,3580,1
KAPCHORWA,2022,1940,1740,3680,1
KAPCHORWA,2023,1990,1780,3770,1
KAPCHORWA,2024,2050,1820,3870,1
KAPCHORWA,2025,2100,1860,3960,1
KAPELEBYONG,2015,2010,1770,3780,1
KAPELEBYONG,2016,2030,1890,3920,1
KAPELEBYONG,2017,2070,1910,3980,1
KAPELEBYONG,2018,2100,1950,4050,1
KAPELEBYONG,2019,2150,1970,4120,1
KAPELEBYONG,2020,2190,2000,4190,1
KAPELEBYONG,2021,2220,2030,4250,1
KAPELEBYONG,2022,2260,2050,4310,1
KAPELEBYONG,2023,2290,2080,4370,1
KAPELEBYONG,2024,2320,2100,4420,1
KAPELEBYONG,2025,2350,2110,4460,1
KASESE,2015,14050,13070,27120,1
KASESE,2016,14100,13820,27920,1
KASESE,2017,14280,13970,28250,1
KASESE,2018,14450,14120,28570,1
KASESE,2019,14620,14270,28890,1
KASESE,2020,14750,14390,29140,1
KASESE,2021,14890,14500,29390,1
KASESE,2022,15020,14620,29640,1
KASESE,2023,15140,14700,29840,1
KASESE,2024,15220,14770,29990,1
KASESE,2025,15270,14800,30070,1
KASSANDA,2015,5060,4480,9540,1
KASSANDA,2016,5200,4580,9780,1
KASSANDA,2017,5350,4680,10030,1
KASSANDA,2018,5500,4780,10280,1
KASSANDA,2019,5650,4880,10530,1
KASSANDA,2020,5810,4980,10790,1
KASSANDA,2021,5960,5070,11030,1
KASSANDA,2022,6110,5170,11280,1
KASSANDA,2023,6260,5260,11520,1
KASSANDA,2024,6420,5350,11770,1
KASSANDA,2025,6560,5440,12000,1
KATAKWI,2015,3190,2810,6000,1
KATAKWI,2016,3220,2970,6190,1
KATAKWI,2017,3270,3020,6290,1
KATAKWI,2018,3330,3050,6380,1
KATAKWI,2019,3380,3100,6480,1
KATAKWI,2020,3440,3140,6580,1
KATAKWI,2021,3480,3160,6640,1
KATAKWI,2022,3530,3200,6730,1
KATAKWI,2023,3580,3240,6820,1
KATAKWI,2024,3610,3260,6870,1
KATAKWI,2025,3650,3280,6930,1
KAYUNGA,2015,6730,6300,13030,1
KAYUNGA,2016,6720,6610,13330,1
KAYUNGA,2017,6780,6650,13430,1
KAYUNGA,2018,6830,6680,13510,1
KAYUNGA,2019,6860,6710,13570,1
KAYUNGA,2020,6900,6740,13640,1
KAYUNGA,2021,6930,6750,13680,1
KAYUNGA,2022,6960,6770,13730,1
KAYUNGA,2023,6970,6770,13740,1
KAYUNGA,2024,6980,6760,13740,1
KAYUNGA,2025,6970,6740,13710,1
KAZO,2015,3100,2920,6020,1
KAZO,2016,3220,3020,6240,1
KAZO,2017,3350,3130,6480,1
KAZO,2018,3470,3240,6710,1
KAZO,2019,3600,3350,6950,1
KAZO,2020,3720,3470,7190,1
KAZO,2021,3860,3580,7440,1
KAZO,2022,3990,3700,7690,1
KAZO,2023,4130,3820,7950,1
KAZO,2024,4270,3940,8210,1
KAZO,2025,4410,4060,8470,1
KIBAALE,2015,3340,3070,6410,1
KIBAALE,2016,3550,3250,6800,1
KIBAALE,2017,3780,3440,7220,1
KIBAALE,2018,4020,3630,7650,1
KIBAALE,2019,4270,3840,8110,1
KIBAALE,2020,4540,4060,8600,1
KIBAALE,2021,4810,4290,9100,1
KIBAALE,2022,5110,4520,9630,1
KIBAALE,2023,5410,4770,10180,1
KIBAALE,2024,5730,5030,10760,1
KIBAALE,2025,6060,5290,11350,1
KIBOGA,2015,2830,2800,5630,1
KIBOGA,2016,2840,2960,5800,1
KIBOGA,2017,2890,2990,5880,1
KIBOGA,2018,2930,3030,5960,1
KIBOGA,2019,2960,3070,6030,1
KIBOGA,2020,3000,3100,6100,1
KIBOGA,2021,3030,3130,6160,1
KIBOGA,2022,3070,3160,6230,1
KIBOGA,2023,3100,3180,6280,1
KIBOGA,2024,3130,3200,6330,1
KIBOGA,2025,3140,3220,6360,1
KIBUKU,2015,4500,4550,9050,1
KIBUKU,2016,4570,4880,9450,1
KIBUKU,2017,4710,5010,9720,1
KIBUKU,2018,4820,5130,9950,1
KIBUKU,2019,4950,5260,10210,1
KIBUKU,2020,5060,5390,10450,1
KIBUKU,2021,5180,5500,10680,1
KIBUKU,2022,5300,5630,10930,1
KIBUKU,2023,5420,5750,11170,1
KIBUKU,2024,5520,5860,11380,1
KIBUKU,2025,5620,5960,11580,1
KIKUUBE,2015,5740,5250,10990,1
KIKUUBE,2016,6050,5520,11570,1
KIKUUBE,2017,6380,5800,12180,1
KIKUUBE,2018,6720,6090,12810,1
KIKUUBE,2019,7070,6400,13470,1
KIKUUBE,2020,7430,6720,14150,1
KIKUUBE,2021,7810,7040,14850,1
KIKUUBE,2022,8210,7380,15590,1
KIKUUBE,2023,8620,7730,16350,1
KIKUUBE,2024,9040,8100,17140,1
KIKUUBE,2025,9470,8470,17940,1
KIRUHURA,2015,2680,2410,5090,1
KIRUHURA,2016,2780,2500,5280,1
KIRUHURA,2017,2880,2590,5470,1
KIRUHURA,2018,2990,2670,5660,1
KIRUHURA,2019,3100,2770,5870,1
KIRUHURA,2020,3220,2860,6080,1
KIRUHURA,2021,3330,2960,6290,1
KIRUHURA,2022,3450,3060,6510,1
KIRUHURA,2023,3570,3150,6720,1
KIRUHURA,2024,3680,3250,6930,1
KIRUHURA,2025,3800,3350,7150,1
KIRYANDONGO,2015,5960,5260,11220,1
KIRYANDONGO,2016,6020,5580,11600,1
KIRYANDONGO,2017,6130,5670,11800,1
KIRYANDONGO,2018,6240,5770,12010,1
KIRYANDONGO,2019,6350,5850,12200,1
KIRYANDONGO,2020,6450,5930,12380,1
KIRYANDONGO,2021,6540,6010,12550,1
KIRYANDONGO,2022,6640,6080,12720,1
KIRYANDONGO,2023,6730,6160,12890,1
KIRYANDONGO,2024,6810,6210,13020,1
KIRYANDONGO,2025,6870,6260,13130,1
KISORO,2015,5440,5100,10540,1
KISORO,2016,5430,5370,10800,1
KISORO,2017,5480,5410,10890,1
KISORO,2018,5510,5470,10980,1
KISORO,2019,5540,5510,11050,1
KISORO,2020,5580,5540,11120,1
KISORO,2021,5600,5570,11170,1
KISORO,2022,5630,5610,11240,1
KISORO,2023,5650,5630,11280,1
KISORO,2024,5650,5640,11290,1
KISORO,2025,5650,5650,11300,1
KITAGWENDA,2015,2570,2240,4810,1
KITAGWENDA,2016,2680,2320,5000,1
KITAGWENDA,2017,2790,2410,5200,1
KITAGWENDA,2018,2900,2490,5390,1
KITAGWENDA,2019,3010,2580,5590,1
KITAGWENDA,2020,3140,2670,5810,1
KITAGWENDA,2021,3250,2760,6010,1
KITAGWENDA,2022,3370,2850,6220,1
KITAGWENDA,2023,3500,2940,6440,1
KITAGWENDA,2024,3620,3030,6650,1
KITAGWENDA,2025,3750,3130,6880,1
KITGUM,2015,3880,3630,7510,1
KITGUM,2016,3860,3810,7670,1
KITGUM,2017,3870,3830,7700,1
KITGUM,2018,3890,3840,7730,1
KITGUM,2019,3900,3860,7760,1
KITGUM,2020,3910,3870,7780,1
KITGUM,2021,3910,3870,7780,1
KITGUM,2022,3920,3880,7800,1
KITGUM,2023,3910,3880,7790,1
KITGUM,2024,3900,3880,7780,1
KITGUM,2025,3890,3860,7750,1
KOBOKO,2015,4170,3830,8000,1
KOBOKO,2016,4250,4110,8360,1
KOBOKO,2017,4370,4220,8590,1
KOBOKO,2018,4490,4330,8820,1
KOBOKO,2019,4610,4440,9050,1
KOBOKO,2020,4730,4550,9280,1
KOBOKO,2021,4840,4660,9500,1
KOBOKO,2022,4970,4770,9740,1
KOBOKO,2023,5070,4880,9950,1
KOBOKO,2024,5180,4980,10160,1
KOBOKO,2025,5270,5070,10340,1
KOLE,2015,4240,3880,8120,1
KOLE,2016,4380,4000,8380,1
KOLE,2017,4520,4110,8630,1
KOLE,2018,4670,4230,8900,1
KOLE,2019,4820,4340,9160,1
KOLE,2020,4970,4460,9430,1
KOLE,2021,5120,4580,9700,1
KOLE,2022,5270,4700,9970,1
KOLE,2023,5420,4820,10240,1
KOLE,2024,5580,4940,10520,1
KOLE,2025,5730,5060,10790,1
KOTIDO,2015,2850,2730,5580,1
KOTIDO,2016,2850,2890,5740,1
KOTIDO,2017,2890,2920,5810,1
KOTIDO,2018,2930,2950,5880,1
KOTIDO,2019,2960,2970,5930,1
KOTIDO,2020,2990,3010,6000,1
KOTIDO,2021,3020,3020,6040,1
KOTIDO,2022,3040,3050,6090,1
KOTIDO,2023,3070,3070,6140,1
KOTIDO,2024,3090,3080,6170,1
KOTIDO,2025,3090,3090,6180,1
KUMI,2015,4720,4310,9030,1
KUMI,2016,4780,4580,9360,1
KUMI,2017,4880,4670,9550,1
KUMI,2018,4970,4760,9730,1
KUMI,2019,5060,4830,9890,1
KUMI,2020,5150,4910,10060,1
KUMI,2021,5230,4970,10200,1
KUMI,2022,5320,5050,10370,1
KUMI,2023,5400,5120,10520,1
KUMI,2024,5470,5170,10640,1
KUMI,2025,5540,5220,10760,1
KWANIA,2015,3030,3050,6080,1
KWANIA,2016,3130,3140,6270,1
KWANIA,2017,3220,3230,6450,1
KWANIA,2018,3320,3320,6640,1
KWANIA,2019,3420,3410,6830,1
KWANIA,2020,3530,3500,7030,1
KWANIA,2021,3620,3600,7220,1
KWANIA,2022,3730,3690,7420,1
KWANIA,2023,3830,3780,7610,1
KWANIA,2024,3930,3870,7800,1
KWANIA,2025,4030,3970,8000,1
KWEEN,2015,1540,1390,2930,1
KWEEN,2016,1590,1430,3020,1
KWEEN,2017,1630,1460,3090,1
KWEEN,2018,1690,1500,3190,1
KWEEN,2019,1740,1530,3270,1
KWEEN,2020,1790,1570,3360,1
KWEEN,2021,1840,1600,3440,1
KWEEN,2022,1890,1640,3530,1
KWEEN,2023,1940,1670,3610,1
KWEEN,2024,1990,1710,3700,1
KWEEN,2025,2040,1740,3780,1
KYANKWANZI,2015,4220,3970,8190,1
KYANKWANZI,2016,4440,4150,8590,1
KYANKWANZI,2017,4670,4350,9020,1
KYANKWANZI,2018,4910,4550,9460,1
KYANKWANZI,2019,5160,4750,9910,1
KYANKWANZI,2020,5410,4970,10380,1
KYANKWANZI,2021,5680,5190,10870,1
KYANKWANZI,2022,5950,5420,11370,1
KYANKWANZI,2023,6230,5650,11880,1
KYANKWANZI,2024,6520,5890,12410,1
KYANKWANZI,2025,6820,6140,12960,1
KYEGEGWA,2015,6220,5650,11870,1
KYEGEGWA,2016,6730,6100,12830,1
KYEGEGWA,2017,7290,6580,13870,1
KYEGEGWA,2018,7890,7100,14990,1
KYEGEGWA,2019,8520,7650,16170,1
KYEGEGWA,2020,9210,8250,17460,1
KYEGEGWA,2021,9950,8880,18830,1
KYEGEGWA,2022,10730,9560,20290,1
KYEGEGWA,2023,11570,10280,21850,1
KYEGEGWA,2024,12470,11050,23520,1
KYEGEGWA,2025,13420,11860,25280,1
KYENJOJO,2015,8470,7690,16160,1
KYENJOJO,2016,8820,7980,16800,1
KYENJOJO,2017,9180,8270,17450,1
KYENJOJO,2018,9560,8570,18130,1
KYENJOJO,2019,9940,8880,18820,1
KYENJOJO,2020,10330,9190,19520,1
KYENJOJO,2021,10730,9510,20240,1
KYENJOJO,2022,11140,9840,20980,1
KYENJOJO,2023,11550,10170,21720,1
KYENJOJO,2024,11970,10500,22470,1
KYENJOJO,2025,12400,10840,23240,1
KYOTERA,2015,4430,3930,8360,1
KYOTERA,2016,4420,4120,8540,1
KYOTERA,2017,4440,4120,8560,1
KYOTERA,2018,4460,4130,8590,1
KYOTERA,2019,4470,4140,8610,1
KYOTERA,2020,4480,4140,8620,1
KYOTERA,2021,4490,4140,8630,1
KYOTERA,2022,4490,4140,8630,1
KYOTERA,2023,4490,4130,8620,1
KYOTERA,2024,4480,4120,8600,1
KYOTERA,2025,4460,4100,8560,1
KARENGA,2015,790,850,1640,1
KARENGA,2016,820,870,1690,1
KARENGA,2017,830,890,1720,1
KARENGA,2018,860,910,1770,1
KARENGA,2019,880,940,1820,1
KARENGA,2020,910,950,1860,1
KARENGA,2021,930,980,1910,1
KARENGA,2022,950,990,1940,1
KARENGA,2023,970,1020,1990,1
KARENGA,2024,1000,1040,2040,1
KARENGA,2025,1020,1060,2080,1
LAMWO,2015,2760,2480,5240,1
LAMWO,2016,2720,2590,5310,1
LAMWO,2017,2720,2600,5320,1
LAMWO,2018,2720,2610,5330,1
LAMWO,2019,2710,2620,5330,1
LAMWO,2020,2690,2620,5310,1
LAMWO,2021,2680,2630,5310,1
LAMWO,2022,2670,2630,5300,1
LAMWO,2023,2650,2620,5270,1
LAMWO,2024,2620,2610,5230,1
LAMWO,2025,2590,2590,5180,1
LIRA,2015,6600,6130,12730,1
LIRA,2016,6790,6310,13100,1
LIRA,2017,6980,6490,13470,1
LIRA,2018,7170,6670,13840,1
LIRA,2019,7360,6860,14220,1
LIRA,2020,7560,7040,14600,1
LIRA,2021,7750,7230,14980,1
LIRA,2022,7950,7420,15370,1
LIRA,2023,8150,7600,15750,1
LIRA,2024,8340,7790,16130,1
LIRA,2025,8530,7970,16500,1
LUUKA,2015,4690,4500,9190,1
LUUKA,2016,4700,4750,9450,1
LUUKA,2017,4740,4800,9540,1
LUUKA,2018,4780,4830,9610,1
LUUKA,2019,4810,4870,9680,1
LUUKA,2020,4850,4900,9750,1
LUUKA,2021,4870,4930,9800,1
LUUKA,2022,4900,4960,9860,1
LUUKA,2023,4920,4980,9900,1
LUUKA,2024,4920,4990,9910,1
LUUKA,2025,4910,4990,9900,1
LUWERO,2015,8490,7810,16300,1
LUWERO,2016,8530,8260,16790,1
LUWERO,2017,8640,8350,16990,1
LUWERO,2018,8750,8450,17200,1
LUWERO,2019,8860,8540,17400,1
LUWERO,2020,8950,8610,17560,1
LUWERO,2021,9050,8680,17730,1
LUWERO,2022,9130,8750,17880,1
LUWERO,2023,9210,8820,18030,1
LUWERO,2024,9260,8850,18110,1
LUWERO,2025,9300,8890,18190,1
LWENGO,2015,5510,5010,10520,1
LWENGO,2016,5460,5220,10680,1
LWENGO,2017,5450,5210,10660,1
LWENGO,2018,5440,5210,10650,1
LWENGO,2019,5430,5190,10620,1
LWENGO,2020,5410,5170,10580,1
LWENGO,2021,5370,5140,10510,1
LWENGO,2022,5350,5130,10480,1
LWENGO,2023,5320,5100,10420,1
LWENGO,2024,5270,5050,10320,1
LWENGO,2025,5230,5000,10230,1
LYANTONDE,2015,1900,1800,3700,1
LYANTONDE,2016,1910,1920,3830,1
LYANTONDE,2017,1950,1960,3910,1
LYANTONDE,2018,1980,1990,3970,1
LYANTONDE,2019,2020,2020,4040,1
LYANTONDE,2020,2050,2050,4100,1
LYANTONDE,2021,2070,2080,4150,1
LYANTONDE,2022,2100,2110,4210,1
LYANTONDE,2023,2130,2130,4260,1
LYANTONDE,2024,2160,2150,4310,1
LYANTONDE,2025,2180,2170,4350,1
MANAFWA,2015,2740,2560,5300,1
MANAFWA,2016,2810,2620,5430,1
MANAFWA,2017,2880,2670,5550,1
MANAFWA,2018,2950,2730,5680,1
MANAFWA,2019,3020,2790,5810,1
MANAFWA,2020,3090,2850,5940,1
MANAFWA,2021,3160,2910,6070,1
MANAFWA,2022,3230,2970,6200,1
MANAFWA,2023,3300,3020,6320,1
MANAFWA,2024,3370,3080,6450,1
MANAFWA,2025,3440,3130,6570,1
MARACHA,2015,3390,3120,6510,1
MARACHA,2016,3460,3190,6650,1
MARACHA,2017,3540,3250,6790,1
MARACHA,2018,3610,3310,6920,1
MARACHA,2019,3680,3370,7050,1
MARACHA,2020,3750,3430,7180,1
MARACHA,2021,3820,3490,7310,1
MARACHA,2022,3890,3550,7440,1
MARACHA,2023,3960,3610,7570,1
MARACHA,2024,4030,3660,7690,1
MARACHA,2025,4090,3720,7810,1
MASAKA,2015,5590,5120,10710,1
MASAKA,2016,5600,5400,11000,1
MASAKA,2017,5660,5460,11120,1
MASAKA,2018,5710,5500,11210,1
MASAKA,2019,5770,5550,11320,1
MASAKA,2020,5810,5600,11410,1
MASAKA,2021,5850,5630,11480,1
MASAKA,2022,5890,5660,11550,1
MASAKA,2023,5930,5680,11610,1
MASAKA,2024,5940,5700,11640,1
MASAKA,2025,5960,5710,11670,1
MASINDI,2015,5310,4800,10110,1
MASINDI,2016,5470,4930,10400,1
MASINDI,2017,5630,5060,10690,1
MASINDI,2018,5790,5200,10990,1
MASINDI,2019,5950,5330,11280,1
MASINDI,2020,6120,5460,11580,1
MASINDI,2021,6280,5600,11880,1
MASINDI,2022,6440,5730,12170,1
MASINDI,2023,6610,5870,12480,1
MASINDI,2024,6770,6000,12770,1
MASINDI,2025,6940,6130,13070,1
MAYUGE,2015,9750,9240,18990,1
MAYUGE,2016,9860,9850,19710,1
MAYUGE,2017,10060,10050,20110,1
MAYUGE,2018,10250,10250,20500,1
MAYUGE,2019,10440,10430,20870,1
MAYUGE,2020,10610,10620,21230,1
MAYUGE,2021,10790,10780,21570,1
MAYUGE,2022,10960,10960,21920,1
MAYUGE,2023,11120,11120,22240,1
MAYUGE,2024,11260,11260,22520,1
MAYUGE,2025,11380,11380,22760,1
MBALE,2015,8600,7890,16490,1
MBALE,2016,8680,8430,17110,1
MBALE,2017,8850,8620,17470,1
MBALE,2018,9010,8810,17820,1
MBALE,2019,9170,9000,18170,1
MBALE,2020,9320,9180,18500,1
MBALE,2021,9460,9350,18810,1
MBALE,2022,9600,9530,19130,1
MBALE,2023,9720,9690,19410,1
MBALE,2024,9840,9840,19680,1
MBALE,2025,9940,9970,19910,1
MBARARA,2015,5350,4900,10250,1
MBARARA,2016,5470,5010,10480,1
MBARARA,2017,5600,5120,10720,1
MBARARA,2018,5730,5220,10950,1
MBARARA,2019,5850,5330,11180,1
MBARARA,2020,5980,5440,11420,1
MBARARA,2021,6100,5550,11650,1
MBARARA,2022,6220,5650,11870,1
MBARARA,2023,6350,5750,12100,1
MBARARA,2024,6460,5850,12310,1
MBARARA,2025,6580,5950,12530,1
MITOOMA,2015,3050,2810,5860,1
MITOOMA,2016,3080,2840,5920,1
MITOOMA,2017,3120,2860,5980,1
MITOOMA,2018,3160,2890,6050,1
MITOOMA,2019,3190,2910,6100,1
MITOOMA,2020,3220,2930,6150,1
MITOOMA,2021,3250,2950,6200,1
MITOOMA,2022,3290,2970,6260,1
MITOOMA,2023,3310,2990,6300,1
MITOOMA,2024,3340,3010,6350,1
MITOOMA,2025,3360,3020,6380,1
MITYANA,2015,6200,5400,11600,1
MITYANA,2016,6200,5680,11880,1
MITYANA,2017,6240,5710,11950,1
MITYANA,2018,6270,5740,12010,1
MITYANA,2019,6300,5750,12050,1
MITYANA,2020,6330,5770,12100,1
MITYANA,2021,6340,5780,12120,1
MITYANA,2022,6370,5790,12160,1
MITYANA,2023,6380,5790,12170,1
MITYANA,2024,6370,5770,12140,1
MITYANA,2025,6360,5750,12110,1
MOROTO,2015,1760,1680,3440,1
MOROTO,2016,1760,1790,3550,1
MOROTO,2017,1780,1810,3590,1
MOROTO,2018,1790,1840,3630,1
MOROTO,2019,1810,1850,3660,1
MOROTO,2020,1830,1870,3700,1
MOROTO,2021,1840,1900,3740,1
MOROTO,2022,1860,1910,3770,1
MOROTO,2023,1860,1930,3790,1
MOROTO,2024,1870,1950,3820,1
MOROTO,2025,1880,1960,3840,1
MOYO,2015,1480,1430,2910,1
MOYO,2016,1510,1470,2980,1
MOYO,2017,1550,1500,3050,1
MOYO,2018,1590,1530,3120,1
MOYO,2019,1630,1560,3190,1
MOYO,2020,1670,1600,3270,1
MOYO,2021,1710,1630,3340,1
MOYO,2022,1750,1660,3410,1
MOYO,2023,1790,1690,3480,1
MOYO,2024,1830,1720,3550,1
MOYO,2025,1860,1750,3610,1
MPIGI,2015,4830,4250,9080,1
MPIGI,2016,4840,4490,9330,1
MPIGI,2017,4900,4550,9450,1
MPIGI,2018,4960,4600,9560,1
MPIGI,2019,5010,4650,9660,1
MPIGI,2020,5060,4690,9750,1
MPIGI,2021,5100,4730,9830,1
MPIGI,2022,5140,4780,9920,1
MPIGI,2023,5190,4810,10000,1
MPIGI,2024,5210,4840,10050,1
MPIGI,2025,5230,4850,10080,1
MUBENDE,2015,9170,8490,17660,1
MUBENDE,2016,9470,9210,18680,1
MUBENDE,2017,9860,9590,19450,1
MUBENDE,2018,10250,9970,20220,1
MUBENDE,2019,10660,10360,21020,1
MUBENDE,2020,11060,10750,21810,1
MUBENDE,2021,11480,11150,22630,1
MUBENDE,2022,11910,11550,23460,1
MUBENDE,2023,12320,11950,24270,1
MUBENDE,2024,12740,12350,25090,1
MUBENDE,2025,13140,12730,25870,1
MUKONO,2015,10310,9500,19810,1
MUKONO,2016,10380,10100,20480,1
MUKONO,2017,10530,10300,20830,1
MUKONO,2018,10690,10480,21170,1
MUKONO,2019,10840,10660,21500,1
MUKONO,2020,10980,10840,21820,1
MUKONO,2021,11110,10990,22100,1
MUKONO,2022,11250,11160,22410,1
MUKONO,2023,11360,11310,22670,1
MUKONO,2024,11450,11440,22890,1
MUKONO,2025,11520,11540,23060,1
MADI OKOLLO,2015,2560,2330,4890,1
MADI OKOLLO,2016,2630,2400,5030,1
MADI OKOLLO,2017,2720,2460,5180,1
MADI OKOLLO,2018,2800,2530,5330,1
MADI OKOLLO,2019,2870,2590,5460,1
MADI OKOLLO,2020,2960,2660,5620,1
MADI OKOLLO,2021,3030,2730,5760,1
MADI OKOLLO,2022,3110,2800,5910,1
MADI OKOLLO,2023,3190,2860,6050,1
MADI OKOLLO,2024,3270,2920,6190,1
MADI OKOLLO,2025,3340,2990,6330,1
NABILATUK,2015,950,940,1890,1
NABILATUK,2016,970,1010,1980,1
NABILATUK,2017,1010,1050,2060,1
NABILATUK,2018,1050,1080,2130,1
NABILATUK,2019,1090,1110,2200,1
NABILATUK,2020,1140,1140,2280,1
NABILATUK,2021,1170,1180,2350,1
NABILATUK,2022,1210,1210,2420,1
NABILATUK,2023,1260,1250,2510,1
NABILATUK,2024,1290,1290,2580,1
NABILATUK,2025,1330,1320,2650,1
NAKAPIRIPIRIT,2015,1400,1280,2680,1
NAKAPIRIPIRIT,2016,1430,1380,2810,1
NAKAPIRIPIRIT,2017,1480,1420,2900,1
NAKAPIRIPIRIT,2018,1520,1470,2990,1
NAKAPIRIPIRIT,2019,1570,1510,3080,1
NAKAPIRIPIRIT,2020,1610,1560,3170,1
NAKAPIRIPIRIT,2021,1660,1600,3260,1
NAKAPIRIPIRIT,2022,1710,1650,3360,1
NAKAPIRIPIRIT,2023,1760,1690,3450,1
NAKAPIRIPIRIT,2024,1800,1740,3540,1
NAKAPIRIPIRIT,2025,1840,1780,3620,1
NAKASEKE,2015,3090,3020,6110,1
NAKASEKE,2016,3210,3090,6300,1
NAKASEKE,2017,3320,3160,6480,1
NAKASEKE,2018,3440,3240,6680,1
NAKASEKE,2019,3560,3310,6870,1
NAKASEKE,2020,3690,3390,7080,1
NAKASEKE,2021,3820,3460,7280,1
NAKASEKE,2022,3950,3540,7490,1
NAKASEKE,2023,4070,3610,7680,1
NAKASEKE,2024,4210,3680,7890,1
NAKASEKE,2025,4340,3750,8090,1
NAKASONGOLA,2015,3650,3350,7000,1
NAKASONGOLA,2016,3690,3550,7240,1
NAKASONGOLA,2017,3760,3590,7350,1
NAKASONGOLA,2018,3830,3650,7480,1
NAKASONGOLA,2019,3900,3710,7610,1
NAKASONGOLA,2020,3970,3740,7710,1
NAKASONGOLA,2021,4020,3790,7810,1
NAKASONGOLA,2022,4100,3850,7950,1
NAKASONGOLA,2023,4150,3890,8040,1
NAKASONGOLA,2024,4220,3920,8140,1
NAKASONGOLA,2025,4270,3970,8240,1
NAMAYINGO,2015,4740,4290,9030,1
NAMAYINGO,2016,4730,4500,9230,1
NAMAYINGO,2017,4770,4530,9300,1
NAMAYINGO,2018,4790,4540,9330,1
NAMAYINGO,2019,4820,4550,9370,1
NAMAYINGO,2020,4840,4560,9400,1
NAMAYINGO,2021,4860,4560,9420,1
NAMAYINGO,2022,4880,4560,9440,1
NAMAYINGO,2023,4890,4560,9450,1
NAMAYINGO,2024,4890,4550,9440,1
NAMAYINGO,2025,4880,4530,9410,1
NAMISINDWA,2015,3730,3380,7110,1
NAMISINDWA,2016,3840,3460,7300,1
NAMISINDWA,2017,3940,3540,7480,1
NAMISINDWA,2018,4050,3630,7680,1
NAMISINDWA,2019,4160,3710,7870,1
NAMISINDWA,2020,4270,3790,8060,1
NAMISINDWA,2021,4380,3870,8250,1
NAMISINDWA,2022,4490,3960,8450,1
NAMISINDWA,2023,4600,4040,8640,1
NAMISINDWA,2024,4700,4120,8820,1
NAMISINDWA,2025,4810,4190,9000,1
NAMUTUMBA,2015,5710,5340,11050,1
NAMUTUMBA,2016,5790,5690,11480,1
NAMUTUMBA,2017,5930,5820,11750,1
NAMUTUMBA,2018,6060,5950,12010,1
NAMUTUMBA,2019,6200,6060,12260,1
NAMUTUMBA,2020,6330,6170,12500,1
NAMUTUMBA,2021,6450,6290,12740,1
NAMUTUMBA,2022,6580,6400,12980,1
NAMUTUMBA,2023,6700,6510,13210,1
NAMUTUMBA,2024,6810,6600,13410,1
NAMUTUMBA,2025,6900,6690,13590,1
NAPAK,2015,2280,2210,4490,1
NAPAK,2016,2270,2340,4610,1
NAPAK,2017,2280,2360,4640,1
NAPAK,2018,2290,2380,4670,1
NAPAK,2019,2290,2400,4690,1
NAPAK,2020,2300,2430,4730,1
NAPAK,2021,2300,2440,4740,1
NAPAK,2022,2310,2460,4770,1
NAPAK,2023,2310,2470,4780,1
NAPAK,2024,2300,2480,4780,1
NAPAK,2025,2290,2480,4770,1
NEBBI,2015,4650,4200,8850,1
NEBBI,2016,4800,4320,9120,1
NEBBI,2017,4960,4440,9400,1
NEBBI,2018,5110,4570,9680,1
NEBBI,2019,5270,4700,9970,1
NEBBI,2020,5430,4820,10250,1
NEBBI,2021,5580,4950,10530,1
NEBBI,2022,5750,5070,10820,1
NEBBI,2023,5910,5200,11110,1
NEBBI,2024,6070,5330,11400,1
NEBBI,2025,6230,5450,11680,1
NGORA,2015,2770,2630,5400,1
NGORA,2016,2790,2790,5580,1
NGORA,2017,2840,2840,5680,1
NGORA,2018,2890,2870,5760,1
NGORA,2019,2930,2920,5850,1
NGORA,2020,2970,2950,5920,1
NGORA,2021,3010,2980,5990,1
NGORA,2022,3050,3020,6070,1
NGORA,2023,3080,3060,6140,1
NGORA,2024,3110,3080,6190,1
NGORA,2025,3130,3100,6230,1
NTOROKO,2015,1380,1270,2650,1
NTOROKO,2016,1390,1330,2720,1
NTOROKO,2017,1400,1340,2740,1
NTOROKO,2018,1420,1360,2780,1
NTOROKO,2019,1440,1370,2810,1
NTOROKO,2020,1450,1370,2820,1
NTOROKO,2021,1470,1380,2850,1
NTOROKO,2022,1480,1380,2860,1
NTOROKO,2023,1490,1390,2880,1
NTOROKO,2024,1510,1390,2900,1
NTOROKO,2025,1510,1390,2900,1
NTUNGAMO,2015,8530,7830,16360,1
NTUNGAMO,2016,8720,7980,16700,1
NTUNGAMO,2017,8910,8130,17040,1
NTUNGAMO,2018,9090,8280,17370,1
NTUNGAMO,2019,9280,8420,17700,1
NTUNGAMO,2020,9470,8570,18040,1
NTUNGAMO,2021,9650,8710,18360,1
NTUNGAMO,2022,9830,8840,18670,1
NTUNGAMO,2023,10000,8980,18980,1
NTUNGAMO,2024,10170,9110,19280,1
NTUNGAMO,2025,10340,9240,19580,1
NWOYA,2015,2900,2840,5740,1
NWOYA,2016,3200,3130,6330,1
NWOYA,2017,3540,3450,6990,1
NWOYA,2018,3910,3800,7710,1
NWOYA,2019,4310,4180,8490,1
NWOYA,2020,4760,4600,9360,1
NWOYA,2021,5240,5060,10300,1
NWOYA,2022,5770,5560,11330,1
NWOYA,2023,6360,6110,12470,1
NWOYA,2024,6990,6700,13690,1
NWOYA,2025,7680,7350,15030,1
OBONGI,2015,800,730,1530,1
OBONGI,2016,800,770,1570,1
OBONGI,2017,810,780,1590,1
OBONGI,2018,820,790,1610,1
OBONGI,2019,830,790,1620,1
OBONGI,2020,840,790,1630,1
OBONGI,2021,850,810,1660,1
OBONGI,2022,860,810,1670,1
OBONGI,2023,870,820,1690,1
OBONGI,2024,860,820,1680,1
OBONGI,2025,880,820,1700,1
OMORO,2015,3120,2860,5980,1
OMORO,2016,3170,3060,6230,1
OMORO,2017,3250,3140,6390,1
OMORO,2018,3320,3210,6530,1
OMORO,2019,3390,3280,6670,1
OMORO,2020,3470,3350,6820,1
OMORO,2021,3530,3420,6950,1
OMORO,2022,3600,3490,7090,1
OMORO,2023,3680,3550,7230,1
OMORO,2024,3740,3620,7360,1
OMORO,2025,3790,3670,7460,1
OTUKE,2015,1880,1770,3650,1
OTUKE,2016,1960,1850,3810,1
OTUKE,2017,2050,1930,3980,1
OTUKE,2018,2140,2010,4150,1
OTUKE,2019,2240,2090,4330,1
OTUKE,2020,2330,2180,4510,1
OTUKE,2021,2430,2270,4700,1
OTUKE,2022,2530,2360,4890,1
OTUKE,2023,2640,2450,5090,1
OTUKE,2024,2750,2550,5300,1
OTUKE,2025,2850,2650,5500,1
OYAM,2015,6900,6530,13430,1
OYAM,2016,7110,6730,13840,1
OYAM,2017,7330,6920,14250,1
OYAM,2018,7550,7120,14670,1
OYAM,2019,7770,7320,15090,1
OYAM,2020,8000,7530,15530,1
OYAM,2021,8220,7730,15950,1
OYAM,2022,8450,7940,16390,1
OYAM,2023,8680,8140,16820,1
OYAM,2024,8910,8350,17260,1
OYAM,2025,9130,8550,17680,1
PADER,2015,3530,3150,6680,1
PADER,2016,3520,3320,6840,1
PADER,2017,3540,3340,6880,1
PADER,2018,3550,3380,6930,1
PADER,2019,3570,3390,6960,1
PADER,2020,3570,3420,6990,1
PADER,2021,3580,3430,7010,1
PADER,2022,3580,3450,7030,1
PADER,2023,3590,3460,7050,1
PADER,2024,3580,3460,7040,1
PADER,2025,3570,3460,7030,1
PAKWACH,2015,3140,2960,6100,1
PAKWACH,2016,3270,3070,6340,1
PAKWACH,2017,3410,3170,6580,1
PAKWACH,2018,3550,3290,6840,1
PAKWACH,2019,3700,3410,7110,1
PAKWACH,2020,3840,3530,7370,1
PAKWACH,2021,4000,3650,7650,1
PAKWACH,2022,4150,3770,7920,1
PAKWACH,2023,4310,3900,8210,1
PAKWACH,2024,4470,4020,8490,1
PAKWACH,2025,4640,4150,8790,1
PALLISA,2015,5940,5520,11460,1
PALLISA,2016,6080,5960,12040,1
PALLISA,2017,6290,6160,12450,1
PALLISA,2018,6490,6350,12840,1
PALLISA,2019,6700,6540,13240,1
PALLISA,2020,6900,6740,13640,1
PALLISA,2021,7090,6940,14030,1
PALLISA,2022,7310,7130,14440,1
PALLISA,2023,7510,7320,14830,1
PALLISA,2024,7700,7510,15210,1
PALLISA,2025,7890,7680,15570,1
RAKAI,2015,5830,5410,11240,1
RAKAI,2016,5860,5720,11580,1
RAKAI,2017,5940,5790,11730,1
RAKAI,2018,6020,5860,11880,1
RAKAI,2019,6100,5920,12020,1
RAKAI,2020,6170,5980,12150,1
RAKAI,2021,6220,6030,12250,1
RAKAI,2022,6290,6070,12360,1
RAKAI,2023,6340,6120,12460,1
RAKAI,2024,6390,6150,12540,1
RAKAI,2025,6410,6170,12580,1
RUBANDA,2015,3300,3050,6350,1
RUBANDA,2016,3350,3080,6430,1
RUBANDA,2017,3390,3100,6490,1
RUBANDA,2018,3430,3120,6550,1
RUBANDA,2019,3480,3150,6630,1
RUBANDA,2020,3520,3170,6690,1
RUBANDA,2021,3560,3190,6750,1
RUBANDA,2022,3590,3200,6790,1
RUBANDA,2023,3630,3220,6850,1
RUBANDA,2024,3660,3230,6890,1
RUBANDA,2025,3690,3240,6930,1
RUBIRIZI,2015,2200,2030,4230,1
RUBIRIZI,2016,2250,2070,4320,1
RUBIRIZI,2017,2290,2110,4400,1
RUBIRIZI,2018,2340,2140,4480,1
RUBIRIZI,2019,2380,2180,4560,1
RUBIRIZI,2020,2430,2220,4650,1
RUBIRIZI,2021,2470,2260,4730,1
RUBIRIZI,2022,2510,2300,4810,1
RUBIRIZI,2023,2560,2330,4890,1
RUBIRIZI,2024,2600,2370,4970,1
RUBIRIZI,2025,2640,2400,5040,1
RUKIGA,2015,1540,1450,2990,1
RUKIGA,2016,1560,1460,3020,1
RUKIGA,2017,1580,1470,3050,1
RUKIGA,2018,1590,1480,3070,1
RUKIGA,2019,1610,1490,3100,1
RUKIGA,2020,1620,1500,3120,1
RUKIGA,2021,1630,1500,3130,1
RUKIGA,2022,1650,1510,3160,1
RUKIGA,2023,1660,1520,3180,1
RUKIGA,2024,1670,1520,3190,1
RUKIGA,2025,1670,1520,3190,1
RUKUNGIRI,2015,4980,4510,9490,1
RUKUNGIRI,2016,5040,4550,9590,1
RUKUNGIRI,2017,5100,4600,9700,1
RUKUNGIRI,2018,5160,4640,9800,1
RUKUNGIRI,2019,5220,4680,9900,1
RUKUNGIRI,2020,5270,4720,9990,1
RUKUNGIRI,2021,5320,4750,10070,1
RUKUNGIRI,2022,5370,4790,10160,1
RUKUNGIRI,2023,5420,4820,10240,1
RUKUNGIRI,2024,5460,4850,10310,1
RUKUNGIRI,2025,5500,4870,10370,1
RWAMPARA,2015,2140,1850,3990,1
RWAMPARA,2016,2190,1890,4080,1
RWAMPARA,2017,2240,1930,4170,1
RWAMPARA,2018,2290,1970,4260,1
RWAMPARA,2019,2340,2010,4350,1
RWAMPARA,2020,2390,2050,4440,1
RWAMPARA,2021,2440,2090,4530,1
RWAMPARA,2022,2490,2130,4620,1
RWAMPARA,2023,2530,2170,4700,1
RWAMPARA,2024,2580,2210,4790,1
RWAMPARA,2025,2620,2250,4870,1
SERERE,2015,5860,5480,11340,1
SERERE,2016,5980,5890,11870,1
SERERE,2017,6150,6060,12210,1
SERERE,2018,6340,6230,12570,1
SERERE,2019,6500,6400,12900,1
SERERE,2020,6680,6570,13250,1
SERERE,2021,6840,6720,13560,1
SERERE,2022,7020,6890,13910,1
SERERE,2023,7180,7050,14230,1
SERERE,2024,7340,7210,14550,1
SERERE,2025,7490,7350,14840,1
SHEEMA,2015,2960,2720,5680,1
SHEEMA,2016,3000,2750,5750,1
SHEEMA,2017,3030,2780,5810,1
SHEEMA,2018,3070,2810,5880,1
SHEEMA,2019,3100,2830,5930,1
SHEEMA,2020,3130,2860,5990,1
SHEEMA,2021,3170,2880,6050,1
SHEEMA,2022,3200,2910,6110,1
SHEEMA,2023,3220,2930,6150,1
SHEEMA,2024,3250,2950,6200,1
SHEEMA,2025,3270,2960,6230,1
SIRONKO,2015,4100,3600,7700,1
SIRONKO,2016,4200,3670,7870,1
SIRONKO,2017,4300,3750,8050,1
SIRONKO,2018,4400,3820,8220,1
SIRONKO,2019,4510,3900,8410,1
SIRONKO,2020,4610,3970,8580,1
SIRONKO,2021,4700,4040,8740,1
SIRONKO,2022,4800,4110,8910,1
SIRONKO,2023,4900,4180,9080,1
SIRONKO,2024,4990,4250,9240,1
SIRONKO,2025,5090,4320,9410,1
SOROTI,2015,5930,5510,11440,1
SOROTI,2016,6030,5890,11920,1
SOROTI,2017,6170,6030,12200,1
SOROTI,2018,6330,6180,12510,1
SOROTI,2019,6470,6310,12780,1
SOROTI,2020,6610,6460,13070,1
SOROTI,2021,6740,6580,13320,1
SOROTI,2022,6890,6710,13600,1
SOROTI,2023,7020,6840,13860,1
SOROTI,2024,7140,6970,14110,1
SOROTI,2025,7250,7060,14310,1
SSEMBABULE,2015,5230,4810,10040,1
SSEMBABULE,2016,5270,5110,10380,1
SSEMBABULE,2017,5360,5190,10550,1
SSEMBABULE,2018,5450,5270,10720,1
SSEMBABULE,2019,5540,5340,10880,1
SSEMBABULE,2020,5620,5410,11030,1
SSEMBABULE,2021,5690,5490,11180,1
SSEMBABULE,2022,5780,5550,11330,1
SSEMBABULE,2023,5840,5610,11450,1
SSEMBABULE,2024,5900,5660,11560,1
SSEMBABULE,2025,5950,5700,11650,1
TORORO,2015,9600,8810,18410,1
TORORO,2016,9860,9040,18900,1
TORORO,2017,10120,9260,19380,1
TORORO,2018,10390,9490,19880,1
TORORO,2019,10650,9720,20370,1
TORORO,2020,10920,9950,20870,1
TORORO,2021,11190,10180,21370,1
TORORO,2022,11450,10400,21850,1
TORORO,2023,11710,10630,22340,1
TORORO,2024,11970,10850,22820,1
TORORO,2025,12230,11070,23300,1
WAKISO,2015,36610,32770,69380,1
WAKISO,2016,39060,35010,74070,1
WAKISO,2017,41680,37410,79090,1
WAKISO,2018,44450,39940,84390,1
WAKISO,2019,47400,42620,90020,1
WAKISO,2020,50490,45450,95940,1
WAKISO,2021,53730,48470,102200,1
WAKISO,2022,57180,51670,108850,1
WAKISO,2023,60810,54990,115800,1
WAKISO,2024,64590,58490,123080,1
WAKISO,2025,68570,62210,130780,1
YUMBE,2015,7510,7540,15050,1
YUMBE,2016,7740,8250,15990,1
YUMBE,2017,8040,8650,16690,1
YUMBE,2018,8360,9070,17430,1
YUMBE,2019,8670,9490,18160,1
YUMBE,2020,8990,9910,18900,1
YUMBE,2021,9320,10350,19670,1
YUMBE,2022,9650,10810,20460,1
YUMBE,2023,9970,11270,21240,1
YUMBE,2024,10290,11740,22030,1
YUMBE,2025,10600,12190,22790,1
ZOMBO,2015,4440,4010,8450,1
ZOMBO,2016,4580,4130,8710,1
ZOMBO,2017,4720,4240,8960,1
ZOMBO,2018,4860,4360,9220,1
ZOMBO,2019,5010,4470,9480,1
ZOMBO,2020,5160,4590,9750,1
ZOMBO,2021,5300,4710,10010,1
ZOMBO,2022,5450,4830,10280,1
ZOMBO,2023,5600,4950,10550,1
ZOMBO,2024,5750,5070,10820,1
ZOMBO,2025,5890,5180,11070,1
ABIM,2015,2050,2030,4080,10
ABIM,2016,2170,2120,4290,10
ABIM,2017,2280,2210,4490,10
ABIM,2018,2410,2310,4720,10
ABIM,2019,2540,2420,4960,10
ABIM,2020,2640,2480,5120,10
ABIM,2021,2750,2570,5320,10
ABIM,2022,2860,2670,5530,10
ABIM,2023,3030,2810,5840,10
ABIM,2024,3290,3030,6320,10
ABIM,2025,3420,3320,6740,10
ADJUMANI,2015,3740,3620,7360,10
ADJUMANI,2016,3770,3660,7430,10
ADJUMANI,2017,3800,3690,7490,10
ADJUMANI,2018,3820,3730,7550,10
ADJUMANI,2019,3850,3760,7610,10
ADJUMANI,2020,3870,3790,7660,10
ADJUMANI,2021,3890,3820,7710,10
ADJUMANI,2022,3910,3850,7760,10
ADJUMANI,2023,3920,3870,7790,10
ADJUMANI,2024,3930,3900,7830,10
ADJUMANI,2025,3940,3910,7850,10
AGAGO,2015,3680,3710,7390,10
AGAGO,2016,3740,3770,7510,10
AGAGO,2017,3810,3840,7650,10
AGAGO,2018,3870,3910,7780,10
AGAGO,2019,3930,3970,7900,10
AGAGO,2020,4000,4030,8030,10
AGAGO,2021,4060,4100,8160,10
AGAGO,2022,4120,4160,8280,10
AGAGO,2023,4180,4220,8400,10
AGAGO,2024,4230,4270,8500,10
AGAGO,2025,4280,4330,8610,10
ALEBTONG,2015,3450,3510,6960,10
ALEBTONG,2016,3510,3530,7040,10
ALEBTONG,2017,3580,3580,7160,10
ALEBTONG,2018,3640,3620,7260,10
ALEBTONG,2019,3700,3660,7360,10
ALEBTONG,2020,3740,3640,7380,10
ALEBTONG,2021,3750,3650,7400,10
ALEBTONG,2022,3770,3670,7440,10
ALEBTONG,2023,3840,3740,7580,10
ALEBTONG,2024,4040,3890,7930,10
ALEBTONG,2025,4070,4140,8210,10
AMOLATAR,2015,2270,2310,4580,10
AMOLATAR,2016,2310,2320,4630,10
AMOLATAR,2017,2350,2340,4690,10
AMOLATAR,2018,2380,2370,4750,10
AMOLATAR,2019,2420,2390,4810,10
AMOLATAR,2020,2430,2370,4800,10
AMOLATAR,2021,2440,2370,4810,10
AMOLATAR,2022,2450,2380,4830,10
AMOLATAR,2023,2500,2410,4910,10
AMOLATAR,2024,2620,2510,5130,10
AMOLATAR,2025,2630,2660,5290,10
AMUDAT,2015,2570,2430,5000,10
AMUDAT,2016,2640,2490,5130,10
AMUDAT,2017,2710,2570,5280,10
AMUDAT,2018,2810,2660,5470,10
AMUDAT,2019,2880,2740,5620,10
AMUDAT,2020,2940,2770,5710,10
AMUDAT,2021,2980,2830,5810,10
AMUDAT,2022,3030,2900,5930,10
AMUDAT,2023,3130,3010,6140,10
AMUDAT,2024,3320,3200,6520,10
AMUDAT,2025,3380,3450,6830,10
AMURIA,2015,2800,2760,5560,10
AMURIA,2016,2880,2820,5700,10
AMURIA,2017,2950,2870,5820,10
AMURIA,2018,3040,2930,5970,10
AMURIA,2019,3120,2980,6100,10
AMURIA,2020,3170,2980,6150,10
AMURIA,2021,3210,3010,6220,10
AMURIA,2022,3260,3060,6320,10
AMURIA,2023,3360,3140,6500,10
AMURIA,2024,3560,3290,6850,10
AMURIA,2025,3620,3520,7140,10
AMURU,2015,3190,3110,6300,10
AMURU,2016,3230,3150,6380,10
AMURU,2017,3290,3180,6470,10
AMURU,2018,3340,3210,6550,10
AMURU,2019,3400,3250,6650,10
AMURU,2020,3420,3240,6660,10
AMURU,2021,3420,3240,6660,10
AMURU,2022,3440,3250,6690,10
AMURU,2023,3500,3310,6810,10
AMURU,2024,3670,3450,7120,10
AMURU,2025,3690,3660,7350,10
APAC,2015,3100,3040,6140,10
APAC,2016,3210,3150,6360,10
APAC,2017,3330,3260,6590,10
APAC,2018,3450,3370,6820,10
APAC,2019,3570,3490,7060,10
APAC,2020,3700,3600,7300,10
APAC,2021,3830,3720,7550,10
APAC,2022,3960,3840,7800,10
APAC,2023,4090,3960,8050,10
APAC,2024,4220,4080,8300,10
APAC,2025,4350,4200,8550,10
ARUA,2015,10270,10200,20470,10
ARUA,2016,10580,10470,21050,10
ARUA,2017,10870,10760,21630,10
ARUA,2018,11190,11040,22230,10
ARUA,2019,11500,11340,22840,10
ARUA,2020,11810,11630,23440,10
ARUA,2021,12130,11920,24050,10
ARUA,2022,12440,12210,24650,10
ARUA,2023,12750,12510,25260,10
ARUA,2024,13070,12790,25860,10
ARUA,2025,13380,13080,26460,10
BUDAKA,2015,3540,3430,6970,10
BUDAKA,2016,3620,3480,7100,10
BUDAKA,2017,3710,3540,7250,10
BUDAKA,2018,3810,3610,7420,10
BUDAKA,2019,3910,3680,7590,10
BUDAKA,2020,3970,3690,7660,10
BUDAKA,2021,4010,3720,7730,10
BUDAKA,2022,4070,3770,7840,10
BUDAKA,2023,4190,3860,8050,10
BUDAKA,2024,4430,4050,8480,10
BUDAKA,2025,4490,4330,8820,10
BUDUDA,2015,4000,3810,7810,10
BUDUDA,2016,4130,3920,8050,10
BUDUDA,2017,4280,4020,8300,10
BUDUDA,2018,4430,4140,8570,10
BUDUDA,2019,4590,4260,8850,10
BUDUDA,2020,4700,4310,9010,10
BUDUDA,2021,4790,4400,9190,10
BUDUDA,2022,4900,4500,9400,10
BUDUDA,2023,5090,4660,9750,10
BUDUDA,2024,5430,4940,10370,10
BUDUDA,2025,5560,5330,10890,10
BUGIRI,2015,6770,6660,13430,10
BUGIRI,2016,6980,6810,13790,10
BUGIRI,2017,7190,6960,14150,10
BUGIRI,2018,7420,7130,14550,10
BUGIRI,2019,7640,7300,14940,10
BUGIRI,2020,7800,7340,15140,10
BUGIRI,2021,7920,7450,15370,10
BUGIRI,2022,8080,7580,15660,10
BUGIRI,2023,8340,7810,16150,10
BUGIRI,2024,8870,8230,17100,10
BUGIRI,2025,9040,8830,17870,10
BUGWERI,2015,3060,2880,5940,10
BUGWERI,2016,3110,2900,6010,10
BUGWERI,2017,3160,2920,6080,10
BUGWERI,2018,3220,2970,6190,10
BUGWERI,2019,3280,3000,6280,10
BUGWERI,2020,3300,2970,6270,10
BUGWERI,2021,3310,2970,6280,10
BUGWERI,2022,3330,2990,6320,10
BUGWERI,2023,3390,3040,6430,10
BUGWERI,2024,3560,3160,6720,10
BUGWERI,2025,3580,3350,6930,10
BUHWEJU,2015,1980,1950,3930,10
BUHWEJU,2016,2040,2010,4050,10
BUHWEJU,2017,2110,2070,4180,10
BUHWEJU,2018,2170,2140,4310,10
BUHWEJU,2019,2240,2200,4440,10
BUHWEJU,2020,2310,2260,4570,10
BUHWEJU,2021,2380,2330,4710,10
BUHWEJU,2022,2450,2390,4840,10
BUHWEJU,2023,2530,2460,4990,10
BUHWEJU,2024,2590,2520,5110,10
BUHWEJU,2025,2670,2590,5260,10
BUIKWE,2015,6780,6510,13290,10
BUIKWE,2016,6850,6530,13380,10
BUIKWE,2017,6920,6560,13480,10
BUIKWE,2018,6990,6590,13580,10
BUIKWE,2019,7070,6630,13700,10
BUIKWE,2020,7060,6540,13600,10
BUIKWE,2021,7030,6520,13550,10
BUIKWE,2022,7020,6520,13540,10
BUIKWE,2023,7100,6590,13690,10
BUIKWE,2024,7400,6820,14220,10
BUIKWE,2025,7400,7190,14590,10
BUKEDEA,2015,3440,3360,6800,10
BUKEDEA,2016,3560,3450,7010,10
BUKEDEA,2017,3680,3530,7210,10
BUKEDEA,2018,3800,3620,7420,10
BUKEDEA,2019,3940,3720,7660,10
BUKEDEA,2020,4030,3750,7780,10
BUKEDEA,2021,4100,3810,7910,10
BUKEDEA,2022,4190,3880,8070,10
BUKEDEA,2023,4350,4000,8350,10
BUKEDEA,2024,4630,4230,8860,10
BUKEDEA,2025,4750,4550,9300,10
BUKOMANSIMBI,2015,2790,2470,5260,10
BUKOMANSIMBI,2016,2770,2440,5210,10
BUKOMANSIMBI,2017,2770,2410,5180,10
BUKOMANSIMBI,2018,2760,2380,5140,10
BUKOMANSIMBI,2019,2760,2360,5120,10
BUKOMANSIMBI,2020,2720,2300,5020,10
BUKOMANSIMBI,2021,2680,2260,4940,10
BUKOMANSIMBI,2022,2640,2220,4860,10
BUKOMANSIMBI,2023,2650,2210,4860,10
BUKOMANSIMBI,2024,2720,2250,4970,10
BUKOMANSIMBI,2025,2690,2330,5020,10
BUKWO,2015,1520,1460,2980,10
BUKWO,2016,1600,1530,3130,10
BUKWO,2017,1690,1600,3290,10
BUKWO,2018,1780,1680,3460,10
BUKWO,2019,1870,1760,3630,10
BUKWO,2020,1960,1850,3810,10
BUKWO,2021,2060,1930,3990,10
BUKWO,2022,2170,2020,4190,10
BUKWO,2023,2280,2110,4390,10
BUKWO,2024,2390,2210,4600,10
BUKWO,2025,2500,2300,4800,10
BULAMBULI,2015,2920,2900,5820,10
BULAMBULI,2016,3030,3000,6030,10
BULAMBULI,2017,3150,3090,6240,10
BULAMBULI,2018,3270,3200,6470,10
BULAMBULI,2019,3400,3300,6700,10
BULAMBULI,2020,3490,3360,6850,10
BULAMBULI,2021,3570,3440,7010,10
BULAMBULI,2022,3670,3540,7210,10
BULAMBULI,2023,3830,3680,7510,10
BULAMBULI,2024,4100,3920,8020,10
BULAMBULI,2025,4220,4240,8460,10
BULIISA,2015,1810,1710,3520,10
BULIISA,2016,1910,1790,3700,10
BULIISA,2017,2020,1870,3890,10
BULIISA,2018,2130,1950,4080,10
BULIISA,2019,2240,2040,4280,10
BULIISA,2020,2350,2120,4470,10
BULIISA,2021,2480,2210,4690,10
BULIISA,2022,2600,2310,4910,10
BULIISA,2023,2740,2400,5140,10
BULIISA,2024,2870,2500,5370,10
BULIISA,2025,3010,2600,5610,10
BUNDIBUGYO,2015,3390,3470,6860,10
BUNDIBUGYO,2016,3460,3500,6960,10
BUNDIBUGYO,2017,3530,3540,7070,10
BUNDIBUGYO,2018,3600,3580,7180,10
BUNDIBUGYO,2019,3670,3640,7310,10
BUNDIBUGYO,2020,3700,3610,7310,10
BUNDIBUGYO,2021,3720,3620,7340,10
BUNDIBUGYO,2022,3750,3650,7400,10
BUNDIBUGYO,2023,3830,3710,7540,10
BUNDIBUGYO,2024,4030,3870,7900,10
BUNDIBUGYO,2025,4070,4100,8170,10
BUNYANGABU,2015,2690,2580,5270,10
BUNYANGABU,2016,2730,2590,5320,10
BUNYANGABU,2017,2770,2610,5380,10
BUNYANGABU,2018,2810,2630,5440,10
BUNYANGABU,2019,2860,2650,5510,10
BUNYANGABU,2020,2870,2630,5500,10
BUNYANGABU,2021,2880,2620,5500,10
BUNYANGABU,2022,2890,2630,5520,10
BUNYANGABU,2023,2930,2660,5590,10
BUNYANGABU,2024,3080,2760,5840,10
BUNYANGABU,2025,3090,2910,6000,10
BUSHENYI,2015,3640,3380,7020,10
BUSHENYI,2016,3690,3410,7100,10
BUSHENYI,2017,3730,3450,7180,10
BUSHENYI,2018,3780,3480,7260,10
BUSHENYI,2019,3820,3500,7320,10
BUSHENYI,2020,3860,3530,7390,10
BUSHENYI,2021,3900,3550,7450,10
BUSHENYI,2022,3940,3580,7520,10
BUSHENYI,2023,3970,3600,7570,10
BUSHENYI,2024,4000,3620,7620,10
BUSHENYI,2025,4030,3630,7660,10
BUSIA,2015,5230,5110,10340,10
BUSIA,2016,5340,5160,10500,10
BUSIA,2017,5460,5230,10690,10
BUSIA,2018,5570,5300,10870,10
BUSIA,2019,5690,5380,11070,10
BUSIA,2020,5750,5360,11110,10
BUSIA,2021,5790,5380,11170,10
BUSIA,2022,5850,5420,11270,10
BUSIA,2023,5990,5530,11520,10
BUSIA,2024,6310,5770,12080,10
BUSIA,2025,6360,6130,12490,10
BUTALEJA,2015,4280,4090,8370,10
BUTALEJA,2016,4390,4170,8560,10
BUTALEJA,2017,4510,4240,8750,10
BUTALEJA,2018,4640,4330,8970,10
BUTALEJA,2019,4770,4430,9200,10
BUTALEJA,2020,4850,4430,9280,10
BUTALEJA,2021,4910,4480,9390,10
BUTALEJA,2022,4980,4540,9520,10
BUTALEJA,2023,5140,4670,9810,10
BUTALEJA,2024,5440,4900,10340,10
BUTALEJA,2025,5530,5240,10770,10
BUTAMBALA,2015,1990,1650,3640,10
BUTAMBALA,2016,2000,1640,3640,10
BUTAMBALA,2017,2010,1630,3640,10
BUTAMBALA,2018,2020,1630,3650,10
BUTAMBALA,2019,2020,1630,3650,10
BUTAMBALA,2020,2000,1580,3580,10
BUTAMBALA,2021,1980,1570,3550,10
BUTAMBALA,2022,1970,1550,3520,10
BUTAMBALA,2023,1980,1550,3530,10
BUTAMBALA,2024,2050,1590,3640,10
BUTAMBALA,2025,2030,1650,3680,10
BUTEBO,2015,1850,1840,3690,10
BUTEBO,2016,1850,1840,3690,10
BUTEBO,2017,1860,1830,3690,10
BUTEBO,2018,1880,1820,3700,10
BUTEBO,2019,1890,1820,3710,10
BUTEBO,2020,1880,1780,3660,10
BUTEBO,2021,1860,1760,3620,10
BUTEBO,2022,1850,1760,3610,10
BUTEBO,2023,1870,1760,3630,10
BUTEBO,2024,1940,1810,3750,10
BUTEBO,2025,1920,1890,3810,10
BUVUMA,2015,1070,1070,2140,10
BUVUMA,2016,1140,1140,2280,10
BUVUMA,2017,1210,1220,2430,10
BUVUMA,2018,1280,1300,2580,10
BUVUMA,2019,1360,1390,2750,10
BUVUMA,2020,1440,1480,2920,10
BUVUMA,2021,1530,1580,3110,10
BUVUMA,2022,1620,1680,3300,10
BUVUMA,2023,1710,1790,3500,10
BUVUMA,2024,1810,1900,3710,10
BUVUMA,2025,1910,2020,3930,10
BUYENDE,2015,5930,5460,11390,10
BUYENDE,2016,6130,5600,11730,10
BUYENDE,2017,6340,5750,12090,10
BUYENDE,2018,6560,5910,12470,10
BUYENDE,2019,6790,6080,12870,10
BUYENDE,2020,6950,6140,13090,10
BUYENDE,2021,7090,6260,13350,10
BUYENDE,2022,7250,6390,13640,10
BUYENDE,2023,7520,6610,14130,10
BUYENDE,2024,8020,6990,15010,10
BUYENDE,2025,8210,7540,15750,10
DOKOLO,2015,3290,3090,6380,10
DOKOLO,2016,3390,3170,6560,10
DOKOLO,2017,3490,3260,6750,10
DOKOLO,2018,3600,3350,6950,10
DOKOLO,2019,3700,3440,7140,10
DOKOLO,2020,3810,3530,7340,10
DOKOLO,2021,3920,3620,7540,10
DOKOLO,2022,4030,3710,7740,10
DOKOLO,2023,4140,3800,7940,10
DOKOLO,2024,4240,3890,8130,10
DOKOLO,2025,4350,3970,8320,10
GOMBA,2015,2740,2530,5270,10
GOMBA,2016,2750,2520,5270,10
GOMBA,2017,2780,2510,5290,10
GOMBA,2018,2800,2500,5300,10
GOMBA,2019,2810,2500,5310,10
GOMBA,2020,2800,2440,5240,10
GOMBA,2021,2790,2420,5210,10
GOMBA,2022,2770,2390,5160,10
GOMBA,2023,2800,2410,5210,10
GOMBA,2024,2910,2470,5380,10
GOMBA,2025,2900,2580,5480,10
GULU,2015,4290,4220,8510,10
GULU,2016,4420,4350,8770,10
GULU,2017,4560,4470,9030,10
GULU,2018,4690,4600,9290,10
GULU,2019,4830,4730,9560,10
GULU,2020,4970,4860,9830,10
GULU,2021,5100,4990,10090,10
GULU,2022,5240,5120,10360,10
GULU,2023,5380,5260,10640,10
GULU,2024,5520,5390,10910,10
GULU,2025,5660,5520,11180,10
HOIMA,2015,4580,4370,8950,10
HOIMA,2016,4760,4520,9280,10
HOIMA,2017,4940,4680,9620,10
HOIMA,2018,5120,4840,9960,10
HOIMA,2019,5310,5000,10310,10
HOIMA,2020,5500,5170,10670,10
HOIMA,2021,5690,5340,11030,10
HOIMA,2022,5890,5500,11390,10
HOIMA,2023,6090,5680,11770,10
HOIMA,2024,6290,5850,12140,10
HOIMA,2025,6500,6030,12530,10
IBANDA,2015,3800,3620,7420,10
IBANDA,2016,3880,3690,7570,10
IBANDA,2017,3950,3750,7700,10
IBANDA,2018,4030,3820,7850,10
IBANDA,2019,4110,3890,8000,10
IBANDA,2020,4180,3950,8130,10
IBANDA,2021,4250,4010,8260,10
IBANDA,2022,4330,4070,8400,10
IBANDA,2023,4400,4140,8540,10
IBANDA,2024,4460,4190,8650,10
IBANDA,2025,4530,4250,8780,10
IGANGA,2015,5600,5580,11180,10
IGANGA,2016,5720,5650,11370,10
IGANGA,2017,5830,5720,11550,10
IGANGA,2018,5970,5790,11760,10
IGANGA,2019,6100,5880,11980,10
IGANGA,2020,6150,5850,12000,10
IGANGA,2021,6190,5880,12070,10
IGANGA,2022,6260,5920,12180,10
IGANGA,2023,6410,6040,12450,10
IGANGA,2024,6750,6310,13060,10
IGANGA,2025,6810,6710,13520,10
ISINGIRO,2015,8370,7950,16320,10
ISINGIRO,2016,8680,8230,16910,10
ISINGIRO,2017,9010,8520,17530,10
ISINGIRO,2018,9340,8820,18160,10
ISINGIRO,2019,9680,9120,18800,10
ISINGIRO,2020,10030,9430,19460,10
ISINGIRO,2021,10380,9740,20120,10
ISINGIRO,2022,10740,10060,20800,10
ISINGIRO,2023,11100,10370,21470,10
ISINGIRO,2024,11460,10700,22160,10
ISINGIRO,2025,11830,11020,22850,10
JINJA,2015,7190,7150,14340,10
JINJA,2016,7310,7260,14570,10
JINJA,2017,7440,7370,14810,10
JINJA,2018,7560,7480,15040,10
JINJA,2019,7680,7590,15270,10
JINJA,2020,7800,7700,15500,10
JINJA,2021,7910,7800,15710,10
JINJA,2022,8020,7900,15920,10
JINJA,2023,8120,7990,16110,10
JINJA,2024,8220,8080,16300,10
JINJA,2025,8320,8170,16490,10
KAABONG,2015,2010,2200,4210,10
KAABONG,2016,2070,2260,4330,10
KAABONG,2017,2130,2320,4450,10
KAABONG,2018,2180,2370,4550,10
KAABONG,2019,2240,2420,4660,10
KAABONG,2020,2290,2480,4770,10
KAABONG,2021,2350,2530,4880,10
KAABONG,2022,2410,2590,5000,10
KAABONG,2023,2470,2640,5110,10
KAABONG,2024,2520,2690,5210,10
KAABONG,2025,2580,2750,5330,10
KABALE,2015,3280,3250,6530,10
KABALE,2016,3340,3290,6630,10
KABALE,2017,3390,3330,6720,10
KABALE,2018,3440,3370,6810,10
KABALE,2019,3490,3410,6900,10
KABALE,2020,3540,3450,6990,10
KABALE,2021,3590,3480,7070,10
KABALE,2022,3630,3510,7140,10
KABALE,2023,3680,3540,7220,10
KABALE,2024,3720,3570,7290,10
KABALE,2025,3760,3600,7360,10
KABAROLE,2015,4430,4170,8600,10
KABAROLE,2016,4530,4260,8790,10
KABAROLE,2017,4630,4350,8980,10
KABAROLE,2018,4720,4450,9170,10
KABAROLE,2019,4830,4540,9370,10
KABAROLE,2020,4920,4630,9550,10
KABAROLE,2021,5020,4720,9740,10
KABAROLE,2022,5120,4810,9930,10
KABAROLE,2023,5210,4900,10110,10
KABAROLE,2024,5300,4980,10280,10
KABAROLE,2025,5390,5070,10460,10
KABERAMAIDO,2015,1770,1650,3420,10
KABERAMAIDO,2016,1830,1680,3510,10
KABERAMAIDO,2017,1880,1720,3600,10
KABERAMAIDO,2018,1940,1760,3700,10
KABERAMAIDO,2019,2010,1810,3820,10
KABERAMAIDO,2020,2050,1820,3870,10
KABERAMAIDO,2021,2080,1850,3930,10
KABERAMAIDO,2022,2130,1880,4010,10
KABERAMAIDO,2023,2200,1940,4140,10
KABERAMAIDO,2024,2350,2040,4390,10
KABERAMAIDO,2025,2400,2190,4590,10
KAGADI,2015,5580,5450,11030,10
KAGADI,2016,5790,5640,11430,10
KAGADI,2017,6000,5840,11840,10
KAGADI,2018,6220,6040,12260,10
KAGADI,2019,6450,6250,12700,10
KAGADI,2020,6680,6460,13140,10
KAGADI,2021,6910,6680,13590,10
KAGADI,2022,7150,6890,14040,10
KAGADI,2023,7380,7120,14500,10
KAGADI,2024,7620,7340,14960,10
KAGADI,2025,7860,7560,15420,10
KAKUMIRO,2015,4810,4680,9490,10
KAKUMIRO,2016,5230,5070,10300,10
KAKUMIRO,2017,5700,5500,11200,10
KAKUMIRO,2018,6200,5960,12160,10
KAKUMIRO,2019,6740,6460,13200,10
KAKUMIRO,2020,7330,6990,14320,10
KAKUMIRO,2021,7960,7560,15520,10
KAKUMIRO,2022,8640,8180,16820,10
KAKUMIRO,2023,9370,8840,18210,10
KAKUMIRO,2024,10150,9540,19690,10
KAKUMIRO,2025,10990,10300,21290,10
KALAKI,2015,1850,1740,3590,10
KALAKI,2016,1930,1810,3740,10
KALAKI,2017,2020,1880,3900,10
KALAKI,2018,2110,1950,4060,10
KALAKI,2019,2190,2020,4210,10
KALAKI,2020,2280,2100,4380,10
KALAKI,2021,2380,2180,4560,10
KALAKI,2022,2470,2260,4730,10
KALAKI,2023,2570,2340,4910,10
KALAKI,2024,2670,2430,5100,10
KALAKI,2025,2770,2510,5280,10
KALANGALA,2015,420,370,790,10
KALANGALA,2016,440,380,820,10
KALANGALA,2017,450,400,850,10
KALANGALA,2018,470,410,880,10
KALANGALA,2019,480,430,910,10
KALANGALA,2020,500,450,950,10
KALANGALA,2021,520,460,980,10
KALANGALA,2022,530,480,1010,10
KALANGALA,2023,550,500,1050,10
KALANGALA,2024,570,520,1090,10
KALANGALA,2025,580,540,1120,10
KALIRO,2015,4150,4110,8260,10
KALIRO,2016,4260,4180,8440,10
KALIRO,2017,4360,4250,8610,10
KALIRO,2018,4490,4340,8830,10
KALIRO,2019,4590,4430,9020,10
KALIRO,2020,4660,4430,9090,10
KALIRO,2021,4710,4480,9190,10
KALIRO,2022,4780,4540,9320,10
KALIRO,2023,4910,4660,9570,10
KALIRO,2024,5190,4890,10080,10
KALIRO,2025,5270,5230,10500,10
KALUNGU,2015,3140,2910,6050,10
KALUNGU,2016,3140,2890,6030,10
KALUNGU,2017,3150,2870,6020,10
KALUNGU,2018,3150,2860,6010,10
KALUNGU,2019,3160,2850,6010,10
KALUNGU,2020,3120,2770,5890,10
KALUNGU,2021,3080,2740,5820,10
KALUNGU,2022,3050,2710,5760,10
KALUNGU,2023,3060,2710,5770,10
KALUNGU,2024,3160,2780,5940,10
KALUNGU,2025,3130,2900,6030,10
KAMPALA,2015,14830,14880,29710,10
KAMPALA,2016,15130,15170,30300,10
KAMPALA,2017,15430,15460,30890,10
KAMPALA,2018,15720,15750,31470,10
KAMPALA,2019,16020,16050,32070,10
KAMPALA,2020,16310,16330,32640,10
KAMPALA,2021,16600,16620,33220,10
KAMPALA,2022,16880,16890,33770,10
KAMPALA,2023,17150,17170,34320,10
KAMPALA,2024,17410,17430,34840,10
KAMPALA,2025,17660,17690,35350,10
KAMULI,2015,8840,8080,16920,10
KAMULI,2016,8970,8120,17090,10
KAMULI,2017,9110,8180,17290,10
KAMULI,2018,9270,8240,17510,10
KAMULI,2019,9420,8310,17730,10
KAMULI,2020,9470,8220,17690,10
KAMULI,2021,9480,8220,17700,10
KAMULI,2022,9520,8230,17750,10
KAMULI,2023,9690,8350,18040,10
KAMULI,2024,10170,8660,18830,10
KAMULI,2025,10210,9150,19360,10
KAMWENGE,2015,4350,4030,8380,10
KAMWENGE,2016,4520,4180,8700,10
KAMWENGE,2017,4710,4330,9040,10
KAMWENGE,2018,4900,4480,9380,10
KAMWENGE,2019,5090,4640,9730,10
KAMWENGE,2020,5290,4790,10080,10
KAMWENGE,2021,5500,4950,10450,10
KAMWENGE,2022,5700,5110,10810,10
KAMWENGE,2023,5910,5290,11200,10
KAMWENGE,2024,6120,5450,11570,10
KAMWENGE,2025,6340,5620,11960,10
KANUNGU,2015,3950,3730,7680,10
KANUNGU,2016,4030,3800,7830,10
KANUNGU,2017,4100,3860,7960,10
KANUNGU,2018,4170,3920,8090,10
KANUNGU,2019,4240,3980,8220,10
KANUNGU,2020,4310,4040,8350,10
KANUNGU,2021,4380,4090,8470,10
KANUNGU,2022,4450,4150,8600,10
KANUNGU,2023,4510,4200,8710,10
KANUNGU,2024,4570,4260,8830,10
KANUNGU,2025,4630,4300,8930,10
KAPCHORWA,2015,1800,1730,3530,10
KAPCHORWA,2016,1860,1780,3640,10
KAPCHORWA,2017,1910,1830,3740,10
KAPCHORWA,2018,1970,1880,3850,10
KAPCHORWA,2019,2030,1930,3960,10
KAPCHORWA,2020,2090,1980,4070,10
KAPCHORWA,2021,2150,2030,4180,10
KAPCHORWA,2022,2210,2080,4290,10
KAPCHORWA,2023,2270,2130,4400,10
KAPCHORWA,2024,2330,2180,4510,10
KAPCHORWA,2025,2380,2230,4610,10
KAPELEBYONG,2015,1490,1390,2880,10
KAPELEBYONG,2016,1520,1410,2930,10
KAPELEBYONG,2017,1550,1420,2970,10
KAPELEBYONG,2018,1590,1440,3030,10
KAPELEBYONG,2019,1620,1460,3080,10
KAPELEBYONG,2020,1640,1450,3090,10
KAPELEBYONG,2021,1650,1460,3110,10
KAPELEBYONG,2022,1660,1460,3120,10
KAPELEBYONG,2023,1710,1500,3210,10
KAPELEBYONG,2024,1800,1560,3360,10
KAPELEBYONG,2025,1820,1650,3470,10
KASESE,2015,10930,10570,21500,10
KASESE,2016,11080,10630,21710,10
KASESE,2017,11230,10700,21930,10
KASESE,2018,11400,10780,22180,10
KASESE,2019,11560,10860,22420,10
KASESE,2020,11610,10730,22340,10
KASESE,2021,11600,10720,22320,10
KASESE,2022,11640,10730,22370,10
KASESE,2023,11840,10880,22720,10
KASESE,2024,12380,11280,23660,10
KASESE,2025,12420,11910,24330,10
KASSANDA,2015,4710,4220,8930,10
KASSANDA,2016,4840,4320,9160,10
KASSANDA,2017,4980,4410,9390,10
KASSANDA,2018,5120,4500,9620,10
KASSANDA,2019,5260,4590,9850,10
KASSANDA,2020,5400,4690,10090,10
KASSANDA,2021,5550,4780,10330,10
KASSANDA,2022,5690,4870,10560,10
KASSANDA,2023,5830,4960,10790,10
KASSANDA,2024,5970,5040,11010,10
KASSANDA,2025,6110,5130,11240,10
KATAKWI,2015,2650,2670,5320,10
KATAKWI,2016,2700,2690,5390,10
KATAKWI,2017,2750,2710,5460,10
KATAKWI,2018,2810,2740,5550,10
KATAKWI,2019,2860,2770,5630,10
KATAKWI,2020,2890,2750,5640,10
KATAKWI,2021,2900,2750,5650,10
KATAKWI,2022,2920,2770,5690,10
KATAKWI,2023,2990,2810,5800,10
KATAKWI,2024,3140,2920,6060,10
KATAKWI,2025,3170,3100,6270,10
KAYUNGA,2015,6560,6110,12670,10
KAYUNGA,2016,6620,6100,12720,10
KAYUNGA,2017,6680,6110,12790,10
KAYUNGA,2018,6750,6120,12870,10
KAYUNGA,2019,6820,6130,12950,10
KAYUNGA,2020,6800,6030,12830,10
KAYUNGA,2021,6770,5990,12760,10
KAYUNGA,2022,6760,5970,12730,10
KAYUNGA,2023,6840,6010,12850,10
KAYUNGA,2024,7120,6200,13320,10
KAYUNGA,2025,7110,6510,13620,10
KAZO,2015,2850,2710,5560,10
KAZO,2016,2950,2810,5760,10
KAZO,2017,3070,2910,5980,10
KAZO,2018,3180,3010,6190,10
KAZO,2019,3300,3120,6420,10
KAZO,2020,3410,3220,6630,10
KAZO,2021,3540,3320,6860,10
KAZO,2022,3660,3430,7090,10
KAZO,2023,3790,3540,7330,10
KAZO,2024,3920,3660,7580,10
KAZO,2025,4050,3770,7820,10
KIBAALE,2015,2240,2150,4390,10
KIBAALE,2016,2390,2280,4670,10
KIBAALE,2017,2540,2410,4950,10
KIBAALE,2018,2700,2550,5250,10
KIBAALE,2019,2870,2690,5560,10
KIBAALE,2020,3050,2840,5890,10
KIBAALE,2021,3230,3000,6230,10
KIBAALE,2022,3430,3170,6600,10
KIBAALE,2023,3640,3340,6980,10
KIBAALE,2024,3850,3520,7370,10
KIBAALE,2025,4080,3710,7790,10
KIBOGA,2015,2350,2080,4430,10
KIBOGA,2016,2390,2090,4480,10
KIBOGA,2017,2430,2100,4530,10
KIBOGA,2018,2470,2120,4590,10
KIBOGA,2019,2510,2150,4660,10
KIBOGA,2020,2530,2120,4650,10
KIBOGA,2021,2530,2120,4650,10
KIBOGA,2022,2540,2130,4670,10
KIBOGA,2023,2590,2160,4750,10
KIBOGA,2024,2710,2250,4960,10
KIBOGA,2025,2740,2380,5120,10
KIBUKU,2015,3660,3520,7180,10
KIBUKU,2016,3750,3590,7340,10
KIBUKU,2017,3860,3660,7520,10
KIBUKU,2018,3980,3740,7720,10
KIBUKU,2019,4090,3820,7910,10
KIBUKU,2020,4160,3840,8000,10
KIBUKU,2021,4220,3880,8100,10
KIBUKU,2022,4290,3950,8240,10
KIBUKU,2023,4420,4060,8480,10
KIBUKU,2024,4700,4270,8970,10
KIBUKU,2025,4770,4580,9350,10
KIKUUBE,2015,4390,4150,8540,10
KIKUUBE,2016,4630,4360,8990,10
KIKUUBE,2017,4870,4580,9450,10
KIKUUBE,2018,5130,4810,9940,10
KIKUUBE,2019,5400,5050,10450,10
KIKUUBE,2020,5680,5310,10990,10
KIKUUBE,2021,5970,5570,11540,10
KIKUUBE,2022,6270,5830,12100,10
KIKUUBE,2023,6590,6110,12700,10
KIKUUBE,2024,6910,6400,13310,10
KIKUUBE,2025,7240,6690,13930,10
KIRUHURA,2015,2310,2020,4330,10
KIRUHURA,2016,2400,2090,4490,10
KIRUHURA,2017,2490,2170,4660,10
KIRUHURA,2018,2590,2240,4830,10
KIRUHURA,2019,2680,2320,5000,10
KIRUHURA,2020,2780,2390,5170,10
KIRUHURA,2021,2880,2480,5360,10
KIRUHURA,2022,2980,2560,5540,10
KIRUHURA,2023,3090,2640,5730,10
KIRUHURA,2024,3180,2720,5900,10
KIRUHURA,2025,3290,2800,6090,10
KIRYANDONGO,2015,4300,4140,8440,10
KIRYANDONGO,2016,4390,4190,8580,10
KIRYANDONGO,2017,4480,4230,8710,10
KIRYANDONGO,2018,4580,4290,8870,10
KIRYANDONGO,2019,4680,4350,9030,10
KIRYANDONGO,2020,4720,4310,9030,10
KIRYANDONGO,2021,4740,4330,9070,10
KIRYANDONGO,2022,4780,4360,9140,10
KIRYANDONGO,2023,4890,4440,9330,10
KIRYANDONGO,2024,5150,4630,9780,10
KIRYANDONGO,2025,5190,4910,10100,10
KISORO,2015,4290,4450,8740,10
KISORO,2016,4320,4460,8780,10
KISORO,2017,4360,4470,8830,10
KISORO,2018,4410,4500,8910,10
KISORO,2019,4450,4530,8980,10
KISORO,2020,4450,4470,8920,10
KISORO,2021,4430,4450,8880,10
KISORO,2022,4420,4450,8870,10
KISORO,2023,4470,4490,8960,10
KISORO,2024,4660,4650,9310,10
KISORO,2025,4660,4900,9560,10
KITAGWENDA,2015,2410,2160,4570,10
KITAGWENDA,2016,2520,2240,4760,10
KITAGWENDA,2017,2620,2320,4940,10
KITAGWENDA,2018,2730,2400,5130,10
KITAGWENDA,2019,2830,2480,5310,10
KITAGWENDA,2020,2950,2570,5520,10
KITAGWENDA,2021,3050,2660,5710,10
KITAGWENDA,2022,3170,2740,5910,10
KITAGWENDA,2023,3290,2830,6120,10
KITAGWENDA,2024,3400,2920,6320,10
KITAGWENDA,2025,3530,3010,6540,10
KITGUM,2015,3080,3060,6140,10
KITGUM,2016,3100,3050,6150,10
KITGUM,2017,3120,3050,6170,10
KITGUM,2018,3130,3060,6190,10
KITGUM,2019,3160,3060,6220,10
KITGUM,2020,3150,3010,6160,10
KITGUM,2021,3120,2990,6110,10
KITGUM,2022,3100,2970,6070,10
KITGUM,2023,3130,3000,6130,10
KITGUM,2024,3250,3090,6340,10
KITGUM,2025,3230,3240,6470,10
KOBOKO,2015,3450,3230,6680,10
KOBOKO,2016,3560,3300,6860,10
KOBOKO,2017,3660,3380,7040,10
KOBOKO,2018,3780,3450,7230,10
KOBOKO,2019,3880,3540,7420,10
KOBOKO,2020,3960,3550,7510,10
KOBOKO,2021,4020,3600,7620,10
KOBOKO,2022,4100,3660,7760,10
KOBOKO,2023,4230,3770,8000,10
KOBOKO,2024,4490,3970,8460,10
KOBOKO,2025,4570,4260,8830,10
KOLE,2015,4030,3890,7920,10
KOLE,2016,4170,4000,8170,10
KOLE,2017,4300,4120,8420,10
KOLE,2018,4440,4230,8670,10
KOLE,2019,4580,4350,8930,10
KOLE,2020,4730,4470,9200,10
KOLE,2021,4870,4590,9460,10
KOLE,2022,5010,4710,9720,10
KOLE,2023,5160,4830,9990,10
KOLE,2024,5310,4950,10260,10
KOLE,2025,5450,5070,10520,10
KOTIDO,2015,3380,3520,6900,10
KOTIDO,2016,3420,3540,6960,10
KOTIDO,2017,3480,3570,7050,10
KOTIDO,2018,3520,3590,7110,10
KOTIDO,2019,3580,3620,7200,10
KOTIDO,2020,3590,3580,7170,10
KOTIDO,2021,3590,3570,7160,10
KOTIDO,2022,3600,3570,7170,10
KOTIDO,2023,3660,3630,7290,10
KOTIDO,2024,3820,3750,7570,10
KOTIDO,2025,3840,3970,7810,10
KUMI,2015,4020,3890,7910,10
KUMI,2016,4110,3930,8040,10
KUMI,2017,4200,3980,8180,10
KUMI,2018,4290,4040,8330,10
KUMI,2019,4390,4090,8480,10
KUMI,2020,4440,4080,8520,10
KUMI,2021,4470,4100,8570,10
KUMI,2022,4520,4130,8650,10
KUMI,2023,4630,4220,8850,10
KUMI,2024,4880,4400,9280,10
KUMI,2025,4930,4680,9610,10
KWANIA,2015,3250,3060,6310,10
KWANIA,2016,3360,3150,6510,10
KWANIA,2017,3460,3240,6700,10
KWANIA,2018,3560,3340,6900,10
KWANIA,2019,3670,3430,7100,10
KWANIA,2020,3780,3520,7300,10
KWANIA,2021,3890,3620,7510,10
KWANIA,2022,4000,3710,7710,10
KWANIA,2023,4110,3800,7910,10
KWANIA,2024,4210,3890,8100,10
KWANIA,2025,4320,3990,8310,10
KWEEN,2015,1600,1520,3120,10
KWEEN,2016,1650,1560,3210,10
KWEEN,2017,1700,1600,3300,10
KWEEN,2018,1750,1640,3390,10
KWEEN,2019,1810,1680,3490,10
KWEEN,2020,1860,1720,3580,10
KWEEN,2021,1910,1750,3660,10
KWEEN,2022,1970,1790,3760,10
KWEEN,2023,2020,1830,3850,10
KWEEN,2024,2070,1870,3940,10
KWEEN,2025,2130,1910,4040,10
KYANKWANZI,2015,3470,3350,6820,10
KYANKWANZI,2016,3650,3500,7150,10
KYANKWANZI,2017,3830,3670,7500,10
KYANKWANZI,2018,4030,3840,7870,10
KYANKWANZI,2019,4230,4010,8240,10
KYANKWANZI,2020,4440,4190,8630,10
KYANKWANZI,2021,4660,4380,9040,10
KYANKWANZI,2022,4880,4570,9450,10
KYANKWANZI,2023,5120,4770,9890,10
KYANKWANZI,2024,5350,4970,10320,10
KYANKWANZI,2025,5600,5180,10780,10
KYEGEGWA,2015,4580,4350,8930,10
KYEGEGWA,2016,4950,4690,9640,10
KYEGEGWA,2017,5360,5060,10420,10
KYEGEGWA,2018,5800,5460,11260,10
KYEGEGWA,2019,6270,5880,12150,10
KYEGEGWA,2020,6770,6340,13110,10
KYEGEGWA,2021,7310,6830,14140,10
KYEGEGWA,2022,7890,7350,15240,10
KYEGEGWA,2023,8510,7900,16410,10
KYEGEGWA,2024,9170,8500,17670,10
KYEGEGWA,2025,9870,9120,18990,10
KYENJOJO,2015,6610,6470,13080,10
KYENJOJO,2016,6890,6710,13600,10
KYENJOJO,2017,7170,6950,14120,10
KYENJOJO,2018,7460,7210,14670,10
KYENJOJO,2019,7760,7470,15230,10
KYENJOJO,2020,8060,7730,15790,10
KYENJOJO,2021,8380,8000,16380,10
KYENJOJO,2022,8700,8270,16970,10
KYENJOJO,2023,9020,8550,17570,10
KYENJOJO,2024,9350,8830,18180,10
KYENJOJO,2025,9680,9110,18790,10
KYOTERA,2015,4110,3610,7720,10
KYOTERA,2016,4130,3600,7730,10
KYOTERA,2017,4160,3600,7760,10
KYOTERA,2018,4190,3590,7780,10
KYOTERA,2019,4220,3590,7810,10
KYOTERA,2020,4200,3520,7720,10
KYOTERA,2021,4170,3480,7650,10
KYOTERA,2022,4150,3460,7610,10
KYOTERA,2023,4180,3480,7660,10
KYOTERA,2024,4340,3580,7920,10
KYOTERA,2025,4320,3750,8070,10
KARENGA,2015,1010,1090,2100,10
KARENGA,2016,1030,1110,2140,10
KARENGA,2017,1060,1140,2200,10
KARENGA,2018,1090,1160,2250,10
KARENGA,2019,1120,1200,2320,10
KARENGA,2020,1150,1220,2370,10
KARENGA,2021,1170,1250,2420,10
KARENGA,2022,1200,1270,2470,10
KARENGA,2023,1230,1300,2530,10
KARENGA,2024,1260,1330,2590,10
KARENGA,2025,1290,1350,2640,10
LAMWO,2015,2160,2030,4190,10
LAMWO,2016,2150,2020,4170,10
LAMWO,2017,2150,2020,4170,10
LAMWO,2018,2150,2020,4170,10
LAMWO,2019,2150,2020,4170,10
LAMWO,2020,2120,1980,4100,10
LAMWO,2021,2090,1970,4060,10
LAMWO,2022,2070,1960,4030,10
LAMWO,2023,2080,1960,4040,10
LAMWO,2024,2140,2030,4170,10
LAMWO,2025,2120,2120,4240,10
LIRA,2015,6140,6420,12560,10
LIRA,2016,6320,6610,12930,10
LIRA,2017,6490,6800,13290,10
LIRA,2018,6670,6990,13660,10
LIRA,2019,6850,7180,14030,10
LIRA,2020,7040,7380,14420,10
LIRA,2021,7220,7570,14790,10
LIRA,2022,7400,7770,15170,10
LIRA,2023,7580,7960,15540,10
LIRA,2024,7760,8160,15920,10
LIRA,2025,7940,8350,16290,10
LUUKA,2015,4330,4120,8450,10
LUUKA,2016,4370,4130,8500,10
LUUKA,2017,4430,4150,8580,10
LUUKA,2018,4480,4180,8660,10
LUUKA,2019,4520,4200,8720,10
LUUKA,2020,4520,4140,8660,10
LUUKA,2021,4500,4120,8620,10
LUUKA,2022,4500,4120,8620,10
LUUKA,2023,4560,4170,8730,10
LUUKA,2024,4750,4310,9060,10
LUUKA,2025,4750,4540,9290,10
LUWERO,2015,7460,6760,14220,10
LUWERO,2016,7560,6800,14360,10
LUWERO,2017,7670,6850,14520,10
LUWERO,2018,7800,6900,14700,10
LUWERO,2019,7920,6960,14880,10
LUWERO,2020,7950,6890,14840,10
LUWERO,2021,7960,6880,14840,10
LUWERO,2022,7980,6890,14870,10
LUWERO,2023,8130,6980,15110,10
LUWERO,2024,8500,7250,15750,10
LUWERO,2025,8540,7660,16200,10
LWENGO,2015,4870,4510,9380,10
LWENGO,2016,4870,4470,9340,10
LWENGO,2017,4870,4440,9310,10
LWENGO,2018,4880,4410,9290,10
LWENGO,2019,4880,4390,9270,10
LWENGO,2020,4830,4290,9120,10
LWENGO,2021,4760,4230,8990,10
LWENGO,2022,4710,4180,8890,10
LWENGO,2023,4730,4190,8920,10
LWENGO,2024,4880,4280,9160,10
LWENGO,2025,4820,4470,9290,10
LYANTONDE,2015,1430,1320,2750,10
LYANTONDE,2016,1460,1340,2800,10
LYANTONDE,2017,1490,1350,2840,10
LYANTONDE,2018,1530,1360,2890,10
LYANTONDE,2019,1560,1380,2940,10
LYANTONDE,2020,1570,1370,2940,10
LYANTONDE,2021,1580,1390,2970,10
LYANTONDE,2022,1590,1400,2990,10
LYANTONDE,2023,1630,1420,3050,10
LYANTONDE,2024,1710,1480,3190,10
LYANTONDE,2025,1730,1580,3310,10
MANAFWA,2015,2530,2440,4970,10
MANAFWA,2016,2590,2500,5090,10
MANAFWA,2017,2660,2550,5210,10
MANAFWA,2018,2720,2610,5330,10
MANAFWA,2019,2790,2660,5450,10
MANAFWA,2020,2850,2720,5570,10
MANAFWA,2021,2920,2770,5690,10
MANAFWA,2022,2980,2830,5810,10
MANAFWA,2023,3040,2880,5920,10
MANAFWA,2024,3110,2940,6050,10
MANAFWA,2025,3170,2980,6150,10
MARACHA,2015,3160,2870,6030,10
MARACHA,2016,3230,2920,6150,10
MARACHA,2017,3300,2980,6280,10
MARACHA,2018,3370,3040,6410,10
MARACHA,2019,3440,3090,6530,10
MARACHA,2020,3500,3150,6650,10
MARACHA,2021,3570,3200,6770,10
MARACHA,2022,3630,3260,6890,10
MARACHA,2023,3700,3310,7010,10
MARACHA,2024,3760,3360,7120,10
MARACHA,2025,3820,3410,7230,10
MASAKA,2015,4520,4300,8820,10
MASAKA,2016,4570,4320,8890,10
MASAKA,2017,4630,4330,8960,10
MASAKA,2018,4690,4370,9060,10
MASAKA,2019,4750,4390,9140,10
MASAKA,2020,4760,4330,9090,10
MASAKA,2021,4740,4320,9060,10
MASAKA,2022,4750,4320,9070,10
MASAKA,2023,4820,4370,9190,10
MASAKA,2024,5030,4530,9560,10
MASAKA,2025,5040,4770,9810,10
MASINDI,2015,4390,4100,8490,10
MASINDI,2016,4520,4210,8730,10
MASINDI,2017,4660,4320,8980,10
MASINDI,2018,4790,4440,9230,10
MASINDI,2019,4920,4560,9480,10
MASINDI,2020,5060,4670,9730,10
MASINDI,2021,5190,4780,9970,10
MASINDI,2022,5330,4900,10230,10
MASINDI,2023,5470,5010,10480,10
MASINDI,2024,5600,5130,10730,10
MASINDI,2025,5740,5240,10980,10
MAYUGE,2015,8310,7810,16120,10
MAYUGE,2016,8480,7920,16400,10
MAYUGE,2017,8660,8040,16700,10
MAYUGE,2018,8850,8170,17020,10
MAYUGE,2019,9050,8310,17360,10
MAYUGE,2020,9140,8280,17420,10
MAYUGE,2021,9200,8340,17540,10
MAYUGE,2022,9300,8420,17720,10
MAYUGE,2023,9520,8610,18130,10
MAYUGE,2024,10030,8990,19020,10
MAYUGE,2025,10130,9570,19700,10
MBALE,2015,7360,7450,14810,10
MBALE,2016,7510,7570,15080,10
MBALE,2017,7660,7690,15350,10
MBALE,2018,7820,7840,15660,10
MBALE,2019,7980,7990,15970,10
MBALE,2020,8060,7990,16050,10
MBALE,2021,8100,8050,16150,10
MBALE,2022,8170,8160,16330,10
MBALE,2023,8360,8360,16720,10
MBALE,2024,8800,8760,17560,10
MBALE,2025,8880,9350,18230,10
MBARARA,2015,4430,4320,8750,10
MBARARA,2016,4540,4410,8950,10
MBARARA,2017,4640,4510,9150,10
MBARARA,2018,4750,4600,9350,10
MBARARA,2019,4850,4700,9550,10
MBARARA,2020,4950,4790,9740,10
MBARARA,2021,5060,4890,9950,10
MBARARA,2022,5150,4980,10130,10
MBARARA,2023,5260,5070,10330,10
MBARARA,2024,5350,5150,10500,10
MBARARA,2025,5450,5240,10690,10
MITOOMA,2015,2870,2900,5770,10
MITOOMA,2016,2900,2930,5830,10
MITOOMA,2017,2940,2950,5890,10
MITOOMA,2018,2970,2980,5950,10
MITOOMA,2019,3010,3010,6020,10
MITOOMA,2020,3040,3030,6070,10
MITOOMA,2021,3070,3050,6120,10
MITOOMA,2022,3100,3070,6170,10
MITOOMA,2023,3120,3090,6210,10
MITOOMA,2024,3140,3110,6250,10
MITOOMA,2025,3170,3120,6290,10
MITYANA,2015,5280,4640,9920,10
MITYANA,2016,5320,4640,9960,10
MITYANA,2017,5360,4630,9990,10
MITYANA,2018,5410,4640,10050,10
MITYANA,2019,5450,4650,10100,10
MITYANA,2020,5440,4570,10010,10
MITYANA,2021,5410,4530,9940,10
MITYANA,2022,5390,4510,9900,10
MITYANA,2023,5450,4540,9990,10
MITYANA,2024,5660,4680,10340,10
MITYANA,2025,5650,4910,10560,10
MOROTO,2015,1870,1970,3840,10
MOROTO,2016,1890,1990,3880,10
MOROTO,2017,1920,2000,3920,10
MOROTO,2018,1940,2030,3970,10
MOROTO,2019,1960,2050,4010,10
MOROTO,2020,1970,2030,4000,10
MOROTO,2021,1960,2030,3990,10
MOROTO,2022,1970,2040,4010,10
MOROTO,2023,1990,2080,4070,10
MOROTO,2024,2080,2150,4230,10
MOROTO,2025,2080,2290,4370,10
MOYO,2015,1560,1480,3040,10
MOYO,2016,1600,1520,3120,10
MOYO,2017,1640,1550,3190,10
MOYO,2018,1680,1590,3270,10
MOYO,2019,1720,1620,3340,10
MOYO,2020,1760,1650,3410,10
MOYO,2021,1810,1680,3490,10
MOYO,2022,1840,1710,3550,10
MOYO,2023,1890,1740,3630,10
MOYO,2024,1930,1780,3710,10
MOYO,2025,1960,1810,3770,10
MPIGI,2015,4150,3680,7830,10
MPIGI,2016,4200,3700,7900,10
MPIGI,2017,4260,3720,7980,10
MPIGI,2018,4320,3750,8070,10
MPIGI,2019,4390,3790,8180,10
MPIGI,2020,4400,3750,8150,10
MPIGI,2021,4400,3750,8150,10
MPIGI,2022,4410,3760,8170,10
MPIGI,2023,4480,3810,8290,10
MPIGI,2024,4690,3950,8640,10
MPIGI,2025,4700,4180,8880,10
MUBENDE,2015,6410,6070,12480,10
MUBENDE,2016,6680,6270,12950,10
MUBENDE,2017,6980,6490,13470,10
MUBENDE,2018,7280,6720,14000,10
MUBENDE,2019,7590,6980,14570,10
MUBENDE,2020,7830,7090,14920,10
MUBENDE,2021,8050,7280,15330,10
MUBENDE,2022,8290,7500,15790,10
MUBENDE,2023,8670,7820,16490,10
MUBENDE,2024,9330,8340,17670,10
MUBENDE,2025,9620,9060,18680,10
MUKONO,2015,8980,8340,17320,10
MUKONO,2016,9140,8450,17590,10
MUKONO,2017,9290,8560,17850,10
MUKONO,2018,9460,8690,18150,10
MUKONO,2019,9620,8820,18440,10
MUKONO,2020,9690,8790,18480,10
MUKONO,2021,9700,8830,18530,10
MUKONO,2022,9760,8910,18670,10
MUKONO,2023,9960,9090,19050,10
MUKONO,2024,10440,9490,19930,10
MUKONO,2025,10510,10090,20600,10
MADI OKOLLO,2015,2280,2180,4460,10
MADI OKOLLO,2016,2340,2240,4580,10
MADI OKOLLO,2017,2420,2290,4710,10
MADI OKOLLO,2018,2490,2360,4850,10
MADI OKOLLO,2019,2550,2420,4970,10
MADI OKOLLO,2020,2630,2480,5110,10
MADI OKOLLO,2021,2690,2550,5240,10
MADI OKOLLO,2022,2770,2610,5380,10
MADI OKOLLO,2023,2840,2670,5510,10
MADI OKOLLO,2024,2900,2730,5630,10
MADI OKOLLO,2025,2970,2790,5760,10
NABILATUK,2015,1380,1420,2800,10
NABILATUK,2016,1430,1460,2890,10
NABILATUK,2017,1490,1500,2990,10
NABILATUK,2018,1550,1550,3100,10
NABILATUK,2019,1610,1600,3210,10
NABILATUK,2020,1660,1610,3270,10
NABILATUK,2021,1700,1640,3340,10
NABILATUK,2022,1760,1680,3440,10
NABILATUK,2023,1820,1750,3570,10
NABILATUK,2024,1960,1850,3810,10
NABILATUK,2025,2020,2000,4020,10
NAKAPIRIPIRIT,2015,1570,1580,3150,10
NAKAPIRIPIRIT,2016,1610,1620,3230,10
NAKAPIRIPIRIT,2017,1670,1660,3330,10
NAKAPIRIPIRIT,2018,1730,1720,3450,10
NAKAPIRIPIRIT,2019,1790,1770,3560,10
NAKAPIRIPIRIT,2020,1830,1780,3610,10
NAKAPIRIPIRIT,2021,1870,1810,3680,10
NAKAPIRIPIRIT,2022,1910,1860,3770,10
NAKAPIRIPIRIT,2023,1980,1920,3900,10
NAKAPIRIPIRIT,2024,2110,2030,4140,10
NAKAPIRIPIRIT,2025,2150,2190,4340,10
NAKASEKE,2015,3210,2920,6130,10
NAKASEKE,2016,3330,2990,6320,10
NAKASEKE,2017,3450,3060,6510,10
NAKASEKE,2018,3570,3140,6710,10
NAKASEKE,2019,3700,3210,6910,10
NAKASEKE,2020,3830,3280,7110,10
NAKASEKE,2021,3960,3350,7310,10
NAKASEKE,2022,4090,3420,7510,10
NAKASEKE,2023,4230,3490,7720,10
NAKASEKE,2024,4360,3560,7920,10
NAKASEKE,2025,4500,3630,8130,10
NAKASONGOLA,2015,2970,2770,5740,10
NAKASONGOLA,2016,3040,2800,5840,10
NAKASONGOLA,2017,3110,2830,5940,10
NAKASONGOLA,2018,3180,2870,6050,10
NAKASONGOLA,2019,3250,2910,6160,10
NAKASONGOLA,2020,3280,2890,6170,10
NAKASONGOLA,2021,3310,2890,6200,10
NAKASONGOLA,2022,3340,2910,6250,10
NAKASONGOLA,2023,3420,2970,6390,10
NAKASONGOLA,2024,3600,3090,6690,10
NAKASONGOLA,2025,3640,3280,6920,10
NAMAYINGO,2015,3590,3490,7080,10
NAMAYINGO,2016,3610,3480,7090,10
NAMAYINGO,2017,3650,3480,7130,10
NAMAYINGO,2018,3690,3470,7160,10
NAMAYINGO,2019,3710,3470,7180,10
NAMAYINGO,2020,3700,3410,7110,10
NAMAYINGO,2021,3690,3380,7070,10
NAMAYINGO,2022,3670,3360,7030,10
NAMAYINGO,2023,3720,3390,7110,10
NAMAYINGO,2024,3870,3480,7350,10
NAMAYINGO,2025,3860,3650,7510,10
NAMISINDWA,2015,3450,3320,6770,10
NAMISINDWA,2016,3550,3400,6950,10
NAMISINDWA,2017,3640,3480,7120,10
NAMISINDWA,2018,3740,3560,7300,10
NAMISINDWA,2019,3850,3640,7490,10
NAMISINDWA,2020,3950,3720,7670,10
NAMISINDWA,2021,4050,3800,7850,10
NAMISINDWA,2022,4150,3880,8030,10
NAMISINDWA,2023,4250,3960,8210,10
NAMISINDWA,2024,4350,4040,8390,10
NAMISINDWA,2025,4450,4120,8570,10
NAMUTUMBA,2015,4470,4260,8730,10
NAMUTUMBA,2016,4590,4330,8920,10
NAMUTUMBA,2017,4700,4400,9100,10
NAMUTUMBA,2018,4820,4480,9300,10
NAMUTUMBA,2019,4950,4550,9500,10
NAMUTUMBA,2020,5020,4550,9570,10
NAMUTUMBA,2021,5070,4590,9660,10
NAMUTUMBA,2022,5140,4640,9780,10
NAMUTUMBA,2023,5280,4760,10040,10
NAMUTUMBA,2024,5580,4980,10560,10
NAMUTUMBA,2025,5660,5320,10980,10
NAPAK,2015,2440,2630,5070,10
NAPAK,2016,2460,2630,5090,10
NAPAK,2017,2480,2650,5130,10
NAPAK,2018,2490,2670,5160,10
NAPAK,2019,2510,2680,5190,10
NAPAK,2020,2490,2650,5140,10
NAPAK,2021,2470,2640,5110,10
NAPAK,2022,2470,2640,5110,10
NAPAK,2023,2490,2670,5160,10
NAPAK,2024,2580,2770,5350,10
NAPAK,2025,2570,2920,5490,10
NEBBI,2015,3950,3840,7790,10
NEBBI,2016,4080,3950,8030,10
NEBBI,2017,4210,4060,8270,10
NEBBI,2018,4340,4180,8520,10
NEBBI,2019,4470,4290,8760,10
NEBBI,2020,4610,4410,9020,10
NEBBI,2021,4740,4520,9260,10
NEBBI,2022,4880,4640,9520,10
NEBBI,2023,5020,4760,9780,10
NEBBI,2024,5150,4870,10020,10
NEBBI,2025,5290,4990,10280,10
NGORA,2015,2250,2240,4490,10
NGORA,2016,2290,2260,4550,10
NGORA,2017,2330,2280,4610,10
NGORA,2018,2380,2310,4690,10
NGORA,2019,2430,2330,4760,10
NGORA,2020,2440,2310,4750,10
NGORA,2021,2450,2320,4770,10
NGORA,2022,2470,2330,4800,10
NGORA,2023,2510,2380,4890,10
NGORA,2024,2640,2470,5110,10
NGORA,2025,2660,2620,5280,10
NTOROKO,2015,980,880,1860,10
NTOROKO,2016,1000,880,1880,10
NTOROKO,2017,1020,890,1910,10
NTOROKO,2018,1030,890,1920,10
NTOROKO,2019,1040,890,1930,10
NTOROKO,2020,1050,880,1930,10
NTOROKO,2021,1050,880,1930,10
NTOROKO,2022,1060,870,1930,10
NTOROKO,2023,1070,880,1950,10
NTOROKO,2024,1120,910,2030,10
NTOROKO,2025,1130,960,2090,10
NTUNGAMO,2015,7760,7600,15360,10
NTUNGAMO,2016,7930,7740,15670,10
NTUNGAMO,2017,8100,7880,15980,10
NTUNGAMO,2018,8270,8030,16300,10
NTUNGAMO,2019,8440,8170,16610,10
NTUNGAMO,2020,8610,8310,16920,10
NTUNGAMO,2021,8770,8440,17210,10
NTUNGAMO,2022,8940,8580,17520,10
NTUNGAMO,2023,9100,8710,17810,10
NTUNGAMO,2024,9250,8840,18090,10
NTUNGAMO,2025,9400,8960,18360,10
NWOYA,2015,2290,2190,4480,10
NWOYA,2016,2530,2410,4940,10
NWOYA,2017,2790,2660,5450,10
NWOYA,2018,3090,2930,6020,10
NWOYA,2019,3400,3220,6620,10
NWOYA,2020,3760,3550,7310,10
NWOYA,2021,4140,3900,8040,10
NWOYA,2022,4560,4290,8850,10
NWOYA,2023,5020,4710,9730,10
NWOYA,2024,5520,5170,10690,10
NWOYA,2025,6060,5670,11730,10
OBONGI,2015,730,720,1450,10
OBONGI,2016,750,720,1470,10
OBONGI,2017,760,730,1490,10
OBONGI,2018,770,730,1500,10
OBONGI,2019,780,740,1520,10
OBONGI,2020,780,730,1510,10
OBONGI,2021,780,730,1510,10
OBONGI,2022,790,730,1520,10
OBONGI,2023,800,740,1540,10
OBONGI,2024,840,760,1600,10
OBONGI,2025,840,810,1650,10
OMORO,2015,2700,2500,5200,10
OMORO,2016,2770,2540,5310,10
OMORO,2017,2840,2580,5420,10
OMORO,2018,2910,2640,5550,10
OMORO,2019,2990,2680,5670,10
OMORO,2020,3040,2690,5730,10
OMORO,2021,3070,2720,5790,10
OMORO,2022,3110,2750,5860,10
OMORO,2023,3200,2830,6030,10
OMORO,2024,3390,2970,6360,10
OMORO,2025,3430,3170,6600,10
OTUKE,2015,1760,1570,3330,10
OTUKE,2016,1840,1640,3480,10
OTUKE,2017,1930,1710,3640,10
OTUKE,2018,2010,1780,3790,10
OTUKE,2019,2100,1860,3960,10
OTUKE,2020,2190,1940,4130,10
OTUKE,2021,2290,2010,4300,10
OTUKE,2022,2380,2090,4470,10
OTUKE,2023,2480,2180,4660,10
OTUKE,2024,2580,2260,4840,10
OTUKE,2025,2680,2350,5030,10
OYAM,2015,6480,6290,12770,10
OYAM,2016,6680,6470,13150,10
OYAM,2017,6880,6660,13540,10
OYAM,2018,7090,6850,13940,10
OYAM,2019,7300,7050,14350,10
OYAM,2020,7510,7240,14750,10
OYAM,2021,7720,7440,15160,10
OYAM,2022,7940,7640,15580,10
OYAM,2023,8150,7830,15980,10
OYAM,2024,8370,8030,16400,10
OYAM,2025,8580,8230,16810,10
PADER,2015,2850,2860,5710,10
PADER,2016,2860,2870,5730,10
PADER,2017,2890,2880,5770,10
PADER,2018,2910,2890,5800,10
PADER,2019,2930,2910,5840,10
PADER,2020,2930,2860,5790,10
PADER,2021,2900,2850,5750,10
PADER,2022,2890,2840,5730,10
PADER,2023,2920,2870,5790,10
PADER,2024,3020,2980,6000,10
PADER,2025,3020,3120,6140,10
PAKWACH,2015,2530,2420,4950,10
PAKWACH,2016,2630,2510,5140,10
PAKWACH,2017,2740,2600,5340,10
PAKWACH,2018,2860,2690,5550,10
PAKWACH,2019,2970,2790,5760,10
PAKWACH,2020,3090,2890,5980,10
PAKWACH,2021,3220,2980,6200,10
PAKWACH,2022,3340,3080,6420,10
PAKWACH,2023,3470,3190,6660,10
PAKWACH,2024,3600,3290,6890,10
PAKWACH,2025,3730,3400,7130,10
PALLISA,2015,4880,4780,9660,10
PALLISA,2016,5040,4910,9950,10
PALLISA,2017,5220,5040,10260,10
PALLISA,2018,5400,5190,10590,10
PALLISA,2019,5590,5330,10920,10
PALLISA,2020,5720,5380,11100,10
PALLISA,2021,5840,5480,11320,10
PALLISA,2022,5970,5610,11580,10
PALLISA,2023,6200,5800,12000,10
PALLISA,2024,6610,6140,12750,10
PALLISA,2025,6760,6620,13380,10
RAKAI,2015,4870,4660,9530,10
RAKAI,2016,4940,4690,9630,10
RAKAI,2017,5020,4720,9740,10
RAKAI,2018,5100,4760,9860,10
RAKAI,2019,5180,4800,9980,10
RAKAI,2020,5210,4750,9960,10
RAKAI,2021,5210,4740,9950,10
RAKAI,2022,5230,4760,9990,10
RAKAI,2023,5330,4830,10160,10
RAKAI,2024,5570,5000,10570,10
RAKAI,2025,5600,5290,10890,10
RUBANDA,2015,3140,3050,6190,10
RUBANDA,2016,3190,3080,6270,10
RUBANDA,2017,3230,3100,6330,10
RUBANDA,2018,3270,3120,6390,10
RUBANDA,2019,3310,3150,6460,10
RUBANDA,2020,3350,3170,6520,10
RUBANDA,2021,3390,3190,6580,10
RUBANDA,2022,3420,3200,6620,10
RUBANDA,2023,3460,3220,6680,10
RUBANDA,2024,3490,3230,6720,10
RUBANDA,2025,3520,3240,6760,10
RUBIRIZI,2015,2270,2160,4430,10
RUBIRIZI,2016,2320,2200,4520,10
RUBIRIZI,2017,2370,2240,4610,10
RUBIRIZI,2018,2410,2280,4690,10
RUBIRIZI,2019,2460,2330,4790,10
RUBIRIZI,2020,2510,2370,4880,10
RUBIRIZI,2021,2550,2410,4960,10
RUBIRIZI,2022,2600,2450,5050,10
RUBIRIZI,2023,2640,2490,5130,10
RUBIRIZI,2024,2680,2520,5200,10
RUBIRIZI,2025,2720,2560,5280,10
RUKIGA,2015,1430,1440,2870,10
RUKIGA,2016,1440,1450,2890,10
RUKIGA,2017,1460,1460,2920,10
RUKIGA,2018,1470,1470,2940,10
RUKIGA,2019,1490,1480,2970,10
RUKIGA,2020,1500,1480,2980,10
RUKIGA,2021,1510,1490,3000,10
RUKIGA,2022,1520,1500,3020,10
RUKIGA,2023,1530,1500,3030,10
RUKIGA,2024,1540,1510,3050,10
RUKIGA,2025,1550,1510,3060,10
RUKUNGIRI,2015,4760,4710,9470,10
RUKUNGIRI,2016,4820,4760,9580,10
RUKUNGIRI,2017,4880,4810,9690,10
RUKUNGIRI,2018,4930,4850,9780,10
RUKUNGIRI,2019,4990,4890,9880,10
RUKUNGIRI,2020,5040,4930,9970,10
RUKUNGIRI,2021,5090,4970,10060,10
RUKUNGIRI,2022,5140,5000,10140,10
RUKUNGIRI,2023,5180,5040,10220,10
RUKUNGIRI,2024,5220,5070,10290,10
RUKUNGIRI,2025,5260,5090,10350,10
RWAMPARA,2015,2090,2000,4090,10
RWAMPARA,2016,2140,2040,4180,10
RWAMPARA,2017,2190,2090,4280,10
RWAMPARA,2018,2230,2130,4360,10
RWAMPARA,2019,2280,2180,4460,10
RWAMPARA,2020,2330,2220,4550,10
RWAMPARA,2021,2380,2260,4640,10
RWAMPARA,2022,2430,2310,4740,10
RWAMPARA,2023,2470,2350,4820,10
RWAMPARA,2024,2520,2400,4920,10
RWAMPARA,2025,2560,2440,5000,10
SERERE,2015,4760,4760,9520,10
SERERE,2016,4910,4870,9780,10
SERERE,2017,5060,4980,10040,10
SERERE,2018,5220,5100,10320,10
SERERE,2019,5390,5230,10620,10
SERERE,2020,5490,5260,10750,10
SERERE,2021,5580,5340,10920,10
SERERE,2022,5680,5450,11130,10
SERERE,2023,5880,5610,11490,10
SERERE,2024,6250,5920,12170,10
SERERE,2025,6370,6350,12720,10
SHEEMA,2015,3250,3080,6330,10
SHEEMA,2016,3290,3110,6400,10
SHEEMA,2017,3330,3150,6480,10
SHEEMA,2018,3370,3180,6550,10
SHEEMA,2019,3410,3210,6620,10
SHEEMA,2020,3440,3240,6680,10
SHEEMA,2021,3480,3270,6750,10
SHEEMA,2022,3510,3290,6800,10
SHEEMA,2023,3540,3320,6860,10
SHEEMA,2024,3570,3340,6910,10
SHEEMA,2025,3590,3360,6950,10
SIRONKO,2015,3990,3840,7830,10
SIRONKO,2016,4090,3910,8000,10
SIRONKO,2017,4190,3990,8180,10
SIRONKO,2018,4290,4070,8360,10
SIRONKO,2019,4390,4150,8540,10
SIRONKO,2020,4480,4230,8710,10
SIRONKO,2021,4580,4310,8890,10
SIRONKO,2022,4670,4390,9060,10
SIRONKO,2023,4770,4460,9230,10
SIRONKO,2024,4860,4530,9390,10
SIRONKO,2025,4950,4600,9550,10
SOROTI,2015,4350,4400,8750,10
SOROTI,2016,4470,4480,8950,10
SOROTI,2017,4580,4570,9150,10
SOROTI,2018,4700,4660,9360,10
SOROTI,2019,4830,4750,9580,10
SOROTI,2020,4900,4760,9660,10
SOROTI,2021,4960,4810,9770,10
SOROTI,2022,5030,4880,9910,10
SOROTI,2023,5180,5000,10180,10
SOROTI,2024,5480,5260,10740,10
SOROTI,2025,5560,5610,11170,10
SSEMBABULE,2015,4250,4050,8300,10
SSEMBABULE,2016,4320,4080,8400,10
SSEMBABULE,2017,4400,4130,8530,10
SSEMBABULE,2018,4490,4180,8670,10
SSEMBABULE,2019,4580,4230,8810,10
SSEMBABULE,2020,4610,4200,8810,10
SSEMBABULE,2021,4630,4210,8840,10
SSEMBABULE,2022,4670,4230,8900,10
SSEMBABULE,2023,4770,4310,9080,10
SSEMBABULE,2024,5010,4490,9500,10
SSEMBABULE,2025,5050,4760,9810,10
TORORO,2015,8690,8720,17410,10
TORORO,2016,8930,8940,17870,10
TORORO,2017,9160,9160,18320,10
TORORO,2018,9400,9390,18790,10
TORORO,2019,9650,9620,19270,10
TORORO,2020,9890,9840,19730,10
TORORO,2021,10130,10070,20200,10
TORORO,2022,10370,10290,20660,10
TORORO,2023,10610,10520,21130,10
TORORO,2024,10840,10740,21580,10
TORORO,2025,11070,10950,22020,10
WAKISO,2015,25830,24910,50740,10
WAKISO,2016,27550,26610,54160,10
WAKISO,2017,29400,28430,57830,10
WAKISO,2018,31350,30360,61710,10
WAKISO,2019,33440,32400,65840,10
WAKISO,2020,35620,34550,70170,10
WAKISO,2021,37900,36840,74740,10
WAKISO,2022,40340,39270,79610,10
WAKISO,2023,42890,41800,84690,10
WAKISO,2024,45560,44460,90020,10
WAKISO,2025,48370,47290,95660,10
YUMBE,2015,10460,11460,21920,10
YUMBE,2016,10880,11940,22820,10
YUMBE,2017,11330,12450,23780,10
YUMBE,2018,11800,13010,24810,10
YUMBE,2019,12290,13590,25880,10
YUMBE,2020,12660,13920,26580,10
YUMBE,2021,12980,14400,27380,10
YUMBE,2022,13360,14950,28310,10
YUMBE,2023,13950,15700,29650,10
YUMBE,2024,14980,16870,31850,10
YUMBE,2025,15430,18460,33890,10
ZOMBO,2015,4350,3970,8320,10
ZOMBO,2016,4480,4080,8560,10
ZOMBO,2017,4620,4200,8820,10
ZOMBO,2018,4760,4310,9070,10
ZOMBO,2019,4910,4430,9340,10
ZOMBO,2020,5050,4550,9600,10
ZOMBO,2021,5190,4660,9850,10
ZOMBO,2022,5340,4780,10120,10
ZOMBO,2023,5480,4900,10380,10
ZOMBO,2024,5630,5020,10650,10
ZOMBO,2025,5770,5130,10900,10
ABIM,2015,1520,1730,3250,11
ABIM,2016,1610,1810,3420,11
ABIM,2017,1680,1880,3560,11
ABIM,2018,1780,1970,3750,11
ABIM,2019,1880,2060,3940,11
ABIM,2020,1970,2160,4130,11
ABIM,2021,2060,2210,4270,11
ABIM,2022,2140,2290,4430,11
ABIM,2023,2230,2380,4610,11
ABIM,2024,2360,2500,4860,11
ABIM,2025,2560,2700,5260,11
ADJUMANI,2015,3070,2960,6030,11
ADJUMANI,2016,3100,2990,6090,11
ADJUMANI,2017,3120,3020,6140,11
ADJUMANI,2018,3140,3050,6190,11
ADJUMANI,2019,3160,3080,6240,11
ADJUMANI,2020,3180,3100,6280,11
ADJUMANI,2021,3200,3120,6320,11
ADJUMANI,2022,3210,3150,6360,11
ADJUMANI,2023,3220,3170,6390,11
ADJUMANI,2024,3230,3190,6420,11
ADJUMANI,2025,3240,3200,6440,11
AGAGO,2015,3020,2810,5830,11
AGAGO,2016,3070,2860,5930,11
AGAGO,2017,3130,2910,6040,11
AGAGO,2018,3180,2960,6140,11
AGAGO,2019,3230,3010,6240,11
AGAGO,2020,3290,3060,6350,11
AGAGO,2021,3330,3110,6440,11
AGAGO,2022,3380,3160,6540,11
AGAGO,2023,3430,3200,6630,11
AGAGO,2024,3480,3240,6720,11
AGAGO,2025,3520,3290,6810,11
ALEBTONG,2015,4080,3890,7970,11
ALEBTONG,2016,4160,3930,8090,11
ALEBTONG,2017,4230,3970,8200,11
ALEBTONG,2018,4310,4010,8320,11
ALEBTONG,2019,4390,4060,8450,11
ALEBTONG,2020,4460,4110,8570,11
ALEBTONG,2021,4500,4090,8590,11
ALEBTONG,2022,4510,4100,8610,11
ALEBTONG,2023,4540,4120,8660,11
ALEBTONG,2024,4640,4190,8830,11
ALEBTONG,2025,4860,4370,9230,11
AMOLATAR,2015,2570,2490,5060,11
AMOLATAR,2016,2620,2510,5130,11
AMOLATAR,2017,2660,2520,5180,11
AMOLATAR,2018,2700,2550,5250,11
AMOLATAR,2019,2740,2570,5310,11
AMOLATAR,2020,2800,2600,5400,11
AMOLATAR,2021,2810,2570,5380,11
AMOLATAR,2022,2810,2580,5390,11
AMOLATAR,2023,2820,2590,5410,11
AMOLATAR,2024,2870,2630,5500,11
AMOLATAR,2025,3010,2730,5740,11
AMUDAT,2015,1520,1340,2860,11
AMUDAT,2016,1560,1380,2940,11
AMUDAT,2017,1600,1430,3030,11
AMUDAT,2018,1650,1470,3120,11
AMUDAT,2019,1710,1510,3220,11
AMUDAT,2020,1760,1560,3320,11
AMUDAT,2021,1780,1580,3360,11
AMUDAT,2022,1800,1610,3410,11
AMUDAT,2023,1850,1660,3510,11
AMUDAT,2024,1900,1720,3620,11
AMUDAT,2025,2020,1830,3850,11
AMURIA,2015,3470,3270,6740,11
AMURIA,2016,3570,3320,6890,11
AMURIA,2017,3670,3380,7050,11
AMURIA,2018,3770,3440,7210,11
AMURIA,2019,3870,3520,7390,11
AMURIA,2020,3980,3580,7560,11
AMURIA,2021,4050,3590,7640,11
AMURIA,2022,4080,3620,7700,11
AMURIA,2023,4160,3670,7830,11
AMURIA,2024,4280,3770,8050,11
AMURIA,2025,4530,3950,8480,11
AMURU,2015,3270,3020,6290,11
AMURU,2016,3330,3050,6380,11
AMURU,2017,3380,3080,6460,11
AMURU,2018,3430,3100,6530,11
AMURU,2019,3490,3150,6640,11
AMURU,2020,3550,3190,6740,11
AMURU,2021,3570,3160,6730,11
AMURU,2022,3570,3170,6740,11
AMURU,2023,3580,3180,6760,11
AMURU,2024,3660,3240,6900,11
AMURU,2025,3820,3370,7190,11
APAC,2015,2780,2630,5410,11
APAC,2016,2880,2720,5600,11
APAC,2017,2990,2810,5800,11
APAC,2018,3100,2910,6010,11
APAC,2019,3210,3010,6220,11
APAC,2020,3320,3110,6430,11
APAC,2021,3440,3210,6650,11
APAC,2022,3550,3310,6860,11
APAC,2023,3670,3420,7090,11
APAC,2024,3790,3520,7310,11
APAC,2025,3910,3630,7540,11
ARUA,2015,8150,8010,16160,11
ARUA,2016,8390,8230,16620,11
ARUA,2017,8620,8460,17080,11
ARUA,2018,8870,8680,17550,11
ARUA,2019,9120,8910,18030,11
ARUA,2020,9360,9140,18500,11
ARUA,2021,9620,9360,18980,11
ARUA,2022,9870,9590,19460,11
ARUA,2023,10120,9830,19950,11
ARUA,2024,10370,10050,20420,11
ARUA,2025,10610,10280,20890,11
BUDAKA,2015,3450,3340,6790,11
BUDAKA,2016,3540,3400,6940,11
BUDAKA,2017,3630,3450,7080,11
BUDAKA,2018,3730,3510,7240,11
BUDAKA,2019,3820,3580,7400,11
BUDAKA,2020,3920,3650,7570,11
BUDAKA,2021,3980,3650,7630,11
BUDAKA,2022,4020,3680,7700,11
BUDAKA,2023,4080,3730,7810,11
BUDAKA,2024,4190,3830,8020,11
BUDAKA,2025,4430,4010,8440,11
BUDUDA,2015,3520,3210,6730,11
BUDUDA,2016,3640,3310,6950,11
BUDUDA,2017,3770,3390,7160,11
BUDUDA,2018,3890,3480,7370,11
BUDUDA,2019,4040,3590,7630,11
BUDUDA,2020,4180,3700,7880,11
BUDUDA,2021,4280,3740,8020,11
BUDUDA,2022,4370,3820,8190,11
BUDUDA,2023,4460,3910,8370,11
BUDUDA,2024,4630,4040,8670,11
BUDUDA,2025,4940,4280,9220,11
BUGIRI,2015,6330,6130,12460,11
BUGIRI,2016,6520,6260,12780,11
BUGIRI,2017,6720,6400,13120,11
BUGIRI,2018,6930,6540,13470,11
BUGIRI,2019,7140,6700,13840,11
BUGIRI,2020,7370,6870,14240,11
BUGIRI,2021,7520,6900,14420,11
BUGIRI,2022,7630,7000,14630,11
BUGIRI,2023,7770,7130,14900,11
BUGIRI,2024,8040,7340,15380,11
BUGIRI,2025,8540,7740,16280,11
BUGWERI,2015,2550,2560,5110,11
BUGWERI,2016,2600,2580,5180,11
BUGWERI,2017,2650,2600,5250,11
BUGWERI,2018,2690,2630,5320,11
BUGWERI,2019,2740,2650,5390,11
BUGWERI,2020,2780,2680,5460,11
BUGWERI,2021,2800,2670,5470,11
BUGWERI,2022,2810,2660,5470,11
BUGWERI,2023,2820,2680,5500,11
BUGWERI,2024,2870,2730,5600,11
BUGWERI,2025,3020,2830,5850,11
BUHWEJU,2015,1680,1730,3410,11
BUHWEJU,2016,1740,1780,3520,11
BUHWEJU,2017,1790,1830,3620,11
BUHWEJU,2018,1850,1890,3740,11
BUHWEJU,2019,1910,1950,3860,11
BUHWEJU,2020,1970,2000,3970,11
BUHWEJU,2021,2030,2060,4090,11
BUHWEJU,2022,2090,2110,4200,11
BUHWEJU,2023,2150,2170,4320,11
BUHWEJU,2024,2210,2230,4440,11
BUHWEJU,2025,2270,2290,4560,11
BUIKWE,2015,5870,5970,11840,11
BUIKWE,2016,5940,6000,11940,11
BUIKWE,2017,5990,6010,12000,11
BUIKWE,2018,6050,6040,12090,11
BUIKWE,2019,6110,6070,12180,11
BUIKWE,2020,6180,6110,12290,11
BUIKWE,2021,6170,6030,12200,11
BUIKWE,2022,6140,6010,12150,11
BUIKWE,2023,6130,6000,12130,11
BUIKWE,2024,6210,6080,12290,11
BUIKWE,2025,6470,6290,12760,11
BUKEDEA,2015,3510,3370,6880,11
BUKEDEA,2016,3620,3460,7080,11
BUKEDEA,2017,3750,3540,7290,11
BUKEDEA,2018,3880,3630,7510,11
BUKEDEA,2019,4010,3730,7740,11
BUKEDEA,2020,4150,3820,7970,11
BUKEDEA,2021,4240,3840,8080,11
BUKEDEA,2022,4320,3910,8230,11
BUKEDEA,2023,4420,3990,8410,11
BUKEDEA,2024,4580,4120,8700,11
BUKEDEA,2025,4890,4350,9240,11
BUKOMANSIMBI,2015,2700,2380,5080,11
BUKOMANSIMBI,2016,2690,2350,5040,11
BUKOMANSIMBI,2017,2690,2330,5020,11
BUKOMANSIMBI,2018,2680,2300,4980,11
BUKOMANSIMBI,2019,2670,2280,4950,11
BUKOMANSIMBI,2020,2670,2260,4930,11
BUKOMANSIMBI,2021,2640,2200,4840,11
BUKOMANSIMBI,2022,2590,2150,4740,11
BUKOMANSIMBI,2023,2560,2120,4680,11
BUKOMANSIMBI,2024,2560,2110,4670,11
BUKOMANSIMBI,2025,2630,2150,4780,11
BUKWO,2015,1340,1270,2610,11
BUKWO,2016,1410,1330,2740,11
BUKWO,2017,1490,1400,2890,11
BUKWO,2018,1570,1470,3040,11
BUKWO,2019,1650,1540,3190,11
BUKWO,2020,1730,1610,3340,11
BUKWO,2021,1820,1680,3500,11
BUKWO,2022,1920,1760,3680,11
BUKWO,2023,2010,1840,3850,11
BUKWO,2024,2110,1920,4030,11
BUKWO,2025,2210,2010,4220,11
BULAMBULI,2015,2660,2680,5340,11
BULAMBULI,2016,2760,2760,5520,11
BULAMBULI,2017,2870,2850,5720,11
BULAMBULI,2018,2980,2940,5920,11
BULAMBULI,2019,3090,3050,6140,11
BULAMBULI,2020,3220,3160,6380,11
BULAMBULI,2021,3310,3200,6510,11
BULAMBULI,2022,3390,3280,6670,11
BULAMBULI,2023,3480,3370,6850,11
BULAMBULI,2024,3620,3500,7120,11
BULAMBULI,2025,3890,3720,7610,11
BULIISA,2015,1320,1290,2610,11
BULIISA,2016,1400,1350,2750,11
BULIISA,2017,1470,1400,2870,11
BULIISA,2018,1550,1470,3020,11
BULIISA,2019,1630,1530,3160,11
BULIISA,2020,1720,1600,3320,11
BULIISA,2021,1810,1660,3470,11
BULIISA,2022,1900,1730,3630,11
BULIISA,2023,2000,1800,3800,11
BULIISA,2024,2100,1880,3980,11
BULIISA,2025,2200,1950,4150,11
BUNDIBUGYO,2015,2930,2850,5780,11
BUNDIBUGYO,2016,2990,2880,5870,11
BUNDIBUGYO,2017,3050,2910,5960,11
BUNDIBUGYO,2018,3110,2940,6050,11
BUNDIBUGYO,2019,3170,2980,6150,11
BUNDIBUGYO,2020,3230,3020,6250,11
BUNDIBUGYO,2021,3260,2990,6250,11
BUNDIBUGYO,2022,3270,3010,6280,11
BUNDIBUGYO,2023,3310,3030,6340,11
BUNDIBUGYO,2024,3380,3080,6460,11
BUNDIBUGYO,2025,3550,3220,6770,11
BUNYANGABU,2015,2500,2510,5010,11
BUNYANGABU,2016,2530,2530,5060,11
BUNYANGABU,2017,2580,2540,5120,11
BUNYANGABU,2018,2620,2550,5170,11
BUNYANGABU,2019,2660,2570,5230,11
BUNYANGABU,2020,2710,2600,5310,11
BUNYANGABU,2021,2710,2570,5280,11
BUNYANGABU,2022,2710,2570,5280,11
BUNYANGABU,2023,2730,2580,5310,11
BUNYANGABU,2024,2770,2610,5380,11
BUNYANGABU,2025,2900,2700,5600,11
BUSHENYI,2015,3140,2930,6070,11
BUSHENYI,2016,3180,2960,6140,11
BUSHENYI,2017,3220,2980,6200,11
BUSHENYI,2018,3260,3010,6270,11
BUSHENYI,2019,3300,3040,6340,11
BUSHENYI,2020,3330,3060,6390,11
BUSHENYI,2021,3370,3080,6450,11
BUSHENYI,2022,3400,3100,6500,11
BUSHENYI,2023,3430,3120,6550,11
BUSHENYI,2024,3450,3130,6580,11
BUSHENYI,2025,3480,3140,6620,11
BUSIA,2015,5450,5400,10850,11
BUSIA,2016,5560,5460,11020,11
BUSIA,2017,5680,5520,11200,11
BUSIA,2018,5810,5600,11410,11
BUSIA,2019,5930,5680,11610,11
BUSIA,2020,6050,5760,11810,11
BUSIA,2021,6120,5730,11850,11
BUSIA,2022,6160,5760,11920,11
BUSIA,2023,6210,5810,12020,11
BUSIA,2024,6370,5930,12300,11
BUSIA,2025,6710,6180,12890,11
BUTALEJA,2015,4080,3870,7950,11
BUTALEJA,2016,4200,3940,8140,11
BUTALEJA,2017,4320,4000,8320,11
BUTALEJA,2018,4430,4090,8520,11
BUTALEJA,2019,4550,4170,8720,11
BUTALEJA,2020,4680,4260,8940,11
BUTALEJA,2021,4750,4270,9020,11
BUTALEJA,2022,4820,4320,9140,11
BUTALEJA,2023,4890,4380,9270,11
BUTALEJA,2024,5040,4490,9530,11
BUTALEJA,2025,5340,4720,10060,11
BUTAMBALA,2015,1650,1520,3170,11
BUTAMBALA,2016,1650,1510,3160,11
BUTAMBALA,2017,1660,1510,3170,11
BUTAMBALA,2018,1660,1490,3150,11
BUTAMBALA,2019,1670,1490,3160,11
BUTAMBALA,2020,1680,1480,3160,11
BUTAMBALA,2021,1670,1450,3120,11
BUTAMBALA,2022,1640,1440,3080,11
BUTAMBALA,2023,1630,1410,3040,11
BUTAMBALA,2024,1640,1420,3060,11
BUTAMBALA,2025,1700,1450,3150,11
BUTEBO,2015,1860,1890,3750,11
BUTEBO,2016,1870,1880,3750,11
BUTEBO,2017,1880,1870,3750,11
BUTEBO,2018,1880,1870,3750,11
BUTEBO,2019,1900,1860,3760,11
BUTEBO,2020,1920,1860,3780,11
BUTEBO,2021,1900,1830,3730,11
BUTEBO,2022,1880,1810,3690,11
BUTEBO,2023,1880,1800,3680,11
BUTEBO,2024,1890,1800,3690,11
BUTEBO,2025,1960,1860,3820,11
BUVUMA,2015,780,790,1570,11
BUVUMA,2016,830,840,1670,11
BUVUMA,2017,880,900,1780,11
BUVUMA,2018,930,960,1890,11
BUVUMA,2019,990,1020,2010,11
BUVUMA,2020,1050,1090,2140,11
BUVUMA,2021,1110,1160,2270,11
BUVUMA,2022,1180,1240,2420,11
BUVUMA,2023,1240,1310,2550,11
BUVUMA,2024,1310,1400,2710,11
BUVUMA,2025,1390,1490,2880,11
BUYENDE,2015,5160,4980,10140,11
BUYENDE,2016,5340,5120,10460,11
BUYENDE,2017,5510,5250,10760,11
BUYENDE,2018,5710,5380,11090,11
BUYENDE,2019,5900,5530,11430,11
BUYENDE,2020,6110,5700,11810,11
BUYENDE,2021,6260,5760,12020,11
BUYENDE,2022,6370,5870,12240,11
BUYENDE,2023,6520,5990,12510,11
BUYENDE,2024,6760,6190,12950,11
BUYENDE,2025,7220,6560,13780,11
DOKOLO,2015,2810,2820,5630,11
DOKOLO,2016,2900,2890,5790,11
DOKOLO,2017,2990,2970,5960,11
DOKOLO,2018,3080,3050,6130,11
DOKOLO,2019,3170,3140,6310,11
DOKOLO,2020,3260,3220,6480,11
DOKOLO,2021,3350,3300,6650,11
DOKOLO,2022,3450,3380,6830,11
DOKOLO,2023,3540,3460,7000,11
DOKOLO,2024,3630,3550,7180,11
DOKOLO,2025,3720,3630,7350,11
GOMBA,2015,2680,2420,5100,11
GOMBA,2016,2700,2400,5100,11
GOMBA,2017,2710,2380,5090,11
GOMBA,2018,2730,2380,5110,11
GOMBA,2019,2750,2370,5120,11
GOMBA,2020,2770,2370,5140,11
GOMBA,2021,2760,2310,5070,11
GOMBA,2022,2740,2290,5030,11
GOMBA,2023,2740,2270,5010,11
GOMBA,2024,2760,2280,5040,11
GOMBA,2025,2870,2330,5200,11
GULU,2015,3530,3410,6940,11
GULU,2016,3640,3520,7160,11
GULU,2017,3750,3620,7370,11
GULU,2018,3860,3720,7580,11
GULU,2019,3970,3830,7800,11
GULU,2020,4090,3930,8020,11
GULU,2021,4200,4040,8240,11
GULU,2022,4320,4150,8470,11
GULU,2023,4430,4260,8690,11
GULU,2024,4550,4360,8910,11
GULU,2025,4660,4470,9130,11
HOIMA,2015,3600,3640,7240,11
HOIMA,2016,3740,3760,7500,11
HOIMA,2017,3880,3890,7770,11
HOIMA,2018,4020,4030,8050,11
HOIMA,2019,4170,4160,8330,11
HOIMA,2020,4320,4300,8620,11
HOIMA,2021,4470,4440,8910,11
HOIMA,2022,4630,4580,9210,11
HOIMA,2023,4790,4730,9520,11
HOIMA,2024,4940,4870,9810,11
HOIMA,2025,5100,5020,10120,11
IBANDA,2015,3160,3200,6360,11
IBANDA,2016,3220,3250,6470,11
IBANDA,2017,3290,3310,6600,11
IBANDA,2018,3350,3370,6720,11
IBANDA,2019,3410,3430,6840,11
IBANDA,2020,3480,3490,6970,11
IBANDA,2021,3540,3540,7080,11
IBANDA,2022,3600,3600,7200,11
IBANDA,2023,3660,3650,7310,11
IBANDA,2024,3710,3700,7410,11
IBANDA,2025,3760,3750,7510,11
IGANGA,2015,5260,5180,10440,11
IGANGA,2016,5370,5240,10610,11
IGANGA,2017,5490,5310,10800,11
IGANGA,2018,5600,5370,10970,11
IGANGA,2019,5730,5450,11180,11
IGANGA,2020,5850,5520,11370,11
IGANGA,2021,5910,5500,11410,11
IGANGA,2022,5940,5520,11460,11
IGANGA,2023,6000,5570,11570,11
IGANGA,2024,6150,5680,11830,11
IGANGA,2025,6480,5920,12400,11
ISINGIRO,2015,6720,6620,13340,11
ISINGIRO,2016,6970,6850,13820,11
ISINGIRO,2017,7230,7100,14330,11
ISINGIRO,2018,7500,7340,14840,11
ISINGIRO,2019,7770,7590,15360,11
ISINGIRO,2020,8050,7850,15900,11
ISINGIRO,2021,8340,8110,16450,11
ISINGIRO,2022,8620,8380,17000,11
ISINGIRO,2023,8910,8640,17550,11
ISINGIRO,2024,9210,8910,18120,11
ISINGIRO,2025,9500,9180,18680,11
JINJA,2015,5590,5700,11290,11
JINJA,2016,5690,5790,11480,11
JINJA,2017,5780,5880,11660,11
JINJA,2018,5880,5970,11850,11
JINJA,2019,5970,6060,12030,11
JINJA,2020,6060,6140,12200,11
JINJA,2021,6150,6220,12370,11
JINJA,2022,6230,6300,12530,11
JINJA,2023,6320,6380,12700,11
JINJA,2024,6390,6450,12840,11
JINJA,2025,6470,6520,12990,11
KAABONG,2015,1040,950,1990,11
KAABONG,2016,1070,970,2040,11
KAABONG,2017,1100,1000,2100,11
KAABONG,2018,1130,1020,2150,11
KAABONG,2019,1160,1040,2200,11
KAABONG,2020,1190,1070,2260,11
KAABONG,2021,1220,1090,2310,11
KAABONG,2022,1250,1110,2360,11
KAABONG,2023,1280,1140,2420,11
KAABONG,2024,1310,1160,2470,11
KAABONG,2025,1340,1180,2520,11
KABALE,2015,2830,2880,5710,11
KABALE,2016,2870,2910,5780,11
KABALE,2017,2920,2950,5870,11
KABALE,2018,2960,2980,5940,11
KABALE,2019,3000,3020,6020,11
KABALE,2020,3050,3050,6100,11
KABALE,2021,3090,3080,6170,11
KABALE,2022,3130,3110,6240,11
KABALE,2023,3160,3130,6290,11
KABALE,2024,3200,3160,6360,11
KABALE,2025,3230,3180,6410,11
KABAROLE,2015,3520,3500,7020,11
KABAROLE,2016,3600,3580,7180,11
KABAROLE,2017,3680,3660,7340,11
KABAROLE,2018,3760,3730,7490,11
KABAROLE,2019,3840,3810,7650,11
KABAROLE,2020,3910,3890,7800,11
KABAROLE,2021,3990,3960,7950,11
KABAROLE,2022,4070,4040,8110,11
KABAROLE,2023,4140,4110,8250,11
KABAROLE,2024,4210,4190,8400,11
KABAROLE,2025,4290,4260,8550,11
KABERAMAIDO,2015,2050,1990,4040,11
KABERAMAIDO,2016,2120,2040,4160,11
KABERAMAIDO,2017,2180,2090,4270,11
KABERAMAIDO,2018,2260,2140,4400,11
KABERAMAIDO,2019,2330,2200,4530,11
KABERAMAIDO,2020,2410,2250,4660,11
KABERAMAIDO,2021,2470,2250,4720,11
KABERAMAIDO,2022,2510,2290,4800,11
KABERAMAIDO,2023,2560,2330,4890,11
KABERAMAIDO,2024,2650,2410,5060,11
KABERAMAIDO,2025,2820,2540,5360,11
KAGADI,2015,4550,4400,8950,11
KAGADI,2016,4720,4560,9280,11
KAGADI,2017,4900,4720,9620,11
KAGADI,2018,5080,4880,9960,11
KAGADI,2019,5260,5050,10310,11
KAGADI,2020,5450,5220,10670,11
KAGADI,2021,5640,5400,11040,11
KAGADI,2022,5830,5570,11400,11
KAGADI,2023,6020,5750,11770,11
KAGADI,2024,6220,5930,12150,11
KAGADI,2025,6420,6110,12530,11
KAKUMIRO,2015,3760,3800,7560,11
KAKUMIRO,2016,4100,4110,8210,11
KAKUMIRO,2017,4460,4460,8920,11
KAKUMIRO,2018,4850,4830,9680,11
KAKUMIRO,2019,5280,5240,10520,11
KAKUMIRO,2020,5730,5670,11400,11
KAKUMIRO,2021,6230,6130,12360,11
KAKUMIRO,2022,6760,6630,13390,11
KAKUMIRO,2023,7330,7170,14500,11
KAKUMIRO,2024,7950,7740,15690,11
KAKUMIRO,2025,8600,8350,16950,11
KALAKI,2015,1770,1580,3350,11
KALAKI,2016,1850,1640,3490,11
KALAKI,2017,1930,1700,3630,11
KALAKI,2018,2010,1770,3780,11
KALAKI,2019,2100,1840,3940,11
KALAKI,2020,2180,1910,4090,11
KALAKI,2021,2280,1980,4260,11
KALAKI,2022,2360,2050,4410,11
KALAKI,2023,2460,2130,4590,11
KALAKI,2024,2550,2200,4750,11
KALAKI,2025,2650,2280,4930,11
KALANGALA,2015,290,270,560,11
KALANGALA,2016,300,280,580,11
KALANGALA,2017,320,290,610,11
KALANGALA,2018,330,300,630,11
KALANGALA,2019,340,320,660,11
KALANGALA,2020,350,330,680,11
KALANGALA,2021,360,340,700,11
KALANGALA,2022,370,350,720,11
KALANGALA,2023,380,370,750,11
KALANGALA,2024,400,380,780,11
KALANGALA,2025,410,400,810,11
KALIRO,2015,3820,3680,7500,11
KALIRO,2016,3920,3750,7670,11
KALIRO,2017,4010,3810,7820,11
KALIRO,2018,4110,3880,7990,11
KALIRO,2019,4220,3960,8180,11
KALIRO,2020,4330,4040,8370,11
KALIRO,2021,4390,4050,8440,11
KALIRO,2022,4440,4090,8530,11
KALIRO,2023,4500,4140,8640,11
KALIRO,2024,4630,4260,8890,11
KALIRO,2025,4890,4460,9350,11
KALUNGU,2015,3170,2960,6130,11
KALUNGU,2016,3180,2930,6110,11
KALUNGU,2017,3180,2920,6100,11
KALUNGU,2018,3180,2900,6080,11
KALUNGU,2019,3180,2880,6060,11
KALUNGU,2020,3190,2870,6060,11
KALUNGU,2021,3160,2800,5960,11
KALUNGU,2022,3110,2770,5880,11
KALUNGU,2023,3090,2740,5830,11
KALUNGU,2024,3100,2740,5840,11
KALUNGU,2025,3200,2800,6000,11
KAMPALA,2015,12000,12780,24780,11
KAMPALA,2016,12240,13030,25270,11
KAMPALA,2017,12480,13280,25760,11
KAMPALA,2018,12720,13530,26250,11
KAMPALA,2019,12960,13780,26740,11
KAMPALA,2020,13200,14030,27230,11
KAMPALA,2021,13430,14270,27700,11
KAMPALA,2022,13660,14510,28170,11
KAMPALA,2023,13880,14750,28630,11
KAMPALA,2024,14090,14970,29060,11
KAMPALA,2025,14290,15190,29480,11
KAMULI,2015,7940,7840,15780,11
KAMULI,2016,8080,7900,15980,11
KAMULI,2017,8200,7940,16140,11
KAMULI,2018,8330,7990,16320,11
KAMULI,2019,8470,8060,16530,11
KAMULI,2020,8610,8130,16740,11
KAMULI,2021,8660,8040,16700,11
KAMULI,2022,8670,8030,16700,11
KAMULI,2023,8700,8050,16750,11
KAMULI,2024,8860,8170,17030,11
KAMULI,2025,9280,8470,17750,11
KAMWENGE,2015,3230,3150,6380,11
KAMWENGE,2016,3360,3270,6630,11
KAMWENGE,2017,3500,3380,6880,11
KAMWENGE,2018,3640,3500,7140,11
KAMWENGE,2019,3780,3620,7400,11
KAMWENGE,2020,3930,3750,7680,11
KAMWENGE,2021,4080,3870,7950,11
KAMWENGE,2022,4240,4000,8240,11
KAMWENGE,2023,4390,4130,8520,11
KAMWENGE,2024,4550,4260,8810,11
KAMWENGE,2025,4710,4390,9100,11
KANUNGU,2015,3280,3390,6670,11
KANUNGU,2016,3340,3450,6790,11
KANUNGU,2017,3400,3500,6900,11
KANUNGU,2018,3460,3560,7020,11
KANUNGU,2019,3520,3610,7130,11
KANUNGU,2020,3580,3670,7250,11
KANUNGU,2021,3630,3720,7350,11
KANUNGU,2022,3690,3770,7460,11
KANUNGU,2023,3740,3820,7560,11
KANUNGU,2024,3800,3870,7670,11
KANUNGU,2025,3840,3910,7750,11
KAPCHORWA,2015,1520,1460,2980,11
KAPCHORWA,2016,1560,1500,3060,11
KAPCHORWA,2017,1610,1550,3160,11
KAPCHORWA,2018,1660,1590,3250,11
KAPCHORWA,2019,1710,1630,3340,11
KAPCHORWA,2020,1760,1670,3430,11
KAPCHORWA,2021,1810,1720,3530,11
KAPCHORWA,2022,1860,1760,3620,11
KAPCHORWA,2023,1910,1800,3710,11
KAPCHORWA,2024,1960,1850,3810,11
KAPCHORWA,2025,2010,1890,3900,11
KAPELEBYONG,2015,1650,1560,3210,11
KAPELEBYONG,2016,1690,1580,3270,11
KAPELEBYONG,2017,1730,1600,3330,11
KAPELEBYONG,2018,1760,1610,3370,11
KAPELEBYONG,2019,1800,1630,3430,11
KAPELEBYONG,2020,1840,1650,3490,11
KAPELEBYONG,2021,1860,1650,3510,11
KAPELEBYONG,2022,1870,1650,3520,11
KAPELEBYONG,2023,1890,1670,3560,11
KAPELEBYONG,2024,1930,1690,3620,11
KAPELEBYONG,2025,2050,1760,3810,11
KASESE,2015,9680,9610,19290,11
KASESE,2016,9810,9660,19470,11
KASESE,2017,9950,9710,19660,11
KASESE,2018,10090,9770,19860,11
KASESE,2019,10250,9850,20100,11
KASESE,2020,10390,9930,20320,11
KASESE,2021,10440,9810,20250,11
KASESE,2022,10430,9800,20230,11
KASESE,2023,10460,9810,20270,11
KASESE,2024,10630,9950,20580,11
KASESE,2025,11120,10300,21420,11
KASSANDA,2015,3520,3270,6790,11
KASSANDA,2016,3620,3340,6960,11
KASSANDA,2017,3730,3410,7140,11
KASSANDA,2018,3830,3480,7310,11
KASSANDA,2019,3940,3550,7490,11
KASSANDA,2020,4040,3630,7670,11
KASSANDA,2021,4150,3700,7850,11
KASSANDA,2022,4260,3760,8020,11
KASSANDA,2023,4360,3830,8190,11
KASSANDA,2024,4470,3900,8370,11
KASSANDA,2025,4570,3960,8530,11
KATAKWI,2015,2760,2680,5440,11
KATAKWI,2016,2820,2700,5520,11
KATAKWI,2017,2870,2720,5590,11
KATAKWI,2018,2920,2740,5660,11
KATAKWI,2019,2980,2770,5750,11
KATAKWI,2020,3040,2800,5840,11
KATAKWI,2021,3060,2780,5840,11
KATAKWI,2022,3080,2790,5870,11
KATAKWI,2023,3110,2800,5910,11
KATAKWI,2024,3170,2850,6020,11
KATAKWI,2025,3340,2970,6310,11
KAYUNGA,2015,5910,5770,11680,11
KAYUNGA,2016,5960,5760,11720,11
KAYUNGA,2017,6010,5760,11770,11
KAYUNGA,2018,6070,5770,11840,11
KAYUNGA,2019,6130,5780,11910,11
KAYUNGA,2020,6190,5800,11990,11
KAYUNGA,2021,6180,5700,11880,11
KAYUNGA,2022,6150,5660,11810,11
KAYUNGA,2023,6140,5630,11770,11
KAYUNGA,2024,6210,5680,11890,11
KAYUNGA,2025,6470,5850,12320,11
KAZO,2015,2370,2230,4600,11
KAZO,2016,2460,2310,4770,11
KAZO,2017,2560,2390,4950,11
KAZO,2018,2650,2480,5130,11
KAZO,2019,2750,2560,5310,11
KAZO,2020,2840,2650,5490,11
KAZO,2021,2950,2740,5690,11
KAZO,2022,3050,2830,5880,11
KAZO,2023,3150,2920,6070,11
KAZO,2024,3260,3010,6270,11
KAZO,2025,3370,3100,6470,11
KIBAALE,2015,1880,1840,3720,11
KIBAALE,2016,2000,1950,3950,11
KIBAALE,2017,2130,2060,4190,11
KIBAALE,2018,2260,2180,4440,11
KIBAALE,2019,2410,2300,4710,11
KIBAALE,2020,2560,2430,4990,11
KIBAALE,2021,2710,2570,5280,11
KIBAALE,2022,2880,2710,5590,11
KIBAALE,2023,3050,2850,5900,11
KIBAALE,2024,3230,3010,6240,11
KIBAALE,2025,3420,3170,6590,11
KIBOGA,2015,2360,2110,4470,11
KIBOGA,2016,2400,2130,4530,11
KIBOGA,2017,2440,2140,4580,11
KIBOGA,2018,2480,2160,4640,11
KIBOGA,2019,2520,2190,4710,11
KIBOGA,2020,2560,2200,4760,11
KIBOGA,2021,2580,2180,4760,11
KIBOGA,2022,2580,2180,4760,11
KIBOGA,2023,2600,2190,4790,11
KIBOGA,2024,2640,2220,4860,11
KIBOGA,2025,2770,2310,5080,11
KIBUKU,2015,3280,3350,6630,11
KIBUKU,2016,3380,3420,6800,11
KIBUKU,2017,3480,3480,6960,11
KIBUKU,2018,3580,3560,7140,11
KIBUKU,2019,3680,3640,7320,11
KIBUKU,2020,3790,3720,7510,11
KIBUKU,2021,3860,3730,7590,11
KIBUKU,2022,3910,3780,7690,11
KIBUKU,2023,3980,3840,7820,11
KIBUKU,2024,4100,3950,8050,11
KIBUKU,2025,4340,4150,8490,11
KIKUUBE,2015,3390,3170,6560,11
KIKUUBE,2016,3580,3330,6910,11
KIKUUBE,2017,3770,3500,7270,11
KIKUUBE,2018,3970,3680,7650,11
KIKUUBE,2019,4180,3870,8050,11
KIKUUBE,2020,4390,4060,8450,11
KIKUUBE,2021,4620,4260,8880,11
KIKUUBE,2022,4850,4460,9310,11
KIKUUBE,2023,5090,4670,9760,11
KIKUUBE,2024,5340,4890,10230,11
KIKUUBE,2025,5600,5120,10720,11
KIRUHURA,2015,1690,1750,3440,11
KIRUHURA,2016,1750,1820,3570,11
KIRUHURA,2017,1820,1880,3700,11
KIRUHURA,2018,1890,1940,3830,11
KIRUHURA,2019,1960,2010,3970,11
KIRUHURA,2020,2030,2080,4110,11
KIRUHURA,2021,2100,2150,4250,11
KIRUHURA,2022,2180,2220,4400,11
KIRUHURA,2023,2250,2290,4540,11
KIRUHURA,2024,2320,2360,4680,11
KIRUHURA,2025,2400,2430,4830,11
KIRYANDONGO,2015,4190,4020,8210,11
KIRYANDONGO,2016,4270,4060,8330,11
KIRYANDONGO,2017,4350,4110,8460,11
KIRYANDONGO,2018,4440,4150,8590,11
KIRYANDONGO,2019,4540,4200,8740,11
KIRYANDONGO,2020,4630,4260,8890,11
KIRYANDONGO,2021,4680,4240,8920,11
KIRYANDONGO,2022,4690,4250,8940,11
KIRYANDONGO,2023,4730,4270,9000,11
KIRYANDONGO,2024,4850,4360,9210,11
KIRYANDONGO,2025,5090,4530,9620,11
KISORO,2015,4110,3990,8100,11
KISORO,2016,4160,3990,8150,11
KISORO,2017,4200,4000,8200,11
KISORO,2018,4240,4020,8260,11
KISORO,2019,4290,4050,8340,11
KISORO,2020,4330,4080,8410,11
KISORO,2021,4320,4010,8330,11
KISORO,2022,4300,4000,8300,11
KISORO,2023,4300,4000,8300,11
KISORO,2024,4340,4040,8380,11
KISORO,2025,4530,4180,8710,11
KITAGWENDA,2015,1930,1840,3770,11
KITAGWENDA,2016,2010,1910,3920,11
KITAGWENDA,2017,2090,1980,4070,11
KITAGWENDA,2018,2180,2050,4230,11
KITAGWENDA,2019,2260,2120,4380,11
KITAGWENDA,2020,2350,2190,4540,11
KITAGWENDA,2021,2440,2260,4700,11
KITAGWENDA,2022,2530,2340,4870,11
KITAGWENDA,2023,2630,2410,5040,11
KITAGWENDA,2024,2720,2490,5210,11
KITAGWENDA,2025,2810,2570,5380,11
KITGUM,2015,3090,2950,6040,11
KITGUM,2016,3110,2950,6060,11
KITGUM,2017,3130,2940,6070,11
KITGUM,2018,3160,2940,6100,11
KITGUM,2019,3170,2950,6120,11
KITGUM,2020,3200,2960,6160,11
KITGUM,2021,3180,2900,6080,11
KITGUM,2022,3150,2880,6030,11
KITGUM,2023,3140,2860,6000,11
KITGUM,2024,3170,2890,6060,11
KITGUM,2025,3280,2980,6260,11
KOBOKO,2015,3140,2970,6110,11
KOBOKO,2016,3240,3040,6280,11
KOBOKO,2017,3330,3100,6430,11
KOBOKO,2018,3430,3170,6600,11
KOBOKO,2019,3540,3250,6790,11
KOBOKO,2020,3640,3320,6960,11
KOBOKO,2021,3700,3330,7030,11
KOBOKO,2022,3760,3380,7140,11
KOBOKO,2023,3830,3450,7280,11
KOBOKO,2024,3950,3540,7490,11
KOBOKO,2025,4200,3730,7930,11
KOLE,2015,3430,3380,6810,11
KOLE,2016,3550,3480,7030,11
KOLE,2017,3660,3580,7240,11
KOLE,2018,3780,3680,7460,11
KOLE,2019,3900,3780,7680,11
KOLE,2020,4020,3880,7900,11
KOLE,2021,4150,3990,8140,11
KOLE,2022,4270,4090,8360,11
KOLE,2023,4390,4200,8590,11
KOLE,2024,4520,4300,8820,11
KOLE,2025,4640,4400,9040,11
KOTIDO,2015,1970,2050,4020,11
KOTIDO,2016,2010,2060,4070,11
KOTIDO,2017,2030,2080,4110,11
KOTIDO,2018,2060,2090,4150,11
KOTIDO,2019,2090,2110,4200,11
KOTIDO,2020,2120,2110,4230,11
KOTIDO,2021,2120,2090,4210,11
KOTIDO,2022,2130,2090,4220,11
KOTIDO,2023,2130,2100,4230,11
KOTIDO,2024,2170,2120,4290,11
KOTIDO,2025,2260,2200,4460,11
KUMI,2015,4020,3860,7880,11
KUMI,2016,4110,3900,8010,11
KUMI,2017,4200,3950,8150,11
KUMI,2018,4290,4000,8290,11
KUMI,2019,4390,4060,8450,11
KUMI,2020,4490,4120,8610,11
KUMI,2021,4530,4100,8630,11
KUMI,2022,4570,4120,8690,11
KUMI,2023,4610,4150,8760,11
KUMI,2024,4730,4240,8970,11
KUMI,2025,4980,4420,9400,11
KWANIA,2015,2850,2730,5580,11
KWANIA,2016,2940,2810,5750,11
KWANIA,2017,3030,2890,5920,11
KWANIA,2018,3130,2980,6110,11
KWANIA,2019,3220,3060,6280,11
KWANIA,2020,3320,3140,6460,11
KWANIA,2021,3410,3220,6630,11
KWANIA,2022,3510,3310,6820,11
KWANIA,2023,3600,3390,6990,11
KWANIA,2024,3700,3470,7170,11
KWANIA,2025,3790,3560,7350,11
KWEEN,2015,1430,1280,2710,11
KWEEN,2016,1480,1310,2790,11
KWEEN,2017,1520,1350,2870,11
KWEEN,2018,1570,1380,2950,11
KWEEN,2019,1620,1410,3030,11
KWEEN,2020,1660,1440,3100,11
KWEEN,2021,1710,1480,3190,11
KWEEN,2022,1760,1510,3270,11
KWEEN,2023,1810,1540,3350,11
KWEEN,2024,1850,1570,3420,11
KWEEN,2025,1900,1600,3500,11
KYANKWANZI,2015,2620,2520,5140,11
KYANKWANZI,2016,2760,2640,5400,11
KYANKWANZI,2017,2900,2760,5660,11
KYANKWANZI,2018,3050,2890,5940,11
KYANKWANZI,2019,3200,3020,6220,11
KYANKWANZI,2020,3360,3160,6520,11
KYANKWANZI,2021,3520,3300,6820,11
KYANKWANZI,2022,3690,3440,7130,11
KYANKWANZI,2023,3870,3590,7460,11
KYANKWANZI,2024,4050,3740,7790,11
KYANKWANZI,2025,4230,3900,8130,11
KYEGEGWA,2015,3760,3720,7480,11
KYEGEGWA,2016,4070,4010,8080,11
KYEGEGWA,2017,4410,4330,8740,11
KYEGEGWA,2018,4770,4670,9440,11
KYEGEGWA,2019,5150,5030,10180,11
KYEGEGWA,2020,5570,5430,11000,11
KYEGEGWA,2021,6010,5840,11850,11
KYEGEGWA,2022,6490,6290,12780,11
KYEGEGWA,2023,6990,6760,13750,11
KYEGEGWA,2024,7540,7270,14810,11
KYEGEGWA,2025,8110,7800,15910,11
KYENJOJO,2015,5360,5170,10530,11
KYENJOJO,2016,5580,5360,10940,11
KYENJOJO,2017,5810,5560,11370,11
KYENJOJO,2018,6050,5760,11810,11
KYENJOJO,2019,6290,5970,12260,11
KYENJOJO,2020,6530,6180,12710,11
KYENJOJO,2021,6790,6400,13190,11
KYENJOJO,2022,7050,6610,13660,11
KYENJOJO,2023,7310,6830,14140,11
KYENJOJO,2024,7570,7060,14630,11
KYENJOJO,2025,7840,7280,15120,11
KYOTERA,2015,3890,3900,7790,11
KYOTERA,2016,3910,3900,7810,11
KYOTERA,2017,3930,3880,7810,11
KYOTERA,2018,3960,3880,7840,11
KYOTERA,2019,3990,3870,7860,11
KYOTERA,2020,4010,3870,7880,11
KYOTERA,2021,4000,3790,7790,11
KYOTERA,2022,3970,3760,7730,11
KYOTERA,2023,3950,3730,7680,11
KYOTERA,2024,3980,3760,7740,11
KYOTERA,2025,4130,3860,7990,11
KARENGA,2015,540,590,1130,11
KARENGA,2016,560,600,1160,11
KARENGA,2017,570,620,1190,11
KARENGA,2018,590,640,1230,11
KARENGA,2019,600,650,1250,11
KARENGA,2020,620,670,1290,11
KARENGA,2021,630,680,1310,11
KARENGA,2022,650,690,1340,11
KARENGA,2023,670,710,1380,11
KARENGA,2024,680,720,1400,11
KARENGA,2025,690,740,1430,11
LAMWO,2015,2100,2060,4160,11
LAMWO,2016,2100,2060,4160,11
LAMWO,2017,2100,2050,4150,11
LAMWO,2018,2090,2060,4150,11
LAMWO,2019,2090,2050,4140,11
LAMWO,2020,2100,2060,4160,11
LAMWO,2021,2070,2020,4090,11
LAMWO,2022,2040,2000,4040,11
LAMWO,2023,2010,1980,3990,11
LAMWO,2024,2020,2000,4020,11
LAMWO,2025,2080,2060,4140,11
LIRA,2015,5390,5680,11070,11
LIRA,2016,5540,5840,11380,11
LIRA,2017,5700,6010,11710,11
LIRA,2018,5850,6180,12030,11
LIRA,2019,6010,6350,12360,11
LIRA,2020,6170,6520,12690,11
LIRA,2021,6330,6700,13030,11
LIRA,2022,6490,6870,13360,11
LIRA,2023,6650,7040,13690,11
LIRA,2024,6810,7220,14030,11
LIRA,2025,6960,7390,14350,11
LUUKA,2015,3920,3800,7720,11
LUUKA,2016,3970,3800,7770,11
LUUKA,2017,4010,3820,7830,11
LUUKA,2018,4050,3830,7880,11
LUUKA,2019,4090,3860,7950,11
LUUKA,2020,4140,3880,8020,11
LUUKA,2021,4150,3820,7970,11
LUUKA,2022,4120,3810,7930,11
LUUKA,2023,4110,3800,7910,11
LUUKA,2024,4170,3850,8020,11
LUUKA,2025,4340,3980,8320,11
LUWERO,2015,7230,6910,14140,11
LUWERO,2016,7340,6950,14290,11
LUWERO,2017,7460,6990,14450,11
LUWERO,2018,7570,7040,14610,11
LUWERO,2019,7690,7100,14790,11
LUWERO,2020,7810,7150,14960,11
LUWERO,2021,7840,7070,14910,11
LUWERO,2022,7840,7060,14900,11
LUWERO,2023,7870,7080,14950,11
LUWERO,2024,8010,7180,15190,11
LUWERO,2025,8390,7450,15840,11
LWENGO,2015,4830,4470,9300,11
LWENGO,2016,4830,4430,9260,11
LWENGO,2017,4830,4400,9230,11
LWENGO,2018,4830,4370,9200,11
LWENGO,2019,4830,4350,9180,11
LWENGO,2020,4840,4330,9170,11
LWENGO,2021,4790,4230,9020,11
LWENGO,2022,4720,4170,8890,11
LWENGO,2023,4670,4120,8790,11
LWENGO,2024,4680,4120,8800,11
LWENGO,2025,4830,4220,9050,11
LYANTONDE,2015,1360,1380,2740,11
LYANTONDE,2016,1380,1400,2780,11
LYANTONDE,2017,1420,1410,2830,11
LYANTONDE,2018,1450,1430,2880,11
LYANTONDE,2019,1470,1450,2920,11
LYANTONDE,2020,1500,1470,2970,11
LYANTONDE,2021,1510,1470,2980,11
LYANTONDE,2022,1520,1470,2990,11
LYANTONDE,2023,1540,1470,3010,11
LYANTONDE,2024,1570,1510,3080,11
LYANTONDE,2025,1660,1570,3230,11
MANAFWA,2015,2150,2180,4330,11
MANAFWA,2016,2210,2230,4440,11
MANAFWA,2017,2260,2280,4540,11
MANAFWA,2018,2320,2330,4650,11
MANAFWA,2019,2370,2380,4750,11
MANAFWA,2020,2430,2430,4860,11
MANAFWA,2021,2490,2480,4970,11
MANAFWA,2022,2540,2530,5070,11
MANAFWA,2023,2590,2580,5170,11
MANAFWA,2024,2650,2630,5280,11
MANAFWA,2025,2700,2670,5370,11
MARACHA,2015,2470,2270,4740,11
MARACHA,2016,2520,2320,4840,11
MARACHA,2017,2570,2370,4940,11
MARACHA,2018,2630,2410,5040,11
MARACHA,2019,2680,2450,5130,11
MARACHA,2020,2730,2500,5230,11
MARACHA,2021,2780,2540,5320,11
MARACHA,2022,2830,2580,5410,11
MARACHA,2023,2880,2630,5510,11
MARACHA,2024,2930,2670,5600,11
MARACHA,2025,2980,2710,5690,11
MASAKA,2015,4340,4290,8630,11
MASAKA,2016,4400,4320,8720,11
MASAKA,2017,4440,4320,8760,11
MASAKA,2018,4500,4350,8850,11
MASAKA,2019,4560,4380,8940,11
MASAKA,2020,4620,4400,9020,11
MASAKA,2021,4630,4350,8980,11
MASAKA,2022,4610,4340,8950,11
MASAKA,2023,4620,4340,8960,11
MASAKA,2024,4690,4390,9080,11
MASAKA,2025,4900,4540,9440,11
MASINDI,2015,3350,3480,6830,11
MASINDI,2016,3450,3570,7020,11
MASINDI,2017,3550,3660,7210,11
MASINDI,2018,3650,3760,7410,11
MASINDI,2019,3750,3860,7610,11
MASINDI,2020,3860,3950,7810,11
MASINDI,2021,3960,4050,8010,11
MASINDI,2022,4070,4150,8220,11
MASINDI,2023,4170,4250,8420,11
MASINDI,2024,4270,4340,8610,11
MASINDI,2025,4380,4440,8820,11
MAYUGE,2015,7300,7080,14380,11
MAYUGE,2016,7470,7170,14640,11
MAYUGE,2017,7620,7270,14890,11
MAYUGE,2018,7780,7370,15150,11
MAYUGE,2019,7960,7500,15460,11
MAYUGE,2020,8130,7620,15750,11
MAYUGE,2021,8210,7590,15800,11
MAYUGE,2022,8270,7640,15910,11
MAYUGE,2023,8350,7730,16080,11
MAYUGE,2024,8560,7900,16460,11
MAYUGE,2025,9010,8250,17260,11
MBALE,2015,7230,7250,14480,11
MBALE,2016,7380,7380,14760,11
MBALE,2017,7530,7500,15030,11
MBALE,2018,7680,7620,15300,11
MBALE,2019,7840,7760,15600,11
MBALE,2020,8000,7910,15910,11
MBALE,2021,8080,7910,15990,11
MBALE,2022,8110,7980,16090,11
MBALE,2023,8190,8080,16270,11
MBALE,2024,8380,8280,16660,11
MBALE,2025,8820,8670,17490,11
MBARARA,2015,3880,4000,7880,11
MBARARA,2016,3970,4090,8060,11
MBARARA,2017,4060,4180,8240,11
MBARARA,2018,4160,4260,8420,11
MBARARA,2019,4250,4350,8600,11
MBARARA,2020,4340,4440,8780,11
MBARARA,2021,4430,4530,8960,11
MBARARA,2022,4520,4610,9130,11
MBARARA,2023,4610,4700,9310,11
MBARARA,2024,4690,4770,9460,11
MBARARA,2025,4780,4860,9640,11
MITOOMA,2015,2540,2500,5040,11
MITOOMA,2016,2570,2520,5090,11
MITOOMA,2017,2610,2550,5160,11
MITOOMA,2018,2640,2570,5210,11
MITOOMA,2019,2670,2590,5260,11
MITOOMA,2020,2690,2610,5300,11
MITOOMA,2021,2720,2630,5350,11
MITOOMA,2022,2750,2650,5400,11
MITOOMA,2023,2770,2660,5430,11
MITOOMA,2024,2790,2680,5470,11
MITOOMA,2025,2810,2690,5500,11
MITYANA,2015,5090,4750,9840,11
MITYANA,2016,5130,4740,9870,11
MITYANA,2017,5170,4730,9900,11
MITYANA,2018,5210,4740,9950,11
MITYANA,2019,5250,4750,10000,11
MITYANA,2020,5300,4750,10050,11
MITYANA,2021,5280,4670,9950,11
MITYANA,2022,5250,4640,9890,11
MITYANA,2023,5240,4610,9850,11
MITYANA,2024,5290,4650,9940,11
MITYANA,2025,5500,4790,10290,11
MOROTO,2015,1020,980,2000,11
MOROTO,2016,1030,990,2020,11
MOROTO,2017,1040,990,2030,11
MOROTO,2018,1060,1000,2060,11
MOROTO,2019,1070,1010,2080,11
MOROTO,2020,1080,1020,2100,11
MOROTO,2021,1080,1010,2090,11
MOROTO,2022,1080,1010,2090,11
MOROTO,2023,1080,1020,2100,11
MOROTO,2024,1100,1040,2140,11
MOROTO,2025,1150,1080,2230,11
MOYO,2015,1300,1380,2680,11
MOYO,2016,1330,1410,2740,11
MOYO,2017,1360,1440,2800,11
MOYO,2018,1400,1470,2870,11
MOYO,2019,1430,1500,2930,11
MOYO,2020,1470,1530,3000,11
MOYO,2021,1500,1560,3060,11
MOYO,2022,1530,1590,3120,11
MOYO,2023,1570,1620,3190,11
MOYO,2024,1600,1650,3250,11
MOYO,2025,1630,1680,3310,11
MPIGI,2015,3970,3610,7580,11
MPIGI,2016,4020,3630,7650,11
MPIGI,2017,4080,3650,7730,11
MPIGI,2018,4130,3680,7810,11
MPIGI,2019,4200,3700,7900,11
MPIGI,2020,4260,3740,8000,11
MPIGI,2021,4280,3710,7990,11
MPIGI,2022,4270,3700,7970,11
MPIGI,2023,4280,3710,7990,11
MPIGI,2024,4350,3760,8110,11
MPIGI,2025,4550,3900,8450,11
MUBENDE,2015,5930,5600,11530,11
MUBENDE,2016,6180,5800,11980,11
MUBENDE,2017,6450,5990,12440,11
MUBENDE,2018,6730,6200,12930,11
MUBENDE,2019,7020,6430,13450,11
MUBENDE,2020,7310,6670,13980,11
MUBENDE,2021,7550,6790,14340,11
MUBENDE,2022,7760,6970,14730,11
MUBENDE,2023,8000,7180,15180,11
MUBENDE,2024,8360,7480,15840,11
MUBENDE,2025,8990,7980,16970,11
MUKONO,2015,8170,8040,16210,11
MUKONO,2016,8320,8140,16460,11
MUKONO,2017,8460,8240,16700,11
MUKONO,2018,8600,8350,16950,11
MUKONO,2019,8760,8470,17230,11
MUKONO,2020,8900,8600,17500,11
MUKONO,2021,8970,8570,17540,11
MUKONO,2022,8980,8610,17590,11
MUKONO,2023,9040,8690,17730,11
MUKONO,2024,9210,8870,18080,11
MUKONO,2025,9660,9250,18910,11
MADI OKOLLO,2015,1730,1590,3320,11
MADI OKOLLO,2016,1780,1640,3420,11
MADI OKOLLO,2017,1840,1680,3520,11
MADI OKOLLO,2018,1890,1730,3620,11
MADI OKOLLO,2019,1940,1770,3710,11
MADI OKOLLO,2020,1990,1810,3800,11
MADI OKOLLO,2021,2040,1860,3900,11
MADI OKOLLO,2022,2100,1910,4010,11
MADI OKOLLO,2023,2150,1950,4100,11
MADI OKOLLO,2024,2200,2000,4200,11
MADI OKOLLO,2025,2250,2040,4290,11
NABILATUK,2015,840,850,1690,11
NABILATUK,2016,870,870,1740,11
NABILATUK,2017,900,890,1790,11
NABILATUK,2018,940,920,1860,11
NABILATUK,2019,980,940,1920,11
NABILATUK,2020,1030,980,2010,11
NABILATUK,2021,1050,990,2040,11
NABILATUK,2022,1080,1010,2090,11
NABILATUK,2023,1110,1030,2140,11
NABILATUK,2024,1160,1070,2230,11
NABILATUK,2025,1250,1130,2380,11
NAKAPIRIPIRIT,2015,920,930,1850,11
NAKAPIRIPIRIT,2016,950,950,1900,11
NAKAPIRIPIRIT,2017,990,980,1970,11
NAKAPIRIPIRIT,2018,1020,1010,2030,11
NAKAPIRIPIRIT,2019,1060,1040,2100,11
NAKAPIRIPIRIT,2020,1090,1060,2150,11
NAKAPIRIPIRIT,2021,1120,1070,2190,11
NAKAPIRIPIRIT,2022,1130,1100,2230,11
NAKAPIRIPIRIT,2023,1170,1120,2290,11
NAKAPIRIPIRIT,2024,1200,1160,2360,11
NAKAPIRIPIRIT,2025,1290,1230,2520,11
NAKASEKE,2015,2390,2310,4700,11
NAKASEKE,2016,2480,2360,4840,11
NAKASEKE,2017,2570,2420,4990,11
NAKASEKE,2018,2660,2480,5140,11
NAKASEKE,2019,2760,2530,5290,11
NAKASEKE,2020,2860,2590,5450,11
NAKASEKE,2021,2950,2650,5600,11
NAKASEKE,2022,3050,2700,5750,11
NAKASEKE,2023,3150,2760,5910,11
NAKASEKE,2024,3250,2810,6060,11
NAKASEKE,2025,3350,2870,6220,11
NAKASONGOLA,2015,2860,2720,5580,11
NAKASONGOLA,2016,2920,2750,5670,11
NAKASONGOLA,2017,2980,2780,5760,11
NAKASONGOLA,2018,3040,2810,5850,11
NAKASONGOLA,2019,3120,2850,5970,11
NAKASONGOLA,2020,3180,2880,6060,11
NAKASONGOLA,2021,3220,2870,6090,11
NAKASONGOLA,2022,3240,2870,6110,11
NAKASONGOLA,2023,3280,2890,6170,11
NAKASONGOLA,2024,3350,2940,6290,11
NAKASONGOLA,2025,3530,3070,6600,11
NAMAYINGO,2015,3430,3370,6800,11
NAMAYINGO,2016,3460,3360,6820,11
NAMAYINGO,2017,3480,3350,6830,11
NAMAYINGO,2018,3510,3350,6860,11
NAMAYINGO,2019,3550,3350,6900,11
NAMAYINGO,2020,3580,3350,6930,11
NAMAYINGO,2021,3570,3290,6860,11
NAMAYINGO,2022,3550,3270,6820,11
NAMAYINGO,2023,3540,3250,6790,11
NAMAYINGO,2024,3580,3270,6850,11
NAMAYINGO,2025,3730,3360,7090,11
NAMISINDWA,2015,2810,2920,5730,11
NAMISINDWA,2016,2890,2990,5880,11
NAMISINDWA,2017,2970,3060,6030,11
NAMISINDWA,2018,3050,3130,6180,11
NAMISINDWA,2019,3140,3200,6340,11
NAMISINDWA,2020,3220,3270,6490,11
NAMISINDWA,2021,3300,3340,6640,11
NAMISINDWA,2022,3390,3410,6800,11
NAMISINDWA,2023,3470,3490,6960,11
NAMISINDWA,2024,3550,3550,7100,11
NAMISINDWA,2025,3630,3620,7250,11
NAMUTUMBA,2015,4160,3860,8020,11
NAMUTUMBA,2016,4270,3920,8190,11
NAMUTUMBA,2017,4370,3980,8350,11
NAMUTUMBA,2018,4490,4050,8540,11
NAMUTUMBA,2019,4610,4130,8740,11
NAMUTUMBA,2020,4720,4200,8920,11
NAMUTUMBA,2021,4790,4190,8980,11
NAMUTUMBA,2022,4840,4230,9070,11
NAMUTUMBA,2023,4900,4270,9170,11
NAMUTUMBA,2024,5040,4380,9420,11
NAMUTUMBA,2025,5330,4590,9920,11
NAPAK,2015,1540,1590,3130,11
NAPAK,2016,1550,1600,3150,11
NAPAK,2017,1570,1610,3180,11
NAPAK,2018,1570,1620,3190,11
NAPAK,2019,1580,1620,3200,11
NAPAK,2020,1590,1630,3220,11
NAPAK,2021,1580,1610,3190,11
NAPAK,2022,1580,1610,3190,11
NAPAK,2023,1570,1610,3180,11
NAPAK,2024,1570,1630,3200,11
NAPAK,2025,1640,1690,3330,11
NEBBI,2015,3380,3270,6650,11
NEBBI,2016,3490,3360,6850,11
NEBBI,2017,3600,3460,7060,11
NEBBI,2018,3710,3550,7260,11
NEBBI,2019,3830,3650,7480,11
NEBBI,2020,3940,3750,7690,11
NEBBI,2021,4060,3850,7910,11
NEBBI,2022,4170,3950,8120,11
NEBBI,2023,4290,4050,8340,11
NEBBI,2024,4410,4140,8550,11
NEBBI,2025,4520,4240,8760,11
NGORA,2015,2370,2310,4680,11
NGORA,2016,2420,2330,4750,11
NGORA,2017,2460,2350,4810,11
NGORA,2018,2510,2370,4880,11
NGORA,2019,2560,2400,4960,11
NGORA,2020,2600,2430,5030,11
NGORA,2021,2630,2410,5040,11
NGORA,2022,2640,2410,5050,11
NGORA,2023,2650,2430,5080,11
NGORA,2024,2700,2470,5170,11
NGORA,2025,2850,2570,5420,11
NTOROKO,2015,870,840,1710,11
NTOROKO,2016,880,850,1730,11
NTOROKO,2017,890,840,1730,11
NTOROKO,2018,910,840,1750,11
NTOROKO,2019,920,850,1770,11
NTOROKO,2020,940,850,1790,11
NTOROKO,2021,940,840,1780,11
NTOROKO,2022,940,840,1780,11
NTOROKO,2023,940,840,1780,11
NTOROKO,2024,960,850,1810,11
NTOROKO,2025,1010,870,1880,11
NTUNGAMO,2015,6520,6470,12990,11
NTUNGAMO,2016,6670,6600,13270,11
NTUNGAMO,2017,6810,6720,13530,11
NTUNGAMO,2018,6950,6840,13790,11
NTUNGAMO,2019,7100,6960,14060,11
NTUNGAMO,2020,7240,7080,14320,11
NTUNGAMO,2021,7380,7200,14580,11
NTUNGAMO,2022,7510,7310,14820,11
NTUNGAMO,2023,7650,7420,15070,11
NTUNGAMO,2024,7780,7530,15310,11
NTUNGAMO,2025,7900,7640,15540,11
NWOYA,2015,2150,1910,4060,11
NWOYA,2016,2380,2110,4490,11
NWOYA,2017,2630,2320,4950,11
NWOYA,2018,2900,2560,5460,11
NWOYA,2019,3200,2810,6010,11
NWOYA,2020,3530,3100,6630,11
NWOYA,2021,3890,3410,7300,11
NWOYA,2022,4280,3740,8020,11
NWOYA,2023,4720,4110,8830,11
NWOYA,2024,5190,4510,9700,11
NWOYA,2025,5700,4950,10650,11
OBONGI,2015,570,630,1200,11
OBONGI,2016,570,630,1200,11
OBONGI,2017,590,630,1220,11
OBONGI,2018,600,630,1230,11
OBONGI,2019,600,630,1230,11
OBONGI,2020,610,640,1250,11
OBONGI,2021,620,640,1260,11
OBONGI,2022,620,630,1250,11
OBONGI,2023,620,630,1250,11
OBONGI,2024,620,640,1260,11
OBONGI,2025,660,660,1320,11
OMORO,2015,2740,2570,5310,11
OMORO,2016,2820,2610,5430,11
OMORO,2017,2880,2660,5540,11
OMORO,2018,2950,2710,5660,11
OMORO,2019,3040,2760,5800,11
OMORO,2020,3110,2820,5930,11
OMORO,2021,3150,2820,5970,11
OMORO,2022,3190,2850,6040,11
OMORO,2023,3230,2880,6110,11
OMORO,2024,3330,2960,6290,11
OMORO,2025,3520,3110,6630,11
OTUKE,2015,1450,1340,2790,11
OTUKE,2016,1520,1400,2920,11
OTUKE,2017,1590,1460,3050,11
OTUKE,2018,1660,1520,3180,11
OTUKE,2019,1730,1580,3310,11
OTUKE,2020,1810,1650,3460,11
OTUKE,2021,1880,1720,3600,11
OTUKE,2022,1960,1790,3750,11
OTUKE,2023,2040,1860,3900,11
OTUKE,2024,2130,1930,4060,11
OTUKE,2025,2210,2000,4210,11
OYAM,2015,5630,5540,11170,11
OYAM,2016,5810,5710,11520,11
OYAM,2017,5980,5880,11860,11
OYAM,2018,6170,6040,12210,11
OYAM,2019,6350,6220,12570,11
OYAM,2020,6530,6390,12920,11
OYAM,2021,6720,6560,13280,11
OYAM,2022,6900,6740,13640,11
OYAM,2023,7090,6910,14000,11
OYAM,2024,7270,7080,14350,11
OYAM,2025,7460,7260,14720,11
PADER,2015,2770,2740,5510,11
PADER,2016,2800,2750,5550,11
PADER,2017,2820,2750,5570,11
PADER,2018,2840,2760,5600,11
PADER,2019,2850,2770,5620,11
PADER,2020,2890,2790,5680,11
PADER,2021,2870,2750,5620,11
PADER,2022,2850,2740,5590,11
PADER,2023,2840,2730,5570,11
PADER,2024,2860,2760,5620,11
PADER,2025,2970,2850,5820,11
PAKWACH,2015,2060,2030,4090,11
PAKWACH,2016,2150,2110,4260,11
PAKWACH,2017,2240,2180,4420,11
PAKWACH,2018,2340,2260,4600,11
PAKWACH,2019,2430,2340,4770,11
PAKWACH,2020,2530,2420,4950,11
PAKWACH,2021,2630,2510,5140,11
PAKWACH,2022,2730,2590,5320,11
PAKWACH,2023,2830,2680,5510,11
PAKWACH,2024,2940,2760,5700,11
PAKWACH,2025,3050,2850,5900,11
PALLISA,2015,4600,4560,9160,11
PALLISA,2016,4760,4690,9450,11
PALLISA,2017,4930,4800,9730,11
PALLISA,2018,5100,4930,10030,11
PALLISA,2019,5280,5080,10360,11
PALLISA,2020,5470,5230,10700,11
PALLISA,2021,5590,5270,10860,11
PALLISA,2022,5700,5370,11070,11
PALLISA,2023,5830,5490,11320,11
PALLISA,2024,6050,5680,11730,11
PALLISA,2025,6460,6010,12470,11
RAKAI,2015,4600,4420,9020,11
RAKAI,2016,4680,4450,9130,11
RAKAI,2017,4740,4480,9220,11
RAKAI,2018,4820,4510,9330,11
RAKAI,2019,4900,4550,9450,11
RAKAI,2020,4980,4590,9570,11
RAKAI,2021,5000,4530,9530,11
RAKAI,2022,5000,4530,9530,11
RAKAI,2023,5030,4550,9580,11
RAKAI,2024,5110,4610,9720,11
RAKAI,2025,5350,4780,10130,11
RUBANDA,2015,2550,2640,5190,11
RUBANDA,2016,2580,2660,5240,11
RUBANDA,2017,2620,2680,5300,11
RUBANDA,2018,2650,2700,5350,11
RUBANDA,2019,2680,2720,5400,11
RUBANDA,2020,2720,2740,5460,11
RUBANDA,2021,2750,2750,5500,11
RUBANDA,2022,2770,2770,5540,11
RUBANDA,2023,2800,2780,5580,11
RUBANDA,2024,2830,2790,5620,11
RUBANDA,2025,2850,2800,5650,11
RUBIRIZI,2015,1820,1770,3590,11
RUBIRIZI,2016,1860,1800,3660,11
RUBIRIZI,2017,1890,1840,3730,11
RUBIRIZI,2018,1930,1870,3800,11
RUBIRIZI,2019,1970,1900,3870,11
RUBIRIZI,2020,2010,1940,3950,11
RUBIRIZI,2021,2040,1970,4010,11
RUBIRIZI,2022,2080,2000,4080,11
RUBIRIZI,2023,2110,2030,4140,11
RUBIRIZI,2024,2150,2070,4220,11
RUBIRIZI,2025,2180,2090,4270,11
RUKIGA,2015,1290,1330,2620,11
RUKIGA,2016,1300,1340,2640,11
RUKIGA,2017,1310,1350,2660,11
RUKIGA,2018,1320,1350,2670,11
RUKIGA,2019,1340,1360,2700,11
RUKIGA,2020,1350,1370,2720,11
RUKIGA,2021,1360,1380,2740,11
RUKIGA,2022,1370,1380,2750,11
RUKIGA,2023,1380,1390,2770,11
RUKIGA,2024,1390,1390,2780,11
RUKIGA,2025,1390,1400,2790,11
RUKUNGIRI,2015,4260,4310,8570,11
RUKUNGIRI,2016,4310,4350,8660,11
RUKUNGIRI,2017,4360,4400,8760,11
RUKUNGIRI,2018,4410,4440,8850,11
RUKUNGIRI,2019,4460,4480,8940,11
RUKUNGIRI,2020,4510,4510,9020,11
RUKUNGIRI,2021,4550,4550,9100,11
RUKUNGIRI,2022,4590,4580,9170,11
RUKUNGIRI,2023,4630,4610,9240,11
RUKUNGIRI,2024,4670,4640,9310,11
RUKUNGIRI,2025,4700,4660,9360,11
RWAMPARA,2015,1740,1700,3440,11
RWAMPARA,2016,1780,1740,3520,11
RWAMPARA,2017,1820,1780,3600,11
RWAMPARA,2018,1860,1820,3680,11
RWAMPARA,2019,1900,1850,3750,11
RWAMPARA,2020,1940,1890,3830,11
RWAMPARA,2021,1980,1930,3910,11
RWAMPARA,2022,2020,1970,3990,11
RWAMPARA,2023,2060,2000,4060,11
RWAMPARA,2024,2100,2040,4140,11
RWAMPARA,2025,2130,2070,4200,11
SERERE,2015,4800,4820,9620,11
SERERE,2016,4960,4930,9890,11
SERERE,2017,5120,5040,10160,11
SERERE,2018,5270,5160,10430,11
SERERE,2019,5440,5290,10730,11
SERERE,2020,5600,5420,11020,11
SERERE,2021,5720,5450,11170,11
SERERE,2022,5800,5530,11330,11
SERERE,2023,5920,5630,11550,11
SERERE,2024,6120,5810,11930,11
SERERE,2025,6500,6120,12620,11
SHEEMA,2015,2930,2830,5760,11
SHEEMA,2016,2970,2860,5830,11
SHEEMA,2017,3010,2890,5900,11
SHEEMA,2018,3040,2920,5960,11
SHEEMA,2019,3080,2950,6030,11
SHEEMA,2020,3110,2970,6080,11
SHEEMA,2021,3140,3000,6140,11
SHEEMA,2022,3170,3020,6190,11
SHEEMA,2023,3200,3040,6240,11
SHEEMA,2024,3220,3060,6280,11
SHEEMA,2025,3240,3080,6320,11
SIRONKO,2015,3260,3000,6260,11
SIRONKO,2016,3340,3060,6400,11
SIRONKO,2017,3420,3120,6540,11
SIRONKO,2018,3500,3180,6680,11
SIRONKO,2019,3580,3240,6820,11
SIRONKO,2020,3660,3310,6970,11
SIRONKO,2021,3740,3370,7110,11
SIRONKO,2022,3820,3430,7250,11
SIRONKO,2023,3900,3480,7380,11
SIRONKO,2024,3970,3540,7510,11
SIRONKO,2025,4050,3600,7650,11
SOROTI,2015,4920,5000,9920,11
SOROTI,2016,5060,5090,10150,11
SOROTI,2017,5190,5190,10380,11
SOROTI,2018,5320,5280,10600,11
SOROTI,2019,5460,5390,10850,11
SOROTI,2020,5600,5500,11100,11
SOROTI,2021,5690,5500,11190,11
SOROTI,2022,5760,5560,11320,11
SOROTI,2023,5840,5640,11480,11
SOROTI,2024,6010,5790,11800,11
SOROTI,2025,6360,6080,12440,11
SSEMBABULE,2015,4190,4010,8200,11
SSEMBABULE,2016,4270,4050,8320,11
SSEMBABULE,2017,4350,4080,8430,11
SSEMBABULE,2018,4430,4140,8570,11
SSEMBABULE,2019,4520,4180,8700,11
SSEMBABULE,2020,4610,4240,8850,11
SSEMBABULE,2021,4640,4210,8850,11
SSEMBABULE,2022,4670,4220,8890,11
SSEMBABULE,2023,4700,4240,8940,11
SSEMBABULE,2024,4800,4320,9120,11
SSEMBABULE,2025,5040,4500,9540,11
TORORO,2015,7540,7580,15120,11
TORORO,2016,7750,7780,15530,11
TORORO,2017,7950,7970,15920,11
TORORO,2018,8160,8160,16320,11
TORORO,2019,8370,8360,16730,11
TORORO,2020,8580,8560,17140,11
TORORO,2021,8790,8750,17540,11
TORORO,2022,9000,8950,17950,11
TORORO,2023,9200,9150,18350,11
TORORO,2024,9410,9340,18750,11
TORORO,2025,9610,9530,19140,11
WAKISO,2015,19870,20380,40250,11
WAKISO,2016,21200,21770,42970,11
WAKISO,2017,22620,23260,45880,11
WAKISO,2018,24120,24830,48950,11
WAKISO,2019,25720,26500,52220,11
WAKISO,2020,27400,28260,55660,11
WAKISO,2021,29160,30140,59300,11
WAKISO,2022,31030,32130,63160,11
WAKISO,2023,33000,34190,67190,11
WAKISO,2024,35050,36370,71420,11
WAKISO,2025,37210,38680,75890,11
YUMBE,2015,7740,8730,16470,11
YUMBE,2016,8060,9080,17140,11
YUMBE,2017,8400,9470,17870,11
YUMBE,2018,8740,9880,18620,11
YUMBE,2019,9100,10320,19420,11
YUMBE,2020,9480,10770,20250,11
YUMBE,2021,9760,11030,20790,11
YUMBE,2022,10020,11420,21440,11
YUMBE,2023,10310,11850,22160,11
YUMBE,2024,10770,12450,23220,11
YUMBE,2025,11550,13370,24920,11
ZOMBO,2015,3390,3240,6630,11
ZOMBO,2016,3490,3330,6820,11
ZOMBO,2017,3600,3420,7020,11
ZOMBO,2018,3710,3510,7220,11
ZOMBO,2019,3820,3610,7430,11
ZOMBO,2020,3930,3710,7640,11
ZOMBO,2021,4040,3800,7840,11
ZOMBO,2022,4160,3900,8060,11
ZOMBO,2023,4270,3990,8260,11
ZOMBO,2024,4380,4090,8470,11
ZOMBO,2025,4490,4180,8670,11
ABIM,2015,2000,1950,3950,12
ABIM,2016,2120,2040,4160,12
ABIM,2017,2230,2120,4350,12
ABIM,2018,2350,2220,4570,12
ABIM,2019,2470,2310,4780,12
ABIM,2020,2610,2420,5030,12
ABIM,2021,2750,2530,5280,12
ABIM,2022,2870,2590,5460,12
ABIM,2023,2980,2690,5670,12
ABIM,2024,3100,2800,5900,12
ABIM,2025,3280,2950,6230,12
ADJUMANI,2015,3420,3330,6750,12
ADJUMANI,2016,3440,3370,6810,12
ADJUMANI,2017,3470,3400,6870,12
ADJUMANI,2018,3490,3430,6920,12
ADJUMANI,2019,3520,3460,6980,12
ADJUMANI,2020,3540,3490,7030,12
ADJUMANI,2021,3550,3520,7070,12
ADJUMANI,2022,3570,3540,7110,12
ADJUMANI,2023,3580,3570,7150,12
ADJUMANI,2024,3590,3590,7180,12
ADJUMANI,2025,3600,3610,7210,12
AGAGO,2015,3490,3390,6880,12
AGAGO,2016,3550,3450,7000,12
AGAGO,2017,3620,3510,7130,12
AGAGO,2018,3680,3570,7250,12
AGAGO,2019,3740,3630,7370,12
AGAGO,2020,3800,3690,7490,12
AGAGO,2021,3860,3750,7610,12
AGAGO,2022,3910,3810,7720,12
AGAGO,2023,3970,3860,7830,12
AGAGO,2024,4020,3910,7930,12
AGAGO,2025,4070,3960,8030,12
ALEBTONG,2015,3670,3540,7210,12
ALEBTONG,2016,3750,3580,7330,12
ALEBTONG,2017,3820,3620,7440,12
ALEBTONG,2018,3880,3650,7530,12
ALEBTONG,2019,3950,3690,7640,12
ALEBTONG,2020,4020,3730,7750,12
ALEBTONG,2021,4090,3790,7880,12
ALEBTONG,2022,4120,3760,7880,12
ALEBTONG,2023,4130,3770,7900,12
ALEBTONG,2024,4160,3790,7950,12
ALEBTONG,2025,4250,3860,8110,12
AMOLATAR,2015,2410,2260,4670,12
AMOLATAR,2016,2450,2280,4730,12
AMOLATAR,2017,2500,2300,4800,12
AMOLATAR,2018,2540,2320,4860,12
AMOLATAR,2019,2580,2330,4910,12
AMOLATAR,2020,2620,2360,4980,12
AMOLATAR,2021,2660,2380,5040,12
AMOLATAR,2022,2670,2360,5030,12
AMOLATAR,2023,2680,2360,5040,12
AMOLATAR,2024,2690,2370,5060,12
AMOLATAR,2025,2740,2410,5150,12
AMUDAT,2015,2170,1860,4030,12
AMUDAT,2016,2250,1920,4170,12
AMUDAT,2017,2310,1980,4290,12
AMUDAT,2018,2380,2030,4410,12
AMUDAT,2019,2440,2100,4540,12
AMUDAT,2020,2520,2160,4680,12
AMUDAT,2021,2590,2230,4820,12
AMUDAT,2022,2640,2260,4900,12
AMUDAT,2023,2680,2310,4990,12
AMUDAT,2024,2720,2370,5090,12
AMUDAT,2025,2810,2450,5260,12
AMURIA,2015,2880,2820,5700,12
AMURIA,2016,2970,2880,5850,12
AMURIA,2017,3040,2930,5970,12
AMURIA,2018,3130,2990,6120,12
AMURIA,2019,3210,3040,6250,12
AMURIA,2020,3310,3100,6410,12
AMURIA,2021,3390,3160,6550,12
AMURIA,2022,3450,3160,6610,12
AMURIA,2023,3490,3190,6680,12
AMURIA,2024,3540,3240,6780,12
AMURIA,2025,3650,3320,6970,12
AMURU,2015,3310,3110,6420,12
AMURU,2016,3370,3140,6510,12
AMURU,2017,3440,3180,6620,12
AMURU,2018,3490,3200,6690,12
AMURU,2019,3540,3240,6780,12
AMURU,2020,3600,3280,6880,12
AMURU,2021,3660,3320,6980,12
AMURU,2022,3670,3280,6950,12
AMURU,2023,3670,3290,6960,12
AMURU,2024,3700,3310,7010,12
AMURU,2025,3760,3370,7130,12
APAC,2015,2970,3090,6060,12
APAC,2016,3080,3200,6280,12
APAC,2017,3190,3310,6500,12
APAC,2018,3310,3420,6730,12
APAC,2019,3420,3530,6950,12
APAC,2020,3550,3650,7200,12
APAC,2021,3670,3770,7440,12
APAC,2022,3790,3890,7680,12
APAC,2023,3920,4010,7930,12
APAC,2024,4040,4140,8180,12
APAC,2025,4170,4260,8430,12
ARUA,2015,9640,9910,19550,12
ARUA,2016,9920,10170,20090,12
ARUA,2017,10200,10460,20660,12
ARUA,2018,10490,10730,21220,12
ARUA,2019,10790,11020,21810,12
ARUA,2020,11080,11300,22380,12
ARUA,2021,11380,11580,22960,12
ARUA,2022,11670,11860,23530,12
ARUA,2023,11970,12150,24120,12
ARUA,2024,12260,12430,24690,12
ARUA,2025,12550,12710,25260,12
BUDAKA,2015,3260,3200,6460,12
BUDAKA,2016,3350,3260,6610,12
BUDAKA,2017,3450,3320,6770,12
BUDAKA,2018,3530,3380,6910,12
BUDAKA,2019,3620,3440,7060,12
BUDAKA,2020,3720,3500,7220,12
BUDAKA,2021,3810,3560,7370,12
BUDAKA,2022,3860,3570,7430,12
BUDAKA,2023,3910,3600,7510,12
BUDAKA,2024,3960,3650,7610,12
BUDAKA,2025,4070,3740,7810,12
BUDUDA,2015,3730,3660,7390,12
BUDUDA,2016,3870,3780,7650,12
BUDUDA,2017,4000,3880,7880,12
BUDUDA,2018,4140,3990,8130,12
BUDUDA,2019,4280,4090,8370,12
BUDUDA,2020,4440,4220,8660,12
BUDUDA,2021,4600,4350,8950,12
BUDUDA,2022,4710,4390,9100,12
BUDUDA,2023,4790,4480,9270,12
BUDUDA,2024,4900,4580,9480,12
BUDUDA,2025,5090,4740,9830,12
BUGIRI,2015,6040,5950,11990,12
BUGIRI,2016,6250,6100,12350,12
BUGIRI,2017,6440,6230,12670,12
BUGIRI,2018,6640,6360,13000,12
BUGIRI,2019,6840,6510,13350,12
BUGIRI,2020,7060,6670,13730,12
BUGIRI,2021,7270,6830,14100,12
BUGIRI,2022,7420,6860,14280,12
BUGIRI,2023,7530,6960,14490,12
BUGIRI,2024,7680,7090,14770,12
BUGIRI,2025,7930,7290,15220,12
BUGWERI,2015,2770,2770,5540,12
BUGWERI,2016,2830,2800,5630,12
BUGWERI,2017,2880,2820,5700,12
BUGWERI,2018,2930,2850,5780,12
BUGWERI,2019,2980,2880,5860,12
BUGWERI,2020,3030,2910,5940,12
BUGWERI,2021,3090,2940,6030,12
BUGWERI,2022,3110,2910,6020,12
BUGWERI,2023,3110,2920,6030,12
BUGWERI,2024,3130,2930,6060,12
BUGWERI,2025,3190,2990,6180,12
BUHWEJU,2015,1830,1830,3660,12
BUHWEJU,2016,1890,1880,3770,12
BUHWEJU,2017,1950,1940,3890,12
BUHWEJU,2018,2010,2000,4010,12
BUHWEJU,2019,2070,2060,4130,12
BUHWEJU,2020,2140,2120,4260,12
BUHWEJU,2021,2200,2180,4380,12
BUHWEJU,2022,2270,2240,4510,12
BUHWEJU,2023,2330,2300,4630,12
BUHWEJU,2024,2400,2360,4760,12
BUHWEJU,2025,2460,2420,4880,12
BUIKWE,2015,6310,6300,12610,12
BUIKWE,2016,6390,6350,12740,12
BUIKWE,2017,6460,6360,12820,12
BUIKWE,2018,6530,6380,12910,12
BUIKWE,2019,6590,6410,13000,12
BUIKWE,2020,6660,6440,13100,12
BUIKWE,2021,6730,6480,13210,12
BUIKWE,2022,6720,6400,13120,12
BUIKWE,2023,6680,6370,13050,12
BUIKWE,2024,6680,6370,13050,12
BUIKWE,2025,6770,6440,13210,12
BUKEDEA,2015,3360,3200,6560,12
BUKEDEA,2016,3480,3290,6770,12
BUKEDEA,2017,3600,3370,6970,12
BUKEDEA,2018,3730,3440,7170,12
BUKEDEA,2019,3850,3530,7380,12
BUKEDEA,2020,3980,3630,7610,12
BUKEDEA,2021,4120,3720,7840,12
BUKEDEA,2022,4220,3740,7960,12
BUKEDEA,2023,4300,3800,8100,12
BUKEDEA,2024,4390,3880,8270,12
BUKEDEA,2025,4550,4010,8560,12
BUKOMANSIMBI,2015,2670,2520,5190,12
BUKOMANSIMBI,2016,2670,2490,5160,12
BUKOMANSIMBI,2017,2670,2460,5130,12
BUKOMANSIMBI,2018,2660,2430,5090,12
BUKOMANSIMBI,2019,2660,2410,5070,12
BUKOMANSIMBI,2020,2650,2380,5030,12
BUKOMANSIMBI,2021,2650,2360,5010,12
BUKOMANSIMBI,2022,2620,2290,4910,12
BUKOMANSIMBI,2023,2570,2250,4820,12
BUKOMANSIMBI,2024,2530,2210,4740,12
BUKOMANSIMBI,2025,2530,2200,4730,12
BUKWO,2015,1470,1380,2850,12
BUKWO,2016,1550,1450,3000,12
BUKWO,2017,1630,1520,3150,12
BUKWO,2018,1720,1600,3320,12
BUKWO,2019,1810,1670,3480,12
BUKWO,2020,1900,1750,3650,12
BUKWO,2021,2000,1830,3830,12
BUKWO,2022,2100,1920,4020,12
BUKWO,2023,2210,2010,4220,12
BUKWO,2024,2310,2100,4410,12
BUKWO,2025,2430,2190,4620,12
BULAMBULI,2015,2910,2810,5720,12
BULAMBULI,2016,3040,2920,5960,12
BULAMBULI,2017,3160,3010,6170,12
BULAMBULI,2018,3280,3100,6380,12
BULAMBULI,2019,3410,3200,6610,12
BULAMBULI,2020,3540,3310,6850,12
BULAMBULI,2021,3680,3420,7100,12
BULAMBULI,2022,3790,3470,7260,12
BULAMBULI,2023,3870,3560,7430,12
BULAMBULI,2024,3980,3660,7640,12
BULAMBULI,2025,4140,3810,7950,12
BULIISA,2015,1670,1540,3210,12
BULIISA,2016,1760,1610,3370,12
BULIISA,2017,1860,1680,3540,12
BULIISA,2018,1960,1760,3720,12
BULIISA,2019,2060,1830,3890,12
BULIISA,2020,2170,1910,4080,12
BULIISA,2021,2290,1990,4280,12
BULIISA,2022,2400,2070,4470,12
BULIISA,2023,2530,2160,4690,12
BULIISA,2024,2650,2250,4900,12
BULIISA,2025,2780,2330,5110,12
BUNDIBUGYO,2015,3390,3450,6840,12
BUNDIBUGYO,2016,3460,3500,6960,12
BUNDIBUGYO,2017,3530,3540,7070,12
BUNDIBUGYO,2018,3600,3570,7170,12
BUNDIBUGYO,2019,3670,3610,7280,12
BUNDIBUGYO,2020,3740,3650,7390,12
BUNDIBUGYO,2021,3820,3700,7520,12
BUNDIBUGYO,2022,3860,3670,7530,12
BUNDIBUGYO,2023,3870,3690,7560,12
BUNDIBUGYO,2024,3900,3710,7610,12
BUNDIBUGYO,2025,3990,3770,7760,12
BUNYANGABU,2015,2480,2430,4910,12
BUNYANGABU,2016,2520,2450,4970,12
BUNYANGABU,2017,2570,2460,5030,12
BUNYANGABU,2018,2600,2480,5080,12
BUNYANGABU,2019,2650,2500,5150,12
BUNYANGABU,2020,2690,2510,5200,12
BUNYANGABU,2021,2730,2530,5260,12
BUNYANGABU,2022,2740,2510,5250,12
BUNYANGABU,2023,2740,2500,5240,12
BUNYANGABU,2024,2750,2510,5260,12
BUNYANGABU,2025,2800,2540,5340,12
BUSHENYI,2015,3400,3410,6810,12
BUSHENYI,2016,3450,3450,6900,12
BUSHENYI,2017,3490,3480,6970,12
BUSHENYI,2018,3530,3510,7040,12
BUSHENYI,2019,3570,3540,7110,12
BUSHENYI,2020,3610,3560,7170,12
BUSHENYI,2021,3650,3590,7240,12
BUSHENYI,2022,3680,3610,7290,12
BUSHENYI,2023,3710,3630,7340,12
BUSHENYI,2024,3740,3650,7390,12
BUSHENYI,2025,3770,3660,7430,12
BUSIA,2015,5120,4930,10050,12
BUSIA,2016,5250,5000,10250,12
BUSIA,2017,5370,5050,10420,12
BUSIA,2018,5480,5110,10590,12
BUSIA,2019,5590,5180,10770,12
BUSIA,2020,5710,5250,10960,12
BUSIA,2021,5830,5320,11150,12
BUSIA,2022,5900,5290,11190,12
BUSIA,2023,5930,5320,11250,12
BUSIA,2024,5990,5360,11350,12
BUSIA,2025,6130,5470,11600,12
BUTALEJA,2015,3730,3610,7340,12
BUTALEJA,2016,3840,3680,7520,12
BUTALEJA,2017,3950,3750,7700,12
BUTALEJA,2018,4060,3820,7880,12
BUTALEJA,2019,4160,3890,8050,12
BUTALEJA,2020,4280,3980,8260,12
BUTALEJA,2021,4400,4050,8450,12
BUTALEJA,2022,4480,4060,8540,12
BUTALEJA,2023,4520,4100,8620,12
BUTALEJA,2024,4600,4160,8760,12
BUTALEJA,2025,4740,4270,9010,12
BUTAMBALA,2015,1770,1670,3440,12
BUTAMBALA,2016,1790,1650,3440,12
BUTAMBALA,2017,1790,1650,3440,12
BUTAMBALA,2018,1790,1640,3430,12
BUTAMBALA,2019,1800,1630,3430,12
BUTAMBALA,2020,1810,1620,3430,12
BUTAMBALA,2021,1820,1620,3440,12
BUTAMBALA,2022,1800,1580,3380,12
BUTAMBALA,2023,1780,1550,3330,12
BUTAMBALA,2024,1770,1550,3320,12
BUTAMBALA,2025,1780,1550,3330,12
BUTEBO,2015,1710,1750,3460,12
BUTEBO,2016,1730,1750,3480,12
BUTEBO,2017,1740,1740,3480,12
BUTEBO,2018,1750,1740,3490,12
BUTEBO,2019,1760,1730,3490,12
BUTEBO,2020,1770,1730,3500,12
BUTEBO,2021,1780,1720,3500,12
BUTEBO,2022,1780,1690,3470,12
BUTEBO,2023,1750,1670,3420,12
BUTEBO,2024,1740,1660,3400,12
BUTEBO,2025,1760,1670,3430,12
BUVUMA,2015,870,930,1800,12
BUVUMA,2016,930,1000,1930,12
BUVUMA,2017,980,1070,2050,12
BUVUMA,2018,1040,1140,2180,12
BUVUMA,2019,1110,1210,2320,12
BUVUMA,2020,1170,1290,2460,12
BUVUMA,2021,1240,1380,2620,12
BUVUMA,2022,1320,1470,2790,12
BUVUMA,2023,1390,1560,2950,12
BUVUMA,2024,1470,1660,3130,12
BUVUMA,2025,1560,1760,3320,12
BUYENDE,2015,5200,4900,10100,12
BUYENDE,2016,5400,5040,10440,12
BUYENDE,2017,5590,5170,10760,12
BUYENDE,2018,5780,5300,11080,12
BUYENDE,2019,5980,5440,11420,12
BUYENDE,2020,6190,5600,11790,12
BUYENDE,2021,6400,5760,12160,12
BUYENDE,2022,6560,5810,12370,12
BUYENDE,2023,6670,5920,12590,12
BUYENDE,2024,6830,6050,12880,12
BUYENDE,2025,7080,6260,13340,12
DOKOLO,2015,2960,2920,5880,12
DOKOLO,2016,3050,3000,6050,12
DOKOLO,2017,3150,3080,6230,12
DOKOLO,2018,3240,3170,6410,12
DOKOLO,2019,3340,3250,6590,12
DOKOLO,2020,3430,3340,6770,12
DOKOLO,2021,3530,3420,6950,12
DOKOLO,2022,3630,3500,7130,12
DOKOLO,2023,3730,3590,7320,12
DOKOLO,2024,3820,3680,7500,12
DOKOLO,2025,3920,3760,7680,12
GOMBA,2015,2550,2410,4960,12
GOMBA,2016,2570,2410,4980,12
GOMBA,2017,2590,2400,4990,12
GOMBA,2018,2610,2390,5000,12
GOMBA,2019,2640,2370,5010,12
GOMBA,2020,2650,2370,5020,12
GOMBA,2021,2680,2360,5040,12
GOMBA,2022,2660,2310,4970,12
GOMBA,2023,2640,2290,4930,12
GOMBA,2024,2630,2270,4900,12
GOMBA,2025,2660,2270,4930,12
GULU,2015,4000,4040,8040,12
GULU,2016,4120,4160,8280,12
GULU,2017,4250,4280,8530,12
GULU,2018,4370,4410,8780,12
GULU,2019,4500,4530,9030,12
GULU,2020,4630,4660,9290,12
GULU,2021,4760,4780,9540,12
GULU,2022,4890,4910,9800,12
GULU,2023,5020,5040,10060,12
GULU,2024,5150,5160,10310,12
GULU,2025,5270,5290,10560,12
HOIMA,2015,4220,4150,8370,12
HOIMA,2016,4380,4300,8680,12
HOIMA,2017,4550,4450,9000,12
HOIMA,2018,4720,4600,9320,12
HOIMA,2019,4890,4750,9640,12
HOIMA,2020,5060,4910,9970,12
HOIMA,2021,5240,5070,10310,12
HOIMA,2022,5420,5230,10650,12
HOIMA,2023,5610,5400,11010,12
HOIMA,2024,5790,5560,11350,12
HOIMA,2025,5980,5730,11710,12
IBANDA,2015,3660,3690,7350,12
IBANDA,2016,3730,3760,7490,12
IBANDA,2017,3800,3820,7620,12
IBANDA,2018,3880,3890,7770,12
IBANDA,2019,3950,3960,7910,12
IBANDA,2020,4020,4020,8040,12
IBANDA,2021,4090,4090,8180,12
IBANDA,2022,4160,4150,8310,12
IBANDA,2023,4230,4210,8440,12
IBANDA,2024,4290,4270,8560,12
IBANDA,2025,4360,4330,8690,12
IGANGA,2015,5370,5400,10770,12
IGANGA,2016,5500,5480,10980,12
IGANGA,2017,5620,5550,11170,12
IGANGA,2018,5740,5600,11340,12
IGANGA,2019,5860,5680,11540,12
IGANGA,2020,5990,5760,11750,12
IGANGA,2021,6120,5840,11960,12
IGANGA,2022,6180,5810,11990,12
IGANGA,2023,6210,5840,12050,12
IGANGA,2024,6270,5880,12150,12
IGANGA,2025,6430,6000,12430,12
ISINGIRO,2015,7390,7700,15090,12
ISINGIRO,2016,7670,7980,15650,12
ISINGIRO,2017,7960,8260,16220,12
ISINGIRO,2018,8250,8550,16800,12
ISINGIRO,2019,8550,8840,17390,12
ISINGIRO,2020,8860,9140,18000,12
ISINGIRO,2021,9170,9440,18610,12
ISINGIRO,2022,9480,9750,19230,12
ISINGIRO,2023,9800,10060,19860,12
ISINGIRO,2024,10130,10370,20500,12
ISINGIRO,2025,10450,10690,21140,12
JINJA,2015,6690,7070,13760,12
JINJA,2016,6810,7180,13990,12
JINJA,2017,6920,7290,14210,12
JINJA,2018,7040,7400,14440,12
JINJA,2019,7150,7510,14660,12
JINJA,2020,7260,7610,14870,12
JINJA,2021,7360,7710,15070,12
JINJA,2022,7460,7810,15270,12
JINJA,2023,7560,7900,15460,12
JINJA,2024,7660,7990,15650,12
JINJA,2025,7740,8080,15820,12
KAABONG,2015,1800,1930,3730,12
KAABONG,2016,1840,1980,3820,12
KAABONG,2017,1900,2030,3930,12
KAABONG,2018,1940,2080,4020,12
KAABONG,2019,2000,2120,4120,12
KAABONG,2020,2040,2180,4220,12
KAABONG,2021,2100,2230,4330,12
KAABONG,2022,2150,2280,4430,12
KAABONG,2023,2200,2320,4520,12
KAABONG,2024,2250,2370,4620,12
KAABONG,2025,2300,2410,4710,12
KABALE,2015,3150,3120,6270,12
KABALE,2016,3200,3160,6360,12
KABALE,2017,3250,3200,6450,12
KABALE,2018,3300,3240,6540,12
KABALE,2019,3350,3270,6620,12
KABALE,2020,3390,3310,6700,12
KABALE,2021,3440,3340,6780,12
KABALE,2022,3480,3370,6850,12
KABALE,2023,3520,3400,6920,12
KABALE,2024,3560,3430,6990,12
KABALE,2025,3600,3450,7050,12
KABAROLE,2015,3920,3860,7780,12
KABAROLE,2016,4010,3950,7960,12
KABAROLE,2017,4100,4040,8140,12
KABAROLE,2018,4190,4120,8310,12
KABAROLE,2019,4280,4210,8490,12
KABAROLE,2020,4360,4290,8650,12
KABAROLE,2021,4450,4380,8830,12
KABAROLE,2022,4530,4460,8990,12
KABAROLE,2023,4620,4540,9160,12
KABAROLE,2024,4700,4620,9320,12
KABAROLE,2025,4780,4700,9480,12
KABERAMAIDO,2015,1690,1610,3300,12
KABERAMAIDO,2016,1750,1640,3390,12
KABERAMAIDO,2017,1810,1680,3490,12
KABERAMAIDO,2018,1870,1720,3590,12
KABERAMAIDO,2019,1930,1770,3700,12
KABERAMAIDO,2020,2000,1810,3810,12
KABERAMAIDO,2021,2050,1850,3900,12
KABERAMAIDO,2022,2100,1860,3960,12
KABERAMAIDO,2023,2130,1890,4020,12
KABERAMAIDO,2024,2190,1930,4120,12
KABERAMAIDO,2025,2260,1990,4250,12
KAGADI,2015,5200,5260,10460,12
KAGADI,2016,5400,5440,10840,12
KAGADI,2017,5600,5640,11240,12
KAGADI,2018,5800,5830,11630,12
KAGADI,2019,6010,6030,12040,12
KAGADI,2020,6220,6240,12460,12
KAGADI,2021,6440,6450,12890,12
KAGADI,2022,6660,6650,13310,12
KAGADI,2023,6880,6870,13750,12
KAGADI,2024,7100,7080,14180,12
KAGADI,2025,7330,7300,14630,12
KAKUMIRO,2015,4170,4230,8400,12
KAKUMIRO,2016,4540,4580,9120,12
KAKUMIRO,2017,4940,4970,9910,12
KAKUMIRO,2018,5380,5380,10760,12
KAKUMIRO,2019,5850,5830,11680,12
KAKUMIRO,2020,6360,6310,12670,12
KAKUMIRO,2021,6900,6830,13730,12
KAKUMIRO,2022,7490,7390,14880,12
KAKUMIRO,2023,8120,7980,16100,12
KAKUMIRO,2024,8810,8620,17430,12
KAKUMIRO,2025,9540,9300,18840,12
KALAKI,2015,1790,1770,3560,12
KALAKI,2016,1870,1840,3710,12
KALAKI,2017,1950,1910,3860,12
KALAKI,2018,2040,1990,4030,12
KALAKI,2019,2120,2070,4190,12
KALAKI,2020,2210,2150,4360,12
KALAKI,2021,2300,2230,4530,12
KALAKI,2022,2390,2310,4700,12
KALAKI,2023,2490,2390,4880,12
KALAKI,2024,2580,2480,5060,12
KALAKI,2025,2680,2560,5240,12
KALANGALA,2015,360,330,690,12
KALANGALA,2016,370,340,710,12
KALANGALA,2017,380,350,730,12
KALANGALA,2018,400,370,770,12
KALANGALA,2019,410,380,790,12
KALANGALA,2020,430,400,830,12
KALANGALA,2021,440,410,850,12
KALANGALA,2022,450,430,880,12
KALANGALA,2023,470,450,920,12
KALANGALA,2024,480,460,940,12
KALANGALA,2025,500,480,980,12
KALIRO,2015,3750,3750,7500,12
KALIRO,2016,3860,3830,7690,12
KALIRO,2017,3960,3900,7860,12
KALIRO,2018,4050,3970,8020,12
KALIRO,2019,4150,4040,8190,12
KALIRO,2020,4260,4120,8380,12
KALIRO,2021,4370,4200,8570,12
KALIRO,2022,4440,4210,8650,12
KALIRO,2023,4480,4260,8740,12
KALIRO,2024,4540,4310,8850,12
KALIRO,2025,4670,4420,9090,12
KALUNGU,2015,3000,2960,5960,12
KALUNGU,2016,3010,2940,5950,12
KALUNGU,2017,3020,2920,5940,12
KALUNGU,2018,3010,2900,5910,12
KALUNGU,2019,3020,2890,5910,12
KALUNGU,2020,3020,2870,5890,12
KALUNGU,2021,3020,2850,5870,12
KALUNGU,2022,3000,2790,5790,12
KALUNGU,2023,2960,2750,5710,12
KALUNGU,2024,2920,2720,5640,12
KALUNGU,2025,2940,2720,5660,12
KAMPALA,2015,12510,14770,27280,12
KAMPALA,2016,12760,15060,27820,12
KAMPALA,2017,13010,15360,28370,12
KAMPALA,2018,13270,15650,28920,12
KAMPALA,2019,13510,15940,29450,12
KAMPALA,2020,13760,16220,29980,12
KAMPALA,2021,14000,16500,30500,12
KAMPALA,2022,14240,16780,31020,12
KAMPALA,2023,14470,17050,31520,12
KAMPALA,2024,14690,17310,32000,12
KAMPALA,2025,14900,17570,32470,12
KAMULI,2015,7890,7790,15680,12
KAMULI,2016,8050,7860,15910,12
KAMULI,2017,8180,7900,16080,12
KAMULI,2018,8310,7940,16250,12
KAMULI,2019,8440,7990,16430,12
KAMULI,2020,8580,8060,16640,12
KAMULI,2021,8720,8120,16840,12
KAMULI,2022,8770,8030,16800,12
KAMULI,2023,8770,8020,16790,12
KAMULI,2024,8810,8040,16850,12
KAMULI,2025,8970,8150,17120,12
KAMWENGE,2015,3820,3850,7670,12
KAMWENGE,2016,3970,4000,7970,12
KAMWENGE,2017,4130,4130,8260,12
KAMWENGE,2018,4300,4280,8580,12
KAMWENGE,2019,4470,4430,8900,12
KAMWENGE,2020,4640,4580,9220,12
KAMWENGE,2021,4830,4730,9560,12
KAMWENGE,2022,5010,4890,9900,12
KAMWENGE,2023,5190,5050,10240,12
KAMWENGE,2024,5380,5210,10590,12
KAMWENGE,2025,5570,5370,10940,12
KANUNGU,2015,3870,3760,7630,12
KANUNGU,2016,3940,3820,7760,12
KANUNGU,2017,4010,3880,7890,12
KANUNGU,2018,4080,3950,8030,12
KANUNGU,2019,4150,4010,8160,12
KANUNGU,2020,4220,4070,8290,12
KANUNGU,2021,4290,4120,8410,12
KANUNGU,2022,4350,4180,8530,12
KANUNGU,2023,4420,4230,8650,12
KANUNGU,2024,4480,4290,8770,12
KANUNGU,2025,4530,4340,8870,12
KAPCHORWA,2015,1720,1620,3340,12
KAPCHORWA,2016,1770,1670,3440,12
KAPCHORWA,2017,1830,1720,3550,12
KAPCHORWA,2018,1880,1760,3640,12
KAPCHORWA,2019,1940,1810,3750,12
KAPCHORWA,2020,1990,1860,3850,12
KAPCHORWA,2021,2050,1900,3950,12
KAPCHORWA,2022,2110,1950,4060,12
KAPCHORWA,2023,2160,2000,4160,12
KAPCHORWA,2024,2220,2050,4270,12
KAPCHORWA,2025,2280,2090,4370,12
KAPELEBYONG,2015,1320,1270,2590,12
KAPELEBYONG,2016,1350,1280,2630,12
KAPELEBYONG,2017,1380,1300,2680,12
KAPELEBYONG,2018,1400,1310,2710,12
KAPELEBYONG,2019,1440,1330,2770,12
KAPELEBYONG,2020,1470,1340,2810,12
KAPELEBYONG,2021,1500,1360,2860,12
KAPELEBYONG,2022,1520,1350,2870,12
KAPELEBYONG,2023,1530,1360,2890,12
KAPELEBYONG,2024,1550,1370,2920,12
KAPELEBYONG,2025,1590,1390,2980,12
KASESE,2015,10470,10400,20870,12
KASESE,2016,10670,10490,21160,12
KASESE,2017,10820,10540,21360,12
KASESE,2018,10970,10590,21560,12
KASESE,2019,11130,10650,21780,12
KASESE,2020,11290,10730,22020,12
KASESE,2021,11460,10820,22280,12
KASESE,2022,11490,10700,22190,12
KASESE,2023,11490,10680,22170,12
KASESE,2024,11520,10680,22200,12
KASESE,2025,11720,10830,22550,12
KASSANDA,2015,4250,4110,8360,12
KASSANDA,2016,4380,4200,8580,12
KASSANDA,2017,4500,4290,8790,12
KASSANDA,2018,4630,4380,9010,12
KASSANDA,2019,4760,4470,9230,12
KASSANDA,2020,4890,4560,9450,12
KASSANDA,2021,5010,4650,9660,12
KASSANDA,2022,5140,4740,9880,12
KASSANDA,2023,5270,4830,10100,12
KASSANDA,2024,5400,4910,10310,12
KASSANDA,2025,5520,4990,10510,12
KATAKWI,2015,2640,2480,5120,12
KATAKWI,2016,2700,2510,5210,12
KATAKWI,2017,2750,2530,5280,12
KATAKWI,2018,2810,2550,5360,12
KATAKWI,2019,2860,2580,5440,12
KATAKWI,2020,2920,2610,5530,12
KATAKWI,2021,2980,2630,5610,12
KATAKWI,2022,3010,2610,5620,12
KATAKWI,2023,3020,2620,5640,12
KATAKWI,2024,3040,2630,5670,12
KATAKWI,2025,3110,2670,5780,12
KAYUNGA,2015,6210,6030,12240,12
KAYUNGA,2016,6280,6050,12330,12
KAYUNGA,2017,6340,6050,12390,12
KAYUNGA,2018,6400,6040,12440,12
KAYUNGA,2019,6460,6050,12510,12
KAYUNGA,2020,6530,6060,12590,12
KAYUNGA,2021,6590,6070,12660,12
KAYUNGA,2022,6580,5970,12550,12
KAYUNGA,2023,6550,5930,12480,12
KAYUNGA,2024,6530,5900,12430,12
KAYUNGA,2025,6610,5940,12550,12
KAZO,2015,2520,2570,5090,12
KAZO,2016,2610,2660,5270,12
KAZO,2017,2720,2750,5470,12
KAZO,2018,2810,2850,5660,12
KAZO,2019,2920,2950,5870,12
KAZO,2020,3020,3050,6070,12
KAZO,2021,3130,3150,6280,12
KAZO,2022,3240,3250,6490,12
KAZO,2023,3350,3360,6710,12
KAZO,2024,3470,3460,6930,12
KAZO,2025,3580,3570,7150,12
KIBAALE,2015,1980,2040,4020,12
KIBAALE,2016,2100,2160,4260,12
KIBAALE,2017,2240,2280,4520,12
KIBAALE,2018,2380,2410,4790,12
KIBAALE,2019,2530,2550,5080,12
KIBAALE,2020,2680,2700,5380,12
KIBAALE,2021,2850,2850,5700,12
KIBAALE,2022,3020,3000,6020,12
KIBAALE,2023,3200,3170,6370,12
KIBAALE,2024,3390,3340,6730,12
KIBAALE,2025,3590,3520,7110,12
KIBOGA,2015,2140,2070,4210,12
KIBOGA,2016,2200,2080,4280,12
KIBOGA,2017,2230,2100,4330,12
KIBOGA,2018,2270,2120,4390,12
KIBOGA,2019,2300,2130,4430,12
KIBOGA,2020,2340,2150,4490,12
KIBOGA,2021,2370,2170,4540,12
KIBOGA,2022,2390,2150,4540,12
KIBOGA,2023,2400,2150,4550,12
KIBOGA,2024,2410,2160,4570,12
KIBOGA,2025,2450,2190,4640,12
KIBUKU,2015,3090,3190,6280,12
KIBUKU,2016,3190,3260,6450,12
KIBUKU,2017,3280,3330,6610,12
KIBUKU,2018,3380,3390,6770,12
KIBUKU,2019,3470,3460,6930,12
KIBUKU,2020,3570,3540,7110,12
KIBUKU,2021,3670,3620,7290,12
KIBUKU,2022,3740,3630,7370,12
KIBUKU,2023,3790,3670,7460,12
KIBUKU,2024,3860,3740,7600,12
KIBUKU,2025,3980,3840,7820,12
KIKUUBE,2015,3870,3800,7670,12
KIKUUBE,2016,4080,3990,8070,12
KIKUUBE,2017,4290,4190,8480,12
KIKUUBE,2018,4520,4410,8930,12
KIKUUBE,2019,4760,4630,9390,12
KIKUUBE,2020,5010,4860,9870,12
KIKUUBE,2021,5260,5090,10350,12
KIKUUBE,2022,5530,5340,10870,12
KIKUUBE,2023,5800,5590,11390,12
KIKUUBE,2024,6080,5860,11940,12
KIKUUBE,2025,6370,6120,12490,12
KIRUHURA,2015,1930,1940,3870,12
KIRUHURA,2016,2010,2010,4020,12
KIRUHURA,2017,2080,2080,4160,12
KIRUHURA,2018,2160,2150,4310,12
KIRUHURA,2019,2240,2220,4460,12
KIRUHURA,2020,2330,2300,4630,12
KIRUHURA,2021,2410,2380,4790,12
KIRUHURA,2022,2490,2460,4950,12
KIRUHURA,2023,2580,2530,5110,12
KIRUHURA,2024,2660,2610,5270,12
KIRUHURA,2025,2750,2690,5440,12
KIRYANDONGO,2015,4040,3930,7970,12
KIRYANDONGO,2016,4140,3990,8130,12
KIRYANDONGO,2017,4230,4020,8250,12
KIRYANDONGO,2018,4310,4060,8370,12
KIRYANDONGO,2019,4390,4110,8500,12
KIRYANDONGO,2020,4490,4160,8650,12
KIRYANDONGO,2021,4580,4210,8790,12
KIRYANDONGO,2022,4610,4190,8800,12
KIRYANDONGO,2023,4640,4200,8840,12
KIRYANDONGO,2024,4680,4230,8910,12
KIRYANDONGO,2025,4790,4300,9090,12
KISORO,2015,4290,4340,8630,12
KISORO,2016,4350,4370,8720,12
KISORO,2017,4400,4380,8780,12
KISORO,2018,4430,4390,8820,12
KISORO,2019,4480,4410,8890,12
KISORO,2020,4520,4440,8960,12
KISORO,2021,4570,4460,9030,12
KISORO,2022,4560,4400,8960,12
KISORO,2023,4540,4380,8920,12
KISORO,2024,4530,4380,8910,12
KISORO,2025,4590,4430,9020,12
KITAGWENDA,2015,2110,2160,4270,12
KITAGWENDA,2016,2190,2240,4430,12
KITAGWENDA,2017,2290,2320,4610,12
KITAGWENDA,2018,2380,2400,4780,12
KITAGWENDA,2019,2470,2480,4950,12
KITAGWENDA,2020,2570,2570,5140,12
KITAGWENDA,2021,2660,2660,5320,12
KITAGWENDA,2022,2770,2740,5510,12
KITAGWENDA,2023,2870,2830,5700,12
KITAGWENDA,2024,2970,2920,5890,12
KITAGWENDA,2025,3080,3010,6090,12
KITGUM,2015,2930,2870,5800,12
KITGUM,2016,2960,2880,5840,12
KITGUM,2017,2980,2870,5850,12
KITGUM,2018,3000,2870,5870,12
KITGUM,2019,3010,2860,5870,12
KITGUM,2020,3030,2870,5900,12
KITGUM,2021,3050,2870,5920,12
KITGUM,2022,3040,2820,5860,12
KITGUM,2023,3010,2800,5810,12
KITGUM,2024,3000,2780,5780,12
KITGUM,2025,3030,2810,5840,12
KOBOKO,2015,3290,3120,6410,12
KOBOKO,2016,3400,3190,6590,12
KOBOKO,2017,3500,3260,6760,12
KOBOKO,2018,3610,3330,6940,12
KOBOKO,2019,3710,3400,7110,12
KOBOKO,2020,3830,3480,7310,12
KOBOKO,2021,3940,3560,7500,12
KOBOKO,2022,4010,3580,7590,12
KOBOKO,2023,4070,3620,7690,12
KOBOKO,2024,4150,3690,7840,12
KOBOKO,2025,4280,3800,8080,12
KOLE,2015,3820,3800,7620,12
KOLE,2016,3950,3910,7860,12
KOLE,2017,4080,4020,8100,12
KOLE,2018,4210,4130,8340,12
KOLE,2019,4350,4250,8600,12
KOLE,2020,4480,4370,8850,12
KOLE,2021,4620,4480,9100,12
KOLE,2022,4750,4600,9350,12
KOLE,2023,4890,4720,9610,12
KOLE,2024,5030,4830,9860,12
KOLE,2025,5170,4950,10120,12
KOTIDO,2015,2910,3030,5940,12
KOTIDO,2016,2970,3060,6030,12
KOTIDO,2017,3020,3070,6090,12
KOTIDO,2018,3050,3090,6140,12
KOTIDO,2019,3100,3110,6210,12
KOTIDO,2020,3150,3130,6280,12
KOTIDO,2021,3180,3160,6340,12
KOTIDO,2022,3200,3120,6320,12
KOTIDO,2023,3200,3120,6320,12
KOTIDO,2024,3210,3120,6330,12
KOTIDO,2025,3260,3150,6410,12
KUMI,2015,4030,3860,7890,12
KUMI,2016,4140,3920,8060,12
KUMI,2017,4230,3960,8190,12
KUMI,2018,4320,4000,8320,12
KUMI,2019,4420,4060,8480,12
KUMI,2020,4510,4120,8630,12
KUMI,2021,4620,4180,8800,12
KUMI,2022,4670,4150,8820,12
KUMI,2023,4690,4180,8870,12
KUMI,2024,4740,4210,8950,12
KUMI,2025,4860,4300,9160,12
KWANIA,2015,2910,3020,5930,12
KWANIA,2016,3000,3110,6110,12
KWANIA,2017,3100,3200,6300,12
KWANIA,2018,3190,3290,6480,12
KWANIA,2019,3290,3380,6670,12
KWANIA,2020,3380,3470,6850,12
KWANIA,2021,3480,3570,7050,12
KWANIA,2022,3580,3660,7240,12
KWANIA,2023,3680,3750,7430,12
KWANIA,2024,3770,3840,7610,12
KWANIA,2025,3870,3930,7800,12
KWEEN,2015,1510,1410,2920,12
KWEEN,2016,1560,1440,3000,12
KWEEN,2017,1600,1480,3080,12
KWEEN,2018,1650,1510,3160,12
KWEEN,2019,1700,1550,3250,12
KWEEN,2020,1750,1590,3340,12
KWEEN,2021,1800,1620,3420,12
KWEEN,2022,1850,1660,3510,12
KWEEN,2023,1900,1690,3590,12
KWEEN,2024,1950,1730,3680,12
KWEEN,2025,2000,1760,3760,12
KYANKWANZI,2015,3110,3030,6140,12
KYANKWANZI,2016,3270,3180,6450,12
KYANKWANZI,2017,3440,3320,6760,12
KYANKWANZI,2018,3610,3480,7090,12
KYANKWANZI,2019,3800,3640,7440,12
KYANKWANZI,2020,3980,3800,7780,12
KYANKWANZI,2021,4180,3970,8150,12
KYANKWANZI,2022,4380,4140,8520,12
KYANKWANZI,2023,4590,4320,8910,12
KYANKWANZI,2024,4800,4510,9310,12
KYANKWANZI,2025,5020,4700,9720,12
KYEGEGWA,2015,4270,4130,8400,12
KYEGEGWA,2016,4620,4450,9070,12
KYEGEGWA,2017,5000,4810,9810,12
KYEGEGWA,2018,5410,5180,10590,12
KYEGEGWA,2019,5840,5590,11430,12
KYEGEGWA,2020,6310,6020,12330,12
KYEGEGWA,2021,6820,6480,13300,12
KYEGEGWA,2022,7360,6980,14340,12
KYEGEGWA,2023,7930,7500,15430,12
KYEGEGWA,2024,8550,8060,16610,12
KYEGEGWA,2025,9200,8660,17860,12
KYENJOJO,2015,5990,5970,11960,12
KYENJOJO,2016,6240,6190,12430,12
KYENJOJO,2017,6490,6410,12900,12
KYENJOJO,2018,6760,6650,13410,12
KYENJOJO,2019,7030,6890,13920,12
KYENJOJO,2020,7300,7130,14430,12
KYENJOJO,2021,7590,7380,14970,12
KYENJOJO,2022,7880,7630,15510,12
KYENJOJO,2023,8170,7890,16060,12
KYENJOJO,2024,8470,8140,16610,12
KYENJOJO,2025,8770,8400,17170,12
KYOTERA,2015,3810,3660,7470,12
KYOTERA,2016,3850,3660,7510,12
KYOTERA,2017,3880,3660,7540,12
KYOTERA,2018,3890,3640,7530,12
KYOTERA,2019,3920,3640,7560,12
KYOTERA,2020,3940,3630,7570,12
KYOTERA,2021,3980,3630,7610,12
KYOTERA,2022,3960,3560,7520,12
KYOTERA,2023,3920,3520,7440,12
KYOTERA,2024,3900,3500,7400,12
KYOTERA,2025,3940,3520,7460,12
KARENGA,2015,870,910,1780,12
KARENGA,2016,890,930,1820,12
KARENGA,2017,910,950,1860,12
KARENGA,2018,940,980,1920,12
KARENGA,2019,960,1010,1970,12
KARENGA,2020,990,1030,2020,12
KARENGA,2021,1010,1050,2060,12
KARENGA,2022,1040,1070,2110,12
KARENGA,2023,1060,1090,2150,12
KARENGA,2024,1090,1120,2210,12
KARENGA,2025,1110,1140,2250,12
LAMWO,2015,2070,2090,4160,12
LAMWO,2016,2090,2090,4180,12
LAMWO,2017,2090,2090,4180,12
LAMWO,2018,2080,2080,4160,12
LAMWO,2019,2080,2080,4160,12
LAMWO,2020,2080,2080,4160,12
LAMWO,2021,2080,2080,4160,12
LAMWO,2022,2050,2040,4090,12
LAMWO,2023,2030,2020,4050,12
LAMWO,2024,2000,2010,4010,12
LAMWO,2025,2000,2020,4020,12
LIRA,2015,5840,6330,12170,12
LIRA,2016,6010,6510,12520,12
LIRA,2017,6180,6700,12880,12
LIRA,2018,6350,6890,13240,12
LIRA,2019,6520,7080,13600,12
LIRA,2020,6700,7270,13970,12
LIRA,2021,6870,7460,14330,12
LIRA,2022,7040,7660,14700,12
LIRA,2023,7210,7850,15060,12
LIRA,2024,7380,8040,15420,12
LIRA,2025,7550,8230,15780,12
LUUKA,2015,4020,4090,8110,12
LUUKA,2016,4070,4120,8190,12
LUUKA,2017,4110,4130,8240,12
LUUKA,2018,4150,4140,8290,12
LUUKA,2019,4200,4160,8360,12
LUUKA,2020,4250,4180,8430,12
LUUKA,2021,4300,4200,8500,12
LUUKA,2022,4290,4150,8440,12
LUUKA,2023,4270,4130,8400,12
LUUKA,2024,4260,4120,8380,12
LUUKA,2025,4320,4170,8490,12
LUWERO,2015,7160,6800,13960,12
LUWERO,2016,7300,6850,14150,12
LUWERO,2017,7420,6890,14310,12
LUWERO,2018,7520,6930,14450,12
LUWERO,2019,7640,6970,14610,12
LUWERO,2020,7750,7030,14780,12
LUWERO,2021,7880,7080,14960,12
LUWERO,2022,7910,7010,14920,12
LUWERO,2023,7910,7000,14910,12
LUWERO,2024,7930,7010,14940,12
LUWERO,2025,8080,7110,15190,12
LWENGO,2015,4450,4370,8820,12
LWENGO,2016,4480,4350,8830,12
LWENGO,2017,4480,4320,8800,12
LWENGO,2018,4480,4280,8760,12
LWENGO,2019,4490,4260,8750,12
LWENGO,2020,4490,4230,8720,12
LWENGO,2021,4490,4210,8700,12
LWENGO,2022,4440,4110,8550,12
LWENGO,2023,4380,4050,8430,12
LWENGO,2024,4330,4000,8330,12
LWENGO,2025,4340,4010,8350,12
LYANTONDE,2015,1290,1320,2610,12
LYANTONDE,2016,1320,1330,2650,12
LYANTONDE,2017,1340,1340,2680,12
LYANTONDE,2018,1370,1360,2730,12
LYANTONDE,2019,1390,1380,2770,12
LYANTONDE,2020,1430,1390,2820,12
LYANTONDE,2021,1450,1410,2860,12
LYANTONDE,2022,1460,1410,2870,12
LYANTONDE,2023,1470,1410,2880,12
LYANTONDE,2024,1480,1420,2900,12
LYANTONDE,2025,1520,1450,2970,12
MANAFWA,2015,2350,2480,4830,12
MANAFWA,2016,2410,2540,4950,12
MANAFWA,2017,2470,2590,5060,12
MANAFWA,2018,2540,2650,5190,12
MANAFWA,2019,2590,2710,5300,12
MANAFWA,2020,2660,2770,5430,12
MANAFWA,2021,2720,2820,5540,12
MANAFWA,2022,2780,2880,5660,12
MANAFWA,2023,2830,2930,5760,12
MANAFWA,2024,2890,2990,5880,12
MANAFWA,2025,2950,3040,5990,12
MARACHA,2015,3180,2850,6030,12
MARACHA,2016,3250,2910,6160,12
MARACHA,2017,3320,2960,6280,12
MARACHA,2018,3380,3020,6400,12
MARACHA,2019,3450,3070,6520,12
MARACHA,2020,3520,3130,6650,12
MARACHA,2021,3590,3190,6780,12
MARACHA,2022,3650,3240,6890,12
MARACHA,2023,3720,3290,7010,12
MARACHA,2024,3780,3340,7120,12
MARACHA,2025,3840,3390,7230,12
MASAKA,2015,4270,4200,8470,12
MASAKA,2016,4350,4230,8580,12
MASAKA,2017,4410,4240,8650,12
MASAKA,2018,4450,4250,8700,12
MASAKA,2019,4510,4270,8780,12
MASAKA,2020,4570,4300,8870,12
MASAKA,2021,4630,4330,8960,12
MASAKA,2022,4630,4280,8910,12
MASAKA,2023,4620,4260,8880,12
MASAKA,2024,4630,4260,8890,12
MASAKA,2025,4690,4300,8990,12
MASINDI,2015,3930,3880,7810,12
MASINDI,2016,4050,3980,8030,12
MASINDI,2017,4170,4090,8260,12
MASINDI,2018,4290,4200,8490,12
MASINDI,2019,4410,4310,8720,12
MASINDI,2020,4530,4410,8940,12
MASINDI,2021,4650,4520,9170,12
MASINDI,2022,4770,4630,9400,12
MASINDI,2023,4890,4740,9630,12
MASINDI,2024,5020,4850,9870,12
MASINDI,2025,5130,4950,10080,12
MAYUGE,2015,7700,7440,15140,12
MAYUGE,2016,7910,7560,15470,12
MAYUGE,2017,8080,7660,15740,12
MAYUGE,2018,8240,7760,16000,12
MAYUGE,2019,8420,7880,16300,12
MAYUGE,2020,8600,8010,16610,12
MAYUGE,2021,8790,8130,16920,12
MAYUGE,2022,8890,8100,16990,12
MAYUGE,2023,8940,8160,17100,12
MAYUGE,2024,9030,8240,17270,12
MAYUGE,2025,9250,8420,17670,12
MBALE,2015,7150,7530,14680,12
MBALE,2016,7330,7680,15010,12
MBALE,2017,7480,7790,15270,12
MBALE,2018,7630,7930,15560,12
MBALE,2019,7780,8060,15840,12
MBALE,2020,7940,8210,16150,12
MBALE,2021,8110,8360,16470,12
MBALE,2022,8180,8350,16530,12
MBALE,2023,8230,8430,16660,12
MBALE,2024,8310,8530,16840,12
MBALE,2025,8490,8740,17230,12
MBARARA,2015,4120,4400,8520,12
MBARARA,2016,4220,4490,8710,12
MBARARA,2017,4310,4590,8900,12
MBARARA,2018,4410,4680,9090,12
MBARARA,2019,4510,4780,9290,12
MBARARA,2020,4610,4880,9490,12
MBARARA,2021,4700,4970,9670,12
MBARARA,2022,4790,5070,9860,12
MBARARA,2023,4890,5160,10050,12
MBARARA,2024,4980,5240,10220,12
MBARARA,2025,5070,5340,10410,12
MITOOMA,2015,2770,2730,5500,12
MITOOMA,2016,2800,2760,5560,12
MITOOMA,2017,2830,2780,5610,12
MITOOMA,2018,2870,2810,5680,12
MITOOMA,2019,2900,2830,5730,12
MITOOMA,2020,2930,2850,5780,12
MITOOMA,2021,2960,2870,5830,12
MITOOMA,2022,2990,2890,5880,12
MITOOMA,2023,3010,2910,5920,12
MITOOMA,2024,3030,2920,5950,12
MITOOMA,2025,3060,2940,6000,12
MITYANA,2015,4940,4730,9670,12
MITYANA,2016,5010,4740,9750,12
MITYANA,2017,5040,4740,9780,12
MITYANA,2018,5080,4740,9820,12
MITYANA,2019,5120,4730,9850,12
MITYANA,2020,5170,4740,9910,12
MITYANA,2021,5210,4750,9960,12
MITYANA,2022,5200,4660,9860,12
MITYANA,2023,5160,4630,9790,12
MITYANA,2024,5150,4600,9750,12
MITYANA,2025,5200,4640,9840,12
MOROTO,2015,1520,1570,3090,12
MOROTO,2016,1550,1590,3140,12
MOROTO,2017,1570,1600,3170,12
MOROTO,2018,1590,1610,3200,12
MOROTO,2019,1600,1630,3230,12
MOROTO,2020,1630,1650,3280,12
MOROTO,2021,1650,1660,3310,12
MOROTO,2022,1660,1650,3310,12
MOROTO,2023,1650,1650,3300,12
MOROTO,2024,1650,1650,3300,12
MOROTO,2025,1670,1680,3350,12
MOYO,2015,1470,1430,2900,12
MOYO,2016,1500,1460,2960,12
MOYO,2017,1540,1490,3030,12
MOYO,2018,1580,1520,3100,12
MOYO,2019,1620,1550,3170,12
MOYO,2020,1650,1590,3240,12
MOYO,2021,1690,1620,3310,12
MOYO,2022,1730,1650,3380,12
MOYO,2023,1770,1680,3450,12
MOYO,2024,1810,1710,3520,12
MOYO,2025,1840,1740,3580,12
MPIGI,2015,3910,3620,7530,12
MPIGI,2016,3980,3650,7630,12
MPIGI,2017,4030,3680,7710,12
MPIGI,2018,4090,3690,7780,12
MPIGI,2019,4150,3720,7870,12
MPIGI,2020,4210,3750,7960,12
MPIGI,2021,4270,3790,8060,12
MPIGI,2022,4280,3740,8020,12
MPIGI,2023,4280,3740,8020,12
MPIGI,2024,4280,3750,8030,12
MPIGI,2025,4360,3800,8160,12
MUBENDE,2015,6070,5780,11850,12
MUBENDE,2016,6350,5990,12340,12
MUBENDE,2017,6620,6200,12820,12
MUBENDE,2018,6900,6400,13300,12
MUBENDE,2019,7200,6630,13830,12
MUBENDE,2020,7510,6860,14370,12
MUBENDE,2021,7830,7120,14950,12
MUBENDE,2022,8080,7240,15320,12
MUBENDE,2023,8290,7430,15720,12
MUBENDE,2024,8560,7650,16210,12
MUBENDE,2025,8940,7980,16920,12
MUKONO,2015,8190,8280,16470,12
MUKONO,2016,8370,8400,16770,12
MUKONO,2017,8520,8510,17030,12
MUKONO,2018,8660,8610,17270,12
MUKONO,2019,8800,8720,17520,12
MUKONO,2020,8960,8850,17810,12
MUKONO,2021,9120,8990,18110,12
MUKONO,2022,9170,8950,18120,12
MUKONO,2023,9190,8990,18180,12
MUKONO,2024,9250,9060,18310,12
MUKONO,2025,9420,9250,18670,12
MADI OKOLLO,2015,2210,2090,4300,12
MADI OKOLLO,2016,2270,2160,4430,12
MADI OKOLLO,2017,2350,2200,4550,12
MADI OKOLLO,2018,2410,2270,4680,12
MADI OKOLLO,2019,2480,2330,4810,12
MADI OKOLLO,2020,2550,2390,4940,12
MADI OKOLLO,2021,2610,2450,5060,12
MADI OKOLLO,2022,2680,2510,5190,12
MADI OKOLLO,2023,2750,2560,5310,12
MADI OKOLLO,2024,2810,2620,5430,12
MADI OKOLLO,2025,2880,2680,5560,12
NABILATUK,2015,1120,1210,2330,12
NABILATUK,2016,1170,1250,2420,12
NABILATUK,2017,1210,1290,2500,12
NABILATUK,2018,1260,1320,2580,12
NABILATUK,2019,1310,1360,2670,12
NABILATUK,2020,1370,1390,2760,12
NABILATUK,2021,1420,1440,2860,12
NABILATUK,2022,1470,1460,2930,12
NABILATUK,2023,1500,1490,2990,12
NABILATUK,2024,1550,1520,3070,12
NABILATUK,2025,1610,1580,3190,12
NAKAPIRIPIRIT,2015,1380,1370,2750,12
NAKAPIRIPIRIT,2016,1420,1410,2830,12
NAKAPIRIPIRIT,2017,1480,1450,2930,12
NAKAPIRIPIRIT,2018,1530,1490,3020,12
NAKAPIRIPIRIT,2019,1570,1530,3100,12
NAKAPIRIPIRIT,2020,1630,1570,3200,12
NAKAPIRIPIRIT,2021,1690,1620,3310,12
NAKAPIRIPIRIT,2022,1730,1630,3360,12
NAKAPIRIPIRIT,2023,1750,1660,3410,12
NAKAPIRIPIRIT,2024,1790,1700,3490,12
NAKAPIRIPIRIT,2025,1860,1760,3620,12
NAKASEKE,2015,2940,2790,5730,12
NAKASEKE,2016,3050,2850,5900,12
NAKASEKE,2017,3160,2920,6080,12
NAKASEKE,2018,3270,2990,6260,12
NAKASEKE,2019,3390,3060,6450,12
NAKASEKE,2020,3510,3130,6640,12
NAKASEKE,2021,3630,3200,6830,12
NAKASEKE,2022,3750,3270,7020,12
NAKASEKE,2023,3880,3330,7210,12
NAKASEKE,2024,4000,3400,7400,12
NAKASEKE,2025,4120,3460,7580,12
NAKASONGOLA,2015,2770,2720,5490,12
NAKASONGOLA,2016,2850,2760,5610,12
NAKASONGOLA,2017,2910,2780,5690,12
NAKASONGOLA,2018,2970,2810,5780,12
NAKASONGOLA,2019,3040,2840,5880,12
NAKASONGOLA,2020,3110,2880,5990,12
NAKASONGOLA,2021,3180,2920,6100,12
NAKASONGOLA,2022,3210,2900,6110,12
NAKASONGOLA,2023,3230,2910,6140,12
NAKASONGOLA,2024,3260,2920,6180,12
NAKASONGOLA,2025,3340,2980,6320,12
NAMAYINGO,2015,3450,3210,6660,12
NAMAYINGO,2016,3490,3200,6690,12
NAMAYINGO,2017,3510,3210,6720,12
NAMAYINGO,2018,3550,3190,6740,12
NAMAYINGO,2019,3580,3190,6770,12
NAMAYINGO,2020,3610,3190,6800,12
NAMAYINGO,2021,3650,3190,6840,12
NAMAYINGO,2022,3630,3140,6770,12
NAMAYINGO,2023,3620,3110,6730,12
NAMAYINGO,2024,3610,3090,6700,12
NAMAYINGO,2025,3640,3110,6750,12
NAMISINDWA,2015,3030,3070,6100,12
NAMISINDWA,2016,3120,3140,6260,12
NAMISINDWA,2017,3210,3220,6430,12
NAMISINDWA,2018,3290,3290,6580,12
NAMISINDWA,2019,3380,3370,6750,12
NAMISINDWA,2020,3470,3440,6910,12
NAMISINDWA,2021,3560,3520,7080,12
NAMISINDWA,2022,3650,3590,7240,12
NAMISINDWA,2023,3740,3660,7400,12
NAMISINDWA,2024,3830,3740,7570,12
NAMISINDWA,2025,3910,3810,7720,12
NAMUTUMBA,2015,4030,3940,7970,12
NAMUTUMBA,2016,4150,4010,8160,12
NAMUTUMBA,2017,4250,4070,8320,12
NAMUTUMBA,2018,4360,4130,8490,12
NAMUTUMBA,2019,4470,4200,8670,12
NAMUTUMBA,2020,4580,4270,8850,12
NAMUTUMBA,2021,4700,4350,9050,12
NAMUTUMBA,2022,4760,4340,9100,12
NAMUTUMBA,2023,4810,4380,9190,12
NAMUTUMBA,2024,4880,4430,9310,12
NAMUTUMBA,2025,5010,4540,9550,12
NAPAK,2015,2100,2160,4260,12
NAPAK,2016,2130,2180,4310,12
NAPAK,2017,2130,2180,4310,12
NAPAK,2018,2150,2190,4340,12
NAPAK,2019,2170,2210,4380,12
NAPAK,2020,2180,2210,4390,12
NAPAK,2021,2200,2230,4430,12
NAPAK,2022,2180,2200,4380,12
NAPAK,2023,2160,2200,4360,12
NAPAK,2024,2150,2190,4340,12
NAPAK,2025,2170,2230,4400,12
NEBBI,2015,3740,3820,7560,12
NEBBI,2016,3860,3930,7790,12
NEBBI,2017,3990,4040,8030,12
NEBBI,2018,4110,4150,8260,12
NEBBI,2019,4240,4270,8510,12
NEBBI,2020,4360,4380,8740,12
NEBBI,2021,4490,4500,8990,12
NEBBI,2022,4620,4610,9230,12
NEBBI,2023,4750,4730,9480,12
NEBBI,2024,4880,4840,9720,12
NEBBI,2025,5010,4950,9960,12
NGORA,2015,2210,2350,4560,12
NGORA,2016,2270,2370,4640,12
NGORA,2017,2300,2390,4690,12
NGORA,2018,2340,2410,4750,12
NGORA,2019,2390,2430,4820,12
NGORA,2020,2430,2470,4900,12
NGORA,2021,2480,2490,4970,12
NGORA,2022,2500,2470,4970,12
NGORA,2023,2510,2470,4980,12
NGORA,2024,2520,2490,5010,12
NGORA,2025,2580,2530,5110,12
NTOROKO,2015,960,940,1900,12
NTOROKO,2016,980,950,1930,12
NTOROKO,2017,1000,950,1950,12
NTOROKO,2018,1010,950,1960,12
NTOROKO,2019,1030,950,1980,12
NTOROKO,2020,1040,950,1990,12
NTOROKO,2021,1060,960,2020,12
NTOROKO,2022,1060,950,2010,12
NTOROKO,2023,1060,950,2010,12
NTOROKO,2024,1070,940,2010,12
NTOROKO,2025,1080,950,2030,12
NTUNGAMO,2015,6950,7210,14160,12
NTUNGAMO,2016,7100,7340,14440,12
NTUNGAMO,2017,7250,7480,14730,12
NTUNGAMO,2018,7410,7620,15030,12
NTUNGAMO,2019,7560,7750,15310,12
NTUNGAMO,2020,7710,7880,15590,12
NTUNGAMO,2021,7860,8010,15870,12
NTUNGAMO,2022,8000,8140,16140,12
NTUNGAMO,2023,8150,8260,16410,12
NTUNGAMO,2024,8290,8380,16670,12
NTUNGAMO,2025,8420,8500,16920,12
NWOYA,2015,2180,2100,4280,12
NWOYA,2016,2410,2320,4730,12
NWOYA,2017,2670,2550,5220,12
NWOYA,2018,2940,2810,5750,12
NWOYA,2019,3250,3100,6350,12
NWOYA,2020,3580,3410,6990,12
NWOYA,2021,3950,3750,7700,12
NWOYA,2022,4350,4120,8470,12
NWOYA,2023,4790,4530,9320,12
NWOYA,2024,5260,4970,10230,12
NWOYA,2025,5790,5450,11240,12
OBONGI,2015,740,660,1400,12
OBONGI,2016,750,670,1420,12
OBONGI,2017,760,680,1440,12
OBONGI,2018,770,680,1450,12
OBONGI,2019,780,670,1450,12
OBONGI,2020,790,680,1470,12
OBONGI,2021,800,690,1490,12
OBONGI,2022,800,680,1480,12
OBONGI,2023,800,680,1480,12
OBONGI,2024,810,680,1490,12
OBONGI,2025,820,690,1510,12
OMORO,2015,2740,2540,5280,12
OMORO,2016,2820,2590,5410,12
OMORO,2017,2890,2630,5520,12
OMORO,2018,2960,2680,5640,12
OMORO,2019,3040,2730,5770,12
OMORO,2020,3120,2780,5900,12
OMORO,2021,3190,2840,6030,12
OMORO,2022,3250,2840,6090,12
OMORO,2023,3280,2870,6150,12
OMORO,2024,3320,2910,6230,12
OMORO,2025,3420,2990,6410,12
OTUKE,2015,1610,1640,3250,12
OTUKE,2016,1680,1710,3390,12
OTUKE,2017,1760,1790,3550,12
OTUKE,2018,1840,1860,3700,12
OTUKE,2019,1920,1940,3860,12
OTUKE,2020,2000,2020,4020,12
OTUKE,2021,2090,2110,4200,12
OTUKE,2022,2170,2190,4360,12
OTUKE,2023,2260,2280,4540,12
OTUKE,2024,2360,2370,4730,12
OTUKE,2025,2450,2460,4910,12
OYAM,2015,6040,6130,12170,12
OYAM,2016,6220,6310,12530,12
OYAM,2017,6410,6490,12900,12
OYAM,2018,6610,6680,13290,12
OYAM,2019,6800,6870,13670,12
OYAM,2020,7000,7060,14060,12
OYAM,2021,7190,7250,14440,12
OYAM,2022,7400,7440,14840,12
OYAM,2023,7590,7630,15220,12
OYAM,2024,7790,7830,15620,12
OYAM,2025,7990,8020,16010,12
PADER,2015,2880,2680,5560,12
PADER,2016,2910,2690,5600,12
PADER,2017,2940,2700,5640,12
PADER,2018,2950,2700,5650,12
PADER,2019,2970,2720,5690,12
PADER,2020,2990,2730,5720,12
PADER,2021,3020,2740,5760,12
PADER,2022,3010,2700,5710,12
PADER,2023,2980,2690,5670,12
PADER,2024,2970,2680,5650,12
PADER,2025,2990,2710,5700,12
PAKWACH,2015,2380,2290,4670,12
PAKWACH,2016,2480,2370,4850,12
PAKWACH,2017,2590,2460,5050,12
PAKWACH,2018,2700,2550,5250,12
PAKWACH,2019,2800,2630,5430,12
PAKWACH,2020,2920,2730,5650,12
PAKWACH,2021,3030,2820,5850,12
PAKWACH,2022,3150,2920,6070,12
PAKWACH,2023,3270,3010,6280,12
PAKWACH,2024,3390,3110,6500,12
PAKWACH,2025,3520,3210,6730,12
PALLISA,2015,4530,4590,9120,12
PALLISA,2016,4710,4720,9430,12
PALLISA,2017,4880,4840,9720,12
PALLISA,2018,5040,4970,10010,12
PALLISA,2019,5220,5090,10310,12
PALLISA,2020,5400,5250,10650,12
PALLISA,2021,5590,5400,10990,12
PALLISA,2022,5720,5440,11160,12
PALLISA,2023,5830,5550,11380,12
PALLISA,2024,5970,5670,11640,12
PALLISA,2025,6190,5860,12050,12
RAKAI,2015,4510,4420,8930,12
RAKAI,2016,4600,4450,9050,12
RAKAI,2017,4670,4480,9150,12
RAKAI,2018,4740,4500,9240,12
RAKAI,2019,4810,4540,9350,12
RAKAI,2020,4890,4570,9460,12
RAKAI,2021,4980,4610,9590,12
RAKAI,2022,4990,4560,9550,12
RAKAI,2023,4990,4560,9550,12
RAKAI,2024,5010,4560,9570,12
RAKAI,2025,5100,4630,9730,12
RUBANDA,2015,2790,2930,5720,12
RUBANDA,2016,2830,2950,5780,12
RUBANDA,2017,2870,2970,5840,12
RUBANDA,2018,2900,3000,5900,12
RUBANDA,2019,2940,3020,5960,12
RUBANDA,2020,2980,3040,6020,12
RUBANDA,2021,3010,3060,6070,12
RUBANDA,2022,3040,3070,6110,12
RUBANDA,2023,3070,3090,6160,12
RUBANDA,2024,3100,3100,6200,12
RUBANDA,2025,3120,3110,6230,12
RUBIRIZI,2015,2070,2020,4090,12
RUBIRIZI,2016,2110,2070,4180,12
RUBIRIZI,2017,2160,2100,4260,12
RUBIRIZI,2018,2200,2140,4340,12
RUBIRIZI,2019,2240,2180,4420,12
RUBIRIZI,2020,2290,2220,4510,12
RUBIRIZI,2021,2330,2260,4590,12
RUBIRIZI,2022,2360,2300,4660,12
RUBIRIZI,2023,2400,2330,4730,12
RUBIRIZI,2024,2440,2370,4810,12
RUBIRIZI,2025,2480,2400,4880,12
RUKIGA,2015,1370,1370,2740,12
RUKIGA,2016,1390,1380,2770,12
RUKIGA,2017,1400,1400,2800,12
RUKIGA,2018,1420,1400,2820,12
RUKIGA,2019,1430,1410,2840,12
RUKIGA,2020,1440,1420,2860,12
RUKIGA,2021,1450,1430,2880,12
RUKIGA,2022,1460,1430,2890,12
RUKIGA,2023,1470,1440,2910,12
RUKIGA,2024,1480,1440,2920,12
RUKIGA,2025,1490,1450,2940,12
RUKUNGIRI,2015,4610,4600,9210,12
RUKUNGIRI,2016,4660,4640,9300,12
RUKUNGIRI,2017,4720,4690,9410,12
RUKUNGIRI,2018,4780,4730,9510,12
RUKUNGIRI,2019,4830,4770,9600,12
RUKUNGIRI,2020,4880,4810,9690,12
RUKUNGIRI,2021,4930,4850,9780,12
RUKUNGIRI,2022,4970,4880,9850,12
RUKUNGIRI,2023,5020,4910,9930,12
RUKUNGIRI,2024,5050,4940,9990,12
RUKUNGIRI,2025,5090,4970,10060,12
RWAMPARA,2015,2020,1940,3960,12
RWAMPARA,2016,2070,1990,4060,12
RWAMPARA,2017,2120,2030,4150,12
RWAMPARA,2018,2160,2070,4230,12
RWAMPARA,2019,2210,2110,4320,12
RWAMPARA,2020,2260,2160,4420,12
RWAMPARA,2021,2300,2200,4500,12
RWAMPARA,2022,2350,2240,4590,12
RWAMPARA,2023,2390,2280,4670,12
RWAMPARA,2024,2440,2330,4770,12
RWAMPARA,2025,2480,2370,4850,12
SERERE,2015,4680,4480,9160,12
SERERE,2016,4850,4590,9440,12
SERERE,2017,5000,4690,9690,12
SERERE,2018,5150,4800,9950,12
SERERE,2019,5310,4910,10220,12
SERERE,2020,5480,5030,10510,12
SERERE,2021,5650,5160,10810,12
SERERE,2022,5760,5190,10950,12
SERERE,2023,5850,5260,11110,12
SERERE,2024,5960,5360,11320,12
SERERE,2025,6160,5520,11680,12
SHEEMA,2015,3100,3060,6160,12
SHEEMA,2016,3140,3090,6230,12
SHEEMA,2017,3180,3120,6300,12
SHEEMA,2018,3220,3150,6370,12
SHEEMA,2019,3250,3180,6430,12
SHEEMA,2020,3290,3210,6500,12
SHEEMA,2021,3320,3240,6560,12
SHEEMA,2022,3350,3260,6610,12
SHEEMA,2023,3380,3290,6670,12
SHEEMA,2024,3410,3310,6720,12
SHEEMA,2025,3430,3330,6760,12
SIRONKO,2015,3900,3810,7710,12
SIRONKO,2016,3990,3890,7880,12
SIRONKO,2017,4090,3970,8060,12
SIRONKO,2018,4180,4050,8230,12
SIRONKO,2019,4280,4130,8410,12
SIRONKO,2020,4370,4200,8570,12
SIRONKO,2021,4470,4280,8750,12
SIRONKO,2022,4560,4360,8920,12
SIRONKO,2023,4650,4430,9080,12
SIRONKO,2024,4740,4500,9240,12
SIRONKO,2025,4830,4570,9400,12
SOROTI,2015,4210,4310,8520,12
SOROTI,2016,4340,4400,8740,12
SOROTI,2017,4460,4480,8940,12
SOROTI,2018,4570,4560,9130,12
SOROTI,2019,4700,4640,9340,12
SOROTI,2020,4820,4730,9550,12
SOROTI,2021,4950,4830,9780,12
SOROTI,2022,5020,4840,9860,12
SOROTI,2023,5070,4890,9960,12
SOROTI,2024,5150,4960,10110,12
SOROTI,2025,5300,5080,10380,12
SSEMBABULE,2015,4130,3810,7940,12
SSEMBABULE,2016,4210,3860,8070,12
SSEMBABULE,2017,4300,3900,8200,12
SSEMBABULE,2018,4380,3930,8310,12
SSEMBABULE,2019,4470,3970,8440,12
SSEMBABULE,2020,4550,4020,8570,12
SSEMBABULE,2021,4640,4070,8710,12
SSEMBABULE,2022,4680,4040,8720,12
SSEMBABULE,2023,4690,4050,8740,12
SSEMBABULE,2024,4730,4080,8810,12
SSEMBABULE,2025,4830,4150,8980,12
TORORO,2015,7700,7950,15650,12
TORORO,2016,7910,8160,16070,12
TORORO,2017,8120,8360,16480,12
TORORO,2018,8330,8560,16890,12
TORORO,2019,8550,8770,17320,12
TORORO,2020,8760,8980,17740,12
TORORO,2021,8970,9180,18150,12
TORORO,2022,9190,9390,18580,12
TORORO,2023,9400,9590,18990,12
TORORO,2024,9610,9790,19400,12
TORORO,2025,9810,9990,19800,12
WAKISO,2015,21200,23620,44820,12
WAKISO,2016,22610,25230,47840,12
WAKISO,2017,24130,26960,51090,12
WAKISO,2018,25730,28780,54510,12
WAKISO,2019,27440,30720,58160,12
WAKISO,2020,29230,32760,61990,12
WAKISO,2021,31110,34930,66040,12
WAKISO,2022,33100,37240,70340,12
WAKISO,2023,35200,39630,74830,12
WAKISO,2024,37390,42150,79540,12
WAKISO,2025,39690,44830,84520,12
YUMBE,2015,9060,10230,19290,12
YUMBE,2016,9470,10680,20150,12
YUMBE,2017,9870,11130,21000,12
YUMBE,2018,10260,11590,21850,12
YUMBE,2019,10690,12090,22780,12
YUMBE,2020,11130,12620,23750,12
YUMBE,2021,11590,13170,24760,12
YUMBE,2022,11940,13500,25440,12
YUMBE,2023,12240,13960,26200,12
YUMBE,2024,12610,14490,27100,12
YUMBE,2025,13150,15220,28370,12
ZOMBO,2015,4220,3920,8140,12
ZOMBO,2016,4350,4030,8380,12
ZOMBO,2017,4480,4140,8620,12
ZOMBO,2018,4620,4260,8880,12
ZOMBO,2019,4760,4370,9130,12
ZOMBO,2020,4890,4490,9380,12
ZOMBO,2021,5030,4600,9630,12
ZOMBO,2022,5180,4720,9900,12
ZOMBO,2023,5310,4840,10150,12
ZOMBO,2024,5460,4950,10410,12
ZOMBO,2025,5590,5070,10660,12
ABIM,2015,1620,1610,3230,13
ABIM,2016,1730,1700,3430,13
ABIM,2017,1830,1780,3610,13
ABIM,2018,1930,1850,3780,13
ABIM,2019,2030,1930,3960,13
ABIM,2020,2130,2020,4150,13
ABIM,2021,2250,2110,4360,13
ABIM,2022,2370,2200,4570,13
ABIM,2023,2470,2260,4730,13
ABIM,2024,2570,2340,4910,13
ABIM,2025,2670,2440,5110,13
ADJUMANI,2015,3350,3300,6650,13
ADJUMANI,2016,3380,3330,6710,13
ADJUMANI,2017,3410,3360,6770,13
ADJUMANI,2018,3430,3400,6830,13
ADJUMANI,2019,3450,3430,6880,13
ADJUMANI,2020,3470,3460,6930,13
ADJUMANI,2021,3490,3480,6970,13
ADJUMANI,2022,3510,3510,7020,13
ADJUMANI,2023,3520,3530,7050,13
ADJUMANI,2024,3530,3550,7080,13
ADJUMANI,2025,3540,3570,7110,13
AGAGO,2015,3020,3010,6030,13
AGAGO,2016,3080,3060,6140,13
AGAGO,2017,3130,3110,6240,13
AGAGO,2018,3180,3170,6350,13
AGAGO,2019,3230,3220,6450,13
AGAGO,2020,3290,3270,6560,13
AGAGO,2021,3340,3320,6660,13
AGAGO,2022,3390,3370,6760,13
AGAGO,2023,3430,3420,6850,13
AGAGO,2024,3480,3470,6950,13
AGAGO,2025,3520,3510,7030,13
ALEBTONG,2015,3410,3330,6740,13
ALEBTONG,2016,3510,3390,6900,13
ALEBTONG,2017,3590,3430,7020,13
ALEBTONG,2018,3650,3470,7120,13
ALEBTONG,2019,3720,3490,7210,13
ALEBTONG,2020,3780,3530,7310,13
ALEBTONG,2021,3850,3570,7420,13
ALEBTONG,2022,3920,3620,7540,13
ALEBTONG,2023,3940,3590,7530,13
ALEBTONG,2024,3960,3600,7560,13
ALEBTONG,2025,3980,3620,7600,13
AMOLATAR,2015,2080,2030,4110,13
AMOLATAR,2016,2130,2060,4190,13
AMOLATAR,2017,2180,2090,4270,13
AMOLATAR,2018,2210,2100,4310,13
AMOLATAR,2019,2250,2110,4360,13
AMOLATAR,2020,2280,2130,4410,13
AMOLATAR,2021,2320,2150,4470,13
AMOLATAR,2022,2350,2170,4520,13
AMOLATAR,2023,2370,2150,4520,13
AMOLATAR,2024,2370,2150,4520,13
AMOLATAR,2025,2380,2160,4540,13
AMUDAT,2015,1470,1240,2710,13
AMUDAT,2016,1530,1290,2820,13
AMUDAT,2017,1580,1340,2920,13
AMUDAT,2018,1630,1380,3010,13
AMUDAT,2019,1670,1410,3080,13
AMUDAT,2020,1720,1450,3170,13
AMUDAT,2021,1770,1500,3270,13
AMUDAT,2022,1830,1550,3380,13
AMUDAT,2023,1850,1560,3410,13
AMUDAT,2024,1880,1590,3470,13
AMUDAT,2025,1920,1640,3560,13
AMURIA,2015,2870,2730,5600,13
AMURIA,2016,2970,2800,5770,13
AMURIA,2017,3070,2860,5930,13
AMURIA,2018,3150,2910,6060,13
AMURIA,2019,3230,2970,6200,13
AMURIA,2020,3320,3020,6340,13
AMURIA,2021,3420,3080,6500,13
AMURIA,2022,3500,3140,6640,13
AMURIA,2023,3570,3140,6710,13
AMURIA,2024,3610,3170,6780,13
AMURIA,2025,3660,3220,6880,13
AMURU,2015,2800,2740,5540,13
AMURU,2016,2890,2790,5680,13
AMURU,2017,2940,2830,5770,13
AMURU,2018,2980,2850,5830,13
AMURU,2019,3040,2880,5920,13
AMURU,2020,3080,2910,5990,13
AMURU,2021,3130,2940,6070,13
AMURU,2022,3180,2980,6160,13
AMURU,2023,3190,2950,6140,13
AMURU,2024,3200,2960,6160,13
AMURU,2025,3210,2970,6180,13
APAC,2015,2600,2550,5150,13
APAC,2016,2690,2640,5330,13
APAC,2017,2790,2740,5530,13
APAC,2018,2890,2830,5720,13
APAC,2019,3000,2920,5920,13
APAC,2020,3100,3020,6120,13
APAC,2021,3210,3120,6330,13
APAC,2022,3320,3220,6540,13
APAC,2023,3430,3320,6750,13
APAC,2024,3540,3420,6960,13
APAC,2025,3650,3530,7180,13
ARUA,2015,8810,9080,17890,13
ARUA,2016,9070,9330,18400,13
ARUA,2017,9320,9590,18910,13
ARUA,2018,9590,9840,19430,13
ARUA,2019,9860,10100,19960,13
ARUA,2020,10120,10360,20480,13
ARUA,2021,10400,10610,21010,13
ARUA,2022,10670,10870,21540,13
ARUA,2023,10940,11140,22080,13
ARUA,2024,11210,11400,22610,13
ARUA,2025,11470,11650,23120,13
BUDAKA,2015,3110,3180,6290,13
BUDAKA,2016,3220,3270,6490,13
BUDAKA,2017,3320,3330,6650,13
BUDAKA,2018,3400,3390,6790,13
BUDAKA,2019,3490,3440,6930,13
BUDAKA,2020,3570,3500,7070,13
BUDAKA,2021,3670,3560,7230,13
BUDAKA,2022,3770,3640,7410,13
BUDAKA,2023,3820,3640,7460,13
BUDAKA,2024,3860,3670,7530,13
BUDAKA,2025,3910,3720,7630,13
BUDUDA,2015,3210,3060,6270,13
BUDUDA,2016,3350,3170,6520,13
BUDUDA,2017,3490,3270,6760,13
BUDUDA,2018,3610,3360,6970,13
BUDUDA,2019,3740,3440,7180,13
BUDUDA,2020,3870,3540,7410,13
BUDUDA,2021,4000,3640,7640,13
BUDUDA,2022,4140,3750,7890,13
BUDUDA,2023,4240,3790,8030,13
BUDUDA,2024,4320,3860,8180,13
BUDUDA,2025,4420,3950,8370,13
BUGIRI,2015,5830,5800,11630,13
BUGIRI,2016,6070,5970,12040,13
BUGIRI,2017,6280,6130,12410,13
BUGIRI,2018,6480,6250,12730,13
BUGIRI,2019,6670,6390,13060,13
BUGIRI,2020,6870,6530,13400,13
BUGIRI,2021,7090,6680,13770,13
BUGIRI,2022,7310,6850,14160,13
BUGIRI,2023,7450,6870,14320,13
BUGIRI,2024,7570,6970,14540,13
BUGIRI,2025,7700,7100,14800,13
BUGWERI,2015,2500,2670,5170,13
BUGWERI,2016,2570,2720,5290,13
BUGWERI,2017,2620,2740,5360,13
BUGWERI,2018,2670,2770,5440,13
BUGWERI,2019,2710,2800,5510,13
BUGWERI,2020,2760,2820,5580,13
BUGWERI,2021,2810,2850,5660,13
BUGWERI,2022,2860,2880,5740,13
BUGWERI,2023,2870,2850,5720,13
BUGWERI,2024,2880,2860,5740,13
BUGWERI,2025,2890,2880,5770,13
BUHWEJU,2015,1710,1670,3380,13
BUHWEJU,2016,1760,1720,3480,13
BUHWEJU,2017,1820,1770,3590,13
BUHWEJU,2018,1880,1820,3700,13
BUHWEJU,2019,1940,1880,3820,13
BUHWEJU,2020,2000,1930,3930,13
BUHWEJU,2021,2060,1990,4050,13
BUHWEJU,2022,2120,2040,4160,13
BUHWEJU,2023,2180,2100,4280,13
BUHWEJU,2024,2240,2150,4390,13
BUHWEJU,2025,2300,2210,4510,13
BUIKWE,2015,6250,6170,12420,13
BUIKWE,2016,6370,6240,12610,13
BUIKWE,2017,6460,6280,12740,13
BUIKWE,2018,6520,6300,12820,13
BUIKWE,2019,6590,6320,12910,13
BUIKWE,2020,6650,6340,12990,13
BUIKWE,2021,6730,6370,13100,13
BUIKWE,2022,6790,6410,13200,13
BUIKWE,2023,6780,6320,13100,13
BUIKWE,2024,6750,6300,13050,13
BUIKWE,2025,6740,6290,13030,13
BUKEDEA,2015,3080,3040,6120,13
BUKEDEA,2016,3220,3140,6360,13
BUKEDEA,2017,3340,3220,6560,13
BUKEDEA,2018,3450,3300,6750,13
BUKEDEA,2019,3570,3370,6940,13
BUKEDEA,2020,3690,3450,7140,13
BUKEDEA,2021,3820,3550,7370,13
BUKEDEA,2022,3950,3640,7590,13
BUKEDEA,2023,4040,3660,7700,13
BUKEDEA,2024,4110,3720,7830,13
BUKEDEA,2025,4200,3790,7990,13
BUKOMANSIMBI,2015,2680,2560,5240,13
BUKOMANSIMBI,2016,2690,2560,5250,13
BUKOMANSIMBI,2017,2710,2540,5250,13
BUKOMANSIMBI,2018,2700,2510,5210,13
BUKOMANSIMBI,2019,2690,2470,5160,13
BUKOMANSIMBI,2020,2690,2440,5130,13
BUKOMANSIMBI,2021,2680,2420,5100,13
BUKOMANSIMBI,2022,2670,2390,5060,13
BUKOMANSIMBI,2023,2640,2320,4960,13
BUKOMANSIMBI,2024,2590,2280,4870,13
BUKOMANSIMBI,2025,2560,2240,4800,13
BUKWO,2015,1190,1240,2430,13
BUKWO,2016,1250,1300,2550,13
BUKWO,2017,1320,1360,2680,13
BUKWO,2018,1390,1430,2820,13
BUKWO,2019,1460,1500,2960,13
BUKWO,2020,1540,1570,3110,13
BUKWO,2021,1620,1640,3260,13
BUKWO,2022,1700,1720,3420,13
BUKWO,2023,1780,1800,3580,13
BUKWO,2024,1870,1880,3750,13
BUKWO,2025,1960,1960,3920,13
BULAMBULI,2015,2500,2370,4870,13
BULAMBULI,2016,2630,2470,5100,13
BULAMBULI,2017,2740,2550,5290,13
BULAMBULI,2018,2850,2630,5480,13
BULAMBULI,2019,2960,2720,5680,13
BULAMBULI,2020,3080,2810,5890,13
BULAMBULI,2021,3190,2900,6090,13
BULAMBULI,2022,3320,3000,6320,13
BULAMBULI,2023,3410,3040,6450,13
BULAMBULI,2024,3490,3110,6600,13
BULAMBULI,2025,3580,3200,6780,13
BULIISA,2015,1430,1360,2790,13
BULIISA,2016,1510,1420,2930,13
BULIISA,2017,1590,1480,3070,13
BULIISA,2018,1680,1550,3230,13
BULIISA,2019,1760,1610,3370,13
BULIISA,2020,1860,1680,3540,13
BULIISA,2021,1950,1750,3700,13
BULIISA,2022,2050,1820,3870,13
BULIISA,2023,2160,1900,4060,13
BULIISA,2024,2260,1980,4240,13
BULIISA,2025,2370,2050,4420,13
BUNDIBUGYO,2015,2950,3130,6080,13
BUNDIBUGYO,2016,3040,3200,6240,13
BUNDIBUGYO,2017,3110,3240,6350,13
BUNDIBUGYO,2018,3170,3270,6440,13
BUNDIBUGYO,2019,3230,3290,6520,13
BUNDIBUGYO,2020,3290,3340,6630,13
BUNDIBUGYO,2021,3360,3370,6730,13
BUNDIBUGYO,2022,3420,3420,6840,13
BUNDIBUGYO,2023,3460,3400,6860,13
BUNDIBUGYO,2024,3470,3400,6870,13
BUNDIBUGYO,2025,3500,3420,6920,13
BUNYANGABU,2015,2520,2270,4790,13
BUNYANGABU,2016,2580,2300,4880,13
BUNYANGABU,2017,2620,2320,4940,13
BUNYANGABU,2018,2670,2340,5010,13
BUNYANGABU,2019,2700,2350,5050,13
BUNYANGABU,2020,2750,2360,5110,13
BUNYANGABU,2021,2790,2380,5170,13
BUNYANGABU,2022,2840,2400,5240,13
BUNYANGABU,2023,2840,2370,5210,13
BUNYANGABU,2024,2840,2370,5210,13
BUNYANGABU,2025,2860,2370,5230,13
BUSHENYI,2015,3200,3240,6440,13
BUSHENYI,2016,3250,3270,6520,13
BUSHENYI,2017,3280,3300,6580,13
BUSHENYI,2018,3320,3330,6650,13
BUSHENYI,2019,3360,3360,6720,13
BUSHENYI,2020,3400,3380,6780,13
BUSHENYI,2021,3430,3410,6840,13
BUSHENYI,2022,3470,3430,6900,13
BUSHENYI,2023,3500,3450,6950,13
BUSHENYI,2024,3520,3470,6990,13
BUSHENYI,2025,3550,3480,7030,13
BUSIA,2015,4760,4840,9600,13
BUSIA,2016,4920,4950,9870,13
BUSIA,2017,5040,5020,10060,13
BUSIA,2018,5150,5080,10230,13
BUSIA,2019,5250,5130,10380,13
BUSIA,2020,5370,5200,10570,13
BUSIA,2021,5480,5270,10750,13
BUSIA,2022,5600,5340,10940,13
BUSIA,2023,5660,5310,10970,13
BUSIA,2024,5690,5330,11020,13
BUSIA,2025,5750,5380,11130,13
BUTALEJA,2015,3720,3640,7360,13
BUTALEJA,2016,3870,3750,7620,13
BUTALEJA,2017,3990,3820,7810,13
BUTALEJA,2018,4090,3890,7980,13
BUTALEJA,2019,4210,3960,8170,13
BUTALEJA,2020,4320,4040,8360,13
BUTALEJA,2021,4450,4130,8580,13
BUTALEJA,2022,4560,4200,8760,13
BUTALEJA,2023,4640,4220,8860,13
BUTALEJA,2024,4690,4260,8950,13
BUTALEJA,2025,4770,4320,9090,13
BUTAMBALA,2015,1830,1810,3640,13
BUTAMBALA,2016,1850,1810,3660,13
BUTAMBALA,2017,1870,1810,3680,13
BUTAMBALA,2018,1870,1790,3660,13
BUTAMBALA,2019,1870,1780,3650,13
BUTAMBALA,2020,1890,1770,3660,13
BUTAMBALA,2021,1890,1760,3650,13
BUTAMBALA,2022,1900,1750,3650,13
BUTAMBALA,2023,1880,1710,3590,13
BUTAMBALA,2024,1860,1690,3550,13
BUTAMBALA,2025,1850,1680,3530,13
BUTEBO,2015,1720,1770,3490,13
BUTEBO,2016,1750,1780,3530,13
BUTEBO,2017,1760,1780,3540,13
BUTEBO,2018,1770,1780,3550,13
BUTEBO,2019,1780,1770,3550,13
BUTEBO,2020,1790,1770,3560,13
BUTEBO,2021,1800,1760,3560,13
BUTEBO,2022,1810,1760,3570,13
BUTEBO,2023,1800,1720,3520,13
BUTEBO,2024,1780,1700,3480,13
BUTEBO,2025,1770,1690,3460,13
BUVUMA,2015,850,820,1670,13
BUVUMA,2016,900,870,1770,13
BUVUMA,2017,960,930,1890,13
BUVUMA,2018,1020,1000,2020,13
BUVUMA,2019,1080,1060,2140,13
BUVUMA,2020,1140,1130,2270,13
BUVUMA,2021,1210,1210,2420,13
BUVUMA,2022,1280,1280,2560,13
BUVUMA,2023,1360,1370,2730,13
BUVUMA,2024,1440,1450,2890,13
BUVUMA,2025,1520,1540,3060,13
BUYENDE,2015,4860,4830,9690,13
BUYENDE,2016,5080,5000,10080,13
BUYENDE,2017,5280,5150,10430,13
BUYENDE,2018,5460,5280,10740,13
BUYENDE,2019,5650,5410,11060,13
BUYENDE,2020,5840,5560,11400,13
BUYENDE,2021,6040,5720,11760,13
BUYENDE,2022,6250,5880,12130,13
BUYENDE,2023,6390,5930,12320,13
BUYENDE,2024,6520,6040,12560,13
BUYENDE,2025,6660,6160,12820,13
DOKOLO,2015,2660,2660,5320,13
DOKOLO,2016,2750,2730,5480,13
DOKOLO,2017,2830,2810,5640,13
DOKOLO,2018,2920,2880,5800,13
DOKOLO,2019,3000,2960,5960,13
DOKOLO,2020,3090,3040,6130,13
DOKOLO,2021,3180,3110,6290,13
DOKOLO,2022,3260,3190,6450,13
DOKOLO,2023,3350,3270,6620,13
DOKOLO,2024,3440,3350,6790,13
DOKOLO,2025,3530,3420,6950,13
GOMBA,2015,2750,2520,5270,13
GOMBA,2016,2790,2530,5320,13
GOMBA,2017,2820,2520,5340,13
GOMBA,2018,2850,2510,5360,13
GOMBA,2019,2870,2500,5370,13
GOMBA,2020,2880,2490,5370,13
GOMBA,2021,2910,2480,5390,13
GOMBA,2022,2930,2470,5400,13
GOMBA,2023,2910,2420,5330,13
GOMBA,2024,2890,2390,5280,13
GOMBA,2025,2880,2370,5250,13
GULU,2015,3680,3870,7550,13
GULU,2016,3790,3990,7780,13
GULU,2017,3900,4100,8000,13
GULU,2018,4020,4220,8240,13
GULU,2019,4130,4340,8470,13
GULU,2020,4260,4460,8720,13
GULU,2021,4370,4580,8950,13
GULU,2022,4490,4700,9190,13
GULU,2023,4610,4820,9430,13
GULU,2024,4730,4940,9670,13
GULU,2025,4850,5060,9910,13
HOIMA,2015,3950,3940,7890,13
HOIMA,2016,4100,4070,8170,13
HOIMA,2017,4260,4210,8470,13
HOIMA,2018,4420,4360,8780,13
HOIMA,2019,4580,4500,9080,13
HOIMA,2020,4740,4660,9400,13
HOIMA,2021,4910,4810,9720,13
HOIMA,2022,5080,4960,10040,13
HOIMA,2023,5250,5120,10370,13
HOIMA,2024,5430,5270,10700,13
HOIMA,2025,5600,5430,11030,13
IBANDA,2015,3370,3360,6730,13
IBANDA,2016,3440,3420,6860,13
IBANDA,2017,3500,3480,6980,13
IBANDA,2018,3570,3540,7110,13
IBANDA,2019,3640,3600,7240,13
IBANDA,2020,3700,3660,7360,13
IBANDA,2021,3770,3720,7490,13
IBANDA,2022,3830,3780,7610,13
IBANDA,2023,3900,3830,7730,13
IBANDA,2024,3950,3890,7840,13
IBANDA,2025,4010,3940,7950,13
IGANGA,2015,4970,5370,10340,13
IGANGA,2016,5120,5470,10590,13
IGANGA,2017,5260,5550,10810,13
IGANGA,2018,5370,5610,10980,13
IGANGA,2019,5480,5680,11160,13
IGANGA,2020,5590,5760,11350,13
IGANGA,2021,5710,5830,11540,13
IGANGA,2022,5830,5920,11750,13
IGANGA,2023,5890,5880,11770,13
IGANGA,2024,5930,5910,11840,13
IGANGA,2025,5980,5950,11930,13
ISINGIRO,2015,6670,6570,13240,13
ISINGIRO,2016,6920,6800,13720,13
ISINGIRO,2017,7170,7040,14210,13
ISINGIRO,2018,7440,7290,14730,13
ISINGIRO,2019,7710,7540,15250,13
ISINGIRO,2020,7990,7790,15780,13
ISINGIRO,2021,8270,8050,16320,13
ISINGIRO,2022,8550,8310,16860,13
ISINGIRO,2023,8840,8580,17420,13
ISINGIRO,2024,9130,8840,17970,13
ISINGIRO,2025,9420,9120,18540,13
JINJA,2015,6190,6680,12870,13
JINJA,2016,6290,6780,13070,13
JINJA,2017,6400,6890,13290,13
JINJA,2018,6500,6990,13490,13
JINJA,2019,6610,7090,13700,13
JINJA,2020,6710,7190,13900,13
JINJA,2021,6810,7290,14100,13
JINJA,2022,6900,7380,14280,13
JINJA,2023,6990,7470,14460,13
JINJA,2024,7080,7550,14630,13
JINJA,2025,7160,7630,14790,13
KAABONG,2015,1210,1340,2550,13
KAABONG,2016,1240,1370,2610,13
KAABONG,2017,1280,1410,2690,13
KAABONG,2018,1310,1440,2750,13
KAABONG,2019,1340,1470,2810,13
KAABONG,2020,1380,1510,2890,13
KAABONG,2021,1420,1540,2960,13
KAABONG,2022,1450,1580,3030,13
KAABONG,2023,1480,1610,3090,13
KAABONG,2024,1510,1640,3150,13
KAABONG,2025,1550,1670,3220,13
KABALE,2015,2950,3080,6030,13
KABALE,2016,3000,3110,6110,13
KABALE,2017,3040,3150,6190,13
KABALE,2018,3090,3190,6280,13
KABALE,2019,3130,3220,6350,13
KABALE,2020,3180,3260,6440,13
KABALE,2021,3220,3290,6510,13
KABALE,2022,3260,3320,6580,13
KABALE,2023,3300,3350,6650,13
KABALE,2024,3340,3380,6720,13
KABALE,2025,3370,3400,6770,13
KABAROLE,2015,3520,3780,7300,13
KABAROLE,2016,3600,3870,7470,13
KABAROLE,2017,3680,3950,7630,13
KABAROLE,2018,3760,4040,7800,13
KABAROLE,2019,3840,4120,7960,13
KABAROLE,2020,3920,4200,8120,13
KABAROLE,2021,4000,4280,8280,13
KABAROLE,2022,4070,4360,8430,13
KABAROLE,2023,4150,4450,8600,13
KABAROLE,2024,4220,4520,8740,13
KABAROLE,2025,4290,4600,8890,13
KABERAMAIDO,2015,1670,1580,3250,13
KABERAMAIDO,2016,1740,1630,3370,13
KABERAMAIDO,2017,1800,1680,3480,13
KABERAMAIDO,2018,1860,1710,3570,13
KABERAMAIDO,2019,1930,1750,3680,13
KABERAMAIDO,2020,1980,1790,3770,13
KABERAMAIDO,2021,2050,1830,3880,13
KABERAMAIDO,2022,2120,1880,4000,13
KABERAMAIDO,2023,2160,1890,4050,13
KABERAMAIDO,2024,2200,1910,4110,13
KABERAMAIDO,2025,2240,1940,4180,13
KAGADI,2015,4780,4790,9570,13
KAGADI,2016,4960,4960,9920,13
KAGADI,2017,5140,5130,10270,13
KAGADI,2018,5330,5310,10640,13
KAGADI,2019,5520,5500,11020,13
KAGADI,2020,5710,5680,11390,13
KAGADI,2021,5910,5870,11780,13
KAGADI,2022,6120,6060,12180,13
KAGADI,2023,6320,6260,12580,13
KAGADI,2024,6520,6450,12970,13
KAGADI,2025,6730,6650,13380,13
KAKUMIRO,2015,3870,3980,7850,13
KAKUMIRO,2016,4220,4320,8540,13
KAKUMIRO,2017,4590,4680,9270,13
KAKUMIRO,2018,4990,5070,10060,13
KAKUMIRO,2019,5430,5500,10930,13
KAKUMIRO,2020,5900,5950,11850,13
KAKUMIRO,2021,6410,6440,12850,13
KAKUMIRO,2022,6960,6960,13920,13
KAKUMIRO,2023,7540,7520,15060,13
KAKUMIRO,2024,8180,8120,16300,13
KAKUMIRO,2025,8850,8770,17620,13
KALAKI,2015,1680,1550,3230,13
KALAKI,2016,1750,1610,3360,13
KALAKI,2017,1830,1670,3500,13
KALAKI,2018,1910,1740,3650,13
KALAKI,2019,1990,1810,3800,13
KALAKI,2020,2070,1880,3950,13
KALAKI,2021,2160,1950,4110,13
KALAKI,2022,2240,2020,4260,13
KALAKI,2023,2330,2090,4420,13
KALAKI,2024,2420,2170,4590,13
KALAKI,2025,2510,2240,4750,13
KALANGALA,2015,360,290,650,13
KALANGALA,2016,370,310,680,13
KALANGALA,2017,380,320,700,13
KALANGALA,2018,400,330,730,13
KALANGALA,2019,410,350,760,13
KALANGALA,2020,420,360,780,13
KALANGALA,2021,440,370,810,13
KALANGALA,2022,450,390,840,13
KALANGALA,2023,470,400,870,13
KALANGALA,2024,480,420,900,13
KALANGALA,2025,490,430,920,13
KALIRO,2015,3700,3700,7400,13
KALIRO,2016,3830,3790,7620,13
KALIRO,2017,3940,3880,7820,13
KALIRO,2018,4040,3940,7980,13
KALIRO,2019,4140,4010,8150,13
KALIRO,2020,4250,4080,8330,13
KALIRO,2021,4350,4170,8520,13
KALIRO,2022,4470,4250,8720,13
KALIRO,2023,4530,4250,8780,13
KALIRO,2024,4580,4300,8880,13
KALIRO,2025,4640,4350,8990,13
KALUNGU,2015,3150,3000,6150,13
KALUNGU,2016,3180,3010,6190,13
KALUNGU,2017,3200,3000,6200,13
KALUNGU,2018,3200,2980,6180,13
KALUNGU,2019,3210,2960,6170,13
KALUNGU,2020,3210,2940,6150,13
KALUNGU,2021,3220,2930,6150,13
KALUNGU,2022,3220,2910,6130,13
KALUNGU,2023,3190,2840,6030,13
KALUNGU,2024,3140,2790,5930,13
KALUNGU,2025,3110,2770,5880,13
KAMPALA,2015,12360,15160,27520,13
KAMPALA,2016,12610,15450,28060,13
KAMPALA,2017,12850,15750,28600,13
KAMPALA,2018,13100,16050,29150,13
KAMPALA,2019,13350,16350,29700,13
KAMPALA,2020,13590,16640,30230,13
KAMPALA,2021,13830,16930,30760,13
KAMPALA,2022,14060,17210,31270,13
KAMPALA,2023,14290,17490,31780,13
KAMPALA,2024,14510,17760,32270,13
KAMPALA,2025,14720,18020,32740,13
KAMULI,2015,8130,8200,16330,13
KAMULI,2016,8350,8330,16680,13
KAMULI,2017,8510,8400,16910,13
KAMULI,2018,8660,8440,17100,13
KAMULI,2019,8780,8490,17270,13
KAMULI,2020,8930,8540,17470,13
KAMULI,2021,9070,8610,17680,13
KAMULI,2022,9220,8680,17900,13
KAMULI,2023,9260,8580,17840,13
KAMULI,2024,9260,8580,17840,13
KAMULI,2025,9310,8580,17890,13
KAMWENGE,2015,3600,3500,7100,13
KAMWENGE,2016,3740,3620,7360,13
KAMWENGE,2017,3890,3750,7640,13
KAMWENGE,2018,4050,3880,7930,13
KAMWENGE,2019,4210,4020,8230,13
KAMWENGE,2020,4370,4150,8520,13
KAMWENGE,2021,4550,4290,8840,13
KAMWENGE,2022,4720,4430,9150,13
KAMWENGE,2023,4890,4580,9470,13
KAMWENGE,2024,5070,4720,9790,13
KAMWENGE,2025,5250,4870,10120,13
KANUNGU,2015,3480,3530,7010,13
KANUNGU,2016,3540,3590,7130,13
KANUNGU,2017,3610,3650,7260,13
KANUNGU,2018,3670,3710,7380,13
KANUNGU,2019,3730,3770,7500,13
KANUNGU,2020,3790,3820,7610,13
KANUNGU,2021,3850,3880,7730,13
KANUNGU,2022,3910,3930,7840,13
KANUNGU,2023,3970,3980,7950,13
KANUNGU,2024,4020,4030,8050,13
KANUNGU,2025,4070,4070,8140,13
KAPCHORWA,2015,1380,1510,2890,13
KAPCHORWA,2016,1430,1550,2980,13
KAPCHORWA,2017,1470,1590,3060,13
KAPCHORWA,2018,1510,1630,3140,13
KAPCHORWA,2019,1560,1680,3240,13
KAPCHORWA,2020,1600,1720,3320,13
KAPCHORWA,2021,1650,1760,3410,13
KAPCHORWA,2022,1690,1810,3500,13
KAPCHORWA,2023,1740,1850,3590,13
KAPCHORWA,2024,1790,1900,3690,13
KAPCHORWA,2025,1830,1940,3770,13
KAPELEBYONG,2015,1340,1240,2580,13
KAPELEBYONG,2016,1380,1260,2640,13
KAPELEBYONG,2017,1420,1290,2710,13
KAPELEBYONG,2018,1450,1290,2740,13
KAPELEBYONG,2019,1480,1310,2790,13
KAPELEBYONG,2020,1520,1320,2840,13
KAPELEBYONG,2021,1550,1340,2890,13
KAPELEBYONG,2022,1570,1360,2930,13
KAPELEBYONG,2023,1600,1350,2950,13
KAPELEBYONG,2024,1610,1360,2970,13
KAPELEBYONG,2025,1620,1360,2980,13
KASESE,2015,9810,9750,19560,13
KASESE,2016,10050,9890,19940,13
KASESE,2017,10240,9970,20210,13
KASESE,2018,10380,10020,20400,13
KASESE,2019,10520,10070,20590,13
KASESE,2020,10670,10120,20790,13
KASESE,2021,10840,10200,21040,13
KASESE,2022,10980,10270,21250,13
KASESE,2023,11020,10150,21170,13
KASESE,2024,11010,10130,21140,13
KASESE,2025,11040,10140,21180,13
KASSANDA,2015,3890,3770,7660,13
KASSANDA,2016,4010,3860,7870,13
KASSANDA,2017,4120,3940,8060,13
KASSANDA,2018,4240,4020,8260,13
KASSANDA,2019,4350,4100,8450,13
KASSANDA,2020,4470,4190,8660,13
KASSANDA,2021,4590,4270,8860,13
KASSANDA,2022,4710,4350,9060,13
KASSANDA,2023,4820,4430,9250,13
KASSANDA,2024,4940,4500,9440,13
KASSANDA,2025,5060,4580,9640,13
KATAKWI,2015,2500,2380,4880,13
KATAKWI,2016,2580,2430,5010,13
KATAKWI,2017,2630,2450,5080,13
KATAKWI,2018,2690,2470,5160,13
KATAKWI,2019,2730,2500,5230,13
KATAKWI,2020,2790,2520,5310,13
KATAKWI,2021,2850,2540,5390,13
KATAKWI,2022,2910,2570,5480,13
KATAKWI,2023,2930,2540,5470,13
KATAKWI,2024,2940,2550,5490,13
KATAKWI,2025,2970,2560,5530,13
KAYUNGA,2015,6130,5920,12050,13
KAYUNGA,2016,6250,5970,12220,13
KAYUNGA,2017,6340,5990,12330,13
KAYUNGA,2018,6400,5990,12390,13
KAYUNGA,2019,6450,5980,12430,13
KAYUNGA,2020,6510,5980,12490,13
KAYUNGA,2021,6570,6000,12570,13
KAYUNGA,2022,6640,6000,12640,13
KAYUNGA,2023,6630,5910,12540,13
KAYUNGA,2024,6590,5850,12440,13
KAYUNGA,2025,6580,5830,12410,13
KAZO,2015,2470,2340,4810,13
KAZO,2016,2560,2420,4980,13
KAZO,2017,2660,2510,5170,13
KAZO,2018,2760,2600,5360,13
KAZO,2019,2860,2690,5550,13
KAZO,2020,2960,2780,5740,13
KAZO,2021,3070,2870,5940,13
KAZO,2022,3180,2960,6140,13
KAZO,2023,3290,3060,6350,13
KAZO,2024,3400,3160,6560,13
KAZO,2025,3510,3250,6760,13
KIBAALE,2015,1940,1790,3730,13
KIBAALE,2016,2060,1900,3960,13
KIBAALE,2017,2190,2010,4200,13
KIBAALE,2018,2330,2120,4450,13
KIBAALE,2019,2480,2240,4720,13
KIBAALE,2020,2630,2370,5000,13
KIBAALE,2021,2800,2500,5300,13
KIBAALE,2022,2960,2640,5600,13
KIBAALE,2023,3140,2780,5920,13
KIBAALE,2024,3330,2930,6260,13
KIBAALE,2025,3520,3090,6610,13
KIBOGA,2015,2210,2110,4320,13
KIBOGA,2016,2270,2150,4420,13
KIBOGA,2017,2320,2170,4490,13
KIBOGA,2018,2360,2180,4540,13
KIBOGA,2019,2390,2200,4590,13
KIBOGA,2020,2430,2220,4650,13
KIBOGA,2021,2470,2230,4700,13
KIBOGA,2022,2510,2250,4760,13
KIBOGA,2023,2530,2230,4760,13
KIBOGA,2024,2520,2230,4750,13
KIBOGA,2025,2540,2240,4780,13
KIBUKU,2015,3090,3010,6100,13
KIBUKU,2016,3210,3110,6320,13
KIBUKU,2017,3310,3180,6490,13
KIBUKU,2018,3410,3240,6650,13
KIBUKU,2019,3500,3300,6800,13
KIBUKU,2020,3600,3370,6970,13
KIBUKU,2021,3700,3440,7140,13
KIBUKU,2022,3820,3520,7340,13
KIBUKU,2023,3870,3530,7400,13
KIBUKU,2024,3930,3570,7500,13
KIBUKU,2025,3990,3630,7620,13
KIKUUBE,2015,3550,3280,6830,13
KIKUUBE,2016,3740,3450,7190,13
KIKUUBE,2017,3940,3630,7570,13
KIKUUBE,2018,4150,3810,7960,13
KIKUUBE,2019,4370,4000,8370,13
KIKUUBE,2020,4600,4200,8800,13
KIKUUBE,2021,4830,4400,9230,13
KIKUUBE,2022,5070,4620,9690,13
KIKUUBE,2023,5330,4830,10160,13
KIKUUBE,2024,5590,5060,10650,13
KIKUUBE,2025,5850,5290,11140,13
KIRUHURA,2015,1870,1870,3740,13
KIRUHURA,2016,1950,1940,3890,13
KIRUHURA,2017,2020,2000,4020,13
KIRUHURA,2018,2100,2070,4170,13
KIRUHURA,2019,2170,2140,4310,13
KIRUHURA,2020,2260,2220,4480,13
KIRUHURA,2021,2330,2290,4620,13
KIRUHURA,2022,2420,2370,4790,13
KIRUHURA,2023,2500,2440,4940,13
KIRUHURA,2024,2580,2520,5100,13
KIRUHURA,2025,2660,2590,5250,13
KIRYANDONGO,2015,3960,3760,7720,13
KIRYANDONGO,2016,4090,3840,7930,13
KIRYANDONGO,2017,4200,3890,8090,13
KIRYANDONGO,2018,4280,3920,8200,13
KIRYANDONGO,2019,4360,3960,8320,13
KIRYANDONGO,2020,4450,4010,8460,13
KIRYANDONGO,2021,4540,4060,8600,13
KIRYANDONGO,2022,4630,4110,8740,13
KIRYANDONGO,2023,4680,4080,8760,13
KIRYANDONGO,2024,4690,4090,8780,13
KIRYANDONGO,2025,4740,4110,8850,13
KISORO,2015,3980,4120,8100,13
KISORO,2016,4060,4170,8230,13
KISORO,2017,4110,4190,8300,13
KISORO,2018,4160,4210,8370,13
KISORO,2019,4200,4220,8420,13
KISORO,2020,4240,4230,8470,13
KISORO,2021,4270,4250,8520,13
KISORO,2022,4320,4270,8590,13
KISORO,2023,4310,4220,8530,13
KISORO,2024,4290,4200,8490,13
KISORO,2025,4280,4190,8470,13
KITAGWENDA,2015,1930,1980,3910,13
KITAGWENDA,2016,2020,2050,4070,13
KITAGWENDA,2017,2100,2130,4230,13
KITAGWENDA,2018,2180,2200,4380,13
KITAGWENDA,2019,2270,2280,4550,13
KITAGWENDA,2020,2360,2360,4720,13
KITAGWENDA,2021,2450,2440,4890,13
KITAGWENDA,2022,2540,2520,5060,13
KITAGWENDA,2023,2640,2600,5240,13
KITAGWENDA,2024,2730,2680,5410,13
KITAGWENDA,2025,2820,2760,5580,13
KITGUM,2015,2760,2790,5550,13
KITGUM,2016,2810,2820,5630,13
KITGUM,2017,2830,2830,5660,13
KITGUM,2018,2860,2820,5680,13
KITGUM,2019,2880,2820,5700,13
KITGUM,2020,2890,2820,5710,13
KITGUM,2021,2910,2820,5730,13
KITGUM,2022,2930,2820,5750,13
KITGUM,2023,2910,2770,5680,13
KITGUM,2024,2890,2750,5640,13
KITGUM,2025,2880,2730,5610,13
KOBOKO,2015,3090,3100,6190,13
KOBOKO,2016,3220,3190,6410,13
KOBOKO,2017,3320,3270,6590,13
KOBOKO,2018,3420,3340,6760,13
KOBOKO,2019,3520,3400,6920,13
KOBOKO,2020,3620,3480,7100,13
KOBOKO,2021,3730,3560,7290,13
KOBOKO,2022,3850,3650,7500,13
KOBOKO,2023,3910,3660,7570,13
KOBOKO,2024,3980,3710,7690,13
KOBOKO,2025,4040,3770,7810,13
KOLE,2015,3370,3310,6680,13
KOLE,2016,3480,3400,6880,13
KOLE,2017,3590,3500,7090,13
KOLE,2018,3710,3600,7310,13
KOLE,2019,3830,3700,7530,13
KOLE,2020,3950,3800,7750,13
KOLE,2021,4070,3910,7980,13
KOLE,2022,4190,4010,8200,13
KOLE,2023,4310,4110,8420,13
KOLE,2024,4430,4210,8640,13
KOLE,2025,4550,4310,8860,13
KOTIDO,2015,2130,2080,4210,13
KOTIDO,2016,2180,2110,4290,13
KOTIDO,2017,2220,2120,4340,13
KOTIDO,2018,2250,2130,4380,13
KOTIDO,2019,2290,2140,4430,13
KOTIDO,2020,2320,2160,4480,13
KOTIDO,2021,2350,2170,4520,13
KOTIDO,2022,2380,2180,4560,13
KOTIDO,2023,2400,2150,4550,13
KOTIDO,2024,2400,2160,4560,13
KOTIDO,2025,2400,2150,4550,13
KUMI,2015,3680,3520,7200,13
KUMI,2016,3800,3600,7400,13
KUMI,2017,3890,3650,7540,13
KUMI,2018,3980,3690,7670,13
KUMI,2019,4070,3730,7800,13
KUMI,2020,4150,3790,7940,13
KUMI,2021,4250,3840,8090,13
KUMI,2022,4340,3890,8230,13
KUMI,2023,4390,3870,8260,13
KUMI,2024,4420,3890,8310,13
KUMI,2025,4460,3920,8380,13
KWANIA,2015,2620,2570,5190,13
KWANIA,2016,2710,2650,5360,13
KWANIA,2017,2790,2720,5510,13
KWANIA,2018,2880,2800,5680,13
KWANIA,2019,2960,2880,5840,13
KWANIA,2020,3050,2960,6010,13
KWANIA,2021,3140,3040,6180,13
KWANIA,2022,3230,3110,6340,13
KWANIA,2023,3310,3190,6500,13
KWANIA,2024,3400,3270,6670,13
KWANIA,2025,3490,3350,6840,13
KWEEN,2015,1190,1230,2420,13
KWEEN,2016,1230,1270,2500,13
KWEEN,2017,1270,1300,2570,13
KWEEN,2018,1310,1330,2640,13
KWEEN,2019,1350,1360,2710,13
KWEEN,2020,1390,1390,2780,13
KWEEN,2021,1430,1420,2850,13
KWEEN,2022,1470,1460,2930,13
KWEEN,2023,1510,1490,3000,13
KWEEN,2024,1550,1520,3070,13
KWEEN,2025,1590,1550,3140,13
KYANKWANZI,2015,2790,2860,5650,13
KYANKWANZI,2016,2940,3000,5940,13
KYANKWANZI,2017,3090,3140,6230,13
KYANKWANZI,2018,3250,3280,6530,13
KYANKWANZI,2019,3410,3430,6840,13
KYANKWANZI,2020,3580,3590,7170,13
KYANKWANZI,2021,3750,3750,7500,13
KYANKWANZI,2022,3930,3910,7840,13
KYANKWANZI,2023,4120,4080,8200,13
KYANKWANZI,2024,4310,4250,8560,13
KYANKWANZI,2025,4510,4430,8940,13
KYEGEGWA,2015,3920,3750,7670,13
KYEGEGWA,2016,4250,4050,8300,13
KYEGEGWA,2017,4600,4370,8970,13
KYEGEGWA,2018,4970,4710,9680,13
KYEGEGWA,2019,5370,5080,10450,13
KYEGEGWA,2020,5810,5470,11280,13
KYEGEGWA,2021,6270,5890,12160,13
KYEGEGWA,2022,6770,6340,13110,13
KYEGEGWA,2023,7300,6820,14120,13
KYEGEGWA,2024,7860,7330,15190,13
KYEGEGWA,2025,8460,7870,16330,13
KYENJOJO,2015,5720,5410,11130,13
KYENJOJO,2016,5960,5610,11570,13
KYENJOJO,2017,6200,5820,12020,13
KYENJOJO,2018,6460,6030,12490,13
KYENJOJO,2019,6710,6250,12960,13
KYENJOJO,2020,6980,6470,13450,13
KYENJOJO,2021,7250,6700,13950,13
KYENJOJO,2022,7520,6930,14450,13
KYENJOJO,2023,7800,7160,14960,13
KYENJOJO,2024,8090,7390,15480,13
KYENJOJO,2025,8370,7630,16000,13
KYOTERA,2015,4000,3770,7770,13
KYOTERA,2016,4070,3790,7860,13
KYOTERA,2017,4110,3790,7900,13
KYOTERA,2018,4130,3780,7910,13
KYOTERA,2019,4150,3770,7920,13
KYOTERA,2020,4190,3760,7950,13
KYOTERA,2021,4210,3750,7960,13
KYOTERA,2022,4240,3750,7990,13
KYOTERA,2023,4220,3680,7900,13
KYOTERA,2024,4180,3640,7820,13
KYOTERA,2025,4170,3610,7780,13
KARENGA,2015,680,710,1390,13
KARENGA,2016,700,720,1420,13
KARENGA,2017,710,740,1450,13
KARENGA,2018,740,760,1500,13
KARENGA,2019,750,780,1530,13
KARENGA,2020,780,800,1580,13
KARENGA,2021,790,810,1600,13
KARENGA,2022,810,830,1640,13
KARENGA,2023,830,850,1680,13
KARENGA,2024,850,870,1720,13
KARENGA,2025,870,880,1750,13
LAMWO,2015,1890,1760,3650,13
LAMWO,2016,1910,1780,3690,13
LAMWO,2017,1910,1780,3690,13
LAMWO,2018,1920,1780,3700,13
LAMWO,2019,1910,1770,3680,13
LAMWO,2020,1910,1770,3680,13
LAMWO,2021,1900,1770,3670,13
LAMWO,2022,1910,1770,3680,13
LAMWO,2023,1880,1740,3620,13
LAMWO,2024,1850,1720,3570,13
LAMWO,2025,1830,1710,3540,13
LIRA,2015,5160,5770,10930,13
LIRA,2016,5310,5930,11240,13
LIRA,2017,5460,6100,11560,13
LIRA,2018,5610,6270,11880,13
LIRA,2019,5760,6450,12210,13
LIRA,2020,5920,6620,12540,13
LIRA,2021,6070,6800,12870,13
LIRA,2022,6220,6970,13190,13
LIRA,2023,6380,7150,13530,13
LIRA,2024,6520,7320,13840,13
LIRA,2025,6670,7500,14170,13
LUUKA,2015,3830,3850,7680,13
LUUKA,2016,3910,3900,7810,13
LUUKA,2017,3970,3920,7890,13
LUUKA,2018,4010,3930,7940,13
LUUKA,2019,4050,3940,7990,13
LUUKA,2020,4080,3950,8030,13
LUUKA,2021,4130,3970,8100,13
LUUKA,2022,4180,3990,8170,13
LUUKA,2023,4170,3940,8110,13
LUUKA,2024,4150,3920,8070,13
LUUKA,2025,4150,3920,8070,13
LUWERO,2015,7380,7230,14610,13
LUWERO,2016,7560,7340,14900,13
LUWERO,2017,7700,7400,15100,13
LUWERO,2018,7820,7440,15260,13
LUWERO,2019,7930,7470,15400,13
LUWERO,2020,8050,7520,15570,13
LUWERO,2021,8180,7580,15760,13
LUWERO,2022,8300,7640,15940,13
LUWERO,2023,8330,7560,15890,13
LUWERO,2024,8330,7550,15880,13
LUWERO,2025,8360,7550,15910,13
LWENGO,2015,4480,4370,8850,13
LWENGO,2016,4530,4380,8910,13
LWENGO,2017,4550,4360,8910,13
LWENGO,2018,4540,4330,8870,13
LWENGO,2019,4550,4290,8840,13
LWENGO,2020,4540,4260,8800,13
LWENGO,2021,4550,4230,8780,13
LWENGO,2022,4550,4210,8760,13
LWENGO,2023,4510,4110,8620,13
LWENGO,2024,4440,4050,8490,13
LWENGO,2025,4400,4010,8410,13
LYANTONDE,2015,1390,1310,2700,13
LYANTONDE,2016,1430,1340,2770,13
LYANTONDE,2017,1460,1360,2820,13
LYANTONDE,2018,1490,1380,2870,13
LYANTONDE,2019,1510,1380,2890,13
LYANTONDE,2020,1540,1400,2940,13
LYANTONDE,2021,1580,1420,3000,13
LYANTONDE,2022,1600,1440,3040,13
LYANTONDE,2023,1630,1430,3060,13
LYANTONDE,2024,1630,1440,3070,13
LYANTONDE,2025,1640,1440,3080,13
MANAFWA,2015,2050,2060,4110,13
MANAFWA,2016,2100,2110,4210,13
MANAFWA,2017,2150,2160,4310,13
MANAFWA,2018,2210,2200,4410,13
MANAFWA,2019,2260,2250,4510,13
MANAFWA,2020,2310,2300,4610,13
MANAFWA,2021,2360,2350,4710,13
MANAFWA,2022,2420,2390,4810,13
MANAFWA,2023,2470,2440,4910,13
MANAFWA,2024,2520,2480,5000,13
MANAFWA,2025,2570,2520,5090,13
MARACHA,2015,2650,2470,5120,13
MARACHA,2016,2710,2520,5230,13
MARACHA,2017,2760,2570,5330,13
MARACHA,2018,2820,2620,5440,13
MARACHA,2019,2880,2660,5540,13
MARACHA,2020,2930,2710,5640,13
MARACHA,2021,2990,2760,5750,13
MARACHA,2022,3040,2800,5840,13
MARACHA,2023,3100,2850,5950,13
MARACHA,2024,3150,2890,6040,13
MARACHA,2025,3200,2940,6140,13
MASAKA,2015,4420,4370,8790,13
MASAKA,2016,4520,4430,8950,13
MASAKA,2017,4590,4450,9040,13
MASAKA,2018,4650,4470,9120,13
MASAKA,2019,4700,4490,9190,13
MASAKA,2020,4760,4500,9260,13
MASAKA,2021,4820,4530,9350,13
MASAKA,2022,4890,4560,9450,13
MASAKA,2023,4890,4490,9380,13
MASAKA,2024,4880,4480,9360,13
MASAKA,2025,4880,4480,9360,13
MASINDI,2015,3610,3570,7180,13
MASINDI,2016,3710,3670,7380,13
MASINDI,2017,3820,3770,7590,13
MASINDI,2018,3930,3870,7800,13
MASINDI,2019,4040,3970,8010,13
MASINDI,2020,4150,4070,8220,13
MASINDI,2021,4270,4170,8440,13
MASINDI,2022,4380,4270,8650,13
MASINDI,2023,4490,4370,8860,13
MASINDI,2024,4600,4460,9060,13
MASINDI,2025,4710,4560,9270,13
MAYUGE,2015,6750,6920,13670,13
MAYUGE,2016,6970,7090,14060,13
MAYUGE,2017,7140,7210,14350,13
MAYUGE,2018,7300,7300,14600,13
MAYUGE,2019,7450,7390,14840,13
MAYUGE,2020,7600,7500,15100,13
MAYUGE,2021,7770,7620,15390,13
MAYUGE,2022,7930,7750,15680,13
MAYUGE,2023,8020,7720,15740,13
MAYUGE,2024,8070,7770,15840,13
MAYUGE,2025,8150,7840,15990,13
MBALE,2015,6330,6740,13070,13
MBALE,2016,6530,6910,13440,13
MBALE,2017,6680,7040,13720,13
MBALE,2018,6820,7160,13980,13
MBALE,2019,6960,7270,14230,13
MBALE,2020,7100,7400,14500,13
MBALE,2021,7250,7530,14780,13
MBALE,2022,7400,7670,15070,13
MBALE,2023,7460,7650,15110,13
MBALE,2024,7500,7720,15220,13
MBALE,2025,7570,7810,15380,13
MBARARA,2015,3810,4140,7950,13
MBARARA,2016,3900,4230,8130,13
MBARARA,2017,3980,4320,8300,13
MBARARA,2018,4080,4410,8490,13
MBARARA,2019,4170,4500,8670,13
MBARARA,2020,4260,4590,8850,13
MBARARA,2021,4340,4680,9020,13
MBARARA,2022,4430,4770,9200,13
MBARARA,2023,4520,4860,9380,13
MBARARA,2024,4600,4940,9540,13
MBARARA,2025,4680,5020,9700,13
MITOOMA,2015,2580,2510,5090,13
MITOOMA,2016,2610,2530,5140,13
MITOOMA,2017,2650,2560,5210,13
MITOOMA,2018,2680,2580,5260,13
MITOOMA,2019,2710,2600,5310,13
MITOOMA,2020,2740,2620,5360,13
MITOOMA,2021,2760,2640,5400,13
MITOOMA,2022,2790,2660,5450,13
MITOOMA,2023,2810,2670,5480,13
MITOOMA,2024,2830,2690,5520,13
MITOOMA,2025,2850,2700,5550,13
MITYANA,2015,5220,4890,10110,13
MITYANA,2016,5330,4930,10260,13
MITYANA,2017,5380,4930,10310,13
MITYANA,2018,5430,4930,10360,13
MITYANA,2019,5470,4930,10400,13
MITYANA,2020,5510,4920,10430,13
MITYANA,2021,5570,4930,10500,13
MITYANA,2022,5610,4930,10540,13
MITYANA,2023,5590,4850,10440,13
MITYANA,2024,5560,4810,10370,13
MITYANA,2025,5540,4780,10320,13
MOROTO,2015,1160,1100,2260,13
MOROTO,2016,1190,1130,2320,13
MOROTO,2017,1220,1140,2360,13
MOROTO,2018,1220,1140,2360,13
MOROTO,2019,1240,1150,2390,13
MOROTO,2020,1260,1170,2430,13
MOROTO,2021,1270,1180,2450,13
MOROTO,2022,1290,1190,2480,13
MOROTO,2023,1290,1180,2470,13
MOROTO,2024,1290,1180,2470,13
MOROTO,2025,1290,1180,2470,13
MOYO,2015,1430,1390,2820,13
MOYO,2016,1460,1430,2890,13
MOYO,2017,1500,1450,2950,13
MOYO,2018,1540,1490,3030,13
MOYO,2019,1580,1520,3100,13
MOYO,2020,1610,1550,3160,13
MOYO,2021,1650,1580,3230,13
MOYO,2022,1690,1610,3300,13
MOYO,2023,1730,1640,3370,13
MOYO,2024,1770,1670,3440,13
MOYO,2025,1800,1700,3500,13
MPIGI,2015,4090,3770,7860,13
MPIGI,2016,4200,3840,8040,13
MPIGI,2017,4270,3870,8140,13
MPIGI,2018,4330,3890,8220,13
MPIGI,2019,4390,3910,8300,13
MPIGI,2020,4450,3940,8390,13
MPIGI,2021,4520,3970,8490,13
MPIGI,2022,4570,4010,8580,13
MPIGI,2023,4590,3970,8560,13
MPIGI,2024,4590,3960,8550,13
MPIGI,2025,4600,3970,8570,13
MUBENDE,2015,5800,5640,11440,13
MUBENDE,2016,6110,5880,11990,13
MUBENDE,2017,6400,6100,12500,13
MUBENDE,2018,6680,6300,12980,13
MUBENDE,2019,6950,6520,13470,13
MUBENDE,2020,7250,6740,13990,13
MUBENDE,2021,7560,6980,14540,13
MUBENDE,2022,7880,7240,15120,13
MUBENDE,2023,8130,7360,15490,13
MUBENDE,2024,8350,7560,15910,13
MUBENDE,2025,8610,7780,16390,13
MUKONO,2015,8330,8400,16730,13
MUKONO,2016,8570,8580,17150,13
MUKONO,2017,8750,8710,17460,13
MUKONO,2018,8900,8820,17720,13
MUKONO,2019,9040,8920,17960,13
MUKONO,2020,9200,9030,18230,13
MUKONO,2021,9360,9160,18520,13
MUKONO,2022,9520,9300,18820,13
MUKONO,2023,9580,9260,18840,13
MUKONO,2024,9600,9300,18900,13
MUKONO,2025,9650,9370,19020,13
MADI OKOLLO,2015,1900,1730,3630,13
MADI OKOLLO,2016,1950,1790,3740,13
MADI OKOLLO,2017,2020,1830,3850,13
MADI OKOLLO,2018,2070,1880,3950,13
MADI OKOLLO,2019,2130,1930,4060,13
MADI OKOLLO,2020,2190,1980,4170,13
MADI OKOLLO,2021,2250,2030,4280,13
MADI OKOLLO,2022,2310,2080,4390,13
MADI OKOLLO,2023,2370,2120,4490,13
MADI OKOLLO,2024,2420,2170,4590,13
MADI OKOLLO,2025,2480,2220,4700,13
NABILATUK,2015,900,900,1800,13
NABILATUK,2016,940,940,1880,13
NABILATUK,2017,980,970,1950,13
NABILATUK,2018,1030,990,2020,13
NABILATUK,2019,1060,1010,2070,13
NABILATUK,2020,1110,1040,2150,13
NABILATUK,2021,1150,1080,2230,13
NABILATUK,2022,1200,1110,2310,13
NABILATUK,2023,1230,1110,2340,13
NABILATUK,2024,1260,1140,2400,13
NABILATUK,2025,1300,1160,2460,13
NAKAPIRIPIRIT,2015,1020,990,2010,13
NAKAPIRIPIRIT,2016,1070,1030,2100,13
NAKAPIRIPIRIT,2017,1110,1060,2170,13
NAKAPIRIPIRIT,2018,1150,1080,2230,13
NAKAPIRIPIRIT,2019,1180,1110,2290,13
NAKAPIRIPIRIT,2020,1220,1150,2370,13
NAKAPIRIPIRIT,2021,1270,1170,2440,13
NAKAPIRIPIRIT,2022,1310,1210,2520,13
NAKAPIRIPIRIT,2023,1340,1220,2560,13
NAKAPIRIPIRIT,2024,1370,1250,2620,13
NAKAPIRIPIRIT,2025,1390,1270,2660,13
NAKASEKE,2015,2920,2730,5650,13
NAKASEKE,2016,3030,2790,5820,13
NAKASEKE,2017,3140,2860,6000,13
NAKASEKE,2018,3250,2930,6180,13
NAKASEKE,2019,3370,3000,6370,13
NAKASEKE,2020,3490,3060,6550,13
NAKASEKE,2021,3610,3130,6740,13
NAKASEKE,2022,3730,3200,6930,13
NAKASEKE,2023,3850,3260,7110,13
NAKASEKE,2024,3970,3330,7300,13
NAKASEKE,2025,4100,3390,7490,13
NAKASONGOLA,2015,2800,2650,5450,13
NAKASONGOLA,2016,2900,2700,5600,13
NAKASONGOLA,2017,2970,2730,5700,13
NAKASONGOLA,2018,3040,2760,5800,13
NAKASONGOLA,2019,3100,2790,5890,13
NAKASONGOLA,2020,3160,2820,5980,13
NAKASONGOLA,2021,3240,2850,6090,13
NAKASONGOLA,2022,3310,2880,6190,13
NAKASONGOLA,2023,3340,2870,6210,13
NAKASONGOLA,2024,3370,2880,6250,13
NAKASONGOLA,2025,3390,2890,6280,13
NAMAYINGO,2015,2970,2650,5620,13
NAMAYINGO,2016,3040,2670,5710,13
NAMAYINGO,2017,3070,2660,5730,13
NAMAYINGO,2018,3100,2660,5760,13
NAMAYINGO,2019,3120,2660,5780,13
NAMAYINGO,2020,3150,2650,5800,13
NAMAYINGO,2021,3170,2650,5820,13
NAMAYINGO,2022,3200,2650,5850,13
NAMAYINGO,2023,3190,2600,5790,13
NAMAYINGO,2024,3170,2580,5750,13
NAMAYINGO,2025,3170,2560,5730,13
NAMISINDWA,2015,2610,2540,5150,13
NAMISINDWA,2016,2690,2600,5290,13
NAMISINDWA,2017,2760,2660,5420,13
NAMISINDWA,2018,2840,2720,5560,13
NAMISINDWA,2019,2910,2790,5700,13
NAMISINDWA,2020,2990,2850,5840,13
NAMISINDWA,2021,3070,2910,5980,13
NAMISINDWA,2022,3140,2970,6110,13
NAMISINDWA,2023,3220,3030,6250,13
NAMISINDWA,2024,3290,3090,6380,13
NAMISINDWA,2025,3370,3150,6520,13
NAMUTUMBA,2015,4030,3790,7820,13
NAMUTUMBA,2016,4180,3890,8070,13
NAMUTUMBA,2017,4290,3960,8250,13
NAMUTUMBA,2018,4410,4020,8430,13
NAMUTUMBA,2019,4520,4080,8600,13
NAMUTUMBA,2020,4630,4150,8780,13
NAMUTUMBA,2021,4740,4220,8960,13
NAMUTUMBA,2022,4870,4290,9160,13
NAMUTUMBA,2023,4930,4290,9220,13
NAMUTUMBA,2024,4980,4320,9300,13
NAMUTUMBA,2025,5040,4370,9410,13
NAPAK,2015,1710,1620,3330,13
NAPAK,2016,1740,1640,3380,13
NAPAK,2017,1760,1640,3400,13
NAPAK,2018,1760,1650,3410,13
NAPAK,2019,1770,1660,3430,13
NAPAK,2020,1790,1670,3460,13
NAPAK,2021,1800,1680,3480,13
NAPAK,2022,1810,1690,3500,13
NAPAK,2023,1800,1660,3460,13
NAPAK,2024,1780,1660,3440,13
NAPAK,2025,1770,1660,3430,13
NEBBI,2015,3540,3280,6820,13
NEBBI,2016,3650,3380,7030,13
NEBBI,2017,3770,3470,7240,13
NEBBI,2018,3890,3570,7460,13
NEBBI,2019,4010,3670,7680,13
NEBBI,2020,4130,3770,7900,13
NEBBI,2021,4250,3870,8120,13
NEBBI,2022,4370,3970,8340,13
NEBBI,2023,4500,4070,8570,13
NEBBI,2024,4620,4170,8790,13
NEBBI,2025,4740,4260,9000,13
NGORA,2015,2140,2100,4240,13
NGORA,2016,2200,2140,4340,13
NGORA,2017,2250,2160,4410,13
NGORA,2018,2300,2170,4470,13
NGORA,2019,2340,2200,4540,13
NGORA,2020,2380,2220,4600,13
NGORA,2021,2430,2250,4680,13
NGORA,2022,2470,2270,4740,13
NGORA,2023,2490,2260,4750,13
NGORA,2024,2490,2260,4750,13
NGORA,2025,2520,2270,4790,13
NTOROKO,2015,980,910,1890,13
NTOROKO,2016,1010,930,1940,13
NTOROKO,2017,1030,930,1960,13
NTOROKO,2018,1050,930,1980,13
NTOROKO,2019,1060,940,2000,13
NTOROKO,2020,1080,930,2010,13
NTOROKO,2021,1090,940,2030,13
NTOROKO,2022,1110,950,2060,13
NTOROKO,2023,1110,930,2040,13
NTOROKO,2024,1110,930,2040,13
NTOROKO,2025,1120,920,2040,13
NTUNGAMO,2015,6460,6400,12860,13
NTUNGAMO,2016,6600,6520,13120,13
NTUNGAMO,2017,6740,6640,13380,13
NTUNGAMO,2018,6880,6770,13650,13
NTUNGAMO,2019,7020,6890,13910,13
NTUNGAMO,2020,7160,7000,14160,13
NTUNGAMO,2021,7300,7120,14420,13
NTUNGAMO,2022,7430,7230,14660,13
NTUNGAMO,2023,7570,7340,14910,13
NTUNGAMO,2024,7700,7450,15150,13
NTUNGAMO,2025,7820,7550,15370,13
NWOYA,2015,2040,1900,3940,13
NWOYA,2016,2250,2090,4340,13
NWOYA,2017,2490,2310,4800,13
NWOYA,2018,2750,2540,5290,13
NWOYA,2019,3040,2800,5840,13
NWOYA,2020,3350,3080,6430,13
NWOYA,2021,3690,3380,7070,13
NWOYA,2022,4060,3720,7780,13
NWOYA,2023,4470,4090,8560,13
NWOYA,2024,4920,4490,9410,13
NWOYA,2025,5410,4920,10330,13
OBONGI,2015,620,630,1250,13
OBONGI,2016,640,640,1280,13
OBONGI,2017,660,650,1310,13
OBONGI,2018,660,650,1310,13
OBONGI,2019,670,650,1320,13
OBONGI,2020,680,660,1340,13
OBONGI,2021,690,660,1350,13
OBONGI,2022,700,660,1360,13
OBONGI,2023,700,660,1360,13
OBONGI,2024,700,660,1360,13
OBONGI,2025,710,650,1360,13
OMORO,2015,2520,2420,4940,13
OMORO,2016,2610,2480,5090,13
OMORO,2017,2690,2530,5220,13
OMORO,2018,2750,2580,5330,13
OMORO,2019,2820,2620,5440,13
OMORO,2020,2890,2670,5560,13
OMORO,2021,2960,2720,5680,13
OMORO,2022,3040,2780,5820,13
OMORO,2023,3080,2780,5860,13
OMORO,2024,3110,2800,5910,13
OMORO,2025,3160,2840,6000,13
OTUKE,2015,1430,1370,2800,13
OTUKE,2016,1500,1420,2920,13
OTUKE,2017,1570,1490,3060,13
OTUKE,2018,1640,1550,3190,13
OTUKE,2019,1710,1620,3330,13
OTUKE,2020,1780,1680,3460,13
OTUKE,2021,1860,1750,3610,13
OTUKE,2022,1940,1820,3760,13
OTUKE,2023,2020,1890,3910,13
OTUKE,2024,2100,1970,4070,13
OTUKE,2025,2180,2040,4220,13
OYAM,2015,5240,5240,10480,13
OYAM,2016,5410,5390,10800,13
OYAM,2017,5570,5550,11120,13
OYAM,2018,5740,5710,11450,13
OYAM,2019,5910,5870,11780,13
OYAM,2020,6080,6030,12110,13
OYAM,2021,6250,6200,12450,13
OYAM,2022,6430,6360,12790,13
OYAM,2023,6600,6530,13130,13
OYAM,2024,6770,6690,13460,13
OYAM,2025,6940,6850,13790,13
PADER,2015,2790,2540,5330,13
PADER,2016,2830,2560,5390,13
PADER,2017,2870,2580,5450,13
PADER,2018,2890,2590,5480,13
PADER,2019,2910,2600,5510,13
PADER,2020,2930,2600,5530,13
PADER,2021,2950,2610,5560,13
PADER,2022,2970,2620,5590,13
PADER,2023,2960,2580,5540,13
PADER,2024,2940,2570,5510,13
PADER,2025,2920,2560,5480,13
PAKWACH,2015,2120,1930,4050,13
PAKWACH,2016,2210,2000,4210,13
PAKWACH,2017,2300,2070,4370,13
PAKWACH,2018,2400,2150,4550,13
PAKWACH,2019,2500,2220,4720,13
PAKWACH,2020,2600,2300,4900,13
PAKWACH,2021,2700,2380,5080,13
PAKWACH,2022,2810,2460,5270,13
PAKWACH,2023,2910,2540,5450,13
PAKWACH,2024,3020,2620,5640,13
PAKWACH,2025,3130,2710,5840,13
PALLISA,2015,4260,4310,8570,13
PALLISA,2016,4450,4460,8910,13
PALLISA,2017,4630,4580,9210,13
PALLISA,2018,4790,4700,9490,13
PALLISA,2019,4950,4830,9780,13
PALLISA,2020,5120,4950,10070,13
PALLISA,2021,5300,5100,10400,13
PALLISA,2022,5490,5240,10730,13
PALLISA,2023,5620,5280,10900,13
PALLISA,2024,5720,5380,11100,13
PALLISA,2025,5850,5500,11350,13
RAKAI,2015,4590,4310,8900,13
RAKAI,2016,4710,4370,9080,13
RAKAI,2017,4800,4410,9210,13
RAKAI,2018,4880,4430,9310,13
RAKAI,2019,4950,4460,9410,13
RAKAI,2020,5030,4480,9510,13
RAKAI,2021,5110,4520,9630,13
RAKAI,2022,5180,4560,9740,13
RAKAI,2023,5200,4510,9710,13
RAKAI,2024,5210,4500,9710,13
RAKAI,2025,5220,4510,9730,13
RUBANDA,2015,2620,2650,5270,13
RUBANDA,2016,2650,2670,5320,13
RUBANDA,2017,2690,2690,5380,13
RUBANDA,2018,2720,2710,5430,13
RUBANDA,2019,2760,2730,5490,13
RUBANDA,2020,2790,2750,5540,13
RUBANDA,2021,2820,2770,5590,13
RUBANDA,2022,2850,2780,5630,13
RUBANDA,2023,2880,2790,5670,13
RUBANDA,2024,2900,2810,5710,13
RUBANDA,2025,2930,2810,5740,13
RUBIRIZI,2015,1880,1890,3770,13
RUBIRIZI,2016,1920,1930,3850,13
RUBIRIZI,2017,1960,1970,3930,13
RUBIRIZI,2018,1990,2000,3990,13
RUBIRIZI,2019,2030,2040,4070,13
RUBIRIZI,2020,2070,2070,4140,13
RUBIRIZI,2021,2110,2110,4220,13
RUBIRIZI,2022,2140,2150,4290,13
RUBIRIZI,2023,2180,2180,4360,13
RUBIRIZI,2024,2220,2210,4430,13
RUBIRIZI,2025,2250,2240,4490,13
RUKIGA,2015,1400,1280,2680,13
RUKIGA,2016,1420,1280,2700,13
RUKIGA,2017,1430,1290,2720,13
RUKIGA,2018,1450,1300,2750,13
RUKIGA,2019,1460,1310,2770,13
RUKIGA,2020,1470,1320,2790,13
RUKIGA,2021,1480,1320,2800,13
RUKIGA,2022,1500,1330,2830,13
RUKIGA,2023,1510,1340,2850,13
RUKIGA,2024,1510,1340,2850,13
RUKIGA,2025,1520,1340,2860,13
RUKUNGIRI,2015,4220,4250,8470,13
RUKUNGIRI,2016,4270,4290,8560,13
RUKUNGIRI,2017,4320,4340,8660,13
RUKUNGIRI,2018,4370,4380,8750,13
RUKUNGIRI,2019,4420,4410,8830,13
RUKUNGIRI,2020,4470,4450,8920,13
RUKUNGIRI,2021,4510,4490,9000,13
RUKUNGIRI,2022,4560,4520,9080,13
RUKUNGIRI,2023,4590,4550,9140,13
RUKUNGIRI,2024,4630,4570,9200,13
RUKUNGIRI,2025,4660,4600,9260,13
RWAMPARA,2015,1760,1740,3500,13
RWAMPARA,2016,1790,1770,3560,13
RWAMPARA,2017,1840,1810,3650,13
RWAMPARA,2018,1870,1850,3720,13
RWAMPARA,2019,1920,1890,3810,13
RWAMPARA,2020,1960,1930,3890,13
RWAMPARA,2021,2000,1970,3970,13
RWAMPARA,2022,2040,2000,4040,13
RWAMPARA,2023,2070,2040,4110,13
RWAMPARA,2024,2110,2080,4190,13
RWAMPARA,2025,2150,2110,4260,13
SERERE,2015,4300,4190,8490,13
SERERE,2016,4470,4330,8800,13
SERERE,2017,4620,4430,9050,13
SERERE,2018,4770,4530,9300,13
SERERE,2019,4910,4630,9540,13
SERERE,2020,5070,4740,9810,13
SERERE,2021,5220,4850,10070,13
SERERE,2022,5380,4980,10360,13
SERERE,2023,5490,5000,10490,13
SERERE,2024,5570,5070,10640,13
SERERE,2025,5670,5170,10840,13
SHEEMA,2015,2880,2850,5730,13
SHEEMA,2016,2920,2880,5800,13
SHEEMA,2017,2960,2910,5870,13
SHEEMA,2018,2990,2940,5930,13
SHEEMA,2019,3020,2970,5990,13
SHEEMA,2020,3060,2990,6050,13
SHEEMA,2021,3090,3020,6110,13
SHEEMA,2022,3120,3040,6160,13
SHEEMA,2023,3140,3060,6200,13
SHEEMA,2024,3170,3080,6250,13
SHEEMA,2025,3190,3100,6290,13
SIRONKO,2015,3350,3250,6600,13
SIRONKO,2016,3430,3310,6740,13
SIRONKO,2017,3520,3380,6900,13
SIRONKO,2018,3600,3450,7050,13
SIRONKO,2019,3680,3510,7190,13
SIRONKO,2020,3760,3580,7340,13
SIRONKO,2021,3840,3650,7490,13
SIRONKO,2022,3920,3710,7630,13
SIRONKO,2023,4000,3770,7770,13
SIRONKO,2024,4080,3830,7910,13
SIRONKO,2025,4160,3900,8060,13
SOROTI,2015,4220,4290,8510,13
SOROTI,2016,4380,4400,8780,13
SOROTI,2017,4510,4490,9000,13
SOROTI,2018,4630,4570,9200,13
SOROTI,2019,4740,4650,9390,13
SOROTI,2020,4860,4740,9600,13
SOROTI,2021,5000,4830,9830,13
SOROTI,2022,5130,4920,10050,13
SOROTI,2023,5200,4930,10130,13
SOROTI,2024,5260,4980,10240,13
SOROTI,2025,5340,5040,10380,13
SSEMBABULE,2015,3980,3720,7700,13
SSEMBABULE,2016,4090,3780,7870,13
SSEMBABULE,2017,4190,3830,8020,13
SSEMBABULE,2018,4260,3870,8130,13
SSEMBABULE,2019,4340,3910,8250,13
SSEMBABULE,2020,4420,3940,8360,13
SSEMBABULE,2021,4510,3990,8500,13
SSEMBABULE,2022,4590,4040,8630,13
SSEMBABULE,2023,4630,4010,8640,13
SSEMBABULE,2024,4650,4020,8670,13
SSEMBABULE,2025,4680,4040,8720,13
TORORO,2015,7260,7460,14720,13
TORORO,2016,7460,7650,15110,13
TORORO,2017,7650,7840,15490,13
TORORO,2018,7860,8030,15890,13
TORORO,2019,8060,8230,16290,13
TORORO,2020,8260,8420,16680,13
TORORO,2021,8460,8610,17070,13
TORORO,2022,8660,8800,17460,13
TORORO,2023,8860,9000,17860,13
TORORO,2024,9050,9180,18230,13
TORORO,2025,9250,9370,18620,13
WAKISO,2015,20200,23490,43690,13
WAKISO,2016,21560,25090,46650,13
WAKISO,2017,23000,26810,49810,13
WAKISO,2018,24530,28630,53160,13
WAKISO,2019,26160,30550,56710,13
WAKISO,2020,27860,32580,60440,13
WAKISO,2021,29650,34740,64390,13
WAKISO,2022,31550,37030,68580,13
WAKISO,2023,33560,39410,72970,13
WAKISO,2024,35640,41920,77560,13
WAKISO,2025,37840,44590,82430,13
YUMBE,2015,8530,9730,18260,13
YUMBE,2016,8970,10220,19190,13
YUMBE,2017,9370,10680,20050,13
YUMBE,2018,9760,11120,20880,13
YUMBE,2019,10150,11580,21730,13
YUMBE,2020,10570,12070,22640,13
YUMBE,2021,11010,12600,23610,13
YUMBE,2022,11460,13160,24620,13
YUMBE,2023,11790,13480,25270,13
YUMBE,2024,12100,13940,26040,13
YUMBE,2025,12450,14460,26910,13
ZOMBO,2015,3550,3310,6860,13
ZOMBO,2016,3660,3400,7060,13
ZOMBO,2017,3780,3500,7280,13
ZOMBO,2018,3890,3590,7480,13
ZOMBO,2019,4010,3690,7700,13
ZOMBO,2020,4130,3790,7920,13
ZOMBO,2021,4240,3890,8130,13
ZOMBO,2022,4360,3980,8340,13
ZOMBO,2023,4480,4080,8560,13
ZOMBO,2024,4600,4180,8780,13
ZOMBO,2025,4720,4280,9000,13
ABIM,2015,1770,1780,3550,14
ABIM,2016,1900,1880,3780,14
ABIM,2017,2030,1980,4010,14
ABIM,2018,2140,2080,4220,14
ABIM,2019,2250,2160,4410,14
ABIM,2020,2380,2260,4640,14
ABIM,2021,2500,2360,4860,14
ABIM,2022,2640,2460,5100,14
ABIM,2023,2780,2570,5350,14
ABIM,2024,2890,2640,5530,14
ABIM,2025,3000,2730,5730,14
ADJUMANI,2015,3800,3680,7480,14
ADJUMANI,2016,3830,3710,7540,14
ADJUMANI,2017,3850,3750,7600,14
ADJUMANI,2018,3880,3790,7670,14
ADJUMANI,2019,3910,3820,7730,14
ADJUMANI,2020,3930,3850,7780,14
ADJUMANI,2021,3950,3880,7830,14
ADJUMANI,2022,3970,3910,7880,14
ADJUMANI,2023,3980,3930,7910,14
ADJUMANI,2024,3990,3960,7950,14
ADJUMANI,2025,4000,3980,7980,14
AGAGO,2015,4060,3950,8010,14
AGAGO,2016,4130,4020,8150,14
AGAGO,2017,4210,4090,8300,14
AGAGO,2018,4280,4160,8440,14
AGAGO,2019,4350,4230,8580,14
AGAGO,2020,4420,4300,8720,14
AGAGO,2021,4480,4360,8840,14
AGAGO,2022,4550,4430,8980,14
AGAGO,2023,4620,4490,9110,14
AGAGO,2024,4680,4550,9230,14
AGAGO,2025,4730,4610,9340,14
ALEBTONG,2015,3630,3500,7130,14
ALEBTONG,2016,3770,3600,7370,14
ALEBTONG,2017,3870,3670,7540,14
ALEBTONG,2018,3960,3710,7670,14
ALEBTONG,2019,4040,3750,7790,14
ALEBTONG,2020,4100,3780,7880,14
ALEBTONG,2021,4170,3820,7990,14
ALEBTONG,2022,4240,3870,8110,14
ALEBTONG,2023,4320,3910,8230,14
ALEBTONG,2024,4350,3880,8230,14
ALEBTONG,2025,4360,3890,8250,14
AMOLATAR,2015,2140,2050,4190,14
AMOLATAR,2016,2220,2100,4320,14
AMOLATAR,2017,2280,2140,4420,14
AMOLATAR,2018,2320,2160,4480,14
AMOLATAR,2019,2360,2180,4540,14
AMOLATAR,2020,2400,2190,4590,14
AMOLATAR,2021,2430,2200,4630,14
AMOLATAR,2022,2470,2230,4700,14
AMOLATAR,2023,2510,2250,4760,14
AMOLATAR,2024,2530,2220,4750,14
AMOLATAR,2025,2520,2220,4740,14
AMUDAT,2015,1960,1590,3550,14
AMUDAT,2016,2050,1660,3710,14
AMUDAT,2017,2130,1730,3860,14
AMUDAT,2018,2210,1780,3990,14
AMUDAT,2019,2260,1830,4090,14
AMUDAT,2020,2340,1890,4230,14
AMUDAT,2021,2400,1940,4340,14
AMUDAT,2022,2470,2000,4470,14
AMUDAT,2023,2540,2060,4600,14
AMUDAT,2024,2580,2090,4670,14
AMUDAT,2025,2620,2120,4740,14
AMURIA,2015,2630,2640,5270,14
AMURIA,2016,2750,2740,5490,14
AMURIA,2017,2850,2800,5650,14
AMURIA,2018,2940,2860,5800,14
AMURIA,2019,3020,2910,5930,14
AMURIA,2020,3100,2960,6060,14
AMURIA,2021,3190,3010,6200,14
AMURIA,2022,3270,3070,6340,14
AMURIA,2023,3360,3130,6490,14
AMURIA,2024,3410,3130,6540,14
AMURIA,2025,3450,3160,6610,14
AMURU,2015,2840,2740,5580,14
AMURU,2016,2940,2830,5770,14
AMURU,2017,3020,2870,5890,14
AMURU,2018,3080,2900,5980,14
AMURU,2019,3130,2930,6060,14
AMURU,2020,3170,2960,6130,14
AMURU,2021,3220,2990,6210,14
AMURU,2022,3270,3020,6290,14
AMURU,2023,3320,3050,6370,14
AMURU,2024,3340,3020,6360,14
AMURU,2025,3340,3030,6370,14
APAC,2015,3160,3140,6300,14
APAC,2016,3280,3250,6530,14
APAC,2017,3400,3360,6760,14
APAC,2018,3530,3480,7010,14
APAC,2019,3650,3590,7240,14
APAC,2020,3780,3720,7500,14
APAC,2021,3910,3840,7750,14
APAC,2022,4050,3960,8010,14
APAC,2023,4180,4080,8260,14
APAC,2024,4310,4210,8520,14
APAC,2025,4450,4330,8780,14
ARUA,2015,10300,10400,20700,14
ARUA,2016,10610,10680,21290,14
ARUA,2017,10910,10980,21890,14
ARUA,2018,11220,11260,22480,14
ARUA,2019,11540,11560,23100,14
ARUA,2020,11850,11860,23710,14
ARUA,2021,12170,12150,24320,14
ARUA,2022,12480,12450,24930,14
ARUA,2023,12800,12750,25550,14
ARUA,2024,13110,13050,26160,14
ARUA,2025,13420,13340,26760,14
BUDAKA,2015,3150,3190,6340,14
BUDAKA,2016,3290,3300,6590,14
BUDAKA,2017,3410,3390,6800,14
BUDAKA,2018,3510,3450,6960,14
BUDAKA,2019,3600,3510,7110,14
BUDAKA,2020,3680,3560,7240,14
BUDAKA,2021,3780,3620,7400,14
BUDAKA,2022,3880,3690,7570,14
BUDAKA,2023,3980,3760,7740,14
BUDAKA,2024,4040,3760,7800,14
BUDAKA,2025,4080,3790,7870,14
BUDUDA,2015,3880,3590,7470,14
BUDUDA,2016,4090,3750,7840,14
BUDUDA,2017,4270,3890,8160,14
BUDUDA,2018,4440,4010,8450,14
BUDUDA,2019,4600,4110,8710,14
BUDUDA,2020,4750,4210,8960,14
BUDUDA,2021,4920,4340,9260,14
BUDUDA,2022,5080,4460,9540,14
BUDUDA,2023,5270,4590,9860,14
BUDUDA,2024,5390,4630,10020,14
BUDUDA,2025,5490,4720,10210,14
BUGIRI,2015,5760,5570,11330,14
BUGIRI,2016,6050,5790,11840,14
BUGIRI,2017,6300,5980,12280,14
BUGIRI,2018,6520,6120,12640,14
BUGIRI,2019,6720,6250,12970,14
BUGIRI,2020,6930,6370,13300,14
BUGIRI,2021,7130,6520,13650,14
BUGIRI,2022,7350,6670,14020,14
BUGIRI,2023,7580,6830,14410,14
BUGIRI,2024,7720,6850,14570,14
BUGIRI,2025,7830,6950,14780,14
BUGWERI,2015,2580,2620,5200,14
BUGWERI,2016,2680,2690,5370,14
BUGWERI,2017,2750,2730,5480,14
BUGWERI,2018,2810,2770,5580,14
BUGWERI,2019,2870,2790,5660,14
BUGWERI,2020,2910,2810,5720,14
BUGWERI,2021,2960,2840,5800,14
BUGWERI,2022,3010,2870,5880,14
BUGWERI,2023,3050,2900,5950,14
BUGWERI,2024,3080,2870,5950,14
BUGWERI,2025,3080,2870,5950,14
BUHWEJU,2015,1680,1670,3350,14
BUHWEJU,2016,1730,1720,3450,14
BUHWEJU,2017,1790,1780,3570,14
BUHWEJU,2018,1840,1830,3670,14
BUHWEJU,2019,1900,1880,3780,14
BUHWEJU,2020,1960,1940,3900,14
BUHWEJU,2021,2020,1990,4010,14
BUHWEJU,2022,2080,2050,4130,14
BUHWEJU,2023,2140,2100,4240,14
BUHWEJU,2024,2200,2160,4360,14
BUHWEJU,2025,2260,2220,4480,14
BUIKWE,2015,5900,5990,11890,14
BUIKWE,2016,6080,6120,12200,14
BUIKWE,2017,6200,6190,12390,14
BUIKWE,2018,6290,6230,12520,14
BUIKWE,2019,6350,6250,12600,14
BUIKWE,2020,6410,6260,12670,14
BUIKWE,2021,6470,6290,12760,14
BUIKWE,2022,6540,6310,12850,14
BUIKWE,2023,6600,6350,12950,14
BUIKWE,2024,6590,6260,12850,14
BUIKWE,2025,6560,6230,12790,14
BUKEDEA,2015,2940,2890,5830,14
BUKEDEA,2016,3100,3020,6120,14
BUKEDEA,2017,3230,3120,6350,14
BUKEDEA,2018,3360,3200,6560,14
BUKEDEA,2019,3480,3270,6750,14
BUKEDEA,2020,3590,3350,6940,14
BUKEDEA,2021,3710,3430,7140,14
BUKEDEA,2022,3830,3520,7350,14
BUKEDEA,2023,3970,3610,7580,14
BUKEDEA,2024,4050,3630,7680,14
BUKEDEA,2025,4130,3690,7820,14
BUKOMANSIMBI,2015,2350,2200,4550,14
BUKOMANSIMBI,2016,2380,2210,4590,14
BUKOMANSIMBI,2017,2400,2200,4600,14
BUKOMANSIMBI,2018,2410,2180,4590,14
BUKOMANSIMBI,2019,2400,2150,4550,14
BUKOMANSIMBI,2020,2400,2120,4520,14
BUKOMANSIMBI,2021,2380,2100,4480,14
BUKOMANSIMBI,2022,2380,2070,4450,14
BUKOMANSIMBI,2023,2380,2060,4440,14
BUKOMANSIMBI,2024,2350,2000,4350,14
BUKOMANSIMBI,2025,2310,1960,4270,14
BUKWO,2015,1550,1460,3010,14
BUKWO,2016,1630,1530,3160,14
BUKWO,2017,1720,1600,3320,14
BUKWO,2018,1810,1680,3490,14
BUKWO,2019,1900,1770,3670,14
BUKWO,2020,2000,1850,3850,14
BUKWO,2021,2100,1930,4030,14
BUKWO,2022,2210,2020,4230,14
BUKWO,2023,2320,2110,4430,14
BUKWO,2024,2430,2210,4640,14
BUKWO,2025,2550,2310,4860,14
BULAMBULI,2015,2900,2890,5790,14
BULAMBULI,2016,3080,3030,6110,14
BULAMBULI,2017,3230,3150,6380,14
BULAMBULI,2018,3370,3270,6640,14
BULAMBULI,2019,3500,3370,6870,14
BULAMBULI,2020,3630,3460,7090,14
BULAMBULI,2021,3770,3580,7350,14
BULAMBULI,2022,3920,3700,7620,14
BULAMBULI,2023,4070,3820,7890,14
BULAMBULI,2024,4190,3870,8060,14
BULAMBULI,2025,4280,3970,8250,14
BULIISA,2015,1600,1570,3170,14
BULIISA,2016,1680,1640,3320,14
BULIISA,2017,1780,1710,3490,14
BULIISA,2018,1870,1790,3660,14
BULIISA,2019,1970,1870,3840,14
BULIISA,2020,2070,1950,4020,14
BULIISA,2021,2180,2030,4210,14
BULIISA,2022,2290,2110,4400,14
BULIISA,2023,2410,2200,4610,14
BULIISA,2024,2530,2290,4820,14
BULIISA,2025,2650,2380,5030,14
BUNDIBUGYO,2015,2860,2920,5780,14
BUNDIBUGYO,2016,2970,3010,5980,14
BUNDIBUGYO,2017,3060,3070,6130,14
BUNDIBUGYO,2018,3130,3100,6230,14
BUNDIBUGYO,2019,3190,3140,6330,14
BUNDIBUGYO,2020,3250,3160,6410,14
BUNDIBUGYO,2021,3320,3190,6510,14
BUNDIBUGYO,2022,3380,3230,6610,14
BUNDIBUGYO,2023,3440,3280,6720,14
BUNDIBUGYO,2024,3470,3250,6720,14
BUNDIBUGYO,2025,3490,3260,6750,14
BUNYANGABU,2015,2230,2160,4390,14
BUNYANGABU,2016,2310,2210,4520,14
BUNYANGABU,2017,2370,2250,4620,14
BUNYANGABU,2018,2420,2260,4680,14
BUNYANGABU,2019,2460,2270,4730,14
BUNYANGABU,2020,2490,2280,4770,14
BUNYANGABU,2021,2530,2300,4830,14
BUNYANGABU,2022,2570,2320,4890,14
BUNYANGABU,2023,2610,2330,4940,14
BUNYANGABU,2024,2610,2300,4910,14
BUNYANGABU,2025,2610,2290,4900,14
BUSHENYI,2015,3390,3520,6910,14
BUSHENYI,2016,3430,3550,6980,14
BUSHENYI,2017,3480,3580,7060,14
BUSHENYI,2018,3520,3610,7130,14
BUSHENYI,2019,3560,3640,7200,14
BUSHENYI,2020,3600,3670,7270,14
BUSHENYI,2021,3630,3690,7320,14
BUSHENYI,2022,3670,3720,7390,14
BUSHENYI,2023,3700,3740,7440,14
BUSHENYI,2024,3730,3760,7490,14
BUSHENYI,2025,3750,3770,7520,14
BUSIA,2015,4610,4680,9290,14
BUSIA,2016,4800,4820,9620,14
BUSIA,2017,4960,4920,9880,14
BUSIA,2018,5070,4980,10050,14
BUSIA,2019,5180,5040,10220,14
BUSIA,2020,5290,5100,10390,14
BUSIA,2021,5400,5160,10560,14
BUSIA,2022,5520,5220,10740,14
BUSIA,2023,5630,5290,10920,14
BUSIA,2024,5690,5270,10960,14
BUSIA,2025,5720,5290,11010,14
BUTALEJA,2015,3450,3420,6870,14
BUTALEJA,2016,3610,3550,7160,14
BUTALEJA,2017,3750,3640,7390,14
BUTALEJA,2018,3860,3720,7580,14
BUTALEJA,2019,3970,3790,7760,14
BUTALEJA,2020,4070,3850,7920,14
BUTALEJA,2021,4180,3920,8100,14
BUTALEJA,2022,4300,4010,8310,14
BUTALEJA,2023,4410,4090,8500,14
BUTALEJA,2024,4480,4090,8570,14
BUTALEJA,2025,4540,4140,8680,14
BUTAMBALA,2015,1580,1500,3080,14
BUTAMBALA,2016,1620,1510,3130,14
BUTAMBALA,2017,1640,1520,3160,14
BUTAMBALA,2018,1650,1510,3160,14
BUTAMBALA,2019,1660,1500,3160,14
BUTAMBALA,2020,1660,1490,3150,14
BUTAMBALA,2021,1670,1480,3150,14
BUTAMBALA,2022,1670,1470,3140,14
BUTAMBALA,2023,1680,1460,3140,14
BUTAMBALA,2024,1670,1430,3100,14
BUTAMBALA,2025,1650,1410,3060,14
BUTEBO,2015,1710,1610,3320,14
BUTEBO,2016,1760,1640,3400,14
BUTEBO,2017,1790,1640,3430,14
BUTEBO,2018,1800,1640,3440,14
BUTEBO,2019,1810,1640,3450,14
BUTEBO,2020,1820,1630,3450,14
BUTEBO,2021,1830,1620,3450,14
BUTEBO,2022,1840,1620,3460,14
BUTEBO,2023,1850,1610,3460,14
BUTEBO,2024,1840,1580,3420,14
BUTEBO,2025,1820,1570,3390,14
BUVUMA,2015,1010,870,1880,14
BUVUMA,2016,1080,930,2010,14
BUVUMA,2017,1140,990,2130,14
BUVUMA,2018,1210,1060,2270,14
BUVUMA,2019,1290,1130,2420,14
BUVUMA,2020,1360,1200,2560,14
BUVUMA,2021,1450,1280,2730,14
BUVUMA,2022,1530,1370,2900,14
BUVUMA,2023,1620,1450,3070,14
BUVUMA,2024,1710,1550,3260,14
BUVUMA,2025,1810,1640,3450,14
BUYENDE,2015,4760,4420,9180,14
BUYENDE,2016,5020,4610,9630,14
BUYENDE,2017,5250,4780,10030,14
BUYENDE,2018,5450,4910,10360,14
BUYENDE,2019,5640,5040,10680,14
BUYENDE,2020,5830,5160,10990,14
BUYENDE,2021,6020,5300,11320,14
BUYENDE,2022,6230,5440,11670,14
BUYENDE,2023,6450,5600,12050,14
BUYENDE,2024,6600,5640,12240,14
BUYENDE,2025,6720,5750,12470,14
DOKOLO,2015,3350,3240,6590,14
DOKOLO,2016,3460,3340,6800,14
DOKOLO,2017,3560,3430,6990,14
DOKOLO,2018,3670,3520,7190,14
DOKOLO,2019,3780,3610,7390,14
DOKOLO,2020,3880,3710,7590,14
DOKOLO,2021,4000,3800,7800,14
DOKOLO,2022,4110,3900,8010,14
DOKOLO,2023,4220,3990,8210,14
DOKOLO,2024,4330,4090,8420,14
DOKOLO,2025,4440,4180,8620,14
GOMBA,2015,2510,2170,4680,14
GOMBA,2016,2580,2200,4780,14
GOMBA,2017,2620,2210,4830,14
GOMBA,2018,2650,2210,4860,14
GOMBA,2019,2670,2190,4860,14
GOMBA,2020,2690,2180,4870,14
GOMBA,2021,2710,2170,4880,14
GOMBA,2022,2730,2160,4890,14
GOMBA,2023,2740,2150,4890,14
GOMBA,2024,2730,2100,4830,14
GOMBA,2025,2710,2080,4790,14
GULU,2015,4510,4800,9310,14
GULU,2016,4650,4950,9600,14
GULU,2017,4790,5090,9880,14
GULU,2018,4930,5240,10170,14
GULU,2019,5070,5380,10450,14
GULU,2020,5220,5530,10750,14
GULU,2021,5360,5680,11040,14
GULU,2022,5510,5830,11340,14
GULU,2023,5650,5990,11640,14
GULU,2024,5800,6140,11940,14
GULU,2025,5940,6280,12220,14
HOIMA,2015,4480,4180,8660,14
HOIMA,2016,4650,4330,8980,14
HOIMA,2017,4820,4480,9300,14
HOIMA,2018,5000,4630,9630,14
HOIMA,2019,5190,4790,9980,14
HOIMA,2020,5370,4950,10320,14
HOIMA,2021,5560,5110,10670,14
HOIMA,2022,5760,5270,11030,14
HOIMA,2023,5950,5440,11390,14
HOIMA,2024,6150,5610,11760,14
HOIMA,2025,6350,5770,12120,14
IBANDA,2015,3650,3720,7370,14
IBANDA,2016,3720,3790,7510,14
IBANDA,2017,3790,3850,7640,14
IBANDA,2018,3870,3920,7790,14
IBANDA,2019,3940,3990,7930,14
IBANDA,2020,4010,4060,8070,14
IBANDA,2021,4080,4120,8200,14
IBANDA,2022,4150,4180,8330,14
IBANDA,2023,4220,4250,8470,14
IBANDA,2024,4280,4310,8590,14
IBANDA,2025,4340,4360,8700,14
IGANGA,2015,4960,5180,10140,14
IGANGA,2016,5160,5340,10500,14
IGANGA,2017,5320,5440,10760,14
IGANGA,2018,5450,5520,10970,14
IGANGA,2019,5570,5590,11160,14
IGANGA,2020,5680,5640,11320,14
IGANGA,2021,5800,5710,11510,14
IGANGA,2022,5930,5790,11720,14
IGANGA,2023,6050,5860,11910,14
IGANGA,2024,6110,5830,11940,14
IGANGA,2025,6150,5860,12010,14
ISINGIRO,2015,7390,7320,14710,14
ISINGIRO,2016,7660,7580,15240,14
ISINGIRO,2017,7950,7850,15800,14
ISINGIRO,2018,8250,8120,16370,14
ISINGIRO,2019,8540,8400,16940,14
ISINGIRO,2020,8850,8690,17540,14
ISINGIRO,2021,9160,8970,18130,14
ISINGIRO,2022,9480,9270,18750,14
ISINGIRO,2023,9800,9560,19360,14
ISINGIRO,2024,10120,9860,19980,14
ISINGIRO,2025,10440,10160,20600,14
JINJA,2015,7080,7690,14770,14
JINJA,2016,7210,7810,15020,14
JINJA,2017,7330,7930,15260,14
JINJA,2018,7450,8050,15500,14
JINJA,2019,7560,8170,15730,14
JINJA,2020,7680,8280,15960,14
JINJA,2021,7790,8390,16180,14
JINJA,2022,7900,8500,16400,14
JINJA,2023,8000,8600,16600,14
JINJA,2024,8100,8700,16800,14
JINJA,2025,8190,8790,16980,14
KAABONG,2015,1700,1710,3410,14
KAABONG,2016,1750,1760,3510,14
KAABONG,2017,1800,1800,3600,14
KAABONG,2018,1840,1840,3680,14
KAABONG,2019,1890,1880,3770,14
KAABONG,2020,1940,1930,3870,14
KAABONG,2021,1990,1970,3960,14
KAABONG,2022,2040,2020,4060,14
KAABONG,2023,2090,2050,4140,14
KAABONG,2024,2130,2090,4220,14
KAABONG,2025,2180,2140,4320,14
KABALE,2015,3270,3310,6580,14
KABALE,2016,3330,3350,6680,14
KABALE,2017,3380,3390,6770,14
KABALE,2018,3430,3430,6860,14
KABALE,2019,3480,3460,6940,14
KABALE,2020,3530,3500,7030,14
KABALE,2021,3580,3540,7120,14
KABALE,2022,3620,3570,7190,14
KABALE,2023,3670,3600,7270,14
KABALE,2024,3710,3630,7340,14
KABALE,2025,3750,3650,7400,14
KABAROLE,2015,4190,4210,8400,14
KABAROLE,2016,4280,4300,8580,14
KABAROLE,2017,4370,4400,8770,14
KABAROLE,2018,4470,4490,8960,14
KABAROLE,2019,4560,4580,9140,14
KABAROLE,2020,4650,4680,9330,14
KABAROLE,2021,4750,4770,9520,14
KABAROLE,2022,4840,4860,9700,14
KABAROLE,2023,4930,4950,9880,14
KABAROLE,2024,5010,5040,10050,14
KABAROLE,2025,5100,5120,10220,14
KABERAMAIDO,2015,1560,1510,3070,14
KABERAMAIDO,2016,1640,1580,3220,14
KABERAMAIDO,2017,1710,1630,3340,14
KABERAMAIDO,2018,1760,1670,3430,14
KABERAMAIDO,2019,1830,1700,3530,14
KABERAMAIDO,2020,1890,1740,3630,14
KABERAMAIDO,2021,1950,1780,3730,14
KABERAMAIDO,2022,2010,1820,3830,14
KABERAMAIDO,2023,2070,1860,3930,14
KABERAMAIDO,2024,2120,1880,4000,14
KABERAMAIDO,2025,2150,1900,4050,14
KAGADI,2015,5570,5290,10860,14
KAGADI,2016,5770,5470,11240,14
KAGADI,2017,5990,5670,11660,14
KAGADI,2018,6210,5870,12080,14
KAGADI,2019,6430,6070,12500,14
KAGADI,2020,6660,6270,12930,14
KAGADI,2021,6890,6480,13370,14
KAGADI,2022,7130,6690,13820,14
KAGADI,2023,7360,6910,14270,14
KAGADI,2024,7600,7120,14720,14
KAGADI,2025,7840,7340,15180,14
KAKUMIRO,2015,4400,4200,8600,14
KAKUMIRO,2016,4790,4550,9340,14
KAKUMIRO,2017,5210,4940,10150,14
KAKUMIRO,2018,5670,5350,11020,14
KAKUMIRO,2019,6170,5800,11970,14
KAKUMIRO,2020,6700,6280,12980,14
KAKUMIRO,2021,7280,6790,14070,14
KAKUMIRO,2022,7900,7340,15240,14
KAKUMIRO,2023,8570,7940,16510,14
KAKUMIRO,2024,9290,8570,17860,14
KAKUMIRO,2025,10050,9250,19300,14
KALAKI,2015,1850,1840,3690,14
KALAKI,2016,1930,1920,3850,14
KALAKI,2017,2020,1990,4010,14
KALAKI,2018,2100,2070,4170,14
KALAKI,2019,2190,2150,4340,14
KALAKI,2020,2280,2230,4510,14
KALAKI,2021,2380,2320,4700,14
KALAKI,2022,2470,2400,4870,14
KALAKI,2023,2570,2490,5060,14
KALAKI,2024,2670,2580,5250,14
KALAKI,2025,2770,2670,5440,14
KALANGALA,2015,350,350,700,14
KALANGALA,2016,360,360,720,14
KALANGALA,2017,370,380,750,14
KALANGALA,2018,390,390,780,14
KALANGALA,2019,400,410,810,14
KALANGALA,2020,410,420,830,14
KALANGALA,2021,430,440,870,14
KALANGALA,2022,440,460,900,14
KALANGALA,2023,460,480,940,14
KALANGALA,2024,470,490,960,14
KALANGALA,2025,480,510,990,14
KALIRO,2015,3470,3540,7010,14
KALIRO,2016,3620,3660,7280,14
KALIRO,2017,3750,3770,7520,14
KALIRO,2018,3860,3830,7690,14
KALIRO,2019,3960,3900,7860,14
KALIRO,2020,4060,3970,8030,14
KALIRO,2021,4160,4040,8200,14
KALIRO,2022,4260,4120,8380,14
KALIRO,2023,4370,4200,8570,14
KALIRO,2024,4430,4200,8630,14
KALIRO,2025,4470,4240,8710,14
KALUNGU,2015,2710,2660,5370,14
KALUNGU,2016,2760,2690,5450,14
KALUNGU,2017,2790,2690,5480,14
KALUNGU,2018,2810,2670,5480,14
KALUNGU,2019,2810,2650,5460,14
KALUNGU,2020,2810,2640,5450,14
KALUNGU,2021,2810,2620,5430,14
KALUNGU,2022,2810,2600,5410,14
KALUNGU,2023,2820,2590,5410,14
KALUNGU,2024,2790,2530,5320,14
KALUNGU,2025,2750,2480,5230,14
KAMPALA,2015,14240,18620,32860,14
KAMPALA,2016,14530,18990,33520,14
KAMPALA,2017,14810,19350,34160,14
KAMPALA,2018,15100,19720,34820,14
KAMPALA,2019,15380,20090,35470,14
KAMPALA,2020,15660,20450,36110,14
KAMPALA,2021,15940,20800,36740,14
KAMPALA,2022,16210,21150,37360,14
KAMPALA,2023,16470,21490,37960,14
KAMPALA,2024,16720,21820,38540,14
KAMPALA,2025,16960,22140,39100,14
KAMULI,2015,7490,7570,15060,14
KAMULI,2016,7750,7740,15490,14
KAMULI,2017,7960,7850,15810,14
KAMULI,2018,8120,7920,16040,14
KAMULI,2019,8250,7960,16210,14
KAMULI,2020,8370,8000,16370,14
KAMULI,2021,8490,8050,16540,14
KAMULI,2022,8630,8110,16740,14
KAMULI,2023,8770,8170,16940,14
KAMULI,2024,8810,8080,16890,14
KAMULI,2025,8810,8060,16870,14
KAMWENGE,2015,3980,3680,7660,14
KAMWENGE,2016,4140,3820,7960,14
KAMWENGE,2017,4300,3950,8250,14
KAMWENGE,2018,4480,4090,8570,14
KAMWENGE,2019,4660,4230,8890,14
KAMWENGE,2020,4840,4370,9210,14
KAMWENGE,2021,5030,4520,9550,14
KAMWENGE,2022,5210,4670,9880,14
KAMWENGE,2023,5400,4820,10220,14
KAMWENGE,2024,5600,4970,10570,14
KAMWENGE,2025,5800,5120,10920,14
KANUNGU,2015,3830,3880,7710,14
KANUNGU,2016,3900,3940,7840,14
KANUNGU,2017,3980,4010,7990,14
KANUNGU,2018,4040,4070,8110,14
KANUNGU,2019,4110,4130,8240,14
KANUNGU,2020,4180,4190,8370,14
KANUNGU,2021,4250,4250,8500,14
KANUNGU,2022,4310,4310,8620,14
KANUNGU,2023,4370,4370,8740,14
KANUNGU,2024,4430,4420,8850,14
KANUNGU,2025,4490,4470,8960,14
KAPCHORWA,2015,1690,1600,3290,14
KAPCHORWA,2016,1740,1640,3380,14
KAPCHORWA,2017,1800,1690,3490,14
KAPCHORWA,2018,1850,1730,3580,14
KAPCHORWA,2019,1910,1780,3690,14
KAPCHORWA,2020,1960,1820,3780,14
KAPCHORWA,2021,2020,1870,3890,14
KAPCHORWA,2022,2070,1920,3990,14
KAPCHORWA,2023,2130,1970,4100,14
KAPCHORWA,2024,2190,2010,4200,14
KAPCHORWA,2025,2240,2060,4300,14
KAPELEBYONG,2015,1400,1170,2570,14
KAPELEBYONG,2016,1460,1210,2670,14
KAPELEBYONG,2017,1500,1220,2720,14
KAPELEBYONG,2018,1540,1240,2780,14
KAPELEBYONG,2019,1570,1250,2820,14
KAPELEBYONG,2020,1610,1270,2880,14
KAPELEBYONG,2021,1650,1280,2930,14
KAPELEBYONG,2022,1670,1290,2960,14
KAPELEBYONG,2023,1710,1310,3020,14
KAPELEBYONG,2024,1730,1300,3030,14
KAPELEBYONG,2025,1750,1310,3060,14
KASESE,2015,9020,9000,18020,14
KASESE,2016,9330,9210,18540,14
KASESE,2017,9560,9340,18900,14
KASESE,2018,9730,9410,19140,14
KASESE,2019,9870,9450,19320,14
KASESE,2020,10010,9500,19510,14
KASESE,2021,10150,9550,19700,14
KASESE,2022,10290,9610,19900,14
KASESE,2023,10430,9680,20110,14
KASESE,2024,10460,9570,20030,14
KASESE,2025,10450,9540,19990,14
KASSANDA,2015,4430,4150,8580,14
KASSANDA,2016,4560,4240,8800,14
KASSANDA,2017,4690,4330,9020,14
KASSANDA,2018,4820,4420,9240,14
KASSANDA,2019,4960,4510,9470,14
KASSANDA,2020,5090,4600,9690,14
KASSANDA,2021,5220,4690,9910,14
KASSANDA,2022,5360,4780,10140,14
KASSANDA,2023,5490,4870,10360,14
KASSANDA,2024,5620,4950,10570,14
KASSANDA,2025,5750,5040,10790,14
KATAKWI,2015,2410,2270,4680,14
KATAKWI,2016,2500,2330,4830,14
KATAKWI,2017,2580,2370,4950,14
KATAKWI,2018,2630,2400,5030,14
KATAKWI,2019,2680,2420,5100,14
KATAKWI,2020,2730,2440,5170,14
KATAKWI,2021,2790,2460,5250,14
KATAKWI,2022,2840,2480,5320,14
KATAKWI,2023,2890,2510,5400,14
KATAKWI,2024,2920,2490,5410,14
KATAKWI,2025,2930,2480,5410,14
KAYUNGA,2015,5750,5530,11280,14
KAYUNGA,2016,5920,5630,11550,14
KAYUNGA,2017,6030,5670,11700,14
KAYUNGA,2018,6110,5680,11790,14
KAYUNGA,2019,6170,5680,11850,14
KAYUNGA,2020,6230,5670,11900,14
KAYUNGA,2021,6280,5670,11950,14
KAYUNGA,2022,6330,5680,12010,14
KAYUNGA,2023,6400,5690,12090,14
KAYUNGA,2024,6380,5590,11970,14
KAYUNGA,2025,6350,5540,11890,14
KAZO,2015,2770,2570,5340,14
KAZO,2016,2880,2660,5540,14
KAZO,2017,2990,2750,5740,14
KAZO,2018,3100,2850,5950,14
KAZO,2019,3210,2950,6160,14
KAZO,2020,3320,3050,6370,14
KAZO,2021,3450,3150,6600,14
KAZO,2022,3570,3250,6820,14
KAZO,2023,3690,3360,7050,14
KAZO,2024,3820,3460,7280,14
KAZO,2025,3940,3570,7510,14
KIBAALE,2015,2120,1970,4090,14
KIBAALE,2016,2260,2080,4340,14
KIBAALE,2017,2400,2200,4600,14
KIBAALE,2018,2550,2330,4880,14
KIBAALE,2019,2710,2460,5170,14
KIBAALE,2020,2880,2600,5480,14
KIBAALE,2021,3050,2750,5800,14
KIBAALE,2022,3240,2900,6140,14
KIBAALE,2023,3440,3060,6500,14
KIBAALE,2024,3640,3220,6860,14
KIBAALE,2025,3850,3390,7240,14
KIBOGA,2015,2060,2020,4080,14
KIBOGA,2016,2140,2070,4210,14
KIBOGA,2017,2190,2110,4300,14
KIBOGA,2018,2240,2130,4370,14
KIBOGA,2019,2280,2140,4420,14
KIBOGA,2020,2320,2150,4470,14
KIBOGA,2021,2350,2170,4520,14
KIBOGA,2022,2390,2190,4580,14
KIBOGA,2023,2430,2210,4640,14
KIBOGA,2024,2450,2180,4630,14
KIBOGA,2025,2440,2180,4620,14
KIBUKU,2015,3020,3140,6160,14
KIBUKU,2016,3170,3260,6430,14
KIBUKU,2017,3300,3350,6650,14
KIBUKU,2018,3410,3420,6830,14
KIBUKU,2019,3500,3490,6990,14
KIBUKU,2020,3600,3560,7160,14
KIBUKU,2021,3690,3630,7320,14
KIBUKU,2022,3800,3710,7510,14
KIBUKU,2023,3910,3790,7700,14
KIBUKU,2024,3980,3800,7780,14
KIBUKU,2025,4030,3840,7870,14
KIKUUBE,2015,4030,3700,7730,14
KIKUUBE,2016,4250,3900,8150,14
KIKUUBE,2017,4470,4090,8560,14
KIKUUBE,2018,4710,4300,9010,14
KIKUUBE,2019,4960,4510,9470,14
KIKUUBE,2020,5210,4740,9950,14
KIKUUBE,2021,5480,4970,10450,14
KIKUUBE,2022,5760,5210,10970,14
KIKUUBE,2023,6040,5460,11500,14
KIKUUBE,2024,6340,5710,12050,14
KIKUUBE,2025,6640,5980,12620,14
KIRUHURA,2015,2200,1990,4190,14
KIRUHURA,2016,2280,2070,4350,14
KIRUHURA,2017,2370,2140,4510,14
KIRUHURA,2018,2460,2210,4670,14
KIRUHURA,2019,2550,2290,4840,14
KIRUHURA,2020,2650,2370,5020,14
KIRUHURA,2021,2740,2450,5190,14
KIRUHURA,2022,2840,2530,5370,14
KIRUHURA,2023,2930,2610,5540,14
KIRUHURA,2024,3030,2690,5720,14
KIRUHURA,2025,3120,2770,5890,14
KIRYANDONGO,2015,3820,3790,7610,14
KIRYANDONGO,2016,3970,3900,7870,14
KIRYANDONGO,2017,4100,3980,8080,14
KIRYANDONGO,2018,4190,4020,8210,14
KIRYANDONGO,2019,4280,4060,8340,14
KIRYANDONGO,2020,4360,4110,8470,14
KIRYANDONGO,2021,4450,4150,8600,14
KIRYANDONGO,2022,4540,4200,8740,14
KIRYANDONGO,2023,4620,4250,8870,14
KIRYANDONGO,2024,4670,4220,8890,14
KIRYANDONGO,2025,4680,4230,8910,14
KISORO,2015,3660,3880,7540,14
KISORO,2016,3770,3960,7730,14
KISORO,2017,3850,4010,7860,14
KISORO,2018,3890,4030,7920,14
KISORO,2019,3930,4040,7970,14
KISORO,2020,3970,4060,8030,14
KISORO,2021,4000,4060,8060,14
KISORO,2022,4050,4090,8140,14
KISORO,2023,4080,4110,8190,14
KISORO,2024,4080,4050,8130,14
KISORO,2025,4050,4030,8080,14
KITAGWENDA,2015,2230,2230,4460,14
KITAGWENDA,2016,2320,2310,4630,14
KITAGWENDA,2017,2420,2400,4820,14
KITAGWENDA,2018,2510,2480,4990,14
KITAGWENDA,2019,2610,2570,5180,14
KITAGWENDA,2020,2720,2660,5380,14
KITAGWENDA,2021,2820,2750,5570,14
KITAGWENDA,2022,2920,2840,5760,14
KITAGWENDA,2023,3040,2930,5970,14
KITAGWENDA,2024,3140,3020,6160,14
KITAGWENDA,2025,3250,3110,6360,14
KITGUM,2015,3030,2960,5990,14
KITGUM,2016,3100,3020,6120,14
KITGUM,2017,3160,3040,6200,14
KITGUM,2018,3190,3040,6230,14
KITGUM,2019,3210,3030,6240,14
KITGUM,2020,3230,3040,6270,14
KITGUM,2021,3250,3030,6280,14
KITGUM,2022,3260,3030,6290,14
KITGUM,2023,3290,3040,6330,14
KITGUM,2024,3270,2980,6250,14
KITGUM,2025,3240,2960,6200,14
KOBOKO,2015,2910,2810,5720,14
KOBOKO,2016,3050,2910,5960,14
KOBOKO,2017,3170,3010,6180,14
KOBOKO,2018,3280,3080,6360,14
KOBOKO,2019,3380,3140,6520,14
KOBOKO,2020,3480,3200,6680,14
KOBOKO,2021,3580,3270,6850,14
KOBOKO,2022,3690,3340,7030,14
KOBOKO,2023,3800,3420,7220,14
KOBOKO,2024,3860,3430,7290,14
KOBOKO,2025,3920,3480,7400,14
KOLE,2015,4190,4070,8260,14
KOLE,2016,4330,4180,8510,14
KOLE,2017,4470,4300,8770,14
KOLE,2018,4610,4420,9030,14
KOLE,2019,4760,4550,9310,14
KOLE,2020,4910,4670,9580,14
KOLE,2021,5060,4800,9860,14
KOLE,2022,5210,4920,10130,14
KOLE,2023,5350,5050,10400,14
KOLE,2024,5510,5170,10680,14
KOLE,2025,5660,5300,10960,14
KOTIDO,2015,2590,2650,5240,14
KOTIDO,2016,2680,2700,5380,14
KOTIDO,2017,2750,2740,5490,14
KOTIDO,2018,2800,2760,5560,14
KOTIDO,2019,2840,2770,5610,14
KOTIDO,2020,2870,2790,5660,14
KOTIDO,2021,2910,2800,5710,14
KOTIDO,2022,2960,2820,5780,14
KOTIDO,2023,3000,2840,5840,14
KOTIDO,2024,3010,2810,5820,14
KOTIDO,2025,3000,2800,5800,14
KUMI,2015,3550,3390,6940,14
KUMI,2016,3710,3490,7200,14
KUMI,2017,3830,3560,7390,14
KUMI,2018,3930,3610,7540,14
KUMI,2019,4020,3650,7670,14
KUMI,2020,4100,3690,7790,14
KUMI,2021,4190,3740,7930,14
KUMI,2022,4280,3790,8070,14
KUMI,2023,4370,3840,8210,14
KUMI,2024,4420,3820,8240,14
KUMI,2025,4450,3840,8290,14
KWANIA,2015,3170,3240,6410,14
KWANIA,2016,3270,3340,6610,14
KWANIA,2017,3370,3430,6800,14
KWANIA,2018,3470,3530,7000,14
KWANIA,2019,3570,3630,7200,14
KWANIA,2020,3680,3720,7400,14
KWANIA,2021,3780,3830,7610,14
KWANIA,2022,3890,3920,7810,14
KWANIA,2023,4000,4020,8020,14
KWANIA,2024,4100,4120,8220,14
KWANIA,2025,4210,4220,8430,14
KWEEN,2015,1610,1400,3010,14
KWEEN,2016,1660,1440,3100,14
KWEEN,2017,1710,1470,3180,14
KWEEN,2018,1760,1510,3270,14
KWEEN,2019,1820,1550,3370,14
KWEEN,2020,1870,1580,3450,14
KWEEN,2021,1920,1620,3540,14
KWEEN,2022,1980,1650,3630,14
KWEEN,2023,2030,1690,3720,14
KWEEN,2024,2090,1720,3810,14
KWEEN,2025,2140,1760,3900,14
KYANKWANZI,2015,3170,3220,6390,14
KYANKWANZI,2016,3330,3370,6700,14
KYANKWANZI,2017,3500,3530,7030,14
KYANKWANZI,2018,3680,3690,7370,14
KYANKWANZI,2019,3870,3860,7730,14
KYANKWANZI,2020,4060,4030,8090,14
KYANKWANZI,2021,4260,4210,8470,14
KYANKWANZI,2022,4460,4400,8860,14
KYANKWANZI,2023,4680,4590,9270,14
KYANKWANZI,2024,4900,4780,9680,14
KYANKWANZI,2025,5120,4980,10100,14
KYEGEGWA,2015,4420,4090,8510,14
KYEGEGWA,2016,4790,4410,9200,14
KYEGEGWA,2017,5180,4760,9940,14
KYEGEGWA,2018,5610,5130,10740,14
KYEGEGWA,2019,6060,5530,11590,14
KYEGEGWA,2020,6550,5970,12520,14
KYEGEGWA,2021,7070,6420,13490,14
KYEGEGWA,2022,7630,6910,14540,14
KYEGEGWA,2023,8230,7430,15660,14
KYEGEGWA,2024,8860,7990,16850,14
KYEGEGWA,2025,9540,8580,18120,14
KYENJOJO,2015,6210,5820,12030,14
KYENJOJO,2016,6470,6040,12510,14
KYENJOJO,2017,6730,6260,12990,14
KYENJOJO,2018,7010,6490,13500,14
KYENJOJO,2019,7290,6720,14010,14
KYENJOJO,2020,7570,6960,14530,14
KYENJOJO,2021,7860,7200,15060,14
KYENJOJO,2022,8160,7450,15610,14
KYENJOJO,2023,8470,7700,16170,14
KYENJOJO,2024,8780,7950,16730,14
KYENJOJO,2025,9090,8200,17290,14
KYOTERA,2015,3400,3370,6770,14
KYOTERA,2016,3490,3420,6910,14
KYOTERA,2017,3550,3440,6990,14
KYOTERA,2018,3590,3440,7030,14
KYOTERA,2019,3610,3420,7030,14
KYOTERA,2020,3630,3410,7040,14
KYOTERA,2021,3650,3410,7060,14
KYOTERA,2022,3680,3400,7080,14
KYOTERA,2023,3700,3400,7100,14
KYOTERA,2024,3680,3330,7010,14
KYOTERA,2025,3650,3290,6940,14
KARENGA,2015,870,950,1820,14
KARENGA,2016,900,970,1870,14
KARENGA,2017,920,990,1910,14
KARENGA,2018,950,1020,1970,14
KARENGA,2019,970,1040,2010,14
KARENGA,2020,1000,1070,2070,14
KARENGA,2021,1020,1090,2110,14
KARENGA,2022,1050,1110,2160,14
KARENGA,2023,1070,1140,2210,14
KARENGA,2024,1100,1160,2260,14
KARENGA,2025,1120,1180,2300,14
LAMWO,2015,2000,1970,3970,14
LAMWO,2016,2040,2000,4040,14
LAMWO,2017,2060,2010,4070,14
LAMWO,2018,2060,2010,4070,14
LAMWO,2019,2070,2000,4070,14
LAMWO,2020,2070,1990,4060,14
LAMWO,2021,2070,1990,4060,14
LAMWO,2022,2060,1990,4050,14
LAMWO,2023,2060,1990,4050,14
LAMWO,2024,2040,1950,3990,14
LAMWO,2025,2010,1930,3940,14
LIRA,2015,6500,6950,13450,14
LIRA,2016,6690,7150,13840,14
LIRA,2017,6880,7350,14230,14
LIRA,2018,7070,7560,14630,14
LIRA,2019,7260,7770,15030,14
LIRA,2020,7450,7980,15430,14
LIRA,2021,7640,8190,15830,14
LIRA,2022,7840,8400,16240,14
LIRA,2023,8030,8610,16640,14
LIRA,2024,8220,8820,17040,14
LIRA,2025,8400,9030,17430,14
LUUKA,2015,3800,3620,7420,14
LUUKA,2016,3920,3690,7610,14
LUUKA,2017,4000,3730,7730,14
LUUKA,2018,4060,3760,7820,14
LUUKA,2019,4100,3760,7860,14
LUUKA,2020,4140,3770,7910,14
LUUKA,2021,4180,3780,7960,14
LUUKA,2022,4230,3800,8030,14
LUUKA,2023,4270,3820,8090,14
LUUKA,2024,4260,3770,8030,14
LUUKA,2025,4250,3750,8000,14
LUWERO,2015,6660,6340,13000,14
LUWERO,2016,6890,6490,13380,14
LUWERO,2017,7060,6590,13650,14
LUWERO,2018,7190,6640,13830,14
LUWERO,2019,7300,6670,13970,14
LUWERO,2020,7410,6710,14120,14
LUWERO,2021,7520,6750,14270,14
LUWERO,2022,7630,6790,14420,14
LUWERO,2023,7750,6840,14590,14
LUWERO,2024,7770,6770,14540,14
LUWERO,2025,7770,6750,14520,14
LWENGO,2015,3960,3930,7890,14
LWENGO,2016,4040,3970,8010,14
LWENGO,2017,4080,3980,8060,14
LWENGO,2018,4090,3960,8050,14
LWENGO,2019,4100,3930,8030,14
LWENGO,2020,4090,3890,7980,14
LWENGO,2021,4100,3870,7970,14
LWENGO,2022,4100,3840,7940,14
LWENGO,2023,4100,3820,7920,14
LWENGO,2024,4050,3730,7780,14
LWENGO,2025,3990,3670,7660,14
LYANTONDE,2015,1250,1250,2500,14
LYANTONDE,2016,1300,1290,2590,14
LYANTONDE,2017,1340,1310,2650,14
LYANTONDE,2018,1380,1330,2710,14
LYANTONDE,2019,1400,1340,2740,14
LYANTONDE,2020,1430,1350,2780,14
LYANTONDE,2021,1450,1370,2820,14
LYANTONDE,2022,1480,1390,2870,14
LYANTONDE,2023,1510,1410,2920,14
LYANTONDE,2024,1530,1400,2930,14
LYANTONDE,2025,1530,1400,2930,14
MANAFWA,2015,2550,2550,5100,14
MANAFWA,2016,2620,2610,5230,14
MANAFWA,2017,2680,2670,5350,14
MANAFWA,2018,2750,2720,5470,14
MANAFWA,2019,2810,2780,5590,14
MANAFWA,2020,2880,2840,5720,14
MANAFWA,2021,2950,2900,5850,14
MANAFWA,2022,3010,2960,5970,14
MANAFWA,2023,3080,3010,6090,14
MANAFWA,2024,3140,3070,6210,14
MANAFWA,2025,3200,3120,6320,14
MARACHA,2015,3050,2830,5880,14
MARACHA,2016,3120,2890,6010,14
MARACHA,2017,3180,2940,6120,14
MARACHA,2018,3250,3000,6250,14
MARACHA,2019,3310,3050,6360,14
MARACHA,2020,3380,3110,6490,14
MARACHA,2021,3440,3160,6600,14
MARACHA,2022,3500,3220,6720,14
MARACHA,2023,3560,3270,6830,14
MARACHA,2024,3620,3320,6940,14
MARACHA,2025,3680,3370,7050,14
MASAKA,2015,3670,3920,7590,14
MASAKA,2016,3790,4010,7800,14
MASAKA,2017,3870,4050,7920,14
MASAKA,2018,3940,4080,8020,14
MASAKA,2019,3980,4090,8070,14
MASAKA,2020,4030,4110,8140,14
MASAKA,2021,4080,4120,8200,14
MASAKA,2022,4130,4140,8270,14
MASAKA,2023,4190,4170,8360,14
MASAKA,2024,4190,4110,8300,14
MASAKA,2025,4170,4090,8260,14
MASINDI,2015,4160,4070,8230,14
MASINDI,2016,4280,4180,8460,14
MASINDI,2017,4400,4290,8690,14
MASINDI,2018,4530,4410,8940,14
MASINDI,2019,4660,4520,9180,14
MASINDI,2020,4780,4630,9410,14
MASINDI,2021,4910,4750,9660,14
MASINDI,2022,5040,4860,9900,14
MASINDI,2023,5170,4980,10150,14
MASINDI,2024,5300,5090,10390,14
MASINDI,2025,5430,5200,10630,14
MAYUGE,2015,6700,6740,13440,14
MAYUGE,2016,6980,6960,13940,14
MAYUGE,2017,7210,7100,14310,14
MAYUGE,2018,7380,7220,14600,14
MAYUGE,2019,7540,7320,14860,14
MAYUGE,2020,7700,7410,15110,14
MAYUGE,2021,7860,7510,15370,14
MAYUGE,2022,8020,7630,15650,14
MAYUGE,2023,8190,7750,15940,14
MAYUGE,2024,8280,7720,16000,14
MAYUGE,2025,8330,7770,16100,14
MBALE,2015,6690,7270,13960,14
MBALE,2016,6960,7520,14480,14
MBALE,2017,7170,7710,14880,14
MBALE,2018,7340,7850,15190,14
MBALE,2019,7500,7970,15470,14
MBALE,2020,7640,8090,15730,14
MBALE,2021,7790,8230,16020,14
MBALE,2022,7950,8380,16330,14
MBALE,2023,8110,8520,16630,14
MBALE,2024,8180,8510,16690,14
MBALE,2025,8220,8580,16800,14
MBARARA,2015,4290,4700,8990,14
MBARARA,2016,4390,4810,9200,14
MBARARA,2017,4490,4910,9400,14
MBARARA,2018,4590,5010,9600,14
MBARARA,2019,4700,5120,9820,14
MBARARA,2020,4800,5220,10020,14
MBARARA,2021,4900,5320,10220,14
MBARARA,2022,4990,5420,10410,14
MBARARA,2023,5090,5520,10610,14
MBARARA,2024,5180,5610,10790,14
MBARARA,2025,5280,5710,10990,14
MITOOMA,2015,2750,2690,5440,14
MITOOMA,2016,2790,2720,5510,14
MITOOMA,2017,2820,2740,5560,14
MITOOMA,2018,2860,2770,5630,14
MITOOMA,2019,2890,2790,5680,14
MITOOMA,2020,2920,2810,5730,14
MITOOMA,2021,2940,2830,5770,14
MITOOMA,2022,2970,2850,5820,14
MITOOMA,2023,3000,2870,5870,14
MITOOMA,2024,3020,2880,5900,14
MITOOMA,2025,3040,2900,5940,14
MITYANA,2015,4720,4500,9220,14
MITYANA,2016,4850,4570,9420,14
MITYANA,2017,4940,4610,9550,14
MITYANA,2018,5000,4620,9620,14
MITYANA,2019,5040,4610,9650,14
MITYANA,2020,5080,4600,9680,14
MITYANA,2021,5120,4600,9720,14
MITYANA,2022,5160,4600,9760,14
MITYANA,2023,5200,4600,9800,14
MITYANA,2024,5190,4520,9710,14
MITYANA,2025,5150,4480,9630,14
MOROTO,2015,1160,1240,2400,14
MOROTO,2016,1190,1280,2470,14
MOROTO,2017,1220,1300,2520,14
MOROTO,2018,1240,1310,2550,14
MOROTO,2019,1260,1320,2580,14
MOROTO,2020,1270,1340,2610,14
MOROTO,2021,1290,1340,2630,14
MOROTO,2022,1300,1360,2660,14
MOROTO,2023,1320,1370,2690,14
MOROTO,2024,1320,1360,2680,14
MOROTO,2025,1320,1360,2680,14
MOYO,2015,1780,1560,3340,14
MOYO,2016,1830,1600,3430,14
MOYO,2017,1870,1630,3500,14
MOYO,2018,1920,1670,3590,14
MOYO,2019,1970,1700,3670,14
MOYO,2020,2010,1740,3750,14
MOYO,2021,2060,1770,3830,14
MOYO,2022,2110,1800,3910,14
MOYO,2023,2160,1840,4000,14
MOYO,2024,2200,1870,4070,14
MOYO,2025,2240,1900,4140,14
MPIGI,2015,3520,3490,7010,14
MPIGI,2016,3640,3570,7210,14
MPIGI,2017,3720,3630,7350,14
MPIGI,2018,3790,3660,7450,14
MPIGI,2019,3840,3680,7520,14
MPIGI,2020,3900,3700,7600,14
MPIGI,2021,3950,3730,7680,14
MPIGI,2022,4000,3750,7750,14
MPIGI,2023,4060,3780,7840,14
MPIGI,2024,4070,3740,7810,14
MPIGI,2025,4070,3740,7810,14
MUBENDE,2015,5620,5170,10790,14
MUBENDE,2016,5970,5440,11410,14
MUBENDE,2017,6290,5680,11970,14
MUBENDE,2018,6580,5890,12470,14
MUBENDE,2019,6870,6090,12960,14
MUBENDE,2020,7150,6280,13430,14
MUBENDE,2021,7460,6500,13960,14
MUBENDE,2022,7770,6740,14510,14
MUBENDE,2023,8100,6970,15070,14
MUBENDE,2024,8360,7090,15450,14
MUBENDE,2025,8580,7270,15850,14
MUKONO,2015,7620,7910,15530,14
MUKONO,2016,7900,8150,16050,14
MUKONO,2017,8120,8330,16450,14
MUKONO,2018,8280,8440,16720,14
MUKONO,2019,8430,8550,16980,14
MUKONO,2020,8570,8640,17210,14
MUKONO,2021,8720,8750,17470,14
MUKONO,2022,8860,8880,17740,14
MUKONO,2023,9010,9010,18020,14
MUKONO,2024,9070,8960,18030,14
MUKONO,2025,9080,9000,18080,14
MADI OKOLLO,2015,2360,2060,4420,14
MADI OKOLLO,2016,2430,2130,4560,14
MADI OKOLLO,2017,2510,2170,4680,14
MADI OKOLLO,2018,2580,2240,4820,14
MADI OKOLLO,2019,2650,2300,4950,14
MADI OKOLLO,2020,2730,2360,5090,14
MADI OKOLLO,2021,2790,2420,5210,14
MADI OKOLLO,2022,2870,2480,5350,14
MADI OKOLLO,2023,2940,2530,5470,14
MADI OKOLLO,2024,3010,2590,5600,14
MADI OKOLLO,2025,3080,2650,5730,14
NABILATUK,2015,980,1080,2060,14
NABILATUK,2016,1030,1130,2160,14
NABILATUK,2017,1080,1170,2250,14
NABILATUK,2018,1140,1210,2350,14
NABILATUK,2019,1180,1240,2420,14
NABILATUK,2020,1230,1270,2500,14
NABILATUK,2021,1280,1310,2590,14
NABILATUK,2022,1330,1340,2670,14
NABILATUK,2023,1380,1380,2760,14
NABILATUK,2024,1430,1400,2830,14
NABILATUK,2025,1460,1430,2890,14
NAKAPIRIPIRIT,2015,1150,1210,2360,14
NAKAPIRIPIRIT,2016,1210,1270,2480,14
NAKAPIRIPIRIT,2017,1260,1310,2570,14
NAKAPIRIPIRIT,2018,1310,1350,2660,14
NAKAPIRIPIRIT,2019,1350,1380,2730,14
NAKAPIRIPIRIT,2020,1400,1420,2820,14
NAKAPIRIPIRIT,2021,1450,1460,2910,14
NAKAPIRIPIRIT,2022,1500,1500,3000,14
NAKAPIRIPIRIT,2023,1540,1540,3080,14
NAKAPIRIPIRIT,2024,1580,1560,3140,14
NAKAPIRIPIRIT,2025,1610,1580,3190,14
NAKASEKE,2015,3150,3020,6170,14
NAKASEKE,2016,3270,3090,6360,14
NAKASEKE,2017,3390,3160,6550,14
NAKASEKE,2018,3510,3240,6750,14
NAKASEKE,2019,3630,3310,6940,14
NAKASEKE,2020,3760,3390,7150,14
NAKASEKE,2021,3890,3460,7350,14
NAKASEKE,2022,4020,3540,7560,14
NAKASEKE,2023,4150,3610,7760,14
NAKASEKE,2024,4290,3680,7970,14
NAKASEKE,2025,4420,3750,8170,14
NAKASONGOLA,2015,2620,2500,5120,14
NAKASONGOLA,2016,2730,2560,5290,14
NAKASONGOLA,2017,2820,2610,5430,14
NAKASONGOLA,2018,2890,2650,5540,14
NAKASONGOLA,2019,2950,2670,5620,14
NAKASONGOLA,2020,3020,2700,5720,14
NAKASONGOLA,2021,3080,2720,5800,14
NAKASONGOLA,2022,3150,2750,5900,14
NAKASONGOLA,2023,3220,2790,6010,14
NAKASONGOLA,2024,3250,2770,6020,14
NAKASONGOLA,2025,3270,2770,6040,14
NAMAYINGO,2015,3070,2870,5940,14
NAMAYINGO,2016,3160,2910,6070,14
NAMAYINGO,2017,3220,2940,6160,14
NAMAYINGO,2018,3260,2930,6190,14
NAMAYINGO,2019,3290,2920,6210,14
NAMAYINGO,2020,3300,2920,6220,14
NAMAYINGO,2021,3330,2910,6240,14
NAMAYINGO,2022,3370,2910,6280,14
NAMAYINGO,2023,3390,2920,6310,14
NAMAYINGO,2024,3380,2850,6230,14
NAMAYINGO,2025,3360,2830,6190,14
NAMISINDWA,2015,3330,3350,6680,14
NAMISINDWA,2016,3430,3430,6860,14
NAMISINDWA,2017,3520,3510,7030,14
NAMISINDWA,2018,3620,3590,7210,14
NAMISINDWA,2019,3720,3670,7390,14
NAMISINDWA,2020,3810,3760,7570,14
NAMISINDWA,2021,3910,3840,7750,14
NAMISINDWA,2022,4010,3920,7930,14
NAMISINDWA,2023,4110,4000,8110,14
NAMISINDWA,2024,4200,4080,8280,14
NAMISINDWA,2025,4300,4150,8450,14
NAMUTUMBA,2015,3860,3650,7510,14
NAMUTUMBA,2016,4040,3780,7820,14
NAMUTUMBA,2017,4190,3870,8060,14
NAMUTUMBA,2018,4310,3940,8250,14
NAMUTUMBA,2019,4410,4000,8410,14
NAMUTUMBA,2020,4520,4060,8580,14
NAMUTUMBA,2021,4640,4120,8760,14
NAMUTUMBA,2022,4750,4190,8940,14
NAMUTUMBA,2023,4870,4270,9140,14
NAMUTUMBA,2024,4930,4260,9190,14
NAMUTUMBA,2025,4980,4290,9270,14
NAPAK,2015,1820,1710,3530,14
NAPAK,2016,1870,1740,3610,14
NAPAK,2017,1900,1760,3660,14
NAPAK,2018,1910,1780,3690,14
NAPAK,2019,1930,1780,3710,14
NAPAK,2020,1940,1790,3730,14
NAPAK,2021,1950,1790,3740,14
NAPAK,2022,1960,1800,3760,14
NAPAK,2023,1970,1820,3790,14
NAPAK,2024,1960,1790,3750,14
NAPAK,2025,1950,1790,3740,14
NEBBI,2015,4070,3960,8030,14
NEBBI,2016,4200,4070,8270,14
NEBBI,2017,4340,4190,8530,14
NEBBI,2018,4470,4310,8780,14
NEBBI,2019,4610,4420,9030,14
NEBBI,2020,4750,4540,9290,14
NEBBI,2021,4890,4660,9550,14
NEBBI,2022,5030,4780,9810,14
NEBBI,2023,5170,4900,10070,14
NEBBI,2024,5310,5020,10330,14
NEBBI,2025,5450,5140,10590,14
NGORA,2015,2050,2100,4150,14
NGORA,2016,2120,2160,4280,14
NGORA,2017,2190,2190,4380,14
NGORA,2018,2240,2220,4460,14
NGORA,2019,2280,2240,4520,14
NGORA,2020,2320,2260,4580,14
NGORA,2021,2370,2280,4650,14
NGORA,2022,2410,2310,4720,14
NGORA,2023,2450,2330,4780,14
NGORA,2024,2460,2310,4770,14
NGORA,2025,2470,2320,4790,14
NTOROKO,2015,890,820,1710,14
NTOROKO,2016,920,840,1760,14
NTOROKO,2017,950,840,1790,14
NTOROKO,2018,960,840,1800,14
NTOROKO,2019,980,850,1830,14
NTOROKO,2020,990,850,1840,14
NTOROKO,2021,1010,860,1870,14
NTOROKO,2022,1020,850,1870,14
NTOROKO,2023,1040,860,1900,14
NTOROKO,2024,1040,840,1880,14
NTOROKO,2025,1040,840,1880,14
NTUNGAMO,2015,7400,7290,14690,14
NTUNGAMO,2016,7560,7420,14980,14
NTUNGAMO,2017,7720,7560,15280,14
NTUNGAMO,2018,7880,7700,15580,14
NTUNGAMO,2019,8050,7840,15890,14
NTUNGAMO,2020,8210,7970,16180,14
NTUNGAMO,2021,8370,8100,16470,14
NTUNGAMO,2022,8520,8230,16750,14
NTUNGAMO,2023,8670,8350,17020,14
NTUNGAMO,2024,8820,8480,17300,14
NTUNGAMO,2025,8960,8590,17550,14
NWOYA,2015,2220,2290,4510,14
NWOYA,2016,2460,2520,4980,14
NWOYA,2017,2710,2780,5490,14
NWOYA,2018,3000,3060,6060,14
NWOYA,2019,3310,3370,6680,14
NWOYA,2020,3650,3710,7360,14
NWOYA,2021,4020,4070,8090,14
NWOYA,2022,4430,4480,8910,14
NWOYA,2023,4880,4920,9800,14
NWOYA,2024,5360,5400,10760,14
NWOYA,2025,5890,5920,11810,14
OBONGI,2015,680,570,1250,14
OBONGI,2016,710,590,1300,14
OBONGI,2017,730,590,1320,14
OBONGI,2018,740,600,1340,14
OBONGI,2019,750,600,1350,14
OBONGI,2020,760,600,1360,14
OBONGI,2021,770,610,1380,14
OBONGI,2022,780,610,1390,14
OBONGI,2023,790,620,1410,14
OBONGI,2024,800,610,1410,14
OBONGI,2025,800,600,1400,14
OMORO,2015,2550,2380,4930,14
OMORO,2016,2670,2470,5140,14
OMORO,2017,2760,2530,5290,14
OMORO,2018,2840,2590,5430,14
OMORO,2019,2920,2630,5550,14
OMORO,2020,2980,2670,5650,14
OMORO,2021,3060,2720,5780,14
OMORO,2022,3140,2770,5910,14
OMORO,2023,3220,2830,6050,14
OMORO,2024,3270,2830,6100,14
OMORO,2025,3300,2850,6150,14
OTUKE,2015,1890,1750,3640,14
OTUKE,2016,1980,1830,3810,14
OTUKE,2017,2070,1910,3980,14
OTUKE,2018,2160,1990,4150,14
OTUKE,2019,2260,2070,4330,14
OTUKE,2020,2350,2160,4510,14
OTUKE,2021,2450,2250,4700,14
OTUKE,2022,2560,2340,4900,14
OTUKE,2023,2670,2430,5100,14
OTUKE,2024,2770,2520,5290,14
OTUKE,2025,2880,2620,5500,14
OYAM,2015,6460,6250,12710,14
OYAM,2016,6660,6430,13090,14
OYAM,2017,6860,6620,13480,14
OYAM,2018,7070,6810,13880,14
OYAM,2019,7280,7000,14280,14
OYAM,2020,7490,7200,14690,14
OYAM,2021,7700,7390,15090,14
OYAM,2022,7920,7590,15510,14
OYAM,2023,8130,7780,15910,14
OYAM,2024,8340,7980,16320,14
OYAM,2025,8550,8180,16730,14
PADER,2015,2720,2760,5480,14
PADER,2016,2780,2820,5600,14
PADER,2017,2830,2860,5690,14
PADER,2018,2870,2870,5740,14
PADER,2019,2880,2870,5750,14
PADER,2020,2910,2880,5790,14
PADER,2021,2920,2880,5800,14
PADER,2022,2940,2890,5830,14
PADER,2023,2960,2910,5870,14
PADER,2024,2950,2860,5810,14
PADER,2025,2920,2840,5760,14
PAKWACH,2015,2450,2470,4920,14
PAKWACH,2016,2560,2560,5120,14
PAKWACH,2017,2660,2650,5310,14
PAKWACH,2018,2770,2750,5520,14
PAKWACH,2019,2890,2840,5730,14
PAKWACH,2020,3000,2940,5940,14
PAKWACH,2021,3120,3040,6160,14
PAKWACH,2022,3240,3150,6390,14
PAKWACH,2023,3370,3250,6620,14
PAKWACH,2024,3490,3360,6850,14
PAKWACH,2025,3620,3460,7080,14
PALLISA,2015,4090,4150,8240,14
PALLISA,2016,4320,4330,8650,14
PALLISA,2017,4510,4480,8990,14
PALLISA,2018,4690,4610,9300,14
PALLISA,2019,4850,4730,9580,14
PALLISA,2020,5020,4850,9870,14
PALLISA,2021,5180,4980,10160,14
PALLISA,2022,5360,5120,10480,14
PALLISA,2023,5550,5260,10810,14
PALLISA,2024,5680,5300,10980,14
PALLISA,2025,5790,5400,11190,14
RAKAI,2015,3920,3920,7840,14
RAKAI,2016,4050,4010,8060,14
RAKAI,2017,4160,4080,8240,14
RAKAI,2018,4240,4110,8350,14
RAKAI,2019,4310,4140,8450,14
RAKAI,2020,4370,4160,8530,14
RAKAI,2021,4430,4180,8610,14
RAKAI,2022,4500,4210,8710,14
RAKAI,2023,4570,4240,8810,14
RAKAI,2024,4580,4190,8770,14
RAKAI,2025,4590,4190,8780,14
RUBANDA,2015,3040,3030,6070,14
RUBANDA,2016,3090,3060,6150,14
RUBANDA,2017,3130,3080,6210,14
RUBANDA,2018,3170,3110,6280,14
RUBANDA,2019,3210,3130,6340,14
RUBANDA,2020,3250,3150,6400,14
RUBANDA,2021,3280,3170,6450,14
RUBANDA,2022,3320,3190,6510,14
RUBANDA,2023,3350,3200,6550,14
RUBANDA,2024,3380,3220,6600,14
RUBANDA,2025,3410,3220,6630,14
RUBIRIZI,2015,2070,2100,4170,14
RUBIRIZI,2016,2120,2150,4270,14
RUBIRIZI,2017,2160,2190,4350,14
RUBIRIZI,2018,2200,2230,4430,14
RUBIRIZI,2019,2240,2270,4510,14
RUBIRIZI,2020,2290,2310,4600,14
RUBIRIZI,2021,2330,2350,4680,14
RUBIRIZI,2022,2370,2390,4760,14
RUBIRIZI,2023,2410,2420,4830,14
RUBIRIZI,2024,2450,2460,4910,14
RUBIRIZI,2025,2480,2490,4970,14
RUKIGA,2015,1480,1500,2980,14
RUKIGA,2016,1490,1510,3000,14
RUKIGA,2017,1510,1520,3030,14
RUKIGA,2018,1520,1530,3050,14
RUKIGA,2019,1540,1540,3080,14
RUKIGA,2020,1550,1550,3100,14
RUKIGA,2021,1560,1550,3110,14
RUKIGA,2022,1580,1560,3140,14
RUKIGA,2023,1580,1570,3150,14
RUKIGA,2024,1590,1570,3160,14
RUKIGA,2025,1600,1580,3180,14
RUKUNGIRI,2015,4760,4820,9580,14
RUKUNGIRI,2016,4820,4860,9680,14
RUKUNGIRI,2017,4880,4910,9790,14
RUKUNGIRI,2018,4940,4960,9900,14
RUKUNGIRI,2019,4990,5000,9990,14
RUKUNGIRI,2020,5040,5040,10080,14
RUKUNGIRI,2021,5090,5080,10170,14
RUKUNGIRI,2022,5140,5120,10260,14
RUKUNGIRI,2023,5180,5150,10330,14
RUKUNGIRI,2024,5220,5180,10400,14
RUKUNGIRI,2025,5260,5210,10470,14
RWAMPARA,2015,1880,1850,3730,14
RWAMPARA,2016,1930,1890,3820,14
RWAMPARA,2017,1970,1930,3900,14
RWAMPARA,2018,2010,1970,3980,14
RWAMPARA,2019,2060,2010,4070,14
RWAMPARA,2020,2100,2050,4150,14
RWAMPARA,2021,2140,2090,4230,14
RWAMPARA,2022,2190,2130,4320,14
RWAMPARA,2023,2230,2170,4400,14
RWAMPARA,2024,2270,2220,4490,14
RWAMPARA,2025,2310,2250,4560,14
SERERE,2015,4080,4030,8110,14
SERERE,2016,4280,4200,8480,14
SERERE,2017,4470,4330,8800,14
SERERE,2018,4620,4440,9060,14
SERERE,2019,4760,4540,9300,14
SERERE,2020,4900,4630,9530,14
SERERE,2021,5060,4740,9800,14
SERERE,2022,5210,4850,10060,14
SERERE,2023,5370,4960,10330,14
SERERE,2024,5470,4990,10460,14
SERERE,2025,5550,5060,10610,14
SHEEMA,2015,3130,3160,6290,14
SHEEMA,2016,3170,3190,6360,14
SHEEMA,2017,3210,3230,6440,14
SHEEMA,2018,3250,3260,6510,14
SHEEMA,2019,3290,3290,6580,14
SHEEMA,2020,3320,3320,6640,14
SHEEMA,2021,3350,3350,6700,14
SHEEMA,2022,3390,3380,6770,14
SHEEMA,2023,3410,3400,6810,14
SHEEMA,2024,3440,3420,6860,14
SHEEMA,2025,3460,3440,6900,14
SIRONKO,2015,4210,4120,8330,14
SIRONKO,2016,4310,4200,8510,14
SIRONKO,2017,4420,4290,8710,14
SIRONKO,2018,4520,4380,8900,14
SIRONKO,2019,4620,4460,9080,14
SIRONKO,2020,4730,4540,9270,14
SIRONKO,2021,4830,4630,9460,14
SIRONKO,2022,4930,4710,9640,14
SIRONKO,2023,5030,4790,9820,14
SIRONKO,2024,5120,4870,9990,14
SIRONKO,2025,5220,4940,10160,14
SOROTI,2015,4050,4210,8260,14
SOROTI,2016,4230,4360,8590,14
SOROTI,2017,4390,4470,8860,14
SOROTI,2018,4520,4570,9090,14
SOROTI,2019,4640,4640,9280,14
SOROTI,2020,4760,4720,9480,14
SOROTI,2021,4880,4800,9680,14
SOROTI,2022,5010,4900,9910,14
SOROTI,2023,5140,5000,10140,14
SOROTI,2024,5210,5000,10210,14
SOROTI,2025,5270,5040,10310,14
SSEMBABULE,2015,3640,3520,7160,14
SSEMBABULE,2016,3780,3610,7390,14
SSEMBABULE,2017,3890,3690,7580,14
SSEMBABULE,2018,3980,3720,7700,14
SSEMBABULE,2019,4050,3760,7810,14
SSEMBABULE,2020,4130,3800,7930,14
SSEMBABULE,2021,4210,3830,8040,14
SSEMBABULE,2022,4280,3880,8160,14
SSEMBABULE,2023,4360,3920,8280,14
SSEMBABULE,2024,4390,3890,8280,14
SSEMBABULE,2025,4410,3900,8310,14
TORORO,2015,8290,8450,16740,14
TORORO,2016,8520,8660,17180,14
TORORO,2017,8740,8880,17620,14
TORORO,2018,8970,9100,18070,14
TORORO,2019,9200,9320,18520,14
TORORO,2020,9430,9540,18970,14
TORORO,2021,9660,9750,19410,14
TORORO,2022,9890,9970,19860,14
TORORO,2023,10120,10190,20310,14
TORORO,2024,10340,10400,20740,14
TORORO,2025,10560,10610,21170,14
WAKISO,2015,22540,28270,50810,14
WAKISO,2016,24040,30200,54240,14
WAKISO,2017,25660,32270,57930,14
WAKISO,2018,27360,34460,61820,14
WAKISO,2019,29180,36770,65950,14
WAKISO,2020,31080,39210,70290,14
WAKISO,2021,33070,41820,74890,14
WAKISO,2022,35200,44580,79780,14
WAKISO,2023,37430,47440,84870,14
WAKISO,2024,39760,50460,90220,14
WAKISO,2025,42200,53670,95870,14
YUMBE,2015,8420,9280,17700,14
YUMBE,2016,8940,9840,18780,14
YUMBE,2017,9410,10340,19750,14
YUMBE,2018,9830,10810,20640,14
YUMBE,2019,10230,11250,21480,14
YUMBE,2020,10640,11710,22350,14
YUMBE,2021,11070,12200,23270,14
YUMBE,2022,11530,12730,24260,14
YUMBE,2023,12000,13290,25290,14
YUMBE,2024,12350,13600,25950,14
YUMBE,2025,12660,14060,26720,14
ZOMBO,2015,3800,3650,7450,14
ZOMBO,2016,3920,3760,7680,14
ZOMBO,2017,4040,3860,7900,14
ZOMBO,2018,4170,3970,8140,14
ZOMBO,2019,4290,4070,8360,14
ZOMBO,2020,4420,4180,8600,14
ZOMBO,2021,4540,4290,8830,14
ZOMBO,2022,4670,4400,9070,14
ZOMBO,2023,4790,4500,9290,14
ZOMBO,2024,4920,4610,9530,14
ZOMBO,2025,5050,4720,9770,14
ABIM,2015,1660,1600,3260,15
ABIM,2016,1810,1710,3520,15
ABIM,2017,1930,1810,3740,15
ABIM,2018,2060,1920,3980,15
ABIM,2019,2180,2000,4180,15
ABIM,2020,2290,2090,4380,15
ABIM,2021,2420,2170,4590,15
ABIM,2022,2540,2260,4800,15
ABIM,2023,2680,2370,5050,15
ABIM,2024,2820,2470,5290,15
ABIM,2025,2940,2540,5480,15
ADJUMANI,2015,3090,2950,6040,15
ADJUMANI,2016,3120,2980,6100,15
ADJUMANI,2017,3140,3010,6150,15
ADJUMANI,2018,3160,3040,6200,15
ADJUMANI,2019,3180,3060,6240,15
ADJUMANI,2020,3200,3090,6290,15
ADJUMANI,2021,3220,3110,6330,15
ADJUMANI,2022,3230,3130,6360,15
ADJUMANI,2023,3240,3150,6390,15
ADJUMANI,2024,3250,3170,6420,15
ADJUMANI,2025,3260,3190,6450,15
AGAGO,2015,2990,2820,5810,15
AGAGO,2016,3040,2870,5910,15
AGAGO,2017,3090,2920,6010,15
AGAGO,2018,3150,2980,6130,15
AGAGO,2019,3200,3030,6230,15
AGAGO,2020,3250,3070,6320,15
AGAGO,2021,3300,3120,6420,15
AGAGO,2022,3340,3170,6510,15
AGAGO,2023,3390,3210,6600,15
AGAGO,2024,3440,3260,6700,15
AGAGO,2025,3480,3300,6780,15
ALEBTONG,2015,3240,3090,6330,15
ALEBTONG,2016,3380,3200,6580,15
ALEBTONG,2017,3520,3280,6800,15
ALEBTONG,2018,3620,3340,6960,15
ALEBTONG,2019,3700,3380,7080,15
ALEBTONG,2020,3760,3420,7180,15
ALEBTONG,2021,3820,3450,7270,15
ALEBTONG,2022,3890,3480,7370,15
ALEBTONG,2023,3960,3520,7480,15
ALEBTONG,2024,4020,3560,7580,15
ALEBTONG,2025,4050,3530,7580,15
AMOLATAR,2015,1980,1930,3910,15
AMOLATAR,2016,2070,1990,4060,15
AMOLATAR,2017,2150,2040,4190,15
AMOLATAR,2018,2210,2070,4280,15
AMOLATAR,2019,2250,2100,4350,15
AMOLATAR,2020,2280,2110,4390,15
AMOLATAR,2021,2320,2120,4440,15
AMOLATAR,2022,2350,2140,4490,15
AMOLATAR,2023,2390,2150,4540,15
AMOLATAR,2024,2420,2170,4590,15
AMOLATAR,2025,2430,2160,4590,15
AMUDAT,2015,1700,1420,3120,15
AMUDAT,2016,1810,1500,3310,15
AMUDAT,2017,1890,1580,3470,15
AMUDAT,2018,1980,1630,3610,15
AMUDAT,2019,2030,1690,3720,15
AMUDAT,2020,2090,1730,3820,15
AMUDAT,2021,2150,1780,3930,15
AMUDAT,2022,2220,1840,4060,15
AMUDAT,2023,2270,1890,4160,15
AMUDAT,2024,2340,1950,4290,15
AMUDAT,2025,2380,1970,4350,15
AMURIA,2015,2610,2600,5210,15
AMURIA,2016,2760,2710,5470,15
AMURIA,2017,2890,2800,5690,15
AMURIA,2018,3000,2880,5880,15
AMURIA,2019,3100,2940,6040,15
AMURIA,2020,3170,2990,6160,15
AMURIA,2021,3260,3040,6300,15
AMURIA,2022,3340,3090,6430,15
AMURIA,2023,3430,3140,6570,15
AMURIA,2024,3520,3210,6730,15
AMURIA,2025,3570,3200,6770,15
AMURU,2015,2590,2310,4900,15
AMURU,2016,2710,2390,5100,15
AMURU,2017,2810,2450,5260,15
AMURU,2018,2870,2500,5370,15
AMURU,2019,2930,2530,5460,15
AMURU,2020,2980,2550,5530,15
AMURU,2021,3030,2570,5600,15
AMURU,2022,3070,2590,5660,15
AMURU,2023,3110,2620,5730,15
AMURU,2024,3170,2640,5810,15
AMURU,2025,3180,2630,5810,15
APAC,2015,2380,2340,4720,15
APAC,2016,2460,2420,4880,15
APAC,2017,2560,2510,5070,15
APAC,2018,2650,2590,5240,15
APAC,2019,2740,2680,5420,15
APAC,2020,2840,2770,5610,15
APAC,2021,2940,2860,5800,15
APAC,2022,3040,2950,5990,15
APAC,2023,3140,3040,6180,15
APAC,2024,3240,3140,6380,15
APAC,2025,3340,3230,6570,15
ARUA,2015,7920,8160,16080,15
ARUA,2016,8150,8380,16530,15
ARUA,2017,8380,8610,16990,15
ARUA,2018,8620,8840,17460,15
ARUA,2019,8860,9070,17930,15
ARUA,2020,9100,9300,18400,15
ARUA,2021,9350,9530,18880,15
ARUA,2022,9590,9770,19360,15
ARUA,2023,9830,10010,19840,15
ARUA,2024,10070,10240,20310,15
ARUA,2025,10310,10460,20770,15
BUDAKA,2015,2960,2850,5810,15
BUDAKA,2016,3120,2970,6090,15
BUDAKA,2017,3260,3070,6330,15
BUDAKA,2018,3380,3150,6530,15
BUDAKA,2019,3480,3210,6690,15
BUDAKA,2020,3560,3270,6830,15
BUDAKA,2021,3660,3310,6970,15
BUDAKA,2022,3750,3370,7120,15
BUDAKA,2023,3840,3430,7270,15
BUDAKA,2024,3940,3490,7430,15
BUDAKA,2025,4000,3490,7490,15
BUDUDA,2015,3350,3180,6530,15
BUDUDA,2016,3560,3350,6910,15
BUDUDA,2017,3750,3500,7250,15
BUDUDA,2018,3930,3630,7560,15
BUDUDA,2019,4080,3730,7810,15
BUDUDA,2020,4220,3830,8050,15
BUDUDA,2021,4360,3930,8290,15
BUDUDA,2022,4510,4040,8550,15
BUDUDA,2023,4660,4150,8810,15
BUDUDA,2024,4830,4280,9110,15
BUDUDA,2025,4940,4310,9250,15
BUGIRI,2015,5260,4900,10160,15
BUGIRI,2016,5570,5130,10700,15
BUGIRI,2017,5860,5330,11190,15
BUGIRI,2018,6100,5490,11590,15
BUGIRI,2019,6310,5620,11930,15
BUGIRI,2020,6500,5730,12230,15
BUGIRI,2021,6690,5860,12550,15
BUGIRI,2022,6890,5980,12870,15
BUGIRI,2023,7100,6120,13220,15
BUGIRI,2024,7330,6270,13600,15
BUGIRI,2025,7460,6290,13750,15
BUGWERI,2015,2180,2230,4410,15
BUGWERI,2016,2270,2320,4590,15
BUGWERI,2017,2360,2370,4730,15
BUGWERI,2018,2430,2410,4840,15
BUGWERI,2019,2470,2440,4910,15
BUGWERI,2020,2520,2460,4980,15
BUGWERI,2021,2560,2470,5030,15
BUGWERI,2022,2600,2500,5100,15
BUGWERI,2023,2640,2520,5160,15
BUGWERI,2024,2690,2550,5240,15
BUGWERI,2025,2700,2530,5230,15
BUHWEJU,2015,1410,1350,2760,15
BUHWEJU,2016,1450,1390,2840,15
BUHWEJU,2017,1500,1430,2930,15
BUHWEJU,2018,1550,1470,3020,15
BUHWEJU,2019,1600,1520,3120,15
BUHWEJU,2020,1650,1560,3210,15
BUHWEJU,2021,1700,1600,3300,15
BUHWEJU,2022,1750,1650,3400,15
BUHWEJU,2023,1800,1690,3490,15
BUHWEJU,2024,1850,1740,3590,15
BUHWEJU,2025,1900,1780,3680,15
BUIKWE,2015,5460,5670,11130,15
BUIKWE,2016,5670,5840,11510,15
BUIKWE,2017,5840,5950,11790,15
BUIKWE,2018,5960,6030,11990,15
BUIKWE,2019,6040,6070,12110,15
BUIKWE,2020,6100,6080,12180,15
BUIKWE,2021,6150,6090,12240,15
BUIKWE,2022,6210,6110,12320,15
BUIKWE,2023,6270,6130,12400,15
BUIKWE,2024,6330,6170,12500,15
BUIKWE,2025,6330,6070,12400,15
BUKEDEA,2015,2790,2680,5470,15
BUKEDEA,2016,2960,2810,5770,15
BUKEDEA,2017,3120,2940,6060,15
BUKEDEA,2018,3250,3040,6290,15
BUKEDEA,2019,3380,3110,6490,15
BUKEDEA,2020,3490,3180,6670,15
BUKEDEA,2021,3600,3260,6860,15
BUKEDEA,2022,3720,3330,7050,15
BUKEDEA,2023,3850,3410,7260,15
BUKEDEA,2024,3980,3500,7480,15
BUKEDEA,2025,4070,3520,7590,15
BUKOMANSIMBI,2015,2090,1960,4050,15
BUKOMANSIMBI,2016,2140,1990,4130,15
BUKOMANSIMBI,2017,2180,2000,4180,15
BUKOMANSIMBI,2018,2190,1980,4170,15
BUKOMANSIMBI,2019,2200,1970,4170,15
BUKOMANSIMBI,2020,2190,1950,4140,15
BUKOMANSIMBI,2021,2190,1920,4110,15
BUKOMANSIMBI,2022,2180,1890,4070,15
BUKOMANSIMBI,2023,2180,1870,4050,15
BUKOMANSIMBI,2024,2170,1850,4020,15
BUKOMANSIMBI,2025,2140,1790,3930,15
BUKWO,2015,1070,1020,2090,15
BUKWO,2016,1130,1080,2210,15
BUKWO,2017,1190,1130,2320,15
BUKWO,2018,1260,1180,2440,15
BUKWO,2019,1320,1240,2560,15
BUKWO,2020,1390,1300,2690,15
BUKWO,2021,1460,1360,2820,15
BUKWO,2022,1530,1420,2950,15
BUKWO,2023,1610,1480,3090,15
BUKWO,2024,1690,1550,3240,15
BUKWO,2025,1770,1620,3390,15
BULAMBULI,2015,2350,2420,4770,15
BULAMBULI,2016,2510,2560,5070,15
BULAMBULI,2017,2660,2690,5350,15
BULAMBULI,2018,2790,2810,5600,15
BULAMBULI,2019,2910,2900,5810,15
BULAMBULI,2020,3020,2980,6000,15
BULAMBULI,2021,3130,3080,6210,15
BULAMBULI,2022,3250,3170,6420,15
BULAMBULI,2023,3380,3280,6660,15
BULAMBULI,2024,3510,3390,6900,15
BULAMBULI,2025,3610,3430,7040,15
BULIISA,2015,1220,1150,2370,15
BULIISA,2016,1290,1200,2490,15
BULIISA,2017,1360,1250,2610,15
BULIISA,2018,1430,1310,2740,15
BULIISA,2019,1510,1360,2870,15
BULIISA,2020,1590,1420,3010,15
BULIISA,2021,1670,1480,3150,15
BULIISA,2022,1760,1540,3300,15
BULIISA,2023,1850,1610,3460,15
BULIISA,2024,1940,1670,3610,15
BULIISA,2025,2030,1740,3770,15
BUNDIBUGYO,2015,2550,2560,5110,15
BUNDIBUGYO,2016,2670,2650,5320,15
BUNDIBUGYO,2017,2780,2730,5510,15
BUNDIBUGYO,2018,2850,2770,5620,15
BUNDIBUGYO,2019,2920,2810,5730,15
BUNDIBUGYO,2020,2980,2840,5820,15
BUNDIBUGYO,2021,3040,2860,5900,15
BUNDIBUGYO,2022,3080,2890,5970,15
BUNDIBUGYO,2023,3150,2920,6070,15
BUNDIBUGYO,2024,3210,2960,6170,15
BUNDIBUGYO,2025,3240,2940,6180,15
BUNYANGABU,2015,2120,2000,4120,15
BUNYANGABU,2016,2210,2060,4270,15
BUNYANGABU,2017,2280,2120,4400,15
BUNYANGABU,2018,2350,2150,4500,15
BUNYANGABU,2019,2390,2160,4550,15
BUNYANGABU,2020,2430,2170,4600,15
BUNYANGABU,2021,2460,2180,4640,15
BUNYANGABU,2022,2500,2190,4690,15
BUNYANGABU,2023,2540,2200,4740,15
BUNYANGABU,2024,2570,2220,4790,15
BUNYANGABU,2025,2580,2190,4770,15
BUSHENYI,2015,2860,3080,5940,15
BUSHENYI,2016,2900,3110,6010,15
BUSHENYI,2017,2930,3130,6060,15
BUSHENYI,2018,2970,3160,6130,15
BUSHENYI,2019,3000,3190,6190,15
BUSHENYI,2020,3030,3210,6240,15
BUSHENYI,2021,3060,3230,6290,15
BUSHENYI,2022,3090,3250,6340,15
BUSHENYI,2023,3120,3270,6390,15
BUSHENYI,2024,3140,3290,6430,15
BUSHENYI,2025,3160,3300,6460,15
BUSIA,2015,4390,4580,8970,15
BUSIA,2016,4600,4740,9340,15
BUSIA,2017,4800,4890,9690,15
BUSIA,2018,4950,4990,9940,15
BUSIA,2019,5070,5060,10130,15
BUSIA,2020,5170,5110,10280,15
BUSIA,2021,5280,5160,10440,15
BUSIA,2022,5390,5230,10620,15
BUSIA,2023,5500,5300,10800,15
BUSIA,2024,5620,5360,10980,15
BUSIA,2025,5670,5330,11000,15
BUTALEJA,2015,3350,3150,6500,15
BUTALEJA,2016,3540,3290,6830,15
BUTALEJA,2017,3710,3410,7120,15
BUTALEJA,2018,3850,3500,7350,15
BUTALEJA,2019,3970,3570,7540,15
BUTALEJA,2020,4070,3640,7710,15
BUTALEJA,2021,4180,3700,7880,15
BUTALEJA,2022,4290,3760,8050,15
BUTALEJA,2023,4410,3840,8250,15
BUTALEJA,2024,4520,3920,8440,15
BUTALEJA,2025,4600,3920,8520,15
BUTAMBALA,2015,1510,1380,2890,15
BUTAMBALA,2016,1570,1400,2970,15
BUTAMBALA,2017,1600,1420,3020,15
BUTAMBALA,2018,1610,1420,3030,15
BUTAMBALA,2019,1620,1420,3040,15
BUTAMBALA,2020,1630,1400,3030,15
BUTAMBALA,2021,1640,1390,3030,15
BUTAMBALA,2022,1640,1380,3020,15
BUTAMBALA,2023,1650,1380,3030,15
BUTAMBALA,2024,1650,1370,3020,15
BUTAMBALA,2025,1640,1340,2980,15
BUTEBO,2015,1650,1530,3180,15
BUTEBO,2016,1710,1570,3280,15
BUTEBO,2017,1740,1590,3330,15
BUTEBO,2018,1780,1600,3380,15
BUTEBO,2019,1790,1600,3390,15
BUTEBO,2020,1800,1590,3390,15
BUTEBO,2021,1820,1580,3400,15
BUTEBO,2022,1820,1580,3400,15
BUTEBO,2023,1830,1570,3400,15
BUTEBO,2024,1840,1570,3410,15
BUTEBO,2025,1830,1540,3370,15
BUVUMA,2015,750,610,1360,15
BUVUMA,2016,790,650,1440,15
BUVUMA,2017,840,690,1530,15
BUVUMA,2018,890,740,1630,15
BUVUMA,2019,950,790,1740,15
BUVUMA,2020,1010,840,1850,15
BUVUMA,2021,1070,890,1960,15
BUVUMA,2022,1130,950,2080,15
BUVUMA,2023,1190,1010,2200,15
BUVUMA,2024,1260,1080,2340,15
BUVUMA,2025,1330,1140,2470,15
BUYENDE,2015,4060,3950,8010,15
BUYENDE,2016,4320,4160,8480,15
BUYENDE,2017,4550,4340,8890,15
BUYENDE,2018,4760,4490,9250,15
BUYENDE,2019,4940,4620,9560,15
BUYENDE,2020,5110,4730,9840,15
BUYENDE,2021,5280,4850,10130,15
BUYENDE,2022,5460,4980,10440,15
BUYENDE,2023,5640,5110,10750,15
BUYENDE,2024,5840,5250,11090,15
BUYENDE,2025,5970,5290,11260,15
DOKOLO,2015,2510,2480,4990,15
DOKOLO,2016,2590,2550,5140,15
DOKOLO,2017,2670,2620,5290,15
DOKOLO,2018,2750,2700,5450,15
DOKOLO,2019,2830,2770,5600,15
DOKOLO,2020,2910,2840,5750,15
DOKOLO,2021,3000,2910,5910,15
DOKOLO,2022,3080,2980,6060,15
DOKOLO,2023,3160,3060,6220,15
DOKOLO,2024,3240,3130,6370,15
DOKOLO,2025,3320,3200,6520,15
GOMBA,2015,2270,1880,4150,15
GOMBA,2016,2350,1920,4270,15
GOMBA,2017,2410,1940,4350,15
GOMBA,2018,2460,1950,4410,15
GOMBA,2019,2490,1950,4440,15
GOMBA,2020,2510,1940,4450,15
GOMBA,2021,2510,1930,4440,15
GOMBA,2022,2530,1910,4440,15
GOMBA,2023,2550,1910,4460,15
GOMBA,2024,2570,1900,4470,15
GOMBA,2025,2560,1860,4420,15
GULU,2015,3420,3720,7140,15
GULU,2016,3530,3830,7360,15
GULU,2017,3630,3940,7570,15
GULU,2018,3740,4060,7800,15
GULU,2019,3850,4170,8020,15
GULU,2020,3960,4290,8250,15
GULU,2021,4070,4400,8470,15
GULU,2022,4180,4520,8700,15
GULU,2023,4290,4640,8930,15
GULU,2024,4400,4760,9160,15
GULU,2025,4510,4870,9380,15
HOIMA,2015,3440,3420,6860,15
HOIMA,2016,3570,3540,7110,15
HOIMA,2017,3710,3660,7370,15
HOIMA,2018,3850,3780,7630,15
HOIMA,2019,3980,3910,7890,15
HOIMA,2020,4130,4040,8170,15
HOIMA,2021,4280,4180,8460,15
HOIMA,2022,4420,4310,8730,15
HOIMA,2023,4570,4440,9010,15
HOIMA,2024,4730,4580,9310,15
HOIMA,2025,4880,4720,9600,15
IBANDA,2015,3010,2990,6000,15
IBANDA,2016,3070,3040,6110,15
IBANDA,2017,3120,3090,6210,15
IBANDA,2018,3190,3150,6340,15
IBANDA,2019,3250,3200,6450,15
IBANDA,2020,3310,3260,6570,15
IBANDA,2021,3360,3310,6670,15
IBANDA,2022,3420,3360,6780,15
IBANDA,2023,3480,3410,6890,15
IBANDA,2024,3530,3460,6990,15
IBANDA,2025,3580,3500,7080,15
IGANGA,2015,4630,4830,9460,15
IGANGA,2016,4860,5010,9870,15
IGANGA,2017,5060,5160,10220,15
IGANGA,2018,5220,5260,10480,15
IGANGA,2019,5350,5340,10690,15
IGANGA,2020,5460,5390,10850,15
IGANGA,2021,5570,5460,11030,15
IGANGA,2022,5680,5520,11200,15
IGANGA,2023,5810,5580,11390,15
IGANGA,2024,5920,5660,11580,15
IGANGA,2025,5980,5620,11600,15
ISINGIRO,2015,5570,5420,10990,15
ISINGIRO,2016,5770,5610,11380,15
ISINGIRO,2017,5990,5810,11800,15
ISINGIRO,2018,6210,6010,12220,15
ISINGIRO,2019,6440,6220,12660,15
ISINGIRO,2020,6670,6430,13100,15
ISINGIRO,2021,6900,6640,13540,15
ISINGIRO,2022,7140,6860,14000,15
ISINGIRO,2023,7380,7080,14460,15
ISINGIRO,2024,7620,7300,14920,15
ISINGIRO,2025,7870,7520,15390,15
JINJA,2015,5640,6070,11710,15
JINJA,2016,5740,6170,11910,15
JINJA,2017,5840,6260,12100,15
JINJA,2018,5930,6350,12280,15
JINJA,2019,6020,6450,12470,15
JINJA,2020,6120,6540,12660,15
JINJA,2021,6210,6620,12830,15
JINJA,2022,6290,6710,13000,15
JINJA,2023,6370,6790,13160,15
JINJA,2024,6450,6870,13320,15
JINJA,2025,6520,6940,13460,15
KAABONG,2015,1670,1640,3310,15
KAABONG,2016,1710,1680,3390,15
KAABONG,2017,1760,1730,3490,15
KAABONG,2018,1800,1760,3560,15
KAABONG,2019,1850,1800,3650,15
KAABONG,2020,1900,1850,3750,15
KAABONG,2021,1950,1890,3840,15
KAABONG,2022,2000,1930,3930,15
KAABONG,2023,2050,1970,4020,15
KAABONG,2024,2090,2010,4100,15
KAABONG,2025,2140,2050,4190,15
KABALE,2015,2630,2820,5450,15
KABALE,2016,2670,2860,5530,15
KABALE,2017,2710,2890,5600,15
KABALE,2018,2750,2920,5670,15
KABALE,2019,2790,2960,5750,15
KABALE,2020,2830,2990,5820,15
KABALE,2021,2870,3020,5890,15
KABALE,2022,2910,3050,5960,15
KABALE,2023,2940,3070,6010,15
KABALE,2024,2980,3100,6080,15
KABALE,2025,3010,3120,6130,15
KABAROLE,2015,3250,3210,6460,15
KABAROLE,2016,3330,3280,6610,15
KABAROLE,2017,3400,3350,6750,15
KABAROLE,2018,3470,3420,6890,15
KABAROLE,2019,3550,3490,7040,15
KABAROLE,2020,3620,3560,7180,15
KABAROLE,2021,3690,3630,7320,15
KABAROLE,2022,3760,3700,7460,15
KABAROLE,2023,3830,3770,7600,15
KABAROLE,2024,3890,3830,7720,15
KABAROLE,2025,3960,3900,7860,15
KABERAMAIDO,2015,1520,1610,3130,15
KABERAMAIDO,2016,1610,1680,3290,15
KABERAMAIDO,2017,1690,1760,3450,15
KABERAMAIDO,2018,1770,1810,3580,15
KABERAMAIDO,2019,1830,1850,3680,15
KABERAMAIDO,2020,1890,1880,3770,15
KABERAMAIDO,2021,1950,1930,3880,15
KABERAMAIDO,2022,2010,1970,3980,15
KABERAMAIDO,2023,2070,2020,4090,15
KABERAMAIDO,2024,2150,2070,4220,15
KABERAMAIDO,2025,2190,2080,4270,15
KAGADI,2015,3990,3830,7820,15
KAGADI,2016,4140,3970,8110,15
KAGADI,2017,4300,4110,8410,15
KAGADI,2018,4450,4260,8710,15
KAGADI,2019,4610,4400,9010,15
KAGADI,2020,4780,4550,9330,15
KAGADI,2021,4940,4700,9640,15
KAGADI,2022,5110,4850,9960,15
KAGADI,2023,5280,5010,10290,15
KAGADI,2024,5450,5170,10620,15
KAGADI,2025,5630,5330,10960,15
KAKUMIRO,2015,3470,3010,6480,15
KAKUMIRO,2016,3780,3260,7040,15
KAKUMIRO,2017,4110,3540,7650,15
KAKUMIRO,2018,4480,3830,8310,15
KAKUMIRO,2019,4870,4150,9020,15
KAKUMIRO,2020,5290,4500,9790,15
KAKUMIRO,2021,5750,4860,10610,15
KAKUMIRO,2022,6240,5260,11500,15
KAKUMIRO,2023,6760,5680,12440,15
KAKUMIRO,2024,7330,6140,13470,15
KAKUMIRO,2025,7940,6620,14560,15
KALAKI,2015,1420,1450,2870,15
KALAKI,2016,1490,1510,3000,15
KALAKI,2017,1550,1570,3120,15
KALAKI,2018,1620,1630,3250,15
KALAKI,2019,1680,1690,3370,15
KALAKI,2020,1750,1760,3510,15
KALAKI,2021,1830,1820,3650,15
KALAKI,2022,1900,1890,3790,15
KALAKI,2023,1970,1960,3930,15
KALAKI,2024,2050,2030,4080,15
KALAKI,2025,2130,2100,4230,15
KALANGALA,2015,290,250,540,15
KALANGALA,2016,310,260,570,15
KALANGALA,2017,320,270,590,15
KALANGALA,2018,330,280,610,15
KALANGALA,2019,340,290,630,15
KALANGALA,2020,350,310,660,15
KALANGALA,2021,360,320,680,15
KALANGALA,2022,370,330,700,15
KALANGALA,2023,390,340,730,15
KALANGALA,2024,400,360,760,15
KALANGALA,2025,410,370,780,15
KALIRO,2015,3260,3100,6360,15
KALIRO,2016,3440,3230,6670,15
KALIRO,2017,3590,3350,6940,15
KALIRO,2018,3720,3430,7150,15
KALIRO,2019,3830,3500,7330,15
KALIRO,2020,3920,3550,7470,15
KALIRO,2021,4020,3610,7630,15
KALIRO,2022,4120,3680,7800,15
KALIRO,2023,4220,3760,7980,15
KALIRO,2024,4330,3820,8150,15
KALIRO,2025,4390,3820,8210,15
KALUNGU,2015,2600,2460,5060,15
KALUNGU,2016,2680,2500,5180,15
KALUNGU,2017,2720,2530,5250,15
KALUNGU,2018,2750,2540,5290,15
KALUNGU,2019,2770,2520,5290,15
KALUNGU,2020,2780,2500,5280,15
KALUNGU,2021,2770,2480,5250,15
KALUNGU,2022,2770,2470,5240,15
KALUNGU,2023,2780,2450,5230,15
KALUNGU,2024,2780,2430,5210,15
KALUNGU,2025,2750,2380,5130,15
KAMPALA,2015,12410,17920,30330,15
KAMPALA,2016,12660,18270,30930,15
KAMPALA,2017,12910,18630,31540,15
KAMPALA,2018,13160,18980,32140,15
KAMPALA,2019,13410,19330,32740,15
KAMPALA,2020,13650,19680,33330,15
KAMPALA,2021,13890,20020,33910,15
KAMPALA,2022,14120,20350,34470,15
KAMPALA,2023,14350,20680,35030,15
KAMPALA,2024,14570,21000,35570,15
KAMPALA,2025,14780,21310,36090,15
KAMULI,2015,7130,6800,13930,15
KAMULI,2016,7440,7010,14450,15
KAMULI,2017,7700,7180,14880,15
KAMULI,2018,7910,7280,15190,15
KAMULI,2019,8060,7330,15390,15
KAMULI,2020,8190,7370,15560,15
KAMULI,2021,8310,7410,15720,15
KAMULI,2022,8440,7450,15890,15
KAMULI,2023,8570,7500,16070,15
KAMULI,2024,8700,7560,16260,15
KAMULI,2025,8740,7460,16200,15
KAMWENGE,2015,3100,2740,5840,15
KAMWENGE,2016,3220,2840,6060,15
KAMWENGE,2017,3350,2940,6290,15
KAMWENGE,2018,3490,3050,6540,15
KAMWENGE,2019,3630,3150,6780,15
KAMWENGE,2020,3770,3260,7030,15
KAMWENGE,2021,3920,3370,7290,15
KAMWENGE,2022,4060,3480,7540,15
KAMWENGE,2023,4210,3590,7800,15
KAMWENGE,2024,4360,3710,8070,15
KAMWENGE,2025,4520,3820,8340,15
KANUNGU,2015,3180,3030,6210,15
KANUNGU,2016,3240,3080,6320,15
KANUNGU,2017,3300,3130,6430,15
KANUNGU,2018,3350,3180,6530,15
KANUNGU,2019,3410,3220,6630,15
KANUNGU,2020,3470,3270,6740,15
KANUNGU,2021,3520,3320,6840,15
KANUNGU,2022,3580,3360,6940,15
KANUNGU,2023,3630,3410,7040,15
KANUNGU,2024,3680,3450,7130,15
KANUNGU,2025,3720,3490,7210,15
KAPCHORWA,2015,1250,1380,2630,15
KAPCHORWA,2016,1290,1420,2710,15
KAPCHORWA,2017,1330,1460,2790,15
KAPCHORWA,2018,1370,1490,2860,15
KAPCHORWA,2019,1410,1530,2940,15
KAPCHORWA,2020,1450,1580,3030,15
KAPCHORWA,2021,1490,1620,3110,15
KAPCHORWA,2022,1530,1660,3190,15
KAPCHORWA,2023,1570,1700,3270,15
KAPCHORWA,2024,1620,1740,3360,15
KAPCHORWA,2025,1660,1780,3440,15
KAPELEBYONG,2015,1200,1140,2340,15
KAPELEBYONG,2016,1260,1180,2440,15
KAPELEBYONG,2017,1320,1210,2530,15
KAPELEBYONG,2018,1350,1240,2590,15
KAPELEBYONG,2019,1380,1250,2630,15
KAPELEBYONG,2020,1430,1270,2700,15
KAPELEBYONG,2021,1440,1280,2720,15
KAPELEBYONG,2022,1470,1290,2760,15
KAPELEBYONG,2023,1500,1320,2820,15
KAPELEBYONG,2024,1550,1330,2880,15
KAPELEBYONG,2025,1560,1320,2880,15
KASESE,2015,8300,8250,16550,15
KASESE,2016,8650,8500,17150,15
KASESE,2017,8940,8690,17630,15
KASESE,2018,9170,8810,17980,15
KASESE,2019,9330,8870,18200,15
KASESE,2020,9460,8910,18370,15
KASESE,2021,9590,8950,18540,15
KASESE,2022,9720,8990,18710,15
KASESE,2023,9860,9050,18910,15
KASESE,2024,9990,9110,19100,15
KASESE,2025,10010,8990,19000,15
KASSANDA,2015,3390,2990,6380,15
KASSANDA,2016,3490,3060,6550,15
KASSANDA,2017,3590,3120,6710,15
KASSANDA,2018,3690,3190,6880,15
KASSANDA,2019,3790,3250,7040,15
KASSANDA,2020,3890,3320,7210,15
KASSANDA,2021,4000,3380,7380,15
KASSANDA,2022,4100,3440,7540,15
KASSANDA,2023,4200,3510,7710,15
KASSANDA,2024,4300,3570,7870,15
KASSANDA,2025,4400,3630,8030,15
KATAKWI,2015,2360,2190,4550,15
KATAKWI,2016,2470,2260,4730,15
KATAKWI,2017,2570,2320,4890,15
KATAKWI,2018,2640,2360,5000,15
KATAKWI,2019,2700,2380,5080,15
KATAKWI,2020,2760,2400,5160,15
KATAKWI,2021,2810,2420,5230,15
KATAKWI,2022,2860,2440,5300,15
KATAKWI,2023,2910,2460,5370,15
KATAKWI,2024,2980,2480,5460,15
KATAKWI,2025,3000,2470,5470,15
KAYUNGA,2015,5250,4740,9990,15
KAYUNGA,2016,5440,4870,10310,15
KAYUNGA,2017,5600,4950,10550,15
KAYUNGA,2018,5710,4990,10700,15
KAYUNGA,2019,5790,4990,10780,15
KAYUNGA,2020,5840,4990,10830,15
KAYUNGA,2021,5890,4980,10870,15
KAYUNGA,2022,5940,4980,10920,15
KAYUNGA,2023,6000,4990,10990,15
KAYUNGA,2024,6050,4990,11040,15
KAYUNGA,2025,6030,4900,10930,15
KAZO,2015,2220,2130,4350,15
KAZO,2016,2310,2200,4510,15
KAZO,2017,2400,2280,4680,15
KAZO,2018,2480,2360,4840,15
KAZO,2019,2580,2440,5020,15
KAZO,2020,2670,2530,5200,15
KAZO,2021,2760,2610,5370,15
KAZO,2022,2860,2690,5550,15
KAZO,2023,2960,2780,5740,15
KAZO,2024,3060,2870,5930,15
KAZO,2025,3160,2960,6120,15
KIBAALE,2015,1620,1430,3050,15
KIBAALE,2016,1730,1520,3250,15
KIBAALE,2017,1840,1610,3450,15
KIBAALE,2018,1950,1700,3650,15
KIBAALE,2019,2080,1800,3880,15
KIBAALE,2020,2210,1890,4100,15
KIBAALE,2021,2340,2000,4340,15
KIBAALE,2022,2480,2110,4590,15
KIBAALE,2023,2630,2230,4860,15
KIBAALE,2024,2790,2350,5140,15
KIBAALE,2025,2950,2470,5420,15
KIBOGA,2015,1930,1860,3790,15
KIBOGA,2016,2010,1920,3930,15
KIBOGA,2017,2090,1970,4060,15
KIBOGA,2018,2140,1990,4130,15
KIBOGA,2019,2180,2010,4190,15
KIBOGA,2020,2210,2030,4240,15
KIBOGA,2021,2260,2040,4300,15
KIBOGA,2022,2290,2060,4350,15
KIBOGA,2023,2330,2070,4400,15
KIBOGA,2024,2360,2090,4450,15
KIBOGA,2025,2370,2070,4440,15
KIBUKU,2015,2740,2780,5520,15
KIBUKU,2016,2890,2900,5790,15
KIBUKU,2017,3040,3010,6050,15
KIBUKU,2018,3160,3100,6260,15
KIBUKU,2019,3260,3170,6430,15
KIBUKU,2020,3360,3220,6580,15
KIBUKU,2021,3440,3290,6730,15
KIBUKU,2022,3540,3360,6900,15
KIBUKU,2023,3640,3420,7060,15
KIBUKU,2024,3740,3500,7240,15
KIBUKU,2025,3810,3510,7320,15
KIKUUBE,2015,2950,2640,5590,15
KIKUUBE,2016,3110,2780,5890,15
KIKUUBE,2017,3280,2920,6200,15
KIKUUBE,2018,3450,3060,6510,15
KIKUUBE,2019,3630,3220,6850,15
KIKUUBE,2020,3820,3380,7200,15
KIKUUBE,2021,4020,3540,7560,15
KIKUUBE,2022,4220,3710,7930,15
KIKUUBE,2023,4430,3890,8320,15
KIKUUBE,2024,4650,4070,8720,15
KIKUUBE,2025,4870,4260,9130,15
KIRUHURA,2015,1780,1720,3500,15
KIRUHURA,2016,1850,1780,3630,15
KIRUHURA,2017,1920,1840,3760,15
KIRUHURA,2018,1990,1900,3890,15
KIRUHURA,2019,2060,1970,4030,15
KIRUHURA,2020,2140,2040,4180,15
KIRUHURA,2021,2220,2110,4330,15
KIRUHURA,2022,2290,2180,4470,15
KIRUHURA,2023,2370,2250,4620,15
KIRUHURA,2024,2450,2310,4760,15
KIRUHURA,2025,2530,2380,4910,15
KIRYANDONGO,2015,3540,3320,6860,15
KIRYANDONGO,2016,3700,3430,7130,15
KIRYANDONGO,2017,3850,3530,7380,15
KIRYANDONGO,2018,3970,3590,7560,15
KIRYANDONGO,2019,4070,3640,7710,15
KIRYANDONGO,2020,4150,3670,7820,15
KIRYANDONGO,2021,4220,3710,7930,15
KIRYANDONGO,2022,4300,3750,8050,15
KIRYANDONGO,2023,4400,3790,8190,15
KIRYANDONGO,2024,4480,3830,8310,15
KIRYANDONGO,2025,4520,3800,8320,15
KISORO,2015,3510,3890,7400,15
KISORO,2016,3650,4010,7660,15
KISORO,2017,3750,4090,7840,15
KISORO,2018,3830,4130,7960,15
KISORO,2019,3880,4150,8030,15
KISORO,2020,3920,4160,8080,15
KISORO,2021,3950,4170,8120,15
KISORO,2022,3990,4180,8170,15
KISORO,2023,4020,4200,8220,15
KISORO,2024,4050,4220,8270,15
KISORO,2025,4060,4150,8210,15
KITAGWENDA,2015,1730,1600,3330,15
KITAGWENDA,2016,1800,1660,3460,15
KITAGWENDA,2017,1880,1720,3600,15
KITAGWENDA,2018,1960,1780,3740,15
KITAGWENDA,2019,2030,1840,3870,15
KITAGWENDA,2020,2110,1910,4020,15
KITAGWENDA,2021,2190,1970,4160,15
KITAGWENDA,2022,2270,2040,4310,15
KITAGWENDA,2023,2360,2100,4460,15
KITAGWENDA,2024,2440,2170,4610,15
KITAGWENDA,2025,2530,2240,4770,15
KITGUM,2015,2760,2860,5620,15
KITGUM,2016,2850,2920,5770,15
KITGUM,2017,2930,2970,5900,15
KITGUM,2018,2970,2990,5960,15
KITGUM,2019,3010,2990,6000,15
KITGUM,2020,3020,2990,6010,15
KITGUM,2021,3040,2990,6030,15
KITGUM,2022,3050,2980,6030,15
KITGUM,2023,3070,2980,6050,15
KITGUM,2024,3090,2980,6070,15
KITGUM,2025,3070,2930,6000,15
KOBOKO,2015,2840,2960,5800,15
KOBOKO,2016,3000,3090,6090,15
KOBOKO,2017,3150,3210,6360,15
KOBOKO,2018,3280,3310,6590,15
KOBOKO,2019,3380,3380,6760,15
KOBOKO,2020,3490,3460,6950,15
KOBOKO,2021,3580,3520,7100,15
KOBOKO,2022,3690,3600,7290,15
KOBOKO,2023,3800,3670,7470,15
KOBOKO,2024,3910,3760,7670,15
KOBOKO,2025,3980,3770,7750,15
KOLE,2015,3180,2980,6160,15
KOLE,2016,3290,3070,6360,15
KOLE,2017,3390,3160,6550,15
KOLE,2018,3500,3250,6750,15
KOLE,2019,3610,3340,6950,15
KOLE,2020,3720,3430,7150,15
KOLE,2021,3840,3520,7360,15
KOLE,2022,3950,3610,7560,15
KOLE,2023,4070,3710,7780,15
KOLE,2024,4180,3800,7980,15
KOLE,2025,4300,3890,8190,15
KOTIDO,2015,2420,2490,4910,15
KOTIDO,2016,2520,2560,5080,15
KOTIDO,2017,2610,2620,5230,15
KOTIDO,2018,2680,2650,5330,15
KOTIDO,2019,2730,2670,5400,15
KOTIDO,2020,2760,2680,5440,15
KOTIDO,2021,2800,2690,5490,15
KOTIDO,2022,2840,2710,5550,15
KOTIDO,2023,2880,2720,5600,15
KOTIDO,2024,2930,2750,5680,15
KOTIDO,2025,2930,2700,5630,15
KUMI,2015,3410,3420,6830,15
KUMI,2016,3580,3540,7120,15
KUMI,2017,3730,3660,7390,15
KUMI,2018,3850,3730,7580,15
KUMI,2019,3950,3780,7730,15
KUMI,2020,4040,3820,7860,15
KUMI,2021,4120,3870,7990,15
KUMI,2022,4210,3910,8120,15
KUMI,2023,4300,3960,8260,15
KUMI,2024,4390,4020,8410,15
KUMI,2025,4440,3990,8430,15
KWANIA,2015,2340,2280,4620,15
KWANIA,2016,2420,2340,4760,15
KWANIA,2017,2490,2410,4900,15
KWANIA,2018,2570,2480,5050,15
KWANIA,2019,2640,2540,5180,15
KWANIA,2020,2720,2610,5330,15
KWANIA,2021,2800,2680,5480,15
KWANIA,2022,2880,2750,5630,15
KWANIA,2023,2960,2820,5780,15
KWANIA,2024,3030,2890,5920,15
KWANIA,2025,3110,2960,6070,15
KWEEN,2015,1240,1090,2330,15
KWEEN,2016,1280,1120,2400,15
KWEEN,2017,1320,1140,2460,15
KWEEN,2018,1360,1170,2530,15
KWEEN,2019,1400,1200,2600,15
KWEEN,2020,1440,1230,2670,15
KWEEN,2021,1490,1250,2740,15
KWEEN,2022,1530,1280,2810,15
KWEEN,2023,1570,1310,2880,15
KWEEN,2024,1610,1340,2950,15
KWEEN,2025,1650,1360,3010,15
KYANKWANZI,2015,2380,2110,4490,15
KYANKWANZI,2016,2510,2210,4720,15
KYANKWANZI,2017,2640,2310,4950,15
KYANKWANZI,2018,2770,2410,5180,15
KYANKWANZI,2019,2910,2520,5430,15
KYANKWANZI,2020,3050,2640,5690,15
KYANKWANZI,2021,3200,2760,5960,15
KYANKWANZI,2022,3360,2880,6240,15
KYANKWANZI,2023,3520,3000,6520,15
KYANKWANZI,2024,3680,3130,6810,15
KYANKWANZI,2025,3850,3260,7110,15
KYEGEGWA,2015,3330,2970,6300,15
KYEGEGWA,2016,3610,3200,6810,15
KYEGEGWA,2017,3910,3460,7370,15
KYEGEGWA,2018,4230,3730,7960,15
KYEGEGWA,2019,4570,4020,8590,15
KYEGEGWA,2020,4930,4330,9260,15
KYEGEGWA,2021,5330,4660,9990,15
KYEGEGWA,2022,5750,5020,10770,15
KYEGEGWA,2023,6200,5400,11600,15
KYEGEGWA,2024,6680,5800,12480,15
KYEGEGWA,2025,7190,6230,13420,15
KYENJOJO,2015,5030,4570,9600,15
KYENJOJO,2016,5240,4740,9980,15
KYENJOJO,2017,5450,4920,10370,15
KYENJOJO,2018,5670,5090,10760,15
KYENJOJO,2019,5900,5280,11180,15
KYENJOJO,2020,6130,5460,11590,15
KYENJOJO,2021,6370,5660,12030,15
KYENJOJO,2022,6610,5850,12460,15
KYENJOJO,2023,6860,6040,12900,15
KYENJOJO,2024,7110,6240,13350,15
KYENJOJO,2025,7360,6440,13800,15
KYOTERA,2015,3130,3060,6190,15
KYOTERA,2016,3240,3110,6350,15
KYOTERA,2017,3330,3160,6490,15
KYOTERA,2018,3380,3180,6560,15
KYOTERA,2019,3410,3180,6590,15
KYOTERA,2020,3430,3160,6590,15
KYOTERA,2021,3450,3150,6600,15
KYOTERA,2022,3480,3140,6620,15
KYOTERA,2023,3490,3130,6620,15
KYOTERA,2024,3510,3130,6640,15
KYOTERA,2025,3500,3070,6570,15
KARENGA,2015,600,720,1320,15
KARENGA,2016,620,730,1350,15
KARENGA,2017,640,750,1390,15
KARENGA,2018,660,770,1430,15
KARENGA,2019,670,790,1460,15
KARENGA,2020,690,810,1500,15
KARENGA,2021,710,830,1540,15
KARENGA,2022,720,840,1560,15
KARENGA,2023,740,860,1600,15
KARENGA,2024,760,880,1640,15
KARENGA,2025,770,900,1670,15
LAMWO,2015,1920,1820,3740,15
LAMWO,2016,1970,1850,3820,15
LAMWO,2017,2010,1880,3890,15
LAMWO,2018,2030,1900,3930,15
LAMWO,2019,2030,1890,3920,15
LAMWO,2020,2030,1880,3910,15
LAMWO,2021,2020,1880,3900,15
LAMWO,2022,2020,1880,3900,15
LAMWO,2023,2020,1880,3900,15
LAMWO,2024,2020,1870,3890,15
LAMWO,2025,1990,1830,3820,15
LIRA,2015,5180,5330,10510,15
LIRA,2016,5330,5480,10810,15
LIRA,2017,5480,5640,11120,15
LIRA,2018,5630,5790,11420,15
LIRA,2019,5780,5950,11730,15
LIRA,2020,5940,6120,12060,15
LIRA,2021,6090,6280,12370,15
LIRA,2022,6240,6440,12680,15
LIRA,2023,6400,6600,13000,15
LIRA,2024,6550,6770,13320,15
LIRA,2025,6700,6930,13630,15
LUUKA,2015,3570,3420,6990,15
LUUKA,2016,3700,3510,7210,15
LUUKA,2017,3820,3580,7400,15
LUUKA,2018,3900,3630,7530,15
LUUKA,2019,3960,3640,7600,15
LUUKA,2020,4000,3650,7650,15
LUUKA,2021,4030,3660,7690,15
LUUKA,2022,4070,3670,7740,15
LUUKA,2023,4110,3680,7790,15
LUUKA,2024,4160,3700,7860,15
LUUKA,2025,4150,3640,7790,15
LUWERO,2015,6330,6020,12350,15
LUWERO,2016,6610,6200,12810,15
LUWERO,2017,6840,6350,13190,15
LUWERO,2018,7010,6440,13450,15
LUWERO,2019,7140,6490,13630,15
LUWERO,2020,7250,6520,13770,15
LUWERO,2021,7350,6560,13910,15
LUWERO,2022,7450,6590,14040,15
LUWERO,2023,7570,6630,14200,15
LUWERO,2024,7680,6680,14360,15
LUWERO,2025,7700,6600,14300,15
LWENGO,2015,3710,3440,7150,15
LWENGO,2016,3810,3500,7310,15
LWENGO,2017,3880,3530,7410,15
LWENGO,2018,3920,3530,7450,15
LWENGO,2019,3940,3510,7450,15
LWENGO,2020,3940,3480,7420,15
LWENGO,2021,3930,3460,7390,15
LWENGO,2022,3930,3430,7360,15
LWENGO,2023,3940,3410,7350,15
LWENGO,2024,3940,3390,7330,15
LWENGO,2025,3890,3300,7190,15
LYANTONDE,2015,1190,1120,2310,15
LYANTONDE,2016,1250,1160,2410,15
LYANTONDE,2017,1290,1180,2470,15
LYANTONDE,2018,1340,1210,2550,15
LYANTONDE,2019,1360,1220,2580,15
LYANTONDE,2020,1390,1230,2620,15
LYANTONDE,2021,1420,1250,2670,15
LYANTONDE,2022,1450,1260,2710,15
LYANTONDE,2023,1480,1280,2760,15
LYANTONDE,2024,1500,1290,2790,15
LYANTONDE,2025,1520,1280,2800,15
MANAFWA,2015,1910,1970,3880,15
MANAFWA,2016,1960,2010,3970,15
MANAFWA,2017,2010,2060,4070,15
MANAFWA,2018,2060,2100,4160,15
MANAFWA,2019,2110,2150,4260,15
MANAFWA,2020,2160,2190,4350,15
MANAFWA,2021,2210,2240,4450,15
MANAFWA,2022,2260,2280,4540,15
MANAFWA,2023,2310,2320,4630,15
MANAFWA,2024,2350,2370,4720,15
MANAFWA,2025,2400,2410,4810,15
MARACHA,2015,2270,2100,4370,15
MARACHA,2016,2320,2140,4460,15
MARACHA,2017,2370,2180,4550,15
MARACHA,2018,2420,2230,4650,15
MARACHA,2019,2470,2270,4740,15
MARACHA,2020,2520,2310,4830,15
MARACHA,2021,2570,2350,4920,15
MARACHA,2022,2610,2390,5000,15
MARACHA,2023,2660,2430,5090,15
MARACHA,2024,2700,2460,5160,15
MARACHA,2025,2740,2500,5240,15
MASAKA,2015,3700,3780,7480,15
MASAKA,2016,3840,3880,7720,15
MASAKA,2017,3960,3980,7940,15
MASAKA,2018,4060,4020,8080,15
MASAKA,2019,4120,4040,8160,15
MASAKA,2020,4170,4050,8220,15
MASAKA,2021,4210,4060,8270,15
MASAKA,2022,4260,4080,8340,15
MASAKA,2023,4310,4100,8410,15
MASAKA,2024,4370,4120,8490,15
MASAKA,2025,4380,4070,8450,15
MASINDI,2015,3310,3110,6420,15
MASINDI,2016,3410,3190,6600,15
MASINDI,2017,3510,3280,6790,15
MASINDI,2018,3610,3370,6980,15
MASINDI,2019,3710,3450,7160,15
MASINDI,2020,3810,3540,7350,15
MASINDI,2021,3910,3630,7540,15
MASINDI,2022,4020,3710,7730,15
MASINDI,2023,4120,3800,7920,15
MASINDI,2024,4220,3890,8110,15
MASINDI,2025,4320,3970,8290,15
MAYUGE,2015,6200,5790,11990,15
MAYUGE,2016,6510,6010,12520,15
MAYUGE,2017,6780,6210,12990,15
MAYUGE,2018,6990,6350,13340,15
MAYUGE,2019,7170,6440,13610,15
MAYUGE,2020,7320,6520,13840,15
MAYUGE,2021,7470,6610,14080,15
MAYUGE,2022,7620,6690,14310,15
MAYUGE,2023,7790,6800,14590,15
MAYUGE,2024,7950,6900,14850,15
MAYUGE,2025,8030,6870,14900,15
MBALE,2015,6090,7010,13100,15
MBALE,2016,6380,7310,13690,15
MBALE,2017,6630,7550,14180,15
MBALE,2018,6840,7740,14580,15
MBALE,2019,7000,7880,14880,15
MBALE,2020,7140,8000,15140,15
MBALE,2021,7270,8120,15390,15
MBALE,2022,7420,8250,15670,15
MBALE,2023,7570,8390,15960,15
MBALE,2024,7710,8540,16250,15
MBALE,2025,7790,8520,16310,15
MBARARA,2015,3550,3980,7530,15
MBARARA,2016,3630,4060,7690,15
MBARARA,2017,3710,4150,7860,15
MBARARA,2018,3800,4240,8040,15
MBARARA,2019,3880,4330,8210,15
MBARARA,2020,3960,4420,8380,15
MBARARA,2021,4050,4500,8550,15
MBARARA,2022,4120,4590,8710,15
MBARARA,2023,4210,4670,8880,15
MBARARA,2024,4280,4750,9030,15
MBARARA,2025,4360,4830,9190,15
MITOOMA,2015,2340,2250,4590,15
MITOOMA,2016,2360,2280,4640,15
MITOOMA,2017,2390,2300,4690,15
MITOOMA,2018,2420,2320,4740,15
MITOOMA,2019,2450,2340,4790,15
MITOOMA,2020,2470,2360,4830,15
MITOOMA,2021,2500,2370,4870,15
MITOOMA,2022,2520,2390,4910,15
MITOOMA,2023,2540,2400,4940,15
MITOOMA,2024,2560,2420,4980,15
MITOOMA,2025,2580,2430,5010,15
MITYANA,2015,4450,4230,8680,15
MITYANA,2016,4600,4330,8930,15
MITYANA,2017,4730,4400,9130,15
MITYANA,2018,4820,4430,9250,15
MITYANA,2019,4870,4430,9300,15
MITYANA,2020,4910,4430,9340,15
MITYANA,2021,4950,4420,9370,15
MITYANA,2022,4980,4410,9390,15
MITYANA,2023,5030,4420,9450,15
MITYANA,2024,5070,4420,9490,15
MITYANA,2025,5040,4330,9370,15
MOROTO,2015,1370,1420,2790,15
MOROTO,2016,1430,1470,2900,15
MOROTO,2017,1470,1510,2980,15
MOROTO,2018,1510,1530,3040,15
MOROTO,2019,1540,1550,3090,15
MOROTO,2020,1560,1560,3120,15
MOROTO,2021,1570,1570,3140,15
MOROTO,2022,1590,1590,3180,15
MOROTO,2023,1610,1600,3210,15
MOROTO,2024,1630,1610,3240,15
MOROTO,2025,1630,1600,3230,15
MOYO,2015,1390,1230,2620,15
MOYO,2016,1420,1260,2680,15
MOYO,2017,1460,1280,2740,15
MOYO,2018,1490,1310,2800,15
MOYO,2019,1530,1340,2870,15
MOYO,2020,1570,1370,2940,15
MOYO,2021,1610,1390,3000,15
MOYO,2022,1640,1420,3060,15
MOYO,2023,1680,1440,3120,15
MOYO,2024,1720,1470,3190,15
MOYO,2025,1740,1500,3240,15
MPIGI,2015,3400,3190,6590,15
MPIGI,2016,3540,3280,6820,15
MPIGI,2017,3650,3360,7010,15
MPIGI,2018,3740,3410,7150,15
MPIGI,2019,3800,3440,7240,15
MPIGI,2020,3870,3460,7330,15
MPIGI,2021,3910,3470,7380,15
MPIGI,2022,3960,3490,7450,15
MPIGI,2023,4020,3520,7540,15
MPIGI,2024,4060,3540,7600,15
MPIGI,2025,4080,3510,7590,15
MUBENDE,2015,5050,4780,9830,15
MUBENDE,2016,5410,5050,10460,15
MUBENDE,2017,5750,5320,11070,15
MUBENDE,2018,6060,5550,11610,15
MUBENDE,2019,6330,5750,12080,15
MUBENDE,2020,6610,5940,12550,15
MUBENDE,2021,6890,6140,13030,15
MUBENDE,2022,7180,6340,13520,15
MUBENDE,2023,7480,6560,14040,15
MUBENDE,2024,7800,6800,14600,15
MUBENDE,2025,8030,6910,14940,15
MUKONO,2015,7410,8010,15420,15
MUKONO,2016,7750,8300,16050,15
MUKONO,2017,8030,8550,16580,15
MUKONO,2018,8250,8720,16970,15
MUKONO,2019,8430,8850,17280,15
MUKONO,2020,8560,8960,17520,15
MUKONO,2021,8700,9060,17760,15
MUKONO,2022,8850,9170,18020,15
MUKONO,2023,9000,9300,18300,15
MUKONO,2024,9140,9420,18560,15
MUKONO,2025,9190,9370,18560,15
MADI OKOLLO,2015,1780,1540,3320,15
MADI OKOLLO,2016,1830,1590,3420,15
MADI OKOLLO,2017,1890,1620,3510,15
MADI OKOLLO,2018,1940,1670,3610,15
MADI OKOLLO,2019,1990,1710,3700,15
MADI OKOLLO,2020,2050,1760,3810,15
MADI OKOLLO,2021,2100,1800,3900,15
MADI OKOLLO,2022,2160,1850,4010,15
MADI OKOLLO,2023,2210,1890,4100,15
MADI OKOLLO,2024,2260,1930,4190,15
MADI OKOLLO,2025,2320,1980,4300,15
NABILATUK,2015,1170,1220,2390,15
NABILATUK,2016,1240,1280,2520,15
NABILATUK,2017,1320,1350,2670,15
NABILATUK,2018,1390,1390,2780,15
NABILATUK,2019,1450,1440,2890,15
NABILATUK,2020,1510,1470,2980,15
NABILATUK,2021,1560,1510,3070,15
NABILATUK,2022,1630,1550,3180,15
NABILATUK,2023,1690,1600,3290,15
NABILATUK,2024,1770,1640,3410,15
NABILATUK,2025,1820,1670,3490,15
NAKAPIRIPIRIT,2015,1240,1250,2490,15
NAKAPIRIPIRIT,2016,1320,1310,2630,15
NAKAPIRIPIRIT,2017,1390,1370,2760,15
NAKAPIRIPIRIT,2018,1460,1420,2880,15
NAKAPIRIPIRIT,2019,1520,1470,2990,15
NAKAPIRIPIRIT,2020,1570,1500,3070,15
NAKAPIRIPIRIT,2021,1610,1540,3150,15
NAKAPIRIPIRIT,2022,1660,1580,3240,15
NAKAPIRIPIRIT,2023,1730,1620,3350,15
NAKAPIRIPIRIT,2024,1780,1680,3460,15
NAKAPIRIPIRIT,2025,1820,1680,3500,15
NAKASEKE,2015,2370,2110,4480,15
NAKASEKE,2016,2460,2150,4610,15
NAKASEKE,2017,2550,2210,4760,15
NAKASEKE,2018,2640,2260,4900,15
NAKASEKE,2019,2740,2310,5050,15
NAKASEKE,2020,2830,2360,5190,15
NAKASEKE,2021,2930,2420,5350,15
NAKASEKE,2022,3030,2470,5500,15
NAKASEKE,2023,3130,2520,5650,15
NAKASEKE,2024,3230,2570,5800,15
NAKASEKE,2025,3330,2620,5950,15
NAKASONGOLA,2015,2560,2400,4960,15
NAKASONGOLA,2016,2690,2470,5160,15
NAKASONGOLA,2017,2810,2540,5350,15
NAKASONGOLA,2018,2900,2600,5500,15
NAKASONGOLA,2019,2970,2630,5600,15
NAKASONGOLA,2020,3030,2650,5680,15
NAKASONGOLA,2021,3100,2670,5770,15
NAKASONGOLA,2022,3160,2700,5860,15
NAKASONGOLA,2023,3230,2720,5950,15
NAKASONGOLA,2024,3300,2760,6060,15
NAKASONGOLA,2025,3340,2740,6080,15
NAMAYINGO,2015,2680,2540,5220,15
NAMAYINGO,2016,2770,2590,5360,15
NAMAYINGO,2017,2850,2640,5490,15
NAMAYINGO,2018,2910,2650,5560,15
NAMAYINGO,2019,2940,2650,5590,15
NAMAYINGO,2020,2970,2650,5620,15
NAMAYINGO,2021,2990,2640,5630,15
NAMAYINGO,2022,3020,2630,5650,15
NAMAYINGO,2023,3040,2630,5670,15
NAMAYINGO,2024,3070,2630,5700,15
NAMAYINGO,2025,3060,2580,5640,15
NAMISINDWA,2015,2430,2420,4850,15
NAMISINDWA,2016,2500,2480,4980,15
NAMISINDWA,2017,2570,2540,5110,15
NAMISINDWA,2018,2640,2600,5240,15
NAMISINDWA,2019,2710,2660,5370,15
NAMISINDWA,2020,2780,2710,5490,15
NAMISINDWA,2021,2850,2770,5620,15
NAMISINDWA,2022,2930,2830,5760,15
NAMISINDWA,2023,3000,2890,5890,15
NAMISINDWA,2024,3070,2950,6020,15
NAMISINDWA,2025,3130,3000,6130,15
NAMUTUMBA,2015,3680,3200,6880,15
NAMUTUMBA,2016,3870,3330,7200,15
NAMUTUMBA,2017,4050,3450,7500,15
NAMUTUMBA,2018,4190,3530,7720,15
NAMUTUMBA,2019,4310,3590,7900,15
NAMUTUMBA,2020,4420,3640,8060,15
NAMUTUMBA,2021,4520,3700,8220,15
NAMUTUMBA,2022,4630,3750,8380,15
NAMUTUMBA,2023,4750,3820,8570,15
NAMUTUMBA,2024,4870,3880,8750,15
NAMUTUMBA,2025,4930,3870,8800,15
NAPAK,2015,2150,2140,4290,15
NAPAK,2016,2230,2200,4430,15
NAPAK,2017,2280,2240,4520,15
NAPAK,2018,2330,2270,4600,15
NAPAK,2019,2340,2280,4620,15
NAPAK,2020,2360,2300,4660,15
NAPAK,2021,2370,2300,4670,15
NAPAK,2022,2390,2300,4690,15
NAPAK,2023,2400,2320,4720,15
NAPAK,2024,2410,2330,4740,15
NAPAK,2025,2400,2300,4700,15
NEBBI,2015,3120,2980,6100,15
NEBBI,2016,3220,3060,6280,15
NEBBI,2017,3330,3150,6480,15
NEBBI,2018,3430,3240,6670,15
NEBBI,2019,3540,3330,6870,15
NEBBI,2020,3640,3420,7060,15
NEBBI,2021,3750,3500,7250,15
NEBBI,2022,3860,3590,7450,15
NEBBI,2023,3970,3690,7660,15
NEBBI,2024,4070,3770,7840,15
NEBBI,2025,4180,3860,8040,15
NGORA,2015,2000,1920,3920,15
NGORA,2016,2100,1990,4090,15
NGORA,2017,2170,2030,4200,15
NGORA,2018,2240,2070,4310,15
NGORA,2019,2290,2100,4390,15
NGORA,2020,2330,2110,4440,15
NGORA,2021,2370,2130,4500,15
NGORA,2022,2420,2150,4570,15
NGORA,2023,2450,2170,4620,15
NGORA,2024,2500,2190,4690,15
NGORA,2025,2520,2170,4690,15
NTOROKO,2015,800,740,1540,15
NTOROKO,2016,840,770,1610,15
NTOROKO,2017,870,780,1650,15
NTOROKO,2018,890,790,1680,15
NTOROKO,2019,900,800,1700,15
NTOROKO,2020,920,800,1720,15
NTOROKO,2021,930,800,1730,15
NTOROKO,2022,940,810,1750,15
NTOROKO,2023,960,810,1770,15
NTOROKO,2024,970,810,1780,15
NTOROKO,2025,980,790,1770,15
NTUNGAMO,2015,5680,5710,11390,15
NTUNGAMO,2016,5800,5810,11610,15
NTUNGAMO,2017,5930,5920,11850,15
NTUNGAMO,2018,6050,6030,12080,15
NTUNGAMO,2019,6180,6140,12320,15
NTUNGAMO,2020,6300,6240,12540,15
NTUNGAMO,2021,6420,6340,12760,15
NTUNGAMO,2022,6540,6440,12980,15
NTUNGAMO,2023,6660,6540,13200,15
NTUNGAMO,2024,6770,6640,13410,15
NTUNGAMO,2025,6880,6730,13610,15
NWOYA,2015,1800,1660,3460,15
NWOYA,2016,1990,1830,3820,15
NWOYA,2017,2200,2020,4220,15
NWOYA,2018,2430,2220,4650,15
NWOYA,2019,2680,2450,5130,15
NWOYA,2020,2950,2690,5640,15
NWOYA,2021,3250,2960,6210,15
NWOYA,2022,3580,3250,6830,15
NWOYA,2023,3950,3580,7530,15
NWOYA,2024,4340,3930,8270,15
NWOYA,2025,4770,4300,9070,15
OBONGI,2015,600,610,1210,15
OBONGI,2016,630,630,1260,15
OBONGI,2017,650,650,1300,15
OBONGI,2018,670,660,1330,15
OBONGI,2019,680,660,1340,15
OBONGI,2020,690,660,1350,15
OBONGI,2021,700,660,1360,15
OBONGI,2022,710,660,1370,15
OBONGI,2023,720,670,1390,15
OBONGI,2024,720,680,1400,15
OBONGI,2025,730,670,1400,15
OMORO,2015,2380,2250,4630,15
OMORO,2016,2500,2340,4840,15
OMORO,2017,2620,2430,5050,15
OMORO,2018,2710,2490,5200,15
OMORO,2019,2790,2540,5330,15
OMORO,2020,2860,2590,5450,15
OMORO,2021,2930,2630,5560,15
OMORO,2022,3000,2670,5670,15
OMORO,2023,3080,2720,5800,15
OMORO,2024,3160,2780,5940,15
OMORO,2025,3200,2770,5970,15
OTUKE,2015,1400,1320,2720,15
OTUKE,2016,1460,1370,2830,15
OTUKE,2017,1520,1430,2950,15
OTUKE,2018,1590,1490,3080,15
OTUKE,2019,1660,1560,3220,15
OTUKE,2020,1740,1620,3360,15
OTUKE,2021,1810,1690,3500,15
OTUKE,2022,1890,1750,3640,15
OTUKE,2023,1960,1820,3780,15
OTUKE,2024,2040,1890,3930,15
OTUKE,2025,2120,1970,4090,15
OYAM,2015,5010,4820,9830,15
OYAM,2016,5170,4970,10140,15
OYAM,2017,5320,5110,10430,15
OYAM,2018,5480,5260,10740,15
OYAM,2019,5650,5410,11060,15
OYAM,2020,5810,5560,11370,15
OYAM,2021,5970,5710,11680,15
OYAM,2022,6140,5860,12000,15
OYAM,2023,6310,6010,12320,15
OYAM,2024,6470,6160,12630,15
OYAM,2025,6630,6310,12940,15
PADER,2015,2580,2480,5060,15
PADER,2016,2680,2550,5230,15
PADER,2017,2740,2600,5340,15
PADER,2018,2800,2630,5430,15
PADER,2019,2820,2640,5460,15
PADER,2020,2840,2640,5480,15
PADER,2021,2860,2640,5500,15
PADER,2022,2880,2640,5520,15
PADER,2023,2890,2650,5540,15
PADER,2024,2920,2660,5580,15
PADER,2025,2910,2630,5540,15
PAKWACH,2015,1980,1850,3830,15
PAKWACH,2016,2070,1920,3990,15
PAKWACH,2017,2150,1990,4140,15
PAKWACH,2018,2240,2060,4300,15
PAKWACH,2019,2330,2140,4470,15
PAKWACH,2020,2430,2210,4640,15
PAKWACH,2021,2530,2290,4820,15
PAKWACH,2022,2620,2360,4980,15
PAKWACH,2023,2720,2440,5160,15
PAKWACH,2024,2820,2520,5340,15
PAKWACH,2025,2930,2600,5530,15
PALLISA,2015,4020,4010,8030,15
PALLISA,2016,4270,4230,8500,15
PALLISA,2017,4510,4410,8920,15
PALLISA,2018,4710,4560,9270,15
PALLISA,2019,4890,4680,9570,15
PALLISA,2020,5050,4810,9860,15
PALLISA,2021,5230,4920,10150,15
PALLISA,2022,5410,5050,10460,15
PALLISA,2023,5600,5190,10790,15
PALLISA,2024,5780,5340,11120,15
PALLISA,2025,5920,5380,11300,15
RAKAI,2015,3680,3130,6810,15
RAKAI,2016,3830,3220,7050,15
RAKAI,2017,3970,3300,7270,15
RAKAI,2018,4070,3350,7420,15
RAKAI,2019,4150,3370,7520,15
RAKAI,2020,4210,3390,7600,15
RAKAI,2021,4280,3420,7700,15
RAKAI,2022,4340,3430,7770,15
RAKAI,2023,4410,3460,7870,15
RAKAI,2024,4470,3480,7950,15
RAKAI,2025,4490,3440,7930,15
RUBANDA,2015,2320,2490,4810,15
RUBANDA,2016,2350,2510,4860,15
RUBANDA,2017,2390,2530,4920,15
RUBANDA,2018,2420,2550,4970,15
RUBANDA,2019,2450,2570,5020,15
RUBANDA,2020,2480,2580,5060,15
RUBANDA,2021,2500,2600,5100,15
RUBANDA,2022,2530,2610,5140,15
RUBANDA,2023,2550,2620,5170,15
RUBANDA,2024,2580,2640,5220,15
RUBANDA,2025,2600,2640,5240,15
RUBIRIZI,2015,1540,1470,3010,15
RUBIRIZI,2016,1570,1510,3080,15
RUBIRIZI,2017,1600,1530,3130,15
RUBIRIZI,2018,1630,1560,3190,15
RUBIRIZI,2019,1660,1590,3250,15
RUBIRIZI,2020,1700,1620,3320,15
RUBIRIZI,2021,1730,1650,3380,15
RUBIRIZI,2022,1760,1670,3430,15
RUBIRIZI,2023,1780,1700,3480,15
RUBIRIZI,2024,1810,1730,3540,15
RUBIRIZI,2025,1840,1750,3590,15
RUKIGA,2015,1190,1220,2410,15
RUKIGA,2016,1200,1230,2430,15
RUKIGA,2017,1210,1230,2440,15
RUKIGA,2018,1230,1240,2470,15
RUKIGA,2019,1240,1250,2490,15
RUKIGA,2020,1250,1260,2510,15
RUKIGA,2021,1260,1260,2520,15
RUKIGA,2022,1270,1270,2540,15
RUKIGA,2023,1270,1270,2540,15
RUKIGA,2024,1280,1280,2560,15
RUKIGA,2025,1290,1280,2570,15
RUKUNGIRI,2015,4030,4040,8070,15
RUKUNGIRI,2016,4080,4080,8160,15
RUKUNGIRI,2017,4130,4120,8250,15
RUKUNGIRI,2018,4180,4160,8340,15
RUKUNGIRI,2019,4220,4190,8410,15
RUKUNGIRI,2020,4270,4230,8500,15
RUKUNGIRI,2021,4310,4260,8570,15
RUKUNGIRI,2022,4350,4290,8640,15
RUKUNGIRI,2023,4390,4320,8710,15
RUKUNGIRI,2024,4420,4340,8760,15
RUKUNGIRI,2025,4450,4370,8820,15
RWAMPARA,2015,1540,1500,3040,15
RWAMPARA,2016,1580,1530,3110,15
RWAMPARA,2017,1610,1560,3170,15
RWAMPARA,2018,1650,1600,3250,15
RWAMPARA,2019,1680,1630,3310,15
RWAMPARA,2020,1720,1660,3380,15
RWAMPARA,2021,1750,1690,3440,15
RWAMPARA,2022,1790,1730,3520,15
RWAMPARA,2023,1820,1760,3580,15
RWAMPARA,2024,1860,1790,3650,15
RWAMPARA,2025,1890,1820,3710,15
SERERE,2015,3980,3950,7930,15
SERERE,2016,4210,4140,8350,15
SERERE,2017,4430,4310,8740,15
SERERE,2018,4610,4440,9050,15
SERERE,2019,4760,4550,9310,15
SERERE,2020,4910,4650,9560,15
SERERE,2021,5060,4750,9810,15
SERERE,2022,5220,4860,10080,15
SERERE,2023,5380,4970,10350,15
SERERE,2024,5540,5090,10630,15
SERERE,2025,5640,5100,10740,15
SHEEMA,2015,2500,2660,5160,15
SHEEMA,2016,2530,2690,5220,15
SHEEMA,2017,2560,2720,5280,15
SHEEMA,2018,2590,2740,5330,15
SHEEMA,2019,2620,2770,5390,15
SHEEMA,2020,2650,2800,5450,15
SHEEMA,2021,2680,2820,5500,15
SHEEMA,2022,2700,2840,5540,15
SHEEMA,2023,2730,2860,5590,15
SHEEMA,2024,2750,2880,5630,15
SHEEMA,2025,2770,2900,5670,15
SIRONKO,2015,3240,3010,6250,15
SIRONKO,2016,3320,3070,6390,15
SIRONKO,2017,3400,3140,6540,15
SIRONKO,2018,3480,3200,6680,15
SIRONKO,2019,3560,3260,6820,15
SIRONKO,2020,3640,3320,6960,15
SIRONKO,2021,3710,3380,7090,15
SIRONKO,2022,3790,3440,7230,15
SIRONKO,2023,3870,3500,7370,15
SIRONKO,2024,3940,3560,7500,15
SIRONKO,2025,4020,3610,7630,15
SOROTI,2015,4040,4190,8230,15
SOROTI,2016,4250,4370,8620,15
SOROTI,2017,4460,4530,8990,15
SOROTI,2018,4610,4650,9260,15
SOROTI,2019,4750,4740,9490,15
SOROTI,2020,4870,4820,9690,15
SOROTI,2021,4990,4890,9880,15
SOROTI,2022,5120,4980,10100,15
SOROTI,2023,5260,5080,10340,15
SOROTI,2024,5390,5180,10570,15
SOROTI,2025,5470,5170,10640,15
SSEMBABULE,2015,3330,2970,6300,15
SSEMBABULE,2016,3490,3070,6560,15
SSEMBABULE,2017,3620,3160,6780,15
SSEMBABULE,2018,3730,3210,6940,15
SSEMBABULE,2019,3820,3250,7070,15
SSEMBABULE,2020,3890,3280,7170,15
SSEMBABULE,2021,3960,3310,7270,15
SSEMBABULE,2022,4030,3350,7380,15
SSEMBABULE,2023,4100,3380,7480,15
SSEMBABULE,2024,4180,3410,7590,15
SSEMBABULE,2025,4210,3390,7600,15
TORORO,2015,6880,6800,13680,15
TORORO,2016,7070,6970,14040,15
TORORO,2017,7250,7140,14390,15
TORORO,2018,7440,7320,14760,15
TORORO,2019,7640,7500,15140,15
TORORO,2020,7830,7670,15500,15
TORORO,2021,8020,7850,15870,15
TORORO,2022,8210,8020,16230,15
TORORO,2023,8400,8200,16600,15
TORORO,2024,8580,8370,16950,15
TORORO,2025,8760,8540,17300,15
WAKISO,2015,18900,25080,43980,15
WAKISO,2016,20170,26790,46960,15
WAKISO,2017,21520,28630,50150,15
WAKISO,2018,22950,30570,53520,15
WAKISO,2019,24470,32620,57090,15
WAKISO,2020,26070,34790,60860,15
WAKISO,2021,27740,37090,64830,15
WAKISO,2022,29520,39540,69060,15
WAKISO,2023,31400,42090,73490,15
WAKISO,2024,33350,44770,78120,15
WAKISO,2025,35400,47610,83010,15
YUMBE,2015,8660,9390,18050,15
YUMBE,2016,9260,10010,19270,15
YUMBE,2017,9830,10610,20440,15
YUMBE,2018,10340,11160,21500,15
YUMBE,2019,10800,11640,22440,15
YUMBE,2020,11240,12120,23360,15
YUMBE,2021,11690,12610,24300,15
YUMBE,2022,12160,13140,25300,15
YUMBE,2023,12660,13710,26370,15
YUMBE,2024,13180,14300,27480,15
YUMBE,2025,13560,14630,28190,15
ZOMBO,2015,2980,2600,5580,15
ZOMBO,2016,3070,2680,5750,15
ZOMBO,2017,3160,2750,5910,15
ZOMBO,2018,3260,2830,6090,15
ZOMBO,2019,3360,2900,6260,15
ZOMBO,2020,3450,2980,6430,15
ZOMBO,2021,3550,3060,6610,15
ZOMBO,2022,3650,3140,6790,15
ZOMBO,2023,3750,3210,6960,15
ZOMBO,2024,3850,3290,7140,15
ZOMBO,2025,3950,3370,7320,15
ABIM,2015,1590,1560,3150,16
ABIM,2016,1740,1680,3420,16
ABIM,2017,1870,1790,3660,16
ABIM,2018,2010,1900,3910,16
ABIM,2019,2140,2000,4140,16
ABIM,2020,2260,2090,4350,16
ABIM,2021,2380,2180,4560,16
ABIM,2022,2510,2270,4780,16
ABIM,2023,2640,2360,5000,16
ABIM,2024,2780,2480,5260,16
ABIM,2025,2930,2590,5520,16
ADJUMANI,2015,3110,2880,5990,16
ADJUMANI,2016,3140,2910,6050,16
ADJUMANI,2017,3160,2940,6100,16
ADJUMANI,2018,3180,2970,6150,16
ADJUMANI,2019,3200,3000,6200,16
ADJUMANI,2020,3220,3020,6240,16
ADJUMANI,2021,3240,3040,6280,16
ADJUMANI,2022,3250,3070,6320,16
ADJUMANI,2023,3260,3090,6350,16
ADJUMANI,2024,3270,3100,6370,16
ADJUMANI,2025,3280,3120,6400,16
AGAGO,2015,3370,2960,6330,16
AGAGO,2016,3430,3010,6440,16
AGAGO,2017,3490,3060,6550,16
AGAGO,2018,3550,3120,6670,16
AGAGO,2019,3610,3170,6780,16
AGAGO,2020,3670,3220,6890,16
AGAGO,2021,3720,3270,6990,16
AGAGO,2022,3780,3320,7100,16
AGAGO,2023,3830,3370,7200,16
AGAGO,2024,3880,3410,7290,16
AGAGO,2025,3930,3460,7390,16
ALEBTONG,2015,3400,3250,6650,16
ALEBTONG,2016,3580,3370,6950,16
ALEBTONG,2017,3740,3500,7240,16
ALEBTONG,2018,3880,3590,7470,16
ALEBTONG,2019,3990,3660,7650,16
ALEBTONG,2020,4080,3710,7790,16
ALEBTONG,2021,4150,3740,7890,16
ALEBTONG,2022,4220,3770,7990,16
ALEBTONG,2023,4290,3800,8090,16
ALEBTONG,2024,4370,3840,8210,16
ALEBTONG,2025,4440,3890,8330,16
AMOLATAR,2015,1970,2020,3990,16
AMOLATAR,2016,2070,2090,4160,16
AMOLATAR,2017,2150,2160,4310,16
AMOLATAR,2018,2240,2210,4450,16
AMOLATAR,2019,2300,2250,4550,16
AMOLATAR,2020,2340,2280,4620,16
AMOLATAR,2021,2380,2280,4660,16
AMOLATAR,2022,2410,2300,4710,16
AMOLATAR,2023,2450,2320,4770,16
AMOLATAR,2024,2490,2340,4830,16
AMOLATAR,2025,2520,2360,4880,16
AMUDAT,2015,1540,1300,2840,16
AMUDAT,2016,1640,1380,3020,16
AMUDAT,2017,1720,1460,3180,16
AMUDAT,2018,1810,1520,3330,16
AMUDAT,2019,1880,1580,3460,16
AMUDAT,2020,1950,1630,3580,16
AMUDAT,2021,2000,1670,3670,16
AMUDAT,2022,2050,1720,3770,16
AMUDAT,2023,2120,1770,3890,16
AMUDAT,2024,2180,1830,4010,16
AMUDAT,2025,2240,1880,4120,16
AMURIA,2015,2600,2440,5040,16
AMURIA,2016,2750,2560,5310,16
AMURIA,2017,2910,2670,5580,16
AMURIA,2018,3040,2760,5800,16
AMURIA,2019,3160,2840,6000,16
AMURIA,2020,3260,2890,6150,16
AMURIA,2021,3350,2940,6290,16
AMURIA,2022,3430,2990,6420,16
AMURIA,2023,3520,3040,6560,16
AMURIA,2024,3610,3100,6710,16
AMURIA,2025,3710,3160,6870,16
AMURU,2015,2410,2230,4640,16
AMURU,2016,2520,2320,4840,16
AMURU,2017,2640,2400,5040,16
AMURU,2018,2730,2460,5190,16
AMURU,2019,2800,2510,5310,16
AMURU,2020,2860,2540,5400,16
AMURU,2021,2900,2560,5460,16
AMURU,2022,2940,2590,5530,16
AMURU,2023,2990,2610,5600,16
AMURU,2024,3030,2630,5660,16
AMURU,2025,3070,2660,5730,16
APAC,2015,2700,2530,5230,16
APAC,2016,2800,2620,5420,16
APAC,2017,2910,2710,5620,16
APAC,2018,3010,2800,5810,16
APAC,2019,3120,2900,6020,16
APAC,2020,3230,2990,6220,16
APAC,2021,3340,3090,6430,16
APAC,2022,3460,3190,6650,16
APAC,2023,3570,3290,6860,16
APAC,2024,3680,3390,7070,16
APAC,2025,3800,3490,7290,16
ARUA,2015,8410,8940,17350,16
ARUA,2016,8660,9180,17840,16
ARUA,2017,8900,9440,18340,16
ARUA,2018,9160,9690,18850,16
ARUA,2019,9410,9950,19360,16
ARUA,2020,9670,10200,19870,16
ARUA,2021,9930,10450,20380,16
ARUA,2022,10180,10710,20890,16
ARUA,2023,10440,10970,21410,16
ARUA,2024,10700,11220,21920,16
ARUA,2025,10950,11470,22420,16
BUDAKA,2015,2740,2670,5410,16
BUDAKA,2016,2900,2800,5700,16
BUDAKA,2017,3060,2920,5980,16
BUDAKA,2018,3200,3010,6210,16
BUDAKA,2019,3310,3090,6400,16
BUDAKA,2020,3400,3160,6560,16
BUDAKA,2021,3490,3210,6700,16
BUDAKA,2022,3570,3250,6820,16
BUDAKA,2023,3660,3300,6960,16
BUDAKA,2024,3750,3370,7120,16
BUDAKA,2025,3850,3420,7270,16
BUDUDA,2015,3120,3200,6320,16
BUDUDA,2016,3330,3390,6720,16
BUDUDA,2017,3540,3570,7110,16
BUDUDA,2018,3730,3720,7450,16
BUDUDA,2019,3900,3860,7760,16
BUDUDA,2020,4050,3970,8020,16
BUDUDA,2021,4200,4070,8270,16
BUDUDA,2022,4340,4180,8520,16
BUDUDA,2023,4490,4300,8790,16
BUDUDA,2024,4640,4420,9060,16
BUDUDA,2025,4800,4540,9340,16
BUGIRI,2015,4830,4750,9580,16
BUGIRI,2016,5130,5000,10130,16
BUGIRI,2017,5430,5230,10660,16
BUGIRI,2018,5710,5430,11140,16
BUGIRI,2019,5950,5600,11550,16
BUGIRI,2020,6150,5740,11890,16
BUGIRI,2021,6340,5860,12200,16
BUGIRI,2022,6530,5970,12500,16
BUGIRI,2023,6720,6110,12830,16
BUGIRI,2024,6930,6240,13170,16
BUGIRI,2025,7140,6390,13530,16
BUGWERI,2015,2240,2180,4420,16
BUGWERI,2016,2360,2270,4630,16
BUGWERI,2017,2460,2340,4800,16
BUGWERI,2018,2550,2400,4950,16
BUGWERI,2019,2620,2440,5060,16
BUGWERI,2020,2670,2470,5140,16
BUGWERI,2021,2720,2490,5210,16
BUGWERI,2022,2760,2510,5270,16
BUGWERI,2023,2810,2530,5340,16
BUGWERI,2024,2860,2550,5410,16
BUGWERI,2025,2900,2580,5480,16
BUHWEJU,2015,1460,1430,2890,16
BUHWEJU,2016,1510,1480,2990,16
BUHWEJU,2017,1560,1520,3080,16
BUHWEJU,2018,1610,1570,3180,16
BUHWEJU,2019,1660,1620,3280,16
BUHWEJU,2020,1710,1660,3370,16
BUHWEJU,2021,1760,1710,3470,16
BUHWEJU,2022,1820,1760,3580,16
BUHWEJU,2023,1870,1800,3670,16
BUHWEJU,2024,1920,1850,3770,16
BUHWEJU,2025,1970,1900,3870,16
BUIKWE,2015,5380,5580,10960,16
BUIKWE,2016,5600,5770,11370,16
BUIKWE,2017,5810,5930,11740,16
BUIKWE,2018,5990,6050,12040,16
BUIKWE,2019,6100,6120,12220,16
BUIKWE,2020,6180,6160,12340,16
BUIKWE,2021,6250,6170,12420,16
BUIKWE,2022,6300,6180,12480,16
BUIKWE,2023,6360,6200,12560,16
BUIKWE,2024,6420,6230,12650,16
BUIKWE,2025,6490,6260,12750,16
BUKEDEA,2015,2460,2410,4870,16
BUKEDEA,2016,2620,2540,5160,16
BUKEDEA,2017,2790,2660,5450,16
BUKEDEA,2018,2930,2770,5700,16
BUKEDEA,2019,3060,2860,5920,16
BUKEDEA,2020,3180,2940,6120,16
BUKEDEA,2021,3290,3000,6290,16
BUKEDEA,2022,3400,3070,6470,16
BUKEDEA,2023,3510,3140,6650,16
BUKEDEA,2024,3630,3230,6860,16
BUKEDEA,2025,3750,3310,7060,16
BUKOMANSIMBI,2015,1990,1810,3800,16
BUKOMANSIMBI,2016,2040,1850,3890,16
BUKOMANSIMBI,2017,2090,1870,3960,16
BUKOMANSIMBI,2018,2130,1870,4000,16
BUKOMANSIMBI,2019,2150,1870,4020,16
BUKOMANSIMBI,2020,2150,1850,4000,16
BUKOMANSIMBI,2021,2150,1820,3970,16
BUKOMANSIMBI,2022,2140,1800,3940,16
BUKOMANSIMBI,2023,2140,1780,3920,16
BUKOMANSIMBI,2024,2130,1760,3890,16
BUKOMANSIMBI,2025,2130,1740,3870,16
BUKWO,2015,1150,1140,2290,16
BUKWO,2016,1210,1190,2400,16
BUKWO,2017,1280,1250,2530,16
BUKWO,2018,1350,1310,2660,16
BUKWO,2019,1410,1380,2790,16
BUKWO,2020,1490,1440,2930,16
BUKWO,2021,1560,1510,3070,16
BUKWO,2022,1650,1580,3230,16
BUKWO,2023,1730,1650,3380,16
BUKWO,2024,1810,1720,3530,16
BUKWO,2025,1900,1800,3700,16
BULAMBULI,2015,2460,2530,4990,16
BULAMBULI,2016,2630,2680,5310,16
BULAMBULI,2017,2810,2840,5650,16
BULAMBULI,2018,2970,2970,5940,16
BULAMBULI,2019,3130,3100,6230,16
BULAMBULI,2020,3260,3200,6460,16
BULAMBULI,2021,3380,3300,6680,16
BULAMBULI,2022,3510,3390,6900,16
BULAMBULI,2023,3640,3510,7150,16
BULAMBULI,2024,3780,3620,7400,16
BULAMBULI,2025,3930,3750,7680,16
BULIISA,2015,1340,1270,2610,16
BULIISA,2016,1410,1330,2740,16
BULIISA,2017,1490,1390,2880,16
BULIISA,2018,1570,1450,3020,16
BULIISA,2019,1650,1510,3160,16
BULIISA,2020,1740,1580,3320,16
BULIISA,2021,1830,1650,3480,16
BULIISA,2022,1920,1710,3630,16
BULIISA,2023,2020,1790,3810,16
BULIISA,2024,2120,1860,3980,16
BULIISA,2025,2220,1930,4150,16
BUNDIBUGYO,2015,2550,2910,5460,16
BUNDIBUGYO,2016,2680,3030,5710,16
BUNDIBUGYO,2017,2820,3140,5960,16
BUNDIBUGYO,2018,2920,3220,6140,16
BUNDIBUGYO,2019,3010,3280,6290,16
BUNDIBUGYO,2020,3090,3320,6410,16
BUNDIBUGYO,2021,3140,3350,6490,16
BUNDIBUGYO,2022,3200,3390,6590,16
BUNDIBUGYO,2023,3260,3420,6680,16
BUNDIBUGYO,2024,3330,3450,6780,16
BUNDIBUGYO,2025,3380,3500,6880,16
BUNYANGABU,2015,2070,1960,4030,16
BUNYANGABU,2016,2170,2030,4200,16
BUNYANGABU,2017,2270,2090,4360,16
BUNYANGABU,2018,2350,2140,4490,16
BUNYANGABU,2019,2400,2180,4580,16
BUNYANGABU,2020,2440,2190,4630,16
BUNYANGABU,2021,2480,2200,4680,16
BUNYANGABU,2022,2520,2210,4730,16
BUNYANGABU,2023,2560,2220,4780,16
BUNYANGABU,2024,2600,2240,4840,16
BUNYANGABU,2025,2630,2250,4880,16
BUSHENYI,2015,3200,3290,6490,16
BUSHENYI,2016,3240,3320,6560,16
BUSHENYI,2017,3280,3350,6630,16
BUSHENYI,2018,3320,3380,6700,16
BUSHENYI,2019,3360,3410,6770,16
BUSHENYI,2020,3390,3440,6830,16
BUSHENYI,2021,3430,3460,6890,16
BUSHENYI,2022,3460,3480,6940,16
BUSHENYI,2023,3490,3500,6990,16
BUSHENYI,2024,3520,3520,7040,16
BUSHENYI,2025,3540,3530,7070,16
BUSIA,2015,3980,4270,8250,16
BUSIA,2016,4200,4440,8640,16
BUSIA,2017,4410,4610,9020,16
BUSIA,2018,4590,4740,9330,16
BUSIA,2019,4730,4840,9570,16
BUSIA,2020,4850,4900,9750,16
BUSIA,2021,4950,4960,9910,16
BUSIA,2022,5060,5010,10070,16
BUSIA,2023,5150,5070,10220,16
BUSIA,2024,5260,5130,10390,16
BUSIA,2025,5380,5210,10590,16
BUTALEJA,2015,2950,2870,5820,16
BUTALEJA,2016,3130,3020,6150,16
BUTALEJA,2017,3300,3140,6440,16
BUTALEJA,2018,3450,3250,6700,16
BUTALEJA,2019,3580,3350,6930,16
BUTALEJA,2020,3690,3410,7100,16
BUTALEJA,2021,3800,3470,7270,16
BUTALEJA,2022,3890,3530,7420,16
BUTALEJA,2023,4000,3590,7590,16
BUTALEJA,2024,4100,3660,7760,16
BUTALEJA,2025,4220,3740,7960,16
BUTAMBALA,2015,1260,1310,2570,16
BUTAMBALA,2016,1300,1340,2640,16
BUTAMBALA,2017,1330,1360,2690,16
BUTAMBALA,2018,1370,1380,2750,16
BUTAMBALA,2019,1390,1380,2770,16
BUTAMBALA,2020,1400,1370,2770,16
BUTAMBALA,2021,1410,1360,2770,16
BUTAMBALA,2022,1400,1350,2750,16
BUTAMBALA,2023,1410,1340,2750,16
BUTAMBALA,2024,1410,1340,2750,16
BUTAMBALA,2025,1420,1330,2750,16
BUTEBO,2015,1410,1470,2880,16
BUTEBO,2016,1470,1510,2980,16
BUTEBO,2017,1510,1530,3040,16
BUTEBO,2018,1560,1550,3110,16
BUTEBO,2019,1580,1560,3140,16
BUTEBO,2020,1590,1560,3150,16
BUTEBO,2021,1600,1550,3150,16
BUTEBO,2022,1610,1550,3160,16
BUTEBO,2023,1620,1540,3160,16
BUTEBO,2024,1620,1540,3160,16
BUTEBO,2025,1630,1530,3160,16
BUVUMA,2015,830,680,1510,16
BUVUMA,2016,880,720,1600,16
BUVUMA,2017,940,770,1710,16
BUVUMA,2018,990,820,1810,16
BUVUMA,2019,1060,880,1940,16
BUVUMA,2020,1120,940,2060,16
BUVUMA,2021,1190,1000,2190,16
BUVUMA,2022,1250,1060,2310,16
BUVUMA,2023,1330,1130,2460,16
BUVUMA,2024,1400,1200,2600,16
BUVUMA,2025,1480,1280,2760,16
BUYENDE,2015,3940,3580,7520,16
BUYENDE,2016,4190,3770,7960,16
BUYENDE,2017,4460,3970,8430,16
BUYENDE,2018,4700,4140,8840,16
BUYENDE,2019,4920,4280,9200,16
BUYENDE,2020,5100,4400,9500,16
BUYENDE,2021,5270,4520,9790,16
BUYENDE,2022,5450,4620,10070,16
BUYENDE,2023,5630,4750,10380,16
BUYENDE,2024,5830,4870,10700,16
BUYENDE,2025,6020,5000,11020,16
DOKOLO,2015,2870,2690,5560,16
DOKOLO,2016,2960,2760,5720,16
DOKOLO,2017,3050,2840,5890,16
DOKOLO,2018,3140,2910,6050,16
DOKOLO,2019,3230,2990,6220,16
DOKOLO,2020,3320,3070,6390,16
DOKOLO,2021,3420,3150,6570,16
DOKOLO,2022,3510,3230,6740,16
DOKOLO,2023,3610,3310,6920,16
DOKOLO,2024,3700,3380,7080,16
DOKOLO,2025,3800,3460,7260,16
GOMBA,2015,2110,1730,3840,16
GOMBA,2016,2190,1780,3970,16
GOMBA,2017,2270,1810,4080,16
GOMBA,2018,2330,1830,4160,16
GOMBA,2019,2370,1840,4210,16
GOMBA,2020,2390,1830,4220,16
GOMBA,2021,2410,1820,4230,16
GOMBA,2022,2430,1810,4240,16
GOMBA,2023,2440,1800,4240,16
GOMBA,2024,2460,1790,4250,16
GOMBA,2025,2480,1790,4270,16
GULU,2015,3740,4150,7890,16
GULU,2016,3850,4280,8130,16
GULU,2017,3970,4400,8370,16
GULU,2018,4080,4530,8610,16
GULU,2019,4200,4660,8860,16
GULU,2020,4330,4780,9110,16
GULU,2021,4450,4910,9360,16
GULU,2022,4570,5040,9610,16
GULU,2023,4690,5180,9870,16
GULU,2024,4810,5310,10120,16
GULU,2025,4930,5430,10360,16
HOIMA,2015,3380,3650,7030,16
HOIMA,2016,3510,3780,7290,16
HOIMA,2017,3640,3910,7550,16
HOIMA,2018,3770,4040,7810,16
HOIMA,2019,3910,4180,8090,16
HOIMA,2020,4050,4320,8370,16
HOIMA,2021,4200,4460,8660,16
HOIMA,2022,4340,4600,8940,16
HOIMA,2023,4490,4750,9240,16
HOIMA,2024,4640,4890,9530,16
HOIMA,2025,4790,5040,9830,16
IBANDA,2015,3160,3170,6330,16
IBANDA,2016,3220,3230,6450,16
IBANDA,2017,3290,3290,6580,16
IBANDA,2018,3350,3350,6700,16
IBANDA,2019,3410,3400,6810,16
IBANDA,2020,3480,3460,6940,16
IBANDA,2021,3540,3510,7050,16
IBANDA,2022,3600,3570,7170,16
IBANDA,2023,3660,3620,7280,16
IBANDA,2024,3710,3670,7380,16
IBANDA,2025,3760,3720,7480,16
IGANGA,2015,4430,4620,9050,16
IGANGA,2016,4660,4820,9480,16
IGANGA,2017,4890,4990,9880,16
IGANGA,2018,5100,5130,10230,16
IGANGA,2019,5260,5250,10510,16
IGANGA,2020,5390,5320,10710,16
IGANGA,2021,5500,5380,10880,16
IGANGA,2022,5610,5430,11040,16
IGANGA,2023,5730,5490,11220,16
IGANGA,2024,5850,5570,11420,16
IGANGA,2025,5970,5640,11610,16
ISINGIRO,2015,5860,5810,11670,16
ISINGIRO,2016,6080,6020,12100,16
ISINGIRO,2017,6310,6230,12540,16
ISINGIRO,2018,6540,6440,12980,16
ISINGIRO,2019,6780,6660,13440,16
ISINGIRO,2020,7020,6890,13910,16
ISINGIRO,2021,7270,7120,14390,16
ISINGIRO,2022,7510,7350,14860,16
ISINGIRO,2023,7770,7580,15350,16
ISINGIRO,2024,8020,7820,15840,16
ISINGIRO,2025,8280,8060,16340,16
JINJA,2015,6210,6680,12890,16
JINJA,2016,6320,6780,13100,16
JINJA,2017,6420,6890,13310,16
JINJA,2018,6530,6990,13520,16
JINJA,2019,6630,7090,13720,16
JINJA,2020,6730,7190,13920,16
JINJA,2021,6830,7290,14120,16
JINJA,2022,6930,7380,14310,16
JINJA,2023,7020,7470,14490,16
JINJA,2024,7100,7560,14660,16
JINJA,2025,7180,7630,14810,16
KAABONG,2015,1520,1490,3010,16
KAABONG,2016,1560,1530,3090,16
KAABONG,2017,1600,1570,3170,16
KAABONG,2018,1640,1610,3250,16
KAABONG,2019,1690,1640,3330,16
KAABONG,2020,1730,1680,3410,16
KAABONG,2021,1780,1720,3500,16
KAABONG,2022,1820,1760,3580,16
KAABONG,2023,1860,1790,3650,16
KAABONG,2024,1900,1830,3730,16
KAABONG,2025,1940,1860,3800,16
KABALE,2015,2720,2940,5660,16
KABALE,2016,2770,2980,5750,16
KABALE,2017,2810,3010,5820,16
KABALE,2018,2850,3050,5900,16
KABALE,2019,2890,3080,5970,16
KABALE,2020,2930,3110,6040,16
KABALE,2021,2970,3150,6120,16
KABALE,2022,3010,3180,6190,16
KABALE,2023,3050,3200,6250,16
KABALE,2024,3080,3230,6310,16
KABALE,2025,3110,3250,6360,16
KABAROLE,2015,3540,3680,7220,16
KABAROLE,2016,3620,3760,7380,16
KABAROLE,2017,3700,3840,7540,16
KABAROLE,2018,3780,3920,7700,16
KABAROLE,2019,3860,4000,7860,16
KABAROLE,2020,3940,4080,8020,16
KABAROLE,2021,4020,4160,8180,16
KABAROLE,2022,4090,4240,8330,16
KABAROLE,2023,4170,4320,8490,16
KABAROLE,2024,4240,4390,8630,16
KABAROLE,2025,4310,4470,8780,16
KABERAMAIDO,2015,1510,1490,3000,16
KABERAMAIDO,2016,1610,1570,3180,16
KABERAMAIDO,2017,1700,1650,3350,16
KABERAMAIDO,2018,1790,1710,3500,16
KABERAMAIDO,2019,1870,1770,3640,16
KABERAMAIDO,2020,1940,1800,3740,16
KABERAMAIDO,2021,2000,1840,3840,16
KABERAMAIDO,2022,2060,1880,3940,16
KABERAMAIDO,2023,2130,1920,4050,16
KABERAMAIDO,2024,2200,1980,4180,16
KABERAMAIDO,2025,2260,2020,4280,16
KAGADI,2015,4340,4100,8440,16
KAGADI,2016,4500,4240,8740,16
KAGADI,2017,4670,4390,9060,16
KAGADI,2018,4840,4550,9390,16
KAGADI,2019,5010,4700,9710,16
KAGADI,2020,5190,4860,10050,16
KAGADI,2021,5370,5020,10390,16
KAGADI,2022,5560,5190,10750,16
KAGADI,2023,5740,5350,11090,16
KAGADI,2024,5930,5520,11450,16
KAGADI,2025,6110,5690,11800,16
KAKUMIRO,2015,3410,3170,6580,16
KAKUMIRO,2016,3710,3440,7150,16
KAKUMIRO,2017,4040,3730,7770,16
KAKUMIRO,2018,4400,4040,8440,16
KAKUMIRO,2019,4780,4380,9160,16
KAKUMIRO,2020,5200,4740,9940,16
KAKUMIRO,2021,5640,5130,10770,16
KAKUMIRO,2022,6120,5550,11670,16
KAKUMIRO,2023,6640,5990,12630,16
KAKUMIRO,2024,7200,6470,13670,16
KAKUMIRO,2025,7790,6980,14770,16
KALAKI,2015,1680,1600,3280,16
KALAKI,2016,1760,1660,3420,16
KALAKI,2017,1830,1730,3560,16
KALAKI,2018,1910,1790,3700,16
KALAKI,2019,1990,1860,3850,16
KALAKI,2020,2070,1930,4000,16
KALAKI,2021,2160,2010,4170,16
KALAKI,2022,2250,2080,4330,16
KALAKI,2023,2340,2160,4500,16
KALAKI,2024,2420,2230,4650,16
KALAKI,2025,2520,2310,4830,16
KALANGALA,2015,350,270,620,16
KALANGALA,2016,360,280,640,16
KALANGALA,2017,370,290,660,16
KALANGALA,2018,380,300,680,16
KALANGALA,2019,400,310,710,16
KALANGALA,2020,410,320,730,16
KALANGALA,2021,420,340,760,16
KALANGALA,2022,440,350,790,16
KALANGALA,2023,450,360,810,16
KALANGALA,2024,470,380,850,16
KALANGALA,2025,480,390,870,16
KALIRO,2015,3160,3000,6160,16
KALIRO,2016,3340,3130,6470,16
KALIRO,2017,3530,3270,6800,16
KALIRO,2018,3690,3380,7070,16
KALIRO,2019,3820,3480,7300,16
KALIRO,2020,3930,3540,7470,16
KALIRO,2021,4030,3600,7630,16
KALIRO,2022,4130,3660,7790,16
KALIRO,2023,4230,3730,7960,16
KALIRO,2024,4330,3790,8120,16
KALIRO,2025,4440,3870,8310,16
KALUNGU,2015,2420,2300,4720,16
KALUNGU,2016,2500,2360,4860,16
KALUNGU,2017,2570,2400,4970,16
KALUNGU,2018,2620,2420,5040,16
KALUNGU,2019,2650,2420,5070,16
KALUNGU,2020,2650,2410,5060,16
KALUNGU,2021,2660,2390,5050,16
KALUNGU,2022,2660,2380,5040,16
KALUNGU,2023,2660,2360,5020,16
KALUNGU,2024,2670,2340,5010,16
KALUNGU,2025,2660,2330,4990,16
KAMPALA,2015,13970,20150,34120,16
KAMPALA,2016,14250,20540,34790,16
KAMPALA,2017,14530,20940,35470,16
KAMPALA,2018,14810,21340,36150,16
KAMPALA,2019,15090,21730,36820,16
KAMPALA,2020,15360,22120,37480,16
KAMPALA,2021,15630,22510,38140,16
KAMPALA,2022,15900,22880,38780,16
KAMPALA,2023,16150,23250,39400,16
KAMPALA,2024,16400,23610,40010,16
KAMPALA,2025,16630,23950,40580,16
KAMULI,2015,6630,6250,12880,16
KAMULI,2016,6950,6470,13420,16
KAMULI,2017,7260,6670,13930,16
KAMULI,2018,7510,6830,14340,16
KAMULI,2019,7720,6930,14650,16
KAMULI,2020,7860,6970,14830,16
KAMULI,2021,7980,7010,14990,16
KAMULI,2022,8110,7040,15150,16
KAMULI,2023,8230,7070,15300,16
KAMULI,2024,8360,7130,15490,16
KAMULI,2025,8480,7180,15660,16
KAMWENGE,2015,3010,2940,5950,16
KAMWENGE,2016,3140,3040,6180,16
KAMWENGE,2017,3260,3150,6410,16
KAMWENGE,2018,3390,3260,6650,16
KAMWENGE,2019,3530,3380,6910,16
KAMWENGE,2020,3670,3490,7160,16
KAMWENGE,2021,3810,3610,7420,16
KAMWENGE,2022,3950,3720,7670,16
KAMWENGE,2023,4100,3850,7950,16
KAMWENGE,2024,4250,3970,8220,16
KAMWENGE,2025,4400,4090,8490,16
KANUNGU,2015,3260,3220,6480,16
KANUNGU,2016,3320,3270,6590,16
KANUNGU,2017,3380,3330,6710,16
KANUNGU,2018,3440,3380,6820,16
KANUNGU,2019,3500,3430,6930,16
KANUNGU,2020,3560,3480,7040,16
KANUNGU,2021,3610,3530,7140,16
KANUNGU,2022,3670,3580,7250,16
KANUNGU,2023,3720,3630,7350,16
KANUNGU,2024,3770,3670,7440,16
KANUNGU,2025,3820,3710,7530,16
KAPCHORWA,2015,1480,1620,3100,16
KAPCHORWA,2016,1530,1660,3190,16
KAPCHORWA,2017,1580,1710,3290,16
KAPCHORWA,2018,1620,1750,3370,16
KAPCHORWA,2019,1670,1800,3470,16
KAPCHORWA,2020,1720,1850,3570,16
KAPCHORWA,2021,1770,1890,3660,16
KAPCHORWA,2022,1820,1940,3760,16
KAPCHORWA,2023,1860,1990,3850,16
KAPCHORWA,2024,1910,2040,3950,16
KAPCHORWA,2025,1960,2080,4040,16
KAPELEBYONG,2015,1220,1060,2280,16
KAPELEBYONG,2016,1280,1100,2380,16
KAPELEBYONG,2017,1350,1150,2500,16
KAPELEBYONG,2018,1410,1180,2590,16
KAPELEBYONG,2019,1450,1200,2650,16
KAPELEBYONG,2020,1490,1220,2710,16
KAPELEBYONG,2021,1510,1230,2740,16
KAPELEBYONG,2022,1550,1240,2790,16
KAPELEBYONG,2023,1580,1250,2830,16
KAPELEBYONG,2024,1610,1270,2880,16
KAPELEBYONG,2025,1650,1290,2940,16
KASESE,2015,7970,8170,16140,16
KASESE,2016,8330,8450,16780,16
KASESE,2017,8680,8700,17380,16
KASESE,2018,8980,8910,17890,16
KASESE,2019,9200,9020,18220,16
KASESE,2020,9360,9090,18450,16
KASESE,2021,9500,9130,18630,16
KASESE,2022,9620,9170,18790,16
KASESE,2023,9760,9210,18970,16
KASESE,2024,9880,9270,19150,16
KASESE,2025,10030,9330,19360,16
KASSANDA,2015,3520,3010,6530,16
KASSANDA,2016,3620,3080,6700,16
KASSANDA,2017,3720,3140,6860,16
KASSANDA,2018,3820,3210,7030,16
KASSANDA,2019,3930,3270,7200,16
KASSANDA,2020,4040,3340,7380,16
KASSANDA,2021,4140,3410,7550,16
KASSANDA,2022,4250,3470,7720,16
KASSANDA,2023,4350,3530,7880,16
KASSANDA,2024,4460,3590,8050,16
KASSANDA,2025,4560,3650,8210,16
KATAKWI,2015,2120,2150,4270,16
KATAKWI,2016,2230,2230,4460,16
KATAKWI,2017,2340,2310,4650,16
KATAKWI,2018,2430,2360,4790,16
KATAKWI,2019,2500,2400,4900,16
KATAKWI,2020,2550,2430,4980,16
KATAKWI,2021,2600,2450,5050,16
KATAKWI,2022,2660,2470,5130,16
KATAKWI,2023,2700,2490,5190,16
KATAKWI,2024,2750,2510,5260,16
KATAKWI,2025,2800,2540,5340,16
KAYUNGA,2015,4950,4490,9440,16
KAYUNGA,2016,5160,4620,9780,16
KAYUNGA,2017,5340,4730,10070,16
KAYUNGA,2018,5500,4810,10310,16
KAYUNGA,2019,5610,4850,10460,16
KAYUNGA,2020,5680,4860,10540,16
KAYUNGA,2021,5740,4860,10600,16
KAYUNGA,2022,5790,4850,10640,16
KAYUNGA,2023,5830,4840,10670,16
KAYUNGA,2024,5890,4850,10740,16
KAYUNGA,2025,5940,4860,10800,16
KAZO,2015,2240,2200,4440,16
KAZO,2016,2330,2280,4610,16
KAZO,2017,2420,2360,4780,16
KAZO,2018,2510,2450,4960,16
KAZO,2019,2600,2530,5130,16
KAZO,2020,2690,2620,5310,16
KAZO,2021,2790,2700,5490,16
KAZO,2022,2890,2790,5680,16
KAZO,2023,2990,2880,5870,16
KAZO,2024,3090,2970,6060,16
KAZO,2025,3190,3060,6250,16
KIBAALE,2015,1690,1480,3170,16
KIBAALE,2016,1800,1560,3360,16
KIBAALE,2017,1920,1650,3570,16
KIBAALE,2018,2040,1750,3790,16
KIBAALE,2019,2170,1850,4020,16
KIBAALE,2020,2300,1950,4250,16
KIBAALE,2021,2440,2060,4500,16
KIBAALE,2022,2590,2170,4760,16
KIBAALE,2023,2740,2290,5030,16
KIBAALE,2024,2910,2420,5330,16
KIBAALE,2025,3070,2540,5610,16
KIBOGA,2015,1670,1690,3360,16
KIBOGA,2016,1760,1760,3520,16
KIBOGA,2017,1830,1810,3640,16
KIBOGA,2018,1900,1860,3760,16
KIBOGA,2019,1950,1890,3840,16
KIBOGA,2020,1990,1900,3890,16
KIBOGA,2021,2020,1910,3930,16
KIBOGA,2022,2050,1920,3970,16
KIBOGA,2023,2090,1940,4030,16
KIBOGA,2024,2120,1960,4080,16
KIBOGA,2025,2160,1970,4130,16
KIBUKU,2015,2590,2430,5020,16
KIBUKU,2016,2750,2550,5300,16
KIBUKU,2017,2910,2670,5580,16
KIBUKU,2018,3040,2760,5800,16
KIBUKU,2019,3170,2840,6010,16
KIBUKU,2020,3270,2910,6180,16
KIBUKU,2021,3360,2960,6320,16
KIBUKU,2022,3460,3010,6470,16
KIBUKU,2023,3550,3080,6630,16
KIBUKU,2024,3650,3140,6790,16
KIBUKU,2025,3750,3210,6960,16
KIKUUBE,2015,3030,2670,5700,16
KIKUUBE,2016,3190,2810,6000,16
KIKUUBE,2017,3360,2960,6320,16
KIKUUBE,2018,3540,3100,6640,16
KIKUUBE,2019,3720,3260,6980,16
KIKUUBE,2020,3920,3420,7340,16
KIKUUBE,2021,4120,3590,7710,16
KIKUUBE,2022,4330,3760,8090,16
KIKUUBE,2023,4540,3940,8480,16
KIKUUBE,2024,4760,4130,8890,16
KIKUUBE,2025,4990,4310,9300,16
KIRUHURA,2015,1840,1750,3590,16
KIRUHURA,2016,1910,1810,3720,16
KIRUHURA,2017,1980,1880,3860,16
KIRUHURA,2018,2060,1940,4000,16
KIRUHURA,2019,2140,2010,4150,16
KIRUHURA,2020,2220,2080,4300,16
KIRUHURA,2021,2300,2150,4450,16
KIRUHURA,2022,2380,2220,4600,16
KIRUHURA,2023,2460,2290,4750,16
KIRUHURA,2024,2540,2360,4900,16
KIRUHURA,2025,2620,2430,5050,16
KIRYANDONGO,2015,3550,3230,6780,16
KIRYANDONGO,2016,3730,3360,7090,16
KIRYANDONGO,2017,3910,3480,7390,16
KIRYANDONGO,2018,4070,3570,7640,16
KIRYANDONGO,2019,4200,3650,7850,16
KIRYANDONGO,2020,4290,3690,7980,16
KIRYANDONGO,2021,4380,3730,8110,16
KIRYANDONGO,2022,4460,3760,8220,16
KIRYANDONGO,2023,4540,3790,8330,16
KIRYANDONGO,2024,4640,3840,8480,16
KIRYANDONGO,2025,4730,3880,8610,16
KISORO,2015,3470,4080,7550,16
KISORO,2016,3620,4230,7850,16
KISORO,2017,3750,4340,8090,16
KISORO,2018,3860,4430,8290,16
KISORO,2019,3940,4480,8420,16
KISORO,2020,3990,4500,8490,16
KISORO,2021,4030,4510,8540,16
KISORO,2022,4070,4520,8590,16
KISORO,2023,4100,4530,8630,16
KISORO,2024,4130,4560,8690,16
KISORO,2025,4180,4570,8750,16
KITAGWENDA,2015,1740,1630,3370,16
KITAGWENDA,2016,1810,1690,3500,16
KITAGWENDA,2017,1890,1750,3640,16
KITAGWENDA,2018,1960,1820,3780,16
KITAGWENDA,2019,2040,1880,3920,16
KITAGWENDA,2020,2120,1940,4060,16
KITAGWENDA,2021,2200,2010,4210,16
KITAGWENDA,2022,2280,2080,4360,16
KITAGWENDA,2023,2370,2140,4510,16
KITAGWENDA,2024,2450,2210,4660,16
KITAGWENDA,2025,2540,2280,4820,16
KITGUM,2015,2800,2760,5560,16
KITGUM,2016,2910,2840,5750,16
KITGUM,2017,3010,2900,5910,16
KITGUM,2018,3080,2950,6030,16
KITGUM,2019,3140,2970,6110,16
KITGUM,2020,3170,2980,6150,16
KITGUM,2021,3180,2970,6150,16
KITGUM,2022,3200,2970,6170,16
KITGUM,2023,3220,2970,6190,16
KITGUM,2024,3240,2960,6200,16
KITGUM,2025,3260,2970,6230,16
KOBOKO,2015,2690,2570,5260,16
KOBOKO,2016,2850,2700,5550,16
KOBOKO,2017,3020,2830,5850,16
KOBOKO,2018,3180,2930,6110,16
KOBOKO,2019,3300,3020,6320,16
KOBOKO,2020,3410,3100,6510,16
KOBOKO,2021,3510,3160,6670,16
KOBOKO,2022,3610,3220,6830,16
KOBOKO,2023,3710,3280,6990,16
KOBOKO,2024,3820,3360,7180,16
KOBOKO,2025,3940,3440,7380,16
KOLE,2015,3490,3430,6920,16
KOLE,2016,3600,3530,7130,16
KOLE,2017,3720,3630,7350,16
KOLE,2018,3840,3730,7570,16
KOLE,2019,3960,3840,7800,16
KOLE,2020,4090,3940,8030,16
KOLE,2021,4210,4050,8260,16
KOLE,2022,4340,4150,8490,16
KOLE,2023,4460,4260,8720,16
KOLE,2024,4590,4360,8950,16
KOLE,2025,4710,4470,9180,16
KOTIDO,2015,2520,2730,5250,16
KOTIDO,2016,2640,2830,5470,16
KOTIDO,2017,2760,2910,5670,16
KOTIDO,2018,2850,2970,5820,16
KOTIDO,2019,2920,3020,5940,16
KOTIDO,2020,2980,3040,6020,16
KOTIDO,2021,3010,3050,6060,16
KOTIDO,2022,3050,3060,6110,16
KOTIDO,2023,3100,3080,6180,16
KOTIDO,2024,3140,3100,6240,16
KOTIDO,2025,3180,3110,6290,16
KUMI,2015,3130,3020,6150,16
KUMI,2016,3290,3150,6440,16
KUMI,2017,3470,3270,6740,16
KUMI,2018,3610,3360,6970,16
KUMI,2019,3730,3430,7160,16
KUMI,2020,3820,3480,7300,16
KUMI,2021,3910,3510,7420,16
KUMI,2022,3990,3560,7550,16
KUMI,2023,4070,3590,7660,16
KUMI,2024,4160,3650,7810,16
KUMI,2025,4240,3690,7930,16
KWANIA,2015,2710,2500,5210,16
KWANIA,2016,2790,2570,5360,16
KWANIA,2017,2880,2640,5520,16
KWANIA,2018,2960,2720,5680,16
KWANIA,2019,3050,2790,5840,16
KWANIA,2020,3140,2870,6010,16
KWANIA,2021,3230,2950,6180,16
KWANIA,2022,3320,3020,6340,16
KWANIA,2023,3420,3100,6520,16
KWANIA,2024,3500,3170,6670,16
KWANIA,2025,3600,3250,6850,16
KWEEN,2015,1390,1260,2650,16
KWEEN,2016,1430,1300,2730,16
KWEEN,2017,1470,1330,2800,16
KWEEN,2018,1520,1360,2880,16
KWEEN,2019,1560,1390,2950,16
KWEEN,2020,1610,1420,3030,16
KWEEN,2021,1660,1460,3120,16
KWEEN,2022,1700,1490,3190,16
KWEEN,2023,1750,1520,3270,16
KWEEN,2024,1800,1550,3350,16
KWEEN,2025,1840,1580,3420,16
KYANKWANZI,2015,2600,2370,4970,16
KYANKWANZI,2016,2740,2480,5220,16
KYANKWANZI,2017,2880,2600,5480,16
KYANKWANZI,2018,3020,2710,5730,16
KYANKWANZI,2019,3180,2840,6020,16
KYANKWANZI,2020,3330,2970,6300,16
KYANKWANZI,2021,3500,3100,6600,16
KYANKWANZI,2022,3670,3230,6900,16
KYANKWANZI,2023,3840,3380,7220,16
KYANKWANZI,2024,4020,3520,7540,16
KYANKWANZI,2025,4200,3670,7870,16
KYEGEGWA,2015,3380,3250,6630,16
KYEGEGWA,2016,3650,3510,7160,16
KYEGEGWA,2017,3960,3790,7750,16
KYEGEGWA,2018,4280,4090,8370,16
KYEGEGWA,2019,4630,4400,9030,16
KYEGEGWA,2020,5000,4750,9750,16
KYEGEGWA,2021,5400,5110,10510,16
KYEGEGWA,2022,5820,5500,11320,16
KYEGEGWA,2023,6280,5920,12200,16
KYEGEGWA,2024,6770,6360,13130,16
KYEGEGWA,2025,7280,6830,14110,16
KYENJOJO,2015,5090,4710,9800,16
KYENJOJO,2016,5300,4880,10180,16
KYENJOJO,2017,5520,5060,10580,16
KYENJOJO,2018,5750,5250,11000,16
KYENJOJO,2019,5980,5430,11410,16
KYENJOJO,2020,6210,5630,11840,16
KYENJOJO,2021,6450,5820,12270,16
KYENJOJO,2022,6700,6020,12720,16
KYENJOJO,2023,6940,6220,13160,16
KYENJOJO,2024,7200,6430,13630,16
KYENJOJO,2025,7450,6630,14080,16
KYOTERA,2015,3000,2860,5860,16
KYOTERA,2016,3120,2950,6070,16
KYOTERA,2017,3230,3010,6240,16
KYOTERA,2018,3310,3040,6350,16
KYOTERA,2019,3360,3060,6420,16
KYOTERA,2020,3400,3060,6460,16
KYOTERA,2021,3420,3050,6470,16
KYOTERA,2022,3440,3030,6470,16
KYOTERA,2023,3450,3030,6480,16
KYOTERA,2024,3470,3020,6490,16
KYOTERA,2025,3500,3020,6520,16
KARENGA,2015,860,930,1790,16
KARENGA,2016,880,950,1830,16
KARENGA,2017,910,970,1880,16
KARENGA,2018,940,1000,1940,16
KARENGA,2019,960,1030,1990,16
KARENGA,2020,990,1050,2040,16
KARENGA,2021,1000,1070,2070,16
KARENGA,2022,1030,1090,2120,16
KARENGA,2023,1050,1120,2170,16
KARENGA,2024,1080,1140,2220,16
KARENGA,2025,1100,1160,2260,16
LAMWO,2015,1710,1670,3380,16
LAMWO,2016,1760,1720,3480,16
LAMWO,2017,1800,1750,3550,16
LAMWO,2018,1840,1770,3610,16
LAMWO,2019,1860,1790,3650,16
LAMWO,2020,1860,1780,3640,16
LAMWO,2021,1860,1790,3650,16
LAMWO,2022,1860,1780,3640,16
LAMWO,2023,1860,1770,3630,16
LAMWO,2024,1860,1770,3630,16
LAMWO,2025,1860,1770,3630,16
LIRA,2015,5640,5900,11540,16
LIRA,2016,5800,6060,11860,16
LIRA,2017,5970,6240,12210,16
LIRA,2018,6130,6410,12540,16
LIRA,2019,6300,6590,12890,16
LIRA,2020,6470,6770,13240,16
LIRA,2021,6630,6950,13580,16
LIRA,2022,6800,7130,13930,16
LIRA,2023,6970,7310,14280,16
LIRA,2024,7130,7490,14620,16
LIRA,2025,7290,7670,14960,16
LUUKA,2015,3300,3160,6460,16
LUUKA,2016,3430,3260,6690,16
LUUKA,2017,3570,3360,6930,16
LUUKA,2018,3680,3420,7100,16
LUUKA,2019,3750,3470,7220,16
LUUKA,2020,3810,3480,7290,16
LUUKA,2021,3850,3490,7340,16
LUUKA,2022,3880,3500,7380,16
LUUKA,2023,3920,3510,7430,16
LUUKA,2024,3960,3530,7490,16
LUUKA,2025,3990,3530,7520,16
LUWERO,2015,5960,5760,11720,16
LUWERO,2016,6230,5960,12190,16
LUWERO,2017,6500,6150,12650,16
LUWERO,2018,6730,6290,13020,16
LUWERO,2019,6900,6380,13280,16
LUWERO,2020,7030,6430,13460,16
LUWERO,2021,7140,6460,13600,16
LUWERO,2022,7230,6480,13710,16
LUWERO,2023,7340,6520,13860,16
LUWERO,2024,7440,6570,14010,16
LUWERO,2025,7550,6620,14170,16
LWENGO,2015,3300,3180,6480,16
LWENGO,2016,3400,3250,6650,16
LWENGO,2017,3500,3310,6810,16
LWENGO,2018,3570,3340,6910,16
LWENGO,2019,3610,3350,6960,16
LWENGO,2020,3620,3330,6950,16
LWENGO,2021,3620,3300,6920,16
LWENGO,2022,3620,3270,6890,16
LWENGO,2023,3610,3250,6860,16
LWENGO,2024,3620,3230,6850,16
LWENGO,2025,3620,3210,6830,16
LYANTONDE,2015,1090,1120,2210,16
LYANTONDE,2016,1130,1150,2280,16
LYANTONDE,2017,1200,1200,2400,16
LYANTONDE,2018,1250,1230,2480,16
LYANTONDE,2019,1280,1250,2530,16
LYANTONDE,2020,1310,1280,2590,16
LYANTONDE,2021,1340,1290,2630,16
LYANTONDE,2022,1350,1290,2640,16
LYANTONDE,2023,1380,1300,2680,16
LYANTONDE,2024,1410,1310,2720,16
LYANTONDE,2025,1430,1340,2770,16
MANAFWA,2015,2060,2020,4080,16
MANAFWA,2016,2110,2070,4180,16
MANAFWA,2017,2160,2110,4270,16
MANAFWA,2018,2220,2160,4380,16
MANAFWA,2019,2270,2200,4470,16
MANAFWA,2020,2320,2250,4570,16
MANAFWA,2021,2370,2300,4670,16
MANAFWA,2022,2430,2340,4770,16
MANAFWA,2023,2480,2390,4870,16
MANAFWA,2024,2530,2430,4960,16
MANAFWA,2025,2580,2470,5050,16
MARACHA,2015,2480,2400,4880,16
MARACHA,2016,2540,2450,4990,16
MARACHA,2017,2590,2490,5080,16
MARACHA,2018,2640,2540,5180,16
MARACHA,2019,2700,2590,5290,16
MARACHA,2020,2750,2630,5380,16
MARACHA,2021,2800,2680,5480,16
MARACHA,2022,2850,2730,5580,16
MARACHA,2023,2900,2770,5670,16
MARACHA,2024,2950,2810,5760,16
MARACHA,2025,3000,2850,5850,16
MASAKA,2015,3460,3520,6980,16
MASAKA,2016,3610,3640,7250,16
MASAKA,2017,3760,3740,7500,16
MASAKA,2018,3870,3820,7690,16
MASAKA,2019,3960,3870,7830,16
MASAKA,2020,4030,3890,7920,16
MASAKA,2021,4080,3900,7980,16
MASAKA,2022,4120,3910,8030,16
MASAKA,2023,4170,3920,8090,16
MASAKA,2024,4220,3940,8160,16
MASAKA,2025,4270,3970,8240,16
MASINDI,2015,3420,3460,6880,16
MASINDI,2016,3520,3550,7070,16
MASINDI,2017,3630,3650,7280,16
MASINDI,2018,3730,3740,7470,16
MASINDI,2019,3830,3840,7670,16
MASINDI,2020,3940,3930,7870,16
MASINDI,2021,4050,4030,8080,16
MASINDI,2022,4150,4130,8280,16
MASINDI,2023,4260,4230,8490,16
MASINDI,2024,4360,4320,8680,16
MASINDI,2025,4470,4420,8890,16
MAYUGE,2015,6180,5790,11970,16
MAYUGE,2016,6510,6040,12550,16
MAYUGE,2017,6840,6280,13120,16
MAYUGE,2018,7110,6480,13590,16
MAYUGE,2019,7340,6620,13960,16
MAYUGE,2020,7520,6730,14250,16
MAYUGE,2021,7680,6810,14490,16
MAYUGE,2022,7840,6890,14730,16
MAYUGE,2023,8000,6990,14990,16
MAYUGE,2024,8170,7090,15260,16
MAYUGE,2025,8340,7200,15540,16
MBALE,2015,5890,6920,12810,16
MBALE,2016,6200,7230,13430,16
MBALE,2017,6490,7520,14010,16
MBALE,2018,6760,7790,14550,16
MBALE,2019,6970,7980,14950,16
MBALE,2020,7130,8130,15260,16
MBALE,2021,7280,8250,15530,16
MBALE,2022,7420,8370,15790,16
MBALE,2023,7560,8500,16060,16
MBALE,2024,7710,8660,16370,16
MBALE,2025,7860,8800,16660,16
MBARARA,2015,3790,4260,8050,16
MBARARA,2016,3880,4350,8230,16
MBARARA,2017,3970,4440,8410,16
MBARARA,2018,4060,4530,8590,16
MBARARA,2019,4150,4630,8780,16
MBARARA,2020,4240,4720,8960,16
MBARARA,2021,4330,4820,9150,16
MBARARA,2022,4410,4910,9320,16
MBARARA,2023,4500,5000,9500,16
MBARARA,2024,4580,5080,9660,16
MBARARA,2025,4660,5170,9830,16
MITOOMA,2015,2380,2470,4850,16
MITOOMA,2016,2410,2490,4900,16
MITOOMA,2017,2440,2520,4960,16
MITOOMA,2018,2470,2540,5010,16
MITOOMA,2019,2500,2560,5060,16
MITOOMA,2020,2520,2580,5100,16
MITOOMA,2021,2550,2600,5150,16
MITOOMA,2022,2570,2610,5180,16
MITOOMA,2023,2590,2630,5220,16
MITOOMA,2024,2610,2640,5250,16
MITOOMA,2025,2630,2660,5290,16
MITYANA,2015,4190,3990,8180,16
MITYANA,2016,4350,4110,8460,16
MITYANA,2017,4510,4210,8720,16
MITYANA,2018,4630,4270,8900,16
MITYANA,2019,4710,4300,9010,16
MITYANA,2020,4780,4310,9090,16
MITYANA,2021,4810,4300,9110,16
MITYANA,2022,4850,4290,9140,16
MITYANA,2023,4880,4290,9170,16
MITYANA,2024,4920,4290,9210,16
MITYANA,2025,4960,4290,9250,16
MOROTO,2015,1120,1290,2410,16
MOROTO,2016,1170,1340,2510,16
MOROTO,2017,1210,1380,2590,16
MOROTO,2018,1250,1420,2670,16
MOROTO,2019,1280,1440,2720,16
MOROTO,2020,1310,1460,2770,16
MOROTO,2021,1330,1470,2800,16
MOROTO,2022,1330,1480,2810,16
MOROTO,2023,1350,1490,2840,16
MOROTO,2024,1370,1500,2870,16
MOROTO,2025,1380,1510,2890,16
MOYO,2015,1330,1290,2620,16
MOYO,2016,1360,1320,2680,16
MOYO,2017,1400,1340,2740,16
MOYO,2018,1430,1370,2800,16
MOYO,2019,1470,1400,2870,16
MOYO,2020,1510,1430,2940,16
MOYO,2021,1540,1460,3000,16
MOYO,2022,1580,1490,3070,16
MOYO,2023,1610,1510,3120,16
MOYO,2024,1650,1540,3190,16
MOYO,2025,1670,1570,3240,16
MPIGI,2015,3120,2940,6060,16
MPIGI,2016,3260,3050,6310,16
MPIGI,2017,3400,3140,6540,16
MPIGI,2018,3510,3210,6720,16
MPIGI,2019,3600,3260,6860,16
MPIGI,2020,3660,3290,6950,16
MPIGI,2021,3720,3300,7020,16
MPIGI,2022,3760,3320,7080,16
MPIGI,2023,3810,3340,7150,16
MPIGI,2024,3860,3370,7230,16
MPIGI,2025,3920,3390,7310,16
MUBENDE,2015,4700,4610,9310,16
MUBENDE,2016,5060,4910,9970,16
MUBENDE,2017,5410,5210,10620,16
MUBENDE,2018,5760,5470,11230,16
MUBENDE,2019,6070,5710,11780,16
MUBENDE,2020,6340,5910,12250,16
MUBENDE,2021,6620,6110,12730,16
MUBENDE,2022,6890,6310,13200,16
MUBENDE,2023,7180,6520,13700,16
MUBENDE,2024,7480,6750,14230,16
MUBENDE,2025,7800,7000,14800,16
MUKONO,2015,7070,7850,14920,16
MUKONO,2016,7420,8180,15600,16
MUKONO,2017,7750,8480,16230,16
MUKONO,2018,8030,8740,16770,16
MUKONO,2019,8250,8920,17170,16
MUKONO,2020,8430,9050,17480,16
MUKONO,2021,8570,9150,17720,16
MUKONO,2022,8700,9250,17950,16
MUKONO,2023,8840,9370,18210,16
MUKONO,2024,9000,9500,18500,16
MUKONO,2025,9150,9630,18780,16
MADI OKOLLO,2015,1890,1740,3630,16
MADI OKOLLO,2016,1940,1790,3730,16
MADI OKOLLO,2017,2000,1830,3830,16
MADI OKOLLO,2018,2060,1890,3950,16
MADI OKOLLO,2019,2110,1930,4040,16
MADI OKOLLO,2020,2170,1980,4150,16
MADI OKOLLO,2021,2230,2030,4260,16
MADI OKOLLO,2022,2290,2090,4380,16
MADI OKOLLO,2023,2350,2130,4480,16
MADI OKOLLO,2024,2400,2180,4580,16
MADI OKOLLO,2025,2460,2230,4690,16
NABILATUK,2015,1000,1140,2140,16
NABILATUK,2016,1080,1200,2280,16
NABILATUK,2017,1140,1270,2410,16
NABILATUK,2018,1210,1320,2530,16
NABILATUK,2019,1270,1370,2640,16
NABILATUK,2020,1340,1410,2750,16
NABILATUK,2021,1390,1450,2840,16
NABILATUK,2022,1440,1490,2930,16
NABILATUK,2023,1500,1530,3030,16
NABILATUK,2024,1570,1580,3150,16
NABILATUK,2025,1620,1620,3240,16
NAKAPIRIPIRIT,2015,1220,1260,2480,16
NAKAPIRIPIRIT,2016,1300,1340,2640,16
NAKAPIRIPIRIT,2017,1380,1410,2790,16
NAKAPIRIPIRIT,2018,1460,1470,2930,16
NAKAPIRIPIRIT,2019,1530,1520,3050,16
NAKAPIRIPIRIT,2020,1580,1570,3150,16
NAKAPIRIPIRIT,2021,1630,1600,3230,16
NAKAPIRIPIRIT,2022,1690,1640,3330,16
NAKAPIRIPIRIT,2023,1740,1690,3430,16
NAKAPIRIPIRIT,2024,1800,1730,3530,16
NAKAPIRIPIRIT,2025,1870,1780,3650,16
NAKASEKE,2015,2570,2280,4850,16
NAKASEKE,2016,2670,2330,5000,16
NAKASEKE,2017,2760,2390,5150,16
NAKASEKE,2018,2870,2440,5310,16
NAKASEKE,2019,2970,2500,5470,16
NAKASEKE,2020,3070,2550,5620,16
NAKASEKE,2021,3180,2610,5790,16
NAKASEKE,2022,3280,2670,5950,16
NAKASEKE,2023,3390,2720,6110,16
NAKASEKE,2024,3500,2780,6280,16
NAKASEKE,2025,3610,2830,6440,16
NAKASONGOLA,2015,2240,2290,4530,16
NAKASONGOLA,2016,2370,2390,4760,16
NAKASONGOLA,2017,2490,2470,4960,16
NAKASONGOLA,2018,2590,2540,5130,16
NAKASONGOLA,2019,2670,2580,5250,16
NAKASONGOLA,2020,2730,2620,5350,16
NAKASONGOLA,2021,2790,2650,5440,16
NAKASONGOLA,2022,2850,2660,5510,16
NAKASONGOLA,2023,2910,2690,5600,16
NAKASONGOLA,2024,2980,2720,5700,16
NAKASONGOLA,2025,3040,2750,5790,16
NAMAYINGO,2015,2560,2430,4990,16
NAMAYINGO,2016,2660,2490,5150,16
NAMAYINGO,2017,2760,2550,5310,16
NAMAYINGO,2018,2840,2590,5430,16
NAMAYINGO,2019,2890,2600,5490,16
NAMAYINGO,2020,2930,2610,5540,16
NAMAYINGO,2021,2950,2600,5550,16
NAMAYINGO,2022,2970,2590,5560,16
NAMAYINGO,2023,3000,2580,5580,16
NAMAYINGO,2024,3020,2580,5600,16
NAMAYINGO,2025,3050,2580,5630,16
NAMISINDWA,2015,2510,2470,4980,16
NAMISINDWA,2016,2580,2530,5110,16
NAMISINDWA,2017,2650,2590,5240,16
NAMISINDWA,2018,2720,2650,5370,16
NAMISINDWA,2019,2800,2710,5510,16
NAMISINDWA,2020,2870,2770,5640,16
NAMISINDWA,2021,2940,2830,5770,16
NAMISINDWA,2022,3020,2890,5910,16
NAMISINDWA,2023,3090,2950,6040,16
NAMISINDWA,2024,3160,3010,6170,16
NAMISINDWA,2025,3240,3060,6300,16
NAMUTUMBA,2015,3280,3060,6340,16
NAMUTUMBA,2016,3470,3190,6660,16
NAMUTUMBA,2017,3650,3330,6980,16
NAMUTUMBA,2018,3810,3440,7250,16
NAMUTUMBA,2019,3950,3520,7470,16
NAMUTUMBA,2020,4070,3580,7650,16
NAMUTUMBA,2021,4170,3640,7810,16
NAMUTUMBA,2022,4270,3690,7960,16
NAMUTUMBA,2023,4370,3740,8110,16
NAMUTUMBA,2024,4480,3800,8280,16
NAMUTUMBA,2025,4590,3870,8460,16
NAPAK,2015,1740,1960,3700,16
NAPAK,2016,1810,2020,3830,16
NAPAK,2017,1870,2080,3950,16
NAPAK,2018,1920,2120,4040,16
NAPAK,2019,1950,2160,4110,16
NAPAK,2020,1970,2170,4140,16
NAPAK,2021,1980,2170,4150,16
NAPAK,2022,1990,2180,4170,16
NAPAK,2023,2010,2190,4200,16
NAPAK,2024,2020,2200,4220,16
NAPAK,2025,2030,2210,4240,16
NEBBI,2015,3100,3040,6140,16
NEBBI,2016,3200,3130,6330,16
NEBBI,2017,3310,3210,6520,16
NEBBI,2018,3410,3310,6720,16
NEBBI,2019,3520,3400,6920,16
NEBBI,2020,3620,3490,7110,16
NEBBI,2021,3730,3580,7310,16
NEBBI,2022,3830,3670,7500,16
NEBBI,2023,3940,3760,7700,16
NEBBI,2024,4050,3850,7900,16
NEBBI,2025,4160,3940,8100,16
NGORA,2015,1890,1930,3820,16
NGORA,2016,1980,2000,3980,16
NGORA,2017,2070,2070,4140,16
NGORA,2018,2150,2120,4270,16
NGORA,2019,2210,2170,4380,16
NGORA,2020,2270,2190,4460,16
NGORA,2021,2310,2200,4510,16
NGORA,2022,2350,2230,4580,16
NGORA,2023,2390,2240,4630,16
NGORA,2024,2430,2260,4690,16
NGORA,2025,2480,2300,4780,16
NTOROKO,2015,860,870,1730,16
NTOROKO,2016,900,900,1800,16
NTOROKO,2017,930,930,1860,16
NTOROKO,2018,970,950,1920,16
NTOROKO,2019,990,950,1940,16
NTOROKO,2020,1020,960,1980,16
NTOROKO,2021,1030,970,2000,16
NTOROKO,2022,1040,960,2000,16
NTOROKO,2023,1060,970,2030,16
NTOROKO,2024,1070,960,2030,16
NTOROKO,2025,1080,970,2050,16
NTUNGAMO,2015,6010,6300,12310,16
NTUNGAMO,2016,6140,6420,12560,16
NTUNGAMO,2017,6270,6540,12810,16
NTUNGAMO,2018,6410,6660,13070,16
NTUNGAMO,2019,6540,6780,13320,16
NTUNGAMO,2020,6670,6890,13560,16
NTUNGAMO,2021,6800,7000,13800,16
NTUNGAMO,2022,6920,7120,14040,16
NTUNGAMO,2023,7050,7220,14270,16
NTUNGAMO,2024,7170,7330,14500,16
NTUNGAMO,2025,7280,7430,14710,16
NWOYA,2015,1830,1620,3450,16
NWOYA,2016,2020,1790,3810,16
NWOYA,2017,2230,1970,4200,16
NWOYA,2018,2470,2170,4640,16
NWOYA,2019,2720,2390,5110,16
NWOYA,2020,3000,2620,5620,16
NWOYA,2021,3310,2890,6200,16
NWOYA,2022,3640,3170,6810,16
NWOYA,2023,4010,3480,7490,16
NWOYA,2024,4410,3830,8240,16
NWOYA,2025,4850,4200,9050,16
OBONGI,2015,630,560,1190,16
OBONGI,2016,660,580,1240,16
OBONGI,2017,690,590,1280,16
OBONGI,2018,720,600,1320,16
OBONGI,2019,730,620,1350,16
OBONGI,2020,740,620,1360,16
OBONGI,2021,760,620,1380,16
OBONGI,2022,760,620,1380,16
OBONGI,2023,770,630,1400,16
OBONGI,2024,780,630,1410,16
OBONGI,2025,790,630,1420,16
OMORO,2015,2430,2050,4480,16
OMORO,2016,2560,2150,4710,16
OMORO,2017,2700,2240,4940,16
OMORO,2018,2820,2320,5140,16
OMORO,2019,2920,2380,5300,16
OMORO,2020,3010,2420,5430,16
OMORO,2021,3090,2470,5560,16
OMORO,2022,3160,2510,5670,16
OMORO,2023,3240,2550,5790,16
OMORO,2024,3320,2600,5920,16
OMORO,2025,3400,2650,6050,16
OTUKE,2015,1480,1390,2870,16
OTUKE,2016,1550,1450,3000,16
OTUKE,2017,1620,1510,3130,16
OTUKE,2018,1690,1580,3270,16
OTUKE,2019,1770,1640,3410,16
OTUKE,2020,1850,1710,3560,16
OTUKE,2021,1920,1780,3700,16
OTUKE,2022,2010,1850,3860,16
OTUKE,2023,2090,1930,4020,16
OTUKE,2024,2170,2000,4170,16
OTUKE,2025,2260,2080,4340,16
OYAM,2015,5330,5280,10610,16
OYAM,2016,5490,5440,10930,16
OYAM,2017,5660,5590,11250,16
OYAM,2018,5830,5750,11580,16
OYAM,2019,6010,5920,11930,16
OYAM,2020,6180,6080,12260,16
OYAM,2021,6350,6250,12600,16
OYAM,2022,6530,6410,12940,16
OYAM,2023,6710,6580,13290,16
OYAM,2024,6880,6740,13620,16
OYAM,2025,7050,6910,13960,16
PADER,2015,2630,2440,5070,16
PADER,2016,2730,2520,5250,16
PADER,2017,2830,2590,5420,16
PADER,2018,2900,2640,5540,16
PADER,2019,2950,2670,5620,16
PADER,2020,2990,2680,5670,16
PADER,2021,3010,2680,5690,16
PADER,2022,3020,2680,5700,16
PADER,2023,3050,2690,5740,16
PADER,2024,3060,2700,5760,16
PADER,2025,3080,2710,5790,16
PAKWACH,2015,2050,1930,3980,16
PAKWACH,2016,2140,2000,4140,16
PAKWACH,2017,2230,2070,4300,16
PAKWACH,2018,2330,2140,4470,16
PAKWACH,2019,2420,2220,4640,16
PAKWACH,2020,2520,2300,4820,16
PAKWACH,2021,2620,2380,5000,16
PAKWACH,2022,2720,2460,5180,16
PAKWACH,2023,2820,2540,5360,16
PAKWACH,2024,2930,2620,5550,16
PAKWACH,2025,3030,2700,5730,16
PALLISA,2015,3890,3810,7700,16
PALLISA,2016,4140,4030,8170,16
PALLISA,2017,4410,4240,8650,16
PALLISA,2018,4650,4420,9070,16
PALLISA,2019,4860,4580,9440,16
PALLISA,2020,5050,4710,9760,16
PALLISA,2021,5220,4830,10050,16
PALLISA,2022,5390,4940,10330,16
PALLISA,2023,5570,5080,10650,16
PALLISA,2024,5770,5210,10980,16
PALLISA,2025,5970,5350,11320,16
RAKAI,2015,3220,3010,6230,16
RAKAI,2016,3370,3110,6480,16
RAKAI,2017,3520,3210,6730,16
RAKAI,2018,3640,3280,6920,16
RAKAI,2019,3730,3340,7070,16
RAKAI,2020,3810,3360,7170,16
RAKAI,2021,3870,3380,7250,16
RAKAI,2022,3920,3390,7310,16
RAKAI,2023,3980,3420,7400,16
RAKAI,2024,4040,3430,7470,16
RAKAI,2025,4100,3460,7560,16
RUBANDA,2015,2250,2570,4820,16
RUBANDA,2016,2280,2600,4880,16
RUBANDA,2017,2310,2620,4930,16
RUBANDA,2018,2340,2640,4980,16
RUBANDA,2019,2370,2660,5030,16
RUBANDA,2020,2400,2670,5070,16
RUBANDA,2021,2430,2690,5120,16
RUBANDA,2022,2450,2700,5150,16
RUBANDA,2023,2480,2720,5200,16
RUBANDA,2024,2500,2730,5230,16
RUBANDA,2025,2520,2740,5260,16
RUBIRIZI,2015,1590,1600,3190,16
RUBIRIZI,2016,1620,1640,3260,16
RUBIRIZI,2017,1650,1670,3320,16
RUBIRIZI,2018,1690,1700,3390,16
RUBIRIZI,2019,1720,1730,3450,16
RUBIRIZI,2020,1750,1760,3510,16
RUBIRIZI,2021,1780,1790,3570,16
RUBIRIZI,2022,1810,1820,3630,16
RUBIRIZI,2023,1840,1850,3690,16
RUBIRIZI,2024,1870,1870,3740,16
RUBIRIZI,2025,1900,1900,3800,16
RUKIGA,2015,1270,1270,2540,16
RUKIGA,2016,1280,1280,2560,16
RUKIGA,2017,1290,1290,2580,16
RUKIGA,2018,1310,1300,2610,16
RUKIGA,2019,1320,1310,2630,16
RUKIGA,2020,1330,1320,2650,16
RUKIGA,2021,1340,1320,2660,16
RUKIGA,2022,1350,1330,2680,16
RUKIGA,2023,1360,1330,2690,16
RUKIGA,2024,1370,1340,2710,16
RUKIGA,2025,1370,1340,2710,16
RUKUNGIRI,2015,3950,4220,8170,16
RUKUNGIRI,2016,4000,4260,8260,16
RUKUNGIRI,2017,4050,4310,8360,16
RUKUNGIRI,2018,4090,4340,8430,16
RUKUNGIRI,2019,4140,4380,8520,16
RUKUNGIRI,2020,4180,4420,8600,16
RUKUNGIRI,2021,4220,4450,8670,16
RUKUNGIRI,2022,4260,4480,8740,16
RUKUNGIRI,2023,4300,4510,8810,16
RUKUNGIRI,2024,4330,4540,8870,16
RUKUNGIRI,2025,4360,4560,8920,16
RWAMPARA,2015,1650,1590,3240,16
RWAMPARA,2016,1690,1620,3310,16
RWAMPARA,2017,1730,1660,3390,16
RWAMPARA,2018,1770,1690,3460,16
RWAMPARA,2019,1810,1730,3540,16
RWAMPARA,2020,1840,1760,3600,16
RWAMPARA,2021,1880,1790,3670,16
RWAMPARA,2022,1920,1830,3750,16
RWAMPARA,2023,1950,1860,3810,16
RWAMPARA,2024,1990,1900,3890,16
RWAMPARA,2025,2030,1930,3960,16
SERERE,2015,3870,3800,7670,16
SERERE,2016,4110,4000,8110,16
SERERE,2017,4360,4190,8550,16
SERERE,2018,4580,4350,8930,16
SERERE,2019,4760,4490,9250,16
SERERE,2020,4930,4600,9530,16
SERERE,2021,5080,4700,9780,16
SERERE,2022,5230,4800,10030,16
SERERE,2023,5390,4910,10300,16
SERERE,2024,5550,5020,10570,16
SERERE,2025,5710,5140,10850,16
SHEEMA,2015,2750,2830,5580,16
SHEEMA,2016,2780,2860,5640,16
SHEEMA,2017,2820,2890,5710,16
SHEEMA,2018,2850,2920,5770,16
SHEEMA,2019,2880,2950,5830,16
SHEEMA,2020,2910,2980,5890,16
SHEEMA,2021,2940,3000,5940,16
SHEEMA,2022,2970,3020,5990,16
SHEEMA,2023,2990,3050,6040,16
SHEEMA,2024,3020,3070,6090,16
SHEEMA,2025,3040,3080,6120,16
SIRONKO,2015,3550,3500,7050,16
SIRONKO,2016,3640,3570,7210,16
SIRONKO,2017,3730,3640,7370,16
SIRONKO,2018,3810,3710,7520,16
SIRONKO,2019,3900,3780,7680,16
SIRONKO,2020,3990,3850,7840,16
SIRONKO,2021,4070,3930,8000,16
SIRONKO,2022,4160,4000,8160,16
SIRONKO,2023,4240,4060,8300,16
SIRONKO,2024,4320,4130,8450,16
SIRONKO,2025,4400,4190,8590,16
SOROTI,2015,3860,4070,7930,16
SOROTI,2016,4080,4270,8350,16
SOROTI,2017,4300,4450,8750,16
SOROTI,2018,4500,4600,9100,16
SOROTI,2019,4660,4730,9390,16
SOROTI,2020,4810,4820,9630,16
SOROTI,2021,4930,4900,9830,16
SOROTI,2022,5060,4980,10040,16
SOROTI,2023,5180,5080,10260,16
SOROTI,2024,5310,5170,10480,16
SOROTI,2025,5450,5270,10720,16
SSEMBABULE,2015,3050,2790,5840,16
SSEMBABULE,2016,3200,2910,6110,16
SSEMBABULE,2017,3350,3010,6360,16
SSEMBABULE,2018,3480,3090,6570,16
SSEMBABULE,2019,3580,3150,6730,16
SSEMBABULE,2020,3660,3190,6850,16
SSEMBABULE,2021,3730,3220,6950,16
SSEMBABULE,2022,3800,3230,7030,16
SSEMBABULE,2023,3870,3270,7140,16
SSEMBABULE,2024,3940,3300,7240,16
SSEMBABULE,2025,4010,3340,7350,16
TORORO,2015,6740,6640,13380,16
TORORO,2016,6930,6810,13740,16
TORORO,2017,7110,6980,14090,16
TORORO,2018,7300,7150,14450,16
TORORO,2019,7480,7320,14800,16
TORORO,2020,7670,7490,15160,16
TORORO,2021,7860,7670,15530,16
TORORO,2022,8050,7840,15890,16
TORORO,2023,8230,8010,16240,16
TORORO,2024,8410,8180,16590,16
TORORO,2025,8590,8340,16930,16
WAKISO,2015,20520,27720,48240,16
WAKISO,2016,21890,29610,51500,16
WAKISO,2017,23360,31650,55010,16
WAKISO,2018,24910,33790,58700,16
WAKISO,2019,26560,36050,62610,16
WAKISO,2020,28290,38450,66740,16
WAKISO,2021,30110,41000,71110,16
WAKISO,2022,32040,43710,75750,16
WAKISO,2023,34080,46520,80600,16
WAKISO,2024,36200,49480,85680,16
WAKISO,2025,38420,52630,91050,16
YUMBE,2015,6070,6130,12200,16
YUMBE,2016,6520,6580,13100,16
YUMBE,2017,6970,7020,13990,16
YUMBE,2018,7390,7440,14830,16
YUMBE,2019,7780,7810,15590,16
YUMBE,2020,8120,8160,16280,16
YUMBE,2021,8460,8490,16950,16
YUMBE,2022,8800,8830,17630,16
YUMBE,2023,9150,9200,18350,16
YUMBE,2024,9520,9590,19110,16
YUMBE,2025,9910,10010,19920,16
ZOMBO,2015,2930,2760,5690,16
ZOMBO,2016,3020,2830,5850,16
ZOMBO,2017,3110,2910,6020,16
ZOMBO,2018,3210,2990,6200,16
ZOMBO,2019,3310,3070,6380,16
ZOMBO,2020,3400,3160,6560,16
ZOMBO,2021,3500,3240,6740,16
ZOMBO,2022,3600,3320,6920,16
ZOMBO,2023,3690,3400,7090,16
ZOMBO,2024,3790,3480,7270,16
ZOMBO,2025,3890,3560,7450,16
ABIM,2015,1190,1150,2340,17
ABIM,2016,1290,1240,2530,17
ABIM,2017,1400,1330,2730,17
ABIM,2018,1520,1420,2940,17
ABIM,2019,1630,1510,3140,17
ABIM,2020,1740,1590,3330,17
ABIM,2021,1840,1670,3510,17
ABIM,2022,1940,1730,3670,17
ABIM,2023,2030,1800,3830,17
ABIM,2024,2140,1880,4020,17
ABIM,2025,2250,1960,4210,17
ADJUMANI,2015,2600,2330,4930,17
ADJUMANI,2016,2620,2360,4980,17
ADJUMANI,2017,2640,2380,5020,17
ADJUMANI,2018,2660,2400,5060,17
ADJUMANI,2019,2680,2420,5100,17
ADJUMANI,2020,2690,2440,5130,17
ADJUMANI,2021,2710,2460,5170,17
ADJUMANI,2022,2720,2480,5200,17
ADJUMANI,2023,2730,2490,5220,17
ADJUMANI,2024,2740,2510,5250,17
ADJUMANI,2025,2740,2520,5260,17
AGAGO,2015,2420,2310,4730,17
AGAGO,2016,2470,2350,4820,17
AGAGO,2017,2510,2390,4900,17
AGAGO,2018,2550,2430,4980,17
AGAGO,2019,2600,2480,5080,17
AGAGO,2020,2640,2510,5150,17
AGAGO,2021,2680,2550,5230,17
AGAGO,2022,2720,2590,5310,17
AGAGO,2023,2760,2630,5390,17
AGAGO,2024,2790,2660,5450,17
AGAGO,2025,2830,2700,5530,17
ALEBTONG,2015,2880,2690,5570,17
ALEBTONG,2016,3020,2780,5800,17
ALEBTONG,2017,3170,2900,6070,17
ALEBTONG,2018,3320,3000,6320,17
ALEBTONG,2019,3440,3080,6520,17
ALEBTONG,2020,3540,3140,6680,17
ALEBTONG,2021,3610,3170,6780,17
ALEBTONG,2022,3670,3200,6870,17
ALEBTONG,2023,3740,3220,6960,17
ALEBTONG,2024,3800,3250,7050,17
ALEBTONG,2025,3860,3290,7150,17
AMOLATAR,2015,1750,1830,3580,17
AMOLATAR,2016,1840,1890,3730,17
AMOLATAR,2017,1920,1970,3890,17
AMOLATAR,2018,2010,2030,4040,17
AMOLATAR,2019,2080,2080,4160,17
AMOLATAR,2020,2130,2110,4240,17
AMOLATAR,2021,2180,2120,4300,17
AMOLATAR,2022,2220,2150,4370,17
AMOLATAR,2023,2240,2160,4400,17
AMOLATAR,2024,2280,2170,4450,17
AMOLATAR,2025,2310,2190,4500,17
AMUDAT,2015,1120,850,1970,17
AMUDAT,2016,1190,900,2090,17
AMUDAT,2017,1260,960,2220,17
AMUDAT,2018,1340,1010,2350,17
AMUDAT,2019,1410,1060,2470,17
AMUDAT,2020,1450,1090,2540,17
AMUDAT,2021,1500,1120,2620,17
AMUDAT,2022,1540,1160,2700,17
AMUDAT,2023,1590,1190,2780,17
AMUDAT,2024,1630,1220,2850,17
AMUDAT,2025,1680,1260,2940,17
AMURIA,2015,2400,2350,4750,17
AMURIA,2016,2550,2470,5020,17
AMURIA,2017,2700,2590,5290,17
AMURIA,2018,2840,2700,5540,17
AMURIA,2019,2980,2790,5770,17
AMURIA,2020,3090,2860,5950,17
AMURIA,2021,3180,2920,6100,17
AMURIA,2022,3270,2960,6230,17
AMURIA,2023,3350,3010,6360,17
AMURIA,2024,3430,3070,6500,17
AMURIA,2025,3530,3120,6650,17
AMURU,2015,1890,1860,3750,17
AMURU,2016,1980,1930,3910,17
AMURU,2017,2080,2000,4080,17
AMURU,2018,2170,2060,4230,17
AMURU,2019,2230,2120,4350,17
AMURU,2020,2300,2160,4460,17
AMURU,2021,2350,2190,4540,17
AMURU,2022,2380,2200,4580,17
AMURU,2023,2410,2220,4630,17
AMURU,2024,2440,2240,4680,17
AMURU,2025,2480,2260,4740,17
APAC,2015,2220,2200,4420,17
APAC,2016,2300,2280,4580,17
APAC,2017,2380,2360,4740,17
APAC,2018,2470,2440,4910,17
APAC,2019,2560,2520,5080,17
APAC,2020,2650,2610,5260,17
APAC,2021,2740,2690,5430,17
APAC,2022,2830,2780,5610,17
APAC,2023,2930,2860,5790,17
APAC,2024,3020,2950,5970,17
APAC,2025,3120,3040,6160,17
ARUA,2015,7340,7890,15230,17
ARUA,2016,7560,8100,15660,17
ARUA,2017,7770,8330,16100,17
ARUA,2018,8000,8550,16550,17
ARUA,2019,8220,8780,17000,17
ARUA,2020,8440,9000,17440,17
ARUA,2021,8680,9220,17900,17
ARUA,2022,8900,9450,18350,17
ARUA,2023,9120,9680,18800,17
ARUA,2024,9350,9900,19250,17
ARUA,2025,9570,10120,19690,17
BUDAKA,2015,2580,2480,5060,17
BUDAKA,2016,2730,2600,5330,17
BUDAKA,2017,2900,2720,5620,17
BUDAKA,2018,3050,2830,5880,17
BUDAKA,2019,3190,2930,6120,17
BUDAKA,2020,3300,3000,6300,17
BUDAKA,2021,3400,3060,6460,17
BUDAKA,2022,3480,3100,6580,17
BUDAKA,2023,3570,3150,6720,17
BUDAKA,2024,3650,3200,6850,17
BUDAKA,2025,3740,3260,7000,17
BUDUDA,2015,2470,2580,5050,17
BUDUDA,2016,2640,2730,5370,17
BUDUDA,2017,2820,2890,5710,17
BUDUDA,2018,3000,3040,6040,17
BUDUDA,2019,3160,3170,6330,17
BUDUDA,2020,3310,3290,6600,17
BUDUDA,2021,3440,3380,6820,17
BUDUDA,2022,3560,3470,7030,17
BUDUDA,2023,3670,3550,7220,17
BUDUDA,2024,3800,3650,7450,17
BUDUDA,2025,3930,3760,7690,17
BUGIRI,2015,4640,4370,9010,17
BUGIRI,2016,4930,4600,9530,17
BUGIRI,2017,5240,4840,10080,17
BUGIRI,2018,5550,5060,10610,17
BUGIRI,2019,5830,5260,11090,17
BUGIRI,2020,6070,5420,11490,17
BUGIRI,2021,6270,5550,11820,17
BUGIRI,2022,6470,5650,12120,17
BUGIRI,2023,6650,5770,12420,17
BUGIRI,2024,6860,5890,12750,17
BUGIRI,2025,7060,6020,13080,17
BUGWERI,2015,1960,1900,3860,17
BUGWERI,2016,2060,1980,4040,17
BUGWERI,2017,2160,2050,4210,17
BUGWERI,2018,2260,2120,4380,17
BUGWERI,2019,2340,2180,4520,17
BUGWERI,2020,2410,2210,4620,17
BUGWERI,2021,2450,2230,4680,17
BUGWERI,2022,2490,2250,4740,17
BUGWERI,2023,2530,2260,4790,17
BUGWERI,2024,2560,2280,4840,17
BUGWERI,2025,2610,2310,4920,17
BUHWEJU,2015,1240,1210,2450,17
BUHWEJU,2016,1280,1250,2530,17
BUHWEJU,2017,1320,1280,2600,17
BUHWEJU,2018,1360,1320,2680,17
BUHWEJU,2019,1400,1360,2760,17
BUHWEJU,2020,1450,1400,2850,17
BUHWEJU,2021,1490,1440,2930,17
BUHWEJU,2022,1540,1480,3020,17
BUHWEJU,2023,1580,1520,3100,17
BUHWEJU,2024,1620,1560,3180,17
BUHWEJU,2025,1670,1600,3270,17
BUIKWE,2015,5310,5320,10630,17
BUIKWE,2016,5540,5490,11030,17
BUIKWE,2017,5770,5670,11440,17
BUIKWE,2018,5980,5830,11810,17
BUIKWE,2019,6160,5950,12110,17
BUIKWE,2020,6290,6020,12310,17
BUIKWE,2021,6360,6050,12410,17
BUIKWE,2022,6420,6060,12480,17
BUIKWE,2023,6480,6070,12550,17
BUIKWE,2024,6540,6090,12630,17
BUIKWE,2025,6610,6120,12730,17
BUKEDEA,2015,2290,2180,4470,17
BUKEDEA,2016,2450,2300,4750,17
BUKEDEA,2017,2620,2420,5040,17
BUKEDEA,2018,2780,2540,5320,17
BUKEDEA,2019,2930,2650,5580,17
BUKEDEA,2020,3050,2730,5780,17
BUKEDEA,2021,3170,2800,5970,17
BUKEDEA,2022,3280,2860,6140,17
BUKEDEA,2023,3380,2930,6310,17
BUKEDEA,2024,3490,2990,6480,17
BUKEDEA,2025,3610,3060,6670,17
BUKOMANSIMBI,2015,1780,1520,3300,17
BUKOMANSIMBI,2016,1830,1540,3370,17
BUKOMANSIMBI,2017,1890,1560,3450,17
BUKOMANSIMBI,2018,1930,1590,3520,17
BUKOMANSIMBI,2019,1960,1590,3550,17
BUKOMANSIMBI,2020,1990,1590,3580,17
BUKOMANSIMBI,2021,1990,1570,3560,17
BUKOMANSIMBI,2022,1980,1550,3530,17
BUKOMANSIMBI,2023,1970,1520,3490,17
BUKOMANSIMBI,2024,1960,1500,3460,17
BUKOMANSIMBI,2025,1960,1490,3450,17
BUKWO,2015,990,980,1970,17
BUKWO,2016,1040,1030,2070,17
BUKWO,2017,1100,1080,2180,17
BUKWO,2018,1160,1130,2290,17
BUKWO,2019,1210,1190,2400,17
BUKWO,2020,1280,1240,2520,17
BUKWO,2021,1340,1300,2640,17
BUKWO,2022,1410,1360,2770,17
BUKWO,2023,1480,1420,2900,17
BUKWO,2024,1550,1480,3030,17
BUKWO,2025,1630,1550,3180,17
BULAMBULI,2015,2020,2100,4120,17
BULAMBULI,2016,2170,2230,4400,17
BULAMBULI,2017,2320,2370,4690,17
BULAMBULI,2018,2470,2510,4980,17
BULAMBULI,2019,2620,2620,5240,17
BULAMBULI,2020,2760,2730,5490,17
BULAMBULI,2021,2870,2820,5690,17
BULAMBULI,2022,2980,2910,5890,17
BULAMBULI,2023,3090,2990,6080,17
BULAMBULI,2024,3200,3090,6290,17
BULAMBULI,2025,3320,3190,6510,17
BULIISA,2015,1130,1190,2320,17
BULIISA,2016,1190,1250,2440,17
BULIISA,2017,1260,1300,2560,17
BULIISA,2018,1330,1360,2690,17
BULIISA,2019,1400,1420,2820,17
BULIISA,2020,1470,1480,2950,17
BULIISA,2021,1550,1540,3090,17
BULIISA,2022,1620,1600,3220,17
BULIISA,2023,1710,1670,3380,17
BULIISA,2024,1790,1740,3530,17
BULIISA,2025,1880,1810,3690,17
BUNDIBUGYO,2015,2470,2780,5250,17
BUNDIBUGYO,2016,2610,2890,5500,17
BUNDIBUGYO,2017,2740,3010,5750,17
BUNDIBUGYO,2018,2880,3110,5990,17
BUNDIBUGYO,2019,2980,3200,6180,17
BUNDIBUGYO,2020,3070,3260,6330,17
BUNDIBUGYO,2021,3150,3290,6440,17
BUNDIBUGYO,2022,3200,3330,6530,17
BUNDIBUGYO,2023,3260,3350,6610,17
BUNDIBUGYO,2024,3320,3380,6700,17
BUNDIBUGYO,2025,3380,3430,6810,17
BUNYANGABU,2015,2070,2120,4190,17
BUNYANGABU,2016,2170,2190,4360,17
BUNYANGABU,2017,2270,2270,4540,17
BUNYANGABU,2018,2370,2330,4700,17
BUNYANGABU,2019,2450,2390,4840,17
BUNYANGABU,2020,2520,2420,4940,17
BUNYANGABU,2021,2560,2440,5000,17
BUNYANGABU,2022,2600,2450,5050,17
BUNYANGABU,2023,2640,2450,5090,17
BUNYANGABU,2024,2670,2470,5140,17
BUNYANGABU,2025,2710,2490,5200,17
BUSHENYI,2015,2880,3120,6000,17
BUSHENYI,2016,2920,3150,6070,17
BUSHENYI,2017,2960,3180,6140,17
BUSHENYI,2018,2990,3210,6200,17
BUSHENYI,2019,3030,3230,6260,17
BUSHENYI,2020,3060,3250,6310,17
BUSHENYI,2021,3090,3280,6370,17
BUSHENYI,2022,3120,3300,6420,17
BUSHENYI,2023,3150,3320,6470,17
BUSHENYI,2024,3170,3330,6500,17
BUSHENYI,2025,3190,3350,6540,17
BUSIA,2015,4110,4220,8330,17
BUSIA,2016,4320,4390,8710,17
BUSIA,2017,4560,4570,9130,17
BUSIA,2018,4790,4740,9530,17
BUSIA,2019,4980,4880,9860,17
BUSIA,2020,5130,4980,10110,17
BUSIA,2021,5260,5040,10300,17
BUSIA,2022,5370,5100,10470,17
BUSIA,2023,5480,5150,10630,17
BUSIA,2024,5580,5210,10790,17
BUSIA,2025,5700,5270,10970,17
BUTALEJA,2015,2760,2770,5530,17
BUTALEJA,2016,2930,2900,5830,17
BUTALEJA,2017,3100,3040,6140,17
BUTALEJA,2018,3270,3170,6440,17
BUTALEJA,2019,3430,3290,6720,17
BUTALEJA,2020,3550,3380,6930,17
BUTALEJA,2021,3660,3440,7100,17
BUTALEJA,2022,3760,3500,7260,17
BUTALEJA,2023,3850,3560,7410,17
BUTALEJA,2024,3950,3620,7570,17
BUTALEJA,2025,4060,3690,7750,17
BUTAMBALA,2015,1230,1200,2430,17
BUTAMBALA,2016,1280,1230,2510,17
BUTAMBALA,2017,1330,1260,2590,17
BUTAMBALA,2018,1360,1280,2640,17
BUTAMBALA,2019,1400,1290,2690,17
BUTAMBALA,2020,1410,1290,2700,17
BUTAMBALA,2021,1420,1290,2710,17
BUTAMBALA,2022,1420,1280,2700,17
BUTAMBALA,2023,1430,1270,2700,17
BUTAMBALA,2024,1430,1260,2690,17
BUTAMBALA,2025,1430,1250,2680,17
BUTEBO,2015,1290,1300,2590,17
BUTEBO,2016,1340,1340,2680,17
BUTEBO,2017,1390,1370,2760,17
BUTEBO,2018,1440,1400,2840,17
BUTEBO,2019,1470,1410,2880,17
BUTEBO,2020,1500,1420,2920,17
BUTEBO,2021,1510,1420,2930,17
BUTEBO,2022,1510,1420,2930,17
BUTEBO,2023,1520,1410,2930,17
BUTEBO,2024,1530,1400,2930,17
BUTEBO,2025,1530,1390,2920,17
BUVUMA,2015,750,630,1380,17
BUVUMA,2016,800,680,1480,17
BUVUMA,2017,850,720,1570,17
BUVUMA,2018,900,770,1670,17
BUVUMA,2019,950,820,1770,17
BUVUMA,2020,1010,880,1890,17
BUVUMA,2021,1070,930,2000,17
BUVUMA,2022,1130,990,2120,17
BUVUMA,2023,1200,1060,2260,17
BUVUMA,2024,1270,1120,2390,17
BUVUMA,2025,1340,1190,2530,17
BUYENDE,2015,3340,3170,6510,17
BUYENDE,2016,3580,3350,6930,17
BUYENDE,2017,3820,3540,7360,17
BUYENDE,2018,4050,3710,7760,17
BUYENDE,2019,4260,3870,8130,17
BUYENDE,2020,4460,4010,8470,17
BUYENDE,2021,4630,4120,8750,17
BUYENDE,2022,4790,4220,9010,17
BUYENDE,2023,4950,4320,9270,17
BUYENDE,2024,5110,4430,9540,17
BUYENDE,2025,5280,4550,9830,17
DOKOLO,2015,2200,2160,4360,17
DOKOLO,2016,2270,2220,4490,17
DOKOLO,2017,2330,2280,4610,17
DOKOLO,2018,2400,2340,4740,17
DOKOLO,2019,2480,2410,4890,17
DOKOLO,2020,2550,2470,5020,17
DOKOLO,2021,2620,2530,5150,17
DOKOLO,2022,2690,2590,5280,17
DOKOLO,2023,2760,2660,5420,17
DOKOLO,2024,2840,2720,5560,17
DOKOLO,2025,2910,2780,5690,17
GOMBA,2015,1920,1580,3500,17
GOMBA,2016,1990,1620,3610,17
GOMBA,2017,2070,1660,3730,17
GOMBA,2018,2150,1690,3840,17
GOMBA,2019,2200,1710,3910,17
GOMBA,2020,2240,1720,3960,17
GOMBA,2021,2260,1710,3970,17
GOMBA,2022,2270,1700,3970,17
GOMBA,2023,2280,1690,3970,17
GOMBA,2024,2300,1680,3980,17
GOMBA,2025,2320,1670,3990,17
GULU,2015,3210,3390,6600,17
GULU,2016,3310,3500,6810,17
GULU,2017,3410,3600,7010,17
GULU,2018,3510,3700,7210,17
GULU,2019,3610,3800,7410,17
GULU,2020,3720,3910,7630,17
GULU,2021,3820,4020,7840,17
GULU,2022,3920,4120,8040,17
GULU,2023,4030,4230,8260,17
GULU,2024,4130,4340,8470,17
GULU,2025,4230,4440,8670,17
HOIMA,2015,3140,3550,6690,17
HOIMA,2016,3260,3680,6940,17
HOIMA,2017,3380,3800,7180,17
HOIMA,2018,3510,3930,7440,17
HOIMA,2019,3640,4070,7710,17
HOIMA,2020,3770,4200,7970,17
HOIMA,2021,3900,4340,8240,17
HOIMA,2022,4040,4480,8520,17
HOIMA,2023,4170,4620,8790,17
HOIMA,2024,4310,4760,9070,17
HOIMA,2025,4450,4900,9350,17
IBANDA,2015,2850,2870,5720,17
IBANDA,2016,2910,2920,5830,17
IBANDA,2017,2960,2980,5940,17
IBANDA,2018,3020,3030,6050,17
IBANDA,2019,3080,3080,6160,17
IBANDA,2020,3140,3130,6270,17
IBANDA,2021,3190,3180,6370,17
IBANDA,2022,3240,3230,6470,17
IBANDA,2023,3300,3280,6580,17
IBANDA,2024,3350,3330,6680,17
IBANDA,2025,3390,3370,6760,17
IGANGA,2015,4110,4480,8590,17
IGANGA,2016,4320,4670,8990,17
IGANGA,2017,4560,4860,9420,17
IGANGA,2018,4780,5040,9820,17
IGANGA,2019,4980,5180,10160,17
IGANGA,2020,5130,5290,10420,17
IGANGA,2021,5260,5360,10620,17
IGANGA,2022,5370,5410,10780,17
IGANGA,2023,5470,5460,10930,17
IGANGA,2024,5580,5530,11110,17
IGANGA,2025,5700,5590,11290,17
ISINGIRO,2015,4780,4760,9540,17
ISINGIRO,2016,4960,4930,9890,17
ISINGIRO,2017,5150,5100,10250,17
ISINGIRO,2018,5340,5280,10620,17
ISINGIRO,2019,5530,5460,10990,17
ISINGIRO,2020,5730,5640,11370,17
ISINGIRO,2021,5930,5830,11760,17
ISINGIRO,2022,6140,6020,12160,17
ISINGIRO,2023,6340,6210,12550,17
ISINGIRO,2024,6550,6400,12950,17
ISINGIRO,2025,6760,6600,13360,17
JINJA,2015,5450,5950,11400,17
JINJA,2016,5540,6040,11580,17
JINJA,2017,5640,6140,11780,17
JINJA,2018,5730,6230,11960,17
JINJA,2019,5820,6320,12140,17
JINJA,2020,5910,6410,12320,17
JINJA,2021,5990,6490,12480,17
JINJA,2022,6070,6570,12640,17
JINJA,2023,6150,6650,12800,17
JINJA,2024,6230,6730,12960,17
JINJA,2025,6300,6800,13100,17
KAABONG,2015,1160,1160,2320,17
KAABONG,2016,1190,1190,2380,17
KAABONG,2017,1230,1220,2450,17
KAABONG,2018,1260,1240,2500,17
KAABONG,2019,1290,1270,2560,17
KAABONG,2020,1320,1300,2620,17
KAABONG,2021,1360,1330,2690,17
KAABONG,2022,1390,1360,2750,17
KAABONG,2023,1430,1390,2820,17
KAABONG,2024,1460,1420,2880,17
KAABONG,2025,1490,1440,2930,17
KABALE,2015,2660,2840,5500,17
KABALE,2016,2700,2880,5580,17
KABALE,2017,2740,2910,5650,17
KABALE,2018,2780,2940,5720,17
KABALE,2019,2820,2980,5800,17
KABALE,2020,2860,3010,5870,17
KABALE,2021,2900,3040,5940,17
KABALE,2022,2940,3070,6010,17
KABALE,2023,2970,3090,6060,17
KABALE,2024,3010,3120,6130,17
KABALE,2025,3040,3140,6180,17
KABAROLE,2015,3410,3590,7000,17
KABAROLE,2016,3480,3670,7150,17
KABAROLE,2017,3560,3750,7310,17
KABAROLE,2018,3630,3830,7460,17
KABAROLE,2019,3710,3910,7620,17
KABAROLE,2020,3790,3990,7780,17
KABAROLE,2021,3860,4070,7930,17
KABAROLE,2022,3940,4150,8090,17
KABAROLE,2023,4010,4220,8230,17
KABAROLE,2024,4080,4300,8380,17
KABAROLE,2025,4150,4370,8520,17
KABERAMAIDO,2015,1320,1350,2670,17
KABERAMAIDO,2016,1400,1420,2820,17
KABERAMAIDO,2017,1480,1500,2980,17
KABERAMAIDO,2018,1570,1580,3150,17
KABERAMAIDO,2019,1670,1630,3300,17
KABERAMAIDO,2020,1740,1690,3430,17
KABERAMAIDO,2021,1790,1720,3510,17
KABERAMAIDO,2022,1850,1760,3610,17
KABERAMAIDO,2023,1910,1800,3710,17
KABERAMAIDO,2024,1970,1840,3810,17
KABERAMAIDO,2025,2020,1880,3900,17
KAGADI,2015,3840,3850,7690,17
KAGADI,2016,3980,3980,7960,17
KAGADI,2017,4130,4120,8250,17
KAGADI,2018,4280,4270,8550,17
KAGADI,2019,4440,4410,8850,17
KAGADI,2020,4590,4560,9150,17
KAGADI,2021,4750,4720,9470,17
KAGADI,2022,4920,4870,9790,17
KAGADI,2023,5080,5030,10110,17
KAGADI,2024,5240,5180,10420,17
KAGADI,2025,5410,5340,10750,17
KAKUMIRO,2015,3090,2920,6010,17
KAKUMIRO,2016,3360,3170,6530,17
KAKUMIRO,2017,3660,3430,7090,17
KAKUMIRO,2018,3980,3720,7700,17
KAKUMIRO,2019,4330,4030,8360,17
KAKUMIRO,2020,4700,4360,9060,17
KAKUMIRO,2021,5110,4720,9830,17
KAKUMIRO,2022,5540,5100,10640,17
KAKUMIRO,2023,6010,5520,11530,17
KAKUMIRO,2024,6510,5960,12470,17
KAKUMIRO,2025,7050,6430,13480,17
KALAKI,2015,1430,1280,2710,17
KALAKI,2016,1500,1330,2830,17
KALAKI,2017,1560,1380,2940,17
KALAKI,2018,1630,1430,3060,17
KALAKI,2019,1700,1490,3190,17
KALAKI,2020,1770,1550,3320,17
KALAKI,2021,1840,1610,3450,17
KALAKI,2022,1910,1660,3570,17
KALAKI,2023,1990,1730,3720,17
KALAKI,2024,2070,1790,3860,17
KALAKI,2025,2150,1850,4000,17
KALANGALA,2015,350,320,670,17
KALANGALA,2016,370,330,700,17
KALANGALA,2017,380,350,730,17
KALANGALA,2018,390,360,750,17
KALANGALA,2019,410,380,790,17
KALANGALA,2020,420,390,810,17
KALANGALA,2021,430,410,840,17
KALANGALA,2022,450,420,870,17
KALANGALA,2023,460,440,900,17
KALANGALA,2024,480,460,940,17
KALANGALA,2025,490,470,960,17
KALIRO,2015,2720,2540,5260,17
KALIRO,2016,2880,2650,5530,17
KALIRO,2017,3040,2790,5830,17
KALIRO,2018,3210,2900,6110,17
KALIRO,2019,3360,3000,6360,17
KALIRO,2020,3470,3080,6550,17
KALIRO,2021,3570,3140,6710,17
KALIRO,2022,3660,3190,6850,17
KALIRO,2023,3750,3240,6990,17
KALIRO,2024,3840,3300,7140,17
KALIRO,2025,3940,3360,7300,17
KALUNGU,2015,2190,2250,4440,17
KALUNGU,2016,2270,2300,4570,17
KALUNGU,2017,2330,2350,4680,17
KALUNGU,2018,2390,2390,4780,17
KALUNGU,2019,2450,2400,4850,17
KALUNGU,2020,2470,2410,4880,17
KALUNGU,2021,2480,2400,4880,17
KALUNGU,2022,2480,2370,4850,17
KALUNGU,2023,2480,2360,4840,17
KALUNGU,2024,2490,2340,4830,17
KALUNGU,2025,2480,2320,4800,17
KAMPALA,2015,14580,20760,35340,17
KAMPALA,2016,14870,21170,36040,17
KAMPALA,2017,15160,21580,36740,17
KAMPALA,2018,15450,21990,37440,17
KAMPALA,2019,15740,22400,38140,17
KAMPALA,2020,16030,22800,38830,17
KAMPALA,2021,16310,23190,39500,17
KAMPALA,2022,16590,23580,40170,17
KAMPALA,2023,16850,23960,40810,17
KAMPALA,2024,17110,24330,41440,17
KAMPALA,2025,17360,24690,42050,17
KAMULI,2015,6080,5650,11730,17
KAMULI,2016,6380,5850,12230,17
KAMULI,2017,6680,6060,12740,17
KAMULI,2018,6980,6250,13230,17
KAMULI,2019,7230,6390,13620,17
KAMULI,2020,7410,6480,13890,17
KAMULI,2021,7550,6530,14080,17
KAMULI,2022,7660,6560,14220,17
KAMULI,2023,7770,6580,14350,17
KAMULI,2024,7890,6610,14500,17
KAMULI,2025,8000,6650,14650,17
KAMWENGE,2015,2580,2510,5090,17
KAMWENGE,2016,2690,2600,5290,17
KAMWENGE,2017,2800,2690,5490,17
KAMWENGE,2018,2910,2790,5700,17
KAMWENGE,2019,3030,2880,5910,17
KAMWENGE,2020,3140,2980,6120,17
KAMWENGE,2021,3270,3080,6350,17
KAMWENGE,2022,3390,3180,6570,17
KAMWENGE,2023,3510,3290,6800,17
KAMWENGE,2024,3640,3390,7030,17
KAMWENGE,2025,3770,3490,7260,17
KANUNGU,2015,2930,2730,5660,17
KANUNGU,2016,2980,2770,5750,17
KANUNGU,2017,3030,2820,5850,17
KANUNGU,2018,3090,2860,5950,17
KANUNGU,2019,3140,2900,6040,17
KANUNGU,2020,3190,2950,6140,17
KANUNGU,2021,3240,2990,6230,17
KANUNGU,2022,3290,3030,6320,17
KANUNGU,2023,3340,3070,6410,17
KANUNGU,2024,3380,3110,6490,17
KANUNGU,2025,3430,3140,6570,17
KAPCHORWA,2015,1220,1290,2510,17
KAPCHORWA,2016,1260,1330,2590,17
KAPCHORWA,2017,1300,1370,2670,17
KAPCHORWA,2018,1340,1400,2740,17
KAPCHORWA,2019,1380,1440,2820,17
KAPCHORWA,2020,1410,1480,2890,17
KAPCHORWA,2021,1460,1520,2980,17
KAPCHORWA,2022,1500,1560,3060,17
KAPCHORWA,2023,1530,1600,3130,17
KAPCHORWA,2024,1580,1630,3210,17
KAPCHORWA,2025,1620,1670,3290,17
KAPELEBYONG,2015,1150,1060,2210,17
KAPELEBYONG,2016,1200,1110,2310,17
KAPELEBYONG,2017,1270,1160,2430,17
KAPELEBYONG,2018,1340,1190,2530,17
KAPELEBYONG,2019,1380,1220,2600,17
KAPELEBYONG,2020,1430,1250,2680,17
KAPELEBYONG,2021,1470,1260,2730,17
KAPELEBYONG,2022,1500,1280,2780,17
KAPELEBYONG,2023,1530,1290,2820,17
KAPELEBYONG,2024,1560,1300,2860,17
KAPELEBYONG,2025,1600,1310,2910,17
KASESE,2015,7940,8370,16310,17
KASESE,2016,8320,8660,16980,17
KASESE,2017,8700,8960,17660,17
KASESE,2018,9070,9220,18290,17
KASESE,2019,9380,9430,18810,17
KASESE,2020,9600,9560,19160,17
KASESE,2021,9770,9620,19390,17
KASESE,2022,9900,9660,19560,17
KASESE,2023,10030,9690,19720,17
KASESE,2024,10160,9730,19890,17
KASESE,2025,10300,9790,20090,17
KASSANDA,2015,3050,2580,5630,17
KASSANDA,2016,3140,2630,5770,17
KASSANDA,2017,3230,2690,5920,17
KASSANDA,2018,3320,2750,6070,17
KASSANDA,2019,3410,2800,6210,17
KASSANDA,2020,3510,2860,6370,17
KASSANDA,2021,3600,2920,6520,17
KASSANDA,2022,3690,2970,6660,17
KASSANDA,2023,3780,3020,6800,17
KASSANDA,2024,3870,3080,6950,17
KASSANDA,2025,3960,3130,7090,17
KATAKWI,2015,2040,1910,3950,17
KATAKWI,2016,2150,1990,4140,17
KATAKWI,2017,2260,2060,4320,17
KATAKWI,2018,2360,2130,4490,17
KATAKWI,2019,2450,2190,4640,17
KATAKWI,2020,2530,2220,4750,17
KATAKWI,2021,2580,2240,4820,17
KATAKWI,2022,2630,2260,4890,17
KATAKWI,2023,2680,2270,4950,17
KATAKWI,2024,2730,2290,5020,17
KATAKWI,2025,2780,2320,5100,17
KAYUNGA,2015,4570,4250,8820,17
KAYUNGA,2016,4770,4370,9140,17
KAYUNGA,2017,4970,4490,9460,17
KAYUNGA,2018,5150,4610,9760,17
KAYUNGA,2019,5300,4680,9980,17
KAYUNGA,2020,5400,4710,10110,17
KAYUNGA,2021,5470,4720,10190,17
KAYUNGA,2022,5520,4710,10230,17
KAYUNGA,2023,5560,4700,10260,17
KAYUNGA,2024,5600,4700,10300,17
KAYUNGA,2025,5650,4700,10350,17
KAZO,2015,1980,1850,3830,17
KAZO,2016,2060,1910,3970,17
KAZO,2017,2140,1980,4120,17
KAZO,2018,2220,2050,4270,17
KAZO,2019,2300,2120,4420,17
KAZO,2020,2380,2190,4570,17
KAZO,2021,2470,2260,4730,17
KAZO,2022,2550,2340,4890,17
KAZO,2023,2640,2410,5050,17
KAZO,2024,2730,2490,5220,17
KAZO,2025,2820,2570,5390,17
KIBAALE,2015,1480,1430,2910,17
KIBAALE,2016,1580,1520,3100,17
KIBAALE,2017,1680,1600,3280,17
KIBAALE,2018,1780,1700,3480,17
KIBAALE,2019,1900,1790,3690,17
KIBAALE,2020,2010,1890,3900,17
KIBAALE,2021,2140,2000,4140,17
KIBAALE,2022,2270,2110,4380,17
KIBAALE,2023,2400,2230,4630,17
KIBAALE,2024,2540,2350,4890,17
KIBAALE,2025,2690,2470,5160,17
KIBOGA,2015,1800,1600,3400,17
KIBOGA,2016,1900,1650,3550,17
KIBOGA,2017,1990,1720,3710,17
KIBOGA,2018,2080,1760,3840,17
KIBOGA,2019,2140,1810,3950,17
KIBOGA,2020,2200,1840,4040,17
KIBOGA,2021,2250,1850,4100,17
KIBOGA,2022,2280,1870,4150,17
KIBOGA,2023,2320,1880,4200,17
KIBOGA,2024,2360,1890,4250,17
KIBOGA,2025,2390,1900,4290,17
KIBUKU,2015,2380,2300,4680,17
KIBUKU,2016,2530,2410,4940,17
KIBUKU,2017,2680,2530,5210,17
KIBUKU,2018,2820,2640,5460,17
KIBUKU,2019,2960,2750,5710,17
KIBUKU,2020,3070,2830,5900,17
KIBUKU,2021,3170,2880,6050,17
KIBUKU,2022,3270,2930,6200,17
KIBUKU,2023,3350,2990,6340,17
KIBUKU,2024,3440,3050,6490,17
KIBUKU,2025,3530,3110,6640,17
KIKUUBE,2015,2720,2470,5190,17
KIKUUBE,2016,2870,2600,5470,17
KIKUUBE,2017,3020,2730,5750,17
KIKUUBE,2018,3180,2870,6050,17
KIKUUBE,2019,3350,3020,6370,17
KIKUUBE,2020,3520,3170,6690,17
KIKUUBE,2021,3700,3320,7020,17
KIKUUBE,2022,3890,3480,7370,17
KIKUUBE,2023,4080,3650,7730,17
KIKUUBE,2024,4280,3820,8100,17
KIKUUBE,2025,4490,3990,8480,17
KIRUHURA,2015,1630,1550,3180,17
KIRUHURA,2016,1690,1610,3300,17
KIRUHURA,2017,1760,1670,3430,17
KIRUHURA,2018,1820,1720,3540,17
KIRUHURA,2019,1890,1780,3670,17
KIRUHURA,2020,1960,1850,3810,17
KIRUHURA,2021,2030,1910,3940,17
KIRUHURA,2022,2100,1970,4070,17
KIRUHURA,2023,2180,2030,4210,17
KIRUHURA,2024,2240,2100,4340,17
KIRUHURA,2025,2320,2160,4480,17
KIRYANDONGO,2015,3100,3150,6250,17
KIRYANDONGO,2016,3270,3270,6540,17
KIRYANDONGO,2017,3440,3410,6850,17
KIRYANDONGO,2018,3610,3530,7140,17
KIRYANDONGO,2019,3750,3620,7370,17
KIRYANDONGO,2020,3860,3700,7560,17
KIRYANDONGO,2021,3950,3740,7690,17
KIRYANDONGO,2022,4030,3770,7800,17
KIRYANDONGO,2023,4100,3800,7900,17
KIRYANDONGO,2024,4180,3840,8020,17
KIRYANDONGO,2025,4260,3880,8140,17
KISORO,2015,3160,3790,6950,17
KISORO,2016,3300,3920,7220,17
KISORO,2017,3440,4040,7480,17
KISORO,2018,3560,4150,7710,17
KISORO,2019,3660,4250,7910,17
KISORO,2020,3730,4280,8010,17
KISORO,2021,3780,4300,8080,17
KISORO,2022,3810,4310,8120,17
KISORO,2023,3850,4320,8170,17
KISORO,2024,3890,4330,8220,17
KISORO,2025,3910,4350,8260,17
KITAGWENDA,2015,1470,1430,2900,17
KITAGWENDA,2016,1530,1480,3010,17
KITAGWENDA,2017,1590,1530,3120,17
KITAGWENDA,2018,1660,1590,3250,17
KITAGWENDA,2019,1720,1640,3360,17
KITAGWENDA,2020,1790,1700,3490,17
KITAGWENDA,2021,1860,1760,3620,17
KITAGWENDA,2022,1930,1820,3750,17
KITAGWENDA,2023,2000,1870,3870,17
KITAGWENDA,2024,2070,1930,4000,17
KITAGWENDA,2025,2140,1990,4130,17
KITGUM,2015,2590,2410,5000,17
KITGUM,2016,2690,2470,5160,17
KITGUM,2017,2800,2540,5340,17
KITGUM,2018,2890,2600,5490,17
KITGUM,2019,2960,2650,5610,17
KITGUM,2020,3010,2660,5670,17
KITGUM,2021,3030,2670,5700,17
KITGUM,2022,3050,2660,5710,17
KITGUM,2023,3070,2650,5720,17
KITGUM,2024,3080,2650,5730,17
KITGUM,2025,3110,2650,5760,17
KOBOKO,2015,2590,2440,5030,17
KOBOKO,2016,2750,2570,5320,17
KOBOKO,2017,2920,2700,5620,17
KOBOKO,2018,3090,2820,5910,17
KOBOKO,2019,3240,2930,6170,17
KOBOKO,2020,3370,3010,6380,17
KOBOKO,2021,3490,3080,6570,17
KOBOKO,2022,3580,3140,6720,17
KOBOKO,2023,3680,3200,6880,17
KOBOKO,2024,3790,3280,7070,17
KOBOKO,2025,3900,3340,7240,17
KOLE,2015,2830,2930,5760,17
KOLE,2016,2920,3010,5930,17
KOLE,2017,3020,3100,6120,17
KOLE,2018,3120,3180,6300,17
KOLE,2019,3210,3270,6480,17
KOLE,2020,3310,3360,6670,17
KOLE,2021,3410,3450,6860,17
KOLE,2022,3520,3540,7060,17
KOLE,2023,3620,3630,7250,17
KOLE,2024,3720,3720,7440,17
KOLE,2025,3820,3810,7630,17
KOTIDO,2015,1740,1960,3700,17
KOTIDO,2016,1820,2020,3840,17
KOTIDO,2017,1910,2090,4000,17
KOTIDO,2018,1990,2150,4140,17
KOTIDO,2019,2050,2200,4250,17
KOTIDO,2020,2100,2230,4330,17
KOTIDO,2021,2140,2240,4380,17
KOTIDO,2022,2170,2250,4420,17
KOTIDO,2023,2200,2260,4460,17
KOTIDO,2024,2220,2270,4490,17
KOTIDO,2025,2260,2280,4540,17
KUMI,2015,2920,2870,5790,17
KUMI,2016,3090,2990,6080,17
KUMI,2017,3250,3120,6370,17
KUMI,2018,3420,3230,6650,17
KUMI,2019,3560,3320,6880,17
KUMI,2020,3680,3390,7070,17
KUMI,2021,3760,3430,7190,17
KUMI,2022,3850,3480,7330,17
KUMI,2023,3930,3510,7440,17
KUMI,2024,4010,3550,7560,17
KUMI,2025,4090,3590,7680,17
KWANIA,2015,2220,2050,4270,17
KWANIA,2016,2290,2110,4400,17
KWANIA,2017,2360,2170,4530,17
KWANIA,2018,2440,2230,4670,17
KWANIA,2019,2510,2290,4800,17
KWANIA,2020,2580,2350,4930,17
KWANIA,2021,2660,2410,5070,17
KWANIA,2022,2730,2480,5210,17
KWANIA,2023,2810,2540,5350,17
KWANIA,2024,2880,2600,5480,17
KWANIA,2025,2950,2660,5610,17
KWEEN,2015,1080,1060,2140,17
KWEEN,2016,1110,1090,2200,17
KWEEN,2017,1150,1120,2270,17
KWEEN,2018,1180,1150,2330,17
KWEEN,2019,1220,1170,2390,17
KWEEN,2020,1250,1200,2450,17
KWEEN,2021,1290,1230,2520,17
KWEEN,2022,1330,1250,2580,17
KWEEN,2023,1360,1280,2640,17
KWEEN,2024,1400,1310,2710,17
KWEEN,2025,1430,1330,2760,17
KYANKWANZI,2015,2250,1970,4220,17
KYANKWANZI,2016,2360,2060,4420,17
KYANKWANZI,2017,2480,2150,4630,17
KYANKWANZI,2018,2610,2250,4860,17
KYANKWANZI,2019,2740,2360,5100,17
KYANKWANZI,2020,2880,2460,5340,17
KYANKWANZI,2021,3020,2570,5590,17
KYANKWANZI,2022,3170,2690,5860,17
KYANKWANZI,2023,3320,2800,6120,17
KYANKWANZI,2024,3470,2920,6390,17
KYANKWANZI,2025,3630,3040,6670,17
KYEGEGWA,2015,2870,2880,5750,17
KYEGEGWA,2016,3100,3110,6210,17
KYEGEGWA,2017,3360,3350,6710,17
KYEGEGWA,2018,3640,3620,7260,17
KYEGEGWA,2019,3930,3900,7830,17
KYEGEGWA,2020,4250,4200,8450,17
KYEGEGWA,2021,4590,4520,9110,17
KYEGEGWA,2022,4950,4870,9820,17
KYEGEGWA,2023,5340,5230,10570,17
KYEGEGWA,2024,5750,5630,11380,17
KYEGEGWA,2025,6190,6040,12230,17
KYENJOJO,2015,4630,4410,9040,17
KYENJOJO,2016,4830,4580,9410,17
KYENJOJO,2017,5020,4740,9760,17
KYENJOJO,2018,5230,4920,10150,17
KYENJOJO,2019,5440,5090,10530,17
KYENJOJO,2020,5650,5270,10920,17
KYENJOJO,2021,5870,5460,11330,17
KYENJOJO,2022,6090,5640,11730,17
KYENJOJO,2023,6320,5830,12150,17
KYENJOJO,2024,6550,6020,12570,17
KYENJOJO,2025,6780,6220,13000,17
KYOTERA,2015,2650,2710,5360,17
KYOTERA,2016,2750,2780,5530,17
KYOTERA,2017,2860,2850,5710,17
KYOTERA,2018,2960,2910,5870,17
KYOTERA,2019,3040,2960,6000,17
KYOTERA,2020,3090,2970,6060,17
KYOTERA,2021,3110,2960,6070,17
KYOTERA,2022,3130,2950,6080,17
KYOTERA,2023,3150,2940,6090,17
KYOTERA,2024,3170,2930,6100,17
KYOTERA,2025,3180,2920,6100,17
KARENGA,2015,420,520,940,17
KARENGA,2016,430,530,960,17
KARENGA,2017,440,540,980,17
KARENGA,2018,460,550,1010,17
KARENGA,2019,470,570,1040,17
KARENGA,2020,480,580,1060,17
KARENGA,2021,490,590,1080,17
KARENGA,2022,500,600,1100,17
KARENGA,2023,510,620,1130,17
KARENGA,2024,530,630,1160,17
KARENGA,2025,540,640,1180,17
LAMWO,2015,1520,1360,2880,17
LAMWO,2016,1570,1400,2970,17
LAMWO,2017,1630,1440,3070,17
LAMWO,2018,1660,1480,3140,17
LAMWO,2019,1690,1500,3190,17
LAMWO,2020,1710,1500,3210,17
LAMWO,2021,1710,1500,3210,17
LAMWO,2022,1710,1500,3210,17
LAMWO,2023,1710,1490,3200,17
LAMWO,2024,1710,1490,3200,17
LAMWO,2025,1710,1490,3200,17
LIRA,2015,4860,5310,10170,17
LIRA,2016,5000,5470,10470,17
LIRA,2017,5140,5620,10760,17
LIRA,2018,5280,5780,11060,17
LIRA,2019,5420,5940,11360,17
LIRA,2020,5570,6100,11670,17
LIRA,2021,5710,6270,11980,17
LIRA,2022,5860,6430,12290,17
LIRA,2023,6000,6590,12590,17
LIRA,2024,6140,6750,12890,17
LIRA,2025,6280,6910,13190,17
LUUKA,2015,2920,2840,5760,17
LUUKA,2016,3050,2930,5980,17
LUUKA,2017,3190,3020,6210,17
LUUKA,2018,3300,3110,6410,17
LUUKA,2019,3400,3170,6570,17
LUUKA,2020,3470,3200,6670,17
LUUKA,2021,3520,3210,6730,17
LUUKA,2022,3550,3220,6770,17
LUUKA,2023,3580,3220,6800,17
LUUKA,2024,3620,3230,6850,17
LUUKA,2025,3650,3240,6890,17
LUWERO,2015,5900,5600,11500,17
LUWERO,2016,6190,5790,11980,17
LUWERO,2017,6470,5990,12460,17
LUWERO,2018,6750,6170,12920,17
LUWERO,2019,6990,6310,13300,17
LUWERO,2020,7160,6410,13570,17
LUWERO,2021,7290,6450,13740,17
LUWERO,2022,7400,6480,13880,17
LUWERO,2023,7500,6500,14000,17
LUWERO,2024,7590,6540,14130,17
LUWERO,2025,7710,6580,14290,17
LWENGO,2015,2980,2780,5760,17
LWENGO,2016,3080,2840,5920,17
LWENGO,2017,3170,2900,6070,17
LWENGO,2018,3260,2950,6210,17
LWENGO,2019,3320,2980,6300,17
LWENGO,2020,3360,2980,6340,17
LWENGO,2021,3370,2960,6330,17
LWENGO,2022,3370,2940,6310,17
LWENGO,2023,3370,2910,6280,17
LWENGO,2024,3370,2890,6260,17
LWENGO,2025,3370,2870,6240,17
LYANTONDE,2015,1080,1060,2140,17
LYANTONDE,2016,1130,1110,2240,17
LYANTONDE,2017,1180,1160,2340,17
LYANTONDE,2018,1240,1190,2430,17
LYANTONDE,2019,1280,1210,2490,17
LYANTONDE,2020,1320,1240,2560,17
LYANTONDE,2021,1350,1260,2610,17
LYANTONDE,2022,1360,1270,2630,17
LYANTONDE,2023,1380,1270,2650,17
LYANTONDE,2024,1410,1280,2690,17
LYANTONDE,2025,1430,1290,2720,17
MANAFWA,2015,1800,1790,3590,17
MANAFWA,2016,1850,1830,3680,17
MANAFWA,2017,1890,1870,3760,17
MANAFWA,2018,1940,1920,3860,17
MANAFWA,2019,1980,1960,3940,17
MANAFWA,2020,2030,2000,4030,17
MANAFWA,2021,2080,2040,4120,17
MANAFWA,2022,2120,2080,4200,17
MANAFWA,2023,2170,2120,4290,17
MANAFWA,2024,2210,2160,4370,17
MANAFWA,2025,2260,2190,4450,17
MARACHA,2015,1960,2070,4030,17
MARACHA,2016,2000,2110,4110,17
MARACHA,2017,2040,2150,4190,17
MARACHA,2018,2080,2190,4270,17
MARACHA,2019,2120,2230,4350,17
MARACHA,2020,2170,2270,4440,17
MARACHA,2021,2210,2310,4520,17
MARACHA,2022,2250,2350,4600,17
MARACHA,2023,2290,2390,4680,17
MARACHA,2024,2320,2430,4750,17
MARACHA,2025,2360,2460,4820,17
MASAKA,2015,3440,3490,6930,17
MASAKA,2016,3590,3610,7200,17
MASAKA,2017,3750,3730,7480,17
MASAKA,2018,3900,3840,7740,17
MASAKA,2019,4030,3910,7940,17
MASAKA,2020,4120,3960,8080,17
MASAKA,2021,4170,3990,8160,17
MASAKA,2022,4230,3990,8220,17
MASAKA,2023,4270,3990,8260,17
MASAKA,2024,4310,4020,8330,17
MASAKA,2025,4370,4030,8400,17
MASINDI,2015,3080,3190,6270,17
MASINDI,2016,3170,3270,6440,17
MASINDI,2017,3270,3360,6630,17
MASINDI,2018,3360,3450,6810,17
MASINDI,2019,3460,3540,7000,17
MASINDI,2020,3550,3630,7180,17
MASINDI,2021,3650,3720,7370,17
MASINDI,2022,3740,3800,7540,17
MASINDI,2023,3840,3890,7730,17
MASINDI,2024,3930,3980,7910,17
MASINDI,2025,4030,4070,8100,17
MAYUGE,2015,5400,5170,10570,17
MAYUGE,2016,5700,5390,11090,17
MAYUGE,2017,6010,5630,11640,17
MAYUGE,2018,6300,5850,12150,17
MAYUGE,2019,6560,6040,12600,17
MAYUGE,2020,6760,6160,12920,17
MAYUGE,2021,6940,6250,13190,17
MAYUGE,2022,7080,6330,13410,17
MAYUGE,2023,7220,6400,13620,17
MAYUGE,2024,7360,6490,13850,17
MAYUGE,2025,7510,6580,14090,17
MBALE,2015,5480,6520,12000,17
MBALE,2016,5780,6820,12600,17
MBALE,2017,6070,7140,13210,17
MBALE,2018,6360,7420,13780,17
MBALE,2019,6620,7680,14300,17
MBALE,2020,6820,7870,14690,17
MBALE,2021,6980,8010,14990,17
MBALE,2022,7120,8120,15240,17
MBALE,2023,7250,8240,15490,17
MBALE,2024,7400,8370,15770,17
MBALE,2025,7530,8510,16040,17
MBARARA,2015,3720,3990,7710,17
MBARARA,2016,3810,4070,7880,17
MBARARA,2017,3890,4160,8050,17
MBARARA,2018,3980,4250,8230,17
MBARARA,2019,4070,4340,8410,17
MBARARA,2020,4160,4430,8590,17
MBARARA,2021,4240,4510,8750,17
MBARARA,2022,4330,4600,8930,17
MBARARA,2023,4410,4680,9090,17
MBARARA,2024,4490,4760,9250,17
MBARARA,2025,4570,4840,9410,17
MITOOMA,2015,2170,2220,4390,17
MITOOMA,2016,2190,2250,4440,17
MITOOMA,2017,2220,2270,4490,17
MITOOMA,2018,2250,2290,4540,17
MITOOMA,2019,2270,2310,4580,17
MITOOMA,2020,2290,2320,4610,17
MITOOMA,2021,2320,2340,4660,17
MITOOMA,2022,2340,2360,4700,17
MITOOMA,2023,2360,2370,4730,17
MITOOMA,2024,2380,2380,4760,17
MITOOMA,2025,2390,2390,4780,17
MITYANA,2015,4170,3910,8080,17
MITYANA,2016,4350,4020,8370,17
MITYANA,2017,4510,4140,8650,17
MITYANA,2018,4670,4230,8900,17
MITYANA,2019,4810,4300,9110,17
MITYANA,2020,4890,4330,9220,17
MITYANA,2021,4940,4340,9280,17
MITYANA,2022,4990,4320,9310,17
MITYANA,2023,5010,4310,9320,17
MITYANA,2024,5050,4310,9360,17
MITYANA,2025,5100,4300,9400,17
MOROTO,2015,930,1050,1980,17
MOROTO,2016,980,1100,2080,17
MOROTO,2017,1020,1130,2150,17
MOROTO,2018,1060,1180,2240,17
MOROTO,2019,1090,1210,2300,17
MOROTO,2020,1120,1230,2350,17
MOROTO,2021,1140,1240,2380,17
MOROTO,2022,1150,1240,2390,17
MOROTO,2023,1160,1260,2420,17
MOROTO,2024,1180,1260,2440,17
MOROTO,2025,1190,1280,2470,17
MOYO,2015,1170,1090,2260,17
MOYO,2016,1200,1120,2320,17
MOYO,2017,1230,1140,2370,17
MOYO,2018,1260,1160,2420,17
MOYO,2019,1300,1190,2490,17
MOYO,2020,1320,1210,2530,17
MOYO,2021,1360,1230,2590,17
MOYO,2022,1390,1260,2650,17
MOYO,2023,1420,1280,2700,17
MOYO,2024,1450,1300,2750,17
MOYO,2025,1470,1330,2800,17
MPIGI,2015,2980,2780,5760,17
MPIGI,2016,3120,2890,6010,17
MPIGI,2017,3260,3000,6260,17
MPIGI,2018,3400,3090,6490,17
MPIGI,2019,3520,3160,6680,17
MPIGI,2020,3600,3200,6800,17
MPIGI,2021,3670,3220,6890,17
MPIGI,2022,3710,3240,6950,17
MPIGI,2023,3760,3260,7020,17
MPIGI,2024,3810,3280,7090,17
MPIGI,2025,3860,3290,7150,17
MUBENDE,2015,4650,4460,9110,17
MUBENDE,2016,5010,4740,9750,17
MUBENDE,2017,5390,5060,10450,17
MUBENDE,2018,5760,5350,11110,17
MUBENDE,2019,6120,5640,11760,17
MUBENDE,2020,6440,5870,12310,17
MUBENDE,2021,6750,6080,12830,17
MUBENDE,2022,7030,6280,13310,17
MUBENDE,2023,7320,6480,13800,17
MUBENDE,2024,7630,6700,14330,17
MUBENDE,2025,7940,6920,14860,17
MUKONO,2015,7130,7770,14900,17
MUKONO,2016,7490,8100,15590,17
MUKONO,2017,7860,8440,16300,17
MUKONO,2018,8200,8760,16960,17
MUKONO,2019,8510,9010,17520,17
MUKONO,2020,8740,9200,17940,17
MUKONO,2021,8920,9330,18250,17
MUKONO,2022,9070,9430,18500,17
MUKONO,2023,9200,9530,18730,17
MUKONO,2024,9350,9640,18990,17
MUKONO,2025,9500,9770,19270,17
MADI OKOLLO,2015,1580,1520,3100,17
MADI OKOLLO,2016,1630,1570,3200,17
MADI OKOLLO,2017,1680,1600,3280,17
MADI OKOLLO,2018,1730,1650,3380,17
MADI OKOLLO,2019,1770,1690,3460,17
MADI OKOLLO,2020,1830,1730,3560,17
MADI OKOLLO,2021,1870,1780,3650,17
MADI OKOLLO,2022,1920,1830,3750,17
MADI OKOLLO,2023,1970,1860,3830,17
MADI OKOLLO,2024,2020,1910,3930,17
MADI OKOLLO,2025,2060,1950,4010,17
NABILATUK,2015,770,830,1600,17
NABILATUK,2016,830,880,1710,17
NABILATUK,2017,900,940,1840,17
NABILATUK,2018,960,980,1940,17
NABILATUK,2019,1010,1020,2030,17
NABILATUK,2020,1070,1060,2130,17
NABILATUK,2021,1110,1090,2200,17
NABILATUK,2022,1150,1130,2280,17
NABILATUK,2023,1200,1150,2350,17
NABILATUK,2024,1240,1180,2420,17
NABILATUK,2025,1300,1220,2520,17
NAKAPIRIPIRIT,2015,880,940,1820,17
NAKAPIRIPIRIT,2016,940,990,1930,17
NAKAPIRIPIRIT,2017,1000,1050,2050,17
NAKAPIRIPIRIT,2018,1070,1100,2170,17
NAKAPIRIPIRIT,2019,1120,1140,2260,17
NAKAPIRIPIRIT,2020,1170,1190,2360,17
NAKAPIRIPIRIT,2021,1220,1220,2440,17
NAKAPIRIPIRIT,2022,1250,1260,2510,17
NAKAPIRIPIRIT,2023,1300,1290,2590,17
NAKAPIRIPIRIT,2024,1330,1310,2640,17
NAKAPIRIPIRIT,2025,1380,1350,2730,17
NAKASEKE,2015,2330,1900,4230,17
NAKASEKE,2016,2410,1940,4350,17
NAKASEKE,2017,2500,1990,4490,17
NAKASEKE,2018,2590,2040,4630,17
NAKASEKE,2019,2680,2090,4770,17
NAKASEKE,2020,2780,2130,4910,17
NAKASEKE,2021,2870,2180,5050,17
NAKASEKE,2022,2970,2230,5200,17
NAKASEKE,2023,3070,2270,5340,17
NAKASEKE,2024,3170,2320,5490,17
NAKASEKE,2025,3260,2360,5620,17
NAKASONGOLA,2015,2240,2110,4350,17
NAKASONGOLA,2016,2370,2190,4560,17
NAKASONGOLA,2017,2500,2270,4770,17
NAKASONGOLA,2018,2620,2350,4970,17
NAKASONGOLA,2019,2730,2420,5150,17
NAKASONGOLA,2020,2810,2460,5270,17
NAKASONGOLA,2021,2890,2490,5380,17
NAKASONGOLA,2022,2950,2510,5460,17
NAKASONGOLA,2023,3010,2540,5550,17
NAKASONGOLA,2024,3070,2560,5630,17
NAKASONGOLA,2025,3140,2590,5730,17
NAMAYINGO,2015,2320,2220,4540,17
NAMAYINGO,2016,2420,2280,4700,17
NAMAYINGO,2017,2510,2350,4860,17
NAMAYINGO,2018,2610,2400,5010,17
NAMAYINGO,2019,2680,2430,5110,17
NAMAYINGO,2020,2720,2460,5180,17
NAMAYINGO,2021,2760,2450,5210,17
NAMAYINGO,2022,2790,2450,5240,17
NAMAYINGO,2023,2810,2440,5250,17
NAMAYINGO,2024,2830,2430,5260,17
NAMAYINGO,2025,2840,2420,5260,17
NAMISINDWA,2015,2130,2230,4360,17
NAMISINDWA,2016,2190,2280,4470,17
NAMISINDWA,2017,2250,2330,4580,17
NAMISINDWA,2018,2320,2390,4710,17
NAMISINDWA,2019,2380,2440,4820,17
NAMISINDWA,2020,2440,2500,4940,17
NAMISINDWA,2021,2500,2550,5050,17
NAMISINDWA,2022,2570,2610,5180,17
NAMISINDWA,2023,2630,2660,5290,17
NAMISINDWA,2024,2690,2710,5400,17
NAMISINDWA,2025,2750,2760,5510,17
NAMUTUMBA,2015,2970,2770,5740,17
NAMUTUMBA,2016,3140,2890,6030,17
NAMUTUMBA,2017,3330,3030,6360,17
NAMUTUMBA,2018,3510,3150,6660,17
NAMUTUMBA,2019,3660,3260,6920,17
NAMUTUMBA,2020,3790,3330,7120,17
NAMUTUMBA,2021,3900,3390,7290,17
NAMUTUMBA,2022,3990,3430,7420,17
NAMUTUMBA,2023,4090,3490,7580,17
NAMUTUMBA,2024,4180,3540,7720,17
NAMUTUMBA,2025,4290,3590,7880,17
NAPAK,2015,1360,1440,2800,17
NAPAK,2016,1410,1490,2900,17
NAPAK,2017,1470,1540,3010,17
NAPAK,2018,1520,1590,3110,17
NAPAK,2019,1550,1610,3160,17
NAPAK,2020,1580,1630,3210,17
NAPAK,2021,1590,1650,3240,17
NAPAK,2022,1600,1650,3250,17
NAPAK,2023,1610,1650,3260,17
NAPAK,2024,1620,1660,3280,17
NAPAK,2025,1630,1670,3300,17
NEBBI,2015,2550,2790,5340,17
NEBBI,2016,2630,2870,5500,17
NEBBI,2017,2720,2950,5670,17
NEBBI,2018,2800,3030,5830,17
NEBBI,2019,2890,3110,6000,17
NEBBI,2020,2980,3200,6180,17
NEBBI,2021,3060,3280,6340,17
NEBBI,2022,3150,3370,6520,17
NEBBI,2023,3240,3450,6690,17
NEBBI,2024,3330,3530,6860,17
NEBBI,2025,3420,3620,7040,17
NGORA,2015,1700,1760,3460,17
NGORA,2016,1790,1830,3620,17
NGORA,2017,1880,1890,3770,17
NGORA,2018,1970,1960,3930,17
NGORA,2019,2040,2010,4050,17
NGORA,2020,2100,2040,4140,17
NGORA,2021,2140,2070,4210,17
NGORA,2022,2180,2080,4260,17
NGORA,2023,2210,2100,4310,17
NGORA,2024,2250,2120,4370,17
NGORA,2025,2290,2150,4440,17
NTOROKO,2015,800,810,1610,17
NTOROKO,2016,830,840,1670,17
NTOROKO,2017,870,860,1730,17
NTOROKO,2018,910,890,1800,17
NTOROKO,2019,940,900,1840,17
NTOROKO,2020,960,910,1870,17
NTOROKO,2021,980,920,1900,17
NTOROKO,2022,1000,910,1910,17
NTOROKO,2023,1010,920,1930,17
NTOROKO,2024,1020,920,1940,17
NTOROKO,2025,1040,920,1960,17
NTUNGAMO,2015,5340,5620,10960,17
NTUNGAMO,2016,5450,5720,11170,17
NTUNGAMO,2017,5570,5830,11400,17
NTUNGAMO,2018,5690,5940,11630,17
NTUNGAMO,2019,5800,6040,11840,17
NTUNGAMO,2020,5920,6140,12060,17
NTUNGAMO,2021,6030,6240,12270,17
NTUNGAMO,2022,6140,6340,12480,17
NTUNGAMO,2023,6260,6440,12700,17
NTUNGAMO,2024,6360,6540,12900,17
NTUNGAMO,2025,6460,6630,13090,17
NWOYA,2015,1550,1510,3060,17
NWOYA,2016,1710,1660,3370,17
NWOYA,2017,1890,1830,3720,17
NWOYA,2018,2090,2020,4110,17
NWOYA,2019,2310,2220,4530,17
NWOYA,2020,2550,2440,4990,17
NWOYA,2021,2810,2690,5500,17
NWOYA,2022,3090,2950,6040,17
NWOYA,2023,3400,3240,6640,17
NWOYA,2024,3740,3560,7300,17
NWOYA,2025,4110,3910,8020,17
OBONGI,2015,550,430,980,17
OBONGI,2016,570,450,1020,17
OBONGI,2017,610,460,1070,17
OBONGI,2018,630,480,1110,17
OBONGI,2019,650,490,1140,17
OBONGI,2020,670,500,1170,17
OBONGI,2021,680,500,1180,17
OBONGI,2022,680,490,1170,17
OBONGI,2023,700,500,1200,17
OBONGI,2024,700,500,1200,17
OBONGI,2025,710,510,1220,17
OMORO,2015,2020,2000,4020,17
OMORO,2016,2140,2090,4230,17
OMORO,2017,2260,2190,4450,17
OMORO,2018,2370,2290,4660,17
OMORO,2019,2480,2370,4850,17
OMORO,2020,2580,2430,5010,17
OMORO,2021,2640,2470,5110,17
OMORO,2022,2710,2510,5220,17
OMORO,2023,2770,2550,5320,17
OMORO,2024,2840,2600,5440,17
OMORO,2025,2920,2640,5560,17
OTUKE,2015,1270,1190,2460,17
OTUKE,2016,1330,1240,2570,17
OTUKE,2017,1390,1290,2680,17
OTUKE,2018,1450,1350,2800,17
OTUKE,2019,1520,1400,2920,17
OTUKE,2020,1580,1460,3040,17
OTUKE,2021,1650,1520,3170,17
OTUKE,2022,1720,1580,3300,17
OTUKE,2023,1790,1640,3430,17
OTUKE,2024,1870,1710,3580,17
OTUKE,2025,1940,1770,3710,17
OYAM,2015,4390,4520,8910,17
OYAM,2016,4520,4660,9180,17
OYAM,2017,4660,4790,9450,17
OYAM,2018,4800,4930,9730,17
OYAM,2019,4940,5070,10010,17
OYAM,2020,5080,5210,10290,17
OYAM,2021,5230,5350,10580,17
OYAM,2022,5380,5500,10880,17
OYAM,2023,5520,5640,11160,17
OYAM,2024,5660,5780,11440,17
OYAM,2025,5810,5920,11730,17
PADER,2015,2140,1990,4130,17
PADER,2016,2220,2060,4280,17
PADER,2017,2310,2130,4440,17
PADER,2018,2390,2180,4570,17
PADER,2019,2450,2220,4670,17
PADER,2020,2500,2240,4740,17
PADER,2021,2530,2260,4790,17
PADER,2022,2540,2250,4790,17
PADER,2023,2550,2250,4800,17
PADER,2024,2560,2260,4820,17
PADER,2025,2580,2270,4850,17
PAKWACH,2015,1740,1810,3550,17
PAKWACH,2016,1810,1880,3690,17
PAKWACH,2017,1890,1950,3840,17
PAKWACH,2018,1970,2020,3990,17
PAKWACH,2019,2040,2090,4130,17
PAKWACH,2020,2130,2160,4290,17
PAKWACH,2021,2210,2240,4450,17
PAKWACH,2022,2300,2310,4610,17
PAKWACH,2023,2380,2390,4770,17
PAKWACH,2024,2470,2460,4930,17
PAKWACH,2025,2560,2540,5100,17
PALLISA,2015,3370,3210,6580,17
PALLISA,2016,3610,3390,7000,17
PALLISA,2017,3850,3580,7430,17
PALLISA,2018,4090,3760,7850,17
PALLISA,2019,4320,3920,8240,17
PALLISA,2020,4500,4060,8560,17
PALLISA,2021,4680,4170,8850,17
PALLISA,2022,4840,4280,9120,17
PALLISA,2023,5000,4390,9390,17
PALLISA,2024,5160,4500,9660,17
PALLISA,2025,5340,4610,9950,17
RAKAI,2015,2730,2530,5260,17
RAKAI,2016,2850,2610,5460,17
RAKAI,2017,2990,2700,5690,17
RAKAI,2018,3120,2790,5910,17
RAKAI,2019,3230,2850,6080,17
RAKAI,2020,3310,2890,6200,17
RAKAI,2021,3370,2910,6280,17
RAKAI,2022,3420,2930,6350,17
RAKAI,2023,3470,2940,6410,17
RAKAI,2024,3520,2950,6470,17
RAKAI,2025,3580,2970,6550,17
RUBANDA,2015,2120,2250,4370,17
RUBANDA,2016,2150,2270,4420,17
RUBANDA,2017,2180,2290,4470,17
RUBANDA,2018,2210,2300,4510,17
RUBANDA,2019,2230,2320,4550,17
RUBANDA,2020,2260,2340,4600,17
RUBANDA,2021,2290,2350,4640,17
RUBANDA,2022,2310,2360,4670,17
RUBANDA,2023,2330,2370,4700,17
RUBANDA,2024,2350,2390,4740,17
RUBANDA,2025,2370,2390,4760,17
RUBIRIZI,2015,1370,1400,2770,17
RUBIRIZI,2016,1390,1420,2810,17
RUBIRIZI,2017,1420,1450,2870,17
RUBIRIZI,2018,1450,1480,2930,17
RUBIRIZI,2019,1480,1500,2980,17
RUBIRIZI,2020,1510,1530,3040,17
RUBIRIZI,2021,1530,1560,3090,17
RUBIRIZI,2022,1560,1580,3140,17
RUBIRIZI,2023,1590,1610,3200,17
RUBIRIZI,2024,1610,1630,3240,17
RUBIRIZI,2025,1640,1660,3300,17
RUKIGA,2015,1160,1110,2270,17
RUKIGA,2016,1170,1120,2290,17
RUKIGA,2017,1180,1130,2310,17
RUKIGA,2018,1190,1140,2330,17
RUKIGA,2019,1200,1150,2350,17
RUKIGA,2020,1210,1150,2360,17
RUKIGA,2021,1220,1160,2380,17
RUKIGA,2022,1230,1160,2390,17
RUKIGA,2023,1240,1170,2410,17
RUKIGA,2024,1250,1170,2420,17
RUKIGA,2025,1250,1170,2420,17
RUKUNGIRI,2015,3770,3890,7660,17
RUKUNGIRI,2016,3820,3930,7750,17
RUKUNGIRI,2017,3860,3970,7830,17
RUKUNGIRI,2018,3910,4000,7910,17
RUKUNGIRI,2019,3950,4040,7990,17
RUKUNGIRI,2020,3990,4080,8070,17
RUKUNGIRI,2021,4030,4110,8140,17
RUKUNGIRI,2022,4070,4130,8200,17
RUKUNGIRI,2023,4110,4160,8270,17
RUKUNGIRI,2024,4140,4190,8330,17
RUKUNGIRI,2025,4170,4210,8380,17
RWAMPARA,2015,1400,1390,2790,17
RWAMPARA,2016,1430,1420,2850,17
RWAMPARA,2017,1460,1460,2920,17
RWAMPARA,2018,1490,1490,2980,17
RWAMPARA,2019,1530,1520,3050,17
RWAMPARA,2020,1560,1550,3110,17
RWAMPARA,2021,1590,1580,3170,17
RWAMPARA,2022,1630,1610,3240,17
RWAMPARA,2023,1650,1640,3290,17
RWAMPARA,2024,1690,1670,3360,17
RWAMPARA,2025,1720,1700,3420,17
SERERE,2015,3370,3370,6740,17
SERERE,2016,3590,3550,7140,17
SERERE,2017,3820,3730,7550,17
SERERE,2018,4050,3920,7970,17
SERERE,2019,4240,4070,8310,17
SERERE,2020,4420,4190,8610,17
SERERE,2021,4570,4290,8860,17
SERERE,2022,4710,4390,9100,17
SERERE,2023,4850,4470,9320,17
SERERE,2024,5000,4570,9570,17
SERERE,2025,5140,4670,9810,17
SHEEMA,2015,2490,2590,5080,17
SHEEMA,2016,2520,2620,5140,17
SHEEMA,2017,2550,2650,5200,17
SHEEMA,2018,2580,2670,5250,17
SHEEMA,2019,2610,2700,5310,17
SHEEMA,2020,2640,2720,5360,17
SHEEMA,2021,2670,2750,5420,17
SHEEMA,2022,2690,2770,5460,17
SHEEMA,2023,2710,2790,5500,17
SHEEMA,2024,2740,2800,5540,17
SHEEMA,2025,2750,2820,5570,17
SIRONKO,2015,2860,2770,5630,17
SIRONKO,2016,2930,2830,5760,17
SIRONKO,2017,3000,2890,5890,17
SIRONKO,2018,3070,2950,6020,17
SIRONKO,2019,3140,3000,6140,17
SIRONKO,2020,3210,3060,6270,17
SIRONKO,2021,3270,3120,6390,17
SIRONKO,2022,3340,3170,6510,17
SIRONKO,2023,3410,3230,6640,17
SIRONKO,2024,3480,3280,6760,17
SIRONKO,2025,3540,3330,6870,17
SOROTI,2015,3810,4060,7870,17
SOROTI,2016,4030,4250,8280,17
SOROTI,2017,4270,4450,8720,17
SOROTI,2018,4490,4640,9130,17
SOROTI,2019,4710,4800,9510,17
SOROTI,2020,4880,4930,9810,17
SOROTI,2021,5020,5020,10040,17
SOROTI,2022,5160,5110,10270,17
SOROTI,2023,5280,5190,10470,17
SOROTI,2024,5410,5280,10690,17
SOROTI,2025,5540,5370,10910,17
SSEMBABULE,2015,2680,2560,5240,17
SSEMBABULE,2016,2830,2660,5490,17
SSEMBABULE,2017,2980,2770,5750,17
SSEMBABULE,2018,3110,2860,5970,17
SSEMBABULE,2019,3230,2930,6160,17
SSEMBABULE,2020,3320,2990,6310,17
SSEMBABULE,2021,3400,3030,6430,17
SSEMBABULE,2022,3460,3050,6510,17
SSEMBABULE,2023,3520,3080,6600,17
SSEMBABULE,2024,3590,3100,6690,17
SSEMBABULE,2025,3650,3140,6790,17
TORORO,2015,6100,6250,12350,17
TORORO,2016,6260,6410,12670,17
TORORO,2017,6430,6570,13000,17
TORORO,2018,6600,6730,13330,17
TORORO,2019,6770,6890,13660,17
TORORO,2020,6940,7050,13990,17
TORORO,2021,7110,7210,14320,17
TORORO,2022,7280,7370,14650,17
TORORO,2023,7440,7530,14970,17
TORORO,2024,7610,7690,15300,17
TORORO,2025,7770,7850,15620,17
WAKISO,2015,20510,27190,47700,17
WAKISO,2016,21880,29050,50930,17
WAKISO,2017,23350,31040,54390,17
WAKISO,2018,24900,33140,58040,17
WAKISO,2019,26560,35360,61920,17
WAKISO,2020,28290,37710,66000,17
WAKISO,2021,30100,40220,70320,17
WAKISO,2022,32040,42870,74910,17
WAKISO,2023,34070,45630,79700,17
WAKISO,2024,36190,48530,84720,17
WAKISO,2025,38410,51620,90030,17
YUMBE,2015,5050,4900,9950,17
YUMBE,2016,5430,5250,10680,17
YUMBE,2017,5840,5640,11480,17
YUMBE,2018,6240,6010,12250,17
YUMBE,2019,6620,6370,12990,17
YUMBE,2020,6960,6690,13650,17
YUMBE,2021,7270,6980,14250,17
YUMBE,2022,7560,7260,14820,17
YUMBE,2023,7860,7560,15420,17
YUMBE,2024,8180,7870,16050,17
YUMBE,2025,8500,8200,16700,17
ZOMBO,2015,2320,2350,4670,17
ZOMBO,2016,2390,2420,4810,17
ZOMBO,2017,2460,2480,4940,17
ZOMBO,2018,2540,2550,5090,17
ZOMBO,2019,2620,2620,5240,17
ZOMBO,2020,2690,2690,5380,17
ZOMBO,2021,2770,2760,5530,17
ZOMBO,2022,2850,2830,5680,17
ZOMBO,2023,2920,2900,5820,17
ZOMBO,2024,3000,2970,5970,17
ZOMBO,2025,3080,3040,6120,17
ABIM,2015,1390,1440,2830,18
ABIM,2016,1520,1540,3060,18
ABIM,2017,1650,1650,3300,18
ABIM,2018,1800,1770,3570,18
ABIM,2019,1930,1890,3820,18
ABIM,2020,2080,2010,4090,18
ABIM,2021,2220,2110,4330,18
ABIM,2022,2340,2210,4550,18
ABIM,2023,2460,2300,4760,18
ABIM,2024,2590,2390,4980,18
ABIM,2025,2730,2490,5220,18
ADJUMANI,2015,2640,2630,5270,18
ADJUMANI,2016,2670,2660,5330,18
ADJUMANI,2017,2680,2680,5360,18
ADJUMANI,2018,2700,2710,5410,18
ADJUMANI,2019,2720,2730,5450,18
ADJUMANI,2020,2740,2750,5490,18
ADJUMANI,2021,2750,2770,5520,18
ADJUMANI,2022,2760,2790,5550,18
ADJUMANI,2023,2770,2810,5580,18
ADJUMANI,2024,2780,2830,5610,18
ADJUMANI,2025,2790,2840,5630,18
AGAGO,2015,2760,2690,5450,18
AGAGO,2016,2810,2740,5550,18
AGAGO,2017,2860,2780,5640,18
AGAGO,2018,2910,2830,5740,18
AGAGO,2019,2960,2880,5840,18
AGAGO,2020,3010,2930,5940,18
AGAGO,2021,3050,2970,6020,18
AGAGO,2022,3100,3020,6120,18
AGAGO,2023,3140,3060,6200,18
AGAGO,2024,3180,3100,6280,18
AGAGO,2025,3220,3140,6360,18
ALEBTONG,2015,2620,2680,5300,18
ALEBTONG,2016,2750,2770,5520,18
ALEBTONG,2017,2900,2870,5770,18
ALEBTONG,2018,3040,2990,6030,18
ALEBTONG,2019,3180,3090,6270,18
ALEBTONG,2020,3290,3170,6460,18
ALEBTONG,2021,3390,3230,6620,18
ALEBTONG,2022,3450,3260,6710,18
ALEBTONG,2023,3510,3280,6790,18
ALEBTONG,2024,3570,3310,6880,18
ALEBTONG,2025,3630,3340,6970,18
AMOLATAR,2015,1630,1700,3330,18
AMOLATAR,2016,1710,1760,3470,18
AMOLATAR,2017,1800,1820,3620,18
AMOLATAR,2018,1880,1890,3770,18
AMOLATAR,2019,1960,1950,3910,18
AMOLATAR,2020,2030,1990,4020,18
AMOLATAR,2021,2090,2020,4110,18
AMOLATAR,2022,2120,2040,4160,18
AMOLATAR,2023,2160,2050,4210,18
AMOLATAR,2024,2190,2060,4250,18
AMOLATAR,2025,2220,2070,4290,18
AMUDAT,2015,1270,1060,2330,18
AMUDAT,2016,1360,1110,2470,18
AMUDAT,2017,1430,1180,2610,18
AMUDAT,2018,1530,1250,2780,18
AMUDAT,2019,1620,1310,2930,18
AMUDAT,2020,1690,1380,3070,18
AMUDAT,2021,1750,1430,3180,18
AMUDAT,2022,1810,1470,3280,18
AMUDAT,2023,1870,1510,3380,18
AMUDAT,2024,1910,1550,3460,18
AMUDAT,2025,1970,1590,3560,18
AMURIA,2015,2090,2160,4250,18
AMURIA,2016,2210,2250,4460,18
AMURIA,2017,2340,2360,4700,18
AMURIA,2018,2490,2470,4960,18
AMURIA,2019,2620,2570,5190,18
AMURIA,2020,2740,2660,5400,18
AMURIA,2021,2850,2730,5580,18
AMURIA,2022,2930,2780,5710,18
AMURIA,2023,3010,2820,5830,18
AMURIA,2024,3080,2860,5940,18
AMURIA,2025,3170,2910,6080,18
AMURU,2015,2120,2060,4180,18
AMURU,2016,2220,2130,4350,18
AMURU,2017,2320,2200,4520,18
AMURU,2018,2440,2300,4740,18
AMURU,2019,2540,2370,4910,18
AMURU,2020,2630,2430,5060,18
AMURU,2021,2700,2470,5170,18
AMURU,2022,2750,2490,5240,18
AMURU,2023,2790,2520,5310,18
AMURU,2024,2840,2530,5370,18
AMURU,2025,2870,2550,5420,18
APAC,2015,2330,2480,4810,18
APAC,2016,2420,2560,4980,18
APAC,2017,2510,2650,5160,18
APAC,2018,2600,2740,5340,18
APAC,2019,2690,2840,5530,18
APAC,2020,2790,2930,5720,18
APAC,2021,2880,3020,5900,18
APAC,2022,2980,3120,6100,18
APAC,2023,3080,3220,6300,18
APAC,2024,3180,3320,6500,18
APAC,2025,3280,3420,6700,18
ARUA,2015,7970,9050,17020,18
ARUA,2016,8210,9290,17500,18
ARUA,2017,8440,9550,17990,18
ARUA,2018,8680,9800,18480,18
ARUA,2019,8920,10060,18980,18
ARUA,2020,9160,10320,19480,18
ARUA,2021,9410,10570,19980,18
ARUA,2022,9650,10830,20480,18
ARUA,2023,9900,11100,21000,18
ARUA,2024,10140,11350,21490,18
ARUA,2025,10380,11610,21990,18
BUDAKA,2015,2320,2460,4780,18
BUDAKA,2016,2460,2560,5020,18
BUDAKA,2017,2610,2680,5290,18
BUDAKA,2018,2760,2800,5560,18
BUDAKA,2019,2910,2910,5820,18
BUDAKA,2020,3030,3020,6050,18
BUDAKA,2021,3140,3090,6230,18
BUDAKA,2022,3230,3150,6380,18
BUDAKA,2023,3310,3190,6500,18
BUDAKA,2024,3390,3230,6620,18
BUDAKA,2025,3480,3290,6770,18
BUDUDA,2015,2610,2640,5250,18
BUDUDA,2016,2790,2790,5580,18
BUDUDA,2017,2980,2950,5930,18
BUDUDA,2018,3180,3120,6300,18
BUDUDA,2019,3380,3280,6660,18
BUDUDA,2020,3570,3420,6990,18
BUDUDA,2021,3730,3540,7270,18
BUDUDA,2022,3870,3640,7510,18
BUDUDA,2023,4000,3730,7730,18
BUDUDA,2024,4130,3820,7950,18
BUDUDA,2025,4270,3920,8190,18
BUGIRI,2015,3980,4170,8150,18
BUGIRI,2016,4230,4370,8600,18
BUGIRI,2017,4510,4590,9100,18
BUGIRI,2018,4790,4830,9620,18
BUGIRI,2019,5070,5040,10110,18
BUGIRI,2020,5330,5240,10570,18
BUGIRI,2021,5540,5400,10940,18
BUGIRI,2022,5730,5510,11240,18
BUGIRI,2023,5900,5620,11520,18
BUGIRI,2024,6070,5730,11800,18
BUGIRI,2025,6240,5850,12090,18
BUGWERI,2015,1820,1840,3660,18
BUGWERI,2016,1910,1910,3820,18
BUGWERI,2017,2010,1970,3980,18
BUGWERI,2018,2110,2050,4160,18
BUGWERI,2019,2200,2120,4320,18
BUGWERI,2020,2280,2170,4450,18
BUGWERI,2021,2350,2210,4560,18
BUGWERI,2022,2390,2230,4620,18
BUGWERI,2023,2420,2240,4660,18
BUGWERI,2024,2460,2250,4710,18
BUGWERI,2025,2500,2280,4780,18
BUHWEJU,2015,1380,1460,2840,18
BUHWEJU,2016,1420,1500,2920,18
BUHWEJU,2017,1470,1550,3020,18
BUHWEJU,2018,1520,1590,3110,18
BUHWEJU,2019,1570,1640,3210,18
BUHWEJU,2020,1620,1690,3310,18
BUHWEJU,2021,1660,1740,3400,18
BUHWEJU,2022,1710,1780,3490,18
BUHWEJU,2023,1760,1830,3590,18
BUHWEJU,2024,1810,1880,3690,18
BUHWEJU,2025,1860,1930,3790,18
BUIKWE,2015,5000,4920,9920,18
BUIKWE,2016,5230,5060,10290,18
BUIKWE,2017,5450,5220,10670,18
BUIKWE,2018,5670,5400,11070,18
BUIKWE,2019,5880,5540,11420,18
BUIKWE,2020,6060,5650,11710,18
BUIKWE,2021,6180,5710,11890,18
BUIKWE,2022,6250,5740,11990,18
BUIKWE,2023,6310,5740,12050,18
BUIKWE,2024,6370,5750,12120,18
BUIKWE,2025,6420,5760,12180,18
BUKEDEA,2015,2120,2180,4300,18
BUKEDEA,2016,2260,2280,4540,18
BUKEDEA,2017,2410,2400,4810,18
BUKEDEA,2018,2580,2530,5110,18
BUKEDEA,2019,2730,2660,5390,18
BUKEDEA,2020,2870,2760,5630,18
BUKEDEA,2021,3010,2850,5860,18
BUKEDEA,2022,3110,2920,6030,18
BUKEDEA,2023,3220,2980,6200,18
BUKEDEA,2024,3330,3050,6380,18
BUKEDEA,2025,3430,3120,6550,18
BUKOMANSIMBI,2015,1520,1440,2960,18
BUKOMANSIMBI,2016,1570,1460,3030,18
BUKOMANSIMBI,2017,1620,1480,3100,18
BUKOMANSIMBI,2018,1670,1500,3170,18
BUKOMANSIMBI,2019,1710,1520,3230,18
BUKOMANSIMBI,2020,1730,1520,3250,18
BUKOMANSIMBI,2021,1740,1520,3260,18
BUKOMANSIMBI,2022,1750,1500,3250,18
BUKOMANSIMBI,2023,1740,1480,3220,18
BUKOMANSIMBI,2024,1740,1460,3200,18
BUKOMANSIMBI,2025,1730,1440,3170,18
BUKWO,2015,1040,1080,2120,18
BUKWO,2016,1090,1130,2220,18
BUKWO,2017,1150,1190,2340,18
BUKWO,2018,1210,1240,2450,18
BUKWO,2019,1280,1310,2590,18
BUKWO,2020,1340,1370,2710,18
BUKWO,2021,1410,1430,2840,18
BUKWO,2022,1480,1490,2970,18
BUKWO,2023,1560,1560,3120,18
BUKWO,2024,1630,1630,3260,18
BUKWO,2025,1710,1710,3420,18
BULAMBULI,2015,1940,1990,3930,18
BULAMBULI,2016,2090,2100,4190,18
BULAMBULI,2017,2240,2230,4470,18
BULAMBULI,2018,2400,2370,4770,18
BULAMBULI,2019,2560,2500,5060,18
BULAMBULI,2020,2710,2630,5340,18
BULAMBULI,2021,2850,2730,5580,18
BULAMBULI,2022,2960,2820,5780,18
BULAMBULI,2023,3080,2900,5980,18
BULAMBULI,2024,3190,2980,6170,18
BULAMBULI,2025,3310,3070,6380,18
BULIISA,2015,1220,1580,2800,18
BULIISA,2016,1290,1650,2940,18
BULIISA,2017,1360,1730,3090,18
BULIISA,2018,1430,1800,3230,18
BULIISA,2019,1510,1880,3390,18
BULIISA,2020,1590,1960,3550,18
BULIISA,2021,1670,2040,3710,18
BULIISA,2022,1750,2130,3880,18
BULIISA,2023,1840,2220,4060,18
BULIISA,2024,1930,2310,4240,18
BULIISA,2025,2030,2400,4430,18
BUNDIBUGYO,2015,2450,3070,5520,18
BUNDIBUGYO,2016,2580,3180,5760,18
BUNDIBUGYO,2017,2720,3300,6020,18
BUNDIBUGYO,2018,2860,3430,6290,18
BUNDIBUGYO,2019,3000,3540,6540,18
BUNDIBUGYO,2020,3100,3640,6740,18
BUNDIBUGYO,2021,3200,3700,6900,18
BUNDIBUGYO,2022,3270,3750,7020,18
BUNDIBUGYO,2023,3330,3780,7110,18
BUNDIBUGYO,2024,3390,3810,7200,18
BUNDIBUGYO,2025,3460,3840,7300,18
BUNYANGABU,2015,1980,1850,3830,18
BUNYANGABU,2016,2080,1900,3980,18
BUNYANGABU,2017,2180,1960,4140,18
BUNYANGABU,2018,2280,2030,4310,18
BUNYANGABU,2019,2380,2090,4470,18
BUNYANGABU,2020,2460,2130,4590,18
BUNYANGABU,2021,2530,2160,4690,18
BUNYANGABU,2022,2570,2180,4750,18
BUNYANGABU,2023,2610,2190,4800,18
BUNYANGABU,2024,2640,2190,4830,18
BUNYANGABU,2025,2680,2210,4890,18
BUSHENYI,2015,3320,3390,6710,18
BUSHENYI,2016,3360,3420,6780,18
BUSHENYI,2017,3400,3450,6850,18
BUSHENYI,2018,3440,3480,6920,18
BUSHENYI,2019,3480,3510,6990,18
BUSHENYI,2020,3520,3540,7060,18
BUSHENYI,2021,3550,3560,7110,18
BUSHENYI,2022,3590,3590,7180,18
BUSHENYI,2023,3620,3600,7220,18
BUSHENYI,2024,3640,3620,7260,18
BUSHENYI,2025,3670,3640,7310,18
BUSIA,2015,3510,3750,7260,18
BUSIA,2016,3710,3880,7590,18
BUSIA,2017,3910,4040,7950,18
BUSIA,2018,4120,4210,8330,18
BUSIA,2019,4320,4360,8680,18
BUSIA,2020,4490,4490,8980,18
BUSIA,2021,4630,4570,9200,18
BUSIA,2022,4740,4630,9370,18
BUSIA,2023,4840,4670,9510,18
BUSIA,2024,4930,4720,9650,18
BUSIA,2025,5030,4770,9800,18
BUTALEJA,2015,2530,2620,5150,18
BUTALEJA,2016,2690,2730,5420,18
BUTALEJA,2017,2850,2860,5710,18
BUTALEJA,2018,3020,2990,6010,18
BUTALEJA,2019,3190,3120,6310,18
BUTALEJA,2020,3330,3240,6570,18
BUTALEJA,2021,3460,3310,6770,18
BUTALEJA,2022,3560,3380,6940,18
BUTALEJA,2023,3660,3430,7090,18
BUTALEJA,2024,3750,3490,7240,18
BUTALEJA,2025,3850,3550,7400,18
BUTAMBALA,2015,1110,1100,2210,18
BUTAMBALA,2016,1150,1120,2270,18
BUTAMBALA,2017,1200,1150,2350,18
BUTAMBALA,2018,1230,1170,2400,18
BUTAMBALA,2019,1270,1190,2460,18
BUTAMBALA,2020,1300,1200,2500,18
BUTAMBALA,2021,1310,1200,2510,18
BUTAMBALA,2022,1330,1200,2530,18
BUTAMBALA,2023,1330,1190,2520,18
BUTAMBALA,2024,1330,1180,2510,18
BUTAMBALA,2025,1330,1170,2500,18
BUTEBO,2015,1200,1230,2430,18
BUTEBO,2016,1250,1240,2490,18
BUTEBO,2017,1290,1280,2570,18
BUTEBO,2018,1340,1310,2650,18
BUTEBO,2019,1380,1340,2720,18
BUTEBO,2020,1420,1350,2770,18
BUTEBO,2021,1440,1360,2800,18
BUTEBO,2022,1460,1360,2820,18
BUTEBO,2023,1450,1350,2800,18
BUTEBO,2024,1460,1340,2800,18
BUTEBO,2025,1470,1340,2810,18
BUVUMA,2015,930,890,1820,18
BUVUMA,2016,980,950,1930,18
BUVUMA,2017,1040,1010,2050,18
BUVUMA,2018,1110,1080,2190,18
BUVUMA,2019,1180,1150,2330,18
BUVUMA,2020,1250,1230,2480,18
BUVUMA,2021,1320,1310,2630,18
BUVUMA,2022,1400,1390,2790,18
BUVUMA,2023,1480,1480,2960,18
BUVUMA,2024,1560,1580,3140,18
BUVUMA,2025,1650,1680,3330,18
BUYENDE,2015,3090,3350,6440,18
BUYENDE,2016,3300,3520,6820,18
BUYENDE,2017,3520,3710,7230,18
BUYENDE,2018,3760,3920,7680,18
BUYENDE,2019,3990,4120,8110,18
BUYENDE,2020,4210,4290,8500,18
BUYENDE,2021,4390,4440,8830,18
BUYENDE,2022,4560,4560,9120,18
BUYENDE,2023,4710,4670,9380,18
BUYENDE,2024,4870,4780,9650,18
BUYENDE,2025,5030,4900,9930,18
DOKOLO,2015,2340,2530,4870,18
DOKOLO,2016,2410,2600,5010,18
DOKOLO,2017,2490,2670,5160,18
DOKOLO,2018,2560,2740,5300,18
DOKOLO,2019,2640,2820,5460,18
DOKOLO,2020,2710,2890,5600,18
DOKOLO,2021,2790,2960,5750,18
DOKOLO,2022,2870,3040,5910,18
DOKOLO,2023,2940,3110,6050,18
DOKOLO,2024,3020,3180,6200,18
DOKOLO,2025,3100,3260,6360,18
GOMBA,2015,1770,1420,3190,18
GOMBA,2016,1840,1440,3280,18
GOMBA,2017,1910,1470,3380,18
GOMBA,2018,1980,1510,3490,18
GOMBA,2019,2050,1540,3590,18
GOMBA,2020,2100,1560,3660,18
GOMBA,2021,2150,1570,3720,18
GOMBA,2022,2160,1560,3720,18
GOMBA,2023,2180,1550,3730,18
GOMBA,2024,2190,1530,3720,18
GOMBA,2025,2200,1520,3720,18
GULU,2015,3650,3930,7580,18
GULU,2016,3760,4050,7810,18
GULU,2017,3880,4170,8050,18
GULU,2018,3990,4290,8280,18
GULU,2019,4110,4410,8520,18
GULU,2020,4230,4530,8760,18
GULU,2021,4340,4650,8990,18
GULU,2022,4460,4780,9240,18
GULU,2023,4580,4900,9480,18
GULU,2024,4700,5030,9730,18
GULU,2025,4820,5150,9970,18
HOIMA,2015,3680,4510,8190,18
HOIMA,2016,3820,4670,8490,18
HOIMA,2017,3960,4830,8790,18
HOIMA,2018,4110,4990,9100,18
HOIMA,2019,4260,5160,9420,18
HOIMA,2020,4410,5340,9750,18
HOIMA,2021,4570,5510,10080,18
HOIMA,2022,4730,5680,10410,18
HOIMA,2023,4890,5860,10750,18
HOIMA,2024,5050,6040,11090,18
HOIMA,2025,5210,6220,11430,18
IBANDA,2015,3040,3160,6200,18
IBANDA,2016,3100,3210,6310,18
IBANDA,2017,3160,3270,6430,18
IBANDA,2018,3220,3330,6550,18
IBANDA,2019,3290,3390,6680,18
IBANDA,2020,3340,3440,6780,18
IBANDA,2021,3400,3500,6900,18
IBANDA,2022,3460,3550,7010,18
IBANDA,2023,3520,3600,7120,18
IBANDA,2024,3570,3660,7230,18
IBANDA,2025,3620,3700,7320,18
IGANGA,2015,3830,4050,7880,18
IGANGA,2016,4040,4200,8240,18
IGANGA,2017,4260,4370,8630,18
IGANGA,2018,4480,4550,9030,18
IGANGA,2019,4700,4720,9420,18
IGANGA,2020,4890,4850,9740,18
IGANGA,2021,5040,4940,9980,18
IGANGA,2022,5170,5010,10180,18
IGANGA,2023,5270,5050,10320,18
IGANGA,2024,5380,5100,10480,18
IGANGA,2025,5470,5150,10620,18
ISINGIRO,2015,5170,5590,10760,18
ISINGIRO,2016,5370,5790,11160,18
ISINGIRO,2017,5570,5990,11560,18
ISINGIRO,2018,5770,6200,11970,18
ISINGIRO,2019,5980,6410,12390,18
ISINGIRO,2020,6200,6630,12830,18
ISINGIRO,2021,6410,6850,13260,18
ISINGIRO,2022,6630,7070,13700,18
ISINGIRO,2023,6860,7300,14160,18
ISINGIRO,2024,7080,7530,14610,18
ISINGIRO,2025,7310,7760,15070,18
JINJA,2015,5890,6770,12660,18
JINJA,2016,5990,6880,12870,18
JINJA,2017,6090,6980,13070,18
JINJA,2018,6190,7090,13280,18
JINJA,2019,6280,7190,13470,18
JINJA,2020,6380,7290,13670,18
JINJA,2021,6470,7390,13860,18
JINJA,2022,6560,7480,14040,18
JINJA,2023,6650,7570,14220,18
JINJA,2024,6730,7660,14390,18
JINJA,2025,6810,7740,14550,18
KAABONG,2015,1320,1930,3250,18
KAABONG,2016,1350,1980,3330,18
KAABONG,2017,1390,2030,3420,18
KAABONG,2018,1420,2080,3500,18
KAABONG,2019,1460,2120,3580,18
KAABONG,2020,1500,2170,3670,18
KAABONG,2021,1540,2220,3760,18
KAABONG,2022,1580,2270,3850,18
KAABONG,2023,1610,2320,3930,18
KAABONG,2024,1650,2360,4010,18
KAABONG,2025,1690,2410,4100,18
KABALE,2015,2830,3270,6100,18
KABALE,2016,2880,3310,6190,18
KABALE,2017,2920,3350,6270,18
KABALE,2018,2970,3390,6360,18
KABALE,2019,3010,3420,6430,18
KABALE,2020,3050,3460,6510,18
KABALE,2021,3090,3500,6590,18
KABALE,2022,3130,3530,6660,18
KABALE,2023,3170,3560,6730,18
KABALE,2024,3200,3590,6790,18
KABALE,2025,3240,3610,6850,18
KABAROLE,2015,3890,4050,7940,18
KABAROLE,2016,3980,4140,8120,18
KABAROLE,2017,4070,4230,8300,18
KABAROLE,2018,4160,4320,8480,18
KABAROLE,2019,4240,4410,8650,18
KABAROLE,2020,4330,4500,8830,18
KABAROLE,2021,4420,4590,9010,18
KABAROLE,2022,4500,4680,9180,18
KABAROLE,2023,4580,4760,9340,18
KABAROLE,2024,4660,4850,9510,18
KABAROLE,2025,4740,4930,9670,18
KABERAMAIDO,2015,1200,1150,2350,18
KABERAMAIDO,2016,1270,1200,2470,18
KABERAMAIDO,2017,1360,1260,2620,18
KABERAMAIDO,2018,1440,1330,2770,18
KABERAMAIDO,2019,1540,1390,2930,18
KABERAMAIDO,2020,1610,1440,3050,18
KABERAMAIDO,2021,1680,1480,3160,18
KABERAMAIDO,2022,1750,1530,3280,18
KABERAMAIDO,2023,1790,1550,3340,18
KABERAMAIDO,2024,1850,1590,3440,18
KABERAMAIDO,2025,1910,1620,3530,18
KAGADI,2015,4190,4440,8630,18
KAGADI,2016,4340,4600,8940,18
KAGADI,2017,4500,4760,9260,18
KAGADI,2018,4670,4930,9600,18
KAGADI,2019,4840,5100,9940,18
KAGADI,2020,5010,5270,10280,18
KAGADI,2021,5180,5450,10630,18
KAGADI,2022,5360,5630,10990,18
KAGADI,2023,5540,5810,11350,18
KAGADI,2024,5720,5990,11710,18
KAGADI,2025,5900,6170,12070,18
KAKUMIRO,2015,3210,3620,6830,18
KAKUMIRO,2016,3500,3920,7420,18
KAKUMIRO,2017,3810,4250,8060,18
KAKUMIRO,2018,4140,4610,8750,18
KAKUMIRO,2019,4510,4990,9500,18
KAKUMIRO,2020,4900,5400,10300,18
KAKUMIRO,2021,5320,5850,11170,18
KAKUMIRO,2022,5770,6320,12090,18
KAKUMIRO,2023,6260,6830,13090,18
KAKUMIRO,2024,6780,7380,14160,18
KAKUMIRO,2025,7350,7960,15310,18
KALAKI,2015,1430,1420,2850,18
KALAKI,2016,1490,1480,2970,18
KALAKI,2017,1560,1530,3090,18
KALAKI,2018,1620,1590,3210,18
KALAKI,2019,1690,1660,3350,18
KALAKI,2020,1760,1720,3480,18
KALAKI,2021,1830,1780,3610,18
KALAKI,2022,1910,1850,3760,18
KALAKI,2023,1980,1920,3900,18
KALAKI,2024,2060,1980,4040,18
KALAKI,2025,2140,2050,4190,18
KALANGALA,2015,480,440,920,18
KALANGALA,2016,490,450,940,18
KALANGALA,2017,510,470,980,18
KALANGALA,2018,530,490,1020,18
KALANGALA,2019,550,510,1060,18
KALANGALA,2020,570,530,1100,18
KALANGALA,2021,580,550,1130,18
KALANGALA,2022,600,570,1170,18
KALANGALA,2023,620,600,1220,18
KALANGALA,2024,640,620,1260,18
KALANGALA,2025,660,640,1300,18
KALIRO,2015,2560,2580,5140,18
KALIRO,2016,2710,2690,5400,18
KALIRO,2017,2860,2820,5680,18
KALIRO,2018,3030,2960,5990,18
KALIRO,2019,3190,3080,6270,18
KALIRO,2020,3320,3180,6500,18
KALIRO,2021,3450,3260,6710,18
KALIRO,2022,3540,3330,6870,18
KALIRO,2023,3630,3370,7000,18
KALIRO,2024,3720,3430,7150,18
KALIRO,2025,3810,3480,7290,18
KALUNGU,2015,1970,1920,3890,18
KALUNGU,2016,2040,1950,3990,18
KALUNGU,2017,2110,1990,4100,18
KALUNGU,2018,2180,2030,4210,18
KALUNGU,2019,2240,2070,4310,18
KALUNGU,2020,2280,2090,4370,18
KALUNGU,2021,2310,2080,4390,18
KALUNGU,2022,2310,2070,4380,18
KALUNGU,2023,2320,2050,4370,18
KALUNGU,2024,2320,2040,4360,18
KALUNGU,2025,2320,2020,4340,18
KAMPALA,2015,16750,25040,41790,18
KAMPALA,2016,17080,25540,42620,18
KAMPALA,2017,17420,26030,43450,18
KAMPALA,2018,17760,26520,44280,18
KAMPALA,2019,18090,27020,45110,18
KAMPALA,2020,18420,27500,45920,18
KAMPALA,2021,18740,27980,46720,18
KAMPALA,2022,19060,28450,47510,18
KAMPALA,2023,19360,28900,48260,18
KAMPALA,2024,19660,29350,49010,18
KAMPALA,2025,19940,29780,49720,18
KAMULI,2015,5460,5400,10860,18
KAMULI,2016,5740,5570,11310,18
KAMULI,2017,6020,5760,11780,18
KAMULI,2018,6310,5960,12270,18
KAMULI,2019,6580,6140,12720,18
KAMULI,2020,6810,6270,13080,18
KAMULI,2021,6980,6360,13340,18
KAMULI,2022,7110,6400,13510,18
KAMULI,2023,7220,6430,13650,18
KAMULI,2024,7320,6440,13760,18
KAMULI,2025,7420,6480,13900,18
KAMWENGE,2015,2900,3030,5930,18
KAMWENGE,2016,3020,3140,6160,18
KAMWENGE,2017,3140,3250,6390,18
KAMWENGE,2018,3260,3370,6630,18
KAMWENGE,2019,3390,3490,6880,18
KAMWENGE,2020,3520,3600,7120,18
KAMWENGE,2021,3660,3720,7380,18
KAMWENGE,2022,3800,3840,7640,18
KAMWENGE,2023,3940,3970,7910,18
KAMWENGE,2024,4080,4100,8180,18
KAMWENGE,2025,4230,4220,8450,18
KANUNGU,2015,2990,3250,6240,18
KANUNGU,2016,3040,3300,6340,18
KANUNGU,2017,3100,3350,6450,18
KANUNGU,2018,3150,3410,6560,18
KANUNGU,2019,3210,3460,6670,18
KANUNGU,2020,3260,3510,6770,18
KANUNGU,2021,3310,3560,6870,18
KANUNGU,2022,3360,3610,6970,18
KANUNGU,2023,3410,3660,7070,18
KANUNGU,2024,3460,3700,7160,18
KANUNGU,2025,3500,3740,7240,18
KAPCHORWA,2015,1350,1370,2720,18
KAPCHORWA,2016,1400,1410,2810,18
KAPCHORWA,2017,1440,1450,2890,18
KAPCHORWA,2018,1480,1490,2970,18
KAPCHORWA,2019,1530,1530,3060,18
KAPCHORWA,2020,1570,1570,3140,18
KAPCHORWA,2021,1620,1610,3230,18
KAPCHORWA,2022,1660,1650,3310,18
KAPCHORWA,2023,1700,1690,3390,18
KAPCHORWA,2024,1750,1730,3480,18
KAPCHORWA,2025,1790,1770,3560,18
KAPELEBYONG,2015,1000,1020,2020,18
KAPELEBYONG,2016,1060,1050,2110,18
KAPELEBYONG,2017,1110,1100,2210,18
KAPELEBYONG,2018,1170,1140,2310,18
KAPELEBYONG,2019,1230,1170,2400,18
KAPELEBYONG,2020,1280,1210,2490,18
KAPELEBYONG,2021,1320,1230,2550,18
KAPELEBYONG,2022,1360,1240,2600,18
KAPELEBYONG,2023,1390,1260,2650,18
KAPELEBYONG,2024,1410,1270,2680,18
KAPELEBYONG,2025,1440,1280,2720,18
KASESE,2015,8010,8490,16500,18
KASESE,2016,8400,8740,17140,18
KASESE,2017,8800,9040,17840,18
KASESE,2018,9210,9350,18560,18
KASESE,2019,9590,9610,19200,18
KASESE,2020,9890,9830,19720,18
KASESE,2021,10150,9960,20110,18
KASESE,2022,10310,10020,20330,18
KASESE,2023,10460,10050,20510,18
KASESE,2024,10590,10080,20670,18
KASESE,2025,10710,10120,20830,18
KASSANDA,2015,3400,3280,6680,18
KASSANDA,2016,3500,3360,6860,18
KASSANDA,2017,3600,3430,7030,18
KASSANDA,2018,3700,3500,7200,18
KASSANDA,2019,3800,3570,7370,18
KASSANDA,2020,3900,3650,7550,18
KASSANDA,2021,4010,3720,7730,18
KASSANDA,2022,4110,3780,7890,18
KASSANDA,2023,4210,3860,8070,18
KASSANDA,2024,4310,3920,8230,18
KASSANDA,2025,4410,3990,8400,18
KATAKWI,2015,1870,1820,3690,18
KATAKWI,2016,1970,1880,3850,18
KATAKWI,2017,2070,1950,4020,18
KATAKWI,2018,2180,2020,4200,18
KATAKWI,2019,2270,2080,4350,18
KATAKWI,2020,2360,2140,4500,18
KATAKWI,2021,2440,2170,4610,18
KATAKWI,2022,2480,2200,4680,18
KATAKWI,2023,2530,2210,4740,18
KATAKWI,2024,2580,2230,4810,18
KATAKWI,2025,2620,2240,4860,18
KAYUNGA,2015,4030,3920,7950,18
KAYUNGA,2016,4210,4010,8220,18
KAYUNGA,2017,4380,4130,8510,18
KAYUNGA,2018,4560,4250,8810,18
KAYUNGA,2019,4720,4350,9070,18
KAYUNGA,2020,4870,4420,9290,18
KAYUNGA,2021,4950,4450,9400,18
KAYUNGA,2022,5020,4450,9470,18
KAYUNGA,2023,5060,4450,9510,18
KAYUNGA,2024,5100,4430,9530,18
KAYUNGA,2025,5140,4430,9570,18
KAZO,2015,2110,2080,4190,18
KAZO,2016,2190,2150,4340,18
KAZO,2017,2280,2230,4510,18
KAZO,2018,2360,2310,4670,18
KAZO,2019,2450,2390,4840,18
KAZO,2020,2530,2470,5000,18
KAZO,2021,2630,2550,5180,18
KAZO,2022,2720,2630,5350,18
KAZO,2023,2810,2720,5530,18
KAZO,2024,2910,2800,5710,18
KAZO,2025,3000,2890,5890,18
KIBAALE,2015,1620,1770,3390,18
KIBAALE,2016,1720,1870,3590,18
KIBAALE,2017,1830,1980,3810,18
KIBAALE,2018,1950,2090,4040,18
KIBAALE,2019,2070,2210,4280,18
KIBAALE,2020,2200,2340,4540,18
KIBAALE,2021,2330,2470,4800,18
KIBAALE,2022,2470,2600,5070,18
KIBAALE,2023,2620,2750,5370,18
KIBAALE,2024,2780,2900,5680,18
KIBAALE,2025,2940,3050,5990,18
KIBOGA,2015,1760,1540,3300,18
KIBOGA,2016,1850,1590,3440,18
KIBOGA,2017,1940,1650,3590,18
KIBOGA,2018,2030,1710,3740,18
KIBOGA,2019,2120,1760,3880,18
KIBOGA,2020,2190,1800,3990,18
KIBOGA,2021,2260,1830,4090,18
KIBOGA,2022,2300,1840,4140,18
KIBOGA,2023,2330,1850,4180,18
KIBOGA,2024,2360,1860,4220,18
KIBOGA,2025,2410,1870,4280,18
KIBUKU,2015,2140,2280,4420,18
KIBUKU,2016,2280,2370,4650,18
KIBUKU,2017,2420,2490,4910,18
KIBUKU,2018,2570,2610,5180,18
KIBUKU,2019,2710,2730,5440,18
KIBUKU,2020,2840,2840,5680,18
KIBUKU,2021,2950,2910,5860,18
KIBUKU,2022,3040,2970,6010,18
KIBUKU,2023,3130,3020,6150,18
KIBUKU,2024,3210,3080,6290,18
KIBUKU,2025,3290,3130,6420,18
KIKUUBE,2015,3040,3200,6240,18
KIKUUBE,2016,3200,3370,6570,18
KIKUUBE,2017,3370,3540,6910,18
KIKUUBE,2018,3550,3720,7270,18
KIKUUBE,2019,3740,3900,7640,18
KIKUUBE,2020,3930,4100,8030,18
KIKUUBE,2021,4130,4300,8430,18
KIKUUBE,2022,4340,4500,8840,18
KIKUUBE,2023,4560,4720,9280,18
KIKUUBE,2024,4780,4940,9720,18
KIKUUBE,2025,5010,5170,10180,18
KIRUHURA,2015,1810,1750,3560,18
KIRUHURA,2016,1880,1820,3700,18
KIRUHURA,2017,1950,1880,3830,18
KIRUHURA,2018,2020,1950,3970,18
KIRUHURA,2019,2100,2010,4110,18
KIRUHURA,2020,2180,2080,4260,18
KIRUHURA,2021,2250,2150,4400,18
KIRUHURA,2022,2330,2220,4550,18
KIRUHURA,2023,2410,2290,4700,18
KIRUHURA,2024,2490,2370,4860,18
KIRUHURA,2025,2570,2440,5010,18
KIRYANDONGO,2015,3100,3070,6170,18
KIRYANDONGO,2016,3270,3180,6450,18
KIRYANDONGO,2017,3440,3300,6740,18
KIRYANDONGO,2018,3620,3430,7050,18
KIRYANDONGO,2019,3790,3550,7340,18
KIRYANDONGO,2020,3950,3650,7600,18
KIRYANDONGO,2021,4060,3710,7770,18
KIRYANDONGO,2022,4160,3750,7910,18
KIRYANDONGO,2023,4230,3790,8020,18
KIRYANDONGO,2024,4320,3820,8140,18
KIRYANDONGO,2025,4390,3850,8240,18
KISORO,2015,2800,3530,6330,18
KISORO,2016,2930,3630,6560,18
KISORO,2017,3050,3750,6800,18
KISORO,2018,3170,3870,7040,18
KISORO,2019,3290,3970,7260,18
KISORO,2020,3390,4050,7440,18
KISORO,2021,3460,4090,7550,18
KISORO,2022,3500,4100,7600,18
KISORO,2023,3530,4110,7640,18
KISORO,2024,3550,4110,7660,18
KISORO,2025,3580,4130,7710,18
KITAGWENDA,2015,1610,1580,3190,18
KITAGWENDA,2016,1680,1630,3310,18
KITAGWENDA,2017,1750,1690,3440,18
KITAGWENDA,2018,1820,1750,3570,18
KITAGWENDA,2019,1890,1810,3700,18
KITAGWENDA,2020,1970,1870,3840,18
KITAGWENDA,2021,2040,1940,3980,18
KITAGWENDA,2022,2120,2000,4120,18
KITAGWENDA,2023,2200,2070,4270,18
KITAGWENDA,2024,2270,2130,4400,18
KITAGWENDA,2025,2350,2200,4550,18
KITGUM,2015,2460,2290,4750,18
KITGUM,2016,2570,2360,4930,18
KITGUM,2017,2670,2410,5080,18
KITGUM,2018,2770,2490,5260,18
KITGUM,2019,2860,2540,5400,18
KITGUM,2020,2930,2580,5510,18
KITGUM,2021,2980,2600,5580,18
KITGUM,2022,3000,2590,5590,18
KITGUM,2023,3030,2590,5620,18
KITGUM,2024,3030,2580,5610,18
KITGUM,2025,3050,2580,5630,18
KOBOKO,2015,2550,2510,5060,18
KOBOKO,2016,2720,2630,5350,18
KOBOKO,2017,2890,2770,5660,18
KOBOKO,2018,3070,2900,5970,18
KOBOKO,2019,3230,3030,6260,18
KOBOKO,2020,3400,3150,6550,18
KOBOKO,2021,3540,3240,6780,18
KOBOKO,2022,3650,3320,6970,18
KOBOKO,2023,3760,3380,7140,18
KOBOKO,2024,3860,3440,7300,18
KOBOKO,2025,3960,3510,7470,18
KOLE,2015,2980,3420,6400,18
KOLE,2016,3080,3520,6600,18
KOLE,2017,3180,3620,6800,18
KOLE,2018,3280,3730,7010,18
KOLE,2019,3380,3830,7210,18
KOLE,2020,3490,3930,7420,18
KOLE,2021,3600,4040,7640,18
KOLE,2022,3700,4150,7850,18
KOLE,2023,3810,4250,8060,18
KOLE,2024,3920,4360,8280,18
KOLE,2025,4020,4460,8480,18
KOTIDO,2015,2200,2250,4450,18
KOTIDO,2016,2300,2310,4610,18
KOTIDO,2017,2420,2390,4810,18
KOTIDO,2018,2530,2480,5010,18
KOTIDO,2019,2630,2550,5180,18
KOTIDO,2020,2720,2600,5320,18
KOTIDO,2021,2790,2630,5420,18
KOTIDO,2022,2830,2650,5480,18
KOTIDO,2023,2870,2660,5530,18
KOTIDO,2024,2900,2660,5560,18
KOTIDO,2025,2940,2680,5620,18
KUMI,2015,2600,2560,5160,18
KUMI,2016,2750,2650,5400,18
KUMI,2017,2900,2760,5660,18
KUMI,2018,3060,2870,5930,18
KUMI,2019,3210,2970,6180,18
KUMI,2020,3340,3050,6390,18
KUMI,2021,3450,3110,6560,18
KUMI,2022,3540,3160,6700,18
KUMI,2023,3610,3190,6800,18
KUMI,2024,3680,3220,6900,18
KUMI,2025,3760,3250,7010,18
KWANIA,2015,2390,2550,4940,18
KWANIA,2016,2470,2620,5090,18
KWANIA,2017,2540,2700,5240,18
KWANIA,2018,2620,2770,5390,18
KWANIA,2019,2700,2850,5550,18
KWANIA,2020,2780,2930,5710,18
KWANIA,2021,2860,3010,5870,18
KWANIA,2022,2940,3080,6020,18
KWANIA,2023,3020,3160,6180,18
KWANIA,2024,3100,3240,6340,18
KWANIA,2025,3180,3320,6500,18
KWEEN,2015,1120,1200,2320,18
KWEEN,2016,1150,1230,2380,18
KWEEN,2017,1190,1260,2450,18
KWEEN,2018,1230,1290,2520,18
KWEEN,2019,1260,1320,2580,18
KWEEN,2020,1300,1350,2650,18
KWEEN,2021,1340,1380,2720,18
KWEEN,2022,1380,1410,2790,18
KWEEN,2023,1410,1440,2850,18
KWEEN,2024,1450,1470,2920,18
KWEEN,2025,1490,1500,2990,18
KYANKWANZI,2015,2640,2440,5080,18
KYANKWANZI,2016,2780,2560,5340,18
KYANKWANZI,2017,2920,2680,5600,18
KYANKWANZI,2018,3070,2800,5870,18
KYANKWANZI,2019,3220,2930,6150,18
KYANKWANZI,2020,3380,3060,6440,18
KYANKWANZI,2021,3540,3200,6740,18
KYANKWANZI,2022,3720,3340,7060,18
KYANKWANZI,2023,3890,3480,7370,18
KYANKWANZI,2024,4070,3630,7700,18
KYANKWANZI,2025,4260,3780,8040,18
KYEGEGWA,2015,3310,3460,6770,18
KYEGEGWA,2016,3580,3730,7310,18
KYEGEGWA,2017,3880,4030,7910,18
KYEGEGWA,2018,4190,4340,8530,18
KYEGEGWA,2019,4530,4680,9210,18
KYEGEGWA,2020,4900,5050,9950,18
KYEGEGWA,2021,5290,5440,10730,18
KYEGEGWA,2022,5710,5850,11560,18
KYEGEGWA,2023,6150,6290,12440,18
KYEGEGWA,2024,6630,6760,13390,18
KYEGEGWA,2025,7140,7260,14400,18
KYENJOJO,2015,5080,5300,10380,18
KYENJOJO,2016,5290,5490,10780,18
KYENJOJO,2017,5510,5700,11210,18
KYENJOJO,2018,5740,5900,11640,18
KYENJOJO,2019,5960,6110,12070,18
KYENJOJO,2020,6200,6330,12530,18
KYENJOJO,2021,6440,6550,12990,18
KYENJOJO,2022,6680,6780,13460,18
KYENJOJO,2023,6930,7000,13930,18
KYENJOJO,2024,7180,7230,14410,18
KYENJOJO,2025,7440,7460,14900,18
KYOTERA,2015,2550,2430,4980,18
KYOTERA,2016,2650,2480,5130,18
KYOTERA,2017,2750,2540,5290,18
KYOTERA,2018,2860,2600,5460,18
KYOTERA,2019,2950,2660,5610,18
KYOTERA,2020,3020,2690,5710,18
KYOTERA,2021,3080,2710,5790,18
KYOTERA,2022,3100,2700,5800,18
KYOTERA,2023,3120,2680,5800,18
KYOTERA,2024,3130,2670,5800,18
KYOTERA,2025,3150,2660,5810,18
KARENGA,2015,660,700,1360,18
KARENGA,2016,680,710,1390,18
KARENGA,2017,700,730,1430,18
KARENGA,2018,720,750,1470,18
KARENGA,2019,740,770,1510,18
KARENGA,2020,760,790,1550,18
KARENGA,2021,770,810,1580,18
KARENGA,2022,790,820,1610,18
KARENGA,2023,810,840,1650,18
KARENGA,2024,830,860,1690,18
KARENGA,2025,850,870,1720,18
LAMWO,2015,1400,1240,2640,18
LAMWO,2016,1450,1270,2720,18
LAMWO,2017,1490,1300,2790,18
LAMWO,2018,1540,1340,2880,18
LAMWO,2019,1580,1370,2950,18
LAMWO,2020,1610,1380,2990,18
LAMWO,2021,1620,1390,3010,18
LAMWO,2022,1630,1390,3020,18
LAMWO,2023,1630,1380,3010,18
LAMWO,2024,1630,1380,3010,18
LAMWO,2025,1620,1370,2990,18
LIRA,2015,5440,6230,11670,18
LIRA,2016,5600,6410,12010,18
LIRA,2017,5760,6590,12350,18
LIRA,2018,5920,6780,12700,18
LIRA,2019,6080,6970,13050,18
LIRA,2020,6240,7160,13400,18
LIRA,2021,6400,7350,13750,18
LIRA,2022,6560,7540,14100,18
LIRA,2023,6720,7720,14440,18
LIRA,2024,6880,7910,14790,18
LIRA,2025,7030,8100,15130,18
LUUKA,2015,2690,2670,5360,18
LUUKA,2016,2810,2740,5550,18
LUUKA,2017,2930,2830,5760,18
LUUKA,2018,3060,2930,5990,18
LUUKA,2019,3170,3000,6170,18
LUUKA,2020,3260,3060,6320,18
LUUKA,2021,3330,3100,6430,18
LUUKA,2022,3370,3100,6470,18
LUUKA,2023,3400,3110,6510,18
LUUKA,2024,3430,3110,6540,18
LUUKA,2025,3470,3120,6590,18
LUWERO,2015,5310,5160,10470,18
LUWERO,2016,5560,5310,10870,18
LUWERO,2017,5830,5500,11330,18
LUWERO,2018,6100,5690,11790,18
LUWERO,2019,6360,5850,12210,18
LUWERO,2020,6580,5990,12570,18
LUWERO,2021,6740,6070,12810,18
LUWERO,2022,6860,6100,12960,18
LUWERO,2023,6970,6130,13100,18
LUWERO,2024,7050,6150,13200,18
LUWERO,2025,7150,6180,13330,18
LWENGO,2015,2620,2610,5230,18
LWENGO,2016,2720,2650,5370,18
LWENGO,2017,2800,2700,5500,18
LWENGO,2018,2890,2770,5660,18
LWENGO,2019,2970,2800,5770,18
LWENGO,2020,3020,2840,5860,18
LWENGO,2021,3060,2830,5890,18
LWENGO,2022,3070,2820,5890,18
LWENGO,2023,3070,2790,5860,18
LWENGO,2024,3060,2760,5820,18
LWENGO,2025,3060,2740,5800,18
LYANTONDE,2015,950,1000,1950,18
LYANTONDE,2016,1000,1030,2030,18
LYANTONDE,2017,1060,1070,2130,18
LYANTONDE,2018,1110,1110,2220,18
LYANTONDE,2019,1160,1160,2320,18
LYANTONDE,2020,1210,1190,2400,18
LYANTONDE,2021,1240,1200,2440,18
LYANTONDE,2022,1280,1220,2500,18
LYANTONDE,2023,1310,1230,2540,18
LYANTONDE,2024,1320,1240,2560,18
LYANTONDE,2025,1350,1260,2610,18
MANAFWA,2015,1870,1970,3840,18
MANAFWA,2016,1920,2020,3940,18
MANAFWA,2017,1970,2060,4030,18
MANAFWA,2018,2020,2100,4120,18
MANAFWA,2019,2070,2150,4220,18
MANAFWA,2020,2120,2200,4320,18
MANAFWA,2021,2160,2240,4400,18
MANAFWA,2022,2210,2280,4490,18
MANAFWA,2023,2260,2330,4590,18
MANAFWA,2024,2300,2370,4670,18
MANAFWA,2025,2350,2410,4760,18
MARACHA,2015,2010,2360,4370,18
MARACHA,2016,2050,2400,4450,18
MARACHA,2017,2100,2450,4550,18
MARACHA,2018,2140,2500,4640,18
MARACHA,2019,2180,2540,4720,18
MARACHA,2020,2220,2590,4810,18
MARACHA,2021,2270,2630,4900,18
MARACHA,2022,2310,2680,4990,18
MARACHA,2023,2350,2720,5070,18
MARACHA,2024,2390,2760,5150,18
MARACHA,2025,2420,2800,5220,18
MASAKA,2015,3180,3220,6400,18
MASAKA,2016,3320,3310,6630,18
MASAKA,2017,3480,3420,6900,18
MASAKA,2018,3630,3530,7160,18
MASAKA,2019,3770,3620,7390,18
MASAKA,2020,3900,3700,7600,18
MASAKA,2021,3980,3740,7720,18
MASAKA,2022,4040,3760,7800,18
MASAKA,2023,4090,3770,7860,18
MASAKA,2024,4130,3770,7900,18
MASAKA,2025,4170,3780,7950,18
MASINDI,2015,3570,3620,7190,18
MASINDI,2016,3670,3720,7390,18
MASINDI,2017,3780,3820,7600,18
MASINDI,2018,3890,3920,7810,18
MASINDI,2019,4000,4020,8020,18
MASINDI,2020,4110,4120,8230,18
MASINDI,2021,4220,4220,8440,18
MASINDI,2022,4330,4330,8660,18
MASINDI,2023,4440,4430,8870,18
MASINDI,2024,4550,4530,9080,18
MASINDI,2025,4660,4630,9290,18
MAYUGE,2015,4990,5330,10320,18
MAYUGE,2016,5270,5540,10810,18
MAYUGE,2017,5560,5780,11340,18
MAYUGE,2018,5860,6030,11890,18
MAYUGE,2019,6140,6250,12390,18
MAYUGE,2020,6390,6450,12840,18
MAYUGE,2021,6590,6580,13170,18
MAYUGE,2022,6750,6680,13430,18
MAYUGE,2023,6890,6760,13650,18
MAYUGE,2024,7020,6830,13850,18
MAYUGE,2025,7160,6920,14080,18
MBALE,2015,5260,6300,11560,18
MBALE,2016,5540,6550,12090,18
MBALE,2017,5830,6850,12680,18
MBALE,2018,6140,7160,13300,18
MBALE,2019,6430,7450,13880,18
MBALE,2020,6690,7700,14390,18
MBALE,2021,6890,7880,14770,18
MBALE,2022,7050,8010,15060,18
MBALE,2023,7190,8120,15310,18
MBALE,2024,7320,8240,15560,18
MBALE,2025,7460,8360,15820,18
MBARARA,2015,4290,4800,9090,18
MBARARA,2016,4390,4900,9290,18
MBARARA,2017,4490,5010,9500,18
MBARARA,2018,4590,5110,9700,18
MBARARA,2019,4700,5220,9920,18
MBARARA,2020,4800,5330,10130,18
MBARARA,2021,4900,5430,10330,18
MBARARA,2022,4990,5530,10520,18
MBARARA,2023,5090,5630,10720,18
MBARARA,2024,5180,5730,10910,18
MBARARA,2025,5280,5830,11110,18
MITOOMA,2015,2240,2590,4830,18
MITOOMA,2016,2260,2610,4870,18
MITOOMA,2017,2290,2640,4930,18
MITOOMA,2018,2320,2660,4980,18
MITOOMA,2019,2340,2680,5020,18
MITOOMA,2020,2370,2700,5070,18
MITOOMA,2021,2390,2720,5110,18
MITOOMA,2022,2410,2740,5150,18
MITOOMA,2023,2430,2760,5190,18
MITOOMA,2024,2450,2770,5220,18
MITOOMA,2025,2470,2790,5260,18
MITYANA,2015,3740,3560,7300,18
MITYANA,2016,3900,3640,7540,18
MITYANA,2017,4060,3740,7800,18
MITYANA,2018,4220,3850,8070,18
MITYANA,2019,4370,3930,8300,18
MITYANA,2020,4490,3990,8480,18
MITYANA,2021,4560,4020,8580,18
MITYANA,2022,4620,4020,8640,18
MITYANA,2023,4650,4010,8660,18
MITYANA,2024,4680,4000,8680,18
MITYANA,2025,4710,3990,8700,18
MOROTO,2015,930,1090,2020,18
MOROTO,2016,970,1130,2100,18
MOROTO,2017,1010,1170,2180,18
MOROTO,2018,1060,1210,2270,18
MOROTO,2019,1100,1260,2360,18
MOROTO,2020,1140,1290,2430,18
MOROTO,2021,1160,1300,2460,18
MOROTO,2022,1190,1310,2500,18
MOROTO,2023,1200,1330,2530,18
MOROTO,2024,1210,1340,2550,18
MOROTO,2025,1220,1340,2560,18
MOYO,2015,1250,1180,2430,18
MOYO,2016,1270,1210,2480,18
MOYO,2017,1310,1240,2550,18
MOYO,2018,1340,1270,2610,18
MOYO,2019,1380,1290,2670,18
MOYO,2020,1410,1320,2730,18
MOYO,2021,1440,1340,2780,18
MOYO,2022,1470,1370,2840,18
MOYO,2023,1510,1390,2900,18
MOYO,2024,1540,1420,2960,18
MOYO,2025,1560,1450,3010,18
MPIGI,2015,2800,2600,5400,18
MPIGI,2016,2930,2680,5610,18
MPIGI,2017,3070,2770,5840,18
MPIGI,2018,3210,2860,6070,18
MPIGI,2019,3340,2950,6290,18
MPIGI,2020,3460,3020,6480,18
MPIGI,2021,3540,3060,6600,18
MPIGI,2022,3600,3080,6680,18
MPIGI,2023,3650,3100,6750,18
MPIGI,2024,3690,3110,6800,18
MPIGI,2025,3730,3120,6850,18
MUBENDE,2015,4640,4620,9260,18
MUBENDE,2016,4990,4900,9890,18
MUBENDE,2017,5380,5210,10590,18
MUBENDE,2018,5780,5550,11330,18
MUBENDE,2019,6190,5870,12060,18
MUBENDE,2020,6580,6170,12750,18
MUBENDE,2021,6930,6430,13360,18
MUBENDE,2022,7240,6650,13890,18
MUBENDE,2023,7540,6870,14410,18
MUBENDE,2024,7850,7090,14940,18
MUBENDE,2025,8170,7310,15480,18
MUKONO,2015,6400,7080,13480,18
MUKONO,2016,6720,7350,14070,18
MUKONO,2017,7060,7650,14710,18
MUKONO,2018,7410,7970,15380,18
MUKONO,2019,7730,8260,15990,18
MUKONO,2020,8010,8500,16510,18
MUKONO,2021,8230,8670,16900,18
MUKONO,2022,8400,8790,17190,18
MUKONO,2023,8530,8880,17410,18
MUKONO,2024,8660,8970,17630,18
MUKONO,2025,8790,9060,17850,18
MADI OKOLLO,2015,1790,1870,3660,18
MADI OKOLLO,2016,1840,1930,3770,18
MADI OKOLLO,2017,1900,1970,3870,18
MADI OKOLLO,2018,1950,2030,3980,18
MADI OKOLLO,2019,2010,2080,4090,18
MADI OKOLLO,2020,2070,2130,4200,18
MADI OKOLLO,2021,2120,2190,4310,18
MADI OKOLLO,2022,2170,2240,4410,18
MADI OKOLLO,2023,2230,2290,4520,18
MADI OKOLLO,2024,2280,2340,4620,18
MADI OKOLLO,2025,2340,2400,4740,18
NABILATUK,2015,810,920,1730,18
NABILATUK,2016,860,960,1820,18
NABILATUK,2017,930,1020,1950,18
NABILATUK,2018,1000,1080,2080,18
NABILATUK,2019,1060,1140,2200,18
NABILATUK,2020,1130,1190,2320,18
NABILATUK,2021,1180,1220,2400,18
NABILATUK,2022,1240,1260,2500,18
NABILATUK,2023,1290,1290,2580,18
NABILATUK,2024,1330,1330,2660,18
NABILATUK,2025,1380,1360,2740,18
NAKAPIRIPIRIT,2015,910,1080,1990,18
NAKAPIRIPIRIT,2016,960,1140,2100,18
NAKAPIRIPIRIT,2017,1030,1200,2230,18
NAKAPIRIPIRIT,2018,1100,1270,2370,18
NAKAPIRIPIRIT,2019,1170,1330,2500,18
NAKAPIRIPIRIT,2020,1230,1390,2620,18
NAKAPIRIPIRIT,2021,1280,1440,2720,18
NAKAPIRIPIRIT,2022,1340,1470,2810,18
NAKAPIRIPIRIT,2023,1380,1510,2890,18
NAKAPIRIPIRIT,2024,1420,1550,2970,18
NAKAPIRIPIRIT,2025,1470,1580,3050,18
NAKASEKE,2015,2520,2260,4780,18
NAKASEKE,2016,2620,2320,4940,18
NAKASEKE,2017,2710,2370,5080,18
NAKASEKE,2018,2810,2430,5240,18
NAKASEKE,2019,2910,2480,5390,18
NAKASEKE,2020,3010,2540,5550,18
NAKASEKE,2021,3110,2600,5710,18
NAKASEKE,2022,3220,2650,5870,18
NAKASEKE,2023,3320,2700,6020,18
NAKASEKE,2024,3430,2760,6190,18
NAKASEKE,2025,3540,2810,6350,18
NAKASONGOLA,2015,2220,1960,4180,18
NAKASONGOLA,2016,2340,2020,4360,18
NAKASONGOLA,2017,2480,2110,4590,18
NAKASONGOLA,2018,2610,2190,4800,18
NAKASONGOLA,2019,2740,2260,5000,18
NAKASONGOLA,2020,2840,2320,5160,18
NAKASONGOLA,2021,2940,2360,5300,18
NAKASONGOLA,2022,3010,2390,5400,18
NAKASONGOLA,2023,3080,2410,5490,18
NAKASONGOLA,2024,3140,2430,5570,18
NAKASONGOLA,2025,3200,2450,5650,18
NAMAYINGO,2015,2140,2290,4430,18
NAMAYINGO,2016,2240,2350,4590,18
NAMAYINGO,2017,2320,2410,4730,18
NAMAYINGO,2018,2420,2480,4900,18
NAMAYINGO,2019,2510,2520,5030,18
NAMAYINGO,2020,2570,2560,5130,18
NAMAYINGO,2021,2630,2580,5210,18
NAMAYINGO,2022,2650,2570,5220,18
NAMAYINGO,2023,2670,2560,5230,18
NAMAYINGO,2024,2690,2550,5240,18
NAMAYINGO,2025,2710,2550,5260,18
NAMISINDWA,2015,2230,2420,4650,18
NAMISINDWA,2016,2300,2480,4780,18
NAMISINDWA,2017,2360,2540,4900,18
NAMISINDWA,2018,2420,2600,5020,18
NAMISINDWA,2019,2490,2660,5150,18
NAMISINDWA,2020,2550,2710,5260,18
NAMISINDWA,2021,2620,2770,5390,18
NAMISINDWA,2022,2690,2830,5520,18
NAMISINDWA,2023,2750,2890,5640,18
NAMISINDWA,2024,2820,2950,5770,18
NAMISINDWA,2025,2880,3000,5880,18
NAMUTUMBA,2015,2760,2670,5430,18
NAMUTUMBA,2016,2920,2780,5700,18
NAMUTUMBA,2017,3100,2900,6000,18
NAMUTUMBA,2018,3270,3040,6310,18
NAMUTUMBA,2019,3440,3160,6600,18
NAMUTUMBA,2020,3600,3250,6850,18
NAMUTUMBA,2021,3730,3330,7060,18
NAMUTUMBA,2022,3830,3390,7220,18
NAMUTUMBA,2023,3920,3430,7350,18
NAMUTUMBA,2024,4010,3480,7490,18
NAMUTUMBA,2025,4110,3540,7650,18
NAPAK,2015,1390,1550,2940,18
NAPAK,2016,1450,1590,3040,18
NAPAK,2017,1510,1640,3150,18
NAPAK,2018,1560,1700,3260,18
NAPAK,2019,1620,1740,3360,18
NAPAK,2020,1660,1780,3440,18
NAPAK,2021,1680,1800,3480,18
NAPAK,2022,1710,1810,3520,18
NAPAK,2023,1710,1810,3520,18
NAPAK,2024,1720,1810,3530,18
NAPAK,2025,1720,1820,3540,18
NEBBI,2015,2920,3350,6270,18
NEBBI,2016,3020,3440,6460,18
NEBBI,2017,3110,3540,6650,18
NEBBI,2018,3210,3640,6850,18
NEBBI,2019,3310,3740,7050,18
NEBBI,2020,3410,3840,7250,18
NEBBI,2021,3510,3940,7450,18
NEBBI,2022,3610,4040,7650,18
NEBBI,2023,3710,4140,7850,18
NEBBI,2024,3810,4240,8050,18
NEBBI,2025,3920,4340,8260,18
NGORA,2015,1660,1590,3250,18
NGORA,2016,1750,1630,3380,18
NGORA,2017,1840,1700,3540,18
NGORA,2018,1930,1760,3690,18
NGORA,2019,2020,1820,3840,18
NGORA,2020,2090,1870,3960,18
NGORA,2021,2160,1900,4060,18
NGORA,2022,2200,1920,4120,18
NGORA,2023,2240,1930,4170,18
NGORA,2024,2280,1940,4220,18
NGORA,2025,2320,1960,4280,18
NTOROKO,2015,760,840,1600,18
NTOROKO,2016,800,860,1660,18
NTOROKO,2017,830,880,1710,18
NTOROKO,2018,870,910,1780,18
NTOROKO,2019,910,940,1850,18
NTOROKO,2020,940,960,1900,18
NTOROKO,2021,960,970,1930,18
NTOROKO,2022,980,970,1950,18
NTOROKO,2023,1000,970,1970,18
NTOROKO,2024,1010,970,1980,18
NTOROKO,2025,1020,980,2000,18
NTUNGAMO,2015,5850,6050,11900,18
NTUNGAMO,2016,5980,6170,12150,18
NTUNGAMO,2017,6110,6280,12390,18
NTUNGAMO,2018,6230,6390,12620,18
NTUNGAMO,2019,6360,6510,12870,18
NTUNGAMO,2020,6490,6620,13110,18
NTUNGAMO,2021,6610,6730,13340,18
NTUNGAMO,2022,6740,6830,13570,18
NTUNGAMO,2023,6860,6940,13800,18
NTUNGAMO,2024,6970,7040,14010,18
NTUNGAMO,2025,7090,7140,14230,18
NWOYA,2015,1640,1740,3380,18
NWOYA,2016,1810,1920,3730,18
NWOYA,2017,2000,2120,4120,18
NWOYA,2018,2210,2330,4540,18
NWOYA,2019,2440,2570,5010,18
NWOYA,2020,2690,2820,5510,18
NWOYA,2021,2970,3100,6070,18
NWOYA,2022,3270,3410,6680,18
NWOYA,2023,3600,3750,7350,18
NWOYA,2024,3960,4110,8070,18
NWOYA,2025,4350,4510,8860,18
OBONGI,2015,510,460,970,18
OBONGI,2016,540,480,1020,18
OBONGI,2017,560,500,1060,18
OBONGI,2018,600,520,1120,18
OBONGI,2019,620,530,1150,18
OBONGI,2020,630,540,1170,18
OBONGI,2021,650,550,1200,18
OBONGI,2022,660,550,1210,18
OBONGI,2023,670,550,1220,18
OBONGI,2024,680,560,1240,18
OBONGI,2025,690,560,1250,18
OMORO,2015,2010,1870,3880,18
OMORO,2016,2130,1950,4080,18
OMORO,2017,2250,2040,4290,18
OMORO,2018,2370,2140,4510,18
OMORO,2019,2500,2220,4720,18
OMORO,2020,2610,2310,4920,18
OMORO,2021,2710,2360,5070,18
OMORO,2022,2780,2400,5180,18
OMORO,2023,2860,2440,5300,18
OMORO,2024,2920,2480,5400,18
OMORO,2025,2990,2530,5520,18
OTUKE,2015,1310,1320,2630,18
OTUKE,2016,1370,1370,2740,18
OTUKE,2017,1430,1430,2860,18
OTUKE,2018,1490,1490,2980,18
OTUKE,2019,1560,1560,3120,18
OTUKE,2020,1630,1620,3250,18
OTUKE,2021,1700,1690,3390,18
OTUKE,2022,1770,1750,3520,18
OTUKE,2023,1840,1820,3660,18
OTUKE,2024,1910,1890,3800,18
OTUKE,2025,1990,1970,3960,18
OYAM,2015,4630,5260,9890,18
OYAM,2016,4770,5420,10190,18
OYAM,2017,4910,5570,10480,18
OYAM,2018,5060,5730,10790,18
OYAM,2019,5210,5900,11110,18
OYAM,2020,5360,6060,11420,18
OYAM,2021,5510,6220,11730,18
OYAM,2022,5670,6390,12060,18
OYAM,2023,5820,6550,12370,18
OYAM,2024,5970,6720,12690,18
OYAM,2025,6120,6880,13000,18
PADER,2015,2110,1920,4030,18
PADER,2016,2190,1970,4160,18
PADER,2017,2290,2030,4320,18
PADER,2018,2370,2090,4460,18
PADER,2019,2450,2150,4600,18
PADER,2020,2510,2190,4700,18
PADER,2021,2560,2210,4770,18
PADER,2022,2580,2220,4800,18
PADER,2023,2600,2220,4820,18
PADER,2024,2610,2210,4820,18
PADER,2025,2630,2220,4850,18
PAKWACH,2015,1970,2190,4160,18
PAKWACH,2016,2060,2270,4330,18
PAKWACH,2017,2140,2350,4490,18
PAKWACH,2018,2230,2440,4670,18
PAKWACH,2019,2320,2520,4840,18
PAKWACH,2020,2410,2610,5020,18
PAKWACH,2021,2510,2700,5210,18
PAKWACH,2022,2610,2790,5400,18
PAKWACH,2023,2710,2890,5600,18
PAKWACH,2024,2810,2980,5790,18
PAKWACH,2025,2910,3070,5980,18
PALLISA,2015,3140,3080,6220,18
PALLISA,2016,3360,3240,6600,18
PALLISA,2017,3590,3420,7010,18
PALLISA,2018,3830,3610,7440,18
PALLISA,2019,4070,3790,7860,18
PALLISA,2020,4290,3950,8240,18
PALLISA,2021,4480,4080,8560,18
PALLISA,2022,4650,4190,8840,18
PALLISA,2023,4810,4300,9110,18
PALLISA,2024,4960,4400,9360,18
PALLISA,2025,5130,4510,9640,18
RAKAI,2015,2590,2560,5150,18
RAKAI,2016,2730,2630,5360,18
RAKAI,2017,2850,2720,5570,18
RAKAI,2018,2990,2820,5810,18
RAKAI,2019,3120,2900,6020,18
RAKAI,2020,3220,2960,6180,18
RAKAI,2021,3310,3010,6320,18
RAKAI,2022,3370,3030,6400,18
RAKAI,2023,3410,3040,6450,18
RAKAI,2024,3460,3050,6510,18
RAKAI,2025,3510,3060,6570,18
RUBANDA,2015,2190,2470,4660,18
RUBANDA,2016,2220,2490,4710,18
RUBANDA,2017,2250,2510,4760,18
RUBANDA,2018,2280,2520,4800,18
RUBANDA,2019,2310,2540,4850,18
RUBANDA,2020,2340,2560,4900,18
RUBANDA,2021,2360,2580,4940,18
RUBANDA,2022,2390,2590,4980,18
RUBANDA,2023,2410,2600,5010,18
RUBANDA,2024,2430,2610,5040,18
RUBANDA,2025,2450,2620,5070,18
RUBIRIZI,2015,1450,1500,2950,18
RUBIRIZI,2016,1480,1530,3010,18
RUBIRIZI,2017,1510,1560,3070,18
RUBIRIZI,2018,1540,1590,3130,18
RUBIRIZI,2019,1570,1620,3190,18
RUBIRIZI,2020,1600,1650,3250,18
RUBIRIZI,2021,1630,1670,3300,18
RUBIRIZI,2022,1660,1700,3360,18
RUBIRIZI,2023,1690,1730,3420,18
RUBIRIZI,2024,1720,1760,3480,18
RUBIRIZI,2025,1740,1780,3520,18
RUKIGA,2015,1220,1250,2470,18
RUKIGA,2016,1230,1260,2490,18
RUKIGA,2017,1240,1270,2510,18
RUKIGA,2018,1250,1280,2530,18
RUKIGA,2019,1270,1280,2550,18
RUKIGA,2020,1280,1290,2570,18
RUKIGA,2021,1290,1300,2590,18
RUKIGA,2022,1300,1300,2600,18
RUKIGA,2023,1300,1310,2610,18
RUKIGA,2024,1310,1310,2620,18
RUKIGA,2025,1320,1320,2640,18
RUKUNGIRI,2015,3990,4260,8250,18
RUKUNGIRI,2016,4040,4300,8340,18
RUKUNGIRI,2017,4090,4340,8430,18
RUKUNGIRI,2018,4140,4380,8520,18
RUKUNGIRI,2019,4190,4420,8610,18
RUKUNGIRI,2020,4230,4460,8690,18
RUKUNGIRI,2021,4270,4490,8760,18
RUKUNGIRI,2022,4310,4520,8830,18
RUKUNGIRI,2023,4350,4550,8900,18
RUKUNGIRI,2024,4380,4580,8960,18
RUKUNGIRI,2025,4410,4600,9010,18
RWAMPARA,2015,1580,1600,3180,18
RWAMPARA,2016,1620,1630,3250,18
RWAMPARA,2017,1660,1670,3330,18
RWAMPARA,2018,1690,1700,3390,18
RWAMPARA,2019,1730,1740,3470,18
RWAMPARA,2020,1770,1770,3540,18
RWAMPARA,2021,1800,1810,3610,18
RWAMPARA,2022,1840,1840,3680,18
RWAMPARA,2023,1870,1880,3750,18
RWAMPARA,2024,1910,1910,3820,18
RWAMPARA,2025,1940,1940,3880,18
SERERE,2015,3170,3280,6450,18
SERERE,2016,3370,3420,6790,18
SERERE,2017,3600,3610,7210,18
SERERE,2018,3820,3800,7620,18
SERERE,2019,4040,3970,8010,18
SERERE,2020,4250,4120,8370,18
SERERE,2021,4420,4250,8670,18
SERERE,2022,4570,4350,8920,18
SERERE,2023,4700,4440,9140,18
SERERE,2024,4840,4530,9370,18
SERERE,2025,4980,4620,9600,18
SHEEMA,2015,2750,2860,5610,18
SHEEMA,2016,2790,2890,5680,18
SHEEMA,2017,2820,2920,5740,18
SHEEMA,2018,2850,2950,5800,18
SHEEMA,2019,2880,2980,5860,18
SHEEMA,2020,2910,3010,5920,18
SHEEMA,2021,2950,3030,5980,18
SHEEMA,2022,2970,3050,6020,18
SHEEMA,2023,3000,3080,6080,18
SHEEMA,2024,3020,3100,6120,18
SHEEMA,2025,3040,3120,6160,18
SIRONKO,2015,3070,3000,6070,18
SIRONKO,2016,3150,3060,6210,18
SIRONKO,2017,3220,3120,6340,18
SIRONKO,2018,3300,3180,6480,18
SIRONKO,2019,3370,3240,6610,18
SIRONKO,2020,3450,3300,6750,18
SIRONKO,2021,3520,3360,6880,18
SIRONKO,2022,3600,3430,7030,18
SIRONKO,2023,3670,3480,7150,18
SIRONKO,2024,3740,3540,7280,18
SIRONKO,2025,3810,3600,7410,18
SOROTI,2015,3700,3840,7540,18
SOROTI,2016,3920,4000,7920,18
SOROTI,2017,4160,4190,8350,18
SOROTI,2018,4400,4380,8780,18
SOROTI,2019,4630,4560,9190,18
SOROTI,2020,4850,4720,9570,18
SOROTI,2021,5020,4840,9860,18
SOROTI,2022,5170,4930,10100,18
SOROTI,2023,5300,5020,10320,18
SOROTI,2024,5430,5090,10520,18
SOROTI,2025,5560,5180,10740,18
SSEMBABULE,2015,2570,2460,5030,18
SSEMBABULE,2016,2710,2550,5260,18
SSEMBABULE,2017,2850,2650,5500,18
SSEMBABULE,2018,3000,2750,5750,18
SSEMBABULE,2019,3140,2840,5980,18
SSEMBABULE,2020,3250,2920,6170,18
SSEMBABULE,2021,3350,2970,6320,18
SSEMBABULE,2022,3420,3000,6420,18
SSEMBABULE,2023,3480,3020,6500,18
SSEMBABULE,2024,3540,3040,6580,18
SSEMBABULE,2025,3600,3070,6670,18
TORORO,2015,6200,6710,12910,18
TORORO,2016,6370,6880,13250,18
TORORO,2017,6540,7050,13590,18
TORORO,2018,6710,7220,13930,18
TORORO,2019,6880,7400,14280,18
TORORO,2020,7060,7570,14630,18
TORORO,2021,7230,7740,14970,18
TORORO,2022,7400,7920,15320,18
TORORO,2023,7570,8090,15660,18
TORORO,2024,7740,8260,16000,18
TORORO,2025,7900,8420,16320,18
WAKISO,2015,22380,32120,54500,18
WAKISO,2016,23870,34310,58180,18
WAKISO,2017,25470,36670,62140,18
WAKISO,2018,27160,39150,66310,18
WAKISO,2019,28970,41780,70750,18
WAKISO,2020,30860,44550,75410,18
WAKISO,2021,32840,47510,80350,18
WAKISO,2022,34950,50650,85600,18
WAKISO,2023,37160,53900,91060,18
WAKISO,2024,39470,57330,96800,18
WAKISO,2025,41900,60980,102880,18
YUMBE,2015,5140,5430,10570,18
YUMBE,2016,5530,5800,11330,18
YUMBE,2017,5940,6210,12150,18
YUMBE,2018,6380,6660,13040,18
YUMBE,2019,6820,7100,13920,18
YUMBE,2020,7230,7520,14750,18
YUMBE,2021,7600,7900,15500,18
YUMBE,2022,7940,8230,16170,18
YUMBE,2023,8260,8560,16820,18
YUMBE,2024,8580,8900,17480,18
YUMBE,2025,8920,9250,18170,18
ZOMBO,2015,2520,2980,5500,18
ZOMBO,2016,2600,3060,5660,18
ZOMBO,2017,2680,3150,5830,18
ZOMBO,2018,2760,3230,5990,18
ZOMBO,2019,2850,3320,6170,18
ZOMBO,2020,2930,3410,6340,18
ZOMBO,2021,3010,3500,6510,18
ZOMBO,2022,3100,3590,6690,18
ZOMBO,2023,3180,3670,6850,18
ZOMBO,2024,3260,3760,7020,18
ZOMBO,2025,3350,3850,7200,18
ABIM,2015,960,1190,2150,19
ABIM,2016,1040,1260,2300,19
ABIM,2017,1140,1340,2480,19
ABIM,2018,1230,1440,2670,19
ABIM,2019,1330,1550,2880,19
ABIM,2020,1450,1660,3110,19
ABIM,2021,1560,1760,3320,19
ABIM,2022,1650,1840,3490,19
ABIM,2023,1750,1930,3680,19
ABIM,2024,1830,2000,3830,19
ABIM,2025,1930,2090,4020,19
ADJUMANI,2015,1890,2130,4020,19
ADJUMANI,2016,1900,2150,4050,19
ADJUMANI,2017,1920,2170,4090,19
ADJUMANI,2018,1930,2190,4120,19
ADJUMANI,2019,1940,2210,4150,19
ADJUMANI,2020,1950,2230,4180,19
ADJUMANI,2021,1960,2250,4210,19
ADJUMANI,2022,1970,2260,4230,19
ADJUMANI,2023,1980,2280,4260,19
ADJUMANI,2024,1980,2290,4270,19
ADJUMANI,2025,1990,2300,4290,19
AGAGO,2015,1780,2100,3880,19
AGAGO,2016,1810,2140,3950,19
AGAGO,2017,1840,2180,4020,19
AGAGO,2018,1870,2220,4090,19
AGAGO,2019,1900,2250,4150,19
AGAGO,2020,1940,2290,4230,19
AGAGO,2021,1960,2320,4280,19
AGAGO,2022,1990,2360,4350,19
AGAGO,2023,2020,2390,4410,19
AGAGO,2024,2050,2430,4480,19
AGAGO,2025,2070,2460,4530,19
ALEBTONG,2015,2210,2510,4720,19
ALEBTONG,2016,2330,2580,4910,19
ALEBTONG,2017,2440,2660,5100,19
ALEBTONG,2018,2570,2770,5340,19
ALEBTONG,2019,2690,2880,5570,19
ALEBTONG,2020,2810,2980,5790,19
ALEBTONG,2021,2920,3050,5970,19
ALEBTONG,2022,3000,3100,6100,19
ALEBTONG,2023,3060,3140,6200,19
ALEBTONG,2024,3110,3150,6260,19
ALEBTONG,2025,3150,3180,6330,19
AMOLATAR,2015,1600,1610,3210,19
AMOLATAR,2016,1680,1650,3330,19
AMOLATAR,2017,1760,1700,3460,19
AMOLATAR,2018,1840,1760,3600,19
AMOLATAR,2019,1930,1830,3760,19
AMOLATAR,2020,2020,1880,3900,19
AMOLATAR,2021,2090,1920,4010,19
AMOLATAR,2022,2140,1950,4090,19
AMOLATAR,2023,2180,1970,4150,19
AMOLATAR,2024,2210,1980,4190,19
AMOLATAR,2025,2250,1980,4230,19
AMUDAT,2015,920,890,1810,19
AMUDAT,2016,970,930,1900,19
AMUDAT,2017,1040,980,2020,19
AMUDAT,2018,1100,1040,2140,19
AMUDAT,2019,1170,1100,2270,19
AMUDAT,2020,1230,1160,2390,19
AMUDAT,2021,1290,1200,2490,19
AMUDAT,2022,1350,1250,2600,19
AMUDAT,2023,1390,1290,2680,19
AMUDAT,2024,1420,1320,2740,19
AMUDAT,2025,1460,1350,2810,19
AMURIA,2015,2130,2090,4220,19
AMURIA,2016,2260,2160,4420,19
AMURIA,2017,2390,2240,4630,19
AMURIA,2018,2540,2350,4890,19
AMURIA,2019,2690,2460,5150,19
AMURIA,2020,2840,2560,5400,19
AMURIA,2021,2970,2650,5620,19
AMURIA,2022,3080,2700,5780,19
AMURIA,2023,3180,2760,5940,19
AMURIA,2024,3250,2800,6050,19
AMURIA,2025,3330,2840,6170,19
AMURU,2015,1790,1890,3680,19
AMURU,2016,1880,1940,3820,19
AMURU,2017,1970,2000,3970,19
AMURU,2018,2060,2080,4140,19
AMURU,2019,2170,2160,4330,19
AMURU,2020,2260,2230,4490,19
AMURU,2021,2340,2280,4620,19
AMURU,2022,2400,2320,4720,19
AMURU,2023,2440,2340,4780,19
AMURU,2024,2480,2360,4840,19
AMURU,2025,2510,2380,4890,19
APAC,2015,1800,2070,3870,19
APAC,2016,1870,2140,4010,19
APAC,2017,1940,2220,4160,19
APAC,2018,2010,2290,4300,19
APAC,2019,2080,2370,4450,19
APAC,2020,2150,2450,4600,19
APAC,2021,2220,2530,4750,19
APAC,2022,2300,2610,4910,19
APAC,2023,2380,2690,5070,19
APAC,2024,2450,2770,5220,19
APAC,2025,2530,2860,5390,19
ARUA,2015,5890,7070,12960,19
ARUA,2016,6060,7260,13320,19
ARUA,2017,6230,7460,13690,19
ARUA,2018,6410,7660,14070,19
ARUA,2019,6590,7860,14450,19
ARUA,2020,6770,8060,14830,19
ARUA,2021,6960,8260,15220,19
ARUA,2022,7130,8460,15590,19
ARUA,2023,7310,8670,15980,19
ARUA,2024,7490,8870,16360,19
ARUA,2025,7670,9070,16740,19
BUDAKA,2015,2100,2210,4310,19
BUDAKA,2016,2220,2280,4500,19
BUDAKA,2017,2360,2380,4740,19
BUDAKA,2018,2490,2480,4970,19
BUDAKA,2019,2630,2600,5230,19
BUDAKA,2020,2780,2710,5490,19
BUDAKA,2021,2890,2790,5680,19
BUDAKA,2022,3000,2870,5870,19
BUDAKA,2023,3090,2920,6010,19
BUDAKA,2024,3160,2960,6120,19
BUDAKA,2025,3230,3000,6230,19
BUDUDA,2015,2330,2250,4580,19
BUDUDA,2016,2480,2340,4820,19
BUDUDA,2017,2660,2460,5120,19
BUDUDA,2018,2830,2610,5440,19
BUDUDA,2019,3030,2750,5780,19
BUDUDA,2020,3210,2890,6100,19
BUDUDA,2021,3390,3030,6420,19
BUDUDA,2022,3540,3120,6660,19
BUDUDA,2023,3670,3210,6880,19
BUDUDA,2024,3800,3300,7100,19
BUDUDA,2025,3920,3380,7300,19
BUGIRI,2015,4020,4170,8190,19
BUGIRI,2016,4270,4330,8600,19
BUGIRI,2017,4560,4530,9090,19
BUGIRI,2018,4850,4750,9600,19
BUGIRI,2019,5150,5000,10150,19
BUGIRI,2020,5450,5220,10670,19
BUGIRI,2021,5720,5420,11140,19
BUGIRI,2022,5950,5580,11530,19
BUGIRI,2023,6150,5700,11850,19
BUGIRI,2024,6330,5820,12150,19
BUGIRI,2025,6500,5930,12430,19
BUGWERI,2015,1630,1720,3350,19
BUGWERI,2016,1710,1760,3470,19
BUGWERI,2017,1790,1810,3600,19
BUGWERI,2018,1880,1890,3770,19
BUGWERI,2019,1970,1960,3930,19
BUGWERI,2020,2050,2010,4060,19
BUGWERI,2021,2140,2060,4200,19
BUGWERI,2022,2190,2100,4290,19
BUGWERI,2023,2230,2120,4350,19
BUGWERI,2024,2260,2130,4390,19
BUGWERI,2025,2300,2150,4450,19
BUHWEJU,2015,1050,1300,2350,19
BUHWEJU,2016,1080,1340,2420,19
BUHWEJU,2017,1120,1380,2500,19
BUHWEJU,2018,1150,1420,2570,19
BUHWEJU,2019,1190,1460,2650,19
BUHWEJU,2020,1230,1500,2730,19
BUHWEJU,2021,1260,1550,2810,19
BUHWEJU,2022,1300,1590,2890,19
BUHWEJU,2023,1340,1630,2970,19
BUHWEJU,2024,1380,1680,3060,19
BUHWEJU,2025,1420,1720,3140,19
BUIKWE,2015,4570,4800,9370,19
BUIKWE,2016,4760,4890,9650,19
BUIKWE,2017,4980,5020,10000,19
BUIKWE,2018,5180,5190,10370,19
BUIKWE,2019,5400,5350,10750,19
BUIKWE,2020,5590,5490,11080,19
BUIKWE,2021,5760,5600,11360,19
BUIKWE,2022,5870,5660,11530,19
BUIKWE,2023,5940,5680,11620,19
BUIKWE,2024,5980,5690,11670,19
BUIKWE,2025,6040,5690,11730,19
BUKEDEA,2015,2090,2120,4210,19
BUKEDEA,2016,2220,2200,4420,19
BUKEDEA,2017,2370,2310,4680,19
BUKEDEA,2018,2530,2430,4960,19
BUKEDEA,2019,2690,2560,5250,19
BUKEDEA,2020,2870,2680,5550,19
BUKEDEA,2021,3020,2790,5810,19
BUKEDEA,2022,3150,2880,6030,19
BUKEDEA,2023,3260,2950,6210,19
BUKEDEA,2024,3370,3010,6380,19
BUKEDEA,2025,3480,3070,6550,19
BUKOMANSIMBI,2015,1210,1200,2410,19
BUKOMANSIMBI,2016,1250,1200,2450,19
BUKOMANSIMBI,2017,1290,1220,2510,19
BUKOMANSIMBI,2018,1330,1230,2560,19
BUKOMANSIMBI,2019,1370,1260,2630,19
BUKOMANSIMBI,2020,1390,1270,2660,19
BUKOMANSIMBI,2021,1420,1270,2690,19
BUKOMANSIMBI,2022,1440,1260,2700,19
BUKOMANSIMBI,2023,1430,1260,2690,19
BUKOMANSIMBI,2024,1430,1240,2670,19
BUKOMANSIMBI,2025,1420,1220,2640,19
BUKWO,2015,840,900,1740,19
BUKWO,2016,890,940,1830,19
BUKWO,2017,940,990,1930,19
BUKWO,2018,990,1040,2030,19
BUKWO,2019,1040,1090,2130,19
BUKWO,2020,1090,1140,2230,19
BUKWO,2021,1150,1190,2340,19
BUKWO,2022,1210,1250,2460,19
BUKWO,2023,1270,1300,2570,19
BUKWO,2024,1330,1360,2690,19
BUKWO,2025,1390,1420,2810,19
BULAMBULI,2015,1840,1730,3570,19
BULAMBULI,2016,1980,1820,3800,19
BULAMBULI,2017,2130,1920,4050,19
BULAMBULI,2018,2280,2040,4320,19
BULAMBULI,2019,2440,2160,4600,19
BULAMBULI,2020,2600,2290,4890,19
BULAMBULI,2021,2750,2400,5150,19
BULAMBULI,2022,2880,2490,5370,19
BULAMBULI,2023,3010,2570,5580,19
BULAMBULI,2024,3130,2640,5770,19
BULAMBULI,2025,3240,2720,5960,19
BULIISA,2015,930,1200,2130,19
BULIISA,2016,980,1250,2230,19
BULIISA,2017,1040,1310,2350,19
BULIISA,2018,1090,1360,2450,19
BULIISA,2019,1150,1420,2570,19
BULIISA,2020,1210,1480,2690,19
BULIISA,2021,1280,1550,2830,19
BULIISA,2022,1340,1610,2950,19
BULIISA,2023,1410,1680,3090,19
BULIISA,2024,1480,1750,3230,19
BULIISA,2025,1550,1810,3360,19
BUNDIBUGYO,2015,2190,2490,4680,19
BUNDIBUGYO,2016,2310,2560,4870,19
BUNDIBUGYO,2017,2430,2640,5070,19
BUNDIBUGYO,2018,2550,2750,5300,19
BUNDIBUGYO,2019,2690,2850,5540,19
BUNDIBUGYO,2020,2810,2950,5760,19
BUNDIBUGYO,2021,2920,3030,5950,19
BUNDIBUGYO,2022,3010,3080,6090,19
BUNDIBUGYO,2023,3070,3120,6190,19
BUNDIBUGYO,2024,3130,3130,6260,19
BUNDIBUGYO,2025,3180,3160,6340,19
BUNYANGABU,2015,1790,1790,3580,19
BUNYANGABU,2016,1880,1820,3700,19
BUNYANGABU,2017,1970,1880,3850,19
BUNYANGABU,2018,2060,1940,4000,19
BUNYANGABU,2019,2160,2010,4170,19
BUNYANGABU,2020,2260,2070,4330,19
BUNYANGABU,2021,2330,2120,4450,19
BUNYANGABU,2022,2380,2140,4520,19
BUNYANGABU,2023,2420,2160,4580,19
BUNYANGABU,2024,2470,2160,4630,19
BUNYANGABU,2025,2500,2170,4670,19
BUSHENYI,2015,2570,2910,5480,19
BUSHENYI,2016,2610,2940,5550,19
BUSHENYI,2017,2640,2960,5600,19
BUSHENYI,2018,2670,2990,5660,19
BUSHENYI,2019,2700,3010,5710,19
BUSHENYI,2020,2730,3040,5770,19
BUSHENYI,2021,2760,3060,5820,19
BUSHENYI,2022,2780,3080,5860,19
BUSHENYI,2023,2810,3090,5900,19
BUSHENYI,2024,2830,3110,5940,19
BUSHENYI,2025,2850,3120,5970,19
BUSIA,2015,3640,3850,7490,19
BUSIA,2016,3840,3960,7800,19
BUSIA,2017,4040,4100,8140,19
BUSIA,2018,4260,4270,8530,19
BUSIA,2019,4490,4440,8930,19
BUSIA,2020,4700,4590,9290,19
BUSIA,2021,4900,4720,9620,19
BUSIA,2022,5050,4820,9870,19
BUSIA,2023,5160,4870,10030,19
BUSIA,2024,5260,4920,10180,19
BUSIA,2025,5370,4960,10330,19
BUTALEJA,2015,2440,2640,5080,19
BUTALEJA,2016,2590,2730,5320,19
BUTALEJA,2017,2740,2840,5580,19
BUTALEJA,2018,2910,2980,5890,19
BUTALEJA,2019,3080,3130,6210,19
BUTALEJA,2020,3250,3250,6500,19
BUTALEJA,2021,3400,3360,6760,19
BUTALEJA,2022,3520,3450,6970,19
BUTALEJA,2023,3630,3520,7150,19
BUTALEJA,2024,3720,3570,7290,19
BUTALEJA,2025,3820,3640,7460,19
BUTAMBALA,2015,840,950,1790,19
BUTAMBALA,2016,880,960,1840,19
BUTAMBALA,2017,910,980,1890,19
BUTAMBALA,2018,940,1000,1940,19
BUTAMBALA,2019,970,1020,1990,19
BUTAMBALA,2020,1000,1040,2040,19
BUTAMBALA,2021,1020,1050,2070,19
BUTAMBALA,2022,1030,1050,2080,19
BUTAMBALA,2023,1030,1040,2070,19
BUTAMBALA,2024,1040,1040,2080,19
BUTAMBALA,2025,1040,1020,2060,19
BUTEBO,2015,1120,1250,2370,19
BUTEBO,2016,1170,1260,2430,19
BUTEBO,2017,1210,1290,2500,19
BUTEBO,2018,1260,1320,2580,19
BUTEBO,2019,1310,1350,2660,19
BUTEBO,2020,1340,1380,2720,19
BUTEBO,2021,1380,1400,2780,19
BUTEBO,2022,1400,1400,2800,19
BUTEBO,2023,1420,1400,2820,19
BUTEBO,2024,1420,1390,2810,19
BUTEBO,2025,1420,1380,2800,19
BUVUMA,2015,780,850,1630,19
BUVUMA,2016,830,910,1740,19
BUVUMA,2017,880,970,1850,19
BUVUMA,2018,930,1040,1970,19
BUVUMA,2019,990,1110,2100,19
BUVUMA,2020,1050,1180,2230,19
BUVUMA,2021,1110,1260,2370,19
BUVUMA,2022,1170,1340,2510,19
BUVUMA,2023,1240,1430,2670,19
BUVUMA,2024,1310,1520,2830,19
BUVUMA,2025,1390,1610,3000,19
BUYENDE,2015,2930,3420,6350,19
BUYENDE,2016,3120,3570,6690,19
BUYENDE,2017,3340,3740,7080,19
BUYENDE,2018,3570,3960,7530,19
BUYENDE,2019,3800,4170,7970,19
BUYENDE,2020,4040,4380,8420,19
BUYENDE,2021,4260,4570,8830,19
BUYENDE,2022,4450,4720,9170,19
BUYENDE,2023,4600,4840,9440,19
BUYENDE,2024,4760,4960,9720,19
BUYENDE,2025,4910,5070,9980,19
DOKOLO,2015,1690,1970,3660,19
DOKOLO,2016,1750,2020,3770,19
DOKOLO,2017,1800,2080,3880,19
DOKOLO,2018,1860,2140,4000,19
DOKOLO,2019,1910,2190,4100,19
DOKOLO,2020,1960,2250,4210,19
DOKOLO,2021,2020,2310,4330,19
DOKOLO,2022,2080,2360,4440,19
DOKOLO,2023,2130,2420,4550,19
DOKOLO,2024,2190,2480,4670,19
DOKOLO,2025,2240,2540,4780,19
GOMBA,2015,1470,1300,2770,19
GOMBA,2016,1520,1320,2840,19
GOMBA,2017,1590,1340,2930,19
GOMBA,2018,1650,1380,3030,19
GOMBA,2019,1710,1410,3120,19
GOMBA,2020,1780,1430,3210,19
GOMBA,2021,1820,1450,3270,19
GOMBA,2022,1850,1450,3300,19
GOMBA,2023,1860,1450,3310,19
GOMBA,2024,1870,1440,3310,19
GOMBA,2025,1880,1430,3310,19
GULU,2015,2660,3170,5830,19
GULU,2016,2740,3270,6010,19
GULU,2017,2830,3360,6190,19
GULU,2018,2910,3460,6370,19
GULU,2019,2990,3550,6540,19
GULU,2020,3080,3650,6730,19
GULU,2021,3170,3750,6920,19
GULU,2022,3250,3850,7100,19
GULU,2023,3340,3950,7290,19
GULU,2024,3420,4050,7470,19
GULU,2025,3510,4150,7660,19
HOIMA,2015,2910,3630,6540,19
HOIMA,2016,3020,3760,6780,19
HOIMA,2017,3130,3890,7020,19
HOIMA,2018,3250,4020,7270,19
HOIMA,2019,3360,4150,7510,19
HOIMA,2020,3490,4290,7780,19
HOIMA,2021,3610,4430,8040,19
HOIMA,2022,3730,4570,8300,19
HOIMA,2023,3860,4720,8580,19
HOIMA,2024,3990,4860,8850,19
HOIMA,2025,4120,5010,9130,19
IBANDA,2015,2400,2800,5200,19
IBANDA,2016,2450,2850,5300,19
IBANDA,2017,2490,2900,5390,19
IBANDA,2018,2540,2960,5500,19
IBANDA,2019,2590,3010,5600,19
IBANDA,2020,2640,3060,5700,19
IBANDA,2021,2680,3110,5790,19
IBANDA,2022,2730,3150,5880,19
IBANDA,2023,2770,3200,5970,19
IBANDA,2024,2810,3250,6060,19
IBANDA,2025,2850,3290,6140,19
IGANGA,2015,3590,4090,7680,19
IGANGA,2016,3790,4200,7990,19
IGANGA,2017,4000,4350,8350,19
IGANGA,2018,4210,4530,8740,19
IGANGA,2019,4440,4720,9160,19
IGANGA,2020,4640,4870,9510,19
IGANGA,2021,4840,5010,9850,19
IGANGA,2022,4980,5110,10090,19
IGANGA,2023,5100,5170,10270,19
IGANGA,2024,5200,5220,10420,19
IGANGA,2025,5300,5270,10570,19
ISINGIRO,2015,3990,4370,8360,19
ISINGIRO,2016,4140,4530,8670,19
ISINGIRO,2017,4300,4690,8990,19
ISINGIRO,2018,4460,4850,9310,19
ISINGIRO,2019,4620,5020,9640,19
ISINGIRO,2020,4780,5190,9970,19
ISINGIRO,2021,4950,5360,10310,19
ISINGIRO,2022,5120,5530,10650,19
ISINGIRO,2023,5290,5710,11000,19
ISINGIRO,2024,5470,5890,11360,19
ISINGIRO,2025,5640,6070,11710,19
JINJA,2015,4960,5810,10770,19
JINJA,2016,5050,5900,10950,19
JINJA,2017,5130,5990,11120,19
JINJA,2018,5220,6080,11300,19
JINJA,2019,5300,6170,11470,19
JINJA,2020,5380,6250,11630,19
JINJA,2021,5460,6340,11800,19
JINJA,2022,5530,6420,11950,19
JINJA,2023,5600,6500,12100,19
JINJA,2024,5680,6570,12250,19
JINJA,2025,5740,6640,12380,19
KAABONG,2015,820,1150,1970,19
KAABONG,2016,840,1180,2020,19
KAABONG,2017,870,1210,2080,19
KAABONG,2018,890,1240,2130,19
KAABONG,2019,910,1270,2180,19
KAABONG,2020,930,1300,2230,19
KAABONG,2021,960,1330,2290,19
KAABONG,2022,980,1360,2340,19
KAABONG,2023,1000,1380,2380,19
KAABONG,2024,1030,1410,2440,19
KAABONG,2025,1050,1440,2490,19
KABALE,2015,2250,2640,4890,19
KABALE,2016,2280,2680,4960,19
KABALE,2017,2320,2710,5030,19
KABALE,2018,2350,2740,5090,19
KABALE,2019,2390,2770,5160,19
KABALE,2020,2420,2800,5220,19
KABALE,2021,2460,2830,5290,19
KABALE,2022,2490,2850,5340,19
KABALE,2023,2520,2880,5400,19
KABALE,2024,2540,2900,5440,19
KABALE,2025,2570,2920,5490,19
KABAROLE,2015,3220,3240,6460,19
KABAROLE,2016,3290,3310,6600,19
KABAROLE,2017,3370,3380,6750,19
KABAROLE,2018,3440,3450,6890,19
KABAROLE,2019,3510,3520,7030,19
KABAROLE,2020,3580,3590,7170,19
KABAROLE,2021,3650,3670,7320,19
KABAROLE,2022,3720,3730,7450,19
KABAROLE,2023,3790,3800,7590,19
KABAROLE,2024,3860,3870,7730,19
KABAROLE,2025,3920,3940,7860,19
KABERAMAIDO,2015,1120,1160,2280,19
KABERAMAIDO,2016,1190,1210,2400,19
KABERAMAIDO,2017,1270,1260,2530,19
KABERAMAIDO,2018,1360,1330,2690,19
KABERAMAIDO,2019,1450,1400,2850,19
KABERAMAIDO,2020,1520,1460,2980,19
KABERAMAIDO,2021,1600,1520,3120,19
KABERAMAIDO,2022,1680,1560,3240,19
KABERAMAIDO,2023,1730,1600,3330,19
KABERAMAIDO,2024,1780,1640,3420,19
KABERAMAIDO,2025,1830,1660,3490,19
KAGADI,2015,3080,3740,6820,19
KAGADI,2016,3190,3870,7060,19
KAGADI,2017,3310,4010,7320,19
KAGADI,2018,3430,4150,7580,19
KAGADI,2019,3550,4290,7840,19
KAGADI,2020,3680,4440,8120,19
KAGADI,2021,3810,4590,8400,19
KAGADI,2022,3940,4740,8680,19
KAGADI,2023,4070,4890,8960,19
KAGADI,2024,4200,5040,9240,19
KAGADI,2025,4330,5200,9530,19
KAKUMIRO,2015,2680,3110,5790,19
KAKUMIRO,2016,2920,3370,6290,19
KAKUMIRO,2017,3180,3650,6830,19
KAKUMIRO,2018,3460,3960,7420,19
KAKUMIRO,2019,3760,4290,8050,19
KAKUMIRO,2020,4090,4640,8730,19
KAKUMIRO,2021,4440,5020,9460,19
KAKUMIRO,2022,4820,5430,10250,19
KAKUMIRO,2023,5230,5870,11100,19
KAKUMIRO,2024,5670,6340,12010,19
KAKUMIRO,2025,6130,6840,12970,19
KALAKI,2015,1060,1120,2180,19
KALAKI,2016,1100,1170,2270,19
KALAKI,2017,1150,1210,2360,19
KALAKI,2018,1200,1260,2460,19
KALAKI,2019,1250,1310,2560,19
KALAKI,2020,1300,1360,2660,19
KALAKI,2021,1360,1410,2770,19
KALAKI,2022,1410,1460,2870,19
KALAKI,2023,1470,1520,2990,19
KALAKI,2024,1520,1570,3090,19
KALAKI,2025,1580,1620,3200,19
KALANGALA,2015,430,480,910,19
KALANGALA,2016,450,500,950,19
KALANGALA,2017,460,520,980,19
KALANGALA,2018,480,540,1020,19
KALANGALA,2019,500,570,1070,19
KALANGALA,2020,510,590,1100,19
KALANGALA,2021,530,610,1140,19
KALANGALA,2022,550,640,1190,19
KALANGALA,2023,560,660,1220,19
KALANGALA,2024,580,690,1270,19
KALANGALA,2025,600,710,1310,19
KALIRO,2015,2290,2550,4840,19
KALIRO,2016,2430,2630,5060,19
KALIRO,2017,2570,2740,5310,19
KALIRO,2018,2720,2870,5590,19
KALIRO,2019,2880,3000,5880,19
KALIRO,2020,3030,3130,6160,19
KALIRO,2021,3160,3230,6390,19
KALIRO,2022,3280,3320,6600,19
KALIRO,2023,3370,3370,6740,19
KALIRO,2024,3440,3430,6870,19
KALIRO,2025,3530,3480,7010,19
KALUNGU,2015,1590,1690,3280,19
KALUNGU,2016,1650,1700,3350,19
KALUNGU,2017,1700,1730,3430,19
KALUNGU,2018,1760,1760,3520,19
KALUNGU,2019,1810,1810,3620,19
KALUNGU,2020,1860,1830,3690,19
KALUNGU,2021,1890,1840,3730,19
KALUNGU,2022,1920,1840,3760,19
KALUNGU,2023,1930,1830,3760,19
KALUNGU,2024,1920,1810,3730,19
KALUNGU,2025,1920,1800,3720,19
KAMPALA,2015,15880,24150,40030,19
KAMPALA,2016,16190,24620,40810,19
KAMPALA,2017,16510,25100,41610,19
KAMPALA,2018,16830,25570,42400,19
KAMPALA,2019,17150,26050,43200,19
KAMPALA,2020,17460,26510,43970,19
KAMPALA,2021,17770,26970,44740,19
KAMPALA,2022,18070,27430,45500,19
KAMPALA,2023,18350,27870,46220,19
KAMPALA,2024,18640,28300,46940,19
KAMPALA,2025,18910,28710,47620,19
KAMULI,2015,5090,5280,10370,19
KAMULI,2016,5340,5380,10720,19
KAMULI,2017,5610,5550,11160,19
KAMULI,2018,5880,5740,11620,19
KAMULI,2019,6160,5930,12090,19
KAMULI,2020,6420,6110,12530,19
KAMULI,2021,6640,6250,12890,19
KAMULI,2022,6800,6320,13120,19
KAMULI,2023,6920,6360,13280,19
KAMULI,2024,7040,6380,13420,19
KAMULI,2025,7130,6400,13530,19
KAMWENGE,2015,2200,2570,4770,19
KAMWENGE,2016,2290,2670,4960,19
KAMWENGE,2017,2380,2760,5140,19
KAMWENGE,2018,2480,2860,5340,19
KAMWENGE,2019,2580,2960,5540,19
KAMWENGE,2020,2680,3060,5740,19
KAMWENGE,2021,2780,3160,5940,19
KAMWENGE,2022,2890,3260,6150,19
KAMWENGE,2023,2990,3370,6360,19
KAMWENGE,2024,3100,3480,6580,19
KAMWENGE,2025,3210,3580,6790,19
KANUNGU,2015,2230,2720,4950,19
KANUNGU,2016,2270,2760,5030,19
KANUNGU,2017,2310,2810,5120,19
KANUNGU,2018,2350,2850,5200,19
KANUNGU,2019,2390,2890,5280,19
KANUNGU,2020,2430,2940,5370,19
KANUNGU,2021,2470,2980,5450,19
KANUNGU,2022,2500,3020,5520,19
KANUNGU,2023,2540,3060,5600,19
KANUNGU,2024,2580,3100,5680,19
KANUNGU,2025,2610,3130,5740,19
KAPCHORWA,2015,1100,1150,2250,19
KAPCHORWA,2016,1130,1190,2320,19
KAPCHORWA,2017,1170,1220,2390,19
KAPCHORWA,2018,1200,1250,2450,19
KAPCHORWA,2019,1240,1280,2520,19
KAPCHORWA,2020,1270,1320,2590,19
KAPCHORWA,2021,1310,1350,2660,19
KAPCHORWA,2022,1340,1390,2730,19
KAPCHORWA,2023,1380,1420,2800,19
KAPCHORWA,2024,1420,1460,2880,19
KAPCHORWA,2025,1450,1490,2940,19
KAPELEBYONG,2015,940,920,1860,19
KAPELEBYONG,2016,990,950,1940,19
KAPELEBYONG,2017,1050,980,2030,19
KAPELEBYONG,2018,1110,1020,2130,19
KAPELEBYONG,2019,1170,1050,2220,19
KAPELEBYONG,2020,1230,1090,2320,19
KAPELEBYONG,2021,1280,1130,2410,19
KAPELEBYONG,2022,1320,1140,2460,19
KAPELEBYONG,2023,1340,1160,2500,19
KAPELEBYONG,2024,1380,1160,2540,19
KAPELEBYONG,2025,1410,1180,2590,19
KASESE,2015,7050,7780,14830,19
KASESE,2016,7370,7930,15300,19
KASESE,2017,7740,8170,15910,19
KASESE,2018,8100,8450,16550,19
KASESE,2019,8470,8730,17200,19
KASESE,2020,8810,8980,17790,19
KASESE,2021,9100,9180,18280,19
KASESE,2022,9320,9290,18610,19
KASESE,2023,9470,9340,18810,19
KASESE,2024,9590,9370,18960,19
KASESE,2025,9720,9390,19110,19
KASSANDA,2015,2480,2580,5060,19
KASSANDA,2016,2560,2640,5200,19
KASSANDA,2017,2630,2700,5330,19
KASSANDA,2018,2700,2750,5450,19
KASSANDA,2019,2780,2810,5590,19
KASSANDA,2020,2850,2870,5720,19
KASSANDA,2021,2930,2920,5850,19
KASSANDA,2022,3000,2980,5980,19
KASSANDA,2023,3080,3030,6110,19
KASSANDA,2024,3150,3080,6230,19
KASSANDA,2025,3220,3140,6360,19
KATAKWI,2015,1750,1720,3470,19
KATAKWI,2016,1840,1760,3600,19
KATAKWI,2017,1940,1820,3760,19
KATAKWI,2018,2040,1890,3930,19
KATAKWI,2019,2140,1960,4100,19
KATAKWI,2020,2240,2030,4270,19
KATAKWI,2021,2330,2070,4400,19
KATAKWI,2022,2400,2100,4500,19
KATAKWI,2023,2450,2130,4580,19
KATAKWI,2024,2490,2140,4630,19
KATAKWI,2025,2540,2150,4690,19
KAYUNGA,2015,3620,3670,7290,19
KAYUNGA,2016,3770,3720,7490,19
KAYUNGA,2017,3940,3810,7750,19
KAYUNGA,2018,4090,3920,8010,19
KAYUNGA,2019,4260,4030,8290,19
KAYUNGA,2020,4410,4120,8530,19
KAYUNGA,2021,4540,4190,8730,19
KAYUNGA,2022,4630,4210,8840,19
KAYUNGA,2023,4680,4210,8890,19
KAYUNGA,2024,4720,4200,8920,19
KAYUNGA,2025,4760,4190,8950,19
KAZO,2015,1650,1730,3380,19
KAZO,2016,1710,1790,3500,19
KAZO,2017,1780,1850,3630,19
KAZO,2018,1840,1920,3760,19
KAZO,2019,1910,1980,3890,19
KAZO,2020,1980,2050,4030,19
KAZO,2021,2050,2120,4170,19
KAZO,2022,2120,2190,4310,19
KAZO,2023,2200,2260,4460,19
KAZO,2024,2270,2330,4600,19
KAZO,2025,2350,2400,4750,19
KIBAALE,2015,1360,1530,2890,19
KIBAALE,2016,1450,1620,3070,19
KIBAALE,2017,1540,1710,3250,19
KIBAALE,2018,1640,1810,3450,19
KIBAALE,2019,1740,1920,3660,19
KIBAALE,2020,1850,2020,3870,19
KIBAALE,2021,1970,2140,4110,19
KIBAALE,2022,2080,2260,4340,19
KIBAALE,2023,2210,2380,4590,19
KIBAALE,2024,2340,2510,4850,19
KIBAALE,2025,2480,2640,5120,19
KIBOGA,2015,1680,1440,3120,19
KIBOGA,2016,1770,1480,3250,19
KIBOGA,2017,1850,1520,3370,19
KIBOGA,2018,1950,1570,3520,19
KIBOGA,2019,2040,1630,3670,19
KIBOGA,2020,2130,1680,3810,19
KIBOGA,2021,2200,1720,3920,19
KIBOGA,2022,2270,1750,4020,19
KIBOGA,2023,2310,1760,4070,19
KIBOGA,2024,2340,1770,4110,19
KIBOGA,2025,2370,1780,4150,19
KIBUKU,2015,1960,2250,4210,19
KIBUKU,2016,2080,2330,4410,19
KIBUKU,2017,2210,2430,4640,19
KIBUKU,2018,2350,2560,4910,19
KIBUKU,2019,2490,2680,5170,19
KIBUKU,2020,2620,2790,5410,19
KIBUKU,2021,2750,2900,5650,19
KIBUKU,2022,2860,2970,5830,19
KIBUKU,2023,2950,3040,5990,19
KIBUKU,2024,3020,3090,6110,19
KIBUKU,2025,3110,3150,6260,19
KIKUUBE,2015,2390,2700,5090,19
KIKUUBE,2016,2520,2840,5360,19
KIKUUBE,2017,2660,2980,5640,19
KIKUUBE,2018,2800,3130,5930,19
KIKUUBE,2019,2940,3290,6230,19
KIKUUBE,2020,3100,3450,6550,19
KIKUUBE,2021,3250,3620,6870,19
KIKUUBE,2022,3420,3790,7210,19
KIKUUBE,2023,3590,3970,7560,19
KIKUUBE,2024,3760,4160,7920,19
KIKUUBE,2025,3940,4350,8290,19
KIRUHURA,2015,1500,1430,2930,19
KIRUHURA,2016,1550,1480,3030,19
KIRUHURA,2017,1610,1530,3140,19
KIRUHURA,2018,1670,1580,3250,19
KIRUHURA,2019,1730,1640,3370,19
KIRUHURA,2020,1800,1690,3490,19
KIRUHURA,2021,1860,1750,3610,19
KIRUHURA,2022,1930,1810,3740,19
KIRUHURA,2023,2000,1870,3870,19
KIRUHURA,2024,2060,1920,3980,19
KIRUHURA,2025,2130,1980,4110,19
KIRYANDONGO,2015,2920,2850,5770,19
KIRYANDONGO,2016,3080,2930,6010,19
KIRYANDONGO,2017,3240,3030,6270,19
KIRYANDONGO,2018,3420,3140,6560,19
KIRYANDONGO,2019,3590,3270,6860,19
KIRYANDONGO,2020,3770,3380,7150,19
KIRYANDONGO,2021,3920,3470,7390,19
KIRYANDONGO,2022,4020,3530,7550,19
KIRYANDONGO,2023,4120,3560,7680,19
KIRYANDONGO,2024,4200,3600,7800,19
KIRYANDONGO,2025,4270,3630,7900,19
KISORO,2015,2100,2930,5030,19
KISORO,2016,2190,2990,5180,19
KISORO,2017,2280,3070,5350,19
KISORO,2018,2380,3160,5540,19
KISORO,2019,2480,3270,5750,19
KISORO,2020,2560,3360,5920,19
KISORO,2021,2640,3420,6060,19
KISORO,2022,2690,3460,6150,19
KISORO,2023,2720,3470,6190,19
KISORO,2024,2750,3470,6220,19
KISORO,2025,2760,3470,6230,19
KITAGWENDA,2015,1240,1370,2610,19
KITAGWENDA,2016,1290,1420,2710,19
KITAGWENDA,2017,1340,1480,2820,19
KITAGWENDA,2018,1400,1530,2930,19
KITAGWENDA,2019,1450,1580,3030,19
KITAGWENDA,2020,1510,1640,3150,19
KITAGWENDA,2021,1570,1690,3260,19
KITAGWENDA,2022,1630,1750,3380,19
KITAGWENDA,2023,1690,1800,3490,19
KITAGWENDA,2024,1750,1860,3610,19
KITAGWENDA,2025,1810,1920,3730,19
KITGUM,2015,2130,2190,4320,19
KITGUM,2016,2210,2220,4430,19
KITGUM,2017,2310,2260,4570,19
KITGUM,2018,2390,2330,4720,19
KITGUM,2019,2480,2400,4880,19
KITGUM,2020,2560,2450,5010,19
KITGUM,2021,2620,2480,5100,19
KITGUM,2022,2670,2500,5170,19
KITGUM,2023,2690,2500,5190,19
KITGUM,2024,2710,2490,5200,19
KITGUM,2025,2710,2490,5200,19
KOBOKO,2015,2370,2170,4540,19
KOBOKO,2016,2520,2250,4770,19
KOBOKO,2017,2680,2360,5040,19
KOBOKO,2018,2850,2470,5320,19
KOBOKO,2019,3020,2600,5620,19
KOBOKO,2020,3200,2720,5920,19
KOBOKO,2021,3350,2820,6170,19
KOBOKO,2022,3490,2900,6390,19
KOBOKO,2023,3600,2960,6560,19
KOBOKO,2024,3690,3020,6710,19
KOBOKO,2025,3790,3070,6860,19
KOLE,2015,2400,2760,5160,19
KOLE,2016,2480,2840,5320,19
KOLE,2017,2560,2930,5490,19
KOLE,2018,2640,3010,5650,19
KOLE,2019,2720,3090,5810,19
KOLE,2020,2810,3180,5990,19
KOLE,2021,2890,3260,6150,19
KOLE,2022,2980,3350,6330,19
KOLE,2023,3060,3430,6490,19
KOLE,2024,3150,3520,6670,19
KOLE,2025,3240,3600,6840,19
KOTIDO,2015,1590,1420,3010,19
KOTIDO,2016,1670,1450,3120,19
KOTIDO,2017,1750,1490,3240,19
KOTIDO,2018,1830,1540,3370,19
KOTIDO,2019,1910,1600,3510,19
KOTIDO,2020,1990,1640,3630,19
KOTIDO,2021,2060,1670,3730,19
KOTIDO,2022,2100,1690,3790,19
KOTIDO,2023,2140,1700,3840,19
KOTIDO,2024,2160,1710,3870,19
KOTIDO,2025,2200,1710,3910,19
KUMI,2015,2530,2400,4930,19
KUMI,2016,2670,2470,5140,19
KUMI,2017,2820,2560,5380,19
KUMI,2018,2970,2660,5630,19
KUMI,2019,3130,2770,5900,19
KUMI,2020,3280,2870,6150,19
KUMI,2021,3420,2950,6370,19
KUMI,2022,3520,3010,6530,19
KUMI,2023,3620,3040,6660,19
KUMI,2024,3690,3070,6760,19
KUMI,2025,3770,3100,6870,19
KWANIA,2015,1730,2000,3730,19
KWANIA,2016,1780,2060,3840,19
KWANIA,2017,1840,2110,3950,19
KWANIA,2018,1900,2170,4070,19
KWANIA,2019,1950,2230,4180,19
KWANIA,2020,2010,2290,4300,19
KWANIA,2021,2070,2360,4430,19
KWANIA,2022,2130,2420,4550,19
KWANIA,2023,2180,2480,4660,19
KWANIA,2024,2240,2540,4780,19
KWANIA,2025,2300,2600,4900,19
KWEEN,2015,940,870,1810,19
KWEEN,2016,970,890,1860,19
KWEEN,2017,1000,910,1910,19
KWEEN,2018,1030,940,1970,19
KWEEN,2019,1060,960,2020,19
KWEEN,2020,1090,980,2070,19
KWEEN,2021,1120,1000,2120,19
KWEEN,2022,1150,1020,2170,19
KWEEN,2023,1180,1050,2230,19
KWEEN,2024,1220,1070,2290,19
KWEEN,2025,1250,1090,2340,19
KYANKWANZI,2015,2110,2110,4220,19
KYANKWANZI,2016,2220,2210,4430,19
KYANKWANZI,2017,2340,2310,4650,19
KYANKWANZI,2018,2460,2420,4880,19
KYANKWANZI,2019,2580,2530,5110,19
KYANKWANZI,2020,2710,2640,5350,19
KYANKWANZI,2021,2840,2760,5600,19
KYANKWANZI,2022,2980,2880,5860,19
KYANKWANZI,2023,3120,3010,6130,19
KYANKWANZI,2024,3270,3130,6400,19
KYANKWANZI,2025,3410,3260,6670,19
KYEGEGWA,2015,2490,2900,5390,19
KYEGEGWA,2016,2690,3130,5820,19
KYEGEGWA,2017,2910,3380,6290,19
KYEGEGWA,2018,3150,3650,6800,19
KYEGEGWA,2019,3410,3930,7340,19
KYEGEGWA,2020,3680,4240,7920,19
KYEGEGWA,2021,3980,4560,8540,19
KYEGEGWA,2022,4290,4910,9200,19
KYEGEGWA,2023,4630,5280,9910,19
KYEGEGWA,2024,4980,5670,10650,19
KYEGEGWA,2025,5370,6090,11460,19
KYENJOJO,2015,3890,4330,8220,19
KYENJOJO,2016,4050,4490,8540,19
KYENJOJO,2017,4210,4660,8870,19
KYENJOJO,2018,4380,4830,9210,19
KYENJOJO,2019,4560,5000,9560,19
KYENJOJO,2020,4740,5180,9920,19
KYENJOJO,2021,4920,5360,10280,19
KYENJOJO,2022,5110,5540,10650,19
KYENJOJO,2023,5300,5730,11030,19
KYENJOJO,2024,5490,5910,11400,19
KYENJOJO,2025,5690,6100,11790,19
KYOTERA,2015,2090,2220,4310,19
KYOTERA,2016,2180,2250,4430,19
KYOTERA,2017,2260,2300,4560,19
KYOTERA,2018,2350,2360,4710,19
KYOTERA,2019,2430,2420,4850,19
KYOTERA,2020,2510,2470,4980,19
KYOTERA,2021,2570,2490,5060,19
KYOTERA,2022,2610,2510,5120,19
KYOTERA,2023,2640,2500,5140,19
KYOTERA,2024,2660,2490,5150,19
KYOTERA,2025,2660,2480,5140,19
KARENGA,2015,500,490,990,19
KARENGA,2016,510,500,1010,19
KARENGA,2017,520,520,1040,19
KARENGA,2018,540,530,1070,19
KARENGA,2019,550,540,1090,19
KARENGA,2020,570,550,1120,19
KARENGA,2021,580,570,1150,19
KARENGA,2022,600,580,1180,19
KARENGA,2023,610,590,1200,19
KARENGA,2024,630,600,1230,19
KARENGA,2025,640,620,1260,19
LAMWO,2015,1200,1250,2450,19
LAMWO,2016,1240,1260,2500,19
LAMWO,2017,1280,1290,2570,19
LAMWO,2018,1320,1330,2650,19
LAMWO,2019,1360,1360,2720,19
LAMWO,2020,1390,1390,2780,19
LAMWO,2021,1420,1410,2830,19
LAMWO,2022,1440,1410,2850,19
LAMWO,2023,1440,1420,2860,19
LAMWO,2024,1430,1400,2830,19
LAMWO,2025,1430,1390,2820,19
LIRA,2015,4080,5090,9170,19
LIRA,2016,4200,5240,9440,19
LIRA,2017,4320,5390,9710,19
LIRA,2018,4440,5540,9980,19
LIRA,2019,4560,5690,10250,19
LIRA,2020,4680,5850,10530,19
LIRA,2021,4800,6010,10810,19
LIRA,2022,4920,6160,11080,19
LIRA,2023,5040,6310,11350,19
LIRA,2024,5160,6470,11630,19
LIRA,2025,5270,6620,11890,19
LUUKA,2015,2360,2520,4880,19
LUUKA,2016,2460,2570,5030,19
LUUKA,2017,2570,2630,5200,19
LUUKA,2018,2680,2720,5400,19
LUUKA,2019,2790,2800,5590,19
LUUKA,2020,2890,2880,5770,19
LUUKA,2021,2980,2940,5920,19
LUUKA,2022,3040,2960,6000,19
LUUKA,2023,3070,2980,6050,19
LUUKA,2024,3100,2980,6080,19
LUUKA,2025,3130,2970,6100,19
LUWERO,2015,4870,5120,9990,19
LUWERO,2016,5100,5230,10330,19
LUWERO,2017,5350,5390,10740,19
LUWERO,2018,5610,5570,11180,19
LUWERO,2019,5860,5760,11620,19
LUWERO,2020,6110,5940,12050,19
LUWERO,2021,6310,6060,12370,19
LUWERO,2022,6470,6140,12610,19
LUWERO,2023,6580,6180,12760,19
LUWERO,2024,6670,6190,12860,19
LUWERO,2025,6750,6220,12970,19
LWENGO,2015,2190,2430,4620,19
LWENGO,2016,2270,2450,4720,19
LWENGO,2017,2340,2490,4830,19
LWENGO,2018,2420,2540,4960,19
LWENGO,2019,2490,2590,5080,19
LWENGO,2020,2560,2630,5190,19
LWENGO,2021,2610,2660,5270,19
LWENGO,2022,2640,2650,5290,19
LWENGO,2023,2640,2640,5280,19
LWENGO,2024,2640,2610,5250,19
LWENGO,2025,2640,2580,5220,19
LYANTONDE,2015,940,910,1850,19
LYANTONDE,2016,980,940,1920,19
LYANTONDE,2017,1040,960,2000,19
LYANTONDE,2018,1090,990,2080,19
LYANTONDE,2019,1150,1030,2180,19
LYANTONDE,2020,1210,1070,2280,19
LYANTONDE,2021,1270,1110,2380,19
LYANTONDE,2022,1310,1140,2450,19
LYANTONDE,2023,1350,1160,2510,19
LYANTONDE,2024,1380,1170,2550,19
LYANTONDE,2025,1410,1180,2590,19
MANAFWA,2015,1470,1630,3100,19
MANAFWA,2016,1500,1670,3170,19
MANAFWA,2017,1540,1710,3250,19
MANAFWA,2018,1580,1750,3330,19
MANAFWA,2019,1620,1780,3400,19
MANAFWA,2020,1650,1820,3470,19
MANAFWA,2021,1690,1860,3550,19
MANAFWA,2022,1730,1900,3630,19
MANAFWA,2023,1770,1930,3700,19
MANAFWA,2024,1800,1970,3770,19
MANAFWA,2025,1840,2000,3840,19
MARACHA,2015,1430,1940,3370,19
MARACHA,2016,1460,1980,3440,19
MARACHA,2017,1490,2020,3510,19
MARACHA,2018,1520,2050,3570,19
MARACHA,2019,1550,2090,3640,19
MARACHA,2020,1580,2130,3710,19
MARACHA,2021,1610,2170,3780,19
MARACHA,2022,1640,2200,3840,19
MARACHA,2023,1670,2240,3910,19
MARACHA,2024,1700,2270,3970,19
MARACHA,2025,1730,2310,4040,19
MASAKA,2015,2920,3140,6060,19
MASAKA,2016,3050,3200,6250,19
MASAKA,2017,3190,3280,6470,19
MASAKA,2018,3340,3380,6720,19
MASAKA,2019,3480,3500,6980,19
MASAKA,2020,3630,3600,7230,19
MASAKA,2021,3740,3670,7410,19
MASAKA,2022,3820,3710,7530,19
MASAKA,2023,3860,3720,7580,19
MASAKA,2024,3910,3730,7640,19
MASAKA,2025,3950,3730,7680,19
MASINDI,2015,2930,3110,6040,19
MASINDI,2016,3010,3190,6200,19
MASINDI,2017,3100,3280,6380,19
MASINDI,2018,3190,3370,6560,19
MASINDI,2019,3280,3450,6730,19
MASINDI,2020,3370,3540,6910,19
MASINDI,2021,3460,3630,7090,19
MASINDI,2022,3550,3710,7260,19
MASINDI,2023,3640,3800,7440,19
MASINDI,2024,3730,3890,7620,19
MASINDI,2025,3820,3970,7790,19
MAYUGE,2015,4610,5060,9670,19
MAYUGE,2016,4860,5210,10070,19
MAYUGE,2017,5120,5400,10520,19
MAYUGE,2018,5400,5630,11030,19
MAYUGE,2019,5690,5880,11570,19
MAYUGE,2020,5960,6100,12060,19
MAYUGE,2021,6210,6280,12490,19
MAYUGE,2022,6390,6410,12800,19
MAYUGE,2023,6540,6500,13040,19
MAYUGE,2024,6680,6570,13250,19
MAYUGE,2025,6800,6640,13440,19
MBALE,2015,5260,6090,11350,19
MBALE,2016,5530,6290,11820,19
MBALE,2017,5840,6540,12380,19
MBALE,2018,6150,6830,12980,19
MBALE,2019,6470,7150,13620,19
MBALE,2020,6770,7430,14200,19
MBALE,2021,7040,7680,14720,19
MBALE,2022,7240,7850,15090,19
MBALE,2023,7410,7990,15400,19
MBALE,2024,7550,8090,15640,19
MBALE,2025,7680,8200,15880,19
MBARARA,2015,3460,4400,7860,19
MBARARA,2016,3550,4490,8040,19
MBARARA,2017,3620,4590,8210,19
MBARARA,2018,3710,4680,8390,19
MBARARA,2019,3790,4780,8570,19
MBARARA,2020,3870,4880,8750,19
MBARARA,2021,3950,4970,8920,19
MBARARA,2022,4030,5070,9100,19
MBARARA,2023,4110,5160,9270,19
MBARARA,2024,4180,5240,9420,19
MBARARA,2025,4260,5340,9600,19
MITOOMA,2015,1770,2000,3770,19
MITOOMA,2016,1790,2020,3810,19
MITOOMA,2017,1810,2040,3850,19
MITOOMA,2018,1840,2060,3900,19
MITOOMA,2019,1860,2080,3940,19
MITOOMA,2020,1870,2090,3960,19
MITOOMA,2021,1890,2110,4000,19
MITOOMA,2022,1910,2120,4030,19
MITOOMA,2023,1930,2130,4060,19
MITOOMA,2024,1940,2150,4090,19
MITOOMA,2025,1960,2160,4120,19
MITYANA,2015,3330,3340,6670,19
MITYANA,2016,3480,3380,6860,19
MITYANA,2017,3620,3460,7080,19
MITYANA,2018,3760,3550,7310,19
MITYANA,2019,3920,3650,7570,19
MITYANA,2020,4060,3740,7800,19
MITYANA,2021,4160,3800,7960,19
MITYANA,2022,4230,3810,8040,19
MITYANA,2023,4270,3820,8090,19
MITYANA,2024,4300,3800,8100,19
MITYANA,2025,4330,3790,8120,19
MOROTO,2015,760,860,1620,19
MOROTO,2016,800,890,1690,19
MOROTO,2017,840,910,1750,19
MOROTO,2018,870,940,1810,19
MOROTO,2019,910,980,1890,19
MOROTO,2020,940,1010,1950,19
MOROTO,2021,970,1030,2000,19
MOROTO,2022,1000,1050,2050,19
MOROTO,2023,1010,1050,2060,19
MOROTO,2024,1020,1060,2080,19
MOROTO,2025,1030,1070,2100,19
MOYO,2015,910,1040,1950,19
MOYO,2016,930,1070,2000,19
MOYO,2017,950,1090,2040,19
MOYO,2018,980,1110,2090,19
MOYO,2019,1000,1130,2130,19
MOYO,2020,1030,1160,2190,19
MOYO,2021,1050,1180,2230,19
MOYO,2022,1070,1200,2270,19
MOYO,2023,1100,1230,2330,19
MOYO,2024,1120,1250,2370,19
MOYO,2025,1140,1270,2410,19
MPIGI,2015,2470,2380,4850,19
MPIGI,2016,2590,2430,5020,19
MPIGI,2017,2720,2500,5220,19
MPIGI,2018,2830,2580,5410,19
MPIGI,2019,2970,2680,5650,19
MPIGI,2020,3090,2750,5840,19
MPIGI,2021,3190,2820,6010,19
MPIGI,2022,3270,2860,6130,19
MPIGI,2023,3320,2870,6190,19
MPIGI,2024,3350,2880,6230,19
MPIGI,2025,3400,2890,6290,19
MUBENDE,2015,4470,4620,9090,19
MUBENDE,2016,4810,4850,9660,19
MUBENDE,2017,5180,5140,10320,19
MUBENDE,2018,5580,5460,11040,19
MUBENDE,2019,6000,5810,11810,19
MUBENDE,2020,6420,6150,12570,19
MUBENDE,2021,6820,6460,13280,19
MUBENDE,2022,7180,6730,13910,19
MUBENDE,2023,7500,6960,14460,19
MUBENDE,2024,7810,7180,14990,19
MUBENDE,2025,8120,7410,15530,19
MUKONO,2015,6060,6940,13000,19
MUKONO,2016,6370,7130,13500,19
MUKONO,2017,6690,7390,14080,19
MUKONO,2018,7020,7690,14710,19
MUKONO,2019,7370,8020,15390,19
MUKONO,2020,7680,8310,15990,19
MUKONO,2021,7960,8550,16510,19
MUKONO,2022,8180,8710,16890,19
MUKONO,2023,8340,8820,17160,19
MUKONO,2024,8460,8910,17370,19
MUKONO,2025,8590,9000,17590,19
MADI OKOLLO,2015,1340,1410,2750,19
MADI OKOLLO,2016,1380,1460,2840,19
MADI OKOLLO,2017,1420,1490,2910,19
MADI OKOLLO,2018,1460,1530,2990,19
MADI OKOLLO,2019,1500,1570,3070,19
MADI OKOLLO,2020,1550,1610,3160,19
MADI OKOLLO,2021,1580,1650,3230,19
MADI OKOLLO,2022,1630,1700,3330,19
MADI OKOLLO,2023,1670,1730,3400,19
MADI OKOLLO,2024,1710,1770,3480,19
MADI OKOLLO,2025,1750,1810,3560,19
NABILATUK,2015,680,620,1300,19
NABILATUK,2016,730,640,1370,19
NABILATUK,2017,780,670,1450,19
NABILATUK,2018,830,710,1540,19
NABILATUK,2019,900,750,1650,19
NABILATUK,2020,950,790,1740,19
NABILATUK,2021,1010,820,1830,19
NABILATUK,2022,1060,850,1910,19
NABILATUK,2023,1110,870,1980,19
NABILATUK,2024,1150,900,2050,19
NABILATUK,2025,1190,920,2110,19
NAKAPIRIPIRIT,2015,800,830,1630,19
NAKAPIRIPIRIT,2016,850,860,1710,19
NAKAPIRIPIRIT,2017,910,910,1820,19
NAKAPIRIPIRIT,2018,970,970,1940,19
NAKAPIRIPIRIT,2019,1030,1010,2040,19
NAKAPIRIPIRIT,2020,1100,1060,2160,19
NAKAPIRIPIRIT,2021,1150,1110,2260,19
NAKAPIRIPIRIT,2022,1200,1150,2350,19
NAKAPIRIPIRIT,2023,1250,1180,2430,19
NAKAPIRIPIRIT,2024,1290,1210,2500,19
NAKAPIRIPIRIT,2025,1330,1240,2570,19
NAKASEKE,2015,1920,1780,3700,19
NAKASEKE,2016,1990,1830,3820,19
NAKASEKE,2017,2070,1870,3940,19
NAKASEKE,2018,2140,1910,4050,19
NAKASEKE,2019,2220,1960,4180,19
NAKASEKE,2020,2300,2000,4300,19
NAKASEKE,2021,2370,2050,4420,19
NAKASEKE,2022,2450,2090,4540,19
NAKASEKE,2023,2530,2130,4660,19
NAKASEKE,2024,2620,2180,4800,19
NAKASEKE,2025,2700,2220,4920,19
NAKASONGOLA,2015,2090,1900,3990,19
NAKASONGOLA,2016,2200,1950,4150,19
NAKASONGOLA,2017,2320,2010,4330,19
NAKASONGOLA,2018,2460,2090,4550,19
NAKASONGOLA,2019,2580,2170,4750,19
NAKASONGOLA,2020,2700,2240,4940,19
NAKASONGOLA,2021,2820,2310,5130,19
NAKASONGOLA,2022,2910,2350,5260,19
NAKASONGOLA,2023,2970,2370,5340,19
NAKASONGOLA,2024,3040,2390,5430,19
NAKASONGOLA,2025,3100,2410,5510,19
NAMAYINGO,2015,1950,2280,4230,19
NAMAYINGO,2016,2040,2310,4350,19
NAMAYINGO,2017,2120,2370,4490,19
NAMAYINGO,2018,2210,2430,4640,19
NAMAYINGO,2019,2290,2490,4780,19
NAMAYINGO,2020,2370,2550,4920,19
NAMAYINGO,2021,2440,2580,5020,19
NAMAYINGO,2022,2490,2600,5090,19
NAMAYINGO,2023,2510,2600,5110,19
NAMAYINGO,2024,2530,2590,5120,19
NAMAYINGO,2025,2550,2570,5120,19
NAMISINDWA,2015,1720,1990,3710,19
NAMISINDWA,2016,1770,2030,3800,19
NAMISINDWA,2017,1820,2080,3900,19
NAMISINDWA,2018,1870,2130,4000,19
NAMISINDWA,2019,1920,2180,4100,19
NAMISINDWA,2020,1970,2230,4200,19
NAMISINDWA,2021,2030,2280,4310,19
NAMISINDWA,2022,2080,2320,4400,19
NAMISINDWA,2023,2130,2370,4500,19
NAMISINDWA,2024,2180,2420,4600,19
NAMISINDWA,2025,2230,2460,4690,19
NAMUTUMBA,2015,2530,2490,5020,19
NAMUTUMBA,2016,2680,2570,5250,19
NAMUTUMBA,2017,2850,2670,5520,19
NAMUTUMBA,2018,3010,2790,5800,19
NAMUTUMBA,2019,3180,2910,6090,19
NAMUTUMBA,2020,3350,3030,6380,19
NAMUTUMBA,2021,3490,3120,6610,19
NAMUTUMBA,2022,3610,3200,6810,19
NAMUTUMBA,2023,3710,3260,6970,19
NAMUTUMBA,2024,3810,3290,7100,19
NAMUTUMBA,2025,3890,3340,7230,19
NAPAK,2015,1020,1170,2190,19
NAPAK,2016,1060,1200,2260,19
NAPAK,2017,1110,1230,2340,19
NAPAK,2018,1150,1260,2410,19
NAPAK,2019,1200,1310,2510,19
NAPAK,2020,1230,1340,2570,19
NAPAK,2021,1270,1380,2650,19
NAPAK,2022,1280,1390,2670,19
NAPAK,2023,1290,1390,2680,19
NAPAK,2024,1300,1390,2690,19
NAPAK,2025,1310,1390,2700,19
NEBBI,2015,2050,2460,4510,19
NEBBI,2016,2110,2530,4640,19
NEBBI,2017,2180,2600,4780,19
NEBBI,2018,2250,2680,4930,19
NEBBI,2019,2320,2750,5070,19
NEBBI,2020,2390,2820,5210,19
NEBBI,2021,2460,2900,5360,19
NEBBI,2022,2530,2970,5500,19
NEBBI,2023,2600,3050,5650,19
NEBBI,2024,2670,3120,5790,19
NEBBI,2025,2740,3190,5930,19
NGORA,2015,1570,1580,3150,19
NGORA,2016,1650,1610,3260,19
NGORA,2017,1730,1670,3400,19
NGORA,2018,1830,1730,3560,19
NGORA,2019,1920,1790,3710,19
NGORA,2020,2000,1850,3850,19
NGORA,2021,2090,1910,4000,19
NGORA,2022,2140,1940,4080,19
NGORA,2023,2180,1960,4140,19
NGORA,2024,2210,1970,4180,19
NGORA,2025,2260,1980,4240,19
NTOROKO,2015,650,660,1310,19
NTOROKO,2016,690,670,1360,19
NTOROKO,2017,720,680,1400,19
NTOROKO,2018,750,710,1460,19
NTOROKO,2019,790,730,1520,19
NTOROKO,2020,820,750,1570,19
NTOROKO,2021,840,760,1600,19
NTOROKO,2022,870,780,1650,19
NTOROKO,2023,880,780,1660,19
NTOROKO,2024,900,780,1680,19
NTOROKO,2025,900,770,1670,19
NTUNGAMO,2015,4410,5020,9430,19
NTUNGAMO,2016,4510,5110,9620,19
NTUNGAMO,2017,4600,5210,9810,19
NTUNGAMO,2018,4700,5300,10000,19
NTUNGAMO,2019,4800,5400,10200,19
NTUNGAMO,2020,4890,5490,10380,19
NTUNGAMO,2021,4990,5580,10570,19
NTUNGAMO,2022,5080,5670,10750,19
NTUNGAMO,2023,5170,5750,10920,19
NTUNGAMO,2024,5260,5840,11100,19
NTUNGAMO,2025,5340,5920,11260,19
NWOYA,2015,1160,1390,2550,19
NWOYA,2016,1280,1530,2810,19
NWOYA,2017,1410,1690,3100,19
NWOYA,2018,1560,1860,3420,19
NWOYA,2019,1720,2040,3760,19
NWOYA,2020,1900,2250,4150,19
NWOYA,2021,2090,2470,4560,19
NWOYA,2022,2310,2720,5030,19
NWOYA,2023,2540,2990,5530,19
NWOYA,2024,2790,3280,6070,19
NWOYA,2025,3070,3600,6670,19
OBONGI,2015,450,420,870,19
OBONGI,2016,470,430,900,19
OBONGI,2017,490,440,930,19
OBONGI,2018,530,460,990,19
OBONGI,2019,540,470,1010,19
OBONGI,2020,570,480,1050,19
OBONGI,2021,590,490,1080,19
OBONGI,2022,600,500,1100,19
OBONGI,2023,610,500,1110,19
OBONGI,2024,610,500,1110,19
OBONGI,2025,630,510,1140,19
OMORO,2015,1650,1720,3370,19
OMORO,2016,1760,1780,3540,19
OMORO,2017,1850,1860,3710,19
OMORO,2018,1970,1940,3910,19
OMORO,2019,2070,2030,4100,19
OMORO,2020,2180,2110,4290,19
OMORO,2021,2280,2190,4470,19
OMORO,2022,2360,2240,4600,19
OMORO,2023,2420,2290,4710,19
OMORO,2024,2480,2320,4800,19
OMORO,2025,2550,2360,4910,19
OTUKE,2015,910,1120,2030,19
OTUKE,2016,950,1170,2120,19
OTUKE,2017,1000,1220,2220,19
OTUKE,2018,1040,1270,2310,19
OTUKE,2019,1090,1330,2420,19
OTUKE,2020,1130,1380,2510,19
OTUKE,2021,1180,1440,2620,19
OTUKE,2022,1230,1500,2730,19
OTUKE,2023,1280,1560,2840,19
OTUKE,2024,1340,1620,2960,19
OTUKE,2025,1390,1680,3070,19
OYAM,2015,3690,4380,8070,19
OYAM,2016,3800,4510,8310,19
OYAM,2017,3910,4640,8550,19
OYAM,2018,4030,4770,8800,19
OYAM,2019,4150,4910,9060,19
OYAM,2020,4270,5040,9310,19
OYAM,2021,4390,5180,9570,19
OYAM,2022,4520,5320,9840,19
OYAM,2023,4640,5450,10090,19
OYAM,2024,4760,5590,10350,19
OYAM,2025,4880,5730,10610,19
PADER,2015,1800,1710,3510,19
PADER,2016,1870,1740,3610,19
PADER,2017,1950,1780,3730,19
PADER,2018,2030,1850,3880,19
PADER,2019,2110,1900,4010,19
PADER,2020,2180,1950,4130,19
PADER,2021,2230,1980,4210,19
PADER,2022,2270,2000,4270,19
PADER,2023,2300,2010,4310,19
PADER,2024,2300,2010,4310,19
PADER,2025,2310,2000,4310,19
PAKWACH,2015,1460,1740,3200,19
PAKWACH,2016,1530,1800,3330,19
PAKWACH,2017,1590,1870,3460,19
PAKWACH,2018,1660,1940,3600,19
PAKWACH,2019,1720,2010,3730,19
PAKWACH,2020,1790,2080,3870,19
PAKWACH,2021,1860,2150,4010,19
PAKWACH,2022,1940,2220,4160,19
PAKWACH,2023,2010,2290,4300,19
PAKWACH,2024,2090,2370,4460,19
PAKWACH,2025,2160,2440,4600,19
PALLISA,2015,2940,2960,5900,19
PALLISA,2016,3140,3090,6230,19
PALLISA,2017,3360,3240,6600,19
PALLISA,2018,3590,3420,7010,19
PALLISA,2019,3830,3610,7440,19
PALLISA,2020,4060,3790,7850,19
PALLISA,2021,4270,3960,8230,19
PALLISA,2022,4470,4080,8550,19
PALLISA,2023,4640,4190,8830,19
PALLISA,2024,4800,4300,9100,19
PALLISA,2025,4950,4400,9350,19
RAKAI,2015,2270,2510,4780,19
RAKAI,2016,2390,2570,4960,19
RAKAI,2017,2500,2650,5150,19
RAKAI,2018,2630,2740,5370,19
RAKAI,2019,2740,2840,5580,19
RAKAI,2020,2870,2910,5780,19
RAKAI,2021,2960,2980,5940,19
RAKAI,2022,3020,3030,6050,19
RAKAI,2023,3090,3040,6130,19
RAKAI,2024,3130,3050,6180,19
RAKAI,2025,3160,3060,6220,19
RUBANDA,2015,1600,2090,3690,19
RUBANDA,2016,1620,2110,3730,19
RUBANDA,2017,1650,2120,3770,19
RUBANDA,2018,1670,2140,3810,19
RUBANDA,2019,1690,2160,3850,19
RUBANDA,2020,1710,2170,3880,19
RUBANDA,2021,1730,2180,3910,19
RUBANDA,2022,1740,2200,3940,19
RUBANDA,2023,1760,2210,3970,19
RUBANDA,2024,1780,2220,4000,19
RUBANDA,2025,1790,2220,4010,19
RUBIRIZI,2015,1070,1230,2300,19
RUBIRIZI,2016,1090,1260,2350,19
RUBIRIZI,2017,1110,1280,2390,19
RUBIRIZI,2018,1130,1310,2440,19
RUBIRIZI,2019,1160,1330,2490,19
RUBIRIZI,2020,1180,1350,2530,19
RUBIRIZI,2021,1200,1380,2580,19
RUBIRIZI,2022,1220,1400,2620,19
RUBIRIZI,2023,1240,1420,2660,19
RUBIRIZI,2024,1260,1440,2700,19
RUBIRIZI,2025,1280,1460,2740,19
RUKIGA,2015,900,1010,1910,19
RUKIGA,2016,910,1010,1920,19
RUKIGA,2017,920,1020,1940,19
RUKIGA,2018,930,1030,1960,19
RUKIGA,2019,940,1040,1980,19
RUKIGA,2020,950,1040,1990,19
RUKIGA,2021,960,1050,2010,19
RUKIGA,2022,960,1050,2010,19
RUKIGA,2023,970,1060,2030,19
RUKIGA,2024,970,1060,2030,19
RUKIGA,2025,980,1060,2040,19
RUKUNGIRI,2015,2990,3470,6460,19
RUKUNGIRI,2016,3030,3500,6530,19
RUKUNGIRI,2017,3060,3540,6600,19
RUKUNGIRI,2018,3100,3570,6670,19
RUKUNGIRI,2019,3140,3600,6740,19
RUKUNGIRI,2020,3170,3630,6800,19
RUKUNGIRI,2021,3200,3660,6860,19
RUKUNGIRI,2022,3230,3690,6920,19
RUKUNGIRI,2023,3260,3710,6970,19
RUKUNGIRI,2024,3280,3730,7010,19
RUKUNGIRI,2025,3300,3750,7050,19
RWAMPARA,2015,1200,1310,2510,19
RWAMPARA,2016,1220,1330,2550,19
RWAMPARA,2017,1250,1360,2610,19
RWAMPARA,2018,1280,1390,2670,19
RWAMPARA,2019,1310,1420,2730,19
RWAMPARA,2020,1340,1450,2790,19
RWAMPARA,2021,1360,1480,2840,19
RWAMPARA,2022,1390,1510,2900,19
RWAMPARA,2023,1420,1530,2950,19
RWAMPARA,2024,1440,1560,3000,19
RWAMPARA,2025,1470,1590,3060,19
SERERE,2015,2970,3110,6080,19
SERERE,2016,3160,3230,6390,19
SERERE,2017,3360,3380,6740,19
SERERE,2018,3580,3550,7130,19
SERERE,2019,3800,3740,7540,19
SERERE,2020,4020,3910,7930,19
SERERE,2021,4220,4060,8280,19
SERERE,2022,4400,4180,8580,19
SERERE,2023,4540,4280,8820,19
SERERE,2024,4670,4360,9030,19
SERERE,2025,4810,4440,9250,19
SHEEMA,2015,2230,2330,4560,19
SHEEMA,2016,2260,2360,4620,19
SHEEMA,2017,2280,2380,4660,19
SHEEMA,2018,2310,2410,4720,19
SHEEMA,2019,2340,2430,4770,19
SHEEMA,2020,2360,2450,4810,19
SHEEMA,2021,2380,2470,4850,19
SHEEMA,2022,2410,2490,4900,19
SHEEMA,2023,2430,2510,4940,19
SHEEMA,2024,2450,2530,4980,19
SHEEMA,2025,2460,2540,5000,19
SIRONKO,2015,2210,2310,4520,19
SIRONKO,2016,2270,2360,4630,19
SIRONKO,2017,2320,2410,4730,19
SIRONKO,2018,2370,2460,4830,19
SIRONKO,2019,2430,2510,4940,19
SIRONKO,2020,2480,2550,5030,19
SIRONKO,2021,2530,2600,5130,19
SIRONKO,2022,2590,2650,5240,19
SIRONKO,2023,2640,2690,5330,19
SIRONKO,2024,2690,2730,5420,19
SIRONKO,2025,2740,2780,5520,19
SOROTI,2015,3620,3760,7380,19
SOROTI,2016,3840,3880,7720,19
SOROTI,2017,4070,4050,8120,19
SOROTI,2018,4300,4230,8530,19
SOROTI,2019,4550,4430,8980,19
SOROTI,2020,4790,4610,9400,19
SOROTI,2021,5020,4770,9790,19
SOROTI,2022,5190,4890,10080,19
SOROTI,2023,5340,4980,10320,19
SOROTI,2024,5480,5060,10540,19
SOROTI,2025,5600,5130,10730,19
SSEMBABULE,2015,2230,2340,4570,19
SSEMBABULE,2016,2350,2390,4740,19
SSEMBABULE,2017,2480,2470,4950,19
SSEMBABULE,2018,2610,2570,5180,19
SSEMBABULE,2019,2740,2680,5420,19
SSEMBABULE,2020,2870,2760,5630,19
SSEMBABULE,2021,2970,2830,5800,19
SSEMBABULE,2022,3060,2880,5940,19
SSEMBABULE,2023,3120,2900,6020,19
SSEMBABULE,2024,3180,2930,6110,19
SSEMBABULE,2025,3230,2950,6180,19
TORORO,2015,5070,5650,10720,19
TORORO,2016,5200,5790,10990,19
TORORO,2017,5340,5940,11280,19
TORORO,2018,5480,6080,11560,19
TORORO,2019,5620,6230,11850,19
TORORO,2020,5760,6380,12140,19
TORORO,2021,5900,6520,12420,19
TORORO,2022,6040,6670,12710,19
TORORO,2023,6180,6810,12990,19
TORORO,2024,6320,6950,13270,19
TORORO,2025,6450,7100,13550,19
WAKISO,2015,18450,27630,46080,19
WAKISO,2016,19680,29520,49200,19
WAKISO,2017,21000,31550,52550,19
WAKISO,2018,22390,33680,56070,19
WAKISO,2019,23880,35940,59820,19
WAKISO,2020,25440,38330,63770,19
WAKISO,2021,27070,40870,67940,19
WAKISO,2022,28810,43570,72380,19
WAKISO,2023,30640,46370,77010,19
WAKISO,2024,32540,49320,81860,19
WAKISO,2025,34550,52460,87010,19
YUMBE,2015,3990,4280,8270,19
YUMBE,2016,4280,4520,8800,19
YUMBE,2017,4610,4820,9430,19
YUMBE,2018,4950,5170,10120,19
YUMBE,2019,5310,5530,10840,19
YUMBE,2020,5680,5900,11580,19
YUMBE,2021,6030,6250,12280,19
YUMBE,2022,6330,6550,12880,19
YUMBE,2023,6610,6830,13440,19
YUMBE,2024,6870,7100,13970,19
YUMBE,2025,7130,7380,14510,19
ZOMBO,2015,1640,2220,3860,19
ZOMBO,2016,1690,2280,3970,19
ZOMBO,2017,1740,2340,4080,19
ZOMBO,2018,1790,2410,4200,19
ZOMBO,2019,1850,2470,4320,19
ZOMBO,2020,1900,2540,4440,19
ZOMBO,2021,1960,2600,4560,19
ZOMBO,2022,2010,2670,4680,19
ZOMBO,2023,2070,2730,4800,19
ZOMBO,2024,2120,2800,4920,19
ZOMBO,2025,2170,2860,5030,19
ABIM,2015,2110,2100,4210,2
ABIM,2016,2300,2250,4550,2
ABIM,2017,2390,2470,4860,2
ABIM,2018,2520,2600,5120,2
ABIM,2019,2650,2720,5370,2
ABIM,2020,2780,2860,5640,2
ABIM,2021,2920,3000,5920,2
ABIM,2022,3060,3140,6200,2
ABIM,2023,3210,3270,6480,2
ABIM,2024,3350,3420,6770,2
ABIM,2025,3510,3570,7080,2
ADJUMANI,2015,4860,4310,9170,2
ADJUMANI,2016,4900,4350,9250,2
ADJUMANI,2017,4940,4390,9330,2
ADJUMANI,2018,4970,4440,9410,2
ADJUMANI,2019,5010,4480,9490,2
ADJUMANI,2020,5030,4520,9550,2
ADJUMANI,2021,5060,4550,9610,2
ADJUMANI,2022,5080,4580,9660,2
ADJUMANI,2023,5100,4610,9710,2
ADJUMANI,2024,5120,4640,9760,2
ADJUMANI,2025,5130,4660,9790,2
AGAGO,2015,4700,4350,9050,2
AGAGO,2016,4790,4420,9210,2
AGAGO,2017,4870,4500,9370,2
AGAGO,2018,4960,4580,9540,2
AGAGO,2019,5040,4660,9700,2
AGAGO,2020,5120,4730,9850,2
AGAGO,2021,5200,4810,10010,2
AGAGO,2022,5270,4880,10150,2
AGAGO,2023,5350,4950,10300,2
AGAGO,2024,5420,5010,10430,2
AGAGO,2025,5480,5080,10560,2
ALEBTONG,2015,4060,3790,7850,2
ALEBTONG,2016,4270,3950,8220,2
ALEBTONG,2017,4300,4180,8480,2
ALEBTONG,2018,4370,4250,8620,2
ALEBTONG,2019,4440,4320,8760,2
ALEBTONG,2020,4500,4390,8890,2
ALEBTONG,2021,4570,4450,9020,2
ALEBTONG,2022,4620,4500,9120,2
ALEBTONG,2023,4680,4560,9240,2
ALEBTONG,2024,4740,4610,9350,2
ALEBTONG,2025,4780,4660,9440,2
AMOLATAR,2015,2600,2440,5040,2
AMOLATAR,2016,2720,2530,5250,2
AMOLATAR,2017,2740,2690,5430,2
AMOLATAR,2018,2770,2720,5490,2
AMOLATAR,2019,2810,2750,5560,2
AMOLATAR,2020,2850,2790,5640,2
AMOLATAR,2021,2890,2820,5710,2
AMOLATAR,2022,2920,2850,5770,2
AMOLATAR,2023,2950,2870,5820,2
AMOLATAR,2024,2980,2900,5880,2
AMOLATAR,2025,3000,2920,5920,2
AMUDAT,2015,2250,2330,4580,2
AMUDAT,2016,2390,2470,4860,2
AMUDAT,2017,2440,2680,5120,2
AMUDAT,2018,2510,2770,5280,2
AMUDAT,2019,2570,2860,5430,2
AMUDAT,2020,2640,2960,5600,2
AMUDAT,2021,2710,3050,5760,2
AMUDAT,2022,2770,3160,5930,2
AMUDAT,2023,2840,3250,6090,2
AMUDAT,2024,2900,3360,6260,2
AMUDAT,2025,2960,3450,6410,2
AMURIA,2015,3620,3340,6960,2
AMURIA,2016,3840,3510,7350,2
AMURIA,2017,3900,3750,7650,2
AMURIA,2018,4000,3840,7840,2
AMURIA,2019,4100,3930,8030,2
AMURIA,2020,4200,4020,8220,2
AMURIA,2021,4300,4110,8410,2
AMURIA,2022,4390,4190,8580,2
AMURIA,2023,4490,4270,8760,2
AMURIA,2024,4580,4360,8940,2
AMURIA,2025,4660,4430,9090,2
AMURU,2015,3620,3320,6940,2
AMURU,2016,3800,3460,7260,2
AMURU,2017,3810,3670,7480,2
AMURU,2018,3870,3730,7600,2
AMURU,2019,3920,3790,7710,2
AMURU,2020,3980,3840,7820,2
AMURU,2021,4020,3890,7910,2
AMURU,2022,4060,3930,7990,2
AMURU,2023,4100,3990,8090,2
AMURU,2024,4150,4030,8180,2
AMURU,2025,4170,4060,8230,2
APAC,2015,3430,3200,6630,2
APAC,2016,3560,3310,6870,2
APAC,2017,3690,3430,7120,2
APAC,2018,3830,3540,7370,2
APAC,2019,3960,3660,7620,2
APAC,2020,4100,3790,7890,2
APAC,2021,4240,3910,8150,2
APAC,2022,4390,4040,8430,2
APAC,2023,4530,4160,8690,2
APAC,2024,4680,4290,8970,2
APAC,2025,4830,4420,9250,2
ARUA,2015,11540,10550,22090,2
ARUA,2016,11880,10830,22710,2
ARUA,2017,12210,11130,23340,2
ARUA,2018,12570,11420,23990,2
ARUA,2019,12920,11730,24650,2
ARUA,2020,13260,12030,25290,2
ARUA,2021,13630,12320,25950,2
ARUA,2022,13980,12630,26610,2
ARUA,2023,14330,12930,27260,2
ARUA,2024,14680,13230,27910,2
ARUA,2025,15030,13530,28560,2
BUDAKA,2015,4180,3870,8050,2
BUDAKA,2016,4420,4050,8470,2
BUDAKA,2017,4490,4330,8820,2
BUDAKA,2018,4600,4420,9020,2
BUDAKA,2019,4700,4530,9230,2
BUDAKA,2020,4810,4630,9440,2
BUDAKA,2021,4910,4720,9630,2
BUDAKA,2022,5010,4820,9830,2
BUDAKA,2023,5120,4910,10030,2
BUDAKA,2024,5210,5000,10210,2
BUDAKA,2025,5300,5080,10380,2
BUDUDA,2015,3830,3780,7610,2
BUDUDA,2016,4090,4010,8100,2
BUDUDA,2017,4190,4330,8520,2
BUDUDA,2018,4330,4480,8810,2
BUDUDA,2019,4470,4620,9090,2
BUDUDA,2020,4610,4770,9380,2
BUDUDA,2021,4750,4920,9670,2
BUDUDA,2022,4890,5070,9960,2
BUDUDA,2023,5040,5230,10270,2
BUDUDA,2024,5180,5370,10550,2
BUDUDA,2025,5310,5510,10820,2
BUGIRI,2015,7780,7240,15020,2
BUGIRI,2016,8270,7620,15890,2
BUGIRI,2017,8440,8190,16630,2
BUGIRI,2018,8690,8420,17110,2
BUGIRI,2019,8930,8650,17580,2
BUGIRI,2020,9180,8880,18060,2
BUGIRI,2021,9420,9110,18530,2
BUGIRI,2022,9660,9330,18990,2
BUGIRI,2023,9910,9560,19470,2
BUGIRI,2024,10150,9780,19930,2
BUGIRI,2025,10370,9980,20350,2
BUGWERI,2015,3010,2880,5890,2
BUGWERI,2016,3160,3000,6160,2
BUGWERI,2017,3180,3170,6350,2
BUGWERI,2018,3230,3220,6450,2
BUGWERI,2019,3270,3270,6540,2
BUGWERI,2020,3330,3310,6640,2
BUGWERI,2021,3370,3360,6730,2
BUGWERI,2022,3400,3390,6790,2
BUGWERI,2023,3440,3430,6870,2
BUGWERI,2024,3480,3460,6940,2
BUGWERI,2025,3510,3490,7000,2
BUHWEJU,2015,2310,2230,4540,2
BUHWEJU,2016,2390,2300,4690,2
BUHWEJU,2017,2460,2370,4830,2
BUHWEJU,2018,2540,2440,4980,2
BUHWEJU,2019,2620,2510,5130,2
BUHWEJU,2020,2710,2590,5300,2
BUHWEJU,2021,2790,2660,5450,2
BUHWEJU,2022,2870,2730,5600,2
BUHWEJU,2023,2950,2810,5760,2
BUHWEJU,2024,3030,2880,5910,2
BUHWEJU,2025,3120,2960,6080,2
BUIKWE,2015,7530,6840,14370,2
BUIKWE,2016,7840,7070,14910,2
BUIKWE,2017,7840,7470,15310,2
BUIKWE,2018,7910,7540,15450,2
BUIKWE,2019,7970,7610,15580,2
BUIKWE,2020,8030,7670,15700,2
BUIKWE,2021,8070,7720,15790,2
BUIKWE,2022,8110,7770,15880,2
BUIKWE,2023,8150,7810,15960,2
BUIKWE,2024,8180,7860,16040,2
BUIKWE,2025,8190,7870,16060,2
BUKEDEA,2015,3820,3800,7620,2
BUKEDEA,2016,4070,4010,8080,2
BUKEDEA,2017,4160,4320,8480,2
BUKEDEA,2018,4300,4440,8740,2
BUKEDEA,2019,4440,4580,9020,2
BUKEDEA,2020,4580,4710,9290,2
BUKEDEA,2021,4710,4840,9550,2
BUKEDEA,2022,4850,4970,9820,2
BUKEDEA,2023,4990,5100,10090,2
BUKEDEA,2024,5120,5230,10350,2
BUKEDEA,2025,5250,5350,10600,2
BUKOMANSIMBI,2015,2690,2340,5030,2
BUKOMANSIMBI,2016,2760,2380,5140,2
BUKOMANSIMBI,2017,2730,2470,5200,2
BUKOMANSIMBI,2018,2720,2460,5180,2
BUKOMANSIMBI,2019,2700,2440,5140,2
BUKOMANSIMBI,2020,2700,2430,5130,2
BUKOMANSIMBI,2021,2670,2400,5070,2
BUKOMANSIMBI,2022,2650,2390,5040,2
BUKOMANSIMBI,2023,2640,2360,5000,2
BUKOMANSIMBI,2024,2610,2330,4940,2
BUKOMANSIMBI,2025,2590,2300,4890,2
BUKWO,2015,1850,1720,3570,2
BUKWO,2016,1940,1800,3740,2
BUKWO,2017,2050,1890,3940,2
BUKWO,2018,2160,1980,4140,2
BUKWO,2019,2270,2080,4350,2
BUKWO,2020,2390,2180,4570,2
BUKWO,2021,2510,2280,4790,2
BUKWO,2022,2640,2380,5020,2
BUKWO,2023,2770,2490,5260,2
BUKWO,2024,2900,2600,5500,2
BUKWO,2025,3040,2720,5760,2
BULAMBULI,2015,2960,2820,5780,2
BULAMBULI,2016,3170,3010,6180,2
BULAMBULI,2017,3260,3260,6520,2
BULAMBULI,2018,3380,3390,6770,2
BULAMBULI,2019,3500,3520,7020,2
BULAMBULI,2020,3630,3640,7270,2
BULAMBULI,2021,3750,3770,7520,2
BULAMBULI,2022,3880,3910,7790,2
BULAMBULI,2023,4010,4040,8050,2
BULAMBULI,2024,4140,4170,8310,2
BULAMBULI,2025,4270,4300,8570,2
BULIISA,2015,2310,2100,4410,2
BULIISA,2016,2440,2200,4640,2
BULIISA,2017,2570,2290,4860,2
BULIISA,2018,2710,2400,5110,2
BULIISA,2019,2850,2500,5350,2
BULIISA,2020,3000,2600,5600,2
BULIISA,2021,3160,2710,5870,2
BULIISA,2022,3320,2830,6150,2
BULIISA,2023,3490,2950,6440,2
BULIISA,2024,3660,3060,6720,2
BULIISA,2025,3830,3180,7010,2
BUNDIBUGYO,2015,4630,4320,8950,2
BUNDIBUGYO,2016,4870,4500,9370,2
BUNDIBUGYO,2017,4920,4780,9700,2
BUNDIBUGYO,2018,5000,4860,9860,2
BUNDIBUGYO,2019,5090,4940,10030,2
BUNDIBUGYO,2020,5170,5010,10180,2
BUNDIBUGYO,2021,5250,5080,10330,2
BUNDIBUGYO,2022,5340,5150,10490,2
BUNDIBUGYO,2023,5410,5220,10630,2
BUNDIBUGYO,2024,5480,5270,10750,2
BUNDIBUGYO,2025,5540,5320,10860,2
BUNYANGABU,2015,3230,2930,6160,2
BUNYANGABU,2016,3390,3030,6420,2
BUNYANGABU,2017,3400,3200,6600,2
BUNYANGABU,2018,3460,3240,6700,2
BUNYANGABU,2019,3500,3280,6780,2
BUNYANGABU,2020,3540,3310,6850,2
BUNYANGABU,2021,3580,3350,6930,2
BUNYANGABU,2022,3610,3370,6980,2
BUNYANGABU,2023,3650,3400,7050,2
BUNYANGABU,2024,3680,3420,7100,2
BUNYANGABU,2025,3710,3440,7150,2
BUSHENYI,2015,3850,3530,7380,2
BUSHENYI,2016,3900,3560,7460,2
BUSHENYI,2017,3940,3590,7530,2
BUSHENYI,2018,3990,3620,7610,2
BUSHENYI,2019,4040,3650,7690,2
BUSHENYI,2020,4080,3680,7760,2
BUSHENYI,2021,4120,3710,7830,2
BUSHENYI,2022,4160,3730,7890,2
BUSHENYI,2023,4200,3750,7950,2
BUSHENYI,2024,4230,3770,8000,2
BUSHENYI,2025,4260,3780,8040,2
BUSIA,2015,5890,5630,11520,2
BUSIA,2016,6190,5870,12060,2
BUSIA,2017,6260,6240,12500,2
BUSIA,2018,6390,6350,12740,2
BUSIA,2019,6510,6470,12980,2
BUSIA,2020,6630,6570,13200,2
BUSIA,2021,6740,6670,13410,2
BUSIA,2022,6850,6770,13620,2
BUSIA,2023,6960,6870,13830,2
BUSIA,2024,7060,6950,14010,2
BUSIA,2025,7150,7030,14180,2
BUTALEJA,2015,5120,4730,9850,2
BUTALEJA,2016,5420,4970,10390,2
BUTALEJA,2017,5510,5310,10820,2
BUTALEJA,2018,5650,5450,11100,2
BUTALEJA,2019,5800,5570,11370,2
BUTALEJA,2020,5940,5710,11650,2
BUTALEJA,2021,6080,5840,11920,2
BUTALEJA,2022,6210,5950,12160,2
BUTALEJA,2023,6350,6080,12430,2
BUTALEJA,2024,6480,6200,12680,2
BUTALEJA,2025,6600,6310,12910,2
BUTAMBALA,2015,1890,1710,3600,2
BUTAMBALA,2016,1950,1740,3690,2
BUTAMBALA,2017,1940,1820,3760,2
BUTAMBALA,2018,1940,1830,3770,2
BUTAMBALA,2019,1940,1830,3770,2
BUTAMBALA,2020,1950,1820,3770,2
BUTAMBALA,2021,1940,1820,3760,2
BUTAMBALA,2022,1940,1810,3750,2
BUTAMBALA,2023,1940,1800,3740,2
BUTAMBALA,2024,1930,1800,3730,2
BUTAMBALA,2025,1920,1780,3700,2
BUTEBO,2015,2290,2120,4410,2
BUTEBO,2016,2370,2180,4550,2
BUTEBO,2017,2350,2280,4630,2
BUTEBO,2018,2360,2290,4650,2
BUTEBO,2019,2370,2290,4660,2
BUTEBO,2020,2380,2290,4670,2
BUTEBO,2021,2390,2300,4690,2
BUTEBO,2022,2390,2300,4690,2
BUTEBO,2023,2390,2290,4680,2
BUTEBO,2024,2390,2290,4680,2
BUTEBO,2025,2380,2280,4660,2
BUVUMA,2015,2010,1890,3900,2
BUVUMA,2016,2140,2020,4160,2
BUVUMA,2017,2270,2160,4430,2
BUVUMA,2018,2410,2300,4710,2
BUVUMA,2019,2550,2460,5010,2
BUVUMA,2020,2710,2620,5330,2
BUVUMA,2021,2870,2790,5660,2
BUVUMA,2022,3040,2970,6010,2
BUVUMA,2023,3220,3160,6380,2
BUVUMA,2024,3400,3360,6760,2
BUVUMA,2025,3590,3570,7160,2
BUYENDE,2015,7250,6790,14040,2
BUYENDE,2016,7730,7190,14920,2
BUYENDE,2017,7920,7750,15670,2
BUYENDE,2018,8170,8010,16180,2
BUYENDE,2019,8440,8270,16710,2
BUYENDE,2020,8710,8520,17230,2
BUYENDE,2021,8970,8770,17740,2
BUYENDE,2022,9230,9020,18250,2
BUYENDE,2023,9500,9290,18790,2
BUYENDE,2024,9760,9530,19290,2
BUYENDE,2025,10010,9770,19780,2
DOKOLO,2015,3270,3020,6290,2
DOKOLO,2016,3380,3100,6480,2
DOKOLO,2017,3480,3190,6670,2
DOKOLO,2018,3580,3270,6850,2
DOKOLO,2019,3690,3360,7050,2
DOKOLO,2020,3790,3450,7240,2
DOKOLO,2021,3910,3540,7450,2
DOKOLO,2022,4010,3620,7630,2
DOKOLO,2023,4120,3710,7830,2
DOKOLO,2024,4230,3800,8030,2
DOKOLO,2025,4330,3880,8210,2
GOMBA,2015,2980,2570,5550,2
GOMBA,2016,3090,2640,5730,2
GOMBA,2017,3080,2760,5840,2
GOMBA,2018,3100,2770,5870,2
GOMBA,2019,3120,2770,5890,2
GOMBA,2020,3130,2770,5900,2
GOMBA,2021,3150,2760,5910,2
GOMBA,2022,3150,2760,5910,2
GOMBA,2023,3160,2750,5910,2
GOMBA,2024,3150,2740,5890,2
GOMBA,2025,3150,2720,5870,2
GULU,2015,4810,4290,9100,2
GULU,2016,4950,4410,9360,2
GULU,2017,5100,4540,9640,2
GULU,2018,5250,4670,9920,2
GULU,2019,5410,4800,10210,2
GULU,2020,5560,4940,10500,2
GULU,2021,5720,5070,10790,2
GULU,2022,5870,5200,11070,2
GULU,2023,6030,5340,11370,2
GULU,2024,6180,5470,11650,2
GULU,2025,6340,5610,11950,2
HOIMA,2015,5870,5400,11270,2
HOIMA,2016,6090,5590,11680,2
HOIMA,2017,6320,5790,12110,2
HOIMA,2018,6560,5990,12550,2
HOIMA,2019,6790,6190,12980,2
HOIMA,2020,7040,6400,13440,2
HOIMA,2021,7290,6600,13890,2
HOIMA,2022,7540,6810,14350,2
HOIMA,2023,7800,7030,14830,2
HOIMA,2024,8060,7240,15300,2
HOIMA,2025,8320,7460,15780,2
IBANDA,2015,4340,4150,8490,2
IBANDA,2016,4420,4220,8640,2
IBANDA,2017,4510,4300,8810,2
IBANDA,2018,4600,4370,8970,2
IBANDA,2019,4680,4450,9130,2
IBANDA,2020,4770,4520,9290,2
IBANDA,2021,4850,4590,9440,2
IBANDA,2022,4930,4660,9590,2
IBANDA,2023,5020,4730,9750,2
IBANDA,2024,5090,4800,9890,2
IBANDA,2025,5160,4870,10030,2
IGANGA,2015,6160,5880,12040,2
IGANGA,2016,6490,6130,12620,2
IGANGA,2017,6560,6530,13090,2
IGANGA,2018,6690,6640,13330,2
IGANGA,2019,6820,6770,13590,2
IGANGA,2020,6940,6870,13810,2
IGANGA,2021,7060,6980,14040,2
IGANGA,2022,7170,7080,14250,2
IGANGA,2023,7290,7190,14480,2
IGANGA,2024,7390,7270,14660,2
IGANGA,2025,7480,7360,14840,2
ISINGIRO,2015,9460,8900,18360,2
ISINGIRO,2016,9810,9220,19030,2
ISINGIRO,2017,10180,9540,19720,2
ISINGIRO,2018,10550,9870,20420,2
ISINGIRO,2019,10940,10210,21150,2
ISINGIRO,2020,11330,10560,21890,2
ISINGIRO,2021,11730,10910,22640,2
ISINGIRO,2022,12130,11260,23390,2
ISINGIRO,2023,12540,11620,24160,2
ISINGIRO,2024,12950,11980,24930,2
ISINGIRO,2025,13360,12350,25710,2
JINJA,2015,8060,7480,15540,2
JINJA,2016,8200,7600,15800,2
JINJA,2017,8340,7720,16060,2
JINJA,2018,8470,7830,16300,2
JINJA,2019,8610,7950,16560,2
JINJA,2020,8740,8060,16800,2
JINJA,2021,8870,8170,17040,2
JINJA,2022,8990,8270,17260,2
JINJA,2023,9110,8370,17480,2
JINJA,2024,9220,8460,17680,2
JINJA,2025,9320,8550,17870,2
KAABONG,2015,1950,1500,3450,2
KAABONG,2016,2000,1540,3540,2
KAABONG,2017,2060,1580,3640,2
KAABONG,2018,2110,1610,3720,2
KAABONG,2019,2170,1650,3820,2
KAABONG,2020,2220,1690,3910,2
KAABONG,2021,2280,1720,4000,2
KAABONG,2022,2340,1760,4100,2
KAABONG,2023,2390,1800,4190,2
KAABONG,2024,2440,1830,4270,2
KAABONG,2025,2500,1870,4370,2
KABALE,2015,3680,3480,7160,2
KABALE,2016,3740,3520,7260,2
KABALE,2017,3800,3570,7370,2
KABALE,2018,3860,3610,7470,2
KABALE,2019,3910,3650,7560,2
KABALE,2020,3970,3690,7660,2
KABALE,2021,4020,3730,7750,2
KABALE,2022,4070,3760,7830,2
KABALE,2023,4120,3790,7910,2
KABALE,2024,4170,3820,7990,2
KABALE,2025,4210,3850,8060,2
KABAROLE,2015,5380,4710,10090,2
KABAROLE,2016,5500,4810,10310,2
KABAROLE,2017,5620,4910,10530,2
KABAROLE,2018,5740,5020,10760,2
KABAROLE,2019,5870,5120,10990,2
KABAROLE,2020,5980,5230,11210,2
KABAROLE,2021,6100,5330,11430,2
KABAROLE,2022,6220,5430,11650,2
KABAROLE,2023,6330,5530,11860,2
KABAROLE,2024,6440,5630,12070,2
KABAROLE,2025,6550,5720,12270,2
KABERAMAIDO,2015,1930,1760,3690,2
KABERAMAIDO,2016,2050,1850,3900,2
KABERAMAIDO,2017,2090,2000,4090,2
KABERAMAIDO,2018,2160,2060,4220,2
KABERAMAIDO,2019,2220,2120,4340,2
KABERAMAIDO,2020,2290,2170,4460,2
KABERAMAIDO,2021,2350,2230,4580,2
KABERAMAIDO,2022,2420,2280,4700,2
KABERAMAIDO,2023,2480,2340,4820,2
KABERAMAIDO,2024,2550,2400,4950,2
KABERAMAIDO,2025,2600,2440,5040,2
KAGADI,2015,7730,7280,15010,2
KAGADI,2016,8020,7540,15560,2
KAGADI,2017,8320,7810,16130,2
KAGADI,2018,8630,8080,16710,2
KAGADI,2019,8940,8360,17300,2
KAGADI,2020,9250,8640,17890,2
KAGADI,2021,9570,8930,18500,2
KAGADI,2022,9900,9220,19120,2
KAGADI,2023,10230,9510,19740,2
KAGADI,2024,10560,9810,20370,2
KAGADI,2025,10900,10110,21010,2
KAKUMIRO,2015,6800,6380,13180,2
KAKUMIRO,2016,7400,6920,14320,2
KAKUMIRO,2017,8050,7500,15550,2
KAKUMIRO,2018,8760,8130,16890,2
KAKUMIRO,2019,9530,8810,18340,2
KAKUMIRO,2020,10360,9530,19890,2
KAKUMIRO,2021,11250,10310,21560,2
KAKUMIRO,2022,12210,11150,23360,2
KAKUMIRO,2023,13240,12050,25290,2
KAKUMIRO,2024,14350,13020,27370,2
KAKUMIRO,2025,15540,14050,29590,2
KALAKI,2015,2260,2000,4260,2
KALAKI,2016,2360,2080,4440,2
KALAKI,2017,2460,2160,4620,2
KALAKI,2018,2570,2250,4820,2
KALAKI,2019,2670,2330,5000,2
KALAKI,2020,2780,2420,5200,2
KALAKI,2021,2900,2520,5420,2
KALAKI,2022,3010,2610,5620,2
KALAKI,2023,3130,2700,5830,2
KALAKI,2024,3250,2800,6050,2
KALAKI,2025,3380,2900,6280,2
KALANGALA,2015,940,920,1860,2
KALANGALA,2016,980,960,1940,2
KALANGALA,2017,1010,1000,2010,2
KALANGALA,2018,1050,1030,2080,2
KALANGALA,2019,1080,1080,2160,2
KALANGALA,2020,1120,1120,2240,2
KALANGALA,2021,1160,1160,2320,2
KALANGALA,2022,1190,1210,2400,2
KALANGALA,2023,1230,1260,2490,2
KALANGALA,2024,1270,1300,2570,2
KALANGALA,2025,1310,1350,2660,2
KALIRO,2015,4670,4440,9110,2
KALIRO,2016,4940,4650,9590,2
KALIRO,2017,5020,4990,10010,2
KALIRO,2018,5140,5100,10240,2
KALIRO,2019,5250,5230,10480,2
KALIRO,2020,5370,5340,10710,2
KALIRO,2021,5480,5460,10940,2
KALIRO,2022,5590,5570,11160,2
KALIRO,2023,5710,5680,11390,2
KALIRO,2024,5810,5790,11600,2
KALIRO,2025,5910,5880,11790,2
KALUNGU,2015,3130,2870,6000,2
KALUNGU,2016,3230,2940,6170,2
KALUNGU,2017,3200,3070,6270,2
KALUNGU,2018,3200,3070,6270,2
KALUNGU,2019,3200,3060,6260,2
KALUNGU,2020,3190,3060,6250,2
KALUNGU,2021,3180,3040,6220,2
KALUNGU,2022,3160,3030,6190,2
KALUNGU,2023,3160,3020,6180,2
KALUNGU,2024,3130,3000,6130,2
KALUNGU,2025,3120,2980,6100,2
KAMPALA,2015,22930,21050,43980,2
KAMPALA,2016,23390,21470,44860,2
KAMPALA,2017,23850,21880,45730,2
KAMPALA,2018,24320,22300,46620,2
KAMPALA,2019,24770,22710,47480,2
KAMPALA,2020,25220,23120,48340,2
KAMPALA,2021,25670,23520,49190,2
KAMPALA,2022,26100,23910,50010,2
KAMPALA,2023,26520,24300,50820,2
KAMPALA,2024,26920,24670,51590,2
KAMPALA,2025,27310,25030,52340,2
KAMULI,2015,9040,8600,17640,2
KAMULI,2016,9470,8920,18390,2
KAMULI,2017,9520,9430,18950,2
KAMULI,2018,9660,9540,19200,2
KAMULI,2019,9800,9660,19460,2
KAMULI,2020,9920,9750,19670,2
KAMULI,2021,10040,9850,19890,2
KAMULI,2022,10140,9940,20080,2
KAMULI,2023,10250,10020,20270,2
KAMULI,2024,10340,10100,20440,2
KAMULI,2025,10420,10150,20570,2
KAMWENGE,2015,5840,5440,11280,2
KAMWENGE,2016,6080,5640,11720,2
KAMWENGE,2017,6320,5830,12150,2
KAMWENGE,2018,6580,6040,12620,2
KAMWENGE,2019,6840,6250,13090,2
KAMWENGE,2020,7100,6460,13560,2
KAMWENGE,2021,7380,6670,14050,2
KAMWENGE,2022,7650,6890,14540,2
KAMWENGE,2023,7930,7120,15050,2
KAMWENGE,2024,8230,7350,15580,2
KAMWENGE,2025,8520,7570,16090,2
KANUNGU,2015,4240,4030,8270,2
KANUNGU,2016,4320,4090,8410,2
KANUNGU,2017,4400,4160,8560,2
KANUNGU,2018,4470,4230,8700,2
KANUNGU,2019,4550,4290,8840,2
KANUNGU,2020,4620,4350,8970,2
KANUNGU,2021,4700,4410,9110,2
KANUNGU,2022,4770,4470,9240,2
KANUNGU,2023,4840,4530,9370,2
KANUNGU,2024,4900,4590,9490,2
KANUNGU,2025,4970,4640,9610,2
KAPCHORWA,2015,1760,1660,3420,2
KAPCHORWA,2016,1810,1710,3520,2
KAPCHORWA,2017,1860,1750,3610,2
KAPCHORWA,2018,1920,1800,3720,2
KAPCHORWA,2019,1980,1850,3830,2
KAPCHORWA,2020,2030,1900,3930,2
KAPCHORWA,2021,2090,1950,4040,2
KAPCHORWA,2022,2150,2000,4150,2
KAPCHORWA,2023,2210,2050,4260,2
KAPCHORWA,2024,2270,2090,4360,2
KAPCHORWA,2025,2320,2140,4460,2
KAPELEBYONG,2015,1760,1700,3460,2
KAPELEBYONG,2016,1850,1770,3620,2
KAPELEBYONG,2017,1870,1880,3750,2
KAPELEBYONG,2018,1910,1920,3830,2
KAPELEBYONG,2019,1950,1960,3910,2
KAPELEBYONG,2020,1990,1990,3980,2
KAPELEBYONG,2021,2020,2010,4030,2
KAPELEBYONG,2022,2050,2040,4090,2
KAPELEBYONG,2023,2090,2070,4160,2
KAPELEBYONG,2024,2120,2090,4210,2
KAPELEBYONG,2025,2150,2110,4260,2
KASESE,2015,13900,12740,26640,2
KASESE,2016,14530,13200,27730,2
KASESE,2017,14600,13950,28550,2
KASESE,2018,14780,14110,28890,2
KASESE,2019,14970,14270,29240,2
KASESE,2020,15130,14410,29540,2
KASESE,2021,15290,14540,29830,2
KASESE,2022,15420,14650,30070,2
KASESE,2023,15570,14770,30340,2
KASESE,2024,15690,14870,30560,2
KASESE,2025,15770,14930,30700,2
KASSANDA,2015,5200,4760,9960,2
KASSANDA,2016,5350,4870,10220,2
KASSANDA,2017,5510,4970,10480,2
KASSANDA,2018,5660,5080,10740,2
KASSANDA,2019,5820,5180,11000,2
KASSANDA,2020,5980,5290,11270,2
KASSANDA,2021,6130,5390,11520,2
KASSANDA,2022,6290,5490,11780,2
KASSANDA,2023,6450,5590,12040,2
KASSANDA,2024,6600,5690,12290,2
KASSANDA,2025,6760,5780,12540,2
KATAKWI,2015,2940,2640,5580,2
KATAKWI,2016,3090,2740,5830,2
KATAKWI,2017,3110,2910,6020,2
KATAKWI,2018,3170,2950,6120,2
KATAKWI,2019,3230,2990,6220,2
KATAKWI,2020,3280,3030,6310,2
KATAKWI,2021,3330,3060,6390,2
KATAKWI,2022,3380,3110,6490,2
KATAKWI,2023,3430,3140,6570,2
KATAKWI,2024,3470,3170,6640,2
KATAKWI,2025,3510,3200,6710,2
KAYUNGA,2015,6830,6260,13090,2
KAYUNGA,2016,7110,6450,13560,2
KAYUNGA,2017,7100,6780,13880,2
KAYUNGA,2018,7160,6820,13980,2
KAYUNGA,2019,7210,6870,14080,2
KAYUNGA,2020,7260,6890,14150,2
KAYUNGA,2021,7290,6920,14210,2
KAYUNGA,2022,7320,6940,14260,2
KAYUNGA,2023,7360,6950,14310,2
KAYUNGA,2024,7380,6950,14330,2
KAYUNGA,2025,7380,6950,14330,2
KAZO,2015,3370,3120,6490,2
KAZO,2016,3500,3230,6730,2
KAZO,2017,3640,3350,6990,2
KAZO,2018,3770,3470,7240,2
KAZO,2019,3910,3590,7500,2
KAZO,2020,4050,3710,7760,2
KAZO,2021,4190,3820,8010,2
KAZO,2022,4340,3950,8290,2
KAZO,2023,4490,4080,8570,2
KAZO,2024,4640,4210,8850,2
KAZO,2025,4800,4340,9140,2
KIBAALE,2015,3340,3160,6500,2
KIBAALE,2016,3560,3340,6900,2
KIBAALE,2017,3780,3540,7320,2
KIBAALE,2018,4030,3740,7770,2
KIBAALE,2019,4280,3950,8230,2
KIBAALE,2020,4540,4170,8710,2
KIBAALE,2021,4820,4410,9230,2
KIBAALE,2022,5110,4650,9760,2
KIBAALE,2023,5420,4900,10320,2
KIBAALE,2024,5740,5170,10910,2
KIBAALE,2025,6070,5440,11510,2
KIBOGA,2015,2640,2380,5020,2
KIBOGA,2016,2770,2470,5240,2
KIBOGA,2017,2790,2610,5400,2
KIBOGA,2018,2820,2650,5470,2
KIBOGA,2019,2860,2680,5540,2
KIBOGA,2020,2900,2710,5610,2
KIBOGA,2021,2940,2740,5680,2
KIBOGA,2022,2970,2770,5740,2
KIBOGA,2023,3010,2800,5810,2
KIBOGA,2024,3040,2820,5860,2
KIBOGA,2025,3060,2830,5890,2
KIBUKU,2015,4200,3910,8110,2
KIBUKU,2016,4450,4120,8570,2
KIBUKU,2017,4540,4410,8950,2
KIBUKU,2018,4650,4530,9180,2
KIBUKU,2019,4780,4640,9420,2
KIBUKU,2020,4890,4760,9650,2
KIBUKU,2021,5010,4870,9880,2
KIBUKU,2022,5140,4980,10120,2
KIBUKU,2023,5250,5100,10350,2
KIBUKU,2024,5370,5200,10570,2
KIBUKU,2025,5480,5310,10790,2
KIKUUBE,2015,5740,5310,11050,2
KIKUUBE,2016,6050,5580,11630,2
KIKUUBE,2017,6370,5870,12240,2
KIKUUBE,2018,6710,6160,12870,2
KIKUUBE,2019,7060,6470,13530,2
KIKUUBE,2020,7430,6790,14220,2
KIKUUBE,2021,7810,7130,14940,2
KIKUUBE,2022,8210,7470,15680,2
KIKUUBE,2023,8610,7820,16430,2
KIKUUBE,2024,9030,8190,17220,2
KIKUUBE,2025,9460,8570,18030,2
KIRUHURA,2015,2730,2540,5270,2
KIRUHURA,2016,2830,2640,5470,2
KIRUHURA,2017,2940,2730,5670,2
KIRUHURA,2018,3050,2820,5870,2
KIRUHURA,2019,3160,2920,6080,2
KIRUHURA,2020,3290,3020,6310,2
KIRUHURA,2021,3400,3120,6520,2
KIRUHURA,2022,3520,3220,6740,2
KIRUHURA,2023,3640,3330,6970,2
KIRUHURA,2024,3760,3430,7190,2
KIRUHURA,2025,3880,3530,7410,2
KIRYANDONGO,2015,5180,4760,9940,2
KIRYANDONGO,2016,5450,4970,10420,2
KIRYANDONGO,2017,5500,5270,10770,2
KIRYANDONGO,2018,5600,5360,10960,2
KIRYANDONGO,2019,5700,5440,11140,2
KIRYANDONGO,2020,5800,5530,11330,2
KIRYANDONGO,2021,5890,5600,11490,2
KIRYANDONGO,2022,5980,5680,11660,2
KIRYANDONGO,2023,6070,5750,11820,2
KIRYANDONGO,2024,6150,5810,11960,2
KIRYANDONGO,2025,6220,5870,12090,2
KISORO,2015,5180,4970,10150,2
KISORO,2016,5390,5140,10530,2
KISORO,2017,5380,5420,10800,2
KISORO,2018,5430,5480,10910,2
KISORO,2019,5470,5520,10990,2
KISORO,2020,5510,5570,11080,2
KISORO,2021,5540,5600,11140,2
KISORO,2022,5560,5640,11200,2
KISORO,2023,5590,5670,11260,2
KISORO,2024,5610,5690,11300,2
KISORO,2025,5610,5710,11320,2
KITAGWENDA,2015,2750,2580,5330,2
KITAGWENDA,2016,2860,2670,5530,2
KITAGWENDA,2017,2980,2770,5750,2
KITAGWENDA,2018,3100,2870,5970,2
KITAGWENDA,2019,3220,2970,6190,2
KITAGWENDA,2020,3360,3070,6430,2
KITAGWENDA,2021,3480,3170,6650,2
KITAGWENDA,2022,3610,3280,6890,2
KITAGWENDA,2023,3750,3380,7130,2
KITAGWENDA,2024,3880,3490,7370,2
KITAGWENDA,2025,4010,3600,7610,2
KITGUM,2015,3740,3630,7370,2
KITGUM,2016,3890,3740,7630,2
KITGUM,2017,3870,3920,7790,2
KITGUM,2018,3890,3940,7830,2
KITGUM,2019,3900,3960,7860,2
KITGUM,2020,3920,3980,7900,2
KITGUM,2021,3930,3990,7920,2
KITGUM,2022,3930,4000,7930,2
KITGUM,2023,3940,4010,7950,2
KITGUM,2024,3930,4010,7940,2
KITGUM,2025,3920,4000,7920,2
KOBOKO,2015,4100,3520,7620,2
KOBOKO,2016,4360,3700,8060,2
KOBOKO,2017,4440,3970,8410,2
KOBOKO,2018,4570,4080,8650,2
KOBOKO,2019,4690,4190,8880,2
KOBOKO,2020,4820,4310,9130,2
KOBOKO,2021,4940,4420,9360,2
KOBOKO,2022,5070,4520,9590,2
KOBOKO,2023,5190,4630,9820,2
KOBOKO,2024,5310,4730,10040,2
KOBOKO,2025,5410,4830,10240,2
KOLE,2015,4510,4200,8710,2
KOLE,2016,4660,4320,8980,2
KOLE,2017,4810,4450,9260,2
KOLE,2018,4970,4570,9540,2
KOLE,2019,5130,4700,9830,2
KOLE,2020,5280,4830,10110,2
KOLE,2021,5450,4960,10410,2
KOLE,2022,5610,5090,10700,2
KOLE,2023,5770,5220,10990,2
KOLE,2024,5930,5350,11280,2
KOLE,2025,6090,5480,11570,2
KOTIDO,2015,3370,3300,6670,2
KOTIDO,2016,3530,3420,6950,2
KOTIDO,2017,3550,3620,7170,2
KOTIDO,2018,3590,3650,7240,2
KOTIDO,2019,3630,3700,7330,2
KOTIDO,2020,3670,3730,7400,2
KOTIDO,2021,3710,3760,7470,2
KOTIDO,2022,3750,3790,7540,2
KOTIDO,2023,3780,3830,7610,2
KOTIDO,2024,3810,3850,7660,2
KOTIDO,2025,3830,3870,7700,2
KUMI,2015,4170,4000,8170,2
KUMI,2016,4400,4170,8570,2
KUMI,2017,4450,4440,8890,2
KUMI,2018,4540,4530,9070,2
KUMI,2019,4630,4600,9230,2
KUMI,2020,4720,4680,9400,2
KUMI,2021,4800,4760,9560,2
KUMI,2022,4890,4830,9720,2
KUMI,2023,4960,4890,9850,2
KUMI,2024,5030,4960,9990,2
KUMI,2025,5100,5020,10120,2
KWANIA,2015,3320,3090,6410,2
KWANIA,2016,3430,3180,6610,2
KWANIA,2017,3530,3270,6800,2
KWANIA,2018,3640,3370,7010,2
KWANIA,2019,3750,3460,7210,2
KWANIA,2020,3860,3550,7410,2
KWANIA,2021,3970,3650,7620,2
KWANIA,2022,4080,3740,7820,2
KWANIA,2023,4200,3830,8030,2
KWANIA,2024,4300,3930,8230,2
KWANIA,2025,4420,4020,8440,2
KWEEN,2015,1850,1680,3530,2
KWEEN,2016,1900,1720,3620,2
KWEEN,2017,1960,1760,3720,2
KWEEN,2018,2020,1810,3830,2
KWEEN,2019,2080,1850,3930,2
KWEEN,2020,2140,1890,4030,2
KWEEN,2021,2200,1940,4140,2
KWEEN,2022,2270,1980,4250,2
KWEEN,2023,2330,2020,4350,2
KWEEN,2024,2390,2060,4450,2
KWEEN,2025,2450,2100,4550,2
KYANKWANZI,2015,4350,4060,8410,2
KYANKWANZI,2016,4570,4250,8820,2
KYANKWANZI,2017,4800,4440,9240,2
KYANKWANZI,2018,5050,4650,9700,2
KYANKWANZI,2019,5310,4860,10170,2
KYANKWANZI,2020,5570,5080,10650,2
KYANKWANZI,2021,5840,5310,11150,2
KYANKWANZI,2022,6120,5540,11660,2
KYANKWANZI,2023,6410,5780,12190,2
KYANKWANZI,2024,6710,6030,12740,2
KYANKWANZI,2025,7020,6280,13300,2
KYEGEGWA,2015,6510,6120,12630,2
KYEGEGWA,2016,7040,6600,13640,2
KYEGEGWA,2017,7630,7130,14760,2
KYEGEGWA,2018,8250,7680,15930,2
KYEGEGWA,2019,8920,8280,17200,2
KYEGEGWA,2020,9630,8930,18560,2
KYEGEGWA,2021,10410,9610,20020,2
KYEGEGWA,2022,11230,10340,21570,2
KYEGEGWA,2023,12110,11130,23240,2
KYEGEGWA,2024,13040,11960,25000,2
KYEGEGWA,2025,14040,12840,26880,2
KYENJOJO,2015,9110,8610,17720,2
KYENJOJO,2016,9490,8930,18420,2
KYENJOJO,2017,9880,9260,19140,2
KYENJOJO,2018,10280,9590,19870,2
KYENJOJO,2019,10690,9940,20630,2
KYENJOJO,2020,11110,10290,21400,2
KYENJOJO,2021,11540,10650,22190,2
KYENJOJO,2022,11980,11010,22990,2
KYENJOJO,2023,12420,11380,23800,2
KYENJOJO,2024,12880,11750,24630,2
KYENJOJO,2025,13330,12130,25460,2
KYOTERA,2015,4080,3670,7750,2
KYOTERA,2016,4240,3770,8010,2
KYOTERA,2017,4230,3950,8180,2
KYOTERA,2018,4240,3960,8200,2
KYOTERA,2019,4260,3970,8230,2
KYOTERA,2020,4280,3980,8260,2
KYOTERA,2021,4290,3990,8280,2
KYOTERA,2022,4290,3980,8270,2
KYOTERA,2023,4300,3990,8290,2
KYOTERA,2024,4300,3980,8280,2
KYOTERA,2025,4290,3960,8250,2
KARENGA,2015,1220,1300,2520,2
KARENGA,2016,1250,1320,2570,2
KARENGA,2017,1280,1350,2630,2
KARENGA,2018,1330,1390,2720,2
KARENGA,2019,1350,1430,2780,2
KARENGA,2020,1400,1450,2850,2
KARENGA,2021,1420,1490,2910,2
KARENGA,2022,1460,1510,2970,2
KARENGA,2023,1490,1550,3040,2
KARENGA,2024,1530,1580,3110,2
KARENGA,2025,1560,1610,3170,2
LAMWO,2015,2510,2340,4850,2
LAMWO,2016,2590,2410,5000,2
LAMWO,2017,2560,2520,5080,2
LAMWO,2018,2550,2540,5090,2
LAMWO,2019,2540,2540,5080,2
LAMWO,2020,2540,2550,5090,2
LAMWO,2021,2530,2560,5090,2
LAMWO,2022,2510,2560,5070,2
LAMWO,2023,2500,2560,5060,2
LAMWO,2024,2480,2550,5030,2
LAMWO,2025,2460,2550,5010,2
LIRA,2015,7010,6580,13590,2
LIRA,2016,7210,6770,13980,2
LIRA,2017,7410,6970,14380,2
LIRA,2018,7620,7160,14780,2
LIRA,2019,7820,7360,15180,2
LIRA,2020,8030,7560,15590,2
LIRA,2021,8240,7760,16000,2
LIRA,2022,8450,7960,16410,2
LIRA,2023,8650,8160,16810,2
LIRA,2024,8860,8360,17220,2
LIRA,2025,9060,8560,17620,2
LUUKA,2015,4430,4320,8750,2
LUUKA,2016,4610,4470,9080,2
LUUKA,2017,4610,4710,9320,2
LUUKA,2018,4650,4760,9410,2
LUUKA,2019,4690,4800,9490,2
LUUKA,2020,4730,4830,9560,2
LUUKA,2021,4760,4860,9620,2
LUUKA,2022,4790,4890,9680,2
LUUKA,2023,4810,4920,9730,2
LUUKA,2024,4830,4940,9770,2
LUUKA,2025,4830,4950,9780,2
LUWERO,2015,8110,7400,15510,2
LUWERO,2016,8490,7670,16160,2
LUWERO,2017,8520,8120,16640,2
LUWERO,2018,8640,8210,16850,2
LUWERO,2019,8750,8310,17060,2
LUWERO,2020,8860,8400,17260,2
LUWERO,2021,8960,8470,17430,2
LUWERO,2022,9050,8540,17590,2
LUWERO,2023,9130,8610,17740,2
LUWERO,2024,9210,8680,17890,2
LUWERO,2025,9270,8720,17990,2
LWENGO,2015,4960,4680,9640,2
LWENGO,2016,5120,4790,9910,2
LWENGO,2017,5060,5000,10060,2
LWENGO,2018,5060,5000,10060,2
LWENGO,2019,5060,4990,10050,2
LWENGO,2020,5040,4970,10010,2
LWENGO,2021,5020,4950,9970,2
LWENGO,2022,5000,4930,9930,2
LWENGO,2023,4980,4910,9890,2
LWENGO,2024,4950,4870,9820,2
LWENGO,2025,4900,4830,9730,2
LYANTONDE,2015,1740,1640,3380,2
LYANTONDE,2016,1840,1710,3550,2
LYANTONDE,2017,1840,1810,3650,2
LYANTONDE,2018,1880,1850,3730,2
LYANTONDE,2019,1910,1880,3790,2
LYANTONDE,2020,1950,1910,3860,2
LYANTONDE,2021,1980,1940,3920,2
LYANTONDE,2022,2000,1960,3960,2
LYANTONDE,2023,2040,1990,4030,2
LYANTONDE,2024,2070,2010,4080,2
LYANTONDE,2025,2090,2030,4120,2
MANAFWA,2015,2930,2780,5710,2
MANAFWA,2016,3010,2850,5860,2
MANAFWA,2017,3080,2910,5990,2
MANAFWA,2018,3160,2980,6140,2
MANAFWA,2019,3230,3040,6270,2
MANAFWA,2020,3310,3100,6410,2
MANAFWA,2021,3390,3170,6560,2
MANAFWA,2022,3460,3230,6690,2
MANAFWA,2023,3530,3290,6820,2
MANAFWA,2024,3600,3350,6950,2
MANAFWA,2025,3680,3410,7090,2
MARACHA,2015,3520,3180,6700,2
MARACHA,2016,3600,3250,6850,2
MARACHA,2017,3670,3310,6980,2
MARACHA,2018,3750,3370,7120,2
MARACHA,2019,3820,3440,7260,2
MARACHA,2020,3900,3500,7400,2
MARACHA,2021,3970,3560,7530,2
MARACHA,2022,4040,3620,7660,2
MARACHA,2023,4110,3680,7790,2
MARACHA,2024,4180,3730,7910,2
MARACHA,2025,4250,3790,8040,2
MASAKA,2015,4970,4680,9650,2
MASAKA,2016,5190,4850,10040,2
MASAKA,2017,5200,5120,10320,2
MASAKA,2018,5260,5170,10430,2
MASAKA,2019,5310,5220,10530,2
MASAKA,2020,5360,5260,10620,2
MASAKA,2021,5410,5300,10710,2
MASAKA,2022,5450,5330,10780,2
MASAKA,2023,5490,5370,10860,2
MASAKA,2024,5510,5390,10900,2
MASAKA,2025,5540,5410,10950,2
MASINDI,2015,5440,4930,10370,2
MASINDI,2016,5600,5070,10670,2
MASINDI,2017,5770,5200,10970,2
MASINDI,2018,5930,5340,11270,2
MASINDI,2019,6100,5480,11580,2
MASINDI,2020,6270,5610,11880,2
MASINDI,2021,6440,5750,12190,2
MASINDI,2022,6610,5890,12500,2
MASINDI,2023,6770,6030,12800,2
MASINDI,2024,6940,6160,13100,2
MASINDI,2025,7110,6300,13410,2
MAYUGE,2015,9740,9050,18790,2
MAYUGE,2016,10260,9460,19720,2
MAYUGE,2017,10370,10070,20440,2
MAYUGE,2018,10580,10270,20850,2
MAYUGE,2019,10780,10480,21260,2
MAYUGE,2020,10980,10680,21660,2
MAYUGE,2021,11170,10860,22030,2
MAYUGE,2022,11350,11040,22390,2
MAYUGE,2023,11530,11220,22750,2
MAYUGE,2024,11710,11390,23100,2
MAYUGE,2025,11850,11530,23380,2
MBALE,2015,8360,8170,16530,2
MBALE,2016,8800,8560,17360,2
MBALE,2017,8880,9150,18030,2
MBALE,2018,9050,9360,18410,2
MBALE,2019,9230,9580,18810,2
MBALE,2020,9380,9770,19150,2
MBALE,2021,9540,9980,19520,2
MBALE,2022,9680,10160,19840,2
MBALE,2023,9830,10360,20190,2
MBALE,2024,9960,10540,20500,2
MBALE,2025,10080,10710,20790,2
MBARARA,2015,5700,5220,10920,2
MBARARA,2016,5840,5330,11170,2
MBARARA,2017,5970,5440,11410,2
MBARARA,2018,6110,5560,11670,2
MBARARA,2019,6240,5680,11920,2
MBARARA,2020,6380,5790,12170,2
MBARARA,2021,6510,5900,12410,2
MBARARA,2022,6630,6010,12640,2
MBARARA,2023,6770,6120,12890,2
MBARARA,2024,6890,6220,13110,2
MBARARA,2025,7010,6330,13340,2
MITOOMA,2015,3450,3050,6500,2
MITOOMA,2016,3490,3080,6570,2
MITOOMA,2017,3530,3110,6640,2
MITOOMA,2018,3570,3140,6710,2
MITOOMA,2019,3610,3160,6770,2
MITOOMA,2020,3650,3190,6840,2
MITOOMA,2021,3690,3210,6900,2
MITOOMA,2022,3720,3230,6950,2
MITOOMA,2023,3750,3250,7000,2
MITOOMA,2024,3780,3270,7050,2
MITOOMA,2025,3810,3280,7090,2
MITYANA,2015,5800,5160,10960,2
MITYANA,2016,6040,5310,11350,2
MITYANA,2017,6010,5580,11590,2
MITYANA,2018,6060,5610,11670,2
MITYANA,2019,6100,5630,11730,2
MITYANA,2020,6130,5650,11780,2
MITYANA,2021,6160,5670,11830,2
MITYANA,2022,6180,5680,11860,2
MITYANA,2023,6190,5690,11880,2
MITYANA,2024,6200,5690,11890,2
MITYANA,2025,6200,5690,11890,2
MOROTO,2015,1930,1960,3890,2
MOROTO,2016,2010,2050,4060,2
MOROTO,2017,2020,2170,4190,2
MOROTO,2018,2040,2200,4240,2
MOROTO,2019,2060,2230,4290,2
MOROTO,2020,2090,2250,4340,2
MOROTO,2021,2100,2290,4390,2
MOROTO,2022,2110,2310,4420,2
MOROTO,2023,2130,2330,4460,2
MOROTO,2024,2140,2350,4490,2
MOROTO,2025,2150,2370,4520,2
MOYO,2015,1480,1430,2910,2
MOYO,2016,1520,1470,2990,2
MOYO,2017,1560,1500,3060,2
MOYO,2018,1590,1530,3120,2
MOYO,2019,1640,1560,3200,2
MOYO,2020,1670,1600,3270,2
MOYO,2021,1710,1620,3330,2
MOYO,2022,1750,1660,3410,2
MOYO,2023,1790,1680,3470,2
MOYO,2024,1830,1720,3550,2
MOYO,2025,1860,1750,3610,2
MPIGI,2015,4550,4170,8720,2
MPIGI,2016,4760,4320,9080,2
MPIGI,2017,4780,4570,9350,2
MPIGI,2018,4840,4630,9470,2
MPIGI,2019,4900,4680,9580,2
MPIGI,2020,4950,4730,9680,2
MPIGI,2021,5010,4780,9790,2
MPIGI,2022,5040,4820,9860,2
MPIGI,2023,5090,4860,9950,2
MPIGI,2024,5120,4900,10020,2
MPIGI,2025,5150,4920,10070,2
MUBENDE,2015,8310,7730,16040,2
MUBENDE,2016,8930,8250,17180,2
MUBENDE,2017,9210,8970,18180,2
MUBENDE,2018,9600,9330,18930,2
MUBENDE,2019,9980,9710,19690,2
MUBENDE,2020,10380,10080,20460,2
MUBENDE,2021,10780,10470,21250,2
MUBENDE,2022,11180,10850,22030,2
MUBENDE,2023,11600,11240,22840,2
MUBENDE,2024,12020,11640,23660,2
MUBENDE,2025,12430,12020,24450,2
MUKONO,2015,10460,9670,20130,2
MUKONO,2016,10970,10080,21050,2
MUKONO,2017,11050,10730,21780,2
MUKONO,2018,11220,10940,22160,2
MUKONO,2019,11390,11130,22520,2
MUKONO,2020,11550,11330,22880,2
MUKONO,2021,11700,11510,23210,2
MUKONO,2022,11840,11680,23520,2
MUKONO,2023,11980,11860,23840,2
MUKONO,2024,12100,12020,24120,2
MUKONO,2025,12200,12150,24350,2
MADI OKOLLO,2015,2640,2340,4980,2
MADI OKOLLO,2016,2710,2410,5120,2
MADI OKOLLO,2017,2800,2470,5270,2
MADI OKOLLO,2018,2880,2540,5420,2
MADI OKOLLO,2019,2950,2610,5560,2
MADI OKOLLO,2020,3040,2670,5710,2
MADI OKOLLO,2021,3110,2740,5850,2
MADI OKOLLO,2022,3200,2810,6010,2
MADI OKOLLO,2023,3280,2870,6150,2
MADI OKOLLO,2024,3360,2940,6300,2
MADI OKOLLO,2025,3440,3010,6450,2
NABILATUK,2015,1360,1300,2660,2
NABILATUK,2016,1450,1380,2830,2
NABILATUK,2017,1500,1490,2990,2
NABILATUK,2018,1560,1550,3110,2
NABILATUK,2019,1610,1590,3200,2
NABILATUK,2020,1680,1640,3320,2
NABILATUK,2021,1740,1690,3430,2
NABILATUK,2022,1810,1750,3560,2
NABILATUK,2023,1860,1800,3660,2
NABILATUK,2024,1930,1850,3780,2
NABILATUK,2025,1990,1900,3890,2
NAKAPIRIPIRIT,2015,1800,1680,3480,2
NAKAPIRIPIRIT,2016,1910,1780,3690,2
NAKAPIRIPIRIT,2017,1960,1930,3890,2
NAKAPIRIPIRIT,2018,2030,1990,4020,2
NAKAPIRIPIRIT,2019,2090,2060,4150,2
NAKAPIRIPIRIT,2020,2160,2110,4270,2
NAKAPIRIPIRIT,2021,2220,2180,4400,2
NAKAPIRIPIRIT,2022,2280,2240,4520,2
NAKAPIRIPIRIT,2023,2350,2310,4660,2
NAKAPIRIPIRIT,2024,2410,2370,4780,2
NAKAPIRIPIRIT,2025,2470,2430,4900,2
NAKASEKE,2015,3730,2990,6720,2
NAKASEKE,2016,3870,3060,6930,2
NAKASEKE,2017,4010,3130,7140,2
NAKASEKE,2018,4150,3210,7360,2
NAKASEKE,2019,4300,3280,7580,2
NAKASEKE,2020,4450,3350,7800,2
NAKASEKE,2021,4610,3430,8040,2
NAKASEKE,2022,4760,3500,8260,2
NAKASEKE,2023,4920,3570,8490,2
NAKASEKE,2024,5080,3650,8730,2
NAKASEKE,2025,5230,3720,8950,2
NAKASONGOLA,2015,3310,3080,6390,2
NAKASONGOLA,2016,3480,3200,6680,2
NAKASONGOLA,2017,3530,3400,6930,2
NAKASONGOLA,2018,3600,3460,7060,2
NAKASONGOLA,2019,3670,3520,7190,2
NAKASONGOLA,2020,3730,3570,7300,2
NAKASONGOLA,2021,3810,3620,7430,2
NAKASONGOLA,2022,3860,3660,7520,2
NAKASONGOLA,2023,3930,3710,7640,2
NAKASONGOLA,2024,3990,3750,7740,2
NAKASONGOLA,2025,4040,3780,7820,2
NAMAYINGO,2015,4330,4150,8480,2
NAMAYINGO,2016,4500,4270,8770,2
NAMAYINGO,2017,4500,4480,8980,2
NAMAYINGO,2018,4530,4500,9030,2
NAMAYINGO,2019,4560,4520,9080,2
NAMAYINGO,2020,4580,4530,9110,2
NAMAYINGO,2021,4600,4540,9140,2
NAMAYINGO,2022,4610,4540,9150,2
NAMAYINGO,2023,4640,4550,9190,2
NAMAYINGO,2024,4650,4540,9190,2
NAMAYINGO,2025,4640,4530,9170,2
NAMISINDWA,2015,4010,3790,7800,2
NAMISINDWA,2016,4130,3880,8010,2
NAMISINDWA,2017,4250,3970,8220,2
NAMISINDWA,2018,4360,4070,8430,2
NAMISINDWA,2019,4480,4160,8640,2
NAMISINDWA,2020,4600,4250,8850,2
NAMISINDWA,2021,4720,4340,9060,2
NAMISINDWA,2022,4840,4440,9280,2
NAMISINDWA,2023,4950,4530,9480,2
NAMISINDWA,2024,5070,4620,9690,2
NAMISINDWA,2025,5180,4700,9880,2
NAMUTUMBA,2015,4990,4940,9930,2
NAMUTUMBA,2016,5270,5170,10440,2
NAMUTUMBA,2017,5350,5520,10870,2
NAMUTUMBA,2018,5470,5650,11120,2
NAMUTUMBA,2019,5600,5760,11360,2
NAMUTUMBA,2020,5730,5880,11610,2
NAMUTUMBA,2021,5850,5990,11840,2
NAMUTUMBA,2022,5960,6110,12070,2
NAMUTUMBA,2023,6080,6210,12290,2
NAMUTUMBA,2024,6200,6320,12520,2
NAMUTUMBA,2025,6290,6410,12700,2
NAPAK,2015,2820,2800,5620,2
NAPAK,2016,2920,2900,5820,2
NAPAK,2017,2910,3070,5980,2
NAPAK,2018,2920,3100,6020,2
NAPAK,2019,2950,3120,6070,2
NAPAK,2020,2950,3160,6110,2
NAPAK,2021,2960,3180,6140,2
NAPAK,2022,2960,3190,6150,2
NAPAK,2023,2970,3220,6190,2
NAPAK,2024,2970,3240,6210,2
NAPAK,2025,2960,3240,6200,2
NEBBI,2015,4560,4190,8750,2
NEBBI,2016,4710,4310,9020,2
NEBBI,2017,4860,4430,9290,2
NEBBI,2018,5010,4560,9570,2
NEBBI,2019,5170,4680,9850,2
NEBBI,2020,5320,4810,10130,2
NEBBI,2021,5480,4930,10410,2
NEBBI,2022,5630,5060,10690,2
NEBBI,2023,5790,5190,10980,2
NEBBI,2024,5950,5310,11260,2
NEBBI,2025,6110,5440,11550,2
NGORA,2015,2550,2400,4950,2
NGORA,2016,2680,2490,5170,2
NGORA,2017,2700,2640,5340,2
NGORA,2018,2740,2680,5420,2
NGORA,2019,2790,2720,5510,2
NGORA,2020,2840,2760,5600,2
NGORA,2021,2870,2790,5660,2
NGORA,2022,2910,2830,5740,2
NGORA,2023,2940,2860,5800,2
NGORA,2024,2980,2900,5880,2
NGORA,2025,3010,2920,5930,2
NTOROKO,2015,1320,1200,2520,2
NTOROKO,2016,1380,1230,2610,2
NTOROKO,2017,1380,1300,2680,2
NTOROKO,2018,1410,1310,2720,2
NTOROKO,2019,1430,1320,2750,2
NTOROKO,2020,1440,1330,2770,2
NTOROKO,2021,1450,1340,2790,2
NTOROKO,2022,1470,1350,2820,2
NTOROKO,2023,1480,1350,2830,2
NTOROKO,2024,1500,1350,2850,2
NTOROKO,2025,1500,1370,2870,2
NTUNGAMO,2015,9040,8440,17480,2
NTUNGAMO,2016,9230,8600,17830,2
NTUNGAMO,2017,9430,8760,18190,2
NTUNGAMO,2018,9630,8920,18550,2
NTUNGAMO,2019,9830,9080,18910,2
NTUNGAMO,2020,10020,9230,19250,2
NTUNGAMO,2021,10220,9380,19600,2
NTUNGAMO,2022,10410,9530,19940,2
NTUNGAMO,2023,10590,9680,20270,2
NTUNGAMO,2024,10770,9820,20590,2
NTUNGAMO,2025,10940,9960,20900,2
NWOYA,2015,2880,2760,5640,2
NWOYA,2016,3180,3050,6230,2
NWOYA,2017,3520,3360,6880,2
NWOYA,2018,3880,3700,7580,2
NWOYA,2019,4280,4070,8350,2
NWOYA,2020,4730,4480,9210,2
NWOYA,2021,5210,4920,10130,2
NWOYA,2022,5740,5410,11150,2
NWOYA,2023,6320,5940,12260,2
NWOYA,2024,6940,6530,13470,2
NWOYA,2025,7630,7160,14790,2
OBONGI,2015,870,710,1580,2
OBONGI,2016,910,730,1640,2
OBONGI,2017,920,780,1700,2
OBONGI,2018,930,780,1710,2
OBONGI,2019,940,790,1730,2
OBONGI,2020,950,800,1750,2
OBONGI,2021,960,810,1770,2
OBONGI,2022,980,810,1790,2
OBONGI,2023,980,820,1800,2
OBONGI,2024,990,820,1810,2
OBONGI,2025,1000,830,1830,2
OMORO,2015,2960,2690,5650,2
OMORO,2016,3130,2810,5940,2
OMORO,2017,3180,3010,6190,2
OMORO,2018,3250,3080,6330,2
OMORO,2019,3330,3160,6490,2
OMORO,2020,3400,3230,6630,2
OMORO,2021,3480,3300,6780,2
OMORO,2022,3550,3370,6920,2
OMORO,2023,3620,3440,7060,2
OMORO,2024,3690,3500,7190,2
OMORO,2025,3750,3560,7310,2
OTUKE,2015,2080,1960,4040,2
OTUKE,2016,2170,2050,4220,2
OTUKE,2017,2270,2140,4410,2
OTUKE,2018,2370,2230,4600,2
OTUKE,2019,2480,2320,4800,2
OTUKE,2020,2590,2420,5010,2
OTUKE,2021,2700,2520,5220,2
OTUKE,2022,2810,2620,5430,2
OTUKE,2023,2930,2720,5650,2
OTUKE,2024,3050,2830,5880,2
OTUKE,2025,3160,2930,6090,2
OYAM,2015,7540,7080,14620,2
OYAM,2016,7770,7290,15060,2
OYAM,2017,8000,7510,15510,2
OYAM,2018,8250,7720,15970,2
OYAM,2019,8490,7940,16430,2
OYAM,2020,8740,8160,16900,2
OYAM,2021,8980,8380,17360,2
OYAM,2022,9230,8610,17840,2
OYAM,2023,9480,8830,18310,2
OYAM,2024,9730,9050,18780,2
OYAM,2025,9970,9270,19240,2
PADER,2015,3240,3060,6300,2
PADER,2016,3370,3160,6530,2
PADER,2017,3350,3330,6680,2
PADER,2018,3380,3360,6740,2
PADER,2019,3400,3400,6800,2
PADER,2020,3410,3410,6820,2
PADER,2021,3420,3430,6850,2
PADER,2022,3420,3450,6870,2
PADER,2023,3430,3460,6890,2
PADER,2024,3430,3480,6910,2
PADER,2025,3430,3480,6910,2
PAKWACH,2015,3200,2860,6060,2
PAKWACH,2016,3340,2970,6310,2
PAKWACH,2017,3480,3070,6550,2
PAKWACH,2018,3630,3180,6810,2
PAKWACH,2019,3770,3300,7070,2
PAKWACH,2020,3920,3410,7330,2
PAKWACH,2021,4080,3530,7610,2
PAKWACH,2022,4240,3650,7890,2
PAKWACH,2023,4400,3770,8170,2
PAKWACH,2024,4570,3890,8460,2
PAKWACH,2025,4730,4010,8740,2
PALLISA,2015,5540,5010,10550,2
PALLISA,2016,5910,5300,11210,2
PALLISA,2017,6050,5710,11760,2
PALLISA,2018,6250,5900,12150,2
PALLISA,2019,6460,6090,12550,2
PALLISA,2020,6650,6280,12930,2
PALLISA,2021,6860,6470,13330,2
PALLISA,2022,7060,6660,13720,2
PALLISA,2023,7270,6850,14120,2
PALLISA,2024,7470,7040,14510,2
PALLISA,2025,7660,7210,14870,2
RAKAI,2015,5470,4960,10430,2
RAKAI,2016,5720,5140,10860,2
RAKAI,2017,5760,5440,11200,2
RAKAI,2018,5830,5510,11340,2
RAKAI,2019,5910,5570,11480,2
RAKAI,2020,5990,5630,11620,2
RAKAI,2021,6050,5690,11740,2
RAKAI,2022,6110,5730,11840,2
RAKAI,2023,6180,5790,11970,2
RAKAI,2024,6230,5820,12050,2
RAKAI,2025,6270,5850,12120,2
RUBANDA,2015,3670,3400,7070,2
RUBANDA,2016,3730,3430,7160,2
RUBANDA,2017,3780,3450,7230,2
RUBANDA,2018,3820,3480,7300,2
RUBANDA,2019,3870,3500,7370,2
RUBANDA,2020,3920,3530,7450,2
RUBANDA,2021,3960,3550,7510,2
RUBANDA,2022,4000,3570,7570,2
RUBANDA,2023,4040,3580,7620,2
RUBANDA,2024,4080,3600,7680,2
RUBANDA,2025,4110,3610,7720,2
RUBIRIZI,2015,2410,2170,4580,2
RUBIRIZI,2016,2460,2210,4670,2
RUBIRIZI,2017,2510,2260,4770,2
RUBIRIZI,2018,2560,2300,4860,2
RUBIRIZI,2019,2610,2340,4950,2
RUBIRIZI,2020,2660,2380,5040,2
RUBIRIZI,2021,2700,2420,5120,2
RUBIRIZI,2022,2750,2460,5210,2
RUBIRIZI,2023,2790,2500,5290,2
RUBIRIZI,2024,2840,2540,5380,2
RUBIRIZI,2025,2880,2570,5450,2
RUKIGA,2015,1650,1510,3160,2
RUKIGA,2016,1670,1530,3200,2
RUKIGA,2017,1690,1540,3230,2
RUKIGA,2018,1700,1550,3250,2
RUKIGA,2019,1720,1560,3280,2
RUKIGA,2020,1730,1570,3300,2
RUKIGA,2021,1750,1570,3320,2
RUKIGA,2022,1760,1580,3340,2
RUKIGA,2023,1770,1590,3360,2
RUKIGA,2024,1780,1590,3370,2
RUKIGA,2025,1790,1600,3390,2
RUKUNGIRI,2015,5300,4950,10250,2
RUKUNGIRI,2016,5360,5000,10360,2
RUKUNGIRI,2017,5430,5050,10480,2
RUKUNGIRI,2018,5490,5090,10580,2
RUKUNGIRI,2019,5550,5140,10690,2
RUKUNGIRI,2020,5610,5180,10790,2
RUKUNGIRI,2021,5670,5220,10890,2
RUKUNGIRI,2022,5720,5260,10980,2
RUKUNGIRI,2023,5770,5300,11070,2
RUKUNGIRI,2024,5810,5330,11140,2
RUKUNGIRI,2025,5850,5350,11200,2
RWAMPARA,2015,2330,2090,4420,2
RWAMPARA,2016,2380,2130,4510,2
RWAMPARA,2017,2440,2180,4620,2
RWAMPARA,2018,2490,2220,4710,2
RWAMPARA,2019,2540,2270,4810,2
RWAMPARA,2020,2600,2320,4920,2
RWAMPARA,2021,2650,2360,5010,2
RWAMPARA,2022,2710,2410,5120,2
RWAMPARA,2023,2750,2450,5200,2
RWAMPARA,2024,2810,2500,5310,2
RWAMPARA,2025,2850,2540,5390,2
SERERE,2015,5570,5380,10950,2
SERERE,2016,5920,5670,11590,2
SERERE,2017,6040,6100,12140,2
SERERE,2018,6220,6280,12500,2
SERERE,2019,6400,6460,12860,2
SERERE,2020,6580,6630,13210,2
SERERE,2021,6750,6800,13550,2
SERERE,2022,6930,6970,13900,2
SERERE,2023,7100,7150,14250,2
SERERE,2024,7270,7320,14590,2
SERERE,2025,7430,7480,14910,2
SHEEMA,2015,3150,3050,6200,2
SHEEMA,2016,3190,3080,6270,2
SHEEMA,2017,3230,3110,6340,2
SHEEMA,2018,3270,3140,6410,2
SHEEMA,2019,3300,3170,6470,2
SHEEMA,2020,3340,3200,6540,2
SHEEMA,2021,3370,3230,6600,2
SHEEMA,2022,3410,3250,6660,2
SHEEMA,2023,3430,3280,6710,2
SHEEMA,2024,3460,3300,6760,2
SHEEMA,2025,3480,3320,6800,2
SIRONKO,2015,4400,4050,8450,2
SIRONKO,2016,4510,4130,8640,2
SIRONKO,2017,4610,4220,8830,2
SIRONKO,2018,4720,4300,9020,2
SIRONKO,2019,4830,4380,9210,2
SIRONKO,2020,4940,4470,9410,2
SIRONKO,2021,5040,4550,9590,2
SIRONKO,2022,5150,4630,9780,2
SIRONKO,2023,5250,4710,9960,2
SIRONKO,2024,5350,4780,10130,2
SIRONKO,2025,5450,4860,10310,2
SOROTI,2015,5400,5050,10450,2
SOROTI,2016,5710,5300,11010,2
SOROTI,2017,5800,5670,11470,2
SOROTI,2018,5940,5810,11750,2
SOROTI,2019,6090,5940,12030,2
SOROTI,2020,6230,6080,12310,2
SOROTI,2021,6370,6210,12580,2
SOROTI,2022,6500,6340,12840,2
SOROTI,2023,6640,6470,13110,2
SOROTI,2024,6770,6600,13370,2
SOROTI,2025,6880,6700,13580,2
SSEMBABULE,2015,4660,4350,9010,2
SSEMBABULE,2016,4900,4530,9430,2
SSEMBABULE,2017,4940,4810,9750,2
SSEMBABULE,2018,5020,4890,9910,2
SSEMBABULE,2019,5100,4970,10070,2
SSEMBABULE,2020,5190,5030,10220,2
SSEMBABULE,2021,5260,5110,10370,2
SSEMBABULE,2022,5340,5170,10510,2
SSEMBABULE,2023,5410,5230,10640,2
SSEMBABULE,2024,5470,5290,10760,2
SSEMBABULE,2025,5530,5330,10860,2
TORORO,2015,9610,9050,18660,2
TORORO,2016,9870,9280,19150,2
TORORO,2017,10130,9520,19650,2
TORORO,2018,10400,9750,20150,2
TORORO,2019,10660,9990,20650,2
TORORO,2020,10930,10220,21150,2
TORORO,2021,11200,10450,21650,2
TORORO,2022,11460,10690,22150,2
TORORO,2023,11720,10920,22640,2
TORORO,2024,11980,11150,23130,2
TORORO,2025,12240,11370,23610,2
WAKISO,2015,37690,34350,72040,2
WAKISO,2016,40210,36700,76910,2
WAKISO,2017,42910,39220,82130,2
WAKISO,2018,45750,41870,87620,2
WAKISO,2019,48790,44680,93470,2
WAKISO,2020,51970,47650,99620,2
WAKISO,2021,55310,50810,106120,2
WAKISO,2022,58860,54170,113030,2
WAKISO,2023,62590,57650,120240,2
WAKISO,2024,66490,61320,127810,2
WAKISO,2025,70580,65220,135800,2
YUMBE,2015,7800,7920,15720,2
YUMBE,2016,8370,8500,16870,2
YUMBE,2017,8630,9310,17940,2
YUMBE,2018,8960,9760,18720,2
YUMBE,2019,9320,10230,19550,2
YUMBE,2020,9670,10710,20380,2
YUMBE,2021,10030,11200,21230,2
YUMBE,2022,10380,11700,22080,2
YUMBE,2023,10760,12220,22980,2
YUMBE,2024,11130,12740,23870,2
YUMBE,2025,11480,13270,24750,2
ZOMBO,2015,4930,4560,9490,2
ZOMBO,2016,5080,4690,9770,2
ZOMBO,2017,5230,4820,10050,2
ZOMBO,2018,5400,4950,10350,2
ZOMBO,2019,5560,5090,10650,2
ZOMBO,2020,5720,5220,10940,2
ZOMBO,2021,5880,5360,11240,2
ZOMBO,2022,6050,5490,11540,2
ZOMBO,2023,6210,5630,11840,2
ZOMBO,2024,6370,5760,12130,2
ZOMBO,2025,6540,5900,12440,2
ABIM,2015,1150,1360,2510,20
ABIM,2016,1240,1420,2660,20
ABIM,2017,1350,1510,2860,20
ABIM,2018,1480,1610,3090,20
ABIM,2019,1610,1720,3330,20
ABIM,2020,1740,1850,3590,20
ABIM,2021,1890,1970,3860,20
ABIM,2022,2020,2090,4110,20
ABIM,2023,2150,2200,4350,20
ABIM,2024,2260,2300,4560,20
ABIM,2025,2380,2390,4770,20
ADJUMANI,2015,2090,2640,4730,20
ADJUMANI,2016,2110,2660,4770,20
ADJUMANI,2017,2130,2690,4820,20
ADJUMANI,2018,2140,2720,4860,20
ADJUMANI,2019,2150,2740,4890,20
ADJUMANI,2020,2170,2760,4930,20
ADJUMANI,2021,2180,2780,4960,20
ADJUMANI,2022,2190,2800,4990,20
ADJUMANI,2023,2190,2820,5010,20
ADJUMANI,2024,2200,2840,5040,20
ADJUMANI,2025,2210,2850,5060,20
AGAGO,2015,2170,2720,4890,20
AGAGO,2016,2210,2770,4980,20
AGAGO,2017,2250,2820,5070,20
AGAGO,2018,2290,2870,5160,20
AGAGO,2019,2320,2920,5240,20
AGAGO,2020,2360,2960,5320,20
AGAGO,2021,2400,3010,5410,20
AGAGO,2022,2430,3050,5480,20
AGAGO,2023,2470,3100,5570,20
AGAGO,2024,2500,3140,5640,20
AGAGO,2025,2530,3180,5710,20
ALEBTONG,2015,2040,2410,4450,20
ALEBTONG,2016,2150,2450,4600,20
ALEBTONG,2017,2260,2520,4780,20
ALEBTONG,2018,2370,2600,4970,20
ALEBTONG,2019,2490,2690,5180,20
ALEBTONG,2020,2610,2800,5410,20
ALEBTONG,2021,2720,2890,5610,20
ALEBTONG,2022,2820,2970,5790,20
ALEBTONG,2023,2900,3010,5910,20
ALEBTONG,2024,2950,3040,5990,20
ALEBTONG,2025,3000,3070,6070,20
AMOLATAR,2015,1480,1540,3020,20
AMOLATAR,2016,1550,1570,3120,20
AMOLATAR,2017,1630,1600,3230,20
AMOLATAR,2018,1710,1650,3360,20
AMOLATAR,2019,1800,1710,3510,20
AMOLATAR,2020,1870,1780,3650,20
AMOLATAR,2021,1960,1820,3780,20
AMOLATAR,2022,2030,1870,3900,20
AMOLATAR,2023,2080,1900,3980,20
AMOLATAR,2024,2110,1910,4020,20
AMOLATAR,2025,2140,1920,4060,20
AMUDAT,2015,1160,1230,2390,20
AMUDAT,2016,1230,1270,2500,20
AMUDAT,2017,1300,1330,2630,20
AMUDAT,2018,1380,1400,2780,20
AMUDAT,2019,1470,1480,2950,20
AMUDAT,2020,1560,1560,3120,20
AMUDAT,2021,1650,1640,3290,20
AMUDAT,2022,1720,1720,3440,20
AMUDAT,2023,1790,1780,3570,20
AMUDAT,2024,1850,1830,3680,20
AMUDAT,2025,1890,1880,3770,20
AMURIA,2015,1710,1810,3520,20
AMURIA,2016,1820,1850,3670,20
AMURIA,2017,1920,1900,3820,20
AMURIA,2018,2040,1990,4030,20
AMURIA,2019,2160,2080,4240,20
AMURIA,2020,2300,2180,4480,20
AMURIA,2021,2420,2260,4680,20
AMURIA,2022,2530,2340,4870,20
AMURIA,2023,2610,2400,5010,20
AMURIA,2024,2690,2440,5130,20
AMURIA,2025,2760,2480,5240,20
AMURU,2015,1710,1970,3680,20
AMURU,2016,1790,2010,3800,20
AMURU,2017,1880,2060,3940,20
AMURU,2018,1980,2130,4110,20
AMURU,2019,2070,2210,4280,20
AMURU,2020,2170,2290,4460,20
AMURU,2021,2260,2360,4620,20
AMURU,2022,2340,2420,4760,20
AMURU,2023,2390,2460,4850,20
AMURU,2024,2430,2480,4910,20
AMURU,2025,2470,2500,4970,20
APAC,2015,2040,2590,4630,20
APAC,2016,2120,2680,4800,20
APAC,2017,2200,2770,4970,20
APAC,2018,2280,2870,5150,20
APAC,2019,2360,2960,5320,20
APAC,2020,2440,3060,5500,20
APAC,2021,2530,3160,5690,20
APAC,2022,2610,3260,5870,20
APAC,2023,2700,3360,6060,20
APAC,2024,2780,3470,6250,20
APAC,2025,2870,3570,6440,20
ARUA,2015,6800,8810,15610,20
ARUA,2016,7000,9050,16050,20
ARUA,2017,7190,9300,16490,20
ARUA,2018,7400,9540,16940,20
ARUA,2019,7610,9800,17410,20
ARUA,2020,7810,10050,17860,20
ARUA,2021,8030,10300,18330,20
ARUA,2022,8230,10550,18780,20
ARUA,2023,8440,10810,19250,20
ARUA,2024,8650,11060,19710,20
ARUA,2025,8850,11300,20150,20
BUDAKA,2015,1900,1980,3880,20
BUDAKA,2016,2010,2040,4050,20
BUDAKA,2017,2140,2090,4230,20
BUDAKA,2018,2260,2180,4440,20
BUDAKA,2019,2390,2280,4670,20
BUDAKA,2020,2530,2380,4910,20
BUDAKA,2021,2650,2480,5130,20
BUDAKA,2022,2780,2560,5340,20
BUDAKA,2023,2880,2620,5500,20
BUDAKA,2024,2950,2670,5620,20
BUDAKA,2025,3020,2700,5720,20
BUDUDA,2015,2210,2200,4410,20
BUDUDA,2016,2350,2280,4630,20
BUDUDA,2017,2510,2370,4880,20
BUDUDA,2018,2690,2500,5190,20
BUDUDA,2019,2870,2640,5510,20
BUDUDA,2020,3060,2780,5840,20
BUDUDA,2021,3250,2930,6180,20
BUDUDA,2022,3430,3050,6480,20
BUDUDA,2023,3570,3150,6720,20
BUDUDA,2024,3710,3240,6950,20
BUDUDA,2025,3830,3320,7150,20
BUGIRI,2015,3300,3880,7180,20
BUGIRI,2016,3520,3990,7510,20
BUGIRI,2017,3740,4140,7880,20
BUGIRI,2018,3980,4330,8310,20
BUGIRI,2019,4230,4550,8780,20
BUGIRI,2020,4490,4770,9260,20
BUGIRI,2021,4750,4990,9740,20
BUGIRI,2022,4990,5170,10160,20
BUGIRI,2023,5190,5320,10510,20
BUGIRI,2024,5350,5440,10790,20
BUGIRI,2025,5510,5550,11060,20
BUGWERI,2015,1570,1750,3320,20
BUGWERI,2016,1650,1780,3430,20
BUGWERI,2017,1730,1820,3550,20
BUGWERI,2018,1820,1880,3700,20
BUGWERI,2019,1910,1950,3860,20
BUGWERI,2020,2000,2010,4010,20
BUGWERI,2021,2090,2080,4170,20
BUGWERI,2022,2160,2130,4290,20
BUGWERI,2023,2220,2160,4380,20
BUGWERI,2024,2260,2180,4440,20
BUGWERI,2025,2290,2200,4490,20
BUHWEJU,2015,1250,1460,2710,20
BUHWEJU,2016,1290,1510,2800,20
BUHWEJU,2017,1330,1550,2880,20
BUHWEJU,2018,1370,1600,2970,20
BUHWEJU,2019,1420,1650,3070,20
BUHWEJU,2020,1460,1700,3160,20
BUHWEJU,2021,1510,1740,3250,20
BUHWEJU,2022,1550,1790,3340,20
BUHWEJU,2023,1600,1840,3440,20
BUHWEJU,2024,1640,1890,3530,20
BUHWEJU,2025,1680,1940,3620,20
BUIKWE,2015,4390,4760,9150,20
BUIKWE,2016,4580,4810,9390,20
BUIKWE,2017,4770,4900,9670,20
BUIKWE,2018,4980,5030,10010,20
BUIKWE,2019,5190,5180,10370,20
BUIKWE,2020,5400,5350,10750,20
BUIKWE,2021,5600,5490,11090,20
BUIKWE,2022,5750,5590,11340,20
BUIKWE,2023,5860,5640,11500,20
BUIKWE,2024,5930,5670,11600,20
BUIKWE,2025,5980,5660,11640,20
BUKEDEA,2015,1860,2040,3900,20
BUKEDEA,2016,1990,2110,4100,20
BUKEDEA,2017,2130,2180,4310,20
BUKEDEA,2018,2270,2290,4560,20
BUKEDEA,2019,2420,2410,4830,20
BUKEDEA,2020,2580,2540,5120,20
BUKEDEA,2021,2730,2660,5390,20
BUKEDEA,2022,2870,2760,5630,20
BUKEDEA,2023,3000,2850,5850,20
BUKEDEA,2024,3100,2910,6010,20
BUKEDEA,2025,3210,2970,6180,20
BUKOMANSIMBI,2015,1270,1160,2430,20
BUKOMANSIMBI,2016,1310,1150,2460,20
BUKOMANSIMBI,2017,1350,1160,2510,20
BUKOMANSIMBI,2018,1390,1170,2560,20
BUKOMANSIMBI,2019,1430,1190,2620,20
BUKOMANSIMBI,2020,1470,1200,2670,20
BUKOMANSIMBI,2021,1510,1220,2730,20
BUKOMANSIMBI,2022,1530,1220,2750,20
BUKOMANSIMBI,2023,1540,1220,2760,20
BUKOMANSIMBI,2024,1540,1200,2740,20
BUKOMANSIMBI,2025,1540,1180,2720,20
BUKWO,2015,930,980,1910,20
BUKWO,2016,980,1030,2010,20
BUKWO,2017,1030,1080,2110,20
BUKWO,2018,1090,1140,2230,20
BUKWO,2019,1140,1190,2330,20
BUKWO,2020,1200,1250,2450,20
BUKWO,2021,1260,1300,2560,20
BUKWO,2022,1330,1360,2690,20
BUKWO,2023,1390,1430,2820,20
BUKWO,2024,1460,1490,2950,20
BUKWO,2025,1530,1560,3090,20
BULAMBULI,2015,1590,1660,3250,20
BULAMBULI,2016,1700,1730,3430,20
BULAMBULI,2017,1820,1810,3630,20
BULAMBULI,2018,1970,1910,3880,20
BULAMBULI,2019,2100,2030,4130,20
BULAMBULI,2020,2250,2150,4400,20
BULAMBULI,2021,2400,2270,4670,20
BULAMBULI,2022,2540,2380,4920,20
BULAMBULI,2023,2650,2470,5120,20
BULAMBULI,2024,2770,2550,5320,20
BULAMBULI,2025,2870,2620,5490,20
BULIISA,2015,1280,1650,2930,20
BULIISA,2016,1350,1720,3070,20
BULIISA,2017,1420,1800,3220,20
BULIISA,2018,1500,1880,3380,20
BULIISA,2019,1570,1960,3530,20
BULIISA,2020,1660,2040,3700,20
BULIISA,2021,1740,2130,3870,20
BULIISA,2022,1830,2210,4040,20
BULIISA,2023,1930,2310,4240,20
BULIISA,2024,2020,2400,4420,20
BULIISA,2025,2120,2490,4610,20
BUNDIBUGYO,2015,2330,3040,5370,20
BUNDIBUGYO,2016,2450,3090,5540,20
BUNDIBUGYO,2017,2580,3170,5750,20
BUNDIBUGYO,2018,2720,3280,6000,20
BUNDIBUGYO,2019,2850,3410,6260,20
BUNDIBUGYO,2020,3000,3540,6540,20
BUNDIBUGYO,2021,3140,3650,6790,20
BUNDIBUGYO,2022,3270,3740,7010,20
BUNDIBUGYO,2023,3350,3810,7160,20
BUNDIBUGYO,2024,3430,3850,7280,20
BUNDIBUGYO,2025,3490,3880,7370,20
BUNYANGABU,2015,1780,1810,3590,20
BUNYANGABU,2016,1860,1830,3690,20
BUNYANGABU,2017,1940,1860,3800,20
BUNYANGABU,2018,2040,1920,3960,20
BUNYANGABU,2019,2130,1980,4110,20
BUNYANGABU,2020,2240,2060,4300,20
BUNYANGABU,2021,2340,2110,4450,20
BUNYANGABU,2022,2410,2160,4570,20
BUNYANGABU,2023,2460,2180,4640,20
BUNYANGABU,2024,2510,2200,4710,20
BUNYANGABU,2025,2540,2200,4740,20
BUSHENYI,2015,2890,3100,5990,20
BUSHENYI,2016,2930,3130,6060,20
BUSHENYI,2017,2960,3150,6110,20
BUSHENYI,2018,3000,3180,6180,20
BUSHENYI,2019,3030,3210,6240,20
BUSHENYI,2020,3070,3230,6300,20
BUSHENYI,2021,3100,3250,6350,20
BUSHENYI,2022,3130,3270,6400,20
BUSHENYI,2023,3150,3290,6440,20
BUSHENYI,2024,3180,3310,6490,20
BUSHENYI,2025,3200,3320,6520,20
BUSIA,2015,2910,3270,6180,20
BUSIA,2016,3060,3330,6390,20
BUSIA,2017,3230,3420,6650,20
BUSIA,2018,3410,3540,6950,20
BUSIA,2019,3580,3690,7270,20
BUSIA,2020,3780,3830,7610,20
BUSIA,2021,3950,3960,7910,20
BUSIA,2022,4110,4080,8190,20
BUSIA,2023,4240,4150,8390,20
BUSIA,2024,4340,4200,8540,20
BUSIA,2025,4420,4230,8650,20
BUTALEJA,2015,2120,2350,4470,20
BUTALEJA,2016,2240,2410,4650,20
BUTALEJA,2017,2380,2490,4870,20
BUTALEJA,2018,2530,2600,5130,20
BUTALEJA,2019,2680,2720,5400,20
BUTALEJA,2020,2840,2840,5680,20
BUTALEJA,2021,2990,2960,5950,20
BUTALEJA,2022,3120,3060,6180,20
BUTALEJA,2023,3240,3140,6380,20
BUTALEJA,2024,3340,3200,6540,20
BUTALEJA,2025,3420,3240,6660,20
BUTAMBALA,2015,970,930,1900,20
BUTAMBALA,2016,1010,930,1940,20
BUTAMBALA,2017,1040,940,1980,20
BUTAMBALA,2018,1080,960,2040,20
BUTAMBALA,2019,1110,980,2090,20
BUTAMBALA,2020,1160,1000,2160,20
BUTAMBALA,2021,1190,1020,2210,20
BUTAMBALA,2022,1220,1030,2250,20
BUTAMBALA,2023,1230,1030,2260,20
BUTAMBALA,2024,1240,1010,2250,20
BUTAMBALA,2025,1240,1010,2250,20
BUTEBO,2015,1010,1150,2160,20
BUTEBO,2016,1050,1150,2200,20
BUTEBO,2017,1090,1160,2250,20
BUTEBO,2018,1130,1180,2310,20
BUTEBO,2019,1170,1210,2380,20
BUTEBO,2020,1210,1240,2450,20
BUTEBO,2021,1250,1260,2510,20
BUTEBO,2022,1280,1280,2560,20
BUTEBO,2023,1300,1290,2590,20
BUTEBO,2024,1310,1280,2590,20
BUTEBO,2025,1320,1270,2590,20
BUVUMA,2015,1060,1240,2300,20
BUVUMA,2016,1130,1330,2460,20
BUVUMA,2017,1200,1420,2620,20
BUVUMA,2018,1270,1510,2780,20
BUVUMA,2019,1350,1610,2960,20
BUVUMA,2020,1430,1720,3150,20
BUVUMA,2021,1510,1830,3340,20
BUVUMA,2022,1600,1950,3550,20
BUVUMA,2023,1690,2070,3760,20
BUVUMA,2024,1790,2210,4000,20
BUVUMA,2025,1890,2340,4230,20
BUYENDE,2015,2790,3630,6420,20
BUYENDE,2016,2980,3750,6730,20
BUYENDE,2017,3180,3910,7090,20
BUYENDE,2018,3410,4110,7520,20
BUYENDE,2019,3630,4330,7960,20
BUYENDE,2020,3870,4570,8440,20
BUYENDE,2021,4110,4790,8900,20
BUYENDE,2022,4320,4990,9310,20
BUYENDE,2023,4510,5160,9670,20
BUYENDE,2024,4680,5290,9970,20
BUYENDE,2025,4830,5410,10240,20
DOKOLO,2015,1840,2280,4120,20
DOKOLO,2016,1900,2340,4240,20
DOKOLO,2017,1960,2410,4370,20
DOKOLO,2018,2020,2470,4490,20
DOKOLO,2019,2080,2540,4620,20
DOKOLO,2020,2140,2600,4740,20
DOKOLO,2021,2200,2670,4870,20
DOKOLO,2022,2260,2740,5000,20
DOKOLO,2023,2320,2800,5120,20
DOKOLO,2024,2380,2870,5250,20
DOKOLO,2025,2440,2930,5370,20
GOMBA,2015,1500,1350,2850,20
GOMBA,2016,1560,1350,2910,20
GOMBA,2017,1620,1360,2980,20
GOMBA,2018,1680,1390,3070,20
GOMBA,2019,1750,1420,3170,20
GOMBA,2020,1820,1460,3280,20
GOMBA,2021,1880,1490,3370,20
GOMBA,2022,1920,1500,3420,20
GOMBA,2023,1960,1500,3460,20
GOMBA,2024,1980,1490,3470,20
GOMBA,2025,1980,1480,3460,20
GULU,2015,3580,4260,7840,20
GULU,2016,3690,4390,8080,20
GULU,2017,3800,4520,8320,20
GULU,2018,3920,4650,8570,20
GULU,2019,4030,4780,8810,20
GULU,2020,4150,4910,9060,20
GULU,2021,4260,5050,9310,20
GULU,2022,4380,5180,9560,20
GULU,2023,4490,5310,9800,20
GULU,2024,4610,5450,10060,20
GULU,2025,4720,5580,10300,20
HOIMA,2015,3620,4490,8110,20
HOIMA,2016,3750,4640,8390,20
HOIMA,2017,3890,4810,8700,20
HOIMA,2018,4040,4970,9010,20
HOIMA,2019,4180,5140,9320,20
HOIMA,2020,4340,5310,9650,20
HOIMA,2021,4490,5480,9970,20
HOIMA,2022,4650,5660,10310,20
HOIMA,2023,4800,5840,10640,20
HOIMA,2024,4960,6010,10970,20
HOIMA,2025,5120,6190,11310,20
IBANDA,2015,2870,3200,6070,20
IBANDA,2016,2930,3250,6180,20
IBANDA,2017,2990,3310,6300,20
IBANDA,2018,3040,3370,6410,20
IBANDA,2019,3100,3430,6530,20
IBANDA,2020,3160,3490,6650,20
IBANDA,2021,3210,3540,6750,20
IBANDA,2022,3270,3600,6870,20
IBANDA,2023,3320,3650,6970,20
IBANDA,2024,3370,3700,7070,20
IBANDA,2025,3420,3750,7170,20
IGANGA,2015,3470,4000,7470,20
IGANGA,2016,3660,4080,7740,20
IGANGA,2017,3860,4190,8050,20
IGANGA,2018,4070,4340,8410,20
IGANGA,2019,4290,4510,8800,20
IGANGA,2020,4510,4690,9200,20
IGANGA,2021,4730,4850,9580,20
IGANGA,2022,4920,4990,9910,20
IGANGA,2023,5070,5080,10150,20
IGANGA,2024,5180,5140,10320,20
IGANGA,2025,5280,5190,10470,20
ISINGIRO,2015,4840,5620,10460,20
ISINGIRO,2016,5030,5820,10850,20
ISINGIRO,2017,5210,6020,11230,20
ISINGIRO,2018,5410,6230,11640,20
ISINGIRO,2019,5600,6450,12050,20
ISINGIRO,2020,5800,6660,12460,20
ISINGIRO,2021,6010,6880,12890,20
ISINGIRO,2022,6210,7110,13320,20
ISINGIRO,2023,6420,7330,13750,20
ISINGIRO,2024,6630,7560,14190,20
ISINGIRO,2025,6850,7790,14640,20
JINJA,2015,5820,6940,12760,20
JINJA,2016,5920,7050,12970,20
JINJA,2017,6020,7160,13180,20
JINJA,2018,6120,7260,13380,20
JINJA,2019,6220,7370,13590,20
JINJA,2020,6310,7470,13780,20
JINJA,2021,6410,7570,13980,20
JINJA,2022,6490,7670,14160,20
JINJA,2023,6580,7760,14340,20
JINJA,2024,6660,7850,14510,20
JINJA,2025,6740,7930,14670,20
KAABONG,2015,1140,1980,3120,20
KAABONG,2016,1170,2030,3200,20
KAABONG,2017,1210,2090,3300,20
KAABONG,2018,1230,2130,3360,20
KAABONG,2019,1270,2180,3450,20
KAABONG,2020,1300,2230,3530,20
KAABONG,2021,1340,2280,3620,20
KAABONG,2022,1370,2340,3710,20
KAABONG,2023,1400,2380,3780,20
KAABONG,2024,1430,2430,3860,20
KAABONG,2025,1460,2480,3940,20
KABALE,2015,2610,3110,5720,20
KABALE,2016,2650,3150,5800,20
KABALE,2017,2690,3190,5880,20
KABALE,2018,2730,3230,5960,20
KABALE,2019,2770,3260,6030,20
KABALE,2020,2810,3300,6110,20
KABALE,2021,2850,3330,6180,20
KABALE,2022,2890,3360,6250,20
KABALE,2023,2920,3390,6310,20
KABALE,2024,2950,3420,6370,20
KABALE,2025,2980,3440,6420,20
KABAROLE,2015,3980,4200,8180,20
KABAROLE,2016,4070,4290,8360,20
KABAROLE,2017,4160,4380,8540,20
KABAROLE,2018,4250,4480,8730,20
KABAROLE,2019,4340,4570,8910,20
KABAROLE,2020,4430,4660,9090,20
KABAROLE,2021,4520,4750,9270,20
KABAROLE,2022,4610,4840,9450,20
KABAROLE,2023,4690,4930,9620,20
KABAROLE,2024,4770,5020,9790,20
KABAROLE,2025,4850,5100,9950,20
KABERAMAIDO,2015,950,960,1910,20
KABERAMAIDO,2016,1020,990,2010,20
KABERAMAIDO,2017,1080,1030,2110,20
KABERAMAIDO,2018,1150,1080,2230,20
KABERAMAIDO,2019,1230,1140,2370,20
KABERAMAIDO,2020,1300,1200,2500,20
KABERAMAIDO,2021,1380,1250,2630,20
KABERAMAIDO,2022,1450,1300,2750,20
KABERAMAIDO,2023,1510,1330,2840,20
KABERAMAIDO,2024,1570,1360,2930,20
KABERAMAIDO,2025,1620,1390,3010,20
KAGADI,2015,3760,4600,8360,20
KAGADI,2016,3900,4760,8660,20
KAGADI,2017,4040,4930,8970,20
KAGADI,2018,4190,5110,9300,20
KAGADI,2019,4340,5280,9620,20
KAGADI,2020,4490,5460,9950,20
KAGADI,2021,4650,5640,10290,20
KAGADI,2022,4810,5830,10640,20
KAGADI,2023,4970,6010,10980,20
KAGADI,2024,5130,6200,11330,20
KAGADI,2025,5290,6390,11680,20
KAKUMIRO,2015,3210,3710,6920,20
KAKUMIRO,2016,3500,4020,7520,20
KAKUMIRO,2017,3800,4360,8160,20
KAKUMIRO,2018,4140,4730,8870,20
KAKUMIRO,2019,4500,5120,9620,20
KAKUMIRO,2020,4890,5550,10440,20
KAKUMIRO,2021,5310,6000,11310,20
KAKUMIRO,2022,5770,6490,12260,20
KAKUMIRO,2023,6250,7010,13260,20
KAKUMIRO,2024,6780,7570,14350,20
KAKUMIRO,2025,7340,8170,15510,20
KALAKI,2015,1110,1200,2310,20
KALAKI,2016,1160,1250,2410,20
KALAKI,2017,1210,1300,2510,20
KALAKI,2018,1260,1350,2610,20
KALAKI,2019,1310,1400,2710,20
KALAKI,2020,1370,1460,2830,20
KALAKI,2021,1420,1510,2930,20
KALAKI,2022,1480,1570,3050,20
KALAKI,2023,1540,1630,3170,20
KALAKI,2024,1600,1680,3280,20
KALAKI,2025,1660,1740,3400,20
KALANGALA,2015,610,710,1320,20
KALANGALA,2016,640,740,1380,20
KALANGALA,2017,660,770,1430,20
KALANGALA,2018,680,800,1480,20
KALANGALA,2019,710,840,1550,20
KALANGALA,2020,730,870,1600,20
KALANGALA,2021,750,900,1650,20
KALANGALA,2022,780,940,1720,20
KALANGALA,2023,800,970,1770,20
KALANGALA,2024,830,1010,1840,20
KALANGALA,2025,850,1050,1900,20
KALIRO,2015,2210,2590,4800,20
KALIRO,2016,2330,2660,4990,20
KALIRO,2017,2470,2740,5210,20
KALIRO,2018,2620,2850,5470,20
KALIRO,2019,2770,2980,5750,20
KALIRO,2020,2920,3130,6050,20
KALIRO,2021,3070,3250,6320,20
KALIRO,2022,3210,3360,6570,20
KALIRO,2023,3320,3440,6760,20
KALIRO,2024,3420,3500,6920,20
KALIRO,2025,3490,3560,7050,20
KALUNGU,2015,1490,1560,3050,20
KALUNGU,2016,1540,1570,3110,20
KALUNGU,2017,1590,1570,3160,20
KALUNGU,2018,1650,1600,3250,20
KALUNGU,2019,1700,1630,3330,20
KALUNGU,2020,1750,1670,3420,20
KALUNGU,2021,1800,1690,3490,20
KALUNGU,2022,1830,1710,3540,20
KALUNGU,2023,1850,1710,3560,20
KALUNGU,2024,1860,1690,3550,20
KALUNGU,2025,1850,1680,3530,20
KAMPALA,2015,22250,32620,54870,20
KAMPALA,2016,22700,33260,55960,20
KAMPALA,2017,23150,33910,57060,20
KAMPALA,2018,23590,34550,58140,20
KAMPALA,2019,24040,35190,59230,20
KAMPALA,2020,24470,35820,60290,20
KAMPALA,2021,24900,36440,61340,20
KAMPALA,2022,25320,37050,62370,20
KAMPALA,2023,25730,37650,63380,20
KAMPALA,2024,26120,38230,64350,20
KAMPALA,2025,26500,38780,65280,20
KAMULI,2015,4470,4850,9320,20
KAMULI,2016,4680,4920,9600,20
KAMULI,2017,4910,5010,9920,20
KAMULI,2018,5160,5160,10320,20
KAMULI,2019,5400,5340,10740,20
KAMULI,2020,5650,5510,11160,20
KAMULI,2021,5890,5670,11560,20
KAMULI,2022,6100,5790,11890,20
KAMULI,2023,6250,5860,12110,20
KAMULI,2024,6360,5900,12260,20
KAMULI,2025,6440,5920,12360,20
KAMWENGE,2015,2720,3470,6190,20
KAMWENGE,2016,2830,3600,6430,20
KAMWENGE,2017,2950,3730,6680,20
KAMWENGE,2018,3070,3860,6930,20
KAMWENGE,2019,3190,3990,7180,20
KAMWENGE,2020,3310,4130,7440,20
KAMWENGE,2021,3440,4260,7700,20
KAMWENGE,2022,3570,4400,7970,20
KAMWENGE,2023,3700,4550,8250,20
KAMWENGE,2024,3840,4690,8530,20
KAMWENGE,2025,3970,4840,8810,20
KANUNGU,2015,2500,3100,5600,20
KANUNGU,2016,2540,3150,5690,20
KANUNGU,2017,2590,3200,5790,20
KANUNGU,2018,2640,3250,5890,20
KANUNGU,2019,2680,3300,5980,20
KANUNGU,2020,2720,3350,6070,20
KANUNGU,2021,2770,3390,6160,20
KANUNGU,2022,2810,3440,6250,20
KANUNGU,2023,2850,3490,6340,20
KANUNGU,2024,2890,3530,6420,20
KANUNGU,2025,2930,3570,6500,20
KAPCHORWA,2015,1180,1320,2500,20
KAPCHORWA,2016,1220,1360,2580,20
KAPCHORWA,2017,1250,1400,2650,20
KAPCHORWA,2018,1290,1430,2720,20
KAPCHORWA,2019,1330,1470,2800,20
KAPCHORWA,2020,1370,1510,2880,20
KAPCHORWA,2021,1410,1550,2960,20
KAPCHORWA,2022,1450,1590,3040,20
KAPCHORWA,2023,1480,1630,3110,20
KAPCHORWA,2024,1520,1670,3190,20
KAPCHORWA,2025,1560,1710,3270,20
KAPELEBYONG,2015,800,840,1640,20
KAPELEBYONG,2016,860,860,1720,20
KAPELEBYONG,2017,900,880,1780,20
KAPELEBYONG,2018,950,910,1860,20
KAPELEBYONG,2019,1000,950,1950,20
KAPELEBYONG,2020,1050,980,2030,20
KAPELEBYONG,2021,1100,1020,2120,20
KAPELEBYONG,2022,1150,1050,2200,20
KAPELEBYONG,2023,1180,1070,2250,20
KAPELEBYONG,2024,1220,1080,2300,20
KAPELEBYONG,2025,1240,1090,2330,20
KASESE,2015,7250,7960,15210,20
KASESE,2016,7580,8070,15650,20
KASESE,2017,7930,8220,16150,20
KASESE,2018,8320,8460,16780,20
KASESE,2019,8700,8740,17440,20
KASESE,2020,9100,9030,18130,20
KASESE,2021,9460,9290,18750,20
KASESE,2022,9780,9480,19260,20
KASESE,2023,10000,9590,19590,20
KASESE,2024,10160,9640,19800,20
KASESE,2025,10290,9660,19950,20
KASSANDA,2015,3350,3430,6780,20
KASSANDA,2016,3450,3500,6950,20
KASSANDA,2017,3550,3580,7130,20
KASSANDA,2018,3650,3650,7300,20
KASSANDA,2019,3750,3730,7480,20
KASSANDA,2020,3850,3800,7650,20
KASSANDA,2021,3950,3880,7830,20
KASSANDA,2022,4050,3950,8000,20
KASSANDA,2023,4150,4020,8170,20
KASSANDA,2024,4250,4090,8340,20
KASSANDA,2025,4350,4160,8510,20
KATAKWI,2015,1620,1640,3260,20
KATAKWI,2016,1690,1670,3360,20
KATAKWI,2017,1790,1710,3500,20
KATAKWI,2018,1880,1770,3650,20
KATAKWI,2019,1980,1830,3810,20
KATAKWI,2020,2080,1900,3980,20
KATAKWI,2021,2180,1960,4140,20
KATAKWI,2022,2260,2010,4270,20
KATAKWI,2023,2320,2040,4360,20
KATAKWI,2024,2370,2050,4420,20
KATAKWI,2025,2410,2070,4480,20
KAYUNGA,2015,3250,3530,6780,20
KAYUNGA,2016,3390,3560,6950,20
KAYUNGA,2017,3530,3610,7140,20
KAYUNGA,2018,3680,3690,7370,20
KAYUNGA,2019,3830,3790,7620,20
KAYUNGA,2020,3980,3900,7880,20
KAYUNGA,2021,4130,3990,8120,20
KAYUNGA,2022,4240,4040,8280,20
KAYUNGA,2023,4320,4070,8390,20
KAYUNGA,2024,4370,4070,8440,20
KAYUNGA,2025,4410,4060,8470,20
KAZO,2015,1800,2040,3840,20
KAZO,2016,1860,2110,3970,20
KAZO,2017,1940,2180,4120,20
KAZO,2018,2000,2260,4260,20
KAZO,2019,2080,2340,4420,20
KAZO,2020,2150,2420,4570,20
KAZO,2021,2230,2500,4730,20
KAZO,2022,2310,2580,4890,20
KAZO,2023,2390,2660,5050,20
KAZO,2024,2470,2750,5220,20
KAZO,2025,2550,2830,5380,20
KIBAALE,2015,1490,1750,3240,20
KIBAALE,2016,1590,1860,3450,20
KIBAALE,2017,1690,1960,3650,20
KIBAALE,2018,1800,2080,3880,20
KIBAALE,2019,1910,2190,4100,20
KIBAALE,2020,2030,2320,4350,20
KIBAALE,2021,2150,2450,4600,20
KIBAALE,2022,2280,2580,4860,20
KIBAALE,2023,2420,2720,5140,20
KIBAALE,2024,2560,2870,5430,20
KIBAALE,2025,2710,3020,5730,20
KIBOGA,2015,1580,1460,3040,20
KIBOGA,2016,1660,1480,3140,20
KIBOGA,2017,1740,1520,3260,20
KIBOGA,2018,1830,1560,3390,20
KIBOGA,2019,1910,1620,3530,20
KIBOGA,2020,2000,1670,3670,20
KIBOGA,2021,2090,1720,3810,20
KIBOGA,2022,2160,1760,3920,20
KIBOGA,2023,2220,1780,4000,20
KIBOGA,2024,2260,1790,4050,20
KIBOGA,2025,2290,1810,4100,20
KIBUKU,2015,1910,2130,4040,20
KIBUKU,2016,2030,2200,4230,20
KIBUKU,2017,2150,2270,4420,20
KIBUKU,2018,2290,2370,4660,20
KIBUKU,2019,2430,2480,4910,20
KIBUKU,2020,2570,2600,5170,20
KIBUKU,2021,2710,2720,5430,20
KIBUKU,2022,2840,2810,5650,20
KIBUKU,2023,2950,2890,5840,20
KIBUKU,2024,3030,2940,5970,20
KIBUKU,2025,3120,3000,6120,20
KIKUUBE,2015,2970,3580,6550,20
KIKUUBE,2016,3130,3760,6890,20
KIKUUBE,2017,3300,3950,7250,20
KIKUUBE,2018,3470,4150,7620,20
KIKUUBE,2019,3660,4360,8020,20
KIKUUBE,2020,3840,4570,8410,20
KIKUUBE,2021,4040,4800,8840,20
KIKUUBE,2022,4250,5030,9280,20
KIKUUBE,2023,4460,5270,9730,20
KIKUUBE,2024,4670,5520,10190,20
KIKUUBE,2025,4900,5770,10670,20
KIRUHURA,2015,1770,1760,3530,20
KIRUHURA,2016,1840,1820,3660,20
KIRUHURA,2017,1910,1890,3800,20
KIRUHURA,2018,1980,1950,3930,20
KIRUHURA,2019,2050,2020,4070,20
KIRUHURA,2020,2130,2090,4220,20
KIRUHURA,2021,2210,2160,4370,20
KIRUHURA,2022,2290,2230,4520,20
KIRUHURA,2023,2360,2300,4660,20
KIRUHURA,2024,2440,2370,4810,20
KIRUHURA,2025,2520,2440,4960,20
KIRYANDONGO,2015,2660,2910,5570,20
KIRYANDONGO,2016,2800,2970,5770,20
KIRYANDONGO,2017,2950,3040,5990,20
KIRYANDONGO,2018,3110,3140,6250,20
KIRYANDONGO,2019,3280,3260,6540,20
KIRYANDONGO,2020,3440,3390,6830,20
KIRYANDONGO,2021,3600,3500,7100,20
KIRYANDONGO,2022,3740,3590,7330,20
KIRYANDONGO,2023,3850,3650,7500,20
KIRYANDONGO,2024,3940,3690,7630,20
KIRYANDONGO,2025,4010,3720,7730,20
KISORO,2015,2220,3340,5560,20
KISORO,2016,2320,3370,5690,20
KISORO,2017,2410,3440,5850,20
KISORO,2018,2510,3520,6030,20
KISORO,2019,2610,3640,6250,20
KISORO,2020,2730,3750,6480,20
KISORO,2021,2820,3850,6670,20
KISORO,2022,2900,3920,6820,20
KISORO,2023,2960,3960,6920,20
KISORO,2024,2990,3970,6960,20
KISORO,2025,3010,3970,6980,20
KITAGWENDA,2015,1380,1610,2990,20
KITAGWENDA,2016,1440,1660,3100,20
KITAGWENDA,2017,1500,1720,3220,20
KITAGWENDA,2018,1560,1790,3350,20
KITAGWENDA,2019,1620,1850,3470,20
KITAGWENDA,2020,1690,1910,3600,20
KITAGWENDA,2021,1750,1980,3730,20
KITAGWENDA,2022,1820,2040,3860,20
KITAGWENDA,2023,1880,2110,3990,20
KITAGWENDA,2024,1950,2170,4120,20
KITAGWENDA,2025,2020,2240,4260,20
KITGUM,2015,1990,2190,4180,20
KITGUM,2016,2060,2200,4260,20
KITGUM,2017,2140,2240,4380,20
KITGUM,2018,2230,2290,4520,20
KITGUM,2019,2320,2350,4670,20
KITGUM,2020,2390,2420,4810,20
KITGUM,2021,2480,2460,4940,20
KITGUM,2022,2540,2500,5040,20
KITGUM,2023,2570,2510,5080,20
KITGUM,2024,2590,2510,5100,20
KITGUM,2025,2600,2500,5100,20
KOBOKO,2015,2150,2480,4630,20
KOBOKO,2016,2290,2550,4840,20
KOBOKO,2017,2430,2640,5070,20
KOBOKO,2018,2590,2760,5350,20
KOBOKO,2019,2750,2900,5650,20
KOBOKO,2020,2910,3050,5960,20
KOBOKO,2021,3070,3180,6250,20
KOBOKO,2022,3220,3300,6520,20
KOBOKO,2023,3350,3380,6730,20
KOBOKO,2024,3460,3450,6910,20
KOBOKO,2025,3550,3520,7070,20
KOLE,2015,2650,3130,5780,20
KOLE,2016,2740,3220,5960,20
KOLE,2017,2830,3310,6140,20
KOLE,2018,2920,3410,6330,20
KOLE,2019,3020,3500,6520,20
KOLE,2020,3110,3600,6710,20
KOLE,2021,3200,3690,6890,20
KOLE,2022,3300,3790,7090,20
KOLE,2023,3390,3890,7280,20
KOLE,2024,3490,3980,7470,20
KOLE,2025,3590,4080,7670,20
KOTIDO,2015,2010,2120,4130,20
KOTIDO,2016,2100,2140,4240,20
KOTIDO,2017,2200,2180,4380,20
KOTIDO,2018,2310,2250,4560,20
KOTIDO,2019,2410,2320,4730,20
KOTIDO,2020,2520,2400,4920,20
KOTIDO,2021,2620,2470,5090,20
KOTIDO,2022,2710,2510,5220,20
KOTIDO,2023,2770,2550,5320,20
KOTIDO,2024,2820,2550,5370,20
KOTIDO,2025,2850,2560,5410,20
KUMI,2015,2150,2330,4480,20
KUMI,2016,2260,2380,4640,20
KUMI,2017,2390,2440,4830,20
KUMI,2018,2520,2530,5050,20
KUMI,2019,2660,2640,5300,20
KUMI,2020,2810,2740,5550,20
KUMI,2021,2930,2830,5760,20
KUMI,2022,3050,2910,5960,20
KUMI,2023,3150,2970,6120,20
KUMI,2024,3220,3000,6220,20
KUMI,2025,3290,3030,6320,20
KWANIA,2015,1990,2340,4330,20
KWANIA,2016,2050,2410,4460,20
KWANIA,2017,2110,2480,4590,20
KWANIA,2018,2180,2550,4730,20
KWANIA,2019,2240,2620,4860,20
KWANIA,2020,2310,2690,5000,20
KWANIA,2021,2380,2760,5140,20
KWANIA,2022,2440,2840,5280,20
KWANIA,2023,2510,2910,5420,20
KWANIA,2024,2570,2980,5550,20
KWANIA,2025,2640,3050,5690,20
KWEEN,2015,1050,1080,2130,20
KWEEN,2016,1090,1110,2200,20
KWEEN,2017,1120,1130,2250,20
KWEEN,2018,1150,1160,2310,20
KWEEN,2019,1190,1190,2380,20
KWEEN,2020,1220,1220,2440,20
KWEEN,2021,1260,1240,2500,20
KWEEN,2022,1300,1270,2570,20
KWEEN,2023,1330,1300,2630,20
KWEEN,2024,1370,1330,2700,20
KWEEN,2025,1400,1350,2750,20
KYANKWANZI,2015,2850,2690,5540,20
KYANKWANZI,2016,2990,2820,5810,20
KYANKWANZI,2017,3140,2950,6090,20
KYANKWANZI,2018,3310,3090,6400,20
KYANKWANZI,2019,3470,3230,6700,20
KYANKWANZI,2020,3640,3370,7010,20
KYANKWANZI,2021,3820,3520,7340,20
KYANKWANZI,2022,4010,3680,7690,20
KYANKWANZI,2023,4200,3840,8040,20
KYANKWANZI,2024,4390,4000,8390,20
KYANKWANZI,2025,4590,4170,8760,20
KYEGEGWA,2015,3020,3590,6610,20
KYEGEGWA,2016,3270,3870,7140,20
KYEGEGWA,2017,3540,4180,7720,20
KYEGEGWA,2018,3830,4510,8340,20
KYEGEGWA,2019,4140,4860,9000,20
KYEGEGWA,2020,4470,5240,9710,20
KYEGEGWA,2021,4830,5640,10470,20
KYEGEGWA,2022,5210,6070,11280,20
KYEGEGWA,2023,5620,6530,12150,20
KYEGEGWA,2024,6050,7020,13070,20
KYEGEGWA,2025,6510,7530,14040,20
KYENJOJO,2015,4900,5380,10280,20
KYENJOJO,2016,5110,5580,10690,20
KYENJOJO,2017,5320,5790,11110,20
KYENJOJO,2018,5530,6000,11530,20
KYENJOJO,2019,5750,6210,11960,20
KYENJOJO,2020,5980,6430,12410,20
KYENJOJO,2021,6210,6660,12870,20
KYENJOJO,2022,6450,6890,13340,20
KYENJOJO,2023,6690,7120,13810,20
KYENJOJO,2024,6930,7350,14280,20
KYENJOJO,2025,7180,7580,14760,20
KYOTERA,2015,1960,2150,4110,20
KYOTERA,2016,2040,2160,4200,20
KYOTERA,2017,2120,2190,4310,20
KYOTERA,2018,2200,2230,4430,20
KYOTERA,2019,2290,2290,4580,20
KYOTERA,2020,2360,2340,4700,20
KYOTERA,2021,2450,2390,4840,20
KYOTERA,2022,2510,2420,4930,20
KYOTERA,2023,2540,2430,4970,20
KYOTERA,2024,2560,2420,4980,20
KYOTERA,2025,2580,2410,4990,20
KARENGA,2015,860,820,1680,20
KARENGA,2016,880,840,1720,20
KARENGA,2017,900,860,1760,20
KARENGA,2018,940,880,1820,20
KARENGA,2019,960,910,1870,20
KARENGA,2020,990,920,1910,20
KARENGA,2021,1000,950,1950,20
KARENGA,2022,1030,960,1990,20
KARENGA,2023,1050,980,2030,20
KARENGA,2024,1080,1010,2090,20
KARENGA,2025,1100,1020,2120,20
LAMWO,2015,1120,1250,2370,20
LAMWO,2016,1150,1260,2410,20
LAMWO,2017,1190,1270,2460,20
LAMWO,2018,1230,1300,2530,20
LAMWO,2019,1270,1330,2600,20
LAMWO,2020,1300,1370,2670,20
LAMWO,2021,1340,1390,2730,20
LAMWO,2022,1360,1410,2770,20
LAMWO,2023,1370,1420,2790,20
LAMWO,2024,1380,1420,2800,20
LAMWO,2025,1380,1410,2790,20
LIRA,2015,4840,6150,10990,20
LIRA,2016,4980,6320,11300,20
LIRA,2017,5120,6500,11620,20
LIRA,2018,5260,6690,11950,20
LIRA,2019,5400,6870,12270,20
LIRA,2020,5540,7060,12600,20
LIRA,2021,5690,7250,12940,20
LIRA,2022,5830,7430,13260,20
LIRA,2023,5970,7620,13590,20
LIRA,2024,6110,7810,13920,20
LIRA,2025,6250,7990,14240,20
LUUKA,2015,2200,2520,4720,20
LUUKA,2016,2290,2550,4840,20
LUUKA,2017,2390,2590,4980,20
LUUKA,2018,2490,2660,5150,20
LUUKA,2019,2600,2750,5350,20
LUUKA,2020,2710,2830,5540,20
LUUKA,2021,2800,2910,5710,20
LUUKA,2022,2890,2960,5850,20
LUUKA,2023,2950,2990,5940,20
LUUKA,2024,2980,2990,5970,20
LUUKA,2025,3000,3000,6000,20
LUWERO,2015,4540,4810,9350,20
LUWERO,2016,4750,4880,9630,20
LUWERO,2017,4980,4980,9960,20
LUWERO,2018,5220,5120,10340,20
LUWERO,2019,5470,5300,10770,20
LUWERO,2020,5720,5480,11200,20
LUWERO,2021,5960,5630,11590,20
LUWERO,2022,6160,5750,11910,20
LUWERO,2023,6310,5820,12130,20
LUWERO,2024,6410,5860,12270,20
LUWERO,2025,6490,5870,12360,20
LWENGO,2015,2030,2250,4280,20
LWENGO,2016,2090,2250,4340,20
LWENGO,2017,2160,2270,4430,20
LWENGO,2018,2240,2310,4550,20
LWENGO,2019,2310,2350,4660,20
LWENGO,2020,2370,2400,4770,20
LWENGO,2021,2450,2430,4880,20
LWENGO,2022,2490,2460,4950,20
LWENGO,2023,2510,2460,4970,20
LWENGO,2024,2510,2430,4940,20
LWENGO,2025,2510,2410,4920,20
LYANTONDE,2015,940,910,1850,20
LYANTONDE,2016,980,940,1920,20
LYANTONDE,2017,1040,960,2000,20
LYANTONDE,2018,1090,990,2080,20
LYANTONDE,2019,1150,1030,2180,20
LYANTONDE,2020,1210,1070,2280,20
LYANTONDE,2021,1270,1110,2380,20
LYANTONDE,2022,1310,1140,2450,20
LYANTONDE,2023,1350,1160,2510,20
LYANTONDE,2024,1380,1170,2550,20
LYANTONDE,2025,1410,1180,2590,20
MANAFWA,2015,1460,1620,3080,20
MANAFWA,2016,1490,1660,3150,20
MANAFWA,2017,1530,1700,3230,20
MANAFWA,2018,1570,1730,3300,20
MANAFWA,2019,1610,1770,3380,20
MANAFWA,2020,1650,1810,3460,20
MANAFWA,2021,1680,1840,3520,20
MANAFWA,2022,1720,1880,3600,20
MANAFWA,2023,1760,1920,3680,20
MANAFWA,2024,1790,1950,3740,20
MANAFWA,2025,1830,1980,3810,20
MARACHA,2015,1590,2280,3870,20
MARACHA,2016,1620,2330,3950,20
MARACHA,2017,1660,2380,4040,20
MARACHA,2018,1690,2420,4110,20
MARACHA,2019,1720,2460,4180,20
MARACHA,2020,1760,2510,4270,20
MARACHA,2021,1790,2550,4340,20
MARACHA,2022,1820,2600,4420,20
MARACHA,2023,1860,2640,4500,20
MARACHA,2024,1890,2680,4570,20
MARACHA,2025,1920,2720,4640,20
MASAKA,2015,2780,3050,5830,20
MASAKA,2016,2900,3090,5990,20
MASAKA,2017,3040,3140,6180,20
MASAKA,2018,3180,3230,6410,20
MASAKA,2019,3320,3320,6640,20
MASAKA,2020,3460,3430,6890,20
MASAKA,2021,3590,3520,7110,20
MASAKA,2022,3710,3590,7300,20
MASAKA,2023,3780,3630,7410,20
MASAKA,2024,3840,3640,7480,20
MASAKA,2025,3880,3640,7520,20
MASINDI,2015,3540,3860,7400,20
MASINDI,2016,3640,3960,7600,20
MASINDI,2017,3750,4070,7820,20
MASINDI,2018,3860,4180,8040,20
MASINDI,2019,3970,4280,8250,20
MASINDI,2020,4080,4390,8470,20
MASINDI,2021,4180,4500,8680,20
MASINDI,2022,4290,4610,8900,20
MASINDI,2023,4400,4710,9110,20
MASINDI,2024,4510,4820,9330,20
MASINDI,2025,4620,4930,9550,20
MAYUGE,2015,4250,5260,9510,20
MAYUGE,2016,4470,5370,9840,20
MAYUGE,2017,4720,5520,10240,20
MAYUGE,2018,4980,5730,10710,20
MAYUGE,2019,5250,5970,11220,20
MAYUGE,2020,5520,6220,11740,20
MAYUGE,2021,5790,6450,12240,20
MAYUGE,2022,6020,6640,12660,20
MAYUGE,2023,6200,6780,12980,20
MAYUGE,2024,6350,6870,13220,20
MAYUGE,2025,6470,6940,13410,20
MBALE,2015,5020,5700,10720,20
MBALE,2016,5280,5850,11130,20
MBALE,2017,5560,6020,11580,20
MBALE,2018,5860,6270,12130,20
MBALE,2019,6170,6550,12720,20
MBALE,2020,6490,6840,13330,20
MBALE,2021,6790,7110,13900,20
MBALE,2022,7040,7330,14370,20
MBALE,2023,7260,7510,14770,20
MBALE,2024,7410,7620,15030,20
MBALE,2025,7560,7730,15290,20
MBARARA,2015,4490,5380,9870,20
MBARARA,2016,4600,5500,10100,20
MBARARA,2017,4700,5620,10320,20
MBARARA,2018,4810,5730,10540,20
MBARARA,2019,4920,5850,10770,20
MBARARA,2020,5020,5970,10990,20
MBARARA,2021,5130,6090,11220,20
MBARARA,2022,5230,6200,11430,20
MBARARA,2023,5330,6310,11640,20
MBARARA,2024,5430,6420,11850,20
MBARARA,2025,5530,6530,12060,20
MITOOMA,2015,1700,2050,3750,20
MITOOMA,2016,1720,2070,3790,20
MITOOMA,2017,1750,2090,3840,20
MITOOMA,2018,1770,2110,3880,20
MITOOMA,2019,1790,2130,3920,20
MITOOMA,2020,1800,2140,3940,20
MITOOMA,2021,1820,2160,3980,20
MITOOMA,2022,1840,2170,4010,20
MITOOMA,2023,1860,2190,4050,20
MITOOMA,2024,1870,2200,4070,20
MITOOMA,2025,1880,2210,4090,20
MITYANA,2015,3420,3260,6680,20
MITYANA,2016,3550,3280,6830,20
MITYANA,2017,3700,3320,7020,20
MITYANA,2018,3860,3400,7260,20
MITYANA,2019,4010,3490,7500,20
MITYANA,2020,4160,3580,7740,20
MITYANA,2021,4310,3660,7970,20
MITYANA,2022,4420,3710,8130,20
MITYANA,2023,4490,3740,8230,20
MITYANA,2024,4540,3730,8270,20
MITYANA,2025,4570,3720,8290,20
MOROTO,2015,1100,1400,2500,20
MOROTO,2016,1150,1420,2570,20
MOROTO,2017,1210,1460,2670,20
MOROTO,2018,1250,1500,2750,20
MOROTO,2019,1310,1560,2870,20
MOROTO,2020,1370,1610,2980,20
MOROTO,2021,1430,1670,3100,20
MOROTO,2022,1470,1700,3170,20
MOROTO,2023,1490,1730,3220,20
MOROTO,2024,1520,1740,3260,20
MOROTO,2025,1540,1750,3290,20
MOYO,2015,1090,1050,2140,20
MOYO,2016,1120,1080,2200,20
MOYO,2017,1150,1100,2250,20
MOYO,2018,1180,1130,2310,20
MOYO,2019,1210,1150,2360,20
MOYO,2020,1240,1170,2410,20
MOYO,2021,1260,1200,2460,20
MOYO,2022,1290,1220,2510,20
MOYO,2023,1320,1240,2560,20
MOYO,2024,1350,1260,2610,20
MOYO,2025,1370,1290,2660,20
MPIGI,2015,2380,2620,5000,20
MPIGI,2016,2480,2650,5130,20
MPIGI,2017,2600,2710,5310,20
MPIGI,2018,2720,2780,5500,20
MPIGI,2019,2840,2880,5720,20
MPIGI,2020,2970,2980,5950,20
MPIGI,2021,3090,3070,6160,20
MPIGI,2022,3190,3130,6320,20
MPIGI,2023,3270,3180,6450,20
MPIGI,2024,3330,3200,6530,20
MPIGI,2025,3360,3200,6560,20
MUBENDE,2015,4520,4660,9180,20
MUBENDE,2016,4870,4860,9730,20
MUBENDE,2017,5250,5100,10350,20
MUBENDE,2018,5640,5390,11030,20
MUBENDE,2019,6070,5730,11800,20
MUBENDE,2020,6520,6100,12620,20
MUBENDE,2021,6990,6450,13440,20
MUBENDE,2022,7410,6770,14180,20
MUBENDE,2023,7790,7050,14840,20
MUBENDE,2024,8150,7290,15440,20
MUBENDE,2025,8470,7510,15980,20
MUKONO,2015,6030,7070,13100,20
MUKONO,2016,6340,7210,13550,20
MUKONO,2017,6650,7400,14050,20
MUKONO,2018,6990,7670,14660,20
MUKONO,2019,7330,7980,15310,20
MUKONO,2020,7690,8310,16000,20
MUKONO,2021,8020,8600,16620,20
MUKONO,2022,8300,8850,17150,20
MUKONO,2023,8530,9020,17550,20
MUKONO,2024,8690,9120,17810,20
MUKONO,2025,8810,9210,18020,20
NABILATUK,2015,720,810,1530,20
NABILATUK,2016,780,840,1620,20
NABILATUK,2017,840,870,1710,20
NABILATUK,2018,900,920,1820,20
NABILATUK,2019,960,970,1930,20
NABILATUK,2020,1040,1020,2060,20
NABILATUK,2021,1110,1070,2180,20
NABILATUK,2022,1170,1120,2290,20
NABILATUK,2023,1230,1160,2390,20
NABILATUK,2024,1290,1190,2480,20
NABILATUK,2025,1340,1220,2560,20
NAKAPIRIPIRIT,2015,1000,1070,2070,20
NAKAPIRIPIRIT,2016,1060,1100,2160,20
NAKAPIRIPIRIT,2017,1130,1140,2270,20
NAKAPIRIPIRIT,2018,1210,1210,2420,20
NAKAPIRIPIRIT,2019,1290,1270,2560,20
NAKAPIRIPIRIT,2020,1370,1340,2710,20
NAKAPIRIPIRIT,2021,1460,1400,2860,20
NAKAPIRIPIRIT,2022,1530,1460,2990,20
NAKAPIRIPIRIT,2023,1600,1520,3120,20
NAKAPIRIPIRIT,2024,1660,1560,3220,20
NAKAPIRIPIRIT,2025,1710,1590,3300,20
NAKASEKE,2015,2550,2280,4830,20
NAKASEKE,2016,2640,2340,4980,20
NAKASEKE,2017,2740,2390,5130,20
NAKASEKE,2018,2840,2450,5290,20
NAKASEKE,2019,2940,2510,5450,20
NAKASEKE,2020,3040,2560,5600,20
NAKASEKE,2021,3140,2620,5760,20
NAKASEKE,2022,3250,2680,5930,20
NAKASEKE,2023,3360,2730,6090,20
NAKASEKE,2024,3470,2790,6260,20
NAKASEKE,2025,3570,2840,6410,20
NAKASONGOLA,2015,2000,1770,3770,20
NAKASONGOLA,2016,2100,1810,3910,20
NAKASONGOLA,2017,2220,1850,4070,20
NAKASONGOLA,2018,2340,1920,4260,20
NAKASONGOLA,2019,2470,1990,4460,20
NAKASONGOLA,2020,2600,2060,4660,20
NAKASONGOLA,2021,2720,2130,4850,20
NAKASONGOLA,2022,2830,2190,5020,20
NAKASONGOLA,2023,2930,2230,5160,20
NAKASONGOLA,2024,2990,2250,5240,20
NAKASONGOLA,2025,3050,2260,5310,20
NAMAYINGO,2015,1760,2090,3850,20
NAMAYINGO,2016,1830,2110,3940,20
NAMAYINGO,2017,1910,2130,4040,20
NAMAYINGO,2018,1990,2180,4170,20
NAMAYINGO,2019,2070,2240,4310,20
NAMAYINGO,2020,2150,2300,4450,20
NAMAYINGO,2021,2230,2340,4570,20
NAMAYINGO,2022,2280,2370,4650,20
NAMAYINGO,2023,2320,2390,4710,20
NAMAYINGO,2024,2350,2380,4730,20
NAMAYINGO,2025,2360,2370,4730,20
NAMISINDWA,2015,1860,2120,3980,20
NAMISINDWA,2016,1910,2170,4080,20
NAMISINDWA,2017,1970,2220,4190,20
NAMISINDWA,2018,2020,2270,4290,20
NAMISINDWA,2019,2070,2330,4400,20
NAMISINDWA,2020,2130,2380,4510,20
NAMISINDWA,2021,2180,2430,4610,20
NAMISINDWA,2022,2240,2480,4720,20
NAMISINDWA,2023,2290,2530,4820,20
NAMISINDWA,2024,2350,2580,4930,20
NAMISINDWA,2025,2400,2630,5030,20
NAMUTUMBA,2015,2270,2510,4780,20
NAMUTUMBA,2016,2400,2580,4980,20
NAMUTUMBA,2017,2540,2650,5190,20
NAMUTUMBA,2018,2680,2760,5440,20
NAMUTUMBA,2019,2840,2880,5720,20
NAMUTUMBA,2020,3000,3010,6010,20
NAMUTUMBA,2021,3150,3120,6270,20
NAMUTUMBA,2022,3300,3220,6520,20
NAMUTUMBA,2023,3410,3290,6700,20
NAMUTUMBA,2024,3500,3340,6840,20
NAMUTUMBA,2025,3580,3380,6960,20
NAPAK,2015,1280,1610,2890,20
NAPAK,2016,1330,1640,2970,20
NAPAK,2017,1390,1670,3060,20
NAPAK,2018,1440,1710,3150,20
NAPAK,2019,1500,1760,3260,20
NAPAK,2020,1550,1830,3380,20
NAPAK,2021,1600,1870,3470,20
NAPAK,2022,1640,1910,3550,20
NAPAK,2023,1660,1930,3590,20
NAPAK,2024,1680,1940,3620,20
NAPAK,2025,1680,1940,3620,20
NEBBI,2015,2370,3070,5440,20
NEBBI,2016,2450,3160,5610,20
NEBBI,2017,2530,3250,5780,20
NEBBI,2018,2610,3340,5950,20
NEBBI,2019,2690,3430,6120,20
NEBBI,2020,2770,3520,6290,20
NEBBI,2021,2850,3610,6460,20
NEBBI,2022,2930,3710,6640,20
NEBBI,2023,3010,3800,6810,20
NEBBI,2024,3090,3890,6980,20
NEBBI,2025,3180,3980,7160,20
NGORA,2015,1370,1520,2890,20
NGORA,2016,1440,1550,2990,20
NGORA,2017,1520,1590,3110,20
NGORA,2018,1600,1640,3240,20
NGORA,2019,1680,1700,3380,20
NGORA,2020,1760,1760,3520,20
NGORA,2021,1840,1820,3660,20
NGORA,2022,1900,1870,3770,20
NGORA,2023,1960,1900,3860,20
NGORA,2024,2000,1910,3910,20
NGORA,2025,2030,1930,3960,20
NTOROKO,2015,720,770,1490,20
NTOROKO,2016,750,780,1530,20
NTOROKO,2017,780,790,1570,20
NTOROKO,2018,820,820,1640,20
NTOROKO,2019,860,840,1700,20
NTOROKO,2020,900,870,1770,20
NTOROKO,2021,940,890,1830,20
NTOROKO,2022,970,900,1870,20
NTOROKO,2023,990,910,1900,20
NTOROKO,2024,1000,920,1920,20
NTOROKO,2025,1030,910,1940,20
NTUNGAMO,2015,5070,5680,10750,20
NTUNGAMO,2016,5170,5780,10950,20
NTUNGAMO,2017,5290,5890,11180,20
NTUNGAMO,2018,5400,6000,11400,20
NTUNGAMO,2019,5510,6100,11610,20
NTUNGAMO,2020,5620,6210,11830,20
NTUNGAMO,2021,5730,6310,12040,20
NTUNGAMO,2022,5830,6410,12240,20
NTUNGAMO,2023,5940,6510,12450,20
NTUNGAMO,2024,6040,6600,12640,20
NTUNGAMO,2025,6130,6690,12820,20
NWOYA,2015,1470,1720,3190,20
NWOYA,2016,1620,1900,3520,20
NWOYA,2017,1790,2090,3880,20
NWOYA,2018,1980,2310,4290,20
NWOYA,2019,2180,2540,4720,20
NWOYA,2020,2410,2800,5210,20
NWOYA,2021,2650,3070,5720,20
NWOYA,2022,2920,3380,6300,20
NWOYA,2023,3220,3710,6930,20
NWOYA,2024,3530,4070,7600,20
NWOYA,2025,3880,4470,8350,20
OBONGI,2015,420,450,870,20
OBONGI,2016,450,450,900,20
OBONGI,2017,470,460,930,20
OBONGI,2018,490,470,960,20
OBONGI,2019,510,490,1000,20
OBONGI,2020,540,500,1040,20
OBONGI,2021,560,520,1080,20
OBONGI,2022,570,530,1100,20
OBONGI,2023,590,530,1120,20
OBONGI,2024,600,540,1140,20
OBONGI,2025,610,540,1150,20
OMORO,2015,1530,1660,3190,20
OMORO,2016,1620,1700,3320,20
OMORO,2017,1710,1750,3460,20
OMORO,2018,1820,1830,3650,20
OMORO,2019,1920,1910,3830,20
OMORO,2020,2030,2000,4030,20
OMORO,2021,2140,2080,4220,20
OMORO,2022,2230,2150,4380,20
OMORO,2023,2310,2200,4510,20
OMORO,2024,2370,2240,4610,20
OMORO,2025,2430,2280,4710,20
OTUKE,2015,1010,1310,2320,20
OTUKE,2016,1050,1370,2420,20
OTUKE,2017,1100,1430,2530,20
OTUKE,2018,1150,1490,2640,20
OTUKE,2019,1200,1550,2750,20
OTUKE,2020,1250,1620,2870,20
OTUKE,2021,1300,1680,2980,20
OTUKE,2022,1360,1750,3110,20
OTUKE,2023,1420,1820,3240,20
OTUKE,2024,1470,1890,3360,20
OTUKE,2025,1530,1960,3490,20
OYAM,2015,3890,4680,8570,20
OYAM,2016,4010,4820,8830,20
OYAM,2017,4130,4960,9090,20
OYAM,2018,4260,5100,9360,20
OYAM,2019,4380,5250,9630,20
OYAM,2020,4510,5390,9900,20
OYAM,2021,4640,5540,10180,20
OYAM,2022,4770,5690,10460,20
OYAM,2023,4900,5830,10730,20
OYAM,2024,5020,5980,11000,20
OYAM,2025,5150,6130,11280,20
PADER,2015,1570,1770,3340,20
PADER,2016,1640,1800,3440,20
PADER,2017,1700,1820,3520,20
PADER,2018,1770,1870,3640,20
PADER,2019,1840,1930,3770,20
PADER,2020,1910,1990,3900,20
PADER,2021,1980,2040,4020,20
PADER,2022,2030,2070,4100,20
PADER,2023,2060,2090,4150,20
PADER,2024,2070,2090,4160,20
PADER,2025,2080,2090,4170,20
PAKWACH,2015,1650,2210,3860,20
PAKWACH,2016,1730,2300,4030,20
PAKWACH,2017,1800,2380,4180,20
PAKWACH,2018,1870,2470,4340,20
PAKWACH,2019,1950,2550,4500,20
PAKWACH,2020,2030,2640,4670,20
PAKWACH,2021,2110,2730,4840,20
PAKWACH,2022,2190,2820,5010,20
PAKWACH,2023,2270,2920,5190,20
PAKWACH,2024,2360,3010,5370,20
PAKWACH,2025,2440,3110,5550,20
PALLISA,2015,2810,3110,5920,20
PALLISA,2016,2990,3220,6210,20
PALLISA,2017,3200,3350,6550,20
PALLISA,2018,3420,3520,6940,20
PALLISA,2019,3650,3710,7360,20
PALLISA,2020,3900,3910,7810,20
PALLISA,2021,4130,4110,8240,20
PALLISA,2022,4350,4280,8630,20
PALLISA,2023,4540,4420,8960,20
PALLISA,2024,4710,4530,9240,20
PALLISA,2025,4870,4640,9510,20
RAKAI,2015,2160,2450,4610,20
RAKAI,2016,2260,2480,4740,20
RAKAI,2017,2370,2530,4900,20
RAKAI,2018,2480,2610,5090,20
RAKAI,2019,2600,2690,5290,20
RAKAI,2020,2730,2790,5520,20
RAKAI,2021,2830,2870,5700,20
RAKAI,2022,2930,2930,5860,20
RAKAI,2023,3010,2960,5970,20
RAKAI,2024,3050,2980,6030,20
RAKAI,2025,3100,3000,6100,20
RUBANDA,2015,1930,2490,4420,20
RUBANDA,2016,1960,2510,4470,20
RUBANDA,2017,1980,2530,4510,20
RUBANDA,2018,2010,2550,4560,20
RUBANDA,2019,2030,2570,4600,20
RUBANDA,2020,2060,2580,4640,20
RUBANDA,2021,2080,2600,4680,20
RUBANDA,2022,2100,2620,4720,20
RUBANDA,2023,2120,2630,4750,20
RUBANDA,2024,2140,2640,4780,20
RUBANDA,2025,2160,2650,4810,20
RUBIRIZI,2015,1260,1470,2730,20
RUBIRIZI,2016,1290,1500,2790,20
RUBIRIZI,2017,1310,1530,2840,20
RUBIRIZI,2018,1340,1560,2900,20
RUBIRIZI,2019,1360,1590,2950,20
RUBIRIZI,2020,1390,1620,3010,20
RUBIRIZI,2021,1410,1640,3050,20
RUBIRIZI,2022,1440,1670,3110,20
RUBIRIZI,2023,1460,1700,3160,20
RUBIRIZI,2024,1490,1720,3210,20
RUBIRIZI,2025,1510,1750,3260,20
RUKIGA,2015,1030,1170,2200,20
RUKIGA,2016,1040,1180,2220,20
RUKIGA,2017,1050,1190,2240,20
RUKIGA,2018,1060,1200,2260,20
RUKIGA,2019,1070,1210,2280,20
RUKIGA,2020,1080,1210,2290,20
RUKIGA,2021,1090,1220,2310,20
RUKIGA,2022,1090,1230,2320,20
RUKIGA,2023,1100,1230,2330,20
RUKIGA,2024,1110,1230,2340,20
RUKIGA,2025,1110,1240,2350,20
RUKUNGIRI,2015,3350,3690,7040,20
RUKUNGIRI,2016,3390,3730,7120,20
RUKUNGIRI,2017,3430,3770,7200,20
RUKUNGIRI,2018,3470,3800,7270,20
RUKUNGIRI,2019,3510,3830,7340,20
RUKUNGIRI,2020,3550,3870,7420,20
RUKUNGIRI,2021,3580,3900,7480,20
RUKUNGIRI,2022,3610,3920,7530,20
RUKUNGIRI,2023,3640,3950,7590,20
RUKUNGIRI,2024,3670,3970,7640,20
RUKUNGIRI,2025,3700,3990,7690,20
RWAMPARA,2015,1340,1520,2860,20
RWAMPARA,2016,1370,1560,2930,20
RWAMPARA,2017,1400,1590,2990,20
RWAMPARA,2018,1430,1630,3060,20
RWAMPARA,2019,1460,1660,3120,20
RWAMPARA,2020,1490,1690,3180,20
RWAMPARA,2021,1520,1720,3240,20
RWAMPARA,2022,1550,1760,3310,20
RWAMPARA,2023,1580,1790,3370,20
RWAMPARA,2024,1610,1830,3440,20
RWAMPARA,2025,1640,1860,3500,20
SERERE,2015,2690,2900,5590,20
SERERE,2016,2870,2990,5860,20
SERERE,2017,3050,3090,6140,20
SERERE,2018,3250,3240,6490,20
SERERE,2019,3450,3410,6860,20
SERERE,2020,3670,3580,7250,20
SERERE,2021,3880,3750,7630,20
SERERE,2022,4070,3890,7960,20
SERERE,2023,4230,4000,8230,20
SERERE,2024,4370,4090,8460,20
SERERE,2025,4500,4170,8670,20
SHEEMA,2015,2340,2570,4910,20
SHEEMA,2016,2370,2600,4970,20
SHEEMA,2017,2400,2630,5030,20
SHEEMA,2018,2430,2650,5080,20
SHEEMA,2019,2450,2680,5130,20
SHEEMA,2020,2480,2700,5180,20
SHEEMA,2021,2510,2730,5240,20
SHEEMA,2022,2530,2750,5280,20
SHEEMA,2023,2550,2770,5320,20
SHEEMA,2024,2570,2790,5360,20
SHEEMA,2025,2590,2800,5390,20
SIRONKO,2015,2590,2540,5130,20
SIRONKO,2016,2650,2590,5240,20
SIRONKO,2017,2710,2650,5360,20
SIRONKO,2018,2780,2700,5480,20
SIRONKO,2019,2840,2750,5590,20
SIRONKO,2020,2900,2800,5700,20
SIRONKO,2021,2970,2860,5830,20
SIRONKO,2022,3030,2910,5940,20
SIRONKO,2023,3090,2960,6050,20
SIRONKO,2024,3150,3000,6150,20
SIRONKO,2025,3210,3050,6260,20
SOROTI,2015,3010,3420,6430,20
SOROTI,2016,3200,3510,6710,20
SOROTI,2017,3390,3630,7020,20
SOROTI,2018,3580,3770,7350,20
SOROTI,2019,3800,3950,7750,20
SOROTI,2020,4010,4140,8150,20
SOROTI,2021,4230,4300,8530,20
SOROTI,2022,4410,4450,8860,20
SOROTI,2023,4570,4560,9130,20
SOROTI,2024,4700,4640,9340,20
SOROTI,2025,4820,4710,9530,20
SSEMBABULE,2015,2150,2270,4420,20
SSEMBABULE,2016,2260,2310,4570,20
SSEMBABULE,2017,2370,2360,4730,20
SSEMBABULE,2018,2500,2450,4950,20
SSEMBABULE,2019,2630,2540,5170,20
SSEMBABULE,2020,2760,2640,5400,20
SSEMBABULE,2021,2880,2720,5600,20
SSEMBABULE,2022,2990,2790,5780,20
SSEMBABULE,2023,3080,2830,5910,20
SSEMBABULE,2024,3140,2860,6000,20
SSEMBABULE,2025,3190,2880,6070,20
TORORO,2015,5320,6110,11430,20
TORORO,2016,5460,6260,11720,20
TORORO,2017,5600,6420,12020,20
TORORO,2018,5750,6570,12320,20
TORORO,2019,5900,6730,12630,20
TORORO,2020,6050,6890,12940,20
TORORO,2021,6190,7050,13240,20
TORORO,2022,6340,7210,13550,20
TORORO,2023,6490,7360,13850,20
TORORO,2024,6630,7520,14150,20
TORORO,2025,6770,7670,14440,20
WAKISO,2015,24310,36830,61140,20
WAKISO,2016,25940,39340,65280,20
WAKISO,2017,27680,42050,69730,20
WAKISO,2018,29510,44890,74400,20
WAKISO,2019,31470,47900,79370,20
WAKISO,2020,33520,51090,84610,20
WAKISO,2021,35680,54480,90160,20
WAKISO,2022,37970,58070,96040,20
WAKISO,2023,40370,61800,102170,20
WAKISO,2024,42890,65740,108630,20
WAKISO,2025,45530,69920,115450,20
YUMBE,2015,4460,5030,9490,20
YUMBE,2016,4800,5280,10080,20
YUMBE,2017,5150,5590,10740,20
YUMBE,2018,5540,5950,11490,20
YUMBE,2019,5950,6370,12320,20
YUMBE,2020,6380,6830,13210,20
YUMBE,2021,6820,7270,14090,20
YUMBE,2022,7230,7700,14930,20
YUMBE,2023,7590,8070,15660,20
YUMBE,2024,7920,8410,16330,20
YUMBE,2025,8230,8730,16960,20
ZOMBO,2015,2110,2970,5080,20
ZOMBO,2016,2170,3050,5220,20
ZOMBO,2017,2240,3130,5370,20
ZOMBO,2018,2310,3220,5530,20
ZOMBO,2019,2370,3310,5680,20
ZOMBO,2020,2440,3400,5840,20
ZOMBO,2021,2510,3480,5990,20
ZOMBO,2022,2580,3570,6150,20
ZOMBO,2023,2650,3660,6310,20
ZOMBO,2024,2720,3750,6470,20
ZOMBO,2025,2790,3830,6620,20
MADI OKOLLO,2015,1540,1920,3460,20
MADI OKOLLO,2016,1590,1980,3570,20
MADI OKOLLO,2017,1640,2030,3670,20
MADI OKOLLO,2018,1680,2090,3770,20
MADI OKOLLO,2019,1730,2140,3870,20
MADI OKOLLO,2020,1780,2190,3970,20
MADI OKOLLO,2021,1820,2250,4070,20
MADI OKOLLO,2022,1870,2310,4180,20
MADI OKOLLO,2023,1920,2360,4280,20
MADI OKOLLO,2024,1970,2410,4380,20
MADI OKOLLO,2025,2010,2470,4480,20
ABIM,2015,940,1060,2000,21
ABIM,2016,1030,1120,2150,21
ABIM,2017,1110,1170,2280,21
ABIM,2018,1210,1250,2460,21
ABIM,2019,1320,1320,2640,21
ABIM,2020,1430,1420,2850,21
ABIM,2021,1550,1520,3070,21
ABIM,2022,1670,1630,3300,21
ABIM,2023,1800,1720,3520,21
ABIM,2024,1910,1810,3720,21
ABIM,2025,2010,1890,3900,21
ADJUMANI,2015,1490,1770,3260,21
ADJUMANI,2016,1510,1790,3300,21
ADJUMANI,2017,1520,1810,3330,21
ADJUMANI,2018,1530,1830,3360,21
ADJUMANI,2019,1540,1840,3380,21
ADJUMANI,2020,1550,1860,3410,21
ADJUMANI,2021,1550,1870,3420,21
ADJUMANI,2022,1560,1890,3450,21
ADJUMANI,2023,1570,1900,3470,21
ADJUMANI,2024,1570,1910,3480,21
ADJUMANI,2025,1570,1920,3490,21
AGAGO,2015,1470,1800,3270,21
AGAGO,2016,1490,1830,3320,21
AGAGO,2017,1520,1860,3380,21
AGAGO,2018,1540,1900,3440,21
AGAGO,2019,1570,1930,3500,21
AGAGO,2020,1600,1960,3560,21
AGAGO,2021,1620,1990,3610,21
AGAGO,2022,1640,2020,3660,21
AGAGO,2023,1670,2050,3720,21
AGAGO,2024,1690,2080,3770,21
AGAGO,2025,1710,2100,3810,21
ALEBTONG,2015,1950,2160,4110,21
ALEBTONG,2016,2050,2190,4240,21
ALEBTONG,2017,2160,2230,4390,21
ALEBTONG,2018,2270,2290,4560,21
ALEBTONG,2019,2380,2360,4740,21
ALEBTONG,2020,2500,2460,4960,21
ALEBTONG,2021,2620,2550,5170,21
ALEBTONG,2022,2730,2630,5360,21
ALEBTONG,2023,2830,2700,5530,21
ALEBTONG,2024,2910,2740,5650,21
ALEBTONG,2025,2970,2760,5730,21
AMOLATAR,2015,1480,1620,3100,21
AMOLATAR,2016,1550,1650,3200,21
AMOLATAR,2017,1620,1670,3290,21
AMOLATAR,2018,1710,1710,3420,21
AMOLATAR,2019,1790,1760,3550,21
AMOLATAR,2020,1880,1830,3710,21
AMOLATAR,2021,1960,1890,3850,21
AMOLATAR,2022,2040,1950,3990,21
AMOLATAR,2023,2120,1990,4110,21
AMOLATAR,2024,2160,2010,4170,21
AMOLATAR,2025,2200,2040,4240,21
AMUDAT,2015,660,770,1430,21
AMUDAT,2016,710,800,1510,21
AMUDAT,2017,750,820,1570,21
AMUDAT,2018,800,860,1660,21
AMUDAT,2019,850,910,1760,21
AMUDAT,2020,900,960,1860,21
AMUDAT,2021,960,1020,1980,21
AMUDAT,2022,1010,1070,2080,21
AMUDAT,2023,1060,1110,2170,21
AMUDAT,2024,1090,1150,2240,21
AMUDAT,2025,1130,1180,2310,21
AMURIA,2015,1550,1600,3150,21
AMURIA,2016,1670,1640,3310,21
AMURIA,2017,1770,1690,3460,21
AMURIA,2018,1890,1750,3640,21
AMURIA,2019,2020,1830,3850,21
AMURIA,2020,2160,1920,4080,21
AMURIA,2021,2290,2020,4310,21
AMURIA,2022,2420,2110,4530,21
AMURIA,2023,2550,2190,4740,21
AMURIA,2024,2640,2240,4880,21
AMURIA,2025,2730,2280,5010,21
AMURU,2015,1590,1830,3420,21
AMURU,2016,1680,1860,3540,21
AMURU,2017,1760,1890,3650,21
AMURU,2018,1840,1930,3770,21
AMURU,2019,1940,2000,3940,21
AMURU,2020,2030,2070,4100,21
AMURU,2021,2120,2150,4270,21
AMURU,2022,2210,2210,4420,21
AMURU,2023,2290,2280,4570,21
AMURU,2024,2340,2310,4650,21
AMURU,2025,2380,2330,4710,21
APAC,2015,1540,1800,3340,21
APAC,2016,1600,1860,3460,21
APAC,2017,1660,1930,3590,21
APAC,2018,1720,1990,3710,21
APAC,2019,1780,2060,3840,21
APAC,2020,1840,2130,3970,21
APAC,2021,1900,2200,4100,21
APAC,2022,1970,2270,4240,21
APAC,2023,2030,2340,4370,21
APAC,2024,2100,2410,4510,21
APAC,2025,2160,2480,4640,21
ARUA,2015,4650,5410,10060,21
ARUA,2016,4790,5560,10350,21
ARUA,2017,4920,5710,10630,21
ARUA,2018,5060,5860,10920,21
ARUA,2019,5210,6020,11230,21
ARUA,2020,5350,6170,11520,21
ARUA,2021,5490,6330,11820,21
ARUA,2022,5630,6480,12110,21
ARUA,2023,5770,6640,12410,21
ARUA,2024,5920,6790,12710,21
ARUA,2025,6060,6940,13000,21
BUDAKA,2015,1690,2070,3760,21
BUDAKA,2016,1790,2110,3900,21
BUDAKA,2017,1890,2160,4050,21
BUDAKA,2018,2010,2230,4240,21
BUDAKA,2019,2120,2330,4450,21
BUDAKA,2020,2250,2420,4670,21
BUDAKA,2021,2370,2540,4910,21
BUDAKA,2022,2490,2640,5130,21
BUDAKA,2023,2600,2720,5320,21
BUDAKA,2024,2690,2790,5480,21
BUDAKA,2025,2770,2830,5600,21
BUDUDA,2015,1780,1940,3720,21
BUDUDA,2016,1900,2000,3900,21
BUDUDA,2017,2030,2070,4100,21
BUDUDA,2018,2180,2160,4340,21
BUDUDA,2019,2320,2270,4590,21
BUDUDA,2020,2480,2400,4880,21
BUDUDA,2021,2650,2530,5180,21
BUDUDA,2022,2800,2650,5450,21
BUDUDA,2023,2950,2780,5730,21
BUDUDA,2024,3080,2870,5950,21
BUDUDA,2025,3200,2940,6140,21
BUGIRI,2015,3280,3840,7120,21
BUGIRI,2016,3500,3950,7450,21
BUGIRI,2017,3720,4070,7790,21
BUGIRI,2018,3960,4220,8180,21
BUGIRI,2019,4200,4410,8610,21
BUGIRI,2020,4470,4630,9100,21
BUGIRI,2021,4750,4850,9600,21
BUGIRI,2022,5010,5070,10080,21
BUGIRI,2023,5270,5260,10530,21
BUGIRI,2024,5460,5420,10880,21
BUGIRI,2025,5640,5530,11170,21
BUGWERI,2015,1240,1590,2830,21
BUGWERI,2016,1300,1610,2910,21
BUGWERI,2017,1370,1640,3010,21
BUGWERI,2018,1440,1670,3110,21
BUGWERI,2019,1510,1730,3240,21
BUGWERI,2020,1580,1780,3360,21
BUGWERI,2021,1660,1850,3510,21
BUGWERI,2022,1730,1900,3630,21
BUGWERI,2023,1790,1960,3750,21
BUGWERI,2024,1830,1990,3820,21
BUGWERI,2025,1870,2000,3870,21
BUHWEJU,2015,950,1080,2030,21
BUHWEJU,2016,980,1120,2100,21
BUHWEJU,2017,1010,1150,2160,21
BUHWEJU,2018,1040,1190,2230,21
BUHWEJU,2019,1080,1220,2300,21
BUHWEJU,2020,1110,1260,2370,21
BUHWEJU,2021,1140,1290,2430,21
BUHWEJU,2022,1180,1330,2510,21
BUHWEJU,2023,1210,1360,2570,21
BUHWEJU,2024,1250,1400,2650,21
BUHWEJU,2025,1280,1440,2720,21
BUIKWE,2015,3750,4410,8160,21
BUIKWE,2016,3920,4450,8370,21
BUIKWE,2017,4080,4500,8580,21
BUIKWE,2018,4260,4570,8830,21
BUIKWE,2019,4440,4700,9140,21
BUIKWE,2020,4620,4850,9470,21
BUIKWE,2021,4800,4990,9790,21
BUIKWE,2022,4990,5120,10110,21
BUIKWE,2023,5120,5220,10340,21
BUIKWE,2024,5220,5270,10490,21
BUIKWE,2025,5280,5280,10560,21
BUKEDEA,2015,1840,1890,3730,21
BUKEDEA,2016,1970,1950,3920,21
BUKEDEA,2017,2100,2020,4120,21
BUKEDEA,2018,2230,2090,4320,21
BUKEDEA,2019,2390,2190,4580,21
BUKEDEA,2020,2550,2310,4860,21
BUKEDEA,2021,2720,2420,5140,21
BUKEDEA,2022,2880,2540,5420,21
BUKEDEA,2023,3030,2640,5670,21
BUKEDEA,2024,3150,2710,5860,21
BUKEDEA,2025,3270,2780,6050,21
BUKOMANSIMBI,2015,960,1110,2070,21
BUKOMANSIMBI,2016,990,1100,2090,21
BUKOMANSIMBI,2017,1010,1100,2110,21
BUKOMANSIMBI,2018,1040,1100,2140,21
BUKOMANSIMBI,2019,1070,1110,2180,21
BUKOMANSIMBI,2020,1100,1130,2230,21
BUKOMANSIMBI,2021,1140,1150,2290,21
BUKOMANSIMBI,2022,1160,1150,2310,21
BUKOMANSIMBI,2023,1190,1160,2350,21
BUKOMANSIMBI,2024,1190,1150,2340,21
BUKOMANSIMBI,2025,1190,1140,2330,21
BUKWO,2015,740,820,1560,21
BUKWO,2016,780,870,1650,21
BUKWO,2017,820,910,1730,21
BUKWO,2018,860,950,1810,21
BUKWO,2019,910,1000,1910,21
BUKWO,2020,950,1040,1990,21
BUKWO,2021,1000,1090,2090,21
BUKWO,2022,1050,1140,2190,21
BUKWO,2023,1110,1200,2310,21
BUKWO,2024,1160,1250,2410,21
BUKWO,2025,1220,1300,2520,21
BULAMBULI,2015,1540,1570,3110,21
BULAMBULI,2016,1650,1630,3280,21
BULAMBULI,2017,1780,1700,3480,21
BULAMBULI,2018,1910,1770,3680,21
BULAMBULI,2019,2040,1870,3910,21
BULAMBULI,2020,2180,1980,4160,21
BULAMBULI,2021,2340,2100,4440,21
BULAMBULI,2022,2490,2210,4700,21
BULAMBULI,2023,2630,2330,4960,21
BULAMBULI,2024,2770,2410,5180,21
BULAMBULI,2025,2870,2480,5350,21
BULIISA,2015,1060,920,1980,21
BULIISA,2016,1110,970,2080,21
BULIISA,2017,1180,1010,2190,21
BULIISA,2018,1240,1050,2290,21
BULIISA,2019,1300,1100,2400,21
BULIISA,2020,1370,1140,2510,21
BULIISA,2021,1440,1190,2630,21
BULIISA,2022,1520,1240,2760,21
BULIISA,2023,1590,1290,2880,21
BULIISA,2024,1670,1350,3020,21
BULIISA,2025,1750,1400,3150,21
BUNDIBUGYO,2015,1670,1930,3600,21
BUNDIBUGYO,2016,1750,1950,3700,21
BUNDIBUGYO,2017,1840,1990,3830,21
BUNDIBUGYO,2018,1940,2030,3970,21
BUNDIBUGYO,2019,2040,2110,4150,21
BUNDIBUGYO,2020,2160,2190,4350,21
BUNDIBUGYO,2021,2260,2270,4530,21
BUNDIBUGYO,2022,2370,2340,4710,21
BUNDIBUGYO,2023,2450,2410,4860,21
BUNDIBUGYO,2024,2520,2440,4960,21
BUNDIBUGYO,2025,2570,2470,5040,21
BUNYANGABU,2015,1410,1470,2880,21
BUNYANGABU,2016,1480,1480,2960,21
BUNYANGABU,2017,1550,1500,3050,21
BUNYANGABU,2018,1620,1530,3150,21
BUNYANGABU,2019,1700,1580,3280,21
BUNYANGABU,2020,1790,1630,3420,21
BUNYANGABU,2021,1870,1690,3560,21
BUNYANGABU,2022,1940,1730,3670,21
BUNYANGABU,2023,2000,1770,3770,21
BUNYANGABU,2024,2050,1790,3840,21
BUNYANGABU,2025,2080,1790,3870,21
BUSHENYI,2015,2010,2240,4250,21
BUSHENYI,2016,2040,2260,4300,21
BUSHENYI,2017,2060,2290,4350,21
BUSHENYI,2018,2090,2310,4400,21
BUSHENYI,2019,2110,2320,4430,21
BUSHENYI,2020,2130,2340,4470,21
BUSHENYI,2021,2160,2360,4520,21
BUSHENYI,2022,2180,2370,4550,21
BUSHENYI,2023,2200,2390,4590,21
BUSHENYI,2024,2210,2400,4610,21
BUSHENYI,2025,2230,2410,4640,21
BUSIA,2015,3050,3620,6670,21
BUSIA,2016,3220,3680,6900,21
BUSIA,2017,3400,3760,7160,21
BUSIA,2018,3580,3850,7430,21
BUSIA,2019,3780,3980,7760,21
BUSIA,2020,3970,4150,8120,21
BUSIA,2021,4180,4310,8490,21
BUSIA,2022,4380,4460,8840,21
BUSIA,2023,4550,4580,9130,21
BUSIA,2024,4690,4670,9360,21
BUSIA,2025,4800,4720,9520,21
BUTALEJA,2015,2230,2580,4810,21
BUTALEJA,2016,2370,2650,5020,21
BUTALEJA,2017,2510,2710,5220,21
BUTALEJA,2018,2650,2800,5450,21
BUTALEJA,2019,2820,2910,5730,21
BUTALEJA,2020,2990,3050,6040,21
BUTALEJA,2021,3160,3200,6360,21
BUTALEJA,2022,3330,3320,6650,21
BUTALEJA,2023,3480,3440,6920,21
BUTALEJA,2024,3600,3520,7120,21
BUTALEJA,2025,3710,3580,7290,21
BUTAMBALA,2015,630,760,1390,21
BUTAMBALA,2016,650,760,1410,21
BUTAMBALA,2017,660,760,1420,21
BUTAMBALA,2018,690,770,1460,21
BUTAMBALA,2019,720,780,1500,21
BUTAMBALA,2020,740,790,1530,21
BUTAMBALA,2021,770,810,1580,21
BUTAMBALA,2022,790,820,1610,21
BUTAMBALA,2023,800,840,1640,21
BUTAMBALA,2024,820,830,1650,21
BUTAMBALA,2025,810,830,1640,21
BUTEBO,2015,960,1040,2000,21
BUTEBO,2016,990,1040,2030,21
BUTEBO,2017,1040,1040,2080,21
BUTEBO,2018,1070,1050,2120,21
BUTEBO,2019,1110,1070,2180,21
BUTEBO,2020,1150,1100,2250,21
BUTEBO,2021,1200,1130,2330,21
BUTEBO,2022,1230,1150,2380,21
BUTEBO,2023,1260,1170,2430,21
BUTEBO,2024,1280,1160,2440,21
BUTEBO,2025,1280,1160,2440,21
BUVUMA,2015,800,870,1670,21
BUVUMA,2016,850,930,1780,21
BUVUMA,2017,900,1000,1900,21
BUVUMA,2018,950,1060,2010,21
BUVUMA,2019,1010,1140,2150,21
BUVUMA,2020,1070,1210,2280,21
BUVUMA,2021,1140,1290,2430,21
BUVUMA,2022,1200,1370,2570,21
BUVUMA,2023,1270,1460,2730,21
BUVUMA,2024,1350,1550,2900,21
BUVUMA,2025,1420,1650,3070,21
BUYENDE,2015,2680,3170,5850,21
BUYENDE,2016,2870,3270,6140,21
BUYENDE,2017,3070,3380,6450,21
BUYENDE,2018,3260,3510,6770,21
BUYENDE,2019,3500,3680,7180,21
BUYENDE,2020,3720,3890,7610,21
BUYENDE,2021,3970,4100,8070,21
BUYENDE,2022,4210,4300,8510,21
BUYENDE,2023,4440,4490,8930,21
BUYENDE,2024,4620,4620,9240,21
BUYENDE,2025,4800,4740,9540,21
DOKOLO,2015,1340,1600,2940,21
DOKOLO,2016,1380,1650,3030,21
DOKOLO,2017,1420,1690,3110,21
DOKOLO,2018,1470,1740,3210,21
DOKOLO,2019,1510,1790,3300,21
DOKOLO,2020,1550,1830,3380,21
DOKOLO,2021,1600,1880,3480,21
DOKOLO,2022,1640,1930,3570,21
DOKOLO,2023,1680,1970,3650,21
DOKOLO,2024,1730,2020,3750,21
DOKOLO,2025,1770,2070,3840,21
GOMBA,2015,1270,1220,2490,21
GOMBA,2016,1330,1210,2540,21
GOMBA,2017,1380,1210,2590,21
GOMBA,2018,1440,1230,2670,21
GOMBA,2019,1490,1260,2750,21
GOMBA,2020,1550,1280,2830,21
GOMBA,2021,1600,1310,2910,21
GOMBA,2022,1660,1330,2990,21
GOMBA,2023,1700,1350,3050,21
GOMBA,2024,1720,1350,3070,21
GOMBA,2025,1740,1350,3090,21
GULU,2015,2470,3030,5500,21
GULU,2016,2540,3120,5660,21
GULU,2017,2620,3210,5830,21
GULU,2018,2690,3300,5990,21
GULU,2019,2770,3390,6160,21
GULU,2020,2850,3480,6330,21
GULU,2021,2930,3580,6510,21
GULU,2022,3010,3670,6680,21
GULU,2023,3090,3770,6860,21
GULU,2024,3170,3860,7030,21
GULU,2025,3250,3960,7210,21
HOIMA,2015,2600,3030,5630,21
HOIMA,2016,2700,3140,5840,21
HOIMA,2017,2800,3240,6040,21
HOIMA,2018,2910,3360,6270,21
HOIMA,2019,3010,3470,6480,21
HOIMA,2020,3120,3590,6710,21
HOIMA,2021,3230,3700,6930,21
HOIMA,2022,3340,3820,7160,21
HOIMA,2023,3460,3940,7400,21
HOIMA,2024,3570,4060,7630,21
HOIMA,2025,3690,4180,7870,21
IBANDA,2015,1990,2180,4170,21
IBANDA,2016,2030,2220,4250,21
IBANDA,2017,2060,2260,4320,21
IBANDA,2018,2110,2300,4410,21
IBANDA,2019,2150,2340,4490,21
IBANDA,2020,2180,2380,4560,21
IBANDA,2021,2220,2420,4640,21
IBANDA,2022,2260,2460,4720,21
IBANDA,2023,2300,2490,4790,21
IBANDA,2024,2330,2530,4860,21
IBANDA,2025,2360,2560,4920,21
IGANGA,2015,3030,3810,6840,21
IGANGA,2016,3200,3880,7080,21
IGANGA,2017,3360,3950,7310,21
IGANGA,2018,3550,4060,7610,21
IGANGA,2019,3740,4200,7940,21
IGANGA,2020,3940,4370,8310,21
IGANGA,2021,4150,4550,8700,21
IGANGA,2022,4330,4700,9030,21
IGANGA,2023,4510,4830,9340,21
IGANGA,2024,4640,4920,9560,21
IGANGA,2025,4750,4970,9720,21
ISINGIRO,2015,3250,3970,7220,21
ISINGIRO,2016,3370,4110,7480,21
ISINGIRO,2017,3500,4260,7760,21
ISINGIRO,2018,3630,4410,8040,21
ISINGIRO,2019,3760,4560,8320,21
ISINGIRO,2020,3890,4710,8600,21
ISINGIRO,2021,4030,4870,8900,21
ISINGIRO,2022,4170,5030,9200,21
ISINGIRO,2023,4310,5190,9500,21
ISINGIRO,2024,4450,5350,9800,21
ISINGIRO,2025,4590,5510,10100,21
JINJA,2015,4150,5040,9190,21
JINJA,2016,4220,5120,9340,21
JINJA,2017,4300,5200,9500,21
JINJA,2018,4360,5280,9640,21
JINJA,2019,4430,5350,9780,21
JINJA,2020,4500,5430,9930,21
JINJA,2021,4570,5500,10070,21
JINJA,2022,4630,5570,10200,21
JINJA,2023,4690,5640,10330,21
JINJA,2024,4750,5700,10450,21
JINJA,2025,4800,5760,10560,21
KAABONG,2015,610,990,1600,21
KAABONG,2016,630,1020,1650,21
KAABONG,2017,650,1040,1690,21
KAABONG,2018,660,1070,1730,21
KAABONG,2019,680,1090,1770,21
KAABONG,2020,700,1120,1820,21
KAABONG,2021,720,1140,1860,21
KAABONG,2022,740,1170,1910,21
KAABONG,2023,750,1190,1940,21
KAABONG,2024,770,1210,1980,21
KAABONG,2025,790,1240,2030,21
KABALE,2015,1850,2320,4170,21
KABALE,2016,1880,2350,4230,21
KABALE,2017,1910,2380,4290,21
KABALE,2018,1940,2400,4340,21
KABALE,2019,1970,2430,4400,21
KABALE,2020,2000,2460,4460,21
KABALE,2021,2020,2480,4500,21
KABALE,2022,2050,2500,4550,21
KABALE,2023,2070,2520,4590,21
KABALE,2024,2100,2540,4640,21
KABALE,2025,2120,2560,4680,21
KABAROLE,2015,2510,2700,5210,21
KABAROLE,2016,2570,2750,5320,21
KABAROLE,2017,2630,2810,5440,21
KABAROLE,2018,2680,2870,5550,21
KABAROLE,2019,2740,2930,5670,21
KABAROLE,2020,2790,2990,5780,21
KABAROLE,2021,2850,3050,5900,21
KABAROLE,2022,2910,3110,6020,21
KABAROLE,2023,2960,3170,6130,21
KABAROLE,2024,3010,3220,6230,21
KABAROLE,2025,3060,3280,6340,21
KABERAMAIDO,2015,1040,980,2020,21
KABERAMAIDO,2016,1120,1000,2120,21
KABERAMAIDO,2017,1180,1040,2220,21
KABERAMAIDO,2018,1250,1090,2340,21
KABERAMAIDO,2019,1350,1130,2480,21
KABERAMAIDO,2020,1430,1190,2620,21
KABERAMAIDO,2021,1520,1250,2770,21
KABERAMAIDO,2022,1610,1310,2920,21
KABERAMAIDO,2023,1690,1350,3040,21
KABERAMAIDO,2024,1760,1390,3150,21
KABERAMAIDO,2025,1810,1420,3230,21
KAGADI,2015,2530,2900,5430,21
KAGADI,2016,2620,3010,5630,21
KAGADI,2017,2720,3110,5830,21
KAGADI,2018,2820,3220,6040,21
KAGADI,2019,2920,3330,6250,21
KAGADI,2020,3030,3450,6480,21
KAGADI,2021,3130,3560,6690,21
KAGADI,2022,3240,3680,6920,21
KAGADI,2023,3350,3790,7140,21
KAGADI,2024,3460,3910,7370,21
KAGADI,2025,3570,4030,7600,21
KAKUMIRO,2015,2350,2660,5010,21
KAKUMIRO,2016,2560,2880,5440,21
KAKUMIRO,2017,2790,3120,5910,21
KAKUMIRO,2018,3030,3390,6420,21
KAKUMIRO,2019,3300,3670,6970,21
KAKUMIRO,2020,3580,3970,7550,21
KAKUMIRO,2021,3890,4300,8190,21
KAKUMIRO,2022,4220,4650,8870,21
KAKUMIRO,2023,4580,5020,9600,21
KAKUMIRO,2024,4960,5420,10380,21
KAKUMIRO,2025,5370,5850,11220,21
KALAKI,2015,810,880,1690,21
KALAKI,2016,840,920,1760,21
KALAKI,2017,880,950,1830,21
KALAKI,2018,920,990,1910,21
KALAKI,2019,950,1030,1980,21
KALAKI,2020,990,1070,2060,21
KALAKI,2021,1040,1110,2150,21
KALAKI,2022,1080,1150,2230,21
KALAKI,2023,1120,1190,2310,21
KALAKI,2024,1160,1230,2390,21
KALAKI,2025,1210,1270,2480,21
KALANGALA,2015,560,530,1090,21
KALANGALA,2016,580,550,1130,21
KALANGALA,2017,600,570,1170,21
KALANGALA,2018,620,590,1210,21
KALANGALA,2019,640,620,1260,21
KALANGALA,2020,670,640,1310,21
KALANGALA,2021,690,670,1360,21
KALANGALA,2022,710,690,1400,21
KALANGALA,2023,730,720,1450,21
KALANGALA,2024,750,750,1500,21
KALANGALA,2025,780,780,1560,21
KALIRO,2015,1950,2240,4190,21
KALIRO,2016,2070,2300,4370,21
KALIRO,2017,2190,2350,4540,21
KALIRO,2018,2310,2420,4730,21
KALIRO,2019,2460,2530,4990,21
KALIRO,2020,2590,2650,5240,21
KALIRO,2021,2740,2760,5500,21
KALIRO,2022,2880,2880,5760,21
KALIRO,2023,3000,2970,5970,21
KALIRO,2024,3110,3050,6160,21
KALIRO,2025,3180,3100,6280,21
KALUNGU,2015,1260,1430,2690,21
KALUNGU,2016,1300,1420,2720,21
KALUNGU,2017,1350,1420,2770,21
KALUNGU,2018,1400,1430,2830,21
KALUNGU,2019,1440,1450,2890,21
KALUNGU,2020,1490,1480,2970,21
KALUNGU,2021,1530,1510,3040,21
KALUNGU,2022,1570,1540,3110,21
KALUNGU,2023,1600,1550,3150,21
KALUNGU,2024,1620,1550,3170,21
KALUNGU,2025,1630,1530,3160,21
KAMPALA,2015,18140,25680,43820,21
KAMPALA,2016,18510,26190,44700,21
KAMPALA,2017,18870,26690,45560,21
KAMPALA,2018,19240,27200,46440,21
KAMPALA,2019,19600,27700,47300,21
KAMPALA,2020,19950,28200,48150,21
KAMPALA,2021,20310,28690,49000,21
KAMPALA,2022,20650,29170,49820,21
KAMPALA,2023,20980,29640,50620,21
KAMPALA,2024,21300,30090,51390,21
KAMPALA,2025,21610,30530,52140,21
KAMULI,2015,4170,4770,8940,21
KAMULI,2016,4390,4820,9210,21
KAMULI,2017,4590,4890,9480,21
KAMULI,2018,4820,4980,9800,21
KAMULI,2019,5050,5140,10190,21
KAMULI,2020,5290,5300,10590,21
KAMULI,2021,5540,5490,11030,21
KAMULI,2022,5770,5640,11410,21
KAMULI,2023,5970,5760,11730,21
KAMULI,2024,6110,5830,11940,21
KAMULI,2025,6210,5860,12070,21
KAMWENGE,2015,1870,2190,4060,21
KAMWENGE,2016,1950,2280,4230,21
KAMWENGE,2017,2030,2350,4380,21
KAMWENGE,2018,2110,2440,4550,21
KAMWENGE,2019,2200,2520,4720,21
KAMWENGE,2020,2280,2610,4890,21
KAMWENGE,2021,2370,2690,5060,21
KAMWENGE,2022,2460,2780,5240,21
KAMWENGE,2023,2550,2870,5420,21
KAMWENGE,2024,2640,2970,5610,21
KAMWENGE,2025,2730,3060,5790,21
KANUNGU,2015,1770,2150,3920,21
KANUNGU,2016,1800,2180,3980,21
KANUNGU,2017,1830,2220,4050,21
KANUNGU,2018,1870,2250,4120,21
KANUNGU,2019,1900,2290,4190,21
KANUNGU,2020,1930,2320,4250,21
KANUNGU,2021,1960,2350,4310,21
KANUNGU,2022,1990,2390,4380,21
KANUNGU,2023,2020,2420,4440,21
KANUNGU,2024,2050,2450,4500,21
KANUNGU,2025,2070,2470,4540,21
KAPCHORWA,2015,940,1010,1950,21
KAPCHORWA,2016,970,1040,2010,21
KAPCHORWA,2017,1000,1070,2070,21
KAPCHORWA,2018,1030,1090,2120,21
KAPCHORWA,2019,1060,1120,2180,21
KAPCHORWA,2020,1090,1150,2240,21
KAPCHORWA,2021,1120,1180,2300,21
KAPCHORWA,2022,1160,1210,2370,21
KAPCHORWA,2023,1190,1240,2430,21
KAPCHORWA,2024,1220,1270,2490,21
KAPCHORWA,2025,1250,1300,2550,21
KAPELEBYONG,2015,820,860,1680,21
KAPELEBYONG,2016,860,890,1750,21
KAPELEBYONG,2017,920,900,1820,21
KAPELEBYONG,2018,970,930,1900,21
KAPELEBYONG,2019,1010,960,1970,21
KAPELEBYONG,2020,1080,990,2070,21
KAPELEBYONG,2021,1130,1030,2160,21
KAPELEBYONG,2022,1180,1060,2240,21
KAPELEBYONG,2023,1230,1100,2330,21
KAPELEBYONG,2024,1260,1110,2370,21
KAPELEBYONG,2025,1300,1120,2420,21
KASESE,2015,5640,6710,12350,21
KASESE,2016,5910,6780,12690,21
KASESE,2017,6190,6860,13050,21
KASESE,2018,6470,7000,13470,21
KASESE,2019,6780,7200,13980,21
KASESE,2020,7090,7440,14530,21
KASESE,2021,7420,7690,15110,21
KASESE,2022,7710,7890,15600,21
KASESE,2023,7960,8060,16020,21
KASESE,2024,8140,8150,16290,21
KASESE,2025,8270,8200,16470,21
KASSANDA,2015,2110,2060,4170,21
KASSANDA,2016,2170,2100,4270,21
KASSANDA,2017,2230,2150,4380,21
KASSANDA,2018,2290,2190,4480,21
KASSANDA,2019,2360,2240,4600,21
KASSANDA,2020,2420,2280,4700,21
KASSANDA,2021,2480,2330,4810,21
KASSANDA,2022,2550,2370,4920,21
KASSANDA,2023,2610,2420,5030,21
KASSANDA,2024,2670,2460,5130,21
KASSANDA,2025,2730,2500,5230,21
KATAKWI,2015,1620,1600,3220,21
KATAKWI,2016,1700,1630,3330,21
KATAKWI,2017,1790,1650,3440,21
KATAKWI,2018,1880,1690,3570,21
KATAKWI,2019,1980,1750,3730,21
KATAKWI,2020,2090,1810,3900,21
KATAKWI,2021,2190,1880,4070,21
KATAKWI,2022,2280,1930,4210,21
KATAKWI,2023,2380,1980,4360,21
KATAKWI,2024,2440,2010,4450,21
KATAKWI,2025,2480,2030,4510,21
KAYUNGA,2015,2660,3170,5830,21
KAYUNGA,2016,2770,3180,5950,21
KAYUNGA,2017,2890,3210,6100,21
KAYUNGA,2018,3000,3250,6250,21
KAYUNGA,2019,3140,3330,6470,21
KAYUNGA,2020,3260,3420,6680,21
KAYUNGA,2021,3380,3510,6890,21
KAYUNGA,2022,3510,3580,7090,21
KAYUNGA,2023,3610,3640,7250,21
KAYUNGA,2024,3670,3660,7330,21
KAYUNGA,2025,3710,3670,7380,21
KAZO,2015,1350,1480,2830,21
KAZO,2016,1400,1530,2930,21
KAZO,2017,1460,1580,3040,21
KAZO,2018,1510,1640,3150,21
KAZO,2019,1570,1700,3270,21
KAZO,2020,1620,1760,3380,21
KAZO,2021,1680,1810,3490,21
KAZO,2022,1740,1870,3610,21
KAZO,2023,1800,1930,3730,21
KAZO,2024,1860,1990,3850,21
KAZO,2025,1920,2050,3970,21
KIBAALE,2015,1130,1240,2370,21
KIBAALE,2016,1200,1310,2510,21
KIBAALE,2017,1280,1390,2670,21
KIBAALE,2018,1360,1470,2830,21
KIBAALE,2019,1450,1550,3000,21
KIBAALE,2020,1530,1640,3170,21
KIBAALE,2021,1630,1730,3360,21
KIBAALE,2022,1730,1820,3550,21
KIBAALE,2023,1830,1920,3750,21
KIBAALE,2024,1940,2030,3970,21
KIBAALE,2025,2050,2140,4190,21
KIBOGA,2015,1500,1440,2940,21
KIBOGA,2016,1580,1460,3040,21
KIBOGA,2017,1650,1480,3130,21
KIBOGA,2018,1740,1510,3250,21
KIBOGA,2019,1820,1550,3370,21
KIBOGA,2020,1910,1610,3520,21
KIBOGA,2021,1990,1660,3650,21
KIBOGA,2022,2080,1710,3790,21
KIBOGA,2023,2150,1750,3900,21
KIBOGA,2024,2210,1780,3990,21
KIBOGA,2025,2240,1790,4030,21
KIBUKU,2015,1670,2120,3790,21
KIBUKU,2016,1770,2160,3930,21
KIBUKU,2017,1880,2220,4100,21
KIBUKU,2018,1980,2300,4280,21
KIBUKU,2019,2110,2400,4510,21
KIBUKU,2020,2240,2520,4760,21
KIBUKU,2021,2380,2630,5010,21
KIBUKU,2022,2510,2750,5260,21
KIBUKU,2023,2620,2850,5470,21
KIBUKU,2024,2720,2930,5650,21
KIBUKU,2025,2800,2990,5790,21
KIKUUBE,2015,2010,2240,4250,21
KIKUUBE,2016,2120,2360,4480,21
KIKUUBE,2017,2230,2480,4710,21
KIKUUBE,2018,2350,2610,4960,21
KIKUUBE,2019,2480,2740,5220,21
KIKUUBE,2020,2610,2870,5480,21
KIKUUBE,2021,2740,3010,5750,21
KIKUUBE,2022,2880,3160,6040,21
KIKUUBE,2023,3020,3310,6330,21
KIKUUBE,2024,3170,3460,6630,21
KIKUUBE,2025,3320,3620,6940,21
KIRUHURA,2015,1270,1270,2540,21
KIRUHURA,2016,1320,1320,2640,21
KIRUHURA,2017,1360,1360,2720,21
KIRUHURA,2018,1420,1410,2830,21
KIRUHURA,2019,1470,1460,2930,21
KIRUHURA,2020,1520,1510,3030,21
KIRUHURA,2021,1580,1560,3140,21
KIRUHURA,2022,1630,1610,3240,21
KIRUHURA,2023,1690,1660,3350,21
KIRUHURA,2024,1740,1710,3450,21
KIRUHURA,2025,1800,1760,3560,21
KIRYANDONGO,2015,2520,2660,5180,21
KIRYANDONGO,2016,2660,2700,5360,21
KIRYANDONGO,2017,2800,2760,5560,21
KIRYANDONGO,2018,2950,2820,5770,21
KIRYANDONGO,2019,3110,2910,6020,21
KIRYANDONGO,2020,3270,3030,6300,21
KIRYANDONGO,2021,3430,3150,6580,21
KIRYANDONGO,2022,3580,3250,6830,21
KIRYANDONGO,2023,3720,3330,7050,21
KIRYANDONGO,2024,3830,3390,7220,21
KIRYANDONGO,2025,3910,3420,7330,21
KISORO,2015,1520,2370,3890,21
KISORO,2016,1580,2400,3980,21
KISORO,2017,1650,2430,4080,21
KISORO,2018,1720,2470,4190,21
KISORO,2019,1790,2530,4320,21
KISORO,2020,1870,2610,4480,21
KISORO,2021,1940,2690,4630,21
KISORO,2022,2010,2760,4770,21
KISORO,2023,2060,2820,4880,21
KISORO,2024,2110,2830,4940,21
KISORO,2025,2130,2850,4980,21
KITAGWENDA,2015,950,1100,2050,21
KITAGWENDA,2016,990,1140,2130,21
KITAGWENDA,2017,1040,1180,2220,21
KITAGWENDA,2018,1080,1220,2300,21
KITAGWENDA,2019,1120,1260,2380,21
KITAGWENDA,2020,1160,1300,2460,21
KITAGWENDA,2021,1210,1350,2560,21
KITAGWENDA,2022,1250,1390,2640,21
KITAGWENDA,2023,1300,1440,2740,21
KITAGWENDA,2024,1350,1480,2830,21
KITAGWENDA,2025,1390,1530,2920,21
KITGUM,2015,1810,1970,3780,21
KITGUM,2016,1890,1990,3880,21
KITGUM,2017,1970,1990,3960,21
KITGUM,2018,2040,2020,4060,21
KITGUM,2019,2120,2060,4180,21
KITGUM,2020,2200,2120,4320,21
KITGUM,2021,2280,2180,4460,21
KITGUM,2022,2350,2230,4580,21
KITGUM,2023,2400,2250,4650,21
KITGUM,2024,2440,2280,4720,21
KITGUM,2025,2460,2270,4730,21
KOBOKO,2015,1830,1850,3680,21
KOBOKO,2016,1940,1890,3830,21
KOBOKO,2017,2070,1950,4020,21
KOBOKO,2018,2190,2020,4210,21
KOBOKO,2019,2340,2110,4450,21
KOBOKO,2020,2480,2210,4690,21
KOBOKO,2021,2630,2330,4960,21
KOBOKO,2022,2780,2430,5210,21
KOBOKO,2023,2920,2520,5440,21
KOBOKO,2024,3020,2580,5600,21
KOBOKO,2025,3110,2650,5760,21
KOLE,2015,1970,2220,4190,21
KOLE,2016,2040,2280,4320,21
KOLE,2017,2100,2350,4450,21
KOLE,2018,2170,2410,4580,21
KOLE,2019,2240,2480,4720,21
KOLE,2020,2310,2550,4860,21
KOLE,2021,2380,2620,5000,21
KOLE,2022,2450,2680,5130,21
KOLE,2023,2520,2750,5270,21
KOLE,2024,2590,2820,5410,21
KOLE,2025,2660,2890,5550,21
KOTIDO,2015,1270,1290,2560,21
KOTIDO,2016,1340,1310,2650,21
KOTIDO,2017,1410,1320,2730,21
KOTIDO,2018,1460,1340,2800,21
KOTIDO,2019,1540,1380,2920,21
KOTIDO,2020,1610,1420,3030,21
KOTIDO,2021,1690,1480,3170,21
KOTIDO,2022,1740,1510,3250,21
KOTIDO,2023,1800,1550,3350,21
KOTIDO,2024,1850,1560,3410,21
KOTIDO,2025,1870,1570,3440,21
KUMI,2015,2080,2210,4290,21
KUMI,2016,2190,2250,4440,21
KUMI,2017,2310,2290,4600,21
KUMI,2018,2440,2360,4800,21
KUMI,2019,2580,2440,5020,21
KUMI,2020,2710,2540,5250,21
KUMI,2021,2850,2630,5480,21
KUMI,2022,3000,2730,5730,21
KUMI,2023,3120,2800,5920,21
KUMI,2024,3210,2860,6070,21
KUMI,2025,3280,2890,6170,21
KWANIA,2015,1490,1810,3300,21
KWANIA,2016,1540,1860,3400,21
KWANIA,2017,1590,1910,3500,21
KWANIA,2018,1640,1970,3610,21
KWANIA,2019,1680,2020,3700,21
KWANIA,2020,1730,2080,3810,21
KWANIA,2021,1780,2130,3910,21
KWANIA,2022,1830,2190,4020,21
KWANIA,2023,1880,2240,4120,21
KWANIA,2024,1930,2300,4230,21
KWANIA,2025,1980,2350,4330,21
KWEEN,2015,770,860,1630,21
KWEEN,2016,800,880,1680,21
KWEEN,2017,820,900,1720,21
KWEEN,2018,850,920,1770,21
KWEEN,2019,870,940,1810,21
KWEEN,2020,900,970,1870,21
KWEEN,2021,920,990,1910,21
KWEEN,2022,950,1010,1960,21
KWEEN,2023,970,1030,2000,21
KWEEN,2024,1000,1050,2050,21
KWEEN,2025,1020,1070,2090,21
KYANKWANZI,2015,1820,1760,3580,21
KYANKWANZI,2016,1910,1850,3760,21
KYANKWANZI,2017,2010,1930,3940,21
KYANKWANZI,2018,2110,2020,4130,21
KYANKWANZI,2019,2220,2110,4330,21
KYANKWANZI,2020,2330,2210,4540,21
KYANKWANZI,2021,2440,2310,4750,21
KYANKWANZI,2022,2560,2410,4970,21
KYANKWANZI,2023,2680,2510,5190,21
KYANKWANZI,2024,2810,2620,5430,21
KYANKWANZI,2025,2930,2730,5660,21
KYEGEGWA,2015,2200,2480,4680,21
KYEGEGWA,2016,2380,2670,5050,21
KYEGEGWA,2017,2570,2880,5450,21
KYEGEGWA,2018,2780,3110,5890,21
KYEGEGWA,2019,3010,3350,6360,21
KYEGEGWA,2020,3250,3610,6860,21
KYEGEGWA,2021,3510,3890,7400,21
KYEGEGWA,2022,3790,4180,7970,21
KYEGEGWA,2023,4080,4500,8580,21
KYEGEGWA,2024,4400,4840,9240,21
KYEGEGWA,2025,4740,5190,9930,21
KYENJOJO,2015,3140,3480,6620,21
KYENJOJO,2016,3270,3610,6880,21
KYENJOJO,2017,3400,3750,7150,21
KYENJOJO,2018,3540,3880,7420,21
KYENJOJO,2019,3680,4020,7700,21
KYENJOJO,2020,3830,4160,7990,21
KYENJOJO,2021,3970,4310,8280,21
KYENJOJO,2022,4130,4460,8590,21
KYENJOJO,2023,4280,4610,8890,21
KYENJOJO,2024,4430,4760,9190,21
KYENJOJO,2025,4590,4910,9500,21
KYOTERA,2015,1650,2060,3710,21
KYOTERA,2016,1720,2060,3780,21
KYOTERA,2017,1790,2070,3860,21
KYOTERA,2018,1850,2090,3940,21
KYOTERA,2019,1920,2130,4050,21
KYOTERA,2020,2010,2190,4200,21
KYOTERA,2021,2070,2240,4310,21
KYOTERA,2022,2140,2290,4430,21
KYOTERA,2023,2190,2310,4500,21
KYOTERA,2024,2220,2320,4540,21
KYOTERA,2025,2240,2310,4550,21
KARENGA,2015,370,380,750,21
KARENGA,2016,380,390,770,21
KARENGA,2017,390,400,790,21
KARENGA,2018,400,410,810,21
KARENGA,2019,410,420,830,21
KARENGA,2020,420,430,850,21
KARENGA,2021,430,430,860,21
KARENGA,2022,440,440,880,21
KARENGA,2023,450,450,900,21
KARENGA,2024,460,460,920,21
KARENGA,2025,470,470,940,21
LAMWO,2015,990,1110,2100,21
LAMWO,2016,1010,1120,2130,21
LAMWO,2017,1050,1120,2170,21
LAMWO,2018,1080,1130,2210,21
LAMWO,2019,1120,1160,2280,21
LAMWO,2020,1160,1190,2350,21
LAMWO,2021,1180,1220,2400,21
LAMWO,2022,1220,1250,2470,21
LAMWO,2023,1240,1260,2500,21
LAMWO,2024,1250,1270,2520,21
LAMWO,2025,1260,1260,2520,21
LIRA,2015,3430,4340,7770,21
LIRA,2016,3530,4460,7990,21
LIRA,2017,3630,4590,8220,21
LIRA,2018,3730,4720,8450,21
LIRA,2019,3830,4850,8680,21
LIRA,2020,3930,4980,8910,21
LIRA,2021,4030,5120,9150,21
LIRA,2022,4140,5250,9390,21
LIRA,2023,4240,5380,9620,21
LIRA,2024,4340,5510,9850,21
LIRA,2025,4440,5640,10080,21
LUUKA,2015,1890,2220,4110,21
LUUKA,2016,1980,2240,4220,21
LUUKA,2017,2060,2260,4320,21
LUUKA,2018,2150,2300,4450,21
LUUKA,2019,2240,2360,4600,21
LUUKA,2020,2330,2440,4770,21
LUUKA,2021,2440,2510,4950,21
LUUKA,2022,2520,2570,5090,21
LUUKA,2023,2590,2620,5210,21
LUUKA,2024,2640,2640,5280,21
LUUKA,2025,2670,2660,5330,21
LUWERO,2015,4240,4870,9110,21
LUWERO,2016,4450,4930,9380,21
LUWERO,2017,4670,5000,9670,21
LUWERO,2018,4880,5100,9980,21
LUWERO,2019,5110,5250,10360,21
LUWERO,2020,5360,5420,10780,21
LUWERO,2021,5600,5610,11210,21
LUWERO,2022,5840,5760,11600,21
LUWERO,2023,6020,5880,11900,21
LUWERO,2024,6160,5960,12120,21
LUWERO,2025,6270,5980,12250,21
LWENGO,2015,1730,2140,3870,21
LWENGO,2016,1790,2140,3930,21
LWENGO,2017,1840,2140,3980,21
LWENGO,2018,1910,2150,4060,21
LWENGO,2019,1960,2190,4150,21
LWENGO,2020,2030,2230,4260,21
LWENGO,2021,2090,2280,4370,21
LWENGO,2022,2140,2310,4450,21
LWENGO,2023,2170,2330,4500,21
LWENGO,2024,2210,2320,4530,21
LWENGO,2025,2200,2310,4510,21
LYANTONDE,2015,820,930,1750,21
LYANTONDE,2016,860,950,1810,21
LYANTONDE,2017,910,970,1880,21
LYANTONDE,2018,950,990,1940,21
LYANTONDE,2019,1000,1020,2020,21
LYANTONDE,2020,1050,1070,2120,21
LYANTONDE,2021,1110,1110,2220,21
LYANTONDE,2022,1160,1140,2300,21
LYANTONDE,2023,1200,1180,2380,21
LYANTONDE,2024,1250,1200,2450,21
LYANTONDE,2025,1270,1210,2480,21
MANAFWA,2015,1110,1290,2400,21
MANAFWA,2016,1140,1320,2460,21
MANAFWA,2017,1170,1350,2520,21
MANAFWA,2018,1200,1380,2580,21
MANAFWA,2019,1220,1410,2630,21
MANAFWA,2020,1250,1440,2690,21
MANAFWA,2021,1280,1470,2750,21
MANAFWA,2022,1310,1500,2810,21
MANAFWA,2023,1340,1530,2870,21
MANAFWA,2024,1370,1560,2930,21
MANAFWA,2025,1390,1580,2970,21
MARACHA,2015,1020,1410,2430,21
MARACHA,2016,1040,1440,2480,21
MARACHA,2017,1060,1470,2530,21
MARACHA,2018,1080,1500,2580,21
MARACHA,2019,1100,1530,2630,21
MARACHA,2020,1130,1550,2680,21
MARACHA,2021,1150,1580,2730,21
MARACHA,2022,1170,1610,2780,21
MARACHA,2023,1190,1630,2820,21
MARACHA,2024,1210,1660,2870,21
MARACHA,2025,1230,1680,2910,21
MASAKA,2015,2510,3200,5710,21
MASAKA,2016,2620,3230,5850,21
MASAKA,2017,2740,3280,6020,21
MASAKA,2018,2860,3330,6190,21
MASAKA,2019,2990,3420,6410,21
MASAKA,2020,3120,3530,6650,21
MASAKA,2021,3260,3640,6900,21
MASAKA,2022,3390,3740,7130,21
MASAKA,2023,3490,3810,7300,21
MASAKA,2024,3550,3840,7390,21
MASAKA,2025,3610,3850,7460,21
MASINDI,2015,2750,2790,5540,21
MASINDI,2016,2830,2870,5700,21
MASINDI,2017,2920,2940,5860,21
MASINDI,2018,3000,3020,6020,21
MASINDI,2019,3080,3100,6180,21
MASINDI,2020,3170,3180,6350,21
MASINDI,2021,3250,3250,6500,21
MASINDI,2022,3340,3330,6670,21
MASINDI,2023,3420,3410,6830,21
MASINDI,2024,3510,3490,7000,21
MASINDI,2025,3590,3560,7150,21
MAYUGE,2015,3910,4980,8890,21
MAYUGE,2016,4130,5070,9200,21
MAYUGE,2017,4360,5180,9540,21
MAYUGE,2018,4590,5330,9920,21
MAYUGE,2019,4850,5530,10380,21
MAYUGE,2020,5100,5760,10860,21
MAYUGE,2021,5360,6000,11360,21
MAYUGE,2022,5620,6210,11830,21
MAYUGE,2023,5840,6390,12230,21
MAYUGE,2024,6020,6530,12550,21
MAYUGE,2025,6150,6620,12770,21
MBALE,2015,4850,5980,10830,21
MBALE,2016,5120,6110,11230,21
MBALE,2017,5380,6260,11640,21
MBALE,2018,5680,6460,12140,21
MBALE,2019,5980,6710,12690,21
MBALE,2020,6290,7010,13300,21
MBALE,2021,6610,7320,13930,21
MBALE,2022,6910,7610,14520,21
MBALE,2023,7180,7850,15030,21
MBALE,2024,7380,8020,15400,21
MBALE,2025,7550,8150,15700,21
MBARARA,2015,3540,4330,7870,21
MBARARA,2016,3620,4420,8040,21
MBARARA,2017,3700,4520,8220,21
MBARARA,2018,3790,4610,8400,21
MBARARA,2019,3870,4710,8580,21
MBARARA,2020,3960,4810,8770,21
MBARARA,2021,4040,4900,8940,21
MBARARA,2022,4120,4990,9110,21
MBARARA,2023,4200,5080,9280,21
MBARARA,2024,4280,5170,9450,21
MBARARA,2025,4350,5260,9610,21
MITOOMA,2015,1180,1480,2660,21
MITOOMA,2016,1190,1490,2680,21
MITOOMA,2017,1210,1500,2710,21
MITOOMA,2018,1220,1520,2740,21
MITOOMA,2019,1230,1530,2760,21
MITOOMA,2020,1250,1540,2790,21
MITOOMA,2021,1260,1550,2810,21
MITOOMA,2022,1270,1560,2830,21
MITOOMA,2023,1280,1570,2850,21
MITOOMA,2024,1290,1580,2870,21
MITOOMA,2025,1300,1590,2890,21
MITYANA,2015,2930,3240,6170,21
MITYANA,2016,3060,3250,6310,21
MITYANA,2017,3180,3260,6440,21
MITYANA,2018,3320,3320,6640,21
MITYANA,2019,3440,3390,6830,21
MITYANA,2020,3590,3470,7060,21
MITYANA,2021,3720,3570,7290,21
MITYANA,2022,3850,3640,7490,21
MITYANA,2023,3950,3700,7650,21
MITYANA,2024,4010,3720,7730,21
MITYANA,2025,4050,3710,7760,21
MOROTO,2015,710,760,1470,21
MOROTO,2016,750,770,1520,21
MOROTO,2017,780,780,1560,21
MOROTO,2018,820,800,1620,21
MOROTO,2019,850,830,1680,21
MOROTO,2020,890,850,1740,21
MOROTO,2021,930,890,1820,21
MOROTO,2022,960,920,1880,21
MOROTO,2023,990,930,1920,21
MOROTO,2024,1020,950,1970,21
MOROTO,2025,1030,960,1990,21
MOYO,2015,850,800,1650,21
MOYO,2016,870,820,1690,21
MOYO,2017,890,840,1730,21
MOYO,2018,910,860,1770,21
MOYO,2019,940,870,1810,21
MOYO,2020,960,890,1850,21
MOYO,2021,980,910,1890,21
MOYO,2022,1000,930,1930,21
MOYO,2023,1020,940,1960,21
MOYO,2024,1050,960,2010,21
MOYO,2025,1060,980,2040,21
MPIGI,2015,2140,2370,4510,21
MPIGI,2016,2240,2400,4640,21
MPIGI,2017,2340,2430,4770,21
MPIGI,2018,2450,2480,4930,21
MPIGI,2019,2580,2560,5140,21
MPIGI,2020,2690,2650,5340,21
MPIGI,2021,2810,2730,5540,21
MPIGI,2022,2920,2810,5730,21
MPIGI,2023,3020,2870,5890,21
MPIGI,2024,3080,2900,5980,21
MPIGI,2025,3130,2930,6060,21
MUBENDE,2015,3970,4160,8130,21
MUBENDE,2016,4290,4320,8610,21
MUBENDE,2017,4600,4510,9110,21
MUBENDE,2018,4960,4730,9690,21
MUBENDE,2019,5340,5010,10350,21
MUBENDE,2020,5740,5320,11060,21
MUBENDE,2021,6170,5660,11830,21
MUBENDE,2022,6590,5980,12570,21
MUBENDE,2023,7000,6270,13270,21
MUBENDE,2024,7350,6520,13870,21
MUBENDE,2025,7680,6750,14430,21
MUKONO,2015,5360,6770,12130,21
MUKONO,2016,5640,6880,12520,21
MUKONO,2017,5920,7030,12950,21
MUKONO,2018,6210,7210,13420,21
MUKONO,2019,6530,7470,14000,21
MUKONO,2020,6850,7770,14620,21
MUKONO,2021,7170,8090,15260,21
MUKONO,2022,7480,8380,15860,21
MUKONO,2023,7740,8610,16350,21
MUKONO,2024,7930,8770,16700,21
MUKONO,2025,8080,8880,16960,21
NABILATUK,2015,470,470,940,21
NABILATUK,2016,500,490,990,21
NABILATUK,2017,540,500,1040,21
NABILATUK,2018,590,530,1120,21
NABILATUK,2019,630,550,1180,21
NABILATUK,2020,670,580,1250,21
NABILATUK,2021,720,610,1330,21
NABILATUK,2022,760,640,1400,21
NABILATUK,2023,820,670,1490,21
NABILATUK,2024,860,700,1560,21
NABILATUK,2025,890,710,1600,21
NAKAPIRIPIRIT,2015,590,670,1260,21
NAKAPIRIPIRIT,2016,640,680,1320,21
NAKAPIRIPIRIT,2017,680,710,1390,21
NAKAPIRIPIRIT,2018,720,730,1450,21
NAKAPIRIPIRIT,2019,770,770,1540,21
NAKAPIRIPIRIT,2020,820,820,1640,21
NAKAPIRIPIRIT,2021,880,860,1740,21
NAKAPIRIPIRIT,2022,930,900,1830,21
NAKAPIRIPIRIT,2023,970,940,1910,21
NAKAPIRIPIRIT,2024,1020,970,1990,21
NAKAPIRIPIRIT,2025,1060,1000,2060,21
NAKASEKE,2015,1620,1500,3120,21
NAKASEKE,2016,1680,1540,3220,21
NAKASEKE,2017,1740,1570,3310,21
NAKASEKE,2018,1800,1610,3410,21
NAKASEKE,2019,1870,1650,3520,21
NAKASEKE,2020,1930,1690,3620,21
NAKASEKE,2021,2000,1720,3720,21
NAKASEKE,2022,2070,1760,3830,21
NAKASEKE,2023,2130,1800,3930,21
NAKASEKE,2024,2200,1830,4030,21
NAKASEKE,2025,2270,1870,4140,21
NAKASONGOLA,2015,1800,1720,3520,21
NAKASONGOLA,2016,1900,1740,3640,21
NAKASONGOLA,2017,2010,1780,3790,21
NAKASONGOLA,2018,2110,1820,3930,21
NAKASONGOLA,2019,2230,1880,4110,21
NAKASONGOLA,2020,2360,1950,4310,21
NAKASONGOLA,2021,2480,2030,4510,21
NAKASONGOLA,2022,2590,2090,4680,21
NAKASONGOLA,2023,2700,2150,4850,21
NAKASONGOLA,2024,2780,2180,4960,21
NAKASONGOLA,2025,2860,2200,5060,21
NAMAYINGO,2015,1800,2200,4000,21
NAMAYINGO,2016,1880,2210,4090,21
NAMAYINGO,2017,1960,2210,4170,21
NAMAYINGO,2018,2040,2240,4280,21
NAMAYINGO,2019,2120,2290,4410,21
NAMAYINGO,2020,2200,2350,4550,21
NAMAYINGO,2021,2280,2410,4690,21
NAMAYINGO,2022,2370,2460,4830,21
NAMAYINGO,2023,2430,2490,4920,21
NAMAYINGO,2024,2470,2500,4970,21
NAMAYINGO,2025,2500,2490,4990,21
NAMISINDWA,2015,1400,1570,2970,21
NAMISINDWA,2016,1440,1610,3050,21
NAMISINDWA,2017,1480,1650,3130,21
NAMISINDWA,2018,1520,1690,3210,21
NAMISINDWA,2019,1560,1720,3280,21
NAMISINDWA,2020,1600,1760,3360,21
NAMISINDWA,2021,1640,1800,3440,21
NAMISINDWA,2022,1690,1840,3530,21
NAMISINDWA,2023,1730,1880,3610,21
NAMISINDWA,2024,1770,1910,3680,21
NAMISINDWA,2025,1810,1950,3760,21
NAMUTUMBA,2015,2180,2560,4740,21
NAMUTUMBA,2016,2310,2610,4920,21
NAMUTUMBA,2017,2440,2670,5110,21
NAMUTUMBA,2018,2580,2760,5340,21
NAMUTUMBA,2019,2740,2870,5610,21
NAMUTUMBA,2020,2890,2980,5870,21
NAMUTUMBA,2021,3050,3120,6170,21
NAMUTUMBA,2022,3220,3240,6460,21
NAMUTUMBA,2023,3350,3340,6690,21
NAMUTUMBA,2024,3470,3410,6880,21
NAMUTUMBA,2025,3560,3470,7030,21
NAPAK,2015,800,930,1730,21
NAPAK,2016,830,940,1770,21
NAPAK,2017,860,950,1810,21
NAPAK,2018,890,970,1860,21
NAPAK,2019,920,990,1910,21
NAPAK,2020,970,1030,2000,21
NAPAK,2021,1000,1060,2060,21
NAPAK,2022,1030,1080,2110,21
NAPAK,2023,1060,1110,2170,21
NAPAK,2024,1080,1110,2190,21
NAPAK,2025,1090,1120,2210,21
NEBBI,2015,1770,2050,3820,21
NEBBI,2016,1820,2110,3930,21
NEBBI,2017,1880,2170,4050,21
NEBBI,2018,1940,2230,4170,21
NEBBI,2019,2000,2300,4300,21
NEBBI,2020,2060,2360,4420,21
NEBBI,2021,2120,2420,4540,21
NEBBI,2022,2180,2480,4660,21
NEBBI,2023,2240,2540,4780,21
NEBBI,2024,2300,2610,4910,21
NEBBI,2025,2370,2670,5040,21
NGORA,2015,1200,1360,2560,21
NGORA,2016,1270,1360,2630,21
NGORA,2017,1330,1400,2730,21
NGORA,2018,1400,1430,2830,21
NGORA,2019,1470,1470,2940,21
NGORA,2020,1540,1530,3070,21
NGORA,2021,1620,1580,3200,21
NGORA,2022,1690,1630,3320,21
NGORA,2023,1750,1670,3420,21
NGORA,2024,1790,1690,3480,21
NGORA,2025,1830,1710,3540,21
NTOROKO,2015,490,550,1040,21
NTOROKO,2016,530,550,1080,21
NTOROKO,2017,550,560,1110,21
NTOROKO,2018,570,570,1140,21
NTOROKO,2019,600,580,1180,21
NTOROKO,2020,630,590,1220,21
NTOROKO,2021,650,610,1260,21
NTOROKO,2022,680,630,1310,21
NTOROKO,2023,700,640,1340,21
NTOROKO,2024,720,650,1370,21
NTOROKO,2025,730,640,1370,21
NTUNGAMO,2015,3320,4010,7330,21
NTUNGAMO,2016,3390,4080,7470,21
NTUNGAMO,2017,3460,4160,7620,21
NTUNGAMO,2018,3530,4230,7760,21
NTUNGAMO,2019,3610,4310,7920,21
NTUNGAMO,2020,3680,4380,8060,21
NTUNGAMO,2021,3750,4450,8200,21
NTUNGAMO,2022,3820,4520,8340,21
NTUNGAMO,2023,3890,4590,8480,21
NTUNGAMO,2024,3950,4660,8610,21
NTUNGAMO,2025,4020,4720,8740,21
NWOYA,2015,1100,1180,2280,21
NWOYA,2016,1210,1300,2510,21
NWOYA,2017,1340,1440,2780,21
NWOYA,2018,1480,1580,3060,21
NWOYA,2019,1630,1740,3370,21
NWOYA,2020,1800,1920,3720,21
NWOYA,2021,1980,2110,4090,21
NWOYA,2022,2180,2320,4500,21
NWOYA,2023,2400,2540,4940,21
NWOYA,2024,2640,2790,5430,21
NWOYA,2025,2900,3060,5960,21
OBONGI,2015,360,370,730,21
OBONGI,2016,380,380,760,21
OBONGI,2017,380,390,770,21
OBONGI,2018,400,390,790,21
OBONGI,2019,430,400,830,21
OBONGI,2020,450,420,870,21
OBONGI,2021,460,440,900,21
OBONGI,2022,480,440,920,21
OBONGI,2023,500,450,950,21
OBONGI,2024,500,450,950,21
OBONGI,2025,510,460,970,21
OMORO,2015,1480,1650,3130,21
OMORO,2016,1570,1690,3260,21
OMORO,2017,1660,1730,3390,21
OMORO,2018,1760,1780,3540,21
OMORO,2019,1860,1870,3730,21
OMORO,2020,1960,1950,3910,21
OMORO,2021,2070,2030,4100,21
OMORO,2022,2180,2120,4300,21
OMORO,2023,2290,2180,4470,21
OMORO,2024,2370,2240,4610,21
OMORO,2025,2430,2280,4710,21
OTUKE,2015,770,850,1620,21
OTUKE,2016,800,880,1680,21
OTUKE,2017,840,920,1760,21
OTUKE,2018,870,960,1830,21
OTUKE,2019,910,1000,1910,21
OTUKE,2020,950,1040,1990,21
OTUKE,2021,990,1080,2070,21
OTUKE,2022,1040,1130,2170,21
OTUKE,2023,1080,1170,2250,21
OTUKE,2024,1120,1220,2340,21
OTUKE,2025,1170,1260,2430,21
OYAM,2015,3070,3660,6730,21
OYAM,2016,3170,3770,6940,21
OYAM,2017,3260,3880,7140,21
OYAM,2018,3360,3990,7350,21
OYAM,2019,3460,4110,7570,21
OYAM,2020,3560,4220,7780,21
OYAM,2021,3660,4340,8000,21
OYAM,2022,3760,4450,8210,21
OYAM,2023,3860,4570,8430,21
OYAM,2024,3970,4680,8650,21
OYAM,2025,4060,4800,8860,21
PADER,2015,1450,1540,2990,21
PADER,2016,1500,1560,3060,21
PADER,2017,1560,1580,3140,21
PADER,2018,1630,1600,3230,21
PADER,2019,1700,1650,3350,21
PADER,2020,1760,1690,3450,21
PADER,2021,1820,1750,3570,21
PADER,2022,1880,1790,3670,21
PADER,2023,1930,1810,3740,21
PADER,2024,1950,1840,3790,21
PADER,2025,1970,1840,3810,21
PAKWACH,2015,1180,1360,2540,21
PAKWACH,2016,1240,1410,2650,21
PAKWACH,2017,1290,1460,2750,21
PAKWACH,2018,1340,1520,2860,21
PAKWACH,2019,1400,1570,2970,21
PAKWACH,2020,1450,1630,3080,21
PAKWACH,2021,1510,1680,3190,21
PAKWACH,2022,1570,1740,3310,21
PAKWACH,2023,1630,1800,3430,21
PAKWACH,2024,1690,1850,3540,21
PAKWACH,2025,1750,1910,3660,21
PALLISA,2015,2330,2680,5010,21
PALLISA,2016,2490,2760,5250,21
PALLISA,2017,2660,2850,5510,21
PALLISA,2018,2850,2960,5810,21
PALLISA,2019,3040,3110,6150,21
PALLISA,2020,3250,3290,6540,21
PALLISA,2021,3450,3460,6910,21
PALLISA,2022,3670,3630,7300,21
PALLISA,2023,3860,3780,7640,21
PALLISA,2024,4030,3910,7940,21
PALLISA,2025,4170,4010,8180,21
RAKAI,2015,1880,2220,4100,21
RAKAI,2016,1970,2240,4210,21
RAKAI,2017,2060,2270,4330,21
RAKAI,2018,2150,2320,4470,21
RAKAI,2019,2260,2380,4640,21
RAKAI,2020,2370,2470,4840,21
RAKAI,2021,2480,2550,5030,21
RAKAI,2022,2580,2620,5200,21
RAKAI,2023,2660,2680,5340,21
RAKAI,2024,2720,2710,5430,21
RAKAI,2025,2770,2730,5500,21
RUBANDA,2015,1300,1770,3070,21
RUBANDA,2016,1310,1790,3100,21
RUBANDA,2017,1330,1800,3130,21
RUBANDA,2018,1350,1810,3160,21
RUBANDA,2019,1370,1830,3200,21
RUBANDA,2020,1380,1840,3220,21
RUBANDA,2021,1400,1850,3250,21
RUBANDA,2022,1410,1860,3270,21
RUBANDA,2023,1430,1870,3300,21
RUBANDA,2024,1440,1880,3320,21
RUBANDA,2025,1450,1880,3330,21
RUBIRIZI,2015,800,1010,1810,21
RUBIRIZI,2016,820,1030,1850,21
RUBIRIZI,2017,830,1050,1880,21
RUBIRIZI,2018,850,1070,1920,21
RUBIRIZI,2019,870,1090,1960,21
RUBIRIZI,2020,880,1110,1990,21
RUBIRIZI,2021,900,1130,2030,21
RUBIRIZI,2022,910,1150,2060,21
RUBIRIZI,2023,930,1160,2090,21
RUBIRIZI,2024,940,1180,2120,21
RUBIRIZI,2025,960,1200,2160,21
RUKIGA,2015,710,830,1540,21
RUKIGA,2016,710,840,1550,21
RUKIGA,2017,720,840,1560,21
RUKIGA,2018,730,850,1580,21
RUKIGA,2019,740,850,1590,21
RUKIGA,2020,740,860,1600,21
RUKIGA,2021,750,860,1610,21
RUKIGA,2022,750,870,1620,21
RUKIGA,2023,760,870,1630,21
RUKIGA,2024,760,870,1630,21
RUKIGA,2025,760,870,1630,21
RUKUNGIRI,2015,2300,2840,5140,21
RUKUNGIRI,2016,2330,2870,5200,21
RUKUNGIRI,2017,2360,2900,5260,21
RUKUNGIRI,2018,2390,2920,5310,21
RUKUNGIRI,2019,2420,2950,5370,21
RUKUNGIRI,2020,2440,2980,5420,21
RUKUNGIRI,2021,2460,3000,5460,21
RUKUNGIRI,2022,2490,3020,5510,21
RUKUNGIRI,2023,2510,3040,5550,21
RUKUNGIRI,2024,2530,3060,5590,21
RUKUNGIRI,2025,2540,3070,5610,21
RWAMPARA,2015,930,1150,2080,21
RWAMPARA,2016,950,1170,2120,21
RWAMPARA,2017,970,1200,2170,21
RWAMPARA,2018,990,1230,2220,21
RWAMPARA,2019,1010,1250,2260,21
RWAMPARA,2020,1030,1280,2310,21
RWAMPARA,2021,1050,1300,2350,21
RWAMPARA,2022,1080,1330,2410,21
RWAMPARA,2023,1100,1350,2450,21
RWAMPARA,2024,1120,1380,2500,21
RWAMPARA,2025,1140,1400,2540,21
SERERE,2015,2540,2760,5300,21
SERERE,2016,2710,2830,5540,21
SERERE,2017,2880,2920,5800,21
SERERE,2018,3050,3030,6080,21
SERERE,2019,3260,3170,6430,21
SERERE,2020,3460,3330,6790,21
SERERE,2021,3680,3490,7170,21
SERERE,2022,3880,3650,7530,21
SERERE,2023,4080,3790,7870,21
SERERE,2024,4230,3900,8130,21
SERERE,2025,4370,3990,8360,21
SHEEMA,2015,1660,1880,3540,21
SHEEMA,2016,1680,1900,3580,21
SHEEMA,2017,1700,1920,3620,21
SHEEMA,2018,1720,1940,3660,21
SHEEMA,2019,1740,1960,3700,21
SHEEMA,2020,1750,1970,3720,21
SHEEMA,2021,1770,1990,3760,21
SHEEMA,2022,1790,2010,3800,21
SHEEMA,2023,1800,2020,3820,21
SHEEMA,2024,1820,2030,3850,21
SHEEMA,2025,1830,2050,3880,21
SIRONKO,2015,1580,1880,3460,21
SIRONKO,2016,1620,1920,3540,21
SIRONKO,2017,1660,1960,3620,21
SIRONKO,2018,1700,2000,3700,21
SIRONKO,2019,1740,2030,3770,21
SIRONKO,2020,1780,2070,3850,21
SIRONKO,2021,1820,2110,3930,21
SIRONKO,2022,1860,2150,4010,21
SIRONKO,2023,1890,2180,4070,21
SIRONKO,2024,1930,2220,4150,21
SIRONKO,2025,1960,2250,4210,21
SOROTI,2015,3160,3310,6470,21
SOROTI,2016,3360,3380,6740,21
SOROTI,2017,3550,3470,7020,21
SOROTI,2018,3760,3590,7350,21
SOROTI,2019,3980,3730,7710,21
SOROTI,2020,4210,3900,8110,21
SOROTI,2021,4460,4090,8550,21
SOROTI,2022,4690,4250,8940,21
SOROTI,2023,4890,4390,9280,21
SOROTI,2024,5070,4500,9570,21
SOROTI,2025,5210,4580,9790,21
SSEMBABULE,2015,1990,2200,4190,21
SSEMBABULE,2016,2090,2230,4320,21
SSEMBABULE,2017,2200,2270,4470,21
SSEMBABULE,2018,2310,2320,4630,21
SSEMBABULE,2019,2430,2400,4830,21
SSEMBABULE,2020,2550,2480,5030,21
SSEMBABULE,2021,2670,2590,5260,21
SSEMBABULE,2022,2790,2670,5460,21
SSEMBABULE,2023,2900,2730,5630,21
SSEMBABULE,2024,2980,2770,5750,21
SSEMBABULE,2025,3040,2800,5840,21
TORORO,2015,4440,5040,9480,21
TORORO,2016,4560,5170,9730,21
TORORO,2017,4680,5300,9980,21
TORORO,2018,4800,5430,10230,21
TORORO,2019,4930,5560,10490,21
TORORO,2020,5050,5690,10740,21
TORORO,2021,5170,5820,10990,21
TORORO,2022,5300,5950,11250,21
TORORO,2023,5420,6080,11500,21
TORORO,2024,5540,6210,11750,21
TORORO,2025,5660,6340,12000,21
WAKISO,2015,17550,26930,44480,21
WAKISO,2016,18730,28770,47500,21
WAKISO,2017,19980,30750,50730,21
WAKISO,2018,21310,32830,54140,21
WAKISO,2019,22720,35030,57750,21
WAKISO,2020,24200,37360,61560,21
WAKISO,2021,25760,39840,65600,21
WAKISO,2022,27410,42470,69880,21
WAKISO,2023,29150,45200,74350,21
WAKISO,2024,30960,48080,79040,21
WAKISO,2025,32870,51130,84000,21
YUMBE,2015,3050,3420,6470,21
YUMBE,2016,3280,3580,6860,21
YUMBE,2017,3530,3770,7300,21
YUMBE,2018,3790,3980,7770,21
YUMBE,2019,4070,4240,8310,21
YUMBE,2020,4360,4530,8890,21
YUMBE,2021,4690,4850,9540,21
YUMBE,2022,5000,5180,10180,21
YUMBE,2023,5290,5480,10770,21
YUMBE,2024,5560,5740,11300,21
YUMBE,2025,5800,5970,11770,21
ZOMBO,2015,1370,1620,2990,21
ZOMBO,2016,1410,1660,3070,21
ZOMBO,2017,1450,1710,3160,21
ZOMBO,2018,1500,1760,3260,21
ZOMBO,2019,1540,1800,3340,21
ZOMBO,2020,1590,1850,3440,21
ZOMBO,2021,1630,1900,3530,21
ZOMBO,2022,1680,1950,3630,21
ZOMBO,2023,1720,1990,3710,21
ZOMBO,2024,1770,2040,3810,21
ZOMBO,2025,1810,2090,3900,21
MADI OKOLLO,2015,970,1110,2080,21
MADI OKOLLO,2016,1000,1140,2140,21
MADI OKOLLO,2017,1030,1170,2200,21
MADI OKOLLO,2018,1060,1200,2260,21
MADI OKOLLO,2019,1090,1230,2320,21
MADI OKOLLO,2020,1120,1260,2380,21
MADI OKOLLO,2021,1140,1300,2440,21
MADI OKOLLO,2022,1180,1330,2510,21
MADI OKOLLO,2023,1210,1360,2570,21
MADI OKOLLO,2024,1230,1390,2620,21
MADI OKOLLO,2025,1260,1420,2680,21
ABIM,2015,880,1090,1970,22
ABIM,2016,960,1140,2100,22
ABIM,2017,1040,1200,2240,22
ABIM,2018,1130,1250,2380,22
ABIM,2019,1230,1330,2560,22
ABIM,2020,1330,1420,2750,22
ABIM,2021,1450,1520,2970,22
ABIM,2022,1570,1630,3200,22
ABIM,2023,1710,1740,3450,22
ABIM,2024,1820,1840,3660,22
ABIM,2025,1940,1930,3870,22
ADJUMANI,2015,1640,2090,3730,22
ADJUMANI,2016,1660,2120,3780,22
ADJUMANI,2017,1670,2140,3810,22
ADJUMANI,2018,1680,2160,3840,22
ADJUMANI,2019,1690,2180,3870,22
ADJUMANI,2020,1700,2190,3890,22
ADJUMANI,2021,1710,2210,3920,22
ADJUMANI,2022,1720,2230,3950,22
ADJUMANI,2023,1720,2240,3960,22
ADJUMANI,2024,1730,2250,3980,22
ADJUMANI,2025,1730,2270,4000,22
AGAGO,2015,1660,1960,3620,22
AGAGO,2016,1690,2000,3690,22
AGAGO,2017,1720,2030,3750,22
AGAGO,2018,1750,2070,3820,22
AGAGO,2019,1770,2100,3870,22
AGAGO,2020,1800,2130,3930,22
AGAGO,2021,1830,2170,4000,22
AGAGO,2022,1860,2200,4060,22
AGAGO,2023,1880,2230,4110,22
AGAGO,2024,1910,2260,4170,22
AGAGO,2025,1930,2290,4220,22
ALEBTONG,2015,1770,2170,3940,22
ALEBTONG,2016,1870,2210,4080,22
ALEBTONG,2017,1970,2240,4210,22
ALEBTONG,2018,2060,2280,4340,22
ALEBTONG,2019,2170,2330,4500,22
ALEBTONG,2020,2280,2420,4700,22
ALEBTONG,2021,2400,2510,4910,22
ALEBTONG,2022,2500,2600,5100,22
ALEBTONG,2023,2620,2680,5300,22
ALEBTONG,2024,2710,2750,5460,22
ALEBTONG,2025,2780,2790,5570,22
AMOLATAR,2015,1280,1360,2640,22
AMOLATAR,2016,1350,1390,2740,22
AMOLATAR,2017,1420,1400,2820,22
AMOLATAR,2018,1480,1430,2910,22
AMOLATAR,2019,1560,1450,3010,22
AMOLATAR,2020,1640,1500,3140,22
AMOLATAR,2021,1720,1550,3270,22
AMOLATAR,2022,1790,1610,3400,22
AMOLATAR,2023,1870,1650,3520,22
AMOLATAR,2024,1940,1690,3630,22
AMOLATAR,2025,1980,1710,3690,22
AMUDAT,2015,1060,830,1890,22
AMUDAT,2016,1130,860,1990,22
AMUDAT,2017,1210,890,2100,22
AMUDAT,2018,1280,920,2200,22
AMUDAT,2019,1360,960,2320,22
AMUDAT,2020,1440,1010,2450,22
AMUDAT,2021,1530,1070,2600,22
AMUDAT,2022,1620,1140,2760,22
AMUDAT,2023,1720,1200,2920,22
AMUDAT,2024,1800,1250,3050,22
AMUDAT,2025,1860,1290,3150,22
AMURIA,2015,1430,1690,3120,22
AMURIA,2016,1520,1740,3260,22
AMURIA,2017,1620,1770,3390,22
AMURIA,2018,1720,1830,3550,22
AMURIA,2019,1820,1880,3700,22
AMURIA,2020,1930,1960,3890,22
AMURIA,2021,2040,2050,4090,22
AMURIA,2022,2160,2140,4300,22
AMURIA,2023,2270,2230,4500,22
AMURIA,2024,2370,2300,4670,22
AMURIA,2025,2450,2350,4800,22
AMURU,2015,1480,1890,3370,22
AMURU,2016,1550,1920,3470,22
AMURU,2017,1630,1950,3580,22
AMURU,2018,1720,1980,3700,22
AMURU,2019,1800,2030,3830,22
AMURU,2020,1880,2090,3970,22
AMURU,2021,1970,2170,4140,22
AMURU,2022,2060,2250,4310,22
AMURU,2023,2150,2320,4470,22
AMURU,2024,2220,2380,4600,22
AMURU,2025,2270,2410,4680,22
APAC,2015,1780,1870,3650,22
APAC,2016,1840,1930,3770,22
APAC,2017,1910,2000,3910,22
APAC,2018,1980,2070,4050,22
APAC,2019,2050,2140,4190,22
APAC,2020,2120,2210,4330,22
APAC,2021,2190,2280,4470,22
APAC,2022,2270,2350,4620,22
APAC,2023,2340,2430,4770,22
APAC,2024,2420,2500,4920,22
APAC,2025,2500,2580,5080,22
ARUA,2015,5640,7030,12670,22
ARUA,2016,5810,7220,13030,22
ARUA,2017,5970,7420,13390,22
ARUA,2018,6150,7610,13760,22
ARUA,2019,6320,7810,14130,22
ARUA,2020,6490,8010,14500,22
ARUA,2021,6670,8210,14880,22
ARUA,2022,6840,8410,15250,22
ARUA,2023,7010,8620,15630,22
ARUA,2024,7180,8820,16000,22
ARUA,2025,7350,9020,16370,22
BUDAKA,2015,1490,1930,3420,22
BUDAKA,2016,1570,1980,3550,22
BUDAKA,2017,1670,2010,3680,22
BUDAKA,2018,1770,2060,3830,22
BUDAKA,2019,1870,2140,4010,22
BUDAKA,2020,1980,2220,4200,22
BUDAKA,2021,2090,2310,4400,22
BUDAKA,2022,2220,2420,4640,22
BUDAKA,2023,2330,2510,4840,22
BUDAKA,2024,2420,2600,5020,22
BUDAKA,2025,2510,2650,5160,22
BUDUDA,2015,1820,1980,3800,22
BUDUDA,2016,1950,2060,4010,22
BUDUDA,2017,2080,2130,4210,22
BUDUDA,2018,2220,2210,4430,22
BUDUDA,2019,2380,2300,4680,22
BUDUDA,2020,2540,2410,4950,22
BUDUDA,2021,2710,2550,5260,22
BUDUDA,2022,2880,2690,5570,22
BUDUDA,2023,3060,2820,5880,22
BUDUDA,2024,3230,2930,6160,22
BUDUDA,2025,3360,3030,6390,22
BUGIRI,2015,2810,3450,6260,22
BUGIRI,2016,3000,3560,6560,22
BUGIRI,2017,3190,3650,6840,22
BUGIRI,2018,3390,3760,7150,22
BUGIRI,2019,3610,3900,7510,22
BUGIRI,2020,3840,4070,7910,22
BUGIRI,2021,4080,4270,8350,22
BUGIRI,2022,4330,4480,8810,22
BUGIRI,2023,4580,4680,9260,22
BUGIRI,2024,4800,4860,9660,22
BUGIRI,2025,4990,4990,9980,22
BUGWERI,2015,1120,1520,2640,22
BUGWERI,2016,1180,1540,2720,22
BUGWERI,2017,1240,1560,2800,22
BUGWERI,2018,1300,1590,2890,22
BUGWERI,2019,1370,1620,2990,22
BUGWERI,2020,1430,1670,3100,22
BUGWERI,2021,1510,1740,3250,22
BUGWERI,2022,1570,1800,3370,22
BUGWERI,2023,1640,1860,3500,22
BUGWERI,2024,1700,1900,3600,22
BUGWERI,2025,1740,1930,3670,22
BUHWEJU,2015,1040,1230,2270,22
BUHWEJU,2016,1080,1270,2350,22
BUHWEJU,2017,1110,1310,2420,22
BUHWEJU,2018,1150,1350,2500,22
BUHWEJU,2019,1190,1390,2580,22
BUHWEJU,2020,1220,1430,2650,22
BUHWEJU,2021,1260,1470,2730,22
BUHWEJU,2022,1300,1510,2810,22
BUHWEJU,2023,1340,1550,2890,22
BUHWEJU,2024,1370,1590,2960,22
BUHWEJU,2025,1410,1630,3040,22
BUIKWE,2015,3810,4570,8380,22
BUIKWE,2016,3980,4630,8610,22
BUIKWE,2017,4150,4670,8820,22
BUIKWE,2018,4320,4720,9040,22
BUIKWE,2019,4510,4800,9310,22
BUIKWE,2020,4700,4920,9620,22
BUIKWE,2021,4890,5080,9970,22
BUIKWE,2022,5090,5240,10330,22
BUIKWE,2023,5270,5370,10640,22
BUIKWE,2024,5410,5460,10870,22
BUIKWE,2025,5510,5520,11030,22
BUKEDEA,2015,1510,1840,3350,22
BUKEDEA,2016,1620,1900,3520,22
BUKEDEA,2017,1720,1960,3680,22
BUKEDEA,2018,1830,2020,3850,22
BUKEDEA,2019,1960,2100,4060,22
BUKEDEA,2020,2090,2190,4280,22
BUKEDEA,2021,2230,2300,4530,22
BUKEDEA,2022,2380,2420,4800,22
BUKEDEA,2023,2510,2540,5050,22
BUKEDEA,2024,2650,2640,5290,22
BUKEDEA,2025,2760,2720,5480,22
BUKOMANSIMBI,2015,990,1110,2100,22
BUKOMANSIMBI,2016,1020,1110,2130,22
BUKOMANSIMBI,2017,1050,1100,2150,22
BUKOMANSIMBI,2018,1080,1090,2170,22
BUKOMANSIMBI,2019,1120,1090,2210,22
BUKOMANSIMBI,2020,1140,1110,2250,22
BUKOMANSIMBI,2021,1180,1120,2300,22
BUKOMANSIMBI,2022,1220,1140,2360,22
BUKOMANSIMBI,2023,1240,1150,2390,22
BUKOMANSIMBI,2024,1260,1150,2410,22
BUKOMANSIMBI,2025,1270,1140,2410,22
BUKWO,2015,820,850,1670,22
BUKWO,2016,860,890,1750,22
BUKWO,2017,910,930,1840,22
BUKWO,2018,960,980,1940,22
BUKWO,2019,1000,1020,2020,22
BUKWO,2020,1060,1070,2130,22
BUKWO,2021,1110,1120,2230,22
BUKWO,2022,1170,1170,2340,22
BUKWO,2023,1230,1230,2460,22
BUKWO,2024,1280,1280,2560,22
BUKWO,2025,1350,1340,2690,22
BULAMBULI,2015,1460,1600,3060,22
BULAMBULI,2016,1560,1670,3230,22
BULAMBULI,2017,1680,1740,3420,22
BULAMBULI,2018,1800,1800,3600,22
BULAMBULI,2019,1940,1890,3830,22
BULAMBULI,2020,2080,1990,4070,22
BULAMBULI,2021,2230,2110,4340,22
BULAMBULI,2022,2380,2240,4620,22
BULAMBULI,2023,2540,2350,4890,22
BULAMBULI,2024,2680,2470,5150,22
BULAMBULI,2025,2810,2560,5370,22
BULIISA,2015,1360,1190,2550,22
BULIISA,2016,1440,1240,2680,22
BULIISA,2017,1520,1300,2820,22
BULIISA,2018,1600,1360,2960,22
BULIISA,2019,1680,1410,3090,22
BULIISA,2020,1770,1470,3240,22
BULIISA,2021,1860,1540,3400,22
BULIISA,2022,1960,1600,3560,22
BULIISA,2023,2060,1670,3730,22
BULIISA,2024,2160,1730,3890,22
BULIISA,2025,2260,1800,4060,22
BUNDIBUGYO,2015,2030,2450,4480,22
BUNDIBUGYO,2016,2140,2500,4640,22
BUNDIBUGYO,2017,2260,2540,4800,22
BUNDIBUGYO,2018,2380,2590,4970,22
BUNDIBUGYO,2019,2500,2650,5150,22
BUNDIBUGYO,2020,2630,2730,5360,22
BUNDIBUGYO,2021,2770,2840,5610,22
BUNDIBUGYO,2022,2910,2940,5850,22
BUNDIBUGYO,2023,3040,3040,6080,22
BUNDIBUGYO,2024,3140,3110,6250,22
BUNDIBUGYO,2025,3230,3160,6390,22
BUNYANGABU,2015,1500,1590,3090,22
BUNYANGABU,2016,1570,1620,3190,22
BUNYANGABU,2017,1650,1640,3290,22
BUNYANGABU,2018,1730,1650,3380,22
BUNYANGABU,2019,1810,1690,3500,22
BUNYANGABU,2020,1890,1740,3630,22
BUNYANGABU,2021,1980,1800,3780,22
BUNYANGABU,2022,2070,1850,3920,22
BUNYANGABU,2023,2160,1910,4070,22
BUNYANGABU,2024,2230,1940,4170,22
BUNYANGABU,2025,2290,1970,4260,22
BUSHENYI,2015,2140,2460,4600,22
BUSHENYI,2016,2170,2480,4650,22
BUSHENYI,2017,2190,2500,4690,22
BUSHENYI,2018,2220,2520,4740,22
BUSHENYI,2019,2250,2540,4790,22
BUSHENYI,2020,2270,2560,4830,22
BUSHENYI,2021,2290,2580,4870,22
BUSHENYI,2022,2310,2600,4910,22
BUSHENYI,2023,2330,2610,4940,22
BUSHENYI,2024,2350,2630,4980,22
BUSHENYI,2025,2370,2640,5010,22
BUSIA,2015,2530,3300,5830,22
BUSIA,2016,2680,3370,6050,22
BUSIA,2017,2830,3430,6260,22
BUSIA,2018,2980,3500,6480,22
BUSIA,2019,3130,3590,6720,22
BUSIA,2020,3300,3710,7010,22
BUSIA,2021,3490,3860,7350,22
BUSIA,2022,3660,4010,7670,22
BUSIA,2023,3830,4140,7970,22
BUSIA,2024,3980,4250,8230,22
BUSIA,2025,4100,4340,8440,22
BUTALEJA,2015,1780,2210,3990,22
BUTALEJA,2016,1900,2270,4170,22
BUTALEJA,2017,2010,2320,4330,22
BUTALEJA,2018,2140,2390,4530,22
BUTALEJA,2019,2260,2460,4720,22
BUTALEJA,2020,2400,2560,4960,22
BUTALEJA,2021,2540,2680,5220,22
BUTALEJA,2022,2690,2800,5490,22
BUTALEJA,2023,2830,2920,5750,22
BUTALEJA,2024,2970,3010,5980,22
BUTALEJA,2025,3070,3090,6160,22
BUTAMBALA,2015,630,750,1380,22
BUTAMBALA,2016,660,760,1420,22
BUTAMBALA,2017,680,760,1440,22
BUTAMBALA,2018,710,760,1470,22
BUTAMBALA,2019,730,770,1500,22
BUTAMBALA,2020,760,770,1530,22
BUTAMBALA,2021,790,790,1580,22
BUTAMBALA,2022,800,810,1610,22
BUTAMBALA,2023,830,820,1650,22
BUTAMBALA,2024,850,830,1680,22
BUTAMBALA,2025,860,830,1690,22
BUTEBO,2015,830,1030,1860,22
BUTEBO,2016,870,1040,1910,22
BUTEBO,2017,900,1040,1940,22
BUTEBO,2018,940,1050,1990,22
BUTEBO,2019,970,1050,2020,22
BUTEBO,2020,1000,1070,2070,22
BUTEBO,2021,1050,1090,2140,22
BUTEBO,2022,1080,1130,2210,22
BUTEBO,2023,1110,1150,2260,22
BUTEBO,2024,1130,1160,2290,22
BUTEBO,2025,1150,1160,2310,22
BUVUMA,2015,960,1000,1960,22
BUVUMA,2016,1030,1070,2100,22
BUVUMA,2017,1090,1150,2240,22
BUVUMA,2018,1150,1220,2370,22
BUVUMA,2019,1220,1310,2530,22
BUVUMA,2020,1300,1390,2690,22
BUVUMA,2021,1380,1480,2860,22
BUVUMA,2022,1460,1580,3040,22
BUVUMA,2023,1540,1680,3220,22
BUVUMA,2024,1630,1790,3420,22
BUVUMA,2025,1720,1900,3620,22
BUYENDE,2015,2330,2860,5190,22
BUYENDE,2016,2490,2970,5460,22
BUYENDE,2017,2660,3060,5720,22
BUYENDE,2018,2840,3160,6000,22
BUYENDE,2019,3030,3280,6310,22
BUYENDE,2020,3230,3450,6680,22
BUYENDE,2021,3450,3640,7090,22
BUYENDE,2022,3680,3830,7510,22
BUYENDE,2023,3900,4020,7920,22
BUYENDE,2024,4100,4180,8280,22
BUYENDE,2025,4280,4320,8600,22
DOKOLO,2015,1480,1730,3210,22
DOKOLO,2016,1530,1780,3310,22
DOKOLO,2017,1580,1830,3410,22
DOKOLO,2018,1620,1880,3500,22
DOKOLO,2019,1670,1930,3600,22
DOKOLO,2020,1720,1980,3700,22
DOKOLO,2021,1770,2030,3800,22
DOKOLO,2022,1820,2080,3900,22
DOKOLO,2023,1870,2130,4000,22
DOKOLO,2024,1920,2180,4100,22
DOKOLO,2025,1960,2230,4190,22
GOMBA,2015,1190,1210,2400,22
GOMBA,2016,1240,1210,2450,22
GOMBA,2017,1290,1210,2500,22
GOMBA,2018,1340,1220,2560,22
GOMBA,2019,1400,1220,2620,22
GOMBA,2020,1450,1250,2700,22
GOMBA,2021,1510,1280,2790,22
GOMBA,2022,1560,1300,2860,22
GOMBA,2023,1610,1330,2940,22
GOMBA,2024,1650,1340,2990,22
GOMBA,2025,1680,1340,3020,22
GULU,2015,2910,3340,6250,22
GULU,2016,3000,3440,6440,22
GULU,2017,3090,3540,6630,22
GULU,2018,3180,3640,6820,22
GULU,2019,3280,3740,7020,22
GULU,2020,3370,3840,7210,22
GULU,2021,3470,3950,7420,22
GULU,2022,3560,4050,7610,22
GULU,2023,3650,4160,7810,22
GULU,2024,3750,4260,8010,22
GULU,2025,3840,4360,8200,22
HOIMA,2015,3060,3510,6570,22
HOIMA,2016,3180,3630,6810,22
HOIMA,2017,3300,3760,7060,22
HOIMA,2018,3420,3890,7310,22
HOIMA,2019,3550,4020,7570,22
HOIMA,2020,3680,4150,7830,22
HOIMA,2021,3800,4290,8090,22
HOIMA,2022,3940,4420,8360,22
HOIMA,2023,4070,4560,8630,22
HOIMA,2024,4200,4700,8900,22
HOIMA,2025,4340,4840,9180,22
IBANDA,2015,2230,2550,4780,22
IBANDA,2016,2270,2600,4870,22
IBANDA,2017,2320,2650,4970,22
IBANDA,2018,2360,2690,5050,22
IBANDA,2019,2410,2740,5150,22
IBANDA,2020,2450,2780,5230,22
IBANDA,2021,2500,2830,5330,22
IBANDA,2022,2540,2870,5410,22
IBANDA,2023,2580,2910,5490,22
IBANDA,2024,2620,2960,5580,22
IBANDA,2025,2650,2990,5640,22
IGANGA,2015,2600,3570,6170,22
IGANGA,2016,2760,3650,6410,22
IGANGA,2017,2910,3710,6620,22
IGANGA,2018,3060,3780,6840,22
IGANGA,2019,3230,3880,7110,22
IGANGA,2020,3400,4020,7420,22
IGANGA,2021,3590,4170,7760,22
IGANGA,2022,3770,4330,8100,22
IGANGA,2023,3940,4480,8420,22
IGANGA,2024,4100,4600,8700,22
IGANGA,2025,4220,4680,8900,22
ISINGIRO,2015,3820,4500,8320,22
ISINGIRO,2016,3960,4660,8620,22
ISINGIRO,2017,4110,4820,8930,22
ISINGIRO,2018,4260,4990,9250,22
ISINGIRO,2019,4410,5160,9570,22
ISINGIRO,2020,4570,5340,9910,22
ISINGIRO,2021,4730,5510,10240,22
ISINGIRO,2022,4900,5690,10590,22
ISINGIRO,2023,5060,5870,10930,22
ISINGIRO,2024,5230,6060,11290,22
ISINGIRO,2025,5390,6240,11630,22
JINJA,2015,4870,5720,10590,22
JINJA,2016,4950,5810,10760,22
JINJA,2017,5040,5890,10930,22
JINJA,2018,5120,5980,11100,22
JINJA,2019,5200,6070,11270,22
JINJA,2020,5280,6150,11430,22
JINJA,2021,5360,6240,11600,22
JINJA,2022,5430,6320,11750,22
JINJA,2023,5500,6390,11890,22
JINJA,2024,5570,6460,12030,22
JINJA,2025,5630,6530,12160,22
KAABONG,2015,620,1150,1770,22
KAABONG,2016,640,1180,1820,22
KAABONG,2017,660,1210,1870,22
KAABONG,2018,670,1230,1900,22
KAABONG,2019,690,1260,1950,22
KAABONG,2020,710,1290,2000,22
KAABONG,2021,730,1320,2050,22
KAABONG,2022,740,1350,2090,22
KAABONG,2023,760,1370,2130,22
KAABONG,2024,780,1400,2180,22
KAABONG,2025,800,1430,2230,22
KABALE,2015,2150,2490,4640,22
KABALE,2016,2190,2520,4710,22
KABALE,2017,2220,2550,4770,22
KABALE,2018,2260,2580,4840,22
KABALE,2019,2290,2610,4900,22
KABALE,2020,2320,2630,4950,22
KABALE,2021,2350,2660,5010,22
KABALE,2022,2380,2690,5070,22
KABALE,2023,2410,2710,5120,22
KABALE,2024,2440,2730,5170,22
KABALE,2025,2460,2750,5210,22
KABAROLE,2015,3180,3300,6480,22
KABAROLE,2016,3250,3370,6620,22
KABAROLE,2017,3320,3440,6760,22
KABAROLE,2018,3400,3510,6910,22
KABAROLE,2019,3470,3590,7060,22
KABAROLE,2020,3540,3660,7200,22
KABAROLE,2021,3610,3730,7340,22
KABAROLE,2022,3680,3800,7480,22
KABAROLE,2023,3740,3870,7610,22
KABAROLE,2024,3810,3940,7750,22
KABAROLE,2025,3870,4010,7880,22
KABERAMAIDO,2015,870,930,1800,22
KABERAMAIDO,2016,930,960,1890,22
KABERAMAIDO,2017,980,990,1970,22
KABERAMAIDO,2018,1050,1020,2070,22
KABERAMAIDO,2019,1120,1050,2170,22
KABERAMAIDO,2020,1190,1100,2290,22
KABERAMAIDO,2021,1270,1160,2430,22
KABERAMAIDO,2022,1340,1220,2560,22
KABERAMAIDO,2023,1430,1270,2700,22
KABERAMAIDO,2024,1500,1320,2820,22
KABERAMAIDO,2025,1560,1360,2920,22
KAGADI,2015,3050,3500,6550,22
KAGADI,2016,3170,3620,6790,22
KAGADI,2017,3290,3750,7040,22
KAGADI,2018,3410,3880,7290,22
KAGADI,2019,3530,4010,7540,22
KAGADI,2020,3650,4150,7800,22
KAGADI,2021,3780,4290,8070,22
KAGADI,2022,3910,4430,8340,22
KAGADI,2023,4040,4570,8610,22
KAGADI,2024,4170,4710,8880,22
KAGADI,2025,4310,4850,9160,22
KAKUMIRO,2015,2790,3120,5910,22
KAKUMIRO,2016,3040,3390,6430,22
KAKUMIRO,2017,3310,3670,6980,22
KAKUMIRO,2018,3600,3980,7580,22
KAKUMIRO,2019,3920,4310,8230,22
KAKUMIRO,2020,4260,4670,8930,22
KAKUMIRO,2021,4620,5050,9670,22
KAKUMIRO,2022,5020,5460,10480,22
KAKUMIRO,2023,5440,5900,11340,22
KAKUMIRO,2024,5900,6370,12270,22
KAKUMIRO,2025,6380,6880,13260,22
KALAKI,2015,850,980,1830,22
KALAKI,2016,890,1020,1910,22
KALAKI,2017,930,1050,1980,22
KALAKI,2018,970,1100,2070,22
KALAKI,2019,1010,1140,2150,22
KALAKI,2020,1050,1180,2230,22
KALAKI,2021,1100,1230,2330,22
KALAKI,2022,1140,1270,2410,22
KALAKI,2023,1190,1320,2510,22
KALAKI,2024,1230,1360,2590,22
KALAKI,2025,1280,1410,2690,22
KALANGALA,2015,860,670,1530,22
KALANGALA,2016,890,700,1590,22
KALANGALA,2017,920,730,1650,22
KALANGALA,2018,950,760,1710,22
KALANGALA,2019,990,790,1780,22
KALANGALA,2020,1020,820,1840,22
KALANGALA,2021,1050,850,1900,22
KALANGALA,2022,1090,890,1980,22
KALANGALA,2023,1120,920,2040,22
KALANGALA,2024,1160,950,2110,22
KALANGALA,2025,1190,990,2180,22
KALIRO,2015,1720,1990,3710,22
KALIRO,2016,1830,2060,3890,22
KALIRO,2017,1930,2100,4030,22
KALIRO,2018,2040,2150,4190,22
KALIRO,2019,2160,2220,4380,22
KALIRO,2020,2290,2310,4600,22
KALIRO,2021,2420,2420,4840,22
KALIRO,2022,2550,2530,5080,22
KALIRO,2023,2690,2630,5320,22
KALIRO,2024,2800,2720,5520,22
KALIRO,2025,2890,2780,5670,22
KALUNGU,2015,1280,1470,2750,22
KALUNGU,2016,1320,1460,2780,22
KALUNGU,2017,1370,1470,2840,22
KALUNGU,2018,1410,1460,2870,22
KALUNGU,2019,1460,1480,2940,22
KALUNGU,2020,1510,1500,3010,22
KALUNGU,2021,1560,1530,3090,22
KALUNGU,2022,1610,1560,3170,22
KALUNGU,2023,1650,1580,3230,22
KALUNGU,2024,1680,1600,3280,22
KALUNGU,2025,1690,1600,3290,22
KAMPALA,2015,22220,29300,51520,22
KAMPALA,2016,22670,29880,52550,22
KAMPALA,2017,23110,30450,53560,22
KAMPALA,2018,23560,31030,54590,22
KAMPALA,2019,24000,31610,55610,22
KAMPALA,2020,24440,32180,56620,22
KAMPALA,2021,24870,32730,57600,22
KAMPALA,2022,25290,33280,58570,22
KAMPALA,2023,25690,33820,59510,22
KAMPALA,2024,26080,34340,60420,22
KAMPALA,2025,26460,34840,61300,22
KAMULI,2015,3430,4270,7700,22
KAMULI,2016,3610,4340,7950,22
KAMULI,2017,3790,4380,8170,22
KAMULI,2018,3970,4440,8410,22
KAMULI,2019,4160,4530,8690,22
KAMULI,2020,4370,4660,9030,22
KAMULI,2021,4570,4820,9390,22
KAMULI,2022,4780,4970,9750,22
KAMULI,2023,4980,5110,10090,22
KAMULI,2024,5150,5220,10370,22
KAMULI,2025,5270,5280,10550,22
KAMWENGE,2015,2270,2770,5040,22
KAMWENGE,2016,2360,2870,5230,22
KAMWENGE,2017,2450,2970,5420,22
KAMWENGE,2018,2550,3080,5630,22
KAMWENGE,2019,2660,3180,5840,22
KAMWENGE,2020,2760,3290,6050,22
KAMWENGE,2021,2870,3400,6270,22
KAMWENGE,2022,2970,3510,6480,22
KAMWENGE,2023,3080,3630,6710,22
KAMWENGE,2024,3190,3740,6930,22
KAMWENGE,2025,3310,3860,7170,22
KANUNGU,2015,2020,2440,4460,22
KANUNGU,2016,2060,2480,4540,22
KANUNGU,2017,2100,2520,4620,22
KANUNGU,2018,2130,2560,4690,22
KANUNGU,2019,2170,2600,4770,22
KANUNGU,2020,2200,2640,4840,22
KANUNGU,2021,2240,2670,4910,22
KANUNGU,2022,2270,2710,4980,22
KANUNGU,2023,2310,2750,5060,22
KANUNGU,2024,2340,2780,5120,22
KANUNGU,2025,2370,2810,5180,22
KAPCHORWA,2015,940,1110,2050,22
KAPCHORWA,2016,970,1140,2110,22
KAPCHORWA,2017,1000,1170,2170,22
KAPCHORWA,2018,1030,1200,2230,22
KAPCHORWA,2019,1060,1230,2290,22
KAPCHORWA,2020,1090,1260,2350,22
KAPCHORWA,2021,1120,1300,2420,22
KAPCHORWA,2022,1150,1330,2480,22
KAPCHORWA,2023,1180,1360,2540,22
KAPCHORWA,2024,1210,1390,2600,22
KAPCHORWA,2025,1240,1430,2670,22
KAPELEBYONG,2015,740,750,1490,22
KAPELEBYONG,2016,790,770,1560,22
KAPELEBYONG,2017,840,780,1620,22
KAPELEBYONG,2018,870,790,1660,22
KAPELEBYONG,2019,930,820,1750,22
KAPELEBYONG,2020,980,840,1820,22
KAPELEBYONG,2021,1020,870,1890,22
KAPELEBYONG,2022,1080,900,1980,22
KAPELEBYONG,2023,1130,940,2070,22
KAPELEBYONG,2024,1170,960,2130,22
KAPELEBYONG,2025,1210,980,2190,22
KASESE,2015,5930,7180,13110,22
KASESE,2016,6220,7280,13500,22
KASESE,2017,6520,7350,13870,22
KASESE,2018,6820,7450,14270,22
KASESE,2019,7140,7590,14730,22
KASESE,2020,7470,7810,15280,22
KASESE,2021,7820,8060,15880,22
KASESE,2022,8170,8330,16500,22
KASESE,2023,8490,8550,17040,22
KASESE,2024,8760,8730,17490,22
KASESE,2025,8950,8830,17780,22
KASSANDA,2015,2630,2790,5420,22
KASSANDA,2016,2700,2850,5550,22
KASSANDA,2017,2780,2910,5690,22
KASSANDA,2018,2860,2980,5840,22
KASSANDA,2019,2940,3040,5980,22
KASSANDA,2020,3020,3100,6120,22
KASSANDA,2021,3100,3160,6260,22
KASSANDA,2022,3180,3220,6400,22
KASSANDA,2023,3250,3280,6530,22
KASSANDA,2024,3330,3330,6660,22
KASSANDA,2025,3410,3390,6800,22
KATAKWI,2015,1470,1520,2990,22
KATAKWI,2016,1550,1550,3100,22
KATAKWI,2017,1630,1570,3200,22
KATAKWI,2018,1720,1600,3320,22
KATAKWI,2019,1810,1630,3440,22
KATAKWI,2020,1900,1680,3580,22
KATAKWI,2021,2000,1740,3740,22
KATAKWI,2022,2100,1810,3910,22
KATAKWI,2023,2200,1870,4070,22
KATAKWI,2024,2270,1910,4180,22
KATAKWI,2025,2330,1940,4270,22
KAYUNGA,2015,2500,3180,5680,22
KAYUNGA,2016,2610,3210,5820,22
KAYUNGA,2017,2730,3220,5950,22
KAYUNGA,2018,2840,3240,6080,22
KAYUNGA,2019,2960,3290,6250,22
KAYUNGA,2020,3090,3370,6460,22
KAYUNGA,2021,3220,3460,6680,22
KAYUNGA,2022,3340,3550,6890,22
KAYUNGA,2023,3450,3630,7080,22
KAYUNGA,2024,3540,3680,7220,22
KAYUNGA,2025,3610,3690,7300,22
KAZO,2015,1450,1580,3030,22
KAZO,2016,1500,1640,3140,22
KAZO,2017,1560,1700,3260,22
KAZO,2018,1620,1760,3380,22
KAZO,2019,1680,1820,3500,22
KAZO,2020,1740,1880,3620,22
KAZO,2021,1800,1940,3740,22
KAZO,2022,1860,2000,3860,22
KAZO,2023,1930,2070,4000,22
KAZO,2024,1990,2140,4130,22
KAZO,2025,2060,2200,4260,22
KIBAALE,2015,1300,1520,2820,22
KIBAALE,2016,1380,1610,2990,22
KIBAALE,2017,1470,1700,3170,22
KIBAALE,2018,1560,1800,3360,22
KIBAALE,2019,1660,1900,3560,22
KIBAALE,2020,1760,2010,3770,22
KIBAALE,2021,1870,2120,3990,22
KIBAALE,2022,1980,2240,4220,22
KIBAALE,2023,2100,2360,4460,22
KIBAALE,2024,2220,2490,4710,22
KIBAALE,2025,2350,2620,4970,22
KIBOGA,2015,1440,1350,2790,22
KIBOGA,2016,1510,1370,2880,22
KIBOGA,2017,1600,1390,2990,22
KIBOGA,2018,1670,1410,3080,22
KIBOGA,2019,1750,1440,3190,22
KIBOGA,2020,1840,1480,3320,22
KIBOGA,2021,1920,1530,3450,22
KIBOGA,2022,2020,1590,3610,22
KIBOGA,2023,2100,1630,3730,22
KIBOGA,2024,2170,1670,3840,22
KIBOGA,2025,2230,1690,3920,22
KIBUKU,2015,1500,1870,3370,22
KIBUKU,2016,1600,1920,3520,22
KIBUKU,2017,1690,1970,3660,22
KIBUKU,2018,1790,2030,3820,22
KIBUKU,2019,1900,2100,4000,22
KIBUKU,2020,2020,2190,4210,22
KIBUKU,2021,2150,2280,4430,22
KIBUKU,2022,2270,2400,4670,22
KIBUKU,2023,2400,2500,4900,22
KIBUKU,2024,2500,2590,5090,22
KIBUKU,2025,2590,2650,5240,22
KIKUUBE,2015,2520,2730,5250,22
KIKUUBE,2016,2660,2870,5530,22
KIKUUBE,2017,2800,3020,5820,22
KIKUUBE,2018,2950,3170,6120,22
KIKUUBE,2019,3100,3330,6430,22
KIKUUBE,2020,3260,3490,6750,22
KIKUUBE,2021,3430,3660,7090,22
KIKUUBE,2022,3600,3840,7440,22
KIKUUBE,2023,3780,4020,7800,22
KIKUUBE,2024,3970,4210,8180,22
KIKUUBE,2025,4160,4400,8560,22
KIRUHURA,2015,1520,1480,3000,22
KIRUHURA,2016,1580,1530,3110,22
KIRUHURA,2017,1640,1580,3220,22
KIRUHURA,2018,1700,1640,3340,22
KIRUHURA,2019,1760,1690,3450,22
KIRUHURA,2020,1830,1750,3580,22
KIRUHURA,2021,1890,1810,3700,22
KIRUHURA,2022,1960,1870,3830,22
KIRUHURA,2023,2030,1930,3960,22
KIRUHURA,2024,2090,1990,4080,22
KIRUHURA,2025,2160,2050,4210,22
KIRYANDONGO,2015,2470,2660,5130,22
KIRYANDONGO,2016,2610,2710,5320,22
KIRYANDONGO,2017,2760,2750,5510,22
KIRYANDONGO,2018,2910,2800,5710,22
KIRYANDONGO,2019,3060,2870,5930,22
KIRYANDONGO,2020,3210,2960,6170,22
KIRYANDONGO,2021,3390,3080,6470,22
KIRYANDONGO,2022,3550,3190,6740,22
KIRYANDONGO,2023,3720,3290,7010,22
KIRYANDONGO,2024,3860,3380,7240,22
KIRYANDONGO,2025,3970,3430,7400,22
KISORO,2015,1730,2920,4650,22
KISORO,2016,1810,2960,4770,22
KISORO,2017,1880,2980,4860,22
KISORO,2018,1960,3010,4970,22
KISORO,2019,2040,3070,5110,22
KISORO,2020,2120,3150,5270,22
KISORO,2021,2220,3240,5460,22
KISORO,2022,2300,3330,5630,22
KISORO,2023,2380,3420,5800,22
KISORO,2024,2450,3480,5930,22
KISORO,2025,2490,3520,6010,22
KITAGWENDA,2015,1110,1380,2490,22
KITAGWENDA,2016,1160,1430,2590,22
KITAGWENDA,2017,1200,1480,2680,22
KITAGWENDA,2018,1250,1530,2780,22
KITAGWENDA,2019,1300,1590,2890,22
KITAGWENDA,2020,1350,1640,2990,22
KITAGWENDA,2021,1400,1700,3100,22
KITAGWENDA,2022,1460,1760,3220,22
KITAGWENDA,2023,1510,1810,3320,22
KITAGWENDA,2024,1560,1870,3430,22
KITAGWENDA,2025,1620,1920,3540,22
KITGUM,2015,1640,1890,3530,22
KITGUM,2016,1710,1900,3610,22
KITGUM,2017,1780,1910,3690,22
KITGUM,2018,1840,1920,3760,22
KITGUM,2019,1900,1950,3850,22
KITGUM,2020,1980,1990,3970,22
KITGUM,2021,2060,2040,4100,22
KITGUM,2022,2120,2090,4210,22
KITGUM,2023,2200,2140,4340,22
KITGUM,2024,2240,2170,4410,22
KITGUM,2025,2290,2180,4470,22
KOBOKO,2015,1870,2070,3940,22
KOBOKO,2016,2000,2130,4130,22
KOBOKO,2017,2130,2200,4330,22
KOBOKO,2018,2260,2250,4510,22
KOBOKO,2019,2400,2330,4730,22
KOBOKO,2020,2550,2440,4990,22
KOBOKO,2021,2710,2560,5270,22
KOBOKO,2022,2870,2690,5560,22
KOBOKO,2023,3030,2800,5830,22
KOBOKO,2024,3180,2900,6080,22
KOBOKO,2025,3290,2990,6280,22
KOLE,2015,1960,2250,4210,22
KOLE,2016,2030,2310,4340,22
KOLE,2017,2090,2380,4470,22
KOLE,2018,2160,2450,4610,22
KOLE,2019,2230,2510,4740,22
KOLE,2020,2300,2580,4880,22
KOLE,2021,2370,2650,5020,22
KOLE,2022,2440,2720,5160,22
KOLE,2023,2510,2790,5300,22
KOLE,2024,2580,2860,5440,22
KOLE,2025,2650,2930,5580,22
KOTIDO,2015,1480,1650,3130,22
KOTIDO,2016,1550,1670,3220,22
KOTIDO,2017,1630,1690,3320,22
KOTIDO,2018,1710,1710,3420,22
KOTIDO,2019,1790,1750,3540,22
KOTIDO,2020,1870,1790,3660,22
KOTIDO,2021,1960,1850,3810,22
KOTIDO,2022,2040,1910,3950,22
KOTIDO,2023,2130,1960,4090,22
KOTIDO,2024,2200,2000,4200,22
KOTIDO,2025,2240,2020,4260,22
KUMI,2015,1830,2140,3970,22
KUMI,2016,1940,2190,4130,22
KUMI,2017,2040,2220,4260,22
KUMI,2018,2160,2270,4430,22
KUMI,2019,2270,2320,4590,22
KUMI,2020,2400,2410,4810,22
KUMI,2021,2530,2510,5040,22
KUMI,2022,2660,2610,5270,22
KUMI,2023,2780,2690,5470,22
KUMI,2024,2890,2770,5660,22
KUMI,2025,2980,2820,5800,22
KWANIA,2015,1590,1820,3410,22
KWANIA,2016,1640,1880,3520,22
KWANIA,2017,1700,1930,3630,22
KWANIA,2018,1750,1980,3730,22
KWANIA,2019,1800,2040,3840,22
KWANIA,2020,1850,2090,3940,22
KWANIA,2021,1910,2150,4060,22
KWANIA,2022,1960,2200,4160,22
KWANIA,2023,2010,2260,4270,22
KWANIA,2024,2070,2310,4380,22
KWANIA,2025,2120,2370,4490,22
KWEEN,2015,870,910,1780,22
KWEEN,2016,900,930,1830,22
KWEEN,2017,920,950,1870,22
KWEEN,2018,950,980,1930,22
KWEEN,2019,980,1000,1980,22
KWEEN,2020,1010,1020,2030,22
KWEEN,2021,1040,1050,2090,22
KWEEN,2022,1070,1070,2140,22
KWEEN,2023,1100,1090,2190,22
KWEEN,2024,1130,1120,2250,22
KWEEN,2025,1160,1140,2300,22
KYANKWANZI,2015,2310,2260,4570,22
KYANKWANZI,2016,2430,2370,4800,22
KYANKWANZI,2017,2560,2480,5040,22
KYANKWANZI,2018,2690,2590,5280,22
KYANKWANZI,2019,2820,2710,5530,22
KYANKWANZI,2020,2960,2830,5790,22
KYANKWANZI,2021,3110,2960,6070,22
KYANKWANZI,2022,3260,3090,6350,22
KYANKWANZI,2023,3410,3230,6640,22
KYANKWANZI,2024,3570,3360,6930,22
KYANKWANZI,2025,3740,3500,7240,22
KYEGEGWA,2015,2650,3040,5690,22
KYEGEGWA,2016,2860,3290,6150,22
KYEGEGWA,2017,3100,3550,6650,22
KYEGEGWA,2018,3350,3820,7170,22
KYEGEGWA,2019,3630,4120,7750,22
KYEGEGWA,2020,3920,4440,8360,22
KYEGEGWA,2021,4230,4780,9010,22
KYEGEGWA,2022,4560,5150,9710,22
KYEGEGWA,2023,4920,5540,10460,22
KYEGEGWA,2024,5300,5950,11250,22
KYEGEGWA,2025,5710,6390,12100,22
KYENJOJO,2015,3880,4180,8060,22
KYENJOJO,2016,4040,4330,8370,22
KYENJOJO,2017,4210,4490,8700,22
KYENJOJO,2018,4380,4660,9040,22
KYENJOJO,2019,4560,4820,9380,22
KYENJOJO,2020,4740,4990,9730,22
KYENJOJO,2021,4920,5170,10090,22
KYENJOJO,2022,5110,5350,10460,22
KYENJOJO,2023,5300,5520,10820,22
KYENJOJO,2024,5490,5710,11200,22
KYENJOJO,2025,5680,5890,11570,22
KYOTERA,2015,1660,2150,3810,22
KYOTERA,2016,1730,2160,3890,22
KYOTERA,2017,1800,2170,3970,22
KYOTERA,2018,1860,2180,4040,22
KYOTERA,2019,1940,2200,4140,22
KYOTERA,2020,2010,2250,4260,22
KYOTERA,2021,2080,2290,4370,22
KYOTERA,2022,2160,2350,4510,22
KYOTERA,2023,2220,2400,4620,22
KYOTERA,2024,2280,2430,4710,22
KYOTERA,2025,2310,2430,4740,22
KARENGA,2015,490,460,950,22
KARENGA,2016,510,470,980,22
KARENGA,2017,520,480,1000,22
KARENGA,2018,540,490,1030,22
KARENGA,2019,550,510,1060,22
KARENGA,2020,560,520,1080,22
KARENGA,2021,570,530,1100,22
KARENGA,2022,590,540,1130,22
KARENGA,2023,600,550,1150,22
KARENGA,2024,620,560,1180,22
KARENGA,2025,630,570,1200,22
LAMWO,2015,950,1190,2140,22
LAMWO,2016,980,1200,2180,22
LAMWO,2017,1010,1200,2210,22
LAMWO,2018,1040,1210,2250,22
LAMWO,2019,1060,1220,2280,22
LAMWO,2020,1100,1240,2340,22
LAMWO,2021,1140,1280,2420,22
LAMWO,2022,1170,1310,2480,22
LAMWO,2023,1200,1340,2540,22
LAMWO,2024,1220,1350,2570,22
LAMWO,2025,1230,1360,2590,22
LIRA,2015,3830,4560,8390,22
LIRA,2016,3940,4690,8630,22
LIRA,2017,4050,4830,8880,22
LIRA,2018,4160,4960,9120,22
LIRA,2019,4270,5100,9370,22
LIRA,2020,4390,5240,9630,22
LIRA,2021,4500,5380,9880,22
LIRA,2022,4610,5520,10130,22
LIRA,2023,4720,5650,10370,22
LIRA,2024,4830,5790,10620,22
LIRA,2025,4940,5930,10870,22
LUUKA,2015,1630,2100,3730,22
LUUKA,2016,1710,2120,3830,22
LUUKA,2017,1780,2140,3920,22
LUUKA,2018,1850,2170,4020,22
LUUKA,2019,1940,2200,4140,22
LUUKA,2020,2010,2260,4270,22
LUUKA,2021,2100,2320,4420,22
LUUKA,2022,2180,2390,4570,22
LUUKA,2023,2270,2450,4720,22
LUUKA,2024,2330,2500,4830,22
LUUKA,2025,2370,2520,4890,22
LUWERO,2015,3980,4610,8590,22
LUWERO,2016,4180,4670,8850,22
LUWERO,2017,4390,4730,9120,22
LUWERO,2018,4590,4790,9380,22
LUWERO,2019,4810,4890,9700,22
LUWERO,2020,5040,5030,10070,22
LUWERO,2021,5270,5200,10470,22
LUWERO,2022,5510,5360,10870,22
LUWERO,2023,5740,5520,11260,22
LUWERO,2024,5920,5630,11550,22
LUWERO,2025,6060,5690,11750,22
LWENGO,2015,1690,2170,3860,22
LWENGO,2016,1750,2170,3920,22
LWENGO,2017,1810,2170,3980,22
LWENGO,2018,1860,2170,4030,22
LWENGO,2019,1930,2180,4110,22
LWENGO,2020,1990,2210,4200,22
LWENGO,2021,2050,2260,4310,22
LWENGO,2022,2110,2300,4410,22
LWENGO,2023,2160,2330,4490,22
LWENGO,2024,2210,2350,4560,22
LWENGO,2025,2230,2340,4570,22
LYANTONDE,2015,890,980,1870,22
LYANTONDE,2016,940,1000,1940,22
LYANTONDE,2017,980,1020,2000,22
LYANTONDE,2018,1030,1040,2070,22
LYANTONDE,2019,1090,1060,2150,22
LYANTONDE,2020,1140,1100,2240,22
LYANTONDE,2021,1200,1140,2340,22
LYANTONDE,2022,1260,1190,2450,22
LYANTONDE,2023,1320,1230,2550,22
LYANTONDE,2024,1370,1260,2630,22
LYANTONDE,2025,1410,1270,2680,22
MANAFWA,2015,1170,1360,2530,22
MANAFWA,2016,1200,1390,2590,22
MANAFWA,2017,1230,1420,2650,22
MANAFWA,2018,1260,1450,2710,22
MANAFWA,2019,1290,1480,2770,22
MANAFWA,2020,1320,1520,2840,22
MANAFWA,2021,1350,1550,2900,22
MANAFWA,2022,1380,1580,2960,22
MANAFWA,2023,1410,1610,3020,22
MANAFWA,2024,1440,1640,3080,22
MANAFWA,2025,1470,1660,3130,22
MARACHA,2015,1280,1820,3100,22
MARACHA,2016,1310,1860,3170,22
MARACHA,2017,1330,1890,3220,22
MARACHA,2018,1360,1930,3290,22
MARACHA,2019,1390,1960,3350,22
MARACHA,2020,1410,2000,3410,22
MARACHA,2021,1440,2040,3480,22
MARACHA,2022,1470,2070,3540,22
MARACHA,2023,1490,2100,3590,22
MARACHA,2024,1520,2130,3650,22
MARACHA,2025,1540,2170,3710,22
MASAKA,2015,2500,3200,5700,22
MASAKA,2016,2620,3230,5850,22
MASAKA,2017,2750,3260,6010,22
MASAKA,2018,2860,3300,6160,22
MASAKA,2019,2990,3360,6350,22
MASAKA,2020,3120,3450,6570,22
MASAKA,2021,3260,3550,6810,22
MASAKA,2022,3400,3670,7070,22
MASAKA,2023,3530,3760,7290,22
MASAKA,2024,3630,3830,7460,22
MASAKA,2025,3710,3860,7570,22
MASINDI,2015,3150,3150,6300,22
MASINDI,2016,3240,3230,6470,22
MASINDI,2017,3340,3320,6660,22
MASINDI,2018,3430,3410,6840,22
MASINDI,2019,3530,3490,7020,22
MASINDI,2020,3630,3580,7210,22
MASINDI,2021,3720,3670,7390,22
MASINDI,2022,3820,3760,7580,22
MASINDI,2023,3920,3850,7770,22
MASINDI,2024,4020,3930,7950,22
MASINDI,2025,4110,4020,8130,22
MAYUGE,2015,3640,4770,8410,22
MAYUGE,2016,3850,4880,8730,22
MAYUGE,2017,4060,4970,9030,22
MAYUGE,2018,4280,5080,9360,22
MAYUGE,2019,4510,5220,9730,22
MAYUGE,2020,4750,5410,10160,22
MAYUGE,2021,5010,5630,10640,22
MAYUGE,2022,5260,5860,11120,22
MAYUGE,2023,5510,6070,11580,22
MAYUGE,2024,5720,6240,11960,22
MAYUGE,2025,5890,6370,12260,22
MBALE,2015,4830,6100,10930,22
MBALE,2016,5110,6260,11370,22
MBALE,2017,5380,6400,11780,22
MBALE,2018,5670,6550,12220,22
MBALE,2019,5960,6750,12710,22
MBALE,2020,6280,7010,13290,22
MBALE,2021,6600,7320,13920,22
MBALE,2022,6940,7640,14580,22
MBALE,2023,7260,7930,15190,22
MBALE,2024,7540,8180,15720,22
MBALE,2025,7740,8360,16100,22
MBARARA,2015,4130,4770,8900,22
MBARARA,2016,4230,4880,9110,22
MBARARA,2017,4320,4980,9300,22
MBARARA,2018,4420,5090,9510,22
MBARARA,2019,4520,5200,9720,22
MBARARA,2020,4620,5300,9920,22
MBARARA,2021,4710,5400,10110,22
MBARARA,2022,4800,5500,10300,22
MBARARA,2023,4900,5600,10500,22
MBARARA,2024,4990,5700,10690,22
MBARARA,2025,5080,5800,10880,22
MITOOMA,2015,1240,1680,2920,22
MITOOMA,2016,1260,1690,2950,22
MITOOMA,2017,1270,1710,2980,22
MITOOMA,2018,1290,1720,3010,22
MITOOMA,2019,1300,1740,3040,22
MITOOMA,2020,1320,1750,3070,22
MITOOMA,2021,1330,1760,3090,22
MITOOMA,2022,1340,1770,3110,22
MITOOMA,2023,1350,1790,3140,22
MITOOMA,2024,1360,1800,3160,22
MITOOMA,2025,1370,1800,3170,22
MITYANA,2015,2680,3070,5750,22
MITYANA,2016,2810,3090,5900,22
MITYANA,2017,2920,3110,6030,22
MITYANA,2018,3030,3130,6160,22
MITYANA,2019,3160,3170,6330,22
MITYANA,2020,3290,3240,6530,22
MITYANA,2021,3420,3320,6740,22
MITYANA,2022,3550,3410,6960,22
MITYANA,2023,3670,3480,7150,22
MITYANA,2024,3760,3530,7290,22
MITYANA,2025,3830,3550,7380,22
MOROTO,2015,680,950,1630,22
MOROTO,2016,710,960,1670,22
MOROTO,2017,740,980,1720,22
MOROTO,2018,770,990,1760,22
MOROTO,2019,810,1020,1830,22
MOROTO,2020,850,1040,1890,22
MOROTO,2021,880,1080,1960,22
MOROTO,2022,920,1120,2040,22
MOROTO,2023,960,1160,2120,22
MOROTO,2024,980,1180,2160,22
MOROTO,2025,1010,1190,2200,22
MOYO,2015,850,880,1730,22
MOYO,2016,870,900,1770,22
MOYO,2017,890,920,1810,22
MOYO,2018,910,940,1850,22
MOYO,2019,940,960,1900,22
MOYO,2020,960,980,1940,22
MOYO,2021,980,1000,1980,22
MOYO,2022,1000,1020,2020,22
MOYO,2023,1030,1040,2070,22
MOYO,2024,1050,1060,2110,22
MOYO,2025,1070,1080,2150,22
MPIGI,2015,1980,2330,4310,22
MPIGI,2016,2080,2360,4440,22
MPIGI,2017,2180,2390,4570,22
MPIGI,2018,2270,2410,4680,22
MPIGI,2019,2380,2470,4850,22
MPIGI,2020,2490,2530,5020,22
MPIGI,2021,2610,2620,5230,22
MPIGI,2022,2720,2720,5440,22
MPIGI,2023,2830,2790,5620,22
MPIGI,2024,2920,2840,5760,22
MPIGI,2025,2980,2880,5860,22
MUBENDE,2015,4050,4450,8500,22
MUBENDE,2016,4370,4650,9020,22
MUBENDE,2017,4720,4820,9540,22
MUBENDE,2018,5080,5030,10110,22
MUBENDE,2019,5450,5280,10730,22
MUBENDE,2020,5880,5570,11450,22
MUBENDE,2021,6310,5920,12230,22
MUBENDE,2022,6780,6300,13080,22
MUBENDE,2023,7250,6650,13900,22
MUBENDE,2024,7680,6980,14660,22
MUBENDE,2025,8080,7250,15330,22
MUKONO,2015,5450,6960,12410,22
MUKONO,2016,5740,7110,12850,22
MUKONO,2017,6040,7240,13280,22
MUKONO,2018,6330,7390,13720,22
MUKONO,2019,6640,7580,14220,22
MUKONO,2020,6980,7850,14830,22
MUKONO,2021,7310,8160,15470,22
MUKONO,2022,7660,8490,16150,22
MUKONO,2023,7980,8780,16760,22
MUKONO,2024,8260,9020,17280,22
MUKONO,2025,8470,9180,17650,22
MADI OKOLLO,2015,1200,1430,2630,22
MADI OKOLLO,2016,1230,1470,2700,22
MADI OKOLLO,2017,1280,1510,2790,22
MADI OKOLLO,2018,1310,1550,2860,22
MADI OKOLLO,2019,1350,1590,2940,22
MADI OKOLLO,2020,1390,1630,3020,22
MADI OKOLLO,2021,1420,1670,3090,22
MADI OKOLLO,2022,1460,1720,3180,22
MADI OKOLLO,2023,1500,1750,3250,22
MADI OKOLLO,2024,1530,1790,3320,22
MADI OKOLLO,2025,1570,1830,3400,22
NABILATUK,2015,470,560,1030,22
NABILATUK,2016,510,580,1090,22
NABILATUK,2017,550,600,1150,22
NABILATUK,2018,590,620,1210,22
NABILATUK,2019,630,650,1280,22
NABILATUK,2020,680,680,1360,22
NABILATUK,2021,730,720,1450,22
NABILATUK,2022,790,760,1550,22
NABILATUK,2023,840,800,1640,22
NABILATUK,2024,890,830,1720,22
NABILATUK,2025,940,860,1800,22
NAKAPIRIPIRIT,2015,630,740,1370,22
NAKAPIRIPIRIT,2016,680,780,1460,22
NAKAPIRIPIRIT,2017,720,800,1520,22
NAKAPIRIPIRIT,2018,780,830,1610,22
NAKAPIRIPIRIT,2019,830,850,1680,22
NAKAPIRIPIRIT,2020,880,900,1780,22
NAKAPIRIPIRIT,2021,940,950,1890,22
NAKAPIRIPIRIT,2022,1000,1000,2000,22
NAKAPIRIPIRIT,2023,1060,1050,2110,22
NAKAPIRIPIRIT,2024,1110,1090,2200,22
NAKAPIRIPIRIT,2025,1160,1130,2290,22
NAKASEKE,2015,2070,1750,3820,22
NAKASEKE,2016,2140,1790,3930,22
NAKASEKE,2017,2220,1830,4050,22
NAKASEKE,2018,2300,1880,4180,22
NAKASEKE,2019,2380,1920,4300,22
NAKASEKE,2020,2470,1960,4430,22
NAKASEKE,2021,2550,2010,4560,22
NAKASEKE,2022,2640,2050,4690,22
NAKASEKE,2023,2720,2090,4810,22
NAKASEKE,2024,2810,2130,4940,22
NAKASEKE,2025,2900,2170,5070,22
NAKASONGOLA,2015,1620,1710,3330,22
NAKASONGOLA,2016,1710,1740,3450,22
NAKASONGOLA,2017,1810,1760,3570,22
NAKASONGOLA,2018,1910,1800,3710,22
NAKASONGOLA,2019,2000,1840,3840,22
NAKASONGOLA,2020,2110,1900,4010,22
NAKASONGOLA,2021,2230,1970,4200,22
NAKASONGOLA,2022,2340,2050,4390,22
NAKASONGOLA,2023,2450,2120,4570,22
NAKASONGOLA,2024,2550,2160,4710,22
NAKASONGOLA,2025,2630,2200,4830,22
NAMAYINGO,2015,1660,2070,3730,22
NAMAYINGO,2016,1730,2090,3820,22
NAMAYINGO,2017,1800,2100,3900,22
NAMAYINGO,2018,1870,2110,3980,22
NAMAYINGO,2019,1950,2140,4090,22
NAMAYINGO,2020,2020,2180,4200,22
NAMAYINGO,2021,2100,2240,4340,22
NAMAYINGO,2022,2190,2290,4480,22
NAMAYINGO,2023,2270,2330,4600,22
NAMAYINGO,2024,2330,2370,4700,22
NAMAYINGO,2025,2360,2370,4730,22
NAMISINDWA,2015,1480,1830,3310,22
NAMISINDWA,2016,1530,1880,3410,22
NAMISINDWA,2017,1570,1920,3490,22
NAMISINDWA,2018,1610,1960,3570,22
NAMISINDWA,2019,1650,2010,3660,22
NAMISINDWA,2020,1700,2060,3760,22
NAMISINDWA,2021,1740,2100,3840,22
NAMISINDWA,2022,1790,2140,3930,22
NAMISINDWA,2023,1830,2190,4020,22
NAMISINDWA,2024,1870,2230,4100,22
NAMISINDWA,2025,1910,2270,4180,22
NAMUTUMBA,2015,1720,2190,3910,22
NAMUTUMBA,2016,1830,2240,4070,22
NAMUTUMBA,2017,1930,2290,4220,22
NAMUTUMBA,2018,2040,2340,4380,22
NAMUTUMBA,2019,2160,2410,4570,22
NAMUTUMBA,2020,2290,2500,4790,22
NAMUTUMBA,2021,2420,2610,5030,22
NAMUTUMBA,2022,2550,2730,5280,22
NAMUTUMBA,2023,2680,2830,5510,22
NAMUTUMBA,2024,2800,2910,5710,22
NAMUTUMBA,2025,2890,2980,5870,22
NAPAK,2015,840,1140,1980,22
NAPAK,2016,880,1150,2030,22
NAPAK,2017,910,1170,2080,22
NAPAK,2018,950,1180,2130,22
NAPAK,2019,980,1210,2190,22
NAPAK,2020,1020,1230,2250,22
NAPAK,2021,1060,1280,2340,22
NAPAK,2022,1100,1310,2410,22
NAPAK,2023,1130,1350,2480,22
NAPAK,2024,1160,1380,2540,22
NAPAK,2025,1170,1390,2560,22
NEBBI,2015,1880,2410,4290,22
NEBBI,2016,1940,2480,4420,22
NEBBI,2017,2000,2550,4550,22
NEBBI,2018,2060,2630,4690,22
NEBBI,2019,2130,2700,4830,22
NEBBI,2020,2190,2770,4960,22
NEBBI,2021,2250,2840,5090,22
NEBBI,2022,2320,2920,5240,22
NEBBI,2023,2390,2990,5380,22
NEBBI,2024,2450,3060,5510,22
NEBBI,2025,2510,3130,5640,22
NGORA,2015,1050,1340,2390,22
NGORA,2016,1110,1370,2480,22
NGORA,2017,1180,1380,2560,22
NGORA,2018,1230,1410,2640,22
NGORA,2019,1290,1440,2730,22
NGORA,2020,1360,1490,2850,22
NGORA,2021,1430,1540,2970,22
NGORA,2022,1500,1600,3100,22
NGORA,2023,1570,1650,3220,22
NGORA,2024,1620,1690,3310,22
NGORA,2025,1660,1710,3370,22
NTOROKO,2015,680,710,1390,22
NTOROKO,2016,710,730,1440,22
NTOROKO,2017,740,730,1470,22
NTOROKO,2018,780,740,1520,22
NTOROKO,2019,820,750,1570,22
NTOROKO,2020,860,760,1620,22
NTOROKO,2021,900,790,1690,22
NTOROKO,2022,940,810,1750,22
NTOROKO,2023,970,830,1800,22
NTOROKO,2024,1000,840,1840,22
NTOROKO,2025,1030,860,1890,22
NTUNGAMO,2015,3740,4500,8240,22
NTUNGAMO,2016,3820,4580,8400,22
NTUNGAMO,2017,3910,4660,8570,22
NTUNGAMO,2018,3990,4750,8740,22
NTUNGAMO,2019,4070,4830,8900,22
NTUNGAMO,2020,4150,4920,9070,22
NTUNGAMO,2021,4230,5000,9230,22
NTUNGAMO,2022,4310,5080,9390,22
NTUNGAMO,2023,4390,5150,9540,22
NTUNGAMO,2024,4460,5230,9690,22
NTUNGAMO,2025,4530,5300,9830,22
NWOYA,2015,1170,1370,2540,22
NWOYA,2016,1290,1510,2800,22
NWOYA,2017,1430,1660,3090,22
NWOYA,2018,1580,1830,3410,22
NWOYA,2019,1740,2020,3760,22
NWOYA,2020,1920,2220,4140,22
NWOYA,2021,2120,2440,4560,22
NWOYA,2022,2330,2680,5010,22
NWOYA,2023,2570,2940,5510,22
NWOYA,2024,2820,3230,6050,22
NWOYA,2025,3100,3540,6640,22
OBONGI,2015,330,360,690,22
OBONGI,2016,340,360,700,22
OBONGI,2017,360,360,720,22
OBONGI,2018,380,370,750,22
OBONGI,2019,390,380,770,22
OBONGI,2020,410,390,800,22
OBONGI,2021,430,410,840,22
OBONGI,2022,450,410,860,22
OBONGI,2023,470,430,900,22
OBONGI,2024,480,440,920,22
OBONGI,2025,500,430,930,22
OMORO,2015,1320,1480,2800,22
OMORO,2016,1400,1510,2910,22
OMORO,2017,1500,1550,3050,22
OMORO,2018,1580,1590,3170,22
OMORO,2019,1670,1640,3310,22
OMORO,2020,1770,1710,3480,22
OMORO,2021,1870,1790,3660,22
OMORO,2022,1980,1860,3840,22
OMORO,2023,2070,1940,4010,22
OMORO,2024,2160,2010,4170,22
OMORO,2025,2240,2050,4290,22
OTUKE,2015,760,880,1640,22
OTUKE,2016,790,920,1710,22
OTUKE,2017,830,960,1790,22
OTUKE,2018,870,1000,1870,22
OTUKE,2019,910,1040,1950,22
OTUKE,2020,940,1090,2030,22
OTUKE,2021,980,1130,2110,22
OTUKE,2022,1030,1180,2210,22
OTUKE,2023,1070,1220,2290,22
OTUKE,2024,1110,1270,2380,22
OTUKE,2025,1150,1320,2470,22
OYAM,2015,3220,3740,6960,22
OYAM,2016,3320,3860,7180,22
OYAM,2017,3420,3970,7390,22
OYAM,2018,3530,4080,7610,22
OYAM,2019,3630,4200,7830,22
OYAM,2020,3740,4310,8050,22
OYAM,2021,3840,4430,8270,22
OYAM,2022,3950,4550,8500,22
OYAM,2023,4060,4670,8730,22
OYAM,2024,4160,4780,8940,22
OYAM,2025,4270,4900,9170,22
PADER,2015,1310,1580,2890,22
PADER,2016,1370,1600,2970,22
PADER,2017,1420,1610,3030,22
PADER,2018,1480,1640,3120,22
PADER,2019,1540,1660,3200,22
PADER,2020,1610,1700,3310,22
PADER,2021,1660,1750,3410,22
PADER,2022,1720,1800,3520,22
PADER,2023,1780,1840,3620,22
PADER,2024,1820,1870,3690,22
PADER,2025,1850,1890,3740,22
PAKWACH,2015,1440,1580,3020,22
PAKWACH,2016,1500,1640,3140,22
PAKWACH,2017,1560,1700,3260,22
PAKWACH,2018,1630,1760,3390,22
PAKWACH,2019,1690,1830,3520,22
PAKWACH,2020,1760,1890,3650,22
PAKWACH,2021,1830,1950,3780,22
PAKWACH,2022,1900,2020,3920,22
PAKWACH,2023,1970,2090,4060,22
PAKWACH,2024,2050,2150,4200,22
PAKWACH,2025,2120,2220,4340,22
PALLISA,2015,2160,2470,4630,22
PALLISA,2016,2310,2560,4870,22
PALLISA,2017,2480,2640,5120,22
PALLISA,2018,2640,2730,5370,22
PALLISA,2019,2820,2840,5660,22
PALLISA,2020,3000,2980,5980,22
PALLISA,2021,3210,3140,6350,22
PALLISA,2022,3420,3300,6720,22
PALLISA,2023,3620,3470,7090,22
PALLISA,2024,3820,3620,7440,22
PALLISA,2025,3980,3730,7710,22
RAKAI,2015,1930,2440,4370,22
RAKAI,2016,2030,2480,4510,22
RAKAI,2017,2140,2500,4640,22
RAKAI,2018,2230,2540,4770,22
RAKAI,2019,2350,2590,4940,22
RAKAI,2020,2450,2670,5120,22
RAKAI,2021,2580,2760,5340,22
RAKAI,2022,2690,2840,5530,22
RAKAI,2023,2790,2930,5720,22
RAKAI,2024,2890,2980,5870,22
RAKAI,2025,2960,3020,5980,22
RUBANDA,2015,1550,1830,3380,22
RUBANDA,2016,1580,1840,3420,22
RUBANDA,2017,1600,1860,3460,22
RUBANDA,2018,1620,1870,3490,22
RUBANDA,2019,1640,1890,3530,22
RUBANDA,2020,1660,1900,3560,22
RUBANDA,2021,1680,1910,3590,22
RUBANDA,2022,1690,1920,3610,22
RUBANDA,2023,1710,1930,3640,22
RUBANDA,2024,1730,1940,3670,22
RUBANDA,2025,1740,1940,3680,22
RUBIRIZI,2015,910,1110,2020,22
RUBIRIZI,2016,930,1130,2060,22
RUBIRIZI,2017,950,1150,2100,22
RUBIRIZI,2018,960,1170,2130,22
RUBIRIZI,2019,980,1190,2170,22
RUBIRIZI,2020,1000,1220,2220,22
RUBIRIZI,2021,1020,1240,2260,22
RUBIRIZI,2022,1040,1260,2300,22
RUBIRIZI,2023,1050,1280,2330,22
RUBIRIZI,2024,1070,1300,2370,22
RUBIRIZI,2025,1090,1320,2410,22
RUKIGA,2015,810,1060,1870,22
RUKIGA,2016,810,1070,1880,22
RUKIGA,2017,820,1070,1890,22
RUKIGA,2018,830,1080,1910,22
RUKIGA,2019,840,1090,1930,22
RUKIGA,2020,840,1090,1930,22
RUKIGA,2021,850,1100,1950,22
RUKIGA,2022,860,1100,1960,22
RUKIGA,2023,860,1110,1970,22
RUKIGA,2024,870,1110,1980,22
RUKIGA,2025,870,1110,1980,22
RUKUNGIRI,2015,2490,2950,5440,22
RUKUNGIRI,2016,2520,2980,5500,22
RUKUNGIRI,2017,2550,3010,5560,22
RUKUNGIRI,2018,2580,3040,5620,22
RUKUNGIRI,2019,2610,3060,5670,22
RUKUNGIRI,2020,2640,3090,5730,22
RUKUNGIRI,2021,2670,3110,5780,22
RUKUNGIRI,2022,2690,3130,5820,22
RUKUNGIRI,2023,2710,3150,5860,22
RUKUNGIRI,2024,2730,3170,5900,22
RUKUNGIRI,2025,2750,3190,5940,22
RWAMPARA,2015,1010,1170,2180,22
RWAMPARA,2016,1040,1200,2240,22
RWAMPARA,2017,1060,1220,2280,22
RWAMPARA,2018,1080,1250,2330,22
RWAMPARA,2019,1110,1270,2380,22
RWAMPARA,2020,1130,1300,2430,22
RWAMPARA,2021,1150,1320,2470,22
RWAMPARA,2022,1180,1350,2530,22
RWAMPARA,2023,1200,1370,2570,22
RWAMPARA,2024,1220,1400,2620,22
RWAMPARA,2025,1240,1420,2660,22
SERERE,2015,2280,2590,4870,22
SERERE,2016,2430,2680,5110,22
SERERE,2017,2590,2750,5340,22
SERERE,2018,2750,2830,5580,22
SERERE,2019,2930,2930,5860,22
SERERE,2020,3110,3070,6180,22
SERERE,2021,3310,3220,6530,22
SERERE,2022,3510,3380,6890,22
SERERE,2023,3720,3530,7250,22
SERERE,2024,3900,3670,7570,22
SERERE,2025,4050,3770,7820,22
SHEEMA,2015,1800,1990,3790,22
SHEEMA,2016,1830,2010,3840,22
SHEEMA,2017,1850,2030,3880,22
SHEEMA,2018,1870,2050,3920,22
SHEEMA,2019,1890,2070,3960,22
SHEEMA,2020,1910,2090,4000,22
SHEEMA,2021,1930,2110,4040,22
SHEEMA,2022,1950,2130,4080,22
SHEEMA,2023,1960,2140,4100,22
SHEEMA,2024,1980,2160,4140,22
SHEEMA,2025,1990,2170,4160,22
SIRONKO,2015,2020,2080,4100,22
SIRONKO,2016,2060,2120,4180,22
SIRONKO,2017,2110,2160,4270,22
SIRONKO,2018,2160,2210,4370,22
SIRONKO,2019,2210,2250,4460,22
SIRONKO,2020,2260,2290,4550,22
SIRONKO,2021,2310,2340,4650,22
SIRONKO,2022,2360,2380,4740,22
SIRONKO,2023,2410,2420,4830,22
SIRONKO,2024,2450,2460,4910,22
SIRONKO,2025,2500,2500,5000,22
SOROTI,2015,2700,3140,5840,22
SOROTI,2016,2880,3220,6100,22
SOROTI,2017,3040,3300,6340,22
SOROTI,2018,3220,3380,6600,22
SOROTI,2019,3410,3480,6890,22
SOROTI,2020,3620,3630,7250,22
SOROTI,2021,3820,3790,7610,22
SOROTI,2022,4040,3970,8010,22
SOROTI,2023,4250,4120,8370,22
SOROTI,2024,4440,4260,8700,22
SOROTI,2025,4590,4360,8950,22
SSEMBABULE,2015,1990,2160,4150,22
SSEMBABULE,2016,2100,2200,4300,22
SSEMBABULE,2017,2220,2230,4450,22
SSEMBABULE,2018,2330,2270,4600,22
SSEMBABULE,2019,2440,2320,4760,22
SSEMBABULE,2020,2570,2410,4980,22
SSEMBABULE,2021,2700,2500,5200,22
SSEMBABULE,2022,2840,2590,5430,22
SSEMBABULE,2023,2960,2670,5630,22
SSEMBABULE,2024,3070,2740,5810,22
SSEMBABULE,2025,3150,2780,5930,22
TORORO,2015,4170,4960,9130,22
TORORO,2016,4280,5080,9360,22
TORORO,2017,4400,5210,9610,22
TORORO,2018,4510,5340,9850,22
TORORO,2019,4630,5470,10100,22
TORORO,2020,4740,5600,10340,22
TORORO,2021,4860,5720,10580,22
TORORO,2022,4970,5850,10820,22
TORORO,2023,5090,5980,11070,22
TORORO,2024,5200,6100,11300,22
TORORO,2025,5310,6230,11540,22
WAKISO,2015,21350,31800,53150,22
WAKISO,2016,22780,33970,56750,22
WAKISO,2017,24310,36310,60620,22
WAKISO,2018,25920,38760,64680,22
WAKISO,2019,27640,41360,69000,22
WAKISO,2020,29440,44110,73550,22
WAKISO,2021,31330,47040,78370,22
WAKISO,2022,33340,50140,83480,22
WAKISO,2023,35460,53370,88830,22
WAKISO,2024,37670,56770,94440,22
WAKISO,2025,39980,60380,100360,22
YUMBE,2015,3020,3910,6930,22
YUMBE,2016,3250,4100,7350,22
YUMBE,2017,3500,4310,7810,22
YUMBE,2018,3760,4520,8280,22
YUMBE,2019,4030,4770,8800,22
YUMBE,2020,4340,5090,9430,22
YUMBE,2021,4660,5440,10100,22
YUMBE,2022,5000,5820,10820,22
YUMBE,2023,5330,6190,11520,22
YUMBE,2024,5650,6550,12200,22
YUMBE,2025,5920,6870,12790,22
ZOMBO,2015,1570,2040,3610,22
ZOMBO,2016,1620,2090,3710,22
ZOMBO,2017,1670,2150,3820,22
ZOMBO,2018,1720,2210,3930,22
ZOMBO,2019,1770,2270,4040,22
ZOMBO,2020,1820,2330,4150,22
ZOMBO,2021,1870,2390,4260,22
ZOMBO,2022,1930,2450,4380,22
ZOMBO,2023,1980,2510,4490,22
ZOMBO,2024,2030,2570,4600,22
ZOMBO,2025,2080,2630,4710,22
ABIM,2015,880,1060,1940,23
ABIM,2016,970,1130,2100,23
ABIM,2017,1050,1190,2240,23
ABIM,2018,1150,1240,2390,23
ABIM,2019,1240,1310,2550,23
ABIM,2020,1340,1390,2730,23
ABIM,2021,1460,1480,2940,23
ABIM,2022,1590,1570,3160,23
ABIM,2023,1730,1690,3420,23
ABIM,2024,1870,1810,3680,23
ABIM,2025,2000,1900,3900,23
ADJUMANI,2015,1400,1690,3090,23
ADJUMANI,2016,1410,1700,3110,23
ADJUMANI,2017,1420,1720,3140,23
ADJUMANI,2018,1430,1740,3170,23
ADJUMANI,2019,1440,1750,3190,23
ADJUMANI,2020,1450,1770,3220,23
ADJUMANI,2021,1450,1780,3230,23
ADJUMANI,2022,1460,1790,3250,23
ADJUMANI,2023,1470,1800,3270,23
ADJUMANI,2024,1470,1810,3280,23
ADJUMANI,2025,1470,1820,3290,23
AGAGO,2015,1160,1490,2650,23
AGAGO,2016,1180,1520,2700,23
AGAGO,2017,1200,1540,2740,23
AGAGO,2018,1220,1570,2790,23
AGAGO,2019,1240,1600,2840,23
AGAGO,2020,1260,1620,2880,23
AGAGO,2021,1280,1650,2930,23
AGAGO,2022,1300,1670,2970,23
AGAGO,2023,1320,1700,3020,23
AGAGO,2024,1340,1720,3060,23
AGAGO,2025,1350,1740,3090,23
ALEBTONG,2015,1400,1830,3230,23
ALEBTONG,2016,1470,1880,3350,23
ALEBTONG,2017,1550,1920,3470,23
ALEBTONG,2018,1620,1940,3560,23
ALEBTONG,2019,1700,1970,3670,23
ALEBTONG,2020,1790,2020,3810,23
ALEBTONG,2021,1880,2080,3960,23
ALEBTONG,2022,1980,2170,4150,23
ALEBTONG,2023,2070,2240,4310,23
ALEBTONG,2024,2150,2320,4470,23
ALEBTONG,2025,2230,2370,4600,23
AMOLATAR,2015,1120,1290,2410,23
AMOLATAR,2016,1160,1310,2470,23
AMOLATAR,2017,1220,1340,2560,23
AMOLATAR,2018,1290,1360,2650,23
AMOLATAR,2019,1350,1380,2730,23
AMOLATAR,2020,1420,1410,2830,23
AMOLATAR,2021,1490,1440,2930,23
AMOLATAR,2022,1550,1490,3040,23
AMOLATAR,2023,1620,1550,3170,23
AMOLATAR,2024,1690,1600,3290,23
AMOLATAR,2025,1750,1620,3370,23
AMUDAT,2015,590,660,1250,23
AMUDAT,2016,630,690,1320,23
AMUDAT,2017,680,720,1400,23
AMUDAT,2018,720,750,1470,23
AMUDAT,2019,750,770,1520,23
AMUDAT,2020,810,800,1610,23
AMUDAT,2021,850,840,1690,23
AMUDAT,2022,910,890,1800,23
AMUDAT,2023,960,950,1910,23
AMUDAT,2024,1010,990,2000,23
AMUDAT,2025,1070,1030,2100,23
AMURIA,2015,1310,1470,2780,23
AMURIA,2016,1390,1530,2920,23
AMURIA,2017,1480,1570,3050,23
AMURIA,2018,1560,1600,3160,23
AMURIA,2019,1660,1650,3310,23
AMURIA,2020,1750,1700,3450,23
AMURIA,2021,1870,1770,3640,23
AMURIA,2022,1980,1850,3830,23
AMURIA,2023,2090,1930,4020,23
AMURIA,2024,2190,2000,4190,23
AMURIA,2025,2300,2070,4370,23
AMURU,2015,1370,1590,2960,23
AMURU,2016,1440,1640,3080,23
AMURU,2017,1500,1670,3170,23
AMURU,2018,1590,1690,3280,23
AMURU,2019,1660,1710,3370,23
AMURU,2020,1740,1760,3500,23
AMURU,2021,1820,1810,3630,23
AMURU,2022,1910,1880,3790,23
AMURU,2023,1990,1950,3940,23
AMURU,2024,2080,2000,4080,23
AMURU,2025,2150,2060,4210,23
APAC,2015,1280,1500,2780,23
APAC,2016,1330,1550,2880,23
APAC,2017,1370,1610,2980,23
APAC,2018,1420,1660,3080,23
APAC,2019,1480,1720,3200,23
APAC,2020,1530,1780,3310,23
APAC,2021,1580,1830,3410,23
APAC,2022,1630,1890,3520,23
APAC,2023,1690,1950,3640,23
APAC,2024,1740,2010,3750,23
APAC,2025,1800,2070,3870,23
ARUA,2015,4390,5530,9920,23
ARUA,2016,4520,5680,10200,23
ARUA,2017,4650,5840,10490,23
ARUA,2018,4780,5990,10770,23
ARUA,2019,4920,6150,11070,23
ARUA,2020,5050,6310,11360,23
ARUA,2021,5190,6470,11660,23
ARUA,2022,5320,6630,11950,23
ARUA,2023,5450,6790,12240,23
ARUA,2024,5590,6940,12530,23
ARUA,2025,5720,7100,12820,23
BUDAKA,2015,1330,1670,3000,23
BUDAKA,2016,1400,1730,3130,23
BUDAKA,2017,1480,1770,3250,23
BUDAKA,2018,1570,1810,3380,23
BUDAKA,2019,1670,1850,3520,23
BUDAKA,2020,1770,1910,3680,23
BUDAKA,2021,1870,1980,3850,23
BUDAKA,2022,1980,2060,4040,23
BUDAKA,2023,2090,2160,4250,23
BUDAKA,2024,2190,2240,4430,23
BUDAKA,2025,2280,2310,4590,23
BUDUDA,2015,1410,1560,2970,23
BUDUDA,2016,1500,1620,3120,23
BUDUDA,2017,1610,1680,3290,23
BUDUDA,2018,1720,1740,3460,23
BUDUDA,2019,1840,1790,3630,23
BUDUDA,2020,1950,1870,3820,23
BUDUDA,2021,2090,1960,4050,23
BUDUDA,2022,2220,2060,4280,23
BUDUDA,2023,2380,2180,4560,23
BUDUDA,2024,2520,2300,4820,23
BUDUDA,2025,2650,2380,5030,23
BUGIRI,2015,2420,3160,5580,23
BUGIRI,2016,2570,3280,5850,23
BUGIRI,2017,2740,3380,6120,23
BUGIRI,2018,2920,3480,6400,23
BUGIRI,2019,3100,3570,6670,23
BUGIRI,2020,3310,3700,7010,23
BUGIRI,2021,3510,3860,7370,23
BUGIRI,2022,3730,4060,7790,23
BUGIRI,2023,3960,4250,8210,23
BUGIRI,2024,4180,4440,8620,23
BUGIRI,2025,4380,4600,8980,23
BUGWERI,2015,980,1410,2390,23
BUGWERI,2016,1030,1450,2480,23
BUGWERI,2017,1080,1470,2550,23
BUGWERI,2018,1130,1490,2620,23
BUGWERI,2019,1190,1510,2700,23
BUGWERI,2020,1260,1540,2800,23
BUGWERI,2021,1310,1600,2910,23
BUGWERI,2022,1380,1650,3030,23
BUGWERI,2023,1440,1710,3150,23
BUGWERI,2024,1500,1760,3260,23
BUGWERI,2025,1560,1800,3360,23
BUHWEJU,2015,900,1050,1950,23
BUHWEJU,2016,930,1080,2010,23
BUHWEJU,2017,960,1110,2070,23
BUHWEJU,2018,990,1150,2140,23
BUHWEJU,2019,1020,1180,2200,23
BUHWEJU,2020,1050,1210,2260,23
BUHWEJU,2021,1080,1250,2330,23
BUHWEJU,2022,1120,1280,2400,23
BUHWEJU,2023,1150,1320,2470,23
BUHWEJU,2024,1180,1350,2530,23
BUHWEJU,2025,1210,1390,2600,23
BUIKWE,2015,3520,4500,8020,23
BUIKWE,2016,3670,4590,8260,23
BUIKWE,2017,3840,4650,8490,23
BUIKWE,2018,4000,4690,8690,23
BUIKWE,2019,4160,4730,8890,23
BUIKWE,2020,4340,4810,9150,23
BUIKWE,2021,4520,4930,9450,23
BUIKWE,2022,4710,5090,9800,23
BUIKWE,2023,4890,5230,10120,23
BUIKWE,2024,5060,5370,10430,23
BUIKWE,2025,5200,5460,10660,23
BUKEDEA,2015,1350,1790,3140,23
BUKEDEA,2016,1450,1850,3300,23
BUKEDEA,2017,1550,1920,3470,23
BUKEDEA,2018,1660,1980,3640,23
BUKEDEA,2019,1770,2040,3810,23
BUKEDEA,2020,1880,2110,3990,23
BUKEDEA,2021,2010,2210,4220,23
BUKEDEA,2022,2130,2330,4460,23
BUKEDEA,2023,2270,2440,4710,23
BUKEDEA,2024,2410,2550,4960,23
BUKEDEA,2025,2530,2650,5180,23
BUKOMANSIMBI,2015,970,1190,2160,23
BUKOMANSIMBI,2016,1000,1190,2190,23
BUKOMANSIMBI,2017,1040,1190,2230,23
BUKOMANSIMBI,2018,1060,1170,2230,23
BUKOMANSIMBI,2019,1100,1160,2260,23
BUKOMANSIMBI,2020,1130,1170,2300,23
BUKOMANSIMBI,2021,1160,1180,2340,23
BUKOMANSIMBI,2022,1200,1200,2400,23
BUKOMANSIMBI,2023,1220,1210,2430,23
BUKOMANSIMBI,2024,1260,1220,2480,23
BUKOMANSIMBI,2025,1270,1230,2500,23
BUKWO,2015,610,580,1190,23
BUKWO,2016,640,600,1240,23
BUKWO,2017,680,630,1310,23
BUKWO,2018,720,660,1380,23
BUKWO,2019,750,700,1450,23
BUKWO,2020,790,730,1520,23
BUKWO,2021,830,760,1590,23
BUKWO,2022,880,800,1680,23
BUKWO,2023,920,830,1750,23
BUKWO,2024,960,870,1830,23
BUKWO,2025,1010,910,1920,23
BULAMBULI,2015,1200,1320,2520,23
BULAMBULI,2016,1290,1390,2680,23
BULAMBULI,2017,1390,1440,2830,23
BULAMBULI,2018,1490,1500,2990,23
BULAMBULI,2019,1590,1560,3150,23
BULAMBULI,2020,1700,1620,3320,23
BULAMBULI,2021,1830,1710,3540,23
BULAMBULI,2022,1950,1810,3760,23
BULAMBULI,2023,2090,1930,4020,23
BULAMBULI,2024,2230,2030,4260,23
BULAMBULI,2025,2350,2130,4480,23
BULIISA,2015,1240,990,2230,23
BULIISA,2016,1310,1030,2340,23
BULIISA,2017,1380,1080,2460,23
BULIISA,2018,1450,1130,2580,23
BULIISA,2019,1530,1170,2700,23
BULIISA,2020,1610,1220,2830,23
BULIISA,2021,1700,1280,2980,23
BULIISA,2022,1780,1330,3110,23
BULIISA,2023,1870,1380,3250,23
BULIISA,2024,1960,1440,3400,23
BULIISA,2025,2060,1500,3560,23
BUNDIBUGYO,2015,1640,2000,3640,23
BUNDIBUGYO,2016,1720,2060,3780,23
BUNDIBUGYO,2017,1820,2100,3920,23
BUNDIBUGYO,2018,1920,2130,4050,23
BUNDIBUGYO,2019,2010,2170,4180,23
BUNDIBUGYO,2020,2110,2220,4330,23
BUNDIBUGYO,2021,2230,2300,4530,23
BUNDIBUGYO,2022,2340,2380,4720,23
BUNDIBUGYO,2023,2460,2470,4930,23
BUNDIBUGYO,2024,2570,2540,5110,23
BUNDIBUGYO,2025,2650,2600,5250,23
BUNYANGABU,2015,1350,1660,3010,23
BUNYANGABU,2016,1420,1690,3110,23
BUNYANGABU,2017,1490,1710,3200,23
BUNYANGABU,2018,1560,1730,3290,23
BUNYANGABU,2019,1630,1760,3390,23
BUNYANGABU,2020,1720,1790,3510,23
BUNYANGABU,2021,1790,1840,3630,23
BUNYANGABU,2022,1870,1900,3770,23
BUNYANGABU,2023,1970,1960,3930,23
BUNYANGABU,2024,2040,2020,4060,23
BUNYANGABU,2025,2110,2060,4170,23
BUSHENYI,2015,1850,1940,3790,23
BUSHENYI,2016,1880,1950,3830,23
BUSHENYI,2017,1900,1970,3870,23
BUSHENYI,2018,1920,1990,3910,23
BUSHENYI,2019,1940,2000,3940,23
BUSHENYI,2020,1960,2020,3980,23
BUSHENYI,2021,1980,2030,4010,23
BUSHENYI,2022,2000,2050,4050,23
BUSHENYI,2023,2020,2060,4080,23
BUSHENYI,2024,2030,2070,4100,23
BUSHENYI,2025,2050,2080,4130,23
BUSIA,2015,2320,2930,5250,23
BUSIA,2016,2440,3010,5450,23
BUSIA,2017,2580,3070,5650,23
BUSIA,2018,2720,3120,5840,23
BUSIA,2019,2870,3180,6050,23
BUSIA,2020,3020,3260,6280,23
BUSIA,2021,3180,3380,6560,23
BUSIA,2022,3360,3500,6860,23
BUSIA,2023,3520,3640,7160,23
BUSIA,2024,3680,3760,7440,23
BUSIA,2025,3830,3850,7680,23
BUTALEJA,2015,1600,1900,3500,23
BUTALEJA,2016,1700,1970,3670,23
BUTALEJA,2017,1810,2020,3830,23
BUTALEJA,2018,1910,2070,3980,23
BUTALEJA,2019,2020,2120,4140,23
BUTALEJA,2020,2150,2190,4340,23
BUTALEJA,2021,2280,2280,4560,23
BUTALEJA,2022,2410,2380,4790,23
BUTALEJA,2023,2550,2500,5050,23
BUTALEJA,2024,2680,2590,5270,23
BUTALEJA,2025,2800,2670,5470,23
BUTAMBALA,2015,690,890,1580,23
BUTAMBALA,2016,720,890,1610,23
BUTAMBALA,2017,750,890,1640,23
BUTAMBALA,2018,780,890,1670,23
BUTAMBALA,2019,800,900,1700,23
BUTAMBALA,2020,830,890,1720,23
BUTAMBALA,2021,870,910,1780,23
BUTAMBALA,2022,880,940,1820,23
BUTAMBALA,2023,920,950,1870,23
BUTAMBALA,2024,950,970,1920,23
BUTAMBALA,2025,960,970,1930,23
BUTEBO,2015,720,850,1570,23
BUTEBO,2016,740,860,1600,23
BUTEBO,2017,770,870,1640,23
BUTEBO,2018,800,870,1670,23
BUTEBO,2019,830,870,1700,23
BUTEBO,2020,860,880,1740,23
BUTEBO,2021,890,900,1790,23
BUTEBO,2022,920,920,1840,23
BUTEBO,2023,960,940,1900,23
BUTEBO,2024,990,960,1950,23
BUTEBO,2025,1010,970,1980,23
BUVUMA,2015,840,820,1660,23
BUVUMA,2016,890,880,1770,23
BUVUMA,2017,950,940,1890,23
BUVUMA,2018,1000,1000,2000,23
BUVUMA,2019,1060,1070,2130,23
BUVUMA,2020,1130,1130,2260,23
BUVUMA,2021,1200,1210,2410,23
BUVUMA,2022,1270,1290,2560,23
BUVUMA,2023,1340,1370,2710,23
BUVUMA,2024,1420,1460,2880,23
BUVUMA,2025,1500,1550,3050,23
BUYENDE,2015,2100,2600,4700,23
BUYENDE,2016,2240,2720,4960,23
BUYENDE,2017,2400,2810,5210,23
BUYENDE,2018,2560,2900,5460,23
BUYENDE,2019,2730,2990,5720,23
BUYENDE,2020,2910,3120,6030,23
BUYENDE,2021,3120,3270,6390,23
BUYENDE,2022,3320,3440,6760,23
BUYENDE,2023,3540,3630,7170,23
BUYENDE,2024,3750,3800,7550,23
BUYENDE,2025,3940,3950,7890,23
DOKOLO,2015,1110,1240,2350,23
DOKOLO,2016,1140,1270,2410,23
DOKOLO,2017,1180,1310,2490,23
DOKOLO,2018,1210,1340,2550,23
DOKOLO,2019,1250,1380,2630,23
DOKOLO,2020,1280,1420,2700,23
DOKOLO,2021,1320,1450,2770,23
DOKOLO,2022,1360,1490,2850,23
DOKOLO,2023,1390,1520,2910,23
DOKOLO,2024,1430,1560,2990,23
DOKOLO,2025,1470,1600,3070,23
GOMBA,2015,1250,1310,2560,23
GOMBA,2016,1300,1320,2620,23
GOMBA,2017,1350,1330,2680,23
GOMBA,2018,1410,1330,2740,23
GOMBA,2019,1460,1330,2790,23
GOMBA,2020,1520,1340,2860,23
GOMBA,2021,1580,1360,2940,23
GOMBA,2022,1640,1390,3030,23
GOMBA,2023,1700,1430,3130,23
GOMBA,2024,1750,1440,3190,23
GOMBA,2025,1790,1460,3250,23
GULU,2015,2430,2580,5010,23
GULU,2016,2500,2660,5160,23
GULU,2017,2580,2730,5310,23
GULU,2018,2650,2810,5460,23
GULU,2019,2730,2890,5620,23
GULU,2020,2810,2970,5780,23
GULU,2021,2890,3050,5940,23
GULU,2022,2960,3130,6090,23
GULU,2023,3040,3210,6250,23
GULU,2024,3120,3290,6410,23
GULU,2025,3200,3370,6570,23
HOIMA,2015,2750,2960,5710,23
HOIMA,2016,2860,3070,5930,23
HOIMA,2017,2970,3170,6140,23
HOIMA,2018,3080,3280,6360,23
HOIMA,2019,3190,3390,6580,23
HOIMA,2020,3300,3510,6810,23
HOIMA,2021,3420,3620,7040,23
HOIMA,2022,3540,3730,7270,23
HOIMA,2023,3660,3850,7510,23
HOIMA,2024,3780,3970,7750,23
HOIMA,2025,3900,4090,7990,23
IBANDA,2015,1940,2070,4010,23
IBANDA,2016,1980,2110,4090,23
IBANDA,2017,2020,2150,4170,23
IBANDA,2018,2060,2180,4240,23
IBANDA,2019,2100,2220,4320,23
IBANDA,2020,2130,2260,4390,23
IBANDA,2021,2170,2290,4460,23
IBANDA,2022,2210,2330,4540,23
IBANDA,2023,2250,2360,4610,23
IBANDA,2024,2280,2400,4680,23
IBANDA,2025,2310,2430,4740,23
IGANGA,2015,2510,3350,5860,23
IGANGA,2016,2650,3450,6100,23
IGANGA,2017,2800,3520,6320,23
IGANGA,2018,2960,3580,6540,23
IGANGA,2019,3120,3650,6770,23
IGANGA,2020,3280,3740,7020,23
IGANGA,2021,3460,3870,7330,23
IGANGA,2022,3640,4030,7670,23
IGANGA,2023,3830,4170,8000,23
IGANGA,2024,4000,4310,8310,23
IGANGA,2025,4160,4430,8590,23
ISINGIRO,2015,3110,3710,6820,23
ISINGIRO,2016,3230,3840,7070,23
ISINGIRO,2017,3350,3970,7320,23
ISINGIRO,2018,3470,4110,7580,23
ISINGIRO,2019,3600,4250,7850,23
ISINGIRO,2020,3730,4400,8130,23
ISINGIRO,2021,3860,4540,8400,23
ISINGIRO,2022,3990,4690,8680,23
ISINGIRO,2023,4130,4840,8970,23
ISINGIRO,2024,4260,4990,9250,23
ISINGIRO,2025,4400,5140,9540,23
JINJA,2015,4060,4620,8680,23
JINJA,2016,4130,4690,8820,23
JINJA,2017,4190,4760,8950,23
JINJA,2018,4260,4830,9090,23
JINJA,2019,4330,4900,9230,23
JINJA,2020,4400,4970,9370,23
JINJA,2021,4460,5040,9500,23
JINJA,2022,4520,5100,9620,23
JINJA,2023,4580,5160,9740,23
JINJA,2024,4640,5220,9860,23
JINJA,2025,4690,5280,9970,23
KAABONG,2015,490,920,1410,23
KAABONG,2016,510,950,1460,23
KAABONG,2017,520,970,1490,23
KAABONG,2018,530,990,1520,23
KAABONG,2019,550,1010,1560,23
KAABONG,2020,560,1040,1600,23
KAABONG,2021,580,1060,1640,23
KAABONG,2022,590,1080,1670,23
KAABONG,2023,610,1100,1710,23
KAABONG,2024,620,1130,1750,23
KAABONG,2025,630,1150,1780,23
KABALE,2015,1910,2150,4060,23
KABALE,2016,1940,2180,4120,23
KABALE,2017,1970,2200,4170,23
KABALE,2018,2000,2230,4230,23
KABALE,2019,2030,2250,4280,23
KABALE,2020,2060,2280,4340,23
KABALE,2021,2090,2300,4390,23
KABALE,2022,2110,2320,4430,23
KABALE,2023,2140,2340,4480,23
KABALE,2024,2160,2360,4520,23
KABALE,2025,2190,2370,4560,23
KABAROLE,2015,2730,2860,5590,23
KABAROLE,2016,2790,2920,5710,23
KABAROLE,2017,2850,2990,5840,23
KABAROLE,2018,2910,3050,5960,23
KABAROLE,2019,2970,3110,6080,23
KABAROLE,2020,3030,3180,6210,23
KABAROLE,2021,3090,3240,6330,23
KABAROLE,2022,3150,3300,6450,23
KABAROLE,2023,3210,3360,6570,23
KABAROLE,2024,3260,3420,6680,23
KABAROLE,2025,3320,3480,6800,23
KABERAMAIDO,2015,770,940,1710,23
KABERAMAIDO,2016,810,990,1800,23
KABERAMAIDO,2017,860,1020,1880,23
KABERAMAIDO,2018,930,1050,1980,23
KABERAMAIDO,2019,990,1080,2070,23
KABERAMAIDO,2020,1060,1120,2180,23
KABERAMAIDO,2021,1120,1160,2280,23
KABERAMAIDO,2022,1200,1220,2420,23
KABERAMAIDO,2023,1260,1280,2540,23
KABERAMAIDO,2024,1340,1340,2680,23
KABERAMAIDO,2025,1410,1390,2800,23
KAGADI,2015,2620,3000,5620,23
KAGADI,2016,2720,3110,5830,23
KAGADI,2017,2820,3220,6040,23
KAGADI,2018,2920,3330,6250,23
KAGADI,2019,3030,3450,6480,23
KAGADI,2020,3130,3560,6690,23
KAGADI,2021,3240,3680,6920,23
KAGADI,2022,3360,3800,7160,23
KAGADI,2023,3470,3920,7390,23
KAGADI,2024,3580,4050,7630,23
KAGADI,2025,3690,4170,7860,23
KAKUMIRO,2015,2390,2630,5020,23
KAKUMIRO,2016,2610,2850,5460,23
KAKUMIRO,2017,2840,3090,5930,23
KAKUMIRO,2018,3090,3350,6440,23
KAKUMIRO,2019,3360,3630,6990,23
KAKUMIRO,2020,3650,3920,7570,23
KAKUMIRO,2021,3960,4250,8210,23
KAKUMIRO,2022,4300,4590,8890,23
KAKUMIRO,2023,4660,4960,9620,23
KAKUMIRO,2024,5050,5360,10410,23
KAKUMIRO,2025,5470,5780,11250,23
KALAKI,2015,670,720,1390,23
KALAKI,2016,700,750,1450,23
KALAKI,2017,730,780,1510,23
KALAKI,2018,760,810,1570,23
KALAKI,2019,790,840,1630,23
KALAKI,2020,830,870,1700,23
KALAKI,2021,860,910,1770,23
KALAKI,2022,890,940,1830,23
KALAKI,2023,930,980,1910,23
KALAKI,2024,960,1010,1970,23
KALAKI,2025,1000,1040,2040,23
KALANGALA,2015,710,620,1330,23
KALANGALA,2016,740,650,1390,23
KALANGALA,2017,770,680,1450,23
KALANGALA,2018,790,700,1490,23
KALANGALA,2019,820,730,1550,23
KALANGALA,2020,850,760,1610,23
KALANGALA,2021,880,790,1670,23
KALANGALA,2022,900,820,1720,23
KALANGALA,2023,930,850,1780,23
KALANGALA,2024,960,880,1840,23
KALANGALA,2025,990,910,1900,23
KALIRO,2015,1650,1960,3610,23
KALIRO,2016,1750,2030,3780,23
KALIRO,2017,1850,2080,3930,23
KALIRO,2018,1970,2120,4090,23
KALIRO,2019,2080,2180,4260,23
KALIRO,2020,2200,2250,4450,23
KALIRO,2021,2330,2340,4670,23
KALIRO,2022,2460,2440,4900,23
KALIRO,2023,2590,2550,5140,23
KALIRO,2024,2730,2660,5390,23
KALIRO,2025,2840,2730,5570,23
KALUNGU,2015,1170,1500,2670,23
KALUNGU,2016,1210,1520,2730,23
KALUNGU,2017,1260,1520,2780,23
KALUNGU,2018,1300,1510,2810,23
KALUNGU,2019,1340,1510,2850,23
KALUNGU,2020,1380,1520,2900,23
KALUNGU,2021,1430,1540,2970,23
KALUNGU,2022,1470,1570,3040,23
KALUNGU,2023,1520,1610,3130,23
KALUNGU,2024,1560,1630,3190,23
KALUNGU,2025,1590,1650,3240,23
KAMPALA,2015,20230,25540,45770,23
KAMPALA,2016,20640,26040,46680,23
KAMPALA,2017,21040,26540,47580,23
KAMPALA,2018,21450,27040,48490,23
KAMPALA,2019,21860,27550,49410,23
KAMPALA,2020,22250,28040,50290,23
KAMPALA,2021,22640,28520,51160,23
KAMPALA,2022,23020,29000,52020,23
KAMPALA,2023,23390,29470,52860,23
KAMPALA,2024,23750,29920,53670,23
KAMPALA,2025,24090,30360,54450,23
KAMULI,2015,3270,3950,7220,23
KAMULI,2016,3430,4040,7470,23
KAMULI,2017,3600,4090,7690,23
KAMULI,2018,3780,4130,7910,23
KAMULI,2019,3970,4190,8160,23
KAMULI,2020,4150,4270,8420,23
KAMULI,2021,4350,4390,8740,23
KAMULI,2022,4570,4540,9110,23
KAMULI,2023,4770,4680,9450,23
KAMULI,2024,4960,4810,9770,23
KAMULI,2025,5130,4910,10040,23
KAMWENGE,2015,1940,2340,4280,23
KAMWENGE,2016,2020,2420,4440,23
KAMWENGE,2017,2100,2510,4610,23
KAMWENGE,2018,2190,2600,4790,23
KAMWENGE,2019,2270,2690,4960,23
KAMWENGE,2020,2360,2780,5140,23
KAMWENGE,2021,2450,2870,5320,23
KAMWENGE,2022,2540,2960,5500,23
KAMWENGE,2023,2640,3060,5700,23
KAMWENGE,2024,2730,3160,5890,23
KAMWENGE,2025,2830,3250,6080,23
KANUNGU,2015,1700,2030,3730,23
KANUNGU,2016,1730,2060,3790,23
KANUNGU,2017,1770,2090,3860,23
KANUNGU,2018,1800,2130,3930,23
KANUNGU,2019,1830,2160,3990,23
KANUNGU,2020,1860,2190,4050,23
KANUNGU,2021,1890,2220,4110,23
KANUNGU,2022,1920,2250,4170,23
KANUNGU,2023,1940,2280,4220,23
KANUNGU,2024,1970,2310,4280,23
KANUNGU,2025,2000,2340,4340,23
KAPCHORWA,2015,750,850,1600,23
KAPCHORWA,2016,780,870,1650,23
KAPCHORWA,2017,800,900,1700,23
KAPCHORWA,2018,820,920,1740,23
KAPCHORWA,2019,850,940,1790,23
KAPCHORWA,2020,870,970,1840,23
KAPCHORWA,2021,900,990,1890,23
KAPCHORWA,2022,920,1020,1940,23
KAPCHORWA,2023,950,1040,1990,23
KAPCHORWA,2024,970,1070,2040,23
KAPCHORWA,2025,1000,1090,2090,23
KAPELEBYONG,2015,590,710,1300,23
KAPELEBYONG,2016,630,740,1370,23
KAPELEBYONG,2017,660,750,1410,23
KAPELEBYONG,2018,690,760,1450,23
KAPELEBYONG,2019,730,770,1500,23
KAPELEBYONG,2020,770,790,1560,23
KAPELEBYONG,2021,810,820,1630,23
KAPELEBYONG,2022,860,840,1700,23
KAPELEBYONG,2023,900,880,1780,23
KAPELEBYONG,2024,950,910,1860,23
KAPELEBYONG,2025,980,930,1910,23
KASESE,2015,5620,7260,12880,23
KASESE,2016,5880,7420,13300,23
KASESE,2017,6170,7520,13690,23
KASESE,2018,6480,7590,14070,23
KASESE,2019,6770,7680,14450,23
KASESE,2020,7080,7830,14910,23
KASESE,2021,7410,8050,15460,23
KASESE,2022,7740,8300,16040,23
KASESE,2023,8080,8570,16650,23
KASESE,2024,8400,8800,17200,23
KASESE,2025,8660,8970,17630,23
KASSANDA,2015,2260,2270,4530,23
KASSANDA,2016,2330,2320,4650,23
KASSANDA,2017,2390,2370,4760,23
KASSANDA,2018,2460,2420,4880,23
KASSANDA,2019,2530,2470,5000,23
KASSANDA,2020,2600,2520,5120,23
KASSANDA,2021,2670,2570,5240,23
KASSANDA,2022,2730,2620,5350,23
KASSANDA,2023,2800,2670,5470,23
KASSANDA,2024,2870,2710,5580,23
KASSANDA,2025,2940,2760,5700,23
KATAKWI,2015,1250,1430,2680,23
KATAKWI,2016,1310,1460,2770,23
KATAKWI,2017,1390,1490,2880,23
KATAKWI,2018,1470,1510,2980,23
KATAKWI,2019,1530,1530,3060,23
KATAKWI,2020,1620,1570,3190,23
KATAKWI,2021,1710,1610,3320,23
KATAKWI,2022,1780,1680,3460,23
KATAKWI,2023,1870,1730,3600,23
KATAKWI,2024,1960,1780,3740,23
KATAKWI,2025,2020,1820,3840,23
KAYUNGA,2015,2380,3080,5460,23
KAYUNGA,2016,2470,3120,5590,23
KAYUNGA,2017,2580,3150,5730,23
KAYUNGA,2018,2700,3160,5860,23
KAYUNGA,2019,2800,3180,5980,23
KAYUNGA,2020,2920,3230,6150,23
KAYUNGA,2021,3040,3300,6340,23
KAYUNGA,2022,3160,3390,6550,23
KAYUNGA,2023,3280,3480,6760,23
KAYUNGA,2024,3400,3540,6940,23
KAYUNGA,2025,3490,3600,7090,23
KAZO,2015,1240,1360,2600,23
KAZO,2016,1290,1400,2690,23
KAZO,2017,1340,1450,2790,23
KAZO,2018,1390,1510,2900,23
KAZO,2019,1440,1560,3000,23
KAZO,2020,1490,1610,3100,23
KAZO,2021,1550,1660,3210,23
KAZO,2022,1600,1720,3320,23
KAZO,2023,1660,1770,3430,23
KAZO,2024,1710,1830,3540,23
KAZO,2025,1770,1890,3660,23
KIBAALE,2015,1170,1250,2420,23
KIBAALE,2016,1250,1330,2580,23
KIBAALE,2017,1330,1400,2730,23
KIBAALE,2018,1410,1480,2890,23
KIBAALE,2019,1500,1570,3070,23
KIBAALE,2020,1590,1650,3240,23
KIBAALE,2021,1690,1750,3440,23
KIBAALE,2022,1790,1840,3630,23
KIBAALE,2023,1900,1940,3840,23
KIBAALE,2024,2020,2050,4070,23
KIBAALE,2025,2130,2160,4290,23
KIBOGA,2015,1410,1390,2800,23
KIBOGA,2016,1480,1430,2910,23
KIBOGA,2017,1550,1450,3000,23
KIBOGA,2018,1630,1470,3100,23
KIBOGA,2019,1720,1490,3210,23
KIBOGA,2020,1790,1520,3310,23
KIBOGA,2021,1880,1570,3450,23
KIBOGA,2022,1980,1620,3600,23
KIBOGA,2023,2060,1680,3740,23
KIBOGA,2024,2150,1720,3870,23
KIBOGA,2025,2220,1750,3970,23
KIBUKU,2015,1240,1620,2860,23
KIBUKU,2016,1310,1680,2990,23
KIBUKU,2017,1400,1730,3130,23
KIBUKU,2018,1490,1770,3260,23
KIBUKU,2019,1580,1810,3390,23
KIBUKU,2020,1670,1880,3550,23
KIBUKU,2021,1780,1960,3740,23
KIBUKU,2022,1890,2050,3940,23
KIBUKU,2023,1990,2150,4140,23
KIBUKU,2024,2100,2240,4340,23
KIBUKU,2025,2190,2310,4500,23
KIKUUBE,2015,2150,2260,4410,23
KIKUUBE,2016,2270,2380,4650,23
KIKUUBE,2017,2390,2500,4890,23
KIKUUBE,2018,2520,2630,5150,23
KIKUUBE,2019,2650,2760,5410,23
KIKUUBE,2020,2790,2900,5690,23
KIKUUBE,2021,2930,3040,5970,23
KIKUUBE,2022,3080,3180,6260,23
KIKUUBE,2023,3230,3340,6570,23
KIKUUBE,2024,3390,3490,6880,23
KIKUUBE,2025,3550,3650,7200,23
KIRUHURA,2015,1300,1170,2470,23
KIRUHURA,2016,1350,1220,2570,23
KIRUHURA,2017,1400,1260,2660,23
KIRUHURA,2018,1450,1300,2750,23
KIRUHURA,2019,1500,1350,2850,23
KIRUHURA,2020,1560,1390,2950,23
KIRUHURA,2021,1620,1440,3060,23
KIRUHURA,2022,1670,1490,3160,23
KIRUHURA,2023,1730,1540,3270,23
KIRUHURA,2024,1780,1580,3360,23
KIRUHURA,2025,1840,1630,3470,23
KIRYANDONGO,2015,2150,2420,4570,23
KIRYANDONGO,2016,2260,2480,4740,23
KIRYANDONGO,2017,2390,2530,4920,23
KIRYANDONGO,2018,2520,2560,5080,23
KIRYANDONGO,2019,2640,2610,5250,23
KIRYANDONGO,2020,2790,2670,5460,23
KIRYANDONGO,2021,2930,2760,5690,23
KIRYANDONGO,2022,3080,2860,5940,23
KIRYANDONGO,2023,3230,2970,6200,23
KIRYANDONGO,2024,3380,3060,6440,23
KIRYANDONGO,2025,3500,3140,6640,23
KISORO,2015,1690,3010,4700,23
KISORO,2016,1750,3070,4820,23
KISORO,2017,1830,3110,4940,23
KISORO,2018,1910,3130,5040,23
KISORO,2019,1980,3170,5150,23
KISORO,2020,2060,3220,5280,23
KISORO,2021,2150,3300,5450,23
KISORO,2022,2240,3400,5640,23
KISORO,2023,2330,3500,5830,23
KISORO,2024,2410,3590,6000,23
KISORO,2025,2480,3640,6120,23
KITAGWENDA,2015,980,1200,2180,23
KITAGWENDA,2016,1020,1240,2260,23
KITAGWENDA,2017,1060,1290,2350,23
KITAGWENDA,2018,1110,1340,2450,23
KITAGWENDA,2019,1150,1380,2530,23
KITAGWENDA,2020,1190,1430,2620,23
KITAGWENDA,2021,1240,1480,2720,23
KITAGWENDA,2022,1290,1530,2820,23
KITAGWENDA,2023,1330,1580,2910,23
KITAGWENDA,2024,1380,1620,3000,23
KITAGWENDA,2025,1430,1680,3110,23
KITGUM,2015,1500,1670,3170,23
KITGUM,2016,1560,1690,3250,23
KITGUM,2017,1620,1700,3320,23
KITGUM,2018,1680,1710,3390,23
KITGUM,2019,1750,1720,3470,23
KITGUM,2020,1820,1740,3560,23
KITGUM,2021,1880,1780,3660,23
KITGUM,2022,1950,1820,3770,23
KITGUM,2023,2020,1870,3890,23
KITGUM,2024,2080,1910,3990,23
KITGUM,2025,2130,1940,4070,23
KOBOKO,2015,1560,1830,3390,23
KOBOKO,2016,1660,1900,3560,23
KOBOKO,2017,1770,1950,3720,23
KOBOKO,2018,1880,2000,3880,23
KOBOKO,2019,2000,2060,4060,23
KOBOKO,2020,2130,2140,4270,23
KOBOKO,2021,2260,2230,4490,23
KOBOKO,2022,2390,2340,4730,23
KOBOKO,2023,2540,2450,4990,23
KOBOKO,2024,2680,2550,5230,23
KOBOKO,2025,2800,2640,5440,23
KOLE,2015,1530,1710,3240,23
KOLE,2016,1590,1760,3350,23
KOLE,2017,1640,1810,3450,23
KOLE,2018,1690,1860,3550,23
KOLE,2019,1740,1910,3650,23
KOLE,2020,1800,1960,3760,23
KOLE,2021,1850,2010,3860,23
KOLE,2022,1910,2070,3980,23
KOLE,2023,1960,2120,4080,23
KOLE,2024,2020,2170,4190,23
KOLE,2025,2070,2220,4290,23
KOTIDO,2015,1080,1390,2470,23
KOTIDO,2016,1130,1420,2550,23
KOTIDO,2017,1190,1440,2630,23
KOTIDO,2018,1240,1460,2700,23
KOTIDO,2019,1300,1470,2770,23
KOTIDO,2020,1360,1500,2860,23
KOTIDO,2021,1430,1540,2970,23
KOTIDO,2022,1480,1590,3070,23
KOTIDO,2023,1550,1640,3190,23
KOTIDO,2024,1610,1680,3290,23
KOTIDO,2025,1670,1720,3390,23
KUMI,2015,1700,2070,3770,23
KUMI,2016,1790,2130,3920,23
KUMI,2017,1890,2170,4060,23
KUMI,2018,2000,2210,4210,23
KUMI,2019,2110,2250,4360,23
KUMI,2020,2230,2310,4540,23
KUMI,2021,2340,2390,4730,23
KUMI,2022,2470,2490,4960,23
KUMI,2023,2590,2580,5170,23
KUMI,2024,2720,2670,5390,23
KUMI,2025,2830,2730,5560,23
KWANIA,2015,1200,1280,2480,23
KWANIA,2016,1240,1320,2560,23
KWANIA,2017,1280,1360,2640,23
KWANIA,2018,1320,1390,2710,23
KWANIA,2019,1360,1430,2790,23
KWANIA,2020,1400,1470,2870,23
KWANIA,2021,1440,1510,2950,23
KWANIA,2022,1480,1550,3030,23
KWANIA,2023,1520,1590,3110,23
KWANIA,2024,1560,1630,3190,23
KWANIA,2025,1600,1670,3270,23
KWEEN,2015,650,670,1320,23
KWEEN,2016,670,690,1360,23
KWEEN,2017,690,710,1400,23
KWEEN,2018,710,730,1440,23
KWEEN,2019,730,740,1470,23
KWEEN,2020,750,760,1510,23
KWEEN,2021,770,780,1550,23
KWEEN,2022,800,790,1590,23
KWEEN,2023,820,810,1630,23
KWEEN,2024,840,830,1670,23
KWEEN,2025,860,840,1700,23
KYANKWANZI,2015,1960,1790,3750,23
KYANKWANZI,2016,2060,1880,3940,23
KYANKWANZI,2017,2170,1960,4130,23
KYANKWANZI,2018,2280,2050,4330,23
KYANKWANZI,2019,2390,2150,4540,23
KYANKWANZI,2020,2510,2240,4750,23
KYANKWANZI,2021,2640,2340,4980,23
KYANKWANZI,2022,2760,2450,5210,23
KYANKWANZI,2023,2890,2550,5440,23
KYANKWANZI,2024,3030,2660,5690,23
KYANKWANZI,2025,3170,2770,5940,23
KYEGEGWA,2015,2140,2610,4750,23
KYEGEGWA,2016,2310,2820,5130,23
KYEGEGWA,2017,2510,3040,5550,23
KYEGEGWA,2018,2710,3280,5990,23
KYEGEGWA,2019,2930,3540,6470,23
KYEGEGWA,2020,3170,3810,6980,23
KYEGEGWA,2021,3420,4100,7520,23
KYEGEGWA,2022,3690,4420,8110,23
KYEGEGWA,2023,3980,4750,8730,23
KYEGEGWA,2024,4290,5110,9400,23
KYEGEGWA,2025,4610,5480,10090,23
KYENJOJO,2015,3410,3760,7170,23
KYENJOJO,2016,3550,3900,7450,23
KYENJOJO,2017,3700,4040,7740,23
KYENJOJO,2018,3850,4190,8040,23
KYENJOJO,2019,4000,4340,8340,23
KYENJOJO,2020,4160,4490,8650,23
KYENJOJO,2021,4320,4650,8970,23
KYENJOJO,2022,4480,4810,9290,23
KYENJOJO,2023,4650,4970,9620,23
KYENJOJO,2024,4820,5130,9950,23
KYENJOJO,2025,4990,5300,10290,23
KYOTERA,2015,1560,2190,3750,23
KYOTERA,2016,1630,2220,3850,23
KYOTERA,2017,1690,2230,3920,23
KYOTERA,2018,1770,2240,4010,23
KYOTERA,2019,1830,2240,4070,23
KYOTERA,2020,1890,2270,4160,23
KYOTERA,2021,1970,2310,4280,23
KYOTERA,2022,2040,2360,4400,23
KYOTERA,2023,2110,2430,4540,23
KYOTERA,2024,2180,2470,4650,23
KYOTERA,2025,2230,2490,4720,23
KARENGA,2015,370,350,720,23
KARENGA,2016,380,360,740,23
KARENGA,2017,390,360,750,23
KARENGA,2018,410,370,780,23
KARENGA,2019,410,380,790,23
KARENGA,2020,430,390,820,23
KARENGA,2021,440,400,840,23
KARENGA,2022,450,410,860,23
KARENGA,2023,460,420,880,23
KARENGA,2024,470,430,900,23
KARENGA,2025,480,430,910,23
LAMWO,2015,760,1130,1890,23
LAMWO,2016,790,1150,1940,23
LAMWO,2017,800,1150,1950,23
LAMWO,2018,840,1150,1990,23
LAMWO,2019,860,1160,2020,23
LAMWO,2020,880,1170,2050,23
LAMWO,2021,920,1210,2130,23
LAMWO,2022,940,1230,2170,23
LAMWO,2023,970,1260,2230,23
LAMWO,2024,990,1280,2270,23
LAMWO,2025,1010,1300,2310,23
LIRA,2015,3060,3710,6770,23
LIRA,2016,3150,3810,6960,23
LIRA,2017,3240,3920,7160,23
LIRA,2018,3330,4030,7360,23
LIRA,2019,3420,4150,7570,23
LIRA,2020,3510,4260,7770,23
LIRA,2021,3600,4370,7970,23
LIRA,2022,3690,4490,8180,23
LIRA,2023,3780,4600,8380,23
LIRA,2024,3870,4710,8580,23
LIRA,2025,3960,4820,8780,23
LUUKA,2015,1490,1890,3380,23
LUUKA,2016,1550,1920,3470,23
LUUKA,2017,1620,1940,3560,23
LUUKA,2018,1690,1970,3660,23
LUUKA,2019,1770,1980,3750,23
LUUKA,2020,1840,2010,3850,23
LUUKA,2021,1920,2060,3980,23
LUUKA,2022,1990,2120,4110,23
LUUKA,2023,2070,2200,4270,23
LUUKA,2024,2150,2250,4400,23
LUUKA,2025,2200,2280,4480,23
LUWERO,2015,4090,4690,8780,23
LUWERO,2016,4280,4790,9070,23
LUWERO,2017,4500,4860,9360,23
LUWERO,2018,4720,4910,9630,23
LUWERO,2019,4940,4970,9910,23
LUWERO,2020,5160,5080,10240,23
LUWERO,2021,5410,5220,10630,23
LUWERO,2022,5660,5380,11040,23
LUWERO,2023,5910,5560,11470,23
LUWERO,2024,6150,5710,11860,23
LUWERO,2025,6350,5830,12180,23
LWENGO,2015,1680,2300,3980,23
LWENGO,2016,1730,2330,4060,23
LWENGO,2017,1780,2330,4110,23
LWENGO,2018,1850,2320,4170,23
LWENGO,2019,1910,2320,4230,23
LWENGO,2020,1970,2340,4310,23
LWENGO,2021,2020,2370,4390,23
LWENGO,2022,2090,2420,4510,23
LWENGO,2023,2150,2460,4610,23
LWENGO,2024,2200,2490,4690,23
LWENGO,2025,2240,2510,4750,23
LYANTONDE,2015,770,880,1650,23
LYANTONDE,2016,810,910,1720,23
LYANTONDE,2017,850,930,1780,23
LYANTONDE,2018,910,940,1850,23
LYANTONDE,2019,950,950,1900,23
LYANTONDE,2020,990,970,1960,23
LYANTONDE,2021,1040,1010,2050,23
LYANTONDE,2022,1110,1050,2160,23
LYANTONDE,2023,1160,1090,2250,23
LYANTONDE,2024,1200,1120,2320,23
LYANTONDE,2025,1260,1140,2400,23
MANAFWA,2015,890,1010,1900,23
MANAFWA,2016,910,1030,1940,23
MANAFWA,2017,930,1050,1980,23
MANAFWA,2018,960,1070,2030,23
MANAFWA,2019,980,1100,2080,23
MANAFWA,2020,1000,1120,2120,23
MANAFWA,2021,1030,1140,2170,23
MANAFWA,2022,1050,1170,2220,23
MANAFWA,2023,1070,1190,2260,23
MANAFWA,2024,1090,1210,2300,23
MANAFWA,2025,1120,1230,2350,23
MARACHA,2015,1010,1450,2460,23
MARACHA,2016,1030,1480,2510,23
MARACHA,2017,1050,1500,2550,23
MARACHA,2018,1070,1530,2600,23
MARACHA,2019,1090,1560,2650,23
MARACHA,2020,1120,1590,2710,23
MARACHA,2021,1140,1620,2760,23
MARACHA,2022,1160,1640,2800,23
MARACHA,2023,1180,1670,2850,23
MARACHA,2024,1200,1700,2900,23
MARACHA,2025,1220,1720,2940,23
MASAKA,2015,2560,3310,5870,23
MASAKA,2016,2680,3370,6050,23
MASAKA,2017,2800,3420,6220,23
MASAKA,2018,2930,3450,6380,23
MASAKA,2019,3060,3480,6540,23
MASAKA,2020,3200,3540,6740,23
MASAKA,2021,3330,3630,6960,23
MASAKA,2022,3490,3740,7230,23
MASAKA,2023,3630,3860,7490,23
MASAKA,2024,3760,3950,7710,23
MASAKA,2025,3870,4020,7890,23
MASINDI,2015,2780,2670,5450,23
MASINDI,2016,2860,2740,5600,23
MASINDI,2017,2950,2820,5770,23
MASINDI,2018,3030,2890,5920,23
MASINDI,2019,3120,2970,6090,23
MASINDI,2020,3200,3040,6240,23
MASINDI,2021,3290,3110,6400,23
MASINDI,2022,3370,3190,6560,23
MASINDI,2023,3460,3260,6720,23
MASINDI,2024,3550,3340,6890,23
MASINDI,2025,3630,3410,7040,23
MAYUGE,2015,3260,4270,7530,23
MAYUGE,2016,3440,4400,7840,23
MAYUGE,2017,3640,4500,8140,23
MAYUGE,2018,3840,4590,8430,23
MAYUGE,2019,4040,4680,8720,23
MAYUGE,2020,4250,4810,9060,23
MAYUGE,2021,4480,4980,9460,23
MAYUGE,2022,4720,5190,9910,23
MAYUGE,2023,4960,5400,10360,23
MAYUGE,2024,5190,5580,10770,23
MAYUGE,2025,5390,5750,11140,23
MBALE,2015,3970,4930,8900,23
MBALE,2016,4170,5090,9260,23
MBALE,2017,4410,5220,9630,23
MBALE,2018,4650,5330,9980,23
MBALE,2019,4880,5450,10330,23
MBALE,2020,5140,5610,10750,23
MBALE,2021,5420,5830,11250,23
MBALE,2022,5700,6090,11790,23
MBALE,2023,5980,6340,12320,23
MBALE,2024,6250,6580,12830,23
MBALE,2025,6480,6790,13270,23
MBARARA,2015,3410,3820,7230,23
MBARARA,2016,3490,3900,7390,23
MBARARA,2017,3570,3990,7560,23
MBARARA,2018,3660,4070,7730,23
MBARARA,2019,3740,4160,7900,23
MBARARA,2020,3820,4240,8060,23
MBARARA,2021,3900,4320,8220,23
MBARARA,2022,3970,4400,8370,23
MBARARA,2023,4050,4480,8530,23
MBARARA,2024,4120,4560,8680,23
MBARARA,2025,4200,4640,8840,23
MITOOMA,2015,1000,1380,2380,23
MITOOMA,2016,1010,1400,2410,23
MITOOMA,2017,1030,1410,2440,23
MITOOMA,2018,1040,1420,2460,23
MITOOMA,2019,1050,1430,2480,23
MITOOMA,2020,1060,1440,2500,23
MITOOMA,2021,1070,1450,2520,23
MITOOMA,2022,1080,1460,2540,23
MITOOMA,2023,1090,1470,2560,23
MITOOMA,2024,1100,1480,2580,23
MITOOMA,2025,1110,1490,2600,23
MITYANA,2015,2980,3310,6290,23
MITYANA,2016,3100,3350,6450,23
MITYANA,2017,3230,3380,6610,23
MITYANA,2018,3360,3390,6750,23
MITYANA,2019,3490,3420,6910,23
MITYANA,2020,3630,3450,7080,23
MITYANA,2021,3790,3530,7320,23
MITYANA,2022,3930,3620,7550,23
MITYANA,2023,4080,3710,7790,23
MITYANA,2024,4220,3790,8010,23
MITYANA,2025,4320,3840,8160,23
MOROTO,2015,720,840,1560,23
MOROTO,2016,750,860,1610,23
MOROTO,2017,780,880,1660,23
MOROTO,2018,820,890,1710,23
MOROTO,2019,850,910,1760,23
MOROTO,2020,900,930,1830,23
MOROTO,2021,930,960,1890,23
MOROTO,2022,980,980,1960,23
MOROTO,2023,1010,1020,2030,23
MOROTO,2024,1060,1050,2110,23
MOROTO,2025,1080,1070,2150,23
MOYO,2015,710,760,1470,23
MOYO,2016,720,780,1500,23
MOYO,2017,740,790,1530,23
MOYO,2018,760,810,1570,23
MOYO,2019,780,830,1610,23
MOYO,2020,800,850,1650,23
MOYO,2021,820,860,1680,23
MOYO,2022,830,880,1710,23
MOYO,2023,850,890,1740,23
MOYO,2024,870,910,1780,23
MOYO,2025,890,930,1820,23
MPIGI,2015,2050,2600,4650,23
MPIGI,2016,2140,2660,4800,23
MPIGI,2017,2250,2710,4960,23
MPIGI,2018,2350,2730,5080,23
MPIGI,2019,2460,2770,5230,23
MPIGI,2020,2570,2820,5390,23
MPIGI,2021,2700,2910,5610,23
MPIGI,2022,2810,3000,5810,23
MPIGI,2023,2940,3100,6040,23
MPIGI,2024,3040,3180,6220,23
MPIGI,2025,3150,3250,6400,23
MUBENDE,2015,3900,4470,8370,23
MUBENDE,2016,4190,4700,8890,23
MUBENDE,2017,4510,4900,9410,23
MUBENDE,2018,4870,5090,9960,23
MUBENDE,2019,5230,5310,10540,23
MUBENDE,2020,5630,5560,11190,23
MUBENDE,2021,6060,5880,11940,23
MUBENDE,2022,6500,6240,12740,23
MUBENDE,2023,6980,6620,13600,23
MUBENDE,2024,7470,7000,14470,23
MUBENDE,2025,7900,7340,15240,23
MUKONO,2015,5300,7120,12420,23
MUKONO,2016,5560,7340,12900,23
MUKONO,2017,5860,7480,13340,23
MUKONO,2018,6160,7610,13770,23
MUKONO,2019,6450,7760,14210,23
MUKONO,2020,6770,7970,14740,23
MUKONO,2021,7100,8250,15350,23
MUKONO,2022,7440,8570,16010,23
MUKONO,2023,7790,8910,16700,23
MUKONO,2024,8120,9200,17320,23
MUKONO,2025,8400,9460,17860,23
MADI OKOLLO,2015,900,1040,1940,23
MADI OKOLLO,2016,920,1070,1990,23
MADI OKOLLO,2017,950,1100,2050,23
MADI OKOLLO,2018,980,1130,2110,23
MADI OKOLLO,2019,1000,1160,2160,23
MADI OKOLLO,2020,1030,1190,2220,23
MADI OKOLLO,2021,1060,1220,2280,23
MADI OKOLLO,2022,1090,1250,2340,23
MADI OKOLLO,2023,1110,1270,2380,23
MADI OKOLLO,2024,1140,1300,2440,23
MADI OKOLLO,2025,1170,1330,2500,23
NABILATUK,2015,410,460,870,23
NABILATUK,2016,440,470,910,23
NABILATUK,2017,480,490,970,23
NABILATUK,2018,510,510,1020,23
NABILATUK,2019,550,530,1080,23
NABILATUK,2020,600,550,1150,23
NABILATUK,2021,640,570,1210,23
NABILATUK,2022,690,600,1290,23
NABILATUK,2023,730,650,1380,23
NABILATUK,2024,780,680,1460,23
NABILATUK,2025,830,700,1530,23
NAKAPIRIPIRIT,2015,580,660,1240,23
NAKAPIRIPIRIT,2016,620,690,1310,23
NAKAPIRIPIRIT,2017,660,720,1380,23
NAKAPIRIPIRIT,2018,700,730,1430,23
NAKAPIRIPIRIT,2019,750,760,1510,23
NAKAPIRIPIRIT,2020,800,790,1590,23
NAKAPIRIPIRIT,2021,850,830,1680,23
NAKAPIRIPIRIT,2022,910,880,1790,23
NAKAPIRIPIRIT,2023,970,920,1890,23
NAKAPIRIPIRIT,2024,1030,970,2000,23
NAKAPIRIPIRIT,2025,1080,1000,2080,23
NAKASEKE,2015,1820,1620,3440,23
NAKASEKE,2016,1890,1660,3550,23
NAKASEKE,2017,1960,1700,3660,23
NAKASEKE,2018,2030,1740,3770,23
NAKASEKE,2019,2100,1780,3880,23
NAKASEKE,2020,2170,1820,3990,23
NAKASEKE,2021,2250,1860,4110,23
NAKASEKE,2022,2320,1900,4220,23
NAKASEKE,2023,2400,1940,4340,23
NAKASEKE,2024,2480,1980,4460,23
NAKASEKE,2025,2550,2020,4570,23
NAKASONGOLA,2015,1650,1600,3250,23
NAKASONGOLA,2016,1740,1640,3380,23
NAKASONGOLA,2017,1840,1670,3510,23
NAKASONGOLA,2018,1940,1690,3630,23
NAKASONGOLA,2019,2050,1720,3770,23
NAKASONGOLA,2020,2150,1770,3920,23
NAKASONGOLA,2021,2280,1820,4100,23
NAKASONGOLA,2022,2390,1890,4280,23
NAKASONGOLA,2023,2510,1960,4470,23
NAKASONGOLA,2024,2640,2030,4670,23
NAKASONGOLA,2025,2740,2070,4810,23
NAMAYINGO,2015,1550,1880,3430,23
NAMAYINGO,2016,1620,1900,3520,23
NAMAYINGO,2017,1690,1920,3610,23
NAMAYINGO,2018,1770,1920,3690,23
NAMAYINGO,2019,1830,1940,3770,23
NAMAYINGO,2020,1900,1960,3860,23
NAMAYINGO,2021,1980,1990,3970,23
NAMAYINGO,2022,2060,2040,4100,23
NAMAYINGO,2023,2140,2090,4230,23
NAMAYINGO,2024,2200,2130,4330,23
NAMAYINGO,2025,2270,2160,4430,23
NAMISINDWA,2015,1110,1220,2330,23
NAMISINDWA,2016,1140,1250,2390,23
NAMISINDWA,2017,1170,1280,2450,23
NAMISINDWA,2018,1210,1310,2520,23
NAMISINDWA,2019,1240,1340,2580,23
NAMISINDWA,2020,1270,1370,2640,23
NAMISINDWA,2021,1300,1400,2700,23
NAMISINDWA,2022,1340,1430,2770,23
NAMISINDWA,2023,1370,1460,2830,23
NAMISINDWA,2024,1400,1490,2890,23
NAMISINDWA,2025,1430,1520,2950,23
NAMUTUMBA,2015,1590,2100,3690,23
NAMUTUMBA,2016,1670,2160,3830,23
NAMUTUMBA,2017,1780,2220,4000,23
NAMUTUMBA,2018,1880,2260,4140,23
NAMUTUMBA,2019,2000,2320,4320,23
NAMUTUMBA,2020,2100,2380,4480,23
NAMUTUMBA,2021,2230,2480,4710,23
NAMUTUMBA,2022,2350,2580,4930,23
NAMUTUMBA,2023,2490,2690,5180,23
NAMUTUMBA,2024,2610,2780,5390,23
NAMUTUMBA,2025,2720,2870,5590,23
NAPAK,2015,750,920,1670,23
NAPAK,2016,770,930,1700,23
NAPAK,2017,800,950,1750,23
NAPAK,2018,850,960,1810,23
NAPAK,2019,880,960,1840,23
NAPAK,2020,910,980,1890,23
NAPAK,2021,940,1010,1950,23
NAPAK,2022,980,1040,2020,23
NAPAK,2023,1010,1070,2080,23
NAPAK,2024,1040,1110,2150,23
NAPAK,2025,1070,1120,2190,23
NEBBI,2015,1590,1820,3410,23
NEBBI,2016,1640,1880,3520,23
NEBBI,2017,1690,1930,3620,23
NEBBI,2018,1740,1980,3720,23
NEBBI,2019,1800,2040,3840,23
NEBBI,2020,1850,2090,3940,23
NEBBI,2021,1910,2150,4060,23
NEBBI,2022,1960,2200,4160,23
NEBBI,2023,2020,2260,4280,23
NEBBI,2024,2070,2310,4380,23
NEBBI,2025,2130,2370,4500,23
NGORA,2015,1010,1210,2220,23
NGORA,2016,1050,1240,2290,23
NGORA,2017,1110,1270,2380,23
NGORA,2018,1170,1290,2460,23
NGORA,2019,1230,1310,2540,23
NGORA,2020,1280,1330,2610,23
NGORA,2021,1350,1370,2720,23
NGORA,2022,1420,1430,2850,23
NGORA,2023,1490,1480,2970,23
NGORA,2024,1540,1530,3070,23
NGORA,2025,1600,1570,3170,23
NTOROKO,2015,540,590,1130,23
NTOROKO,2016,560,600,1160,23
NTOROKO,2017,580,610,1190,23
NTOROKO,2018,610,610,1220,23
NTOROKO,2019,650,620,1270,23
NTOROKO,2020,670,630,1300,23
NTOROKO,2021,700,640,1340,23
NTOROKO,2022,740,650,1390,23
NTOROKO,2023,770,670,1440,23
NTOROKO,2024,800,690,1490,23
NTOROKO,2025,820,700,1520,23
NTUNGAMO,2015,3130,3730,6860,23
NTUNGAMO,2016,3200,3800,7000,23
NTUNGAMO,2017,3270,3870,7140,23
NTUNGAMO,2018,3340,3940,7280,23
NTUNGAMO,2019,3410,4010,7420,23
NTUNGAMO,2020,3480,4070,7550,23
NTUNGAMO,2021,3540,4140,7680,23
NTUNGAMO,2022,3610,4210,7820,23
NTUNGAMO,2023,3670,4270,7940,23
NTUNGAMO,2024,3730,4330,8060,23
NTUNGAMO,2025,3790,4390,8180,23
NWOYA,2015,910,1030,1940,23
NWOYA,2016,1010,1130,2140,23
NWOYA,2017,1110,1250,2360,23
NWOYA,2018,1230,1380,2610,23
NWOYA,2019,1360,1520,2880,23
NWOYA,2020,1500,1670,3170,23
NWOYA,2021,1650,1830,3480,23
NWOYA,2022,1820,2020,3840,23
NWOYA,2023,2000,2210,4210,23
NWOYA,2024,2200,2430,4630,23
NWOYA,2025,2420,2670,5090,23
OBONGI,2015,290,330,620,23
OBONGI,2016,310,330,640,23
OBONGI,2017,330,340,670,23
OBONGI,2018,330,340,670,23
OBONGI,2019,350,350,700,23
OBONGI,2020,370,360,730,23
OBONGI,2021,380,360,740,23
OBONGI,2022,400,380,780,23
OBONGI,2023,430,390,820,23
OBONGI,2024,430,400,830,23
OBONGI,2025,450,410,860,23
OMORO,2015,1100,1380,2480,23
OMORO,2016,1160,1430,2590,23
OMORO,2017,1220,1460,2680,23
OMORO,2018,1300,1500,2800,23
OMORO,2019,1380,1530,2910,23
OMORO,2020,1460,1590,3050,23
OMORO,2021,1540,1660,3200,23
OMORO,2022,1630,1720,3350,23
OMORO,2023,1710,1800,3510,23
OMORO,2024,1800,1880,3680,23
OMORO,2025,1890,1930,3820,23
OTUKE,2015,590,760,1350,23
OTUKE,2016,610,790,1400,23
OTUKE,2017,640,830,1470,23
OTUKE,2018,670,860,1530,23
OTUKE,2019,700,900,1600,23
OTUKE,2020,730,940,1670,23
OTUKE,2021,760,980,1740,23
OTUKE,2022,790,1020,1810,23
OTUKE,2023,820,1060,1880,23
OTUKE,2024,860,1100,1960,23
OTUKE,2025,890,1140,2030,23
OYAM,2015,2430,2770,5200,23
OYAM,2016,2500,2850,5350,23
OYAM,2017,2580,2940,5520,23
OYAM,2018,2660,3020,5680,23
OYAM,2019,2730,3110,5840,23
OYAM,2020,2810,3190,6000,23
OYAM,2021,2890,3280,6170,23
OYAM,2022,2970,3370,6340,23
OYAM,2023,3050,3450,6500,23
OYAM,2024,3130,3540,6670,23
OYAM,2025,3210,3630,6840,23
PADER,2015,1180,1580,2760,23
PADER,2016,1230,1600,2830,23
PADER,2017,1280,1620,2900,23
PADER,2018,1340,1640,2980,23
PADER,2019,1390,1650,3040,23
PADER,2020,1440,1680,3120,23
PADER,2021,1490,1710,3200,23
PADER,2022,1550,1770,3320,23
PADER,2023,1610,1810,3420,23
PADER,2024,1660,1850,3510,23
PADER,2025,1700,1890,3590,23
PAKWACH,2015,1090,1250,2340,23
PAKWACH,2016,1140,1300,2440,23
PAKWACH,2017,1180,1340,2520,23
PAKWACH,2018,1230,1390,2620,23
PAKWACH,2019,1280,1440,2720,23
PAKWACH,2020,1330,1490,2820,23
PAKWACH,2021,1390,1540,2930,23
PAKWACH,2022,1440,1590,3030,23
PAKWACH,2023,1500,1650,3150,23
PAKWACH,2024,1550,1700,3250,23
PAKWACH,2025,1610,1760,3370,23
PALLISA,2015,1840,2290,4130,23
PALLISA,2016,1970,2400,4370,23
PALLISA,2017,2110,2480,4590,23
PALLISA,2018,2250,2550,4800,23
PALLISA,2019,2410,2640,5050,23
PALLISA,2020,2570,2750,5320,23
PALLISA,2021,2750,2880,5630,23
PALLISA,2022,2930,3030,5960,23
PALLISA,2023,3110,3200,6310,23
PALLISA,2024,3300,3360,6660,23
PALLISA,2025,3470,3490,6960,23
RAKAI,2015,1840,2280,4120,23
RAKAI,2016,1930,2330,4260,23
RAKAI,2017,2030,2370,4400,23
RAKAI,2018,2140,2380,4520,23
RAKAI,2019,2230,2420,4650,23
RAKAI,2020,2340,2470,4810,23
RAKAI,2021,2440,2530,4970,23
RAKAI,2022,2560,2620,5180,23
RAKAI,2023,2670,2700,5370,23
RAKAI,2024,2790,2770,5560,23
RAKAI,2025,2870,2840,5710,23
RUBANDA,2015,1330,1630,2960,23
RUBANDA,2016,1350,1640,2990,23
RUBANDA,2017,1370,1660,3030,23
RUBANDA,2018,1380,1670,3050,23
RUBANDA,2019,1400,1680,3080,23
RUBANDA,2020,1420,1690,3110,23
RUBANDA,2021,1430,1700,3130,23
RUBANDA,2022,1450,1710,3160,23
RUBANDA,2023,1460,1720,3180,23
RUBANDA,2024,1480,1730,3210,23
RUBANDA,2025,1490,1730,3220,23
RUBIRIZI,2015,770,1050,1820,23
RUBIRIZI,2016,780,1070,1850,23
RUBIRIZI,2017,800,1090,1890,23
RUBIRIZI,2018,820,1110,1930,23
RUBIRIZI,2019,830,1130,1960,23
RUBIRIZI,2020,850,1150,2000,23
RUBIRIZI,2021,860,1170,2030,23
RUBIRIZI,2022,880,1190,2070,23
RUBIRIZI,2023,890,1210,2100,23
RUBIRIZI,2024,910,1220,2130,23
RUBIRIZI,2025,920,1240,2160,23
RUKIGA,2015,700,800,1500,23
RUKIGA,2016,700,810,1510,23
RUKIGA,2017,710,810,1520,23
RUKIGA,2018,720,820,1540,23
RUKIGA,2019,730,820,1550,23
RUKIGA,2020,730,830,1560,23
RUKIGA,2021,740,830,1570,23
RUKIGA,2022,740,830,1570,23
RUKIGA,2023,750,840,1590,23
RUKIGA,2024,750,840,1590,23
RUKIGA,2025,750,840,1590,23
RUKUNGIRI,2015,2000,2260,4260,23
RUKUNGIRI,2016,2030,2280,4310,23
RUKUNGIRI,2017,2050,2300,4350,23
RUKUNGIRI,2018,2080,2320,4400,23
RUKUNGIRI,2019,2100,2340,4440,23
RUKUNGIRI,2020,2120,2360,4480,23
RUKUNGIRI,2021,2140,2380,4520,23
RUKUNGIRI,2022,2160,2400,4560,23
RUKUNGIRI,2023,2180,2410,4590,23
RUKUNGIRI,2024,2200,2430,4630,23
RUKUNGIRI,2025,2210,2440,4650,23
RWAMPARA,2015,990,1070,2060,23
RWAMPARA,2016,1010,1090,2100,23
RWAMPARA,2017,1040,1110,2150,23
RWAMPARA,2018,1060,1140,2200,23
RWAMPARA,2019,1080,1160,2240,23
RWAMPARA,2020,1110,1190,2300,23
RWAMPARA,2021,1130,1210,2340,23
RWAMPARA,2022,1150,1230,2380,23
RWAMPARA,2023,1170,1250,2420,23
RWAMPARA,2024,1200,1280,2480,23
RWAMPARA,2025,1220,1300,2520,23
SERERE,2015,1990,2510,4500,23
SERERE,2016,2110,2600,4710,23
SERERE,2017,2250,2690,4940,23
SERERE,2018,2400,2770,5170,23
SERERE,2019,2540,2840,5380,23
SERERE,2020,2710,2950,5660,23
SERERE,2021,2880,3080,5960,23
SERERE,2022,3060,3240,6300,23
SERERE,2023,3240,3400,6640,23
SERERE,2024,3420,3540,6960,23
SERERE,2025,3600,3680,7280,23
SHEEMA,2015,1430,1680,3110,23
SHEEMA,2016,1450,1690,3140,23
SHEEMA,2017,1470,1710,3180,23
SHEEMA,2018,1480,1730,3210,23
SHEEMA,2019,1500,1750,3250,23
SHEEMA,2020,1520,1760,3280,23
SHEEMA,2021,1530,1780,3310,23
SHEEMA,2022,1550,1790,3340,23
SHEEMA,2023,1560,1800,3360,23
SHEEMA,2024,1570,1820,3390,23
SHEEMA,2025,1580,1830,3410,23
SIRONKO,2015,1390,1560,2950,23
SIRONKO,2016,1430,1590,3020,23
SIRONKO,2017,1460,1620,3080,23
SIRONKO,2018,1490,1650,3140,23
SIRONKO,2019,1530,1680,3210,23
SIRONKO,2020,1560,1720,3280,23
SIRONKO,2021,1600,1750,3350,23
SIRONKO,2022,1630,1780,3410,23
SIRONKO,2023,1660,1810,3470,23
SIRONKO,2024,1690,1840,3530,23
SIRONKO,2025,1730,1870,3600,23
SOROTI,2015,2610,2910,5520,23
SOROTI,2016,2770,3020,5790,23
SOROTI,2017,2940,3100,6040,23
SOROTI,2018,3130,3160,6290,23
SOROTI,2019,3300,3250,6550,23
SOROTI,2020,3490,3350,6840,23
SOROTI,2021,3700,3480,7180,23
SOROTI,2022,3920,3640,7560,23
SOROTI,2023,4130,3800,7930,23
SOROTI,2024,4340,3960,8300,23
SOROTI,2025,4540,4090,8630,23
SSEMBABULE,2015,1800,2150,3950,23
SSEMBABULE,2016,1890,2210,4100,23
SSEMBABULE,2017,1990,2250,4240,23
SSEMBABULE,2018,2100,2280,4380,23
SSEMBABULE,2019,2220,2320,4540,23
SSEMBABULE,2020,2330,2370,4700,23
SSEMBABULE,2021,2440,2440,4880,23
SSEMBABULE,2022,2560,2540,5100,23
SSEMBABULE,2023,2680,2630,5310,23
SSEMBABULE,2024,2810,2710,5520,23
SSEMBABULE,2025,2910,2780,5690,23
TORORO,2015,3410,3800,7210,23
TORORO,2016,3510,3900,7410,23
TORORO,2017,3600,3990,7590,23
TORORO,2018,3690,4090,7780,23
TORORO,2019,3790,4190,7980,23
TORORO,2020,3880,4290,8170,23
TORORO,2021,3980,4390,8370,23
TORORO,2022,4070,4480,8550,23
TORORO,2023,4160,4580,8740,23
TORORO,2024,4260,4680,8940,23
TORORO,2025,4350,4770,9120,23
WAKISO,2015,20410,29180,49590,23
WAKISO,2016,21770,31170,52940,23
WAKISO,2017,23230,33310,56540,23
WAKISO,2018,24780,35570,60350,23
WAKISO,2019,26420,37950,64370,23
WAKISO,2020,28140,40480,68620,23
WAKISO,2021,29950,43160,73110,23
WAKISO,2022,31870,46010,77880,23
WAKISO,2023,33900,48970,82870,23
WAKISO,2024,36000,52090,88090,23
WAKISO,2025,38220,55400,93620,23
YUMBE,2015,2560,3460,6020,23
YUMBE,2016,2760,3660,6420,23
YUMBE,2017,2960,3840,6800,23
YUMBE,2018,3190,4020,7210,23
YUMBE,2019,3420,4220,7640,23
YUMBE,2020,3670,4460,8130,23
YUMBE,2021,3940,4740,8680,23
YUMBE,2022,4240,5080,9320,23
YUMBE,2023,4530,5430,9960,23
YUMBE,2024,4840,5780,10620,23
YUMBE,2025,5130,6110,11240,23
ZOMBO,2015,1280,1550,2830,23
ZOMBO,2016,1320,1590,2910,23
ZOMBO,2017,1360,1640,3000,23
ZOMBO,2018,1400,1680,3080,23
ZOMBO,2019,1450,1730,3180,23
ZOMBO,2020,1490,1770,3260,23
ZOMBO,2021,1530,1820,3350,23
ZOMBO,2022,1570,1860,3430,23
ZOMBO,2023,1620,1910,3530,23
ZOMBO,2024,1660,1950,3610,23
ZOMBO,2025,1700,2000,3700,23
ABIM,2015,810,970,1780,24
ABIM,2016,870,1050,1920,24
ABIM,2017,940,1110,2050,24
ABIM,2018,1030,1160,2190,24
ABIM,2019,1130,1220,2350,24
ABIM,2020,1210,1280,2490,24
ABIM,2021,1330,1360,2690,24
ABIM,2022,1440,1450,2890,24
ABIM,2023,1560,1550,3110,24
ABIM,2024,1690,1660,3350,24
ABIM,2025,1830,1770,3600,24
ADJUMANI,2015,1440,1700,3140,24
ADJUMANI,2016,1450,1720,3170,24
ADJUMANI,2017,1460,1730,3190,24
ADJUMANI,2018,1470,1750,3220,24
ADJUMANI,2019,1480,1770,3250,24
ADJUMANI,2020,1490,1780,3270,24
ADJUMANI,2021,1500,1790,3290,24
ADJUMANI,2022,1510,1810,3320,24
ADJUMANI,2023,1510,1820,3330,24
ADJUMANI,2024,1520,1830,3350,24
ADJUMANI,2025,1520,1840,3360,24
AGAGO,2015,1250,1550,2800,24
AGAGO,2016,1270,1570,2840,24
AGAGO,2017,1290,1600,2890,24
AGAGO,2018,1320,1630,2950,24
AGAGO,2019,1340,1660,3000,24
AGAGO,2020,1360,1680,3040,24
AGAGO,2021,1380,1710,3090,24
AGAGO,2022,1400,1740,3140,24
AGAGO,2023,1420,1760,3180,24
AGAGO,2024,1440,1780,3220,24
AGAGO,2025,1460,1810,3270,24
ALEBTONG,2015,1390,1760,3150,24
ALEBTONG,2016,1450,1820,3270,24
ALEBTONG,2017,1530,1870,3400,24
ALEBTONG,2018,1610,1910,3520,24
ALEBTONG,2019,1680,1930,3610,24
ALEBTONG,2020,1770,1970,3740,24
ALEBTONG,2021,1850,2010,3860,24
ALEBTONG,2022,1940,2070,4010,24
ALEBTONG,2023,2040,2150,4190,24
ALEBTONG,2024,2140,2230,4370,24
ALEBTONG,2025,2220,2300,4520,24
AMOLATAR,2015,1020,1110,2130,24
AMOLATAR,2016,1060,1150,2210,24
AMOLATAR,2017,1120,1180,2300,24
AMOLATAR,2018,1170,1190,2360,24
AMOLATAR,2019,1230,1210,2440,24
AMOLATAR,2020,1290,1230,2520,24
AMOLATAR,2021,1350,1250,2600,24
AMOLATAR,2022,1420,1290,2710,24
AMOLATAR,2023,1480,1340,2820,24
AMOLATAR,2024,1550,1380,2930,24
AMOLATAR,2025,1610,1420,3030,24
AMUDAT,2015,860,1050,1910,24
AMUDAT,2016,910,1110,2020,24
AMUDAT,2017,960,1160,2120,24
AMUDAT,2018,1030,1210,2240,24
AMUDAT,2019,1080,1240,2320,24
AMUDAT,2020,1160,1290,2450,24
AMUDAT,2021,1230,1340,2570,24
AMUDAT,2022,1300,1410,2710,24
AMUDAT,2023,1380,1490,2870,24
AMUDAT,2024,1460,1580,3040,24
AMUDAT,2025,1540,1660,3200,24
AMURIA,2015,1140,1310,2450,24
AMURIA,2016,1190,1360,2550,24
AMURIA,2017,1270,1410,2680,24
AMURIA,2018,1350,1440,2790,24
AMURIA,2019,1420,1480,2900,24
AMURIA,2020,1500,1520,3020,24
AMURIA,2021,1600,1570,3170,24
AMURIA,2022,1700,1620,3320,24
AMURIA,2023,1790,1690,3480,24
AMURIA,2024,1890,1770,3660,24
AMURIA,2025,1980,1840,3820,24
AMURU,2015,1230,1480,2710,24
AMURU,2016,1270,1540,2810,24
AMURU,2017,1340,1580,2920,24
AMURU,2018,1400,1610,3010,24
AMURU,2019,1470,1630,3100,24
AMURU,2020,1550,1660,3210,24
AMURU,2021,1610,1690,3300,24
AMURU,2022,1700,1740,3440,24
AMURU,2023,1770,1810,3580,24
AMURU,2024,1850,1870,3720,24
AMURU,2025,1920,1930,3850,24
APAC,2015,1410,1530,2940,24
APAC,2016,1470,1580,3050,24
APAC,2017,1520,1640,3160,24
APAC,2018,1580,1690,3270,24
APAC,2019,1630,1750,3380,24
APAC,2020,1690,1810,3500,24
APAC,2021,1750,1870,3620,24
APAC,2022,1810,1930,3740,24
APAC,2023,1870,1990,3860,24
APAC,2024,1930,2050,3980,24
APAC,2025,1990,2110,4100,24
ARUA,2015,4500,5660,10160,24
ARUA,2016,4630,5820,10450,24
ARUA,2017,4760,5980,10740,24
ARUA,2018,4900,6130,11030,24
ARUA,2019,5040,6300,11340,24
ARUA,2020,5170,6460,11630,24
ARUA,2021,5320,6620,11940,24
ARUA,2022,5450,6780,12230,24
ARUA,2023,5590,6950,12540,24
ARUA,2024,5730,7110,12840,24
ARUA,2025,5860,7270,13130,24
BUDAKA,2015,1250,1520,2770,24
BUDAKA,2016,1310,1590,2900,24
BUDAKA,2017,1390,1640,3030,24
BUDAKA,2018,1470,1680,3150,24
BUDAKA,2019,1570,1730,3300,24
BUDAKA,2020,1650,1760,3410,24
BUDAKA,2021,1740,1820,3560,24
BUDAKA,2022,1850,1890,3740,24
BUDAKA,2023,1950,1970,3920,24
BUDAKA,2024,2070,2050,4120,24
BUDAKA,2025,2160,2130,4290,24
BUDUDA,2015,2060,2240,4300,24
BUDUDA,2016,2190,2370,4560,24
BUDUDA,2017,2330,2470,4800,24
BUDUDA,2018,2500,2560,5060,24
BUDUDA,2019,2670,2640,5310,24
BUDUDA,2020,2850,2730,5580,24
BUDUDA,2021,3040,2840,5880,24
BUDUDA,2022,3230,2980,6210,24
BUDUDA,2023,3460,3150,6610,24
BUDUDA,2024,3670,3310,6980,24
BUDUDA,2025,3900,3470,7370,24
BUGIRI,2015,2400,3140,5540,24
BUGIRI,2016,2540,3300,5840,24
BUGIRI,2017,2700,3420,6120,24
BUGIRI,2018,2880,3520,6400,24
BUGIRI,2019,3060,3620,6680,24
BUGIRI,2020,3250,3720,6970,24
BUGIRI,2021,3460,3850,7310,24
BUGIRI,2022,3670,4020,7690,24
BUGIRI,2023,3900,4210,8110,24
BUGIRI,2024,4140,4420,8560,24
BUGIRI,2025,4370,4620,8990,24
BUGWERI,2015,910,1370,2280,24
BUGWERI,2016,950,1430,2380,24
BUGWERI,2017,990,1460,2450,24
BUGWERI,2018,1050,1490,2540,24
BUGWERI,2019,1090,1500,2590,24
BUGWERI,2020,1150,1530,2680,24
BUGWERI,2021,1210,1560,2770,24
BUGWERI,2022,1270,1600,2870,24
BUGWERI,2023,1320,1660,2980,24
BUGWERI,2024,1380,1710,3090,24
BUGWERI,2025,1450,1770,3220,24
BUHWEJU,2015,1010,1090,2100,24
BUHWEJU,2016,1050,1120,2170,24
BUHWEJU,2017,1080,1160,2240,24
BUHWEJU,2018,1110,1190,2300,24
BUHWEJU,2019,1150,1230,2380,24
BUHWEJU,2020,1190,1260,2450,24
BUHWEJU,2021,1220,1300,2520,24
BUHWEJU,2022,1260,1330,2590,24
BUHWEJU,2023,1290,1370,2660,24
BUHWEJU,2024,1330,1410,2740,24
BUHWEJU,2025,1370,1440,2810,24
BUIKWE,2015,3290,4190,7480,24
BUIKWE,2016,3400,4320,7720,24
BUIKWE,2017,3550,4400,7950,24
BUIKWE,2018,3700,4450,8150,24
BUIKWE,2019,3860,4490,8350,24
BUIKWE,2020,4020,4530,8550,24
BUIKWE,2021,4180,4610,8790,24
BUIKWE,2022,4360,4720,9080,24
BUIKWE,2023,4540,4860,9400,24
BUIKWE,2024,4710,5010,9720,24
BUIKWE,2025,4880,5120,10000,24
BUKEDEA,2015,1300,1590,2890,24
BUKEDEA,2016,1380,1670,3050,24
BUKEDEA,2017,1470,1740,3210,24
BUKEDEA,2018,1570,1800,3370,24
BUKEDEA,2019,1680,1850,3530,24
BUKEDEA,2020,1790,1910,3700,24
BUKEDEA,2021,1910,1970,3880,24
BUKEDEA,2022,2030,2060,4090,24
BUKEDEA,2023,2170,2170,4340,24
BUKEDEA,2024,2310,2270,4580,24
BUKEDEA,2025,2440,2380,4820,24
BUKOMANSIMBI,2015,850,1020,1870,24
BUKOMANSIMBI,2016,870,1030,1900,24
BUKOMANSIMBI,2017,890,1030,1920,24
BUKOMANSIMBI,2018,930,1030,1960,24
BUKOMANSIMBI,2019,950,1020,1970,24
BUKOMANSIMBI,2020,980,1010,1990,24
BUKOMANSIMBI,2021,1010,1020,2030,24
BUKOMANSIMBI,2022,1030,1020,2050,24
BUKOMANSIMBI,2023,1070,1040,2110,24
BUKOMANSIMBI,2024,1090,1050,2140,24
BUKOMANSIMBI,2025,1110,1060,2170,24
BUKWO,2015,760,860,1620,24
BUKWO,2016,800,900,1700,24
BUKWO,2017,850,940,1790,24
BUKWO,2018,890,990,1880,24
BUKWO,2019,940,1040,1980,24
BUKWO,2020,990,1080,2070,24
BUKWO,2021,1040,1130,2170,24
BUKWO,2022,1090,1190,2280,24
BUKWO,2023,1150,1240,2390,24
BUKWO,2024,1200,1300,2500,24
BUKWO,2025,1260,1350,2610,24
BULAMBULI,2015,1660,1810,3470,24
BULAMBULI,2016,1770,1930,3700,24
BULAMBULI,2017,1890,2020,3910,24
BULAMBULI,2018,2040,2100,4140,24
BULAMBULI,2019,2190,2180,4370,24
BULAMBULI,2020,2340,2260,4600,24
BULAMBULI,2021,2500,2370,4870,24
BULAMBULI,2022,2680,2490,5170,24
BULAMBULI,2023,2870,2640,5510,24
BULAMBULI,2024,3070,2800,5870,24
BULAMBULI,2025,3260,2940,6200,24
BULIISA,2015,1320,970,2290,24
BULIISA,2016,1400,1010,2410,24
BULIISA,2017,1470,1060,2530,24
BULIISA,2018,1550,1100,2650,24
BULIISA,2019,1630,1150,2780,24
BULIISA,2020,1720,1200,2920,24
BULIISA,2021,1810,1250,3060,24
BULIISA,2022,1900,1300,3200,24
BULIISA,2023,2000,1360,3360,24
BULIISA,2024,2100,1410,3510,24
BULIISA,2025,2200,1470,3670,24
BUNDIBUGYO,2015,1600,1940,3540,24
BUNDIBUGYO,2016,1670,2010,3680,24
BUNDIBUGYO,2017,1750,2070,3820,24
BUNDIBUGYO,2018,1840,2110,3950,24
BUNDIBUGYO,2019,1950,2140,4090,24
BUNDIBUGYO,2020,2040,2170,4210,24
BUNDIBUGYO,2021,2140,2230,4370,24
BUNDIBUGYO,2022,2260,2300,4560,24
BUNDIBUGYO,2023,2370,2380,4750,24
BUNDIBUGYO,2024,2490,2470,4960,24
BUNDIBUGYO,2025,2590,2550,5140,24
BUNYANGABU,2015,1260,1450,2710,24
BUNYANGABU,2016,1320,1500,2820,24
BUNYANGABU,2017,1380,1540,2920,24
BUNYANGABU,2018,1450,1560,3010,24
BUNYANGABU,2019,1510,1570,3080,24
BUNYANGABU,2020,1590,1590,3180,24
BUNYANGABU,2021,1670,1620,3290,24
BUNYANGABU,2022,1740,1670,3410,24
BUNYANGABU,2023,1830,1720,3550,24
BUNYANGABU,2024,1900,1780,3680,24
BUNYANGABU,2025,1980,1810,3790,24
BUSHENYI,2015,1950,2250,4200,24
BUSHENYI,2016,1980,2270,4250,24
BUSHENYI,2017,2000,2300,4300,24
BUSHENYI,2018,2030,2320,4350,24
BUSHENYI,2019,2050,2330,4380,24
BUSHENYI,2020,2070,2350,4420,24
BUSHENYI,2021,2090,2370,4460,24
BUSHENYI,2022,2110,2380,4490,24
BUSHENYI,2023,2130,2400,4530,24
BUSHENYI,2024,2150,2410,4560,24
BUSHENYI,2025,2160,2420,4580,24
BUSIA,2015,2250,2760,5010,24
BUSIA,2016,2350,2870,5220,24
BUSIA,2017,2470,2940,5410,24
BUSIA,2018,2610,3000,5610,24
BUSIA,2019,2760,3050,5810,24
BUSIA,2020,2900,3110,6010,24
BUSIA,2021,3050,3190,6240,24
BUSIA,2022,3210,3300,6510,24
BUSIA,2023,3390,3430,6820,24
BUSIA,2024,3560,3560,7120,24
BUSIA,2025,3720,3670,7390,24
BUTALEJA,2015,1420,1900,3320,24
BUTALEJA,2016,1500,1980,3480,24
BUTALEJA,2017,1590,2050,3640,24
BUTALEJA,2018,1690,2110,3800,24
BUTALEJA,2019,1790,2150,3940,24
BUTALEJA,2020,1890,2210,4100,24
BUTALEJA,2021,2000,2280,4280,24
BUTALEJA,2022,2120,2370,4490,24
BUTALEJA,2023,2240,2470,4710,24
BUTALEJA,2024,2370,2590,4960,24
BUTALEJA,2025,2500,2680,5180,24
BUTAMBALA,2015,580,690,1270,24
BUTAMBALA,2016,600,710,1310,24
BUTAMBALA,2017,620,720,1340,24
BUTAMBALA,2018,650,730,1380,24
BUTAMBALA,2019,670,720,1390,24
BUTAMBALA,2020,700,720,1420,24
BUTAMBALA,2021,720,720,1440,24
BUTAMBALA,2022,740,740,1480,24
BUTAMBALA,2023,770,750,1520,24
BUTAMBALA,2024,800,770,1570,24
BUTAMBALA,2025,810,770,1580,24
BUTEBO,2015,660,810,1470,24
BUTEBO,2016,680,830,1510,24
BUTEBO,2017,700,840,1540,24
BUTEBO,2018,730,840,1570,24
BUTEBO,2019,760,840,1600,24
BUTEBO,2020,780,850,1630,24
BUTEBO,2021,810,850,1660,24
BUTEBO,2022,840,870,1710,24
BUTEBO,2023,870,890,1760,24
BUTEBO,2024,900,900,1800,24
BUTEBO,2025,930,920,1850,24
BUVUMA,2015,940,820,1760,24
BUVUMA,2016,1000,880,1880,24
BUVUMA,2017,1060,940,2000,24
BUVUMA,2018,1120,1000,2120,24
BUVUMA,2019,1190,1070,2260,24
BUVUMA,2020,1260,1140,2400,24
BUVUMA,2021,1340,1220,2560,24
BUVUMA,2022,1420,1300,2720,24
BUVUMA,2023,1500,1380,2880,24
BUVUMA,2024,1580,1470,3050,24
BUVUMA,2025,1670,1560,3230,24
BUYENDE,2015,1970,2530,4500,24
BUYENDE,2016,2100,2660,4760,24
BUYENDE,2017,2240,2770,5010,24
BUYENDE,2018,2400,2870,5270,24
BUYENDE,2019,2560,2960,5520,24
BUYENDE,2020,2730,3060,5790,24
BUYENDE,2021,2910,3170,6080,24
BUYENDE,2022,3100,3330,6430,24
BUYENDE,2023,3310,3510,6820,24
BUYENDE,2024,3520,3690,7210,24
BUYENDE,2025,3730,3860,7590,24
DOKOLO,2015,1200,1480,2680,24
DOKOLO,2016,1240,1520,2760,24
DOKOLO,2017,1280,1560,2840,24
DOKOLO,2018,1320,1600,2920,24
DOKOLO,2019,1360,1650,3010,24
DOKOLO,2020,1390,1690,3080,24
DOKOLO,2021,1440,1730,3170,24
DOKOLO,2022,1470,1770,3240,24
DOKOLO,2023,1510,1820,3330,24
DOKOLO,2024,1550,1860,3410,24
DOKOLO,2025,1590,1900,3490,24
GOMBA,2015,1020,1100,2120,24
GOMBA,2016,1050,1120,2170,24
GOMBA,2017,1100,1140,2240,24
GOMBA,2018,1140,1140,2280,24
GOMBA,2019,1190,1140,2330,24
GOMBA,2020,1240,1140,2380,24
GOMBA,2021,1280,1150,2430,24
GOMBA,2022,1330,1170,2500,24
GOMBA,2023,1380,1190,2570,24
GOMBA,2024,1430,1220,2650,24
GOMBA,2025,1470,1240,2710,24
GULU,2015,2650,2880,5530,24
GULU,2016,2730,2970,5700,24
GULU,2017,2810,3050,5860,24
GULU,2018,2900,3140,6040,24
GULU,2019,2980,3230,6210,24
GULU,2020,3070,3320,6390,24
GULU,2021,3150,3410,6560,24
GULU,2022,3240,3500,6740,24
GULU,2023,3320,3590,6910,24
GULU,2024,3410,3680,7090,24
GULU,2025,3490,3770,7260,24
HOIMA,2015,2770,2940,5710,24
HOIMA,2016,2870,3040,5910,24
HOIMA,2017,2980,3140,6120,24
HOIMA,2018,3090,3250,6340,24
HOIMA,2019,3200,3360,6560,24
HOIMA,2020,3320,3480,6800,24
HOIMA,2021,3440,3590,7030,24
HOIMA,2022,3560,3700,7260,24
HOIMA,2023,3680,3820,7500,24
HOIMA,2024,3800,3940,7740,24
HOIMA,2025,3920,4050,7970,24
IBANDA,2015,2010,2240,4250,24
IBANDA,2016,2050,2280,4330,24
IBANDA,2017,2090,2320,4410,24
IBANDA,2018,2130,2370,4500,24
IBANDA,2019,2170,2410,4580,24
IBANDA,2020,2210,2450,4660,24
IBANDA,2021,2250,2480,4730,24
IBANDA,2022,2290,2520,4810,24
IBANDA,2023,2330,2560,4890,24
IBANDA,2024,2360,2600,4960,24
IBANDA,2025,2400,2630,5030,24
IGANGA,2015,2430,3280,5710,24
IGANGA,2016,2540,3420,5960,24
IGANGA,2017,2670,3510,6180,24
IGANGA,2018,2830,3570,6400,24
IGANGA,2019,2990,3640,6630,24
IGANGA,2020,3140,3710,6850,24
IGANGA,2021,3300,3790,7090,24
IGANGA,2022,3480,3930,7410,24
IGANGA,2023,3660,4070,7730,24
IGANGA,2024,3850,4230,8080,24
IGANGA,2025,4030,4370,8400,24
ISINGIRO,2015,3460,3930,7390,24
ISINGIRO,2016,3590,4070,7660,24
ISINGIRO,2017,3720,4210,7930,24
ISINGIRO,2018,3860,4360,8220,24
ISINGIRO,2019,4000,4510,8510,24
ISINGIRO,2020,4140,4660,8800,24
ISINGIRO,2021,4290,4820,9110,24
ISINGIRO,2022,4440,4970,9410,24
ISINGIRO,2023,4580,5130,9710,24
ISINGIRO,2024,4740,5290,10030,24
ISINGIRO,2025,4890,5450,10340,24
JINJA,2015,4410,4720,9130,24
JINJA,2016,4490,4790,9280,24
JINJA,2017,4560,4870,9430,24
JINJA,2018,4640,4940,9580,24
JINJA,2019,4710,5010,9720,24
JINJA,2020,4780,5080,9860,24
JINJA,2021,4850,5150,10000,24
JINJA,2022,4920,5220,10140,24
JINJA,2023,4980,5280,10260,24
JINJA,2024,5050,5340,10390,24
JINJA,2025,5100,5390,10490,24
KAABONG,2015,750,1450,2200,24
KAABONG,2016,770,1490,2260,24
KAABONG,2017,790,1530,2320,24
KAABONG,2018,810,1560,2370,24
KAABONG,2019,830,1590,2420,24
KAABONG,2020,850,1630,2480,24
KAABONG,2021,880,1670,2550,24
KAABONG,2022,900,1710,2610,24
KAABONG,2023,920,1740,2660,24
KAABONG,2024,940,1770,2710,24
KAABONG,2025,960,1810,2770,24
KABALE,2015,1970,2050,4020,24
KABALE,2016,2000,2080,4080,24
KABALE,2017,2030,2100,4130,24
KABALE,2018,2060,2130,4190,24
KABALE,2019,2090,2150,4240,24
KABALE,2020,2120,2170,4290,24
KABALE,2021,2150,2200,4350,24
KABALE,2022,2180,2220,4400,24
KABALE,2023,2210,2230,4440,24
KABALE,2024,2230,2250,4480,24
KABALE,2025,2250,2270,4520,24
KABAROLE,2015,2800,2950,5750,24
KABAROLE,2016,2860,3010,5870,24
KABAROLE,2017,2920,3080,6000,24
KABAROLE,2018,2980,3140,6120,24
KABAROLE,2019,3050,3210,6260,24
KABAROLE,2020,3110,3270,6380,24
KABAROLE,2021,3170,3340,6510,24
KABAROLE,2022,3230,3400,6630,24
KABAROLE,2023,3290,3460,6750,24
KABAROLE,2024,3350,3520,6870,24
KABAROLE,2025,3400,3590,6990,24
KABERAMAIDO,2015,690,780,1470,24
KABERAMAIDO,2016,740,820,1560,24
KABERAMAIDO,2017,780,850,1630,24
KABERAMAIDO,2018,830,880,1710,24
KABERAMAIDO,2019,890,900,1790,24
KABERAMAIDO,2020,950,930,1880,24
KABERAMAIDO,2021,1010,960,1970,24
KABERAMAIDO,2022,1080,1000,2080,24
KABERAMAIDO,2023,1140,1050,2190,24
KABERAMAIDO,2024,1210,1100,2310,24
KABERAMAIDO,2025,1280,1160,2440,24
KAGADI,2015,2710,2980,5690,24
KAGADI,2016,2810,3090,5900,24
KAGADI,2017,2920,3200,6120,24
KAGADI,2018,3020,3310,6330,24
KAGADI,2019,3130,3430,6560,24
KAGADI,2020,3240,3540,6780,24
KAGADI,2021,3360,3660,7020,24
KAGADI,2022,3470,3780,7250,24
KAGADI,2023,3590,3900,7490,24
KAGADI,2024,3700,4020,7720,24
KAGADI,2025,3820,4140,7960,24
KAKUMIRO,2015,2550,2800,5350,24
KAKUMIRO,2016,2780,3030,5810,24
KAKUMIRO,2017,3020,3290,6310,24
KAKUMIRO,2018,3290,3560,6850,24
KAKUMIRO,2019,3570,3860,7430,24
KAKUMIRO,2020,3880,4180,8060,24
KAKUMIRO,2021,4220,4520,8740,24
KAKUMIRO,2022,4580,4890,9470,24
KAKUMIRO,2023,4970,5280,10250,24
KAKUMIRO,2024,5380,5700,11080,24
KAKUMIRO,2025,5830,6150,11980,24
KALAKI,2015,670,750,1420,24
KALAKI,2016,700,780,1480,24
KALAKI,2017,730,810,1540,24
KALAKI,2018,760,840,1600,24
KALAKI,2019,790,870,1660,24
KALAKI,2020,830,900,1730,24
KALAKI,2021,860,940,1800,24
KALAKI,2022,890,970,1860,24
KALAKI,2023,930,1010,1940,24
KALAKI,2024,960,1040,2000,24
KALAKI,2025,1000,1080,2080,24
KALANGALA,2015,810,670,1480,24
KALANGALA,2016,840,690,1530,24
KALANGALA,2017,870,720,1590,24
KALANGALA,2018,900,750,1650,24
KALANGALA,2019,930,780,1710,24
KALANGALA,2020,960,810,1770,24
KALANGALA,2021,990,840,1830,24
KALANGALA,2022,1020,880,1900,24
KALANGALA,2023,1060,910,1970,24
KALANGALA,2024,1090,940,2030,24
KALANGALA,2025,1120,980,2100,24
KALIRO,2015,1520,1860,3380,24
KALIRO,2016,1600,1940,3540,24
KALIRO,2017,1690,2010,3700,24
KALIRO,2018,1790,2060,3850,24
KALIRO,2019,1890,2110,4000,24
KALIRO,2020,2010,2160,4170,24
KALIRO,2021,2120,2230,4350,24
KALIRO,2022,2250,2320,4570,24
KALIRO,2023,2370,2420,4790,24
KALIRO,2024,2500,2520,5020,24
KALIRO,2025,2630,2620,5250,24
KALUNGU,2015,1030,1380,2410,24
KALUNGU,2016,1060,1400,2460,24
KALUNGU,2017,1100,1410,2510,24
KALUNGU,2018,1130,1420,2550,24
KALUNGU,2019,1180,1420,2600,24
KALUNGU,2020,1210,1420,2630,24
KALUNGU,2021,1250,1420,2670,24
KALUNGU,2022,1290,1450,2740,24
KALUNGU,2023,1330,1470,2800,24
KALUNGU,2024,1370,1490,2860,24
KALUNGU,2025,1400,1520,2920,24
KAMPALA,2015,22400,27170,49570,24
KAMPALA,2016,22850,27700,50550,24
KAMPALA,2017,23300,28230,51530,24
KAMPALA,2018,23750,28770,52520,24
KAMPALA,2019,24200,29300,53500,24
KAMPALA,2020,24640,29830,54470,24
KAMPALA,2021,25070,30350,55420,24
KAMPALA,2022,25490,30850,56340,24
KAMPALA,2023,25900,31350,57250,24
KAMPALA,2024,26300,31830,58130,24
KAMPALA,2025,26680,32300,58980,24
KAMULI,2015,3010,3790,6800,24
KAMULI,2016,3120,3920,7040,24
KAMULI,2017,3280,4000,7280,24
KAMULI,2018,3440,4050,7490,24
KAMULI,2019,3610,4100,7710,24
KAMULI,2020,3780,4150,7930,24
KAMULI,2021,3950,4230,8180,24
KAMULI,2022,4140,4350,8490,24
KAMULI,2023,4340,4480,8820,24
KAMULI,2024,4530,4630,9160,24
KAMULI,2025,4720,4750,9470,24
KAMWENGE,2015,2100,2350,4450,24
KAMWENGE,2016,2190,2430,4620,24
KAMWENGE,2017,2280,2520,4800,24
KAMWENGE,2018,2370,2610,4980,24
KAMWENGE,2019,2460,2700,5160,24
KAMWENGE,2020,2560,2790,5350,24
KAMWENGE,2021,2660,2880,5540,24
KAMWENGE,2022,2760,2980,5740,24
KAMWENGE,2023,2860,3080,5940,24
KAMWENGE,2024,2960,3170,6130,24
KAMWENGE,2025,3070,3270,6340,24
KANUNGU,2015,1690,2060,3750,24
KANUNGU,2016,1720,2090,3810,24
KANUNGU,2017,1750,2130,3880,24
KANUNGU,2018,1780,2160,3940,24
KANUNGU,2019,1810,2190,4000,24
KANUNGU,2020,1840,2230,4070,24
KANUNGU,2021,1870,2260,4130,24
KANUNGU,2022,1900,2290,4190,24
KANUNGU,2023,1930,2320,4250,24
KANUNGU,2024,1950,2350,4300,24
KANUNGU,2025,1980,2370,4350,24
KAPCHORWA,2015,900,1000,1900,24
KAPCHORWA,2016,930,1030,1960,24
KAPCHORWA,2017,960,1060,2020,24
KAPCHORWA,2018,990,1090,2080,24
KAPCHORWA,2019,1020,1110,2130,24
KAPCHORWA,2020,1050,1140,2190,24
KAPCHORWA,2021,1080,1170,2250,24
KAPCHORWA,2022,1110,1200,2310,24
KAPCHORWA,2023,1140,1230,2370,24
KAPCHORWA,2024,1170,1260,2430,24
KAPCHORWA,2025,1200,1290,2490,24
KAPELEBYONG,2015,440,580,1020,24
KAPELEBYONG,2016,460,610,1070,24
KAPELEBYONG,2017,490,620,1110,24
KAPELEBYONG,2018,510,630,1140,24
KAPELEBYONG,2019,550,640,1190,24
KAPELEBYONG,2020,570,650,1220,24
KAPELEBYONG,2021,600,670,1270,24
KAPELEBYONG,2022,640,690,1330,24
KAPELEBYONG,2023,670,720,1390,24
KAPELEBYONG,2024,700,740,1440,24
KAPELEBYONG,2025,740,760,1500,24
KASESE,2015,5030,6640,11670,24
KASESE,2016,5220,6860,12080,24
KASESE,2017,5460,7000,12460,24
KASESE,2018,5730,7110,12840,24
KASESE,2019,6010,7170,13180,24
KASESE,2020,6270,7250,13520,24
KASESE,2021,6560,7390,13950,24
KASESE,2022,6860,7580,14440,24
KASESE,2023,7170,7830,15000,24
KASESE,2024,7480,8080,15560,24
KASESE,2025,7770,8290,16060,24
KASSANDA,2015,2290,2250,4540,24
KASSANDA,2016,2350,2300,4650,24
KASSANDA,2017,2420,2350,4770,24
KASSANDA,2018,2490,2400,4890,24
KASSANDA,2019,2560,2440,5000,24
KASSANDA,2020,2630,2490,5120,24
KASSANDA,2021,2700,2540,5240,24
KASSANDA,2022,2770,2590,5360,24
KASSANDA,2023,2830,2640,5470,24
KASSANDA,2024,2900,2680,5580,24
KASSANDA,2025,2970,2730,5700,24
KATAKWI,2015,1210,1230,2440,24
KATAKWI,2016,1260,1280,2540,24
KATAKWI,2017,1330,1310,2640,24
KATAKWI,2018,1400,1330,2730,24
KATAKWI,2019,1470,1350,2820,24
KATAKWI,2020,1550,1380,2930,24
KATAKWI,2021,1620,1400,3020,24
KATAKWI,2022,1720,1450,3170,24
KATAKWI,2023,1800,1490,3290,24
KATAKWI,2024,1890,1550,3440,24
KATAKWI,2025,1970,1590,3560,24
KAYUNGA,2015,2250,2800,5050,24
KAYUNGA,2016,2320,2870,5190,24
KAYUNGA,2017,2410,2920,5330,24
KAYUNGA,2018,2520,2940,5460,24
KAYUNGA,2019,2630,2950,5580,24
KAYUNGA,2020,2730,2970,5700,24
KAYUNGA,2021,2840,3010,5850,24
KAYUNGA,2022,2960,3070,6030,24
KAYUNGA,2023,3080,3160,6240,24
KAYUNGA,2024,3190,3240,6430,24
KAYUNGA,2025,3300,3300,6600,24
KAZO,2015,1400,1460,2860,24
KAZO,2016,1450,1510,2960,24
KAZO,2017,1510,1570,3080,24
KAZO,2018,1560,1620,3180,24
KAZO,2019,1620,1680,3300,24
KAZO,2020,1670,1730,3400,24
KAZO,2021,1740,1790,3530,24
KAZO,2022,1800,1850,3650,24
KAZO,2023,1860,1910,3770,24
KAZO,2024,1920,1970,3890,24
KAZO,2025,1990,2030,4020,24
KIBAALE,2015,1290,1300,2590,24
KIBAALE,2016,1370,1380,2750,24
KIBAALE,2017,1460,1460,2920,24
KIBAALE,2018,1550,1540,3090,24
KIBAALE,2019,1650,1630,3280,24
KIBAALE,2020,1750,1720,3470,24
KIBAALE,2021,1860,1820,3680,24
KIBAALE,2022,1970,1910,3880,24
KIBAALE,2023,2090,2020,4110,24
KIBAALE,2024,2210,2130,4340,24
KIBAALE,2025,2340,2240,4580,24
KIBOGA,2015,1260,1270,2530,24
KIBOGA,2016,1320,1310,2630,24
KIBOGA,2017,1390,1340,2730,24
KIBOGA,2018,1450,1360,2810,24
KIBOGA,2019,1530,1380,2910,24
KIBOGA,2020,1600,1400,3000,24
KIBOGA,2021,1680,1410,3090,24
KIBOGA,2022,1760,1460,3220,24
KIBOGA,2023,1840,1510,3350,24
KIBOGA,2024,1920,1560,3480,24
KIBOGA,2025,2010,1600,3610,24
KIBUKU,2015,1180,1590,2770,24
KIBUKU,2016,1240,1670,2910,24
KIBUKU,2017,1320,1720,3040,24
KIBUKU,2018,1400,1770,3170,24
KIBUKU,2019,1490,1810,3300,24
KIBUKU,2020,1580,1860,3440,24
KIBUKU,2021,1670,1920,3590,24
KIBUKU,2022,1770,2010,3780,24
KIBUKU,2023,1880,2100,3980,24
KIBUKU,2024,1980,2200,4180,24
KIBUKU,2025,2090,2280,4370,24
KIKUUBE,2015,2340,2340,4680,24
KIKUUBE,2016,2460,2460,4920,24
KIKUUBE,2017,2590,2580,5170,24
KIKUUBE,2018,2730,2720,5450,24
KIKUUBE,2019,2880,2850,5730,24
KIKUUBE,2020,3030,2990,6020,24
KIKUUBE,2021,3180,3140,6320,24
KIKUUBE,2022,3340,3290,6630,24
KIKUUBE,2023,3510,3450,6960,24
KIKUUBE,2024,3680,3610,7290,24
KIKUUBE,2025,3850,3770,7620,24
KIRUHURA,2015,1390,1430,2820,24
KIRUHURA,2016,1440,1490,2930,24
KIRUHURA,2017,1500,1540,3040,24
KIRUHURA,2018,1560,1590,3150,24
KIRUHURA,2019,1610,1640,3250,24
KIRUHURA,2020,1670,1700,3370,24
KIRUHURA,2021,1730,1760,3490,24
KIRUHURA,2022,1790,1820,3610,24
KIRUHURA,2023,1850,1870,3720,24
KIRUHURA,2024,1910,1930,3840,24
KIRUHURA,2025,1980,1990,3970,24
KIRYANDONGO,2015,1970,2240,4210,24
KIRYANDONGO,2016,2070,2330,4400,24
KIRYANDONGO,2017,2170,2390,4560,24
KIRYANDONGO,2018,2290,2430,4720,24
KIRYANDONGO,2019,2420,2470,4890,24
KIRYANDONGO,2020,2550,2510,5060,24
KIRYANDONGO,2021,2680,2560,5240,24
KIRYANDONGO,2022,2810,2650,5460,24
KIRYANDONGO,2023,2950,2750,5700,24
KIRYANDONGO,2024,3100,2850,5950,24
KIRYANDONGO,2025,3240,2940,6180,24
KISORO,2015,1480,2730,4210,24
KISORO,2016,1540,2810,4350,24
KISORO,2017,1600,2870,4470,24
KISORO,2018,1670,2900,4570,24
KISORO,2019,1740,2920,4660,24
KISORO,2020,1800,2950,4750,24
KISORO,2021,1890,3000,4890,24
KISORO,2022,1970,3070,5040,24
KISORO,2023,2040,3170,5210,24
KISORO,2024,2120,3260,5380,24
KISORO,2025,2190,3330,5520,24
KITAGWENDA,2015,1070,1220,2290,24
KITAGWENDA,2016,1110,1260,2370,24
KITAGWENDA,2017,1160,1310,2470,24
KITAGWENDA,2018,1200,1360,2560,24
KITAGWENDA,2019,1250,1400,2650,24
KITAGWENDA,2020,1300,1450,2750,24
KITAGWENDA,2021,1350,1500,2850,24
KITAGWENDA,2022,1400,1550,2950,24
KITAGWENDA,2023,1450,1600,3050,24
KITAGWENDA,2024,1500,1650,3150,24
KITAGWENDA,2025,1560,1700,3260,24
KITGUM,2015,1280,1550,2830,24
KITGUM,2016,1320,1580,2900,24
KITGUM,2017,1370,1610,2980,24
KITGUM,2018,1430,1620,3050,24
KITGUM,2019,1480,1620,3100,24
KITGUM,2020,1540,1640,3180,24
KITGUM,2021,1590,1660,3250,24
KITGUM,2022,1650,1690,3340,24
KITGUM,2023,1710,1730,3440,24
KITGUM,2024,1770,1780,3550,24
KITGUM,2025,1830,1810,3640,24
KOBOKO,2015,1520,1770,3290,24
KOBOKO,2016,1600,1850,3450,24
KOBOKO,2017,1700,1930,3630,24
KOBOKO,2018,1810,1980,3790,24
KOBOKO,2019,1930,2030,3960,24
KOBOKO,2020,2040,2100,4140,24
KOBOKO,2021,2160,2170,4330,24
KOBOKO,2022,2300,2270,4570,24
KOBOKO,2023,2450,2370,4820,24
KOBOKO,2024,2580,2480,5060,24
KOBOKO,2025,2730,2590,5320,24
KOLE,2015,1690,1940,3630,24
KOLE,2016,1750,2000,3750,24
KOLE,2017,1800,2060,3860,24
KOLE,2018,1860,2110,3970,24
KOLE,2019,1920,2170,4090,24
KOLE,2020,1980,2230,4210,24
KOLE,2021,2040,2290,4330,24
KOLE,2022,2100,2350,4450,24
KOLE,2023,2160,2410,4570,24
KOLE,2024,2230,2470,4700,24
KOLE,2025,2290,2530,4820,24
KOTIDO,2015,1530,2070,3600,24
KOTIDO,2016,1590,2150,3740,24
KOTIDO,2017,1660,2190,3850,24
KOTIDO,2018,1740,2210,3950,24
KOTIDO,2019,1820,2240,4060,24
KOTIDO,2020,1900,2260,4160,24
KOTIDO,2021,1990,2310,4300,24
KOTIDO,2022,2080,2370,4450,24
KOTIDO,2023,2170,2440,4610,24
KOTIDO,2024,2270,2520,4790,24
KOTIDO,2025,2350,2590,4940,24
KUMI,2015,1500,1800,3300,24
KUMI,2016,1570,1880,3450,24
KUMI,2017,1650,1940,3590,24
KUMI,2018,1750,1970,3720,24
KUMI,2019,1840,2000,3840,24
KUMI,2020,1940,2040,3980,24
KUMI,2021,2050,2100,4150,24
KUMI,2022,2160,2160,4320,24
KUMI,2023,2270,2250,4520,24
KUMI,2024,2390,2340,4730,24
KUMI,2025,2500,2410,4910,24
KWANIA,2015,1360,1490,2850,24
KWANIA,2016,1400,1530,2930,24
KWANIA,2017,1440,1580,3020,24
KWANIA,2018,1490,1620,3110,24
KWANIA,2019,1530,1670,3200,24
KWANIA,2020,1580,1710,3290,24
KWANIA,2021,1620,1760,3380,24
KWANIA,2022,1670,1800,3470,24
KWANIA,2023,1710,1850,3560,24
KWANIA,2024,1760,1890,3650,24
KWANIA,2025,1800,1940,3740,24
KWEEN,2015,870,870,1740,24
KWEEN,2016,900,890,1790,24
KWEEN,2017,930,920,1850,24
KWEEN,2018,950,940,1890,24
KWEEN,2019,980,960,1940,24
KWEEN,2020,1010,980,1990,24
KWEEN,2021,1040,1010,2050,24
KWEEN,2022,1070,1030,2100,24
KWEEN,2023,1100,1050,2150,24
KWEEN,2024,1130,1070,2200,24
KWEEN,2025,1160,1090,2250,24
KYANKWANZI,2015,2130,1890,4020,24
KYANKWANZI,2016,2240,1980,4220,24
KYANKWANZI,2017,2350,2070,4420,24
KYANKWANZI,2018,2470,2160,4630,24
KYANKWANZI,2019,2600,2260,4860,24
KYANKWANZI,2020,2730,2370,5100,24
KYANKWANZI,2021,2860,2470,5330,24
KYANKWANZI,2022,3000,2580,5580,24
KYANKWANZI,2023,3140,2690,5830,24
KYANKWANZI,2024,3290,2810,6100,24
KYANKWANZI,2025,3440,2920,6360,24
KYEGEGWA,2015,2380,2680,5060,24
KYEGEGWA,2016,2570,2900,5470,24
KYEGEGWA,2017,2780,3130,5910,24
KYEGEGWA,2018,3010,3370,6380,24
KYEGEGWA,2019,3250,3630,6880,24
KYEGEGWA,2020,3520,3920,7440,24
KYEGEGWA,2021,3800,4220,8020,24
KYEGEGWA,2022,4100,4540,8640,24
KYEGEGWA,2023,4420,4880,9300,24
KYEGEGWA,2024,4760,5250,10010,24
KYEGEGWA,2025,5120,5630,10750,24
KYENJOJO,2015,3670,3720,7390,24
KYENJOJO,2016,3820,3860,7680,24
KYENJOJO,2017,3970,4000,7970,24
KYENJOJO,2018,4140,4150,8290,24
KYENJOJO,2019,4300,4290,8590,24
KYENJOJO,2020,4470,4450,8920,24
KYENJOJO,2021,4640,4600,9240,24
KYENJOJO,2022,4820,4760,9580,24
KYENJOJO,2023,5000,4920,9920,24
KYENJOJO,2024,5180,5080,10260,24
KYENJOJO,2025,5360,5240,10600,24
KYOTERA,2015,1490,1930,3420,24
KYOTERA,2016,1530,1980,3510,24
KYOTERA,2017,1590,2010,3600,24
KYOTERA,2018,1660,2020,3680,24
KYOTERA,2019,1710,2020,3730,24
KYOTERA,2020,1780,2030,3810,24
KYOTERA,2021,1840,2040,3880,24
KYOTERA,2022,1920,2080,4000,24
KYOTERA,2023,1990,2140,4130,24
KYOTERA,2024,2050,2190,4240,24
KYOTERA,2025,2130,2220,4350,24
KARENGA,2015,590,550,1140,24
KARENGA,2016,600,560,1160,24
KARENGA,2017,620,570,1190,24
KARENGA,2018,640,590,1230,24
KARENGA,2019,650,600,1250,24
KARENGA,2020,670,620,1290,24
KARENGA,2021,680,630,1310,24
KARENGA,2022,700,640,1340,24
KARENGA,2023,720,660,1380,24
KARENGA,2024,740,670,1410,24
KARENGA,2025,750,680,1430,24
LAMWO,2015,790,1010,1800,24
LAMWO,2016,810,1030,1840,24
LAMWO,2017,830,1050,1880,24
LAMWO,2018,860,1050,1910,24
LAMWO,2019,890,1050,1940,24
LAMWO,2020,910,1060,1970,24
LAMWO,2021,940,1070,2010,24
LAMWO,2022,980,1090,2070,24
LAMWO,2023,1000,1110,2110,24
LAMWO,2024,1030,1140,2170,24
LAMWO,2025,1050,1170,2220,24
LIRA,2015,3610,4210,7820,24
LIRA,2016,3720,4340,8060,24
LIRA,2017,3820,4460,8280,24
LIRA,2018,3930,4580,8510,24
LIRA,2019,4030,4710,8740,24
LIRA,2020,4140,4840,8980,24
LIRA,2021,4250,4970,9220,24
LIRA,2022,4350,5100,9450,24
LIRA,2023,4460,5220,9680,24
LIRA,2024,4560,5350,9910,24
LIRA,2025,4670,5480,10150,24
LUUKA,2015,1400,1870,3270,24
LUUKA,2016,1450,1930,3380,24
LUUKA,2017,1510,1960,3470,24
LUUKA,2018,1570,1980,3550,24
LUUKA,2019,1650,2000,3650,24
LUUKA,2020,1720,2020,3740,24
LUUKA,2021,1790,2050,3840,24
LUUKA,2022,1860,2100,3960,24
LUUKA,2023,1940,2160,4100,24
LUUKA,2024,2020,2230,4250,24
LUUKA,2025,2090,2280,4370,24
LUWERO,2015,3620,4120,7740,24
LUWERO,2016,3750,4250,8000,24
LUWERO,2017,3930,4360,8290,24
LUWERO,2018,4130,4420,8550,24
LUWERO,2019,4320,4460,8780,24
LUWERO,2020,4530,4510,9040,24
LUWERO,2021,4740,4600,9340,24
LUWERO,2022,4960,4720,9680,24
LUWERO,2023,5190,4880,10070,24
LUWERO,2024,5410,5030,10440,24
LUWERO,2025,5630,5170,10800,24
LWENGO,2015,1530,2030,3560,24
LWENGO,2016,1560,2070,3630,24
LWENGO,2017,1610,2090,3700,24
LWENGO,2018,1670,2100,3770,24
LWENGO,2019,1730,2090,3820,24
LWENGO,2020,1770,2090,3860,24
LWENGO,2021,1830,2100,3930,24
LWENGO,2022,1890,2130,4020,24
LWENGO,2023,1950,2170,4120,24
LWENGO,2024,2010,2210,4220,24
LWENGO,2025,2060,2240,4300,24
LYANTONDE,2015,710,820,1530,24
LYANTONDE,2016,740,860,1600,24
LYANTONDE,2017,760,910,1670,24
LYANTONDE,2018,800,940,1740,24
LYANTONDE,2019,840,960,1800,24
LYANTONDE,2020,880,980,1860,24
LYANTONDE,2021,930,1000,1930,24
LYANTONDE,2022,970,1020,1990,24
LYANTONDE,2023,1020,1040,2060,24
LYANTONDE,2024,1080,1080,2160,24
LYANTONDE,2025,1140,1110,2250,24
MANAFWA,2015,1140,1160,2300,24
MANAFWA,2016,1160,1190,2350,24
MANAFWA,2017,1190,1220,2410,24
MANAFWA,2018,1220,1240,2460,24
MANAFWA,2019,1250,1270,2520,24
MANAFWA,2020,1280,1300,2580,24
MANAFWA,2021,1310,1320,2630,24
MANAFWA,2022,1340,1350,2690,24
MANAFWA,2023,1370,1370,2740,24
MANAFWA,2024,1400,1400,2800,24
MANAFWA,2025,1420,1420,2840,24
MARACHA,2015,990,1510,2500,24
MARACHA,2016,1010,1540,2550,24
MARACHA,2017,1040,1570,2610,24
MARACHA,2018,1060,1600,2660,24
MARACHA,2019,1080,1630,2710,24
MARACHA,2020,1100,1660,2760,24
MARACHA,2021,1120,1690,2810,24
MARACHA,2022,1140,1720,2860,24
MARACHA,2023,1160,1750,2910,24
MARACHA,2024,1180,1770,2950,24
MARACHA,2025,1200,1800,3000,24
MASAKA,2015,2350,3100,5450,24
MASAKA,2016,2440,3210,5650,24
MASAKA,2017,2550,3270,5820,24
MASAKA,2018,2660,3300,5960,24
MASAKA,2019,2790,3330,6120,24
MASAKA,2020,2910,3360,6270,24
MASAKA,2021,3040,3420,6460,24
MASAKA,2022,3170,3510,6680,24
MASAKA,2023,3310,3610,6920,24
MASAKA,2024,3440,3720,7160,24
MASAKA,2025,3570,3810,7380,24
MASINDI,2015,3030,2690,5720,24
MASINDI,2016,3110,2760,5870,24
MASINDI,2017,3210,2840,6050,24
MASINDI,2018,3300,2910,6210,24
MASINDI,2019,3390,2990,6380,24
MASINDI,2020,3480,3060,6540,24
MASINDI,2021,3580,3140,6720,24
MASINDI,2022,3670,3210,6880,24
MASINDI,2023,3760,3290,7050,24
MASINDI,2024,3860,3360,7220,24
MASINDI,2025,3950,3440,7390,24
MAYUGE,2015,3030,4110,7140,24
MAYUGE,2016,3160,4280,7440,24
MAYUGE,2017,3330,4400,7730,24
MAYUGE,2018,3520,4500,8020,24
MAYUGE,2019,3710,4580,8290,24
MAYUGE,2020,3910,4680,8590,24
MAYUGE,2021,4120,4800,8920,24
MAYUGE,2022,4330,4970,9300,24
MAYUGE,2023,4560,5170,9730,24
MAYUGE,2024,4790,5390,10180,24
MAYUGE,2025,5010,5570,10580,24
MBALE,2015,4200,5080,9280,24
MBALE,2016,4390,5310,9700,24
MBALE,2017,4610,5490,10100,24
MBALE,2018,4880,5620,10500,24
MBALE,2019,5130,5730,10860,24
MBALE,2020,5400,5870,11270,24
MBALE,2021,5670,6040,11710,24
MBALE,2022,5970,6270,12240,24
MBALE,2023,6280,6540,12820,24
MBALE,2024,6600,6820,13420,24
MBALE,2025,6880,7070,13950,24
MBARARA,2015,3820,4060,7880,24
MBARARA,2016,3910,4150,8060,24
MBARARA,2017,4000,4240,8240,24
MBARARA,2018,4090,4330,8420,24
MBARARA,2019,4180,4420,8600,24
MBARARA,2020,4270,4510,8780,24
MBARARA,2021,4360,4600,8960,24
MBARARA,2022,4440,4680,9120,24
MBARARA,2023,4540,4770,9310,24
MBARARA,2024,4620,4850,9470,24
MBARARA,2025,4700,4930,9630,24
MITOOMA,2015,1000,1540,2540,24
MITOOMA,2016,1010,1560,2570,24
MITOOMA,2017,1030,1570,2600,24
MITOOMA,2018,1040,1590,2630,24
MITOOMA,2019,1050,1600,2650,24
MITOOMA,2020,1060,1610,2670,24
MITOOMA,2021,1070,1630,2700,24
MITOOMA,2022,1080,1640,2720,24
MITOOMA,2023,1090,1650,2740,24
MITOOMA,2024,1100,1660,2760,24
MITOOMA,2025,1110,1660,2770,24
MITYANA,2015,2570,2780,5350,24
MITYANA,2016,2650,2850,5500,24
MITYANA,2017,2750,2900,5650,24
MITYANA,2018,2870,2920,5790,24
MITYANA,2019,2990,2930,5920,24
MITYANA,2020,3100,2940,6040,24
MITYANA,2021,3230,2980,6210,24
MITYANA,2022,3360,3040,6400,24
MITYANA,2023,3490,3120,6610,24
MITYANA,2024,3610,3200,6810,24
MITYANA,2025,3730,3260,6990,24
MOROTO,2015,910,1110,2020,24
MOROTO,2016,950,1150,2100,24
MOROTO,2017,980,1170,2150,24
MOROTO,2018,1040,1190,2230,24
MOROTO,2019,1080,1210,2290,24
MOROTO,2020,1130,1220,2350,24
MOROTO,2021,1170,1250,2420,24
MOROTO,2022,1240,1290,2530,24
MOROTO,2023,1290,1340,2630,24
MOROTO,2024,1340,1380,2720,24
MOROTO,2025,1390,1420,2810,24
MOYO,2015,800,820,1620,24
MOYO,2016,820,840,1660,24
MOYO,2017,840,850,1690,24
MOYO,2018,860,870,1730,24
MOYO,2019,890,890,1780,24
MOYO,2020,910,910,1820,24
MOYO,2021,930,930,1860,24
MOYO,2022,950,940,1890,24
MOYO,2023,970,960,1930,24
MOYO,2024,990,980,1970,24
MOYO,2025,1010,1000,2010,24
MPIGI,2015,1920,2240,4160,24
MPIGI,2016,1990,2320,4310,24
MPIGI,2017,2080,2370,4450,24
MPIGI,2018,2180,2400,4580,24
MPIGI,2019,2290,2430,4720,24
MPIGI,2020,2400,2460,4860,24
MPIGI,2021,2500,2500,5000,24
MPIGI,2022,2620,2570,5190,24
MPIGI,2023,2730,2660,5390,24
MPIGI,2024,2850,2750,5600,24
MPIGI,2025,2950,2820,5770,24
MUBENDE,2015,3730,4270,8000,24
MUBENDE,2016,3980,4540,8520,24
MUBENDE,2017,4280,4760,9040,24
MUBENDE,2018,4620,4980,9600,24
MUBENDE,2019,4980,5170,10150,24
MUBENDE,2020,5350,5380,10730,24
MUBENDE,2021,5750,5630,11380,24
MUBENDE,2022,6180,5950,12130,24
MUBENDE,2023,6640,6310,12950,24
MUBENDE,2024,7110,6700,13810,24
MUBENDE,2025,7600,7070,14670,24
MUKONO,2015,4870,6750,11620,24
MUKONO,2016,5080,7020,12100,24
MUKONO,2017,5330,7210,12540,24
MUKONO,2018,5610,7370,12980,24
MUKONO,2019,5890,7490,13380,24
MUKONO,2020,6180,7640,13820,24
MUKONO,2021,6480,7830,14310,24
MUKONO,2022,6780,8100,14880,24
MUKONO,2023,7110,8420,15530,24
MUKONO,2024,7440,8740,16180,24
MUKONO,2025,7750,9030,16780,24
MADI OKOLLO,2015,950,1110,2060,24
MADI OKOLLO,2016,980,1150,2130,24
MADI OKOLLO,2017,1010,1170,2180,24
MADI OKOLLO,2018,1040,1210,2250,24
MADI OKOLLO,2019,1060,1240,2300,24
MADI OKOLLO,2020,1100,1270,2370,24
MADI OKOLLO,2021,1120,1300,2420,24
MADI OKOLLO,2022,1150,1340,2490,24
MADI OKOLLO,2023,1180,1370,2550,24
MADI OKOLLO,2024,1210,1400,2610,24
MADI OKOLLO,2025,1240,1430,2670,24
NABILATUK,2015,520,600,1120,24
NABILATUK,2016,550,640,1190,24
NABILATUK,2017,590,670,1260,24
NABILATUK,2018,640,700,1340,24
NABILATUK,2019,680,720,1400,24
NABILATUK,2020,730,740,1470,24
NABILATUK,2021,790,770,1560,24
NABILATUK,2022,850,810,1660,24
NABILATUK,2023,910,850,1760,24
NABILATUK,2024,970,900,1870,24
NABILATUK,2025,1040,940,1980,24
NAKAPIRIPIRIT,2015,750,870,1620,24
NAKAPIRIPIRIT,2016,790,920,1710,24
NAKAPIRIPIRIT,2017,840,960,1800,24
NAKAPIRIPIRIT,2018,910,1000,1910,24
NAKAPIRIPIRIT,2019,970,1030,2000,24
NAKAPIRIPIRIT,2020,1030,1060,2090,24
NAKAPIRIPIRIT,2021,1100,1100,2200,24
NAKAPIRIPIRIT,2022,1170,1160,2330,24
NAKAPIRIPIRIT,2023,1250,1210,2460,24
NAKAPIRIPIRIT,2024,1330,1280,2610,24
NAKAPIRIPIRIT,2025,1400,1340,2740,24
NAKASEKE,2015,1970,1590,3560,24
NAKASEKE,2016,2040,1620,3660,24
NAKASEKE,2017,2110,1660,3770,24
NAKASEKE,2018,2190,1700,3890,24
NAKASEKE,2019,2270,1740,4010,24
NAKASEKE,2020,2350,1780,4130,24
NAKASEKE,2021,2430,1820,4250,24
NAKASEKE,2022,2510,1860,4370,24
NAKASEKE,2023,2590,1900,4490,24
NAKASEKE,2024,2680,1930,4610,24
NAKASEKE,2025,2760,1970,4730,24
NAKASONGOLA,2015,1510,1520,3030,24
NAKASONGOLA,2016,1590,1580,3170,24
NAKASONGOLA,2017,1670,1620,3290,24
NAKASONGOLA,2018,1760,1650,3410,24
NAKASONGOLA,2019,1860,1670,3530,24
NAKASONGOLA,2020,1950,1700,3650,24
NAKASONGOLA,2021,2060,1750,3810,24
NAKASONGOLA,2022,2180,1800,3980,24
NAKASONGOLA,2023,2290,1870,4160,24
NAKASONGOLA,2024,2410,1940,4350,24
NAKASONGOLA,2025,2520,1990,4510,24
NAMAYINGO,2015,1450,1810,3260,24
NAMAYINGO,2016,1500,1850,3350,24
NAMAYINGO,2017,1560,1880,3440,24
NAMAYINGO,2018,1630,1900,3530,24
NAMAYINGO,2019,1690,1900,3590,24
NAMAYINGO,2020,1760,1920,3680,24
NAMAYINGO,2021,1830,1930,3760,24
NAMAYINGO,2022,1910,1970,3880,24
NAMAYINGO,2023,1980,2010,3990,24
NAMAYINGO,2024,2050,2070,4120,24
NAMAYINGO,2025,2120,2110,4230,24
NAMISINDWA,2015,1550,1640,3190,24
NAMISINDWA,2016,1590,1680,3270,24
NAMISINDWA,2017,1640,1720,3360,24
NAMISINDWA,2018,1680,1760,3440,24
NAMISINDWA,2019,1730,1800,3530,24
NAMISINDWA,2020,1770,1840,3610,24
NAMISINDWA,2021,1820,1880,3700,24
NAMISINDWA,2022,1860,1920,3780,24
NAMISINDWA,2023,1910,1960,3870,24
NAMISINDWA,2024,1950,2000,3950,24
NAMISINDWA,2025,2000,2040,4040,24
NAMUTUMBA,2015,1420,1970,3390,24
NAMUTUMBA,2016,1490,2050,3540,24
NAMUTUMBA,2017,1570,2110,3680,24
NAMUTUMBA,2018,1670,2170,3840,24
NAMUTUMBA,2019,1770,2210,3980,24
NAMUTUMBA,2020,1870,2260,4130,24
NAMUTUMBA,2021,1980,2330,4310,24
NAMUTUMBA,2022,2090,2410,4500,24
NAMUTUMBA,2023,2200,2510,4710,24
NAMUTUMBA,2024,2320,2620,4940,24
NAMUTUMBA,2025,2440,2720,5160,24
NAPAK,2015,950,1280,2230,24
NAPAK,2016,980,1320,2300,24
NAPAK,2017,1010,1340,2350,24
NAPAK,2018,1060,1360,2420,24
NAPAK,2019,1100,1370,2470,24
NAPAK,2020,1140,1390,2530,24
NAPAK,2021,1190,1410,2600,24
NAPAK,2022,1220,1450,2670,24
NAPAK,2023,1270,1490,2760,24
NAPAK,2024,1310,1540,2850,24
NAPAK,2025,1360,1570,2930,24
NEBBI,2015,1540,1700,3240,24
NEBBI,2016,1590,1750,3340,24
NEBBI,2017,1640,1800,3440,24
NEBBI,2018,1690,1850,3540,24
NEBBI,2019,1740,1900,3640,24
NEBBI,2020,1790,1950,3740,24
NEBBI,2021,1850,2000,3850,24
NEBBI,2022,1900,2050,3950,24
NEBBI,2023,1950,2100,4050,24
NEBBI,2024,2010,2150,4160,24
NEBBI,2025,2060,2200,4260,24
NGORA,2015,890,1120,2010,24
NGORA,2016,940,1160,2100,24
NGORA,2017,980,1190,2170,24
NGORA,2018,1040,1220,2260,24
NGORA,2019,1090,1230,2320,24
NGORA,2020,1140,1250,2390,24
NGORA,2021,1200,1280,2480,24
NGORA,2022,1260,1320,2580,24
NGORA,2023,1320,1360,2680,24
NGORA,2024,1380,1410,2790,24
NGORA,2025,1450,1450,2900,24
NTOROKO,2015,570,530,1100,24
NTOROKO,2016,590,540,1130,24
NTOROKO,2017,620,550,1170,24
NTOROKO,2018,650,560,1210,24
NTOROKO,2019,680,570,1250,24
NTOROKO,2020,720,570,1290,24
NTOROKO,2021,750,580,1330,24
NTOROKO,2022,790,590,1380,24
NTOROKO,2023,820,610,1430,24
NTOROKO,2024,860,630,1490,24
NTOROKO,2025,880,650,1530,24
NTUNGAMO,2015,3490,3980,7470,24
NTUNGAMO,2016,3560,4050,7610,24
NTUNGAMO,2017,3640,4130,7770,24
NTUNGAMO,2018,3720,4200,7920,24
NTUNGAMO,2019,3790,4280,8070,24
NTUNGAMO,2020,3870,4350,8220,24
NTUNGAMO,2021,3940,4420,8360,24
NTUNGAMO,2022,4020,4490,8510,24
NTUNGAMO,2023,4090,4560,8650,24
NTUNGAMO,2024,4160,4630,8790,24
NTUNGAMO,2025,4220,4690,8910,24
NWOYA,2015,940,1070,2010,24
NWOYA,2016,1040,1180,2220,24
NWOYA,2017,1150,1300,2450,24
NWOYA,2018,1270,1430,2700,24
NWOYA,2019,1400,1580,2980,24
NWOYA,2020,1550,1730,3280,24
NWOYA,2021,1700,1910,3610,24
NWOYA,2022,1880,2090,3970,24
NWOYA,2023,2070,2300,4370,24
NWOYA,2024,2270,2530,4800,24
NWOYA,2025,2500,2770,5270,24
OBONGI,2015,300,360,660,24
OBONGI,2016,320,380,700,24
OBONGI,2017,330,390,720,24
OBONGI,2018,350,380,730,24
OBONGI,2019,370,390,760,24
OBONGI,2020,390,400,790,24
OBONGI,2021,410,410,820,24
OBONGI,2022,420,420,840,24
OBONGI,2023,440,430,870,24
OBONGI,2024,460,440,900,24
OBONGI,2025,480,460,940,24
OMORO,2015,1050,1220,2270,24
OMORO,2016,1100,1280,2380,24
OMORO,2017,1170,1320,2490,24
OMORO,2018,1240,1360,2600,24
OMORO,2019,1310,1390,2700,24
OMORO,2020,1390,1420,2810,24
OMORO,2021,1470,1460,2930,24
OMORO,2022,1550,1530,3080,24
OMORO,2023,1640,1590,3230,24
OMORO,2024,1740,1660,3400,24
OMORO,2025,1820,1730,3550,24
OTUKE,2015,680,850,1530,24
OTUKE,2016,710,890,1600,24
OTUKE,2017,740,930,1670,24
OTUKE,2018,770,970,1740,24
OTUKE,2019,810,1010,1820,24
OTUKE,2020,840,1050,1890,24
OTUKE,2021,880,1090,1970,24
OTUKE,2022,910,1140,2050,24
OTUKE,2023,950,1180,2130,24
OTUKE,2024,990,1230,2220,24
OTUKE,2025,1030,1280,2310,24
OYAM,2015,2680,3120,5800,24
OYAM,2016,2760,3220,5980,24
OYAM,2017,2840,3310,6150,24
OYAM,2018,2930,3400,6330,24
OYAM,2019,3020,3500,6520,24
OYAM,2020,3100,3600,6700,24
OYAM,2021,3190,3700,6890,24
OYAM,2022,3280,3790,7070,24
OYAM,2023,3370,3890,7260,24
OYAM,2024,3460,3990,7450,24
OYAM,2025,3540,4090,7630,24
PADER,2015,1010,1370,2380,24
PADER,2016,1040,1410,2450,24
PADER,2017,1090,1440,2530,24
PADER,2018,1130,1450,2580,24
PADER,2019,1180,1470,2650,24
PADER,2020,1220,1480,2700,24
PADER,2021,1260,1510,2770,24
PADER,2022,1310,1540,2850,24
PADER,2023,1370,1580,2950,24
PADER,2024,1410,1630,3040,24
PADER,2025,1460,1670,3130,24
PAKWACH,2015,1110,1180,2290,24
PAKWACH,2016,1160,1220,2380,24
PAKWACH,2017,1210,1260,2470,24
PAKWACH,2018,1260,1310,2570,24
PAKWACH,2019,1310,1360,2670,24
PAKWACH,2020,1360,1400,2760,24
PAKWACH,2021,1420,1450,2870,24
PAKWACH,2022,1470,1500,2970,24
PAKWACH,2023,1530,1550,3080,24
PAKWACH,2024,1590,1600,3190,24
PAKWACH,2025,1640,1650,3290,24
PALLISA,2015,1620,2070,3690,24
PALLISA,2016,1710,2180,3890,24
PALLISA,2017,1830,2270,4100,24
PALLISA,2018,1970,2360,4330,24
PALLISA,2019,2090,2430,4520,24
PALLISA,2020,2230,2510,4740,24
PALLISA,2021,2380,2600,4980,24
PALLISA,2022,2550,2730,5280,24
PALLISA,2023,2710,2880,5590,24
PALLISA,2024,2890,3030,5920,24
PALLISA,2025,3060,3170,6230,24
RAKAI,2015,1740,2200,3940,24
RAKAI,2016,1810,2270,4080,24
RAKAI,2017,1900,2320,4220,24
RAKAI,2018,2000,2360,4360,24
RAKAI,2019,2090,2380,4470,24
RAKAI,2020,2190,2410,4600,24
RAKAI,2021,2290,2450,4740,24
RAKAI,2022,2400,2520,4920,24
RAKAI,2023,2520,2610,5130,24
RAKAI,2024,2630,2690,5320,24
RAKAI,2025,2730,2760,5490,24
RUBANDA,2015,1390,1680,3070,24
RUBANDA,2016,1400,1700,3100,24
RUBANDA,2017,1420,1710,3130,24
RUBANDA,2018,1440,1720,3160,24
RUBANDA,2019,1460,1730,3190,24
RUBANDA,2020,1480,1750,3230,24
RUBANDA,2021,1490,1760,3250,24
RUBANDA,2022,1510,1770,3280,24
RUBANDA,2023,1520,1770,3290,24
RUBANDA,2024,1540,1780,3320,24
RUBANDA,2025,1550,1790,3340,24
RUBIRIZI,2015,830,1060,1890,24
RUBIRIZI,2016,840,1080,1920,24
RUBIRIZI,2017,860,1100,1960,24
RUBIRIZI,2018,880,1120,2000,24
RUBIRIZI,2019,890,1140,2030,24
RUBIRIZI,2020,910,1160,2070,24
RUBIRIZI,2021,930,1180,2110,24
RUBIRIZI,2022,940,1200,2140,24
RUBIRIZI,2023,960,1220,2180,24
RUBIRIZI,2024,980,1230,2210,24
RUBIRIZI,2025,990,1250,2240,24
RUKIGA,2015,690,830,1520,24
RUKIGA,2016,700,840,1540,24
RUKIGA,2017,700,840,1540,24
RUKIGA,2018,710,850,1560,24
RUKIGA,2019,720,850,1570,24
RUKIGA,2020,720,860,1580,24
RUKIGA,2021,730,860,1590,24
RUKIGA,2022,740,870,1610,24
RUKIGA,2023,740,870,1610,24
RUKIGA,2024,740,870,1610,24
RUKIGA,2025,750,870,1620,24
RUKUNGIRI,2015,2060,2420,4480,24
RUKUNGIRI,2016,2080,2450,4530,24
RUKUNGIRI,2017,2110,2470,4580,24
RUKUNGIRI,2018,2130,2490,4620,24
RUKUNGIRI,2019,2160,2510,4670,24
RUKUNGIRI,2020,2180,2540,4720,24
RUKUNGIRI,2021,2200,2550,4750,24
RUKUNGIRI,2022,2220,2570,4790,24
RUKUNGIRI,2023,2240,2590,4830,24
RUKUNGIRI,2024,2260,2600,4860,24
RUKUNGIRI,2025,2270,2620,4890,24
RWAMPARA,2015,970,1080,2050,24
RWAMPARA,2016,990,1100,2090,24
RWAMPARA,2017,1010,1120,2130,24
RWAMPARA,2018,1030,1150,2180,24
RWAMPARA,2019,1050,1170,2220,24
RWAMPARA,2020,1080,1190,2270,24
RWAMPARA,2021,1100,1220,2320,24
RWAMPARA,2022,1120,1240,2360,24
RWAMPARA,2023,1140,1260,2400,24
RWAMPARA,2024,1160,1290,2450,24
RWAMPARA,2025,1180,1310,2490,24
SERERE,2015,1780,2140,3920,24
SERERE,2016,1880,2240,4120,24
SERERE,2017,2000,2320,4320,24
SERERE,2018,2130,2400,4530,24
SERERE,2019,2270,2470,4740,24
SERERE,2020,2420,2540,4960,24
SERERE,2021,2570,2620,5190,24
SERERE,2022,2730,2750,5480,24
SERERE,2023,2890,2880,5770,24
SERERE,2024,3070,3020,6090,24
SERERE,2025,3240,3150,6390,24
SHEEMA,2015,1590,1760,3350,24
SHEEMA,2016,1610,1780,3390,24
SHEEMA,2017,1630,1800,3430,24
SHEEMA,2018,1650,1820,3470,24
SHEEMA,2019,1670,1840,3510,24
SHEEMA,2020,1690,1850,3540,24
SHEEMA,2021,1700,1870,3570,24
SHEEMA,2022,1720,1880,3600,24
SHEEMA,2023,1740,1900,3640,24
SHEEMA,2024,1750,1910,3660,24
SHEEMA,2025,1760,1920,3680,24
SIRONKO,2015,1760,1870,3630,24
SIRONKO,2016,1810,1910,3720,24
SIRONKO,2017,1850,1950,3800,24
SIRONKO,2018,1890,1990,3880,24
SIRONKO,2019,1940,2030,3970,24
SIRONKO,2020,1980,2060,4040,24
SIRONKO,2021,2020,2100,4120,24
SIRONKO,2022,2070,2140,4210,24
SIRONKO,2023,2110,2180,4290,24
SIRONKO,2024,2150,2210,4360,24
SIRONKO,2025,2190,2250,4440,24
SOROTI,2015,2240,2530,4770,24
SOROTI,2016,2350,2650,5000,24
SOROTI,2017,2480,2730,5210,24
SOROTI,2018,2630,2810,5440,24
SOROTI,2019,2800,2870,5670,24
SOROTI,2020,2950,2940,5890,24
SOROTI,2021,3130,3030,6160,24
SOROTI,2022,3310,3160,6470,24
SOROTI,2023,3500,3290,6790,24
SOROTI,2024,3700,3440,7140,24
SOROTI,2025,3880,3580,7460,24
SSEMBABULE,2015,1670,1970,3640,24
SSEMBABULE,2016,1750,2040,3790,24
SSEMBABULE,2017,1840,2090,3930,24
SSEMBABULE,2018,1930,2130,4060,24
SSEMBABULE,2019,2040,2170,4210,24
SSEMBABULE,2020,2140,2200,4340,24
SSEMBABULE,2021,2250,2250,4500,24
SSEMBABULE,2022,2370,2330,4700,24
SSEMBABULE,2023,2480,2410,4890,24
SSEMBABULE,2024,2590,2490,5080,24
SSEMBABULE,2025,2710,2570,5280,24
TORORO,2015,3400,3860,7260,24
TORORO,2016,3500,3950,7450,24
TORORO,2017,3590,4050,7640,24
TORORO,2018,3680,4150,7830,24
TORORO,2019,3780,4250,8030,24
TORORO,2020,3870,4350,8220,24
TORORO,2021,3970,4450,8420,24
TORORO,2022,4060,4550,8610,24
TORORO,2023,4150,4650,8800,24
TORORO,2024,4250,4750,9000,24
TORORO,2025,4340,4840,9180,24
WAKISO,2015,22760,31220,53980,24
WAKISO,2016,24280,33350,57630,24
WAKISO,2017,25910,35640,61550,24
WAKISO,2018,27630,38050,65680,24
WAKISO,2019,29460,40600,70060,24
WAKISO,2020,31380,43300,74680,24
WAKISO,2021,33400,46170,79570,24
WAKISO,2022,35540,49220,84760,24
WAKISO,2023,37800,52390,90190,24
WAKISO,2024,40150,55720,95870,24
WAKISO,2025,42620,59270,101890,24
YUMBE,2015,2680,3590,6270,24
YUMBE,2016,2860,3850,6710,24
YUMBE,2017,3070,4060,7130,24
YUMBE,2018,3300,4270,7570,24
YUMBE,2019,3560,4470,8030,24
YUMBE,2020,3810,4690,8500,24
YUMBE,2021,4090,4940,9030,24
YUMBE,2022,4390,5270,9660,24
YUMBE,2023,4710,5630,10340,24
YUMBE,2024,5050,6020,11070,24
YUMBE,2025,5380,6400,11780,24
ZOMBO,2015,1340,1640,2980,24
ZOMBO,2016,1390,1680,3070,24
ZOMBO,2017,1430,1730,3160,24
ZOMBO,2018,1470,1780,3250,24
ZOMBO,2019,1520,1830,3350,24
ZOMBO,2020,1560,1870,3430,24
ZOMBO,2021,1600,1920,3520,24
ZOMBO,2022,1650,1970,3620,24
ZOMBO,2023,1690,2020,3710,24
ZOMBO,2024,1740,2070,3810,24
ZOMBO,2025,1780,2120,3900,24
ABIM,2015,850,940,1790,25
ABIM,2016,910,1020,1930,25
ABIM,2017,980,1090,2070,25
ABIM,2018,1060,1150,2210,25
ABIM,2019,1160,1210,2370,25
ABIM,2020,1260,1270,2530,25
ABIM,2021,1370,1340,2710,25
ABIM,2022,1480,1410,2890,25
ABIM,2023,1610,1500,3110,25
ABIM,2024,1750,1610,3360,25
ABIM,2025,1890,1720,3610,25
ADJUMANI,2015,1440,1970,3410,25
ADJUMANI,2016,1450,1990,3440,25
ADJUMANI,2017,1460,2010,3470,25
ADJUMANI,2018,1470,2030,3500,25
ADJUMANI,2019,1480,2050,3530,25
ADJUMANI,2020,1490,2070,3560,25
ADJUMANI,2021,1500,2080,3580,25
ADJUMANI,2022,1510,2100,3610,25
ADJUMANI,2023,1510,2110,3620,25
ADJUMANI,2024,1520,2120,3640,25
ADJUMANI,2025,1520,2130,3650,25
AGAGO,2015,1180,1530,2710,25
AGAGO,2016,1210,1560,2770,25
AGAGO,2017,1230,1580,2810,25
AGAGO,2018,1250,1610,2860,25
AGAGO,2019,1270,1640,2910,25
AGAGO,2020,1290,1660,2950,25
AGAGO,2021,1310,1690,3000,25
AGAGO,2022,1330,1710,3040,25
AGAGO,2023,1350,1740,3090,25
AGAGO,2024,1360,1760,3120,25
AGAGO,2025,1380,1790,3170,25
ALEBTONG,2015,1330,1800,3130,25
ALEBTONG,2016,1380,1890,3270,25
ALEBTONG,2017,1440,1960,3400,25
ALEBTONG,2018,1500,2010,3510,25
ALEBTONG,2019,1590,2040,3630,25
ALEBTONG,2020,1670,2070,3740,25
ALEBTONG,2021,1750,2100,3850,25
ALEBTONG,2022,1830,2150,3980,25
ALEBTONG,2023,1930,2220,4150,25
ALEBTONG,2024,2020,2300,4320,25
ALEBTONG,2025,2110,2380,4490,25
AMOLATAR,2015,950,1140,2090,25
AMOLATAR,2016,980,1190,2170,25
AMOLATAR,2017,1020,1220,2240,25
AMOLATAR,2018,1070,1250,2320,25
AMOLATAR,2019,1130,1270,2400,25
AMOLATAR,2020,1180,1290,2470,25
AMOLATAR,2021,1240,1310,2550,25
AMOLATAR,2022,1290,1340,2630,25
AMOLATAR,2023,1350,1380,2730,25
AMOLATAR,2024,1420,1420,2840,25
AMOLATAR,2025,1480,1470,2950,25
AMUDAT,2015,880,1100,1980,25
AMUDAT,2016,930,1170,2100,25
AMUDAT,2017,980,1230,2210,25
AMUDAT,2018,1040,1290,2330,25
AMUDAT,2019,1110,1350,2460,25
AMUDAT,2020,1170,1390,2560,25
AMUDAT,2021,1240,1440,2680,25
AMUDAT,2022,1320,1500,2820,25
AMUDAT,2023,1400,1580,2980,25
AMUDAT,2024,1490,1660,3150,25
AMUDAT,2025,1560,1760,3320,25
AMURIA,2015,940,1320,2260,25
AMURIA,2016,990,1400,2390,25
AMURIA,2017,1040,1470,2510,25
AMURIA,2018,1100,1520,2620,25
AMURIA,2019,1170,1560,2730,25
AMURIA,2020,1240,1590,2830,25
AMURIA,2021,1310,1630,2940,25
AMURIA,2022,1390,1680,3070,25
AMURIA,2023,1470,1740,3210,25
AMURIA,2024,1550,1820,3370,25
AMURIA,2025,1650,1900,3550,25
AMURU,2015,1320,1460,2780,25
AMURU,2016,1370,1530,2900,25
AMURU,2017,1430,1590,3020,25
AMURU,2018,1490,1630,3120,25
AMURU,2019,1560,1660,3220,25
AMURU,2020,1640,1680,3320,25
AMURU,2021,1720,1710,3430,25
AMURU,2022,1800,1740,3540,25
AMURU,2023,1880,1800,3680,25
AMURU,2024,1970,1860,3830,25
AMURU,2025,2060,1930,3990,25
APAC,2015,1370,1480,2850,25
APAC,2016,1420,1530,2950,25
APAC,2017,1470,1580,3050,25
APAC,2018,1520,1630,3150,25
APAC,2019,1580,1690,3270,25
APAC,2020,1630,1750,3380,25
APAC,2021,1690,1800,3490,25
APAC,2022,1750,1860,3610,25
APAC,2023,1800,1920,3720,25
APAC,2024,1860,1980,3840,25
APAC,2025,1920,2040,3960,25
ARUA,2015,4860,6170,11030,25
ARUA,2016,5000,6330,11330,25
ARUA,2017,5140,6510,11650,25
ARUA,2018,5290,6680,11970,25
ARUA,2019,5440,6860,12300,25
ARUA,2020,5580,7030,12610,25
ARUA,2021,5740,7210,12950,25
ARUA,2022,5880,7380,13260,25
ARUA,2023,6030,7560,13590,25
ARUA,2024,6180,7740,13920,25
ARUA,2025,6330,7910,14240,25
BUDAKA,2015,1020,1440,2460,25
BUDAKA,2016,1060,1520,2580,25
BUDAKA,2017,1120,1590,2710,25
BUDAKA,2018,1180,1640,2820,25
BUDAKA,2019,1260,1680,2940,25
BUDAKA,2020,1330,1720,3050,25
BUDAKA,2021,1410,1760,3170,25
BUDAKA,2022,1480,1810,3290,25
BUDAKA,2023,1570,1880,3450,25
BUDAKA,2024,1660,1960,3620,25
BUDAKA,2025,1750,2040,3790,25
BUDUDA,2015,1230,1290,2520,25
BUDUDA,2016,1300,1370,2670,25
BUDUDA,2017,1380,1450,2830,25
BUDUDA,2018,1470,1510,2980,25
BUDUDA,2019,1570,1570,3140,25
BUDUDA,2020,1680,1610,3290,25
BUDUDA,2021,1790,1670,3460,25
BUDUDA,2022,1910,1730,3640,25
BUDUDA,2023,2040,1830,3870,25
BUDUDA,2024,2170,1920,4090,25
BUDUDA,2025,2310,2020,4330,25
BUGIRI,2015,2050,2670,4720,25
BUGIRI,2016,2160,2820,4980,25
BUGIRI,2017,2280,2970,5250,25
BUGIRI,2018,2430,3080,5510,25
BUGIRI,2019,2590,3180,5770,25
BUGIRI,2020,2750,3250,6000,25
BUGIRI,2021,2920,3340,6260,25
BUGIRI,2022,3110,3470,6580,25
BUGIRI,2023,3290,3620,6910,25
BUGIRI,2024,3500,3800,7300,25
BUGIRI,2025,3710,3970,7680,25
BUGWERI,2015,910,1310,2220,25
BUGWERI,2016,950,1380,2330,25
BUGWERI,2017,990,1430,2420,25
BUGWERI,2018,1040,1470,2510,25
BUGWERI,2019,1090,1490,2580,25
BUGWERI,2020,1140,1510,2650,25
BUGWERI,2021,1200,1530,2730,25
BUGWERI,2022,1260,1570,2830,25
BUGWERI,2023,1320,1610,2930,25
BUGWERI,2024,1380,1670,3050,25
BUGWERI,2025,1440,1720,3160,25
BUHWEJU,2015,930,1060,1990,25
BUHWEJU,2016,970,1090,2060,25
BUHWEJU,2017,1000,1130,2130,25
BUHWEJU,2018,1030,1160,2190,25
BUHWEJU,2019,1060,1200,2260,25
BUHWEJU,2020,1100,1230,2330,25
BUHWEJU,2021,1130,1270,2400,25
BUHWEJU,2022,1160,1300,2460,25
BUHWEJU,2023,1200,1340,2540,25
BUHWEJU,2024,1230,1370,2600,25
BUHWEJU,2025,1260,1410,2670,25
BUIKWE,2015,3350,3970,7320,25
BUIKWE,2016,3440,4140,7580,25
BUIKWE,2017,3560,4260,7820,25
BUIKWE,2018,3700,4350,8050,25
BUIKWE,2019,3870,4400,8270,25
BUIKWE,2020,4030,4430,8460,25
BUIKWE,2021,4210,4480,8690,25
BUIKWE,2022,4370,4550,8920,25
BUIKWE,2023,4550,4660,9210,25
BUIKWE,2024,4740,4800,9540,25
BUIKWE,2025,4910,4940,9850,25
BUKEDEA,2015,1100,1400,2500,25
BUKEDEA,2016,1170,1480,2650,25
BUKEDEA,2017,1230,1570,2800,25
BUKEDEA,2018,1320,1630,2950,25
BUKEDEA,2019,1410,1680,3090,25
BUKEDEA,2020,1500,1730,3230,25
BUKEDEA,2021,1600,1780,3380,25
BUKEDEA,2022,1700,1840,3540,25
BUKEDEA,2023,1820,1930,3750,25
BUKEDEA,2024,1930,2030,3960,25
BUKEDEA,2025,2050,2140,4190,25
BUKOMANSIMBI,2015,890,1010,1900,25
BUKOMANSIMBI,2016,910,1030,1940,25
BUKOMANSIMBI,2017,930,1050,1980,25
BUKOMANSIMBI,2018,950,1050,2000,25
BUKOMANSIMBI,2019,980,1040,2020,25
BUKOMANSIMBI,2020,1020,1040,2060,25
BUKOMANSIMBI,2021,1040,1030,2070,25
BUKOMANSIMBI,2022,1070,1030,2100,25
BUKOMANSIMBI,2023,1110,1040,2150,25
BUKOMANSIMBI,2024,1130,1050,2180,25
BUKOMANSIMBI,2025,1160,1070,2230,25
BUKWO,2015,550,580,1130,25
BUKWO,2016,580,610,1190,25
BUKWO,2017,620,640,1260,25
BUKWO,2018,650,670,1320,25
BUKWO,2019,680,700,1380,25
BUKWO,2020,720,730,1450,25
BUKWO,2021,750,770,1520,25
BUKWO,2022,790,800,1590,25
BUKWO,2023,830,840,1670,25
BUKWO,2024,870,870,1740,25
BUKWO,2025,910,910,1820,25
BULAMBULI,2015,870,1210,2080,25
BULAMBULI,2016,930,1290,2220,25
BULAMBULI,2017,990,1370,2360,25
BULAMBULI,2018,1060,1440,2500,25
BULAMBULI,2019,1140,1500,2640,25
BULAMBULI,2020,1220,1550,2770,25
BULAMBULI,2021,1300,1610,2910,25
BULAMBULI,2022,1400,1680,3080,25
BULAMBULI,2023,1500,1770,3270,25
BULAMBULI,2024,1600,1870,3470,25
BULAMBULI,2025,1720,1980,3700,25
BULIISA,2015,1440,1080,2520,25
BULIISA,2016,1520,1130,2650,25
BULIISA,2017,1610,1180,2790,25
BULIISA,2018,1690,1230,2920,25
BULIISA,2019,1780,1290,3070,25
BULIISA,2020,1870,1340,3210,25
BULIISA,2021,1970,1400,3370,25
BULIISA,2022,2070,1460,3530,25
BULIISA,2023,2180,1520,3700,25
BULIISA,2024,2290,1580,3870,25
BULIISA,2025,2400,1640,4040,25
BUNDIBUGYO,2015,1770,2290,4060,25
BUNDIBUGYO,2016,1840,2400,4240,25
BUNDIBUGYO,2017,1920,2500,4420,25
BUNDIBUGYO,2018,2020,2560,4580,25
BUNDIBUGYO,2019,2130,2610,4740,25
BUNDIBUGYO,2020,2240,2640,4880,25
BUNDIBUGYO,2021,2350,2690,5040,25
BUNDIBUGYO,2022,2480,2760,5240,25
BUNDIBUGYO,2023,2600,2840,5440,25
BUNDIBUGYO,2024,2730,2950,5680,25
BUNDIBUGYO,2025,2860,3050,5910,25
BUNYANGABU,2015,1250,1410,2660,25
BUNYANGABU,2016,1280,1470,2750,25
BUNYANGABU,2017,1340,1520,2860,25
BUNYANGABU,2018,1400,1550,2950,25
BUNYANGABU,2019,1470,1570,3040,25
BUNYANGABU,2020,1540,1590,3130,25
BUNYANGABU,2021,1610,1610,3220,25
BUNYANGABU,2022,1690,1640,3330,25
BUNYANGABU,2023,1760,1680,3440,25
BUNYANGABU,2024,1850,1730,3580,25
BUNYANGABU,2025,1920,1790,3710,25
BUSHENYI,2015,1790,2170,3960,25
BUSHENYI,2016,1810,2190,4000,25
BUSHENYI,2017,1840,2210,4050,25
BUSHENYI,2018,1860,2230,4090,25
BUSHENYI,2019,1880,2250,4130,25
BUSHENYI,2020,1900,2260,4160,25
BUSHENYI,2021,1920,2280,4200,25
BUSHENYI,2022,1940,2290,4230,25
BUSHENYI,2023,1950,2300,4250,25
BUSHENYI,2024,1970,2320,4290,25
BUSHENYI,2025,1980,2330,4310,25
BUSIA,2015,1840,2590,4430,25
BUSIA,2016,1920,2710,4630,25
BUSIA,2017,2000,2820,4820,25
BUSIA,2018,2110,2900,5010,25
BUSIA,2019,2230,2960,5190,25
BUSIA,2020,2340,3010,5350,25
BUSIA,2021,2470,3060,5530,25
BUSIA,2022,2600,3130,5730,25
BUSIA,2023,2740,3240,5980,25
BUSIA,2024,2880,3360,6240,25
BUSIA,2025,3030,3490,6520,25
BUTALEJA,2015,1230,1630,2860,25
BUTALEJA,2016,1280,1720,3000,25
BUTALEJA,2017,1350,1800,3150,25
BUTALEJA,2018,1430,1870,3300,25
BUTALEJA,2019,1520,1910,3430,25
BUTALEJA,2020,1610,1960,3570,25
BUTALEJA,2021,1710,2000,3710,25
BUTALEJA,2022,1810,2070,3880,25
BUTALEJA,2023,1920,2150,4070,25
BUTALEJA,2024,2030,2250,4280,25
BUTALEJA,2025,2130,2350,4480,25
BUTAMBALA,2015,750,790,1540,25
BUTAMBALA,2016,770,820,1590,25
BUTAMBALA,2017,790,840,1630,25
BUTAMBALA,2018,810,850,1660,25
BUTAMBALA,2019,840,840,1680,25
BUTAMBALA,2020,870,840,1710,25
BUTAMBALA,2021,900,840,1740,25
BUTAMBALA,2022,930,840,1770,25
BUTAMBALA,2023,960,860,1820,25
BUTAMBALA,2024,1000,870,1870,25
BUTAMBALA,2025,1030,890,1920,25
BUTEBO,2015,550,730,1280,25
BUTEBO,2016,560,760,1320,25
BUTEBO,2017,580,770,1350,25
BUTEBO,2018,600,780,1380,25
BUTEBO,2019,630,790,1420,25
BUTEBO,2020,650,790,1440,25
BUTEBO,2021,680,790,1470,25
BUTEBO,2022,690,800,1490,25
BUTEBO,2023,720,820,1540,25
BUTEBO,2024,750,840,1590,25
BUTEBO,2025,780,850,1630,25
BUVUMA,2015,1010,930,1940,25
BUVUMA,2016,1080,1000,2080,25
BUVUMA,2017,1140,1070,2210,25
BUVUMA,2018,1210,1140,2350,25
BUVUMA,2019,1290,1210,2500,25
BUVUMA,2020,1370,1290,2660,25
BUVUMA,2021,1450,1380,2830,25
BUVUMA,2022,1530,1470,3000,25
BUVUMA,2023,1620,1560,3180,25
BUVUMA,2024,1710,1660,3370,25
BUVUMA,2025,1810,1760,3570,25
BUYENDE,2015,1890,2510,4400,25
BUYENDE,2016,1990,2670,4660,25
BUYENDE,2017,2110,2820,4930,25
BUYENDE,2018,2250,2940,5190,25
BUYENDE,2019,2400,3030,5430,25
BUYENDE,2020,2570,3130,5700,25
BUYENDE,2021,2740,3240,5980,25
BUYENDE,2022,2920,3360,6280,25
BUYENDE,2023,3110,3520,6630,25
BUYENDE,2024,3320,3710,7030,25
BUYENDE,2025,3540,3900,7440,25
DOKOLO,2015,1210,1420,2630,25
DOKOLO,2016,1250,1460,2710,25
DOKOLO,2017,1290,1500,2790,25
DOKOLO,2018,1330,1540,2870,25
DOKOLO,2019,1370,1580,2950,25
DOKOLO,2020,1400,1620,3020,25
DOKOLO,2021,1450,1670,3120,25
DOKOLO,2022,1480,1710,3190,25
DOKOLO,2023,1520,1750,3270,25
DOKOLO,2024,1560,1790,3350,25
DOKOLO,2025,1600,1830,3430,25
GOMBA,2015,1100,1140,2240,25
GOMBA,2016,1130,1170,2300,25
GOMBA,2017,1170,1190,2360,25
GOMBA,2018,1220,1210,2430,25
GOMBA,2019,1270,1210,2480,25
GOMBA,2020,1320,1210,2530,25
GOMBA,2021,1370,1220,2590,25
GOMBA,2022,1420,1230,2650,25
GOMBA,2023,1470,1250,2720,25
GOMBA,2024,1530,1280,2810,25
GOMBA,2025,1590,1300,2890,25
GULU,2015,2680,2870,5550,25
GULU,2016,2760,2960,5720,25
GULU,2017,2850,3040,5890,25
GULU,2018,2930,3130,6060,25
GULU,2019,3020,3220,6240,25
GULU,2020,3110,3310,6420,25
GULU,2021,3190,3400,6590,25
GULU,2022,3280,3490,6770,25
GULU,2023,3360,3580,6940,25
GULU,2024,3450,3670,7120,25
GULU,2025,3540,3760,7300,25
HOIMA,2015,2680,2990,5670,25
HOIMA,2016,2780,3100,5880,25
HOIMA,2017,2890,3210,6100,25
HOIMA,2018,3000,3310,6310,25
HOIMA,2019,3100,3430,6530,25
HOIMA,2020,3220,3540,6760,25
HOIMA,2021,3330,3660,6990,25
HOIMA,2022,3450,3770,7220,25
HOIMA,2023,3560,3890,7450,25
HOIMA,2024,3680,4010,7690,25
HOIMA,2025,3800,4130,7930,25
IBANDA,2015,1870,2070,3940,25
IBANDA,2016,1910,2100,4010,25
IBANDA,2017,1950,2140,4090,25
IBANDA,2018,1980,2180,4160,25
IBANDA,2019,2020,2220,4240,25
IBANDA,2020,2060,2250,4310,25
IBANDA,2021,2100,2290,4390,25
IBANDA,2022,2130,2320,4450,25
IBANDA,2023,2170,2360,4530,25
IBANDA,2024,2200,2390,4590,25
IBANDA,2025,2230,2420,4650,25
IGANGA,2015,2270,2960,5230,25
IGANGA,2016,2370,3110,5480,25
IGANGA,2017,2470,3230,5700,25
IGANGA,2018,2600,3320,5920,25
IGANGA,2019,2760,3390,6150,25
IGANGA,2020,2900,3440,6340,25
IGANGA,2021,3050,3500,6550,25
IGANGA,2022,3220,3590,6810,25
IGANGA,2023,3380,3710,7090,25
IGANGA,2024,3560,3860,7420,25
IGANGA,2025,3730,4000,7730,25
ISINGIRO,2015,3270,3890,7160,25
ISINGIRO,2016,3390,4030,7420,25
ISINGIRO,2017,3520,4180,7700,25
ISINGIRO,2018,3650,4320,7970,25
ISINGIRO,2019,3780,4470,8250,25
ISINGIRO,2020,3920,4620,8540,25
ISINGIRO,2021,4060,4770,8830,25
ISINGIRO,2022,4200,4930,9130,25
ISINGIRO,2023,4340,5080,9420,25
ISINGIRO,2024,4480,5240,9720,25
ISINGIRO,2025,4620,5400,10020,25
JINJA,2015,4470,4580,9050,25
JINJA,2016,4540,4650,9190,25
JINJA,2017,4620,4720,9340,25
JINJA,2018,4690,4790,9480,25
JINJA,2019,4770,4860,9630,25
JINJA,2020,4840,4930,9770,25
JINJA,2021,4910,5000,9910,25
JINJA,2022,4980,5060,10040,25
JINJA,2023,5050,5120,10170,25
JINJA,2024,5110,5180,10290,25
JINJA,2025,5170,5230,10400,25
KAABONG,2015,780,1390,2170,25
KAABONG,2016,800,1420,2220,25
KAABONG,2017,820,1460,2280,25
KAABONG,2018,840,1490,2330,25
KAABONG,2019,860,1520,2380,25
KAABONG,2020,880,1560,2440,25
KAABONG,2021,910,1600,2510,25
KAABONG,2022,930,1630,2560,25
KAABONG,2023,950,1660,2610,25
KAABONG,2024,970,1700,2670,25
KAABONG,2025,990,1730,2720,25
KABALE,2015,1970,2180,4150,25
KABALE,2016,2010,2210,4220,25
KABALE,2017,2040,2240,4280,25
KABALE,2018,2070,2260,4330,25
KABALE,2019,2100,2290,4390,25
KABALE,2020,2130,2310,4440,25
KABALE,2021,2160,2330,4490,25
KABALE,2022,2180,2360,4540,25
KABALE,2023,2210,2380,4590,25
KABALE,2024,2230,2400,4630,25
KABALE,2025,2260,2410,4670,25
KABAROLE,2015,2770,2850,5620,25
KABAROLE,2016,2830,2920,5750,25
KABAROLE,2017,2890,2980,5870,25
KABAROLE,2018,2960,3040,6000,25
KABAROLE,2019,3020,3110,6130,25
KABAROLE,2020,3080,3170,6250,25
KABAROLE,2021,3140,3230,6370,25
KABAROLE,2022,3200,3290,6490,25
KABAROLE,2023,3260,3350,6610,25
KABAROLE,2024,3320,3410,6730,25
KABAROLE,2025,3370,3470,6840,25
KABERAMAIDO,2015,630,750,1380,25
KABERAMAIDO,2016,660,800,1460,25
KABERAMAIDO,2017,700,840,1540,25
KABERAMAIDO,2018,740,880,1620,25
KABERAMAIDO,2019,800,900,1700,25
KABERAMAIDO,2020,850,920,1770,25
KABERAMAIDO,2021,900,950,1850,25
KABERAMAIDO,2022,960,980,1940,25
KABERAMAIDO,2023,1020,1030,2050,25
KABERAMAIDO,2024,1090,1080,2170,25
KABERAMAIDO,2025,1160,1130,2290,25
KAGADI,2015,2580,2840,5420,25
KAGADI,2016,2680,2950,5630,25
KAGADI,2017,2780,3050,5830,25
KAGADI,2018,2880,3160,6040,25
KAGADI,2019,2990,3260,6250,25
KAGADI,2020,3090,3380,6470,25
KAGADI,2021,3200,3490,6690,25
KAGADI,2022,3310,3600,6910,25
KAGADI,2023,3420,3720,7140,25
KAGADI,2024,3530,3830,7360,25
KAGADI,2025,3640,3950,7590,25
KAKUMIRO,2015,2490,2740,5230,25
KAKUMIRO,2016,2710,2970,5680,25
KAKUMIRO,2017,2950,3220,6170,25
KAKUMIRO,2018,3210,3490,6700,25
KAKUMIRO,2019,3490,3780,7270,25
KAKUMIRO,2020,3790,4090,7880,25
KAKUMIRO,2021,4120,4430,8550,25
KAKUMIRO,2022,4470,4790,9260,25
KAKUMIRO,2023,4850,5170,10020,25
KAKUMIRO,2024,5250,5580,10830,25
KAKUMIRO,2025,5690,6030,11720,25
KALAKI,2015,580,710,1290,25
KALAKI,2016,610,740,1350,25
KALAKI,2017,630,770,1400,25
KALAKI,2018,660,800,1460,25
KALAKI,2019,690,830,1520,25
KALAKI,2020,720,860,1580,25
KALAKI,2021,750,890,1640,25
KALAKI,2022,770,930,1700,25
KALAKI,2023,810,960,1770,25
KALAKI,2024,840,990,1830,25
KALAKI,2025,870,1030,1900,25
KALANGALA,2015,810,690,1500,25
KALANGALA,2016,840,720,1560,25
KALANGALA,2017,870,750,1620,25
KALANGALA,2018,900,780,1680,25
KALANGALA,2019,930,810,1740,25
KALANGALA,2020,960,850,1810,25
KALANGALA,2021,990,880,1870,25
KALANGALA,2022,1030,910,1940,25
KALANGALA,2023,1060,950,2010,25
KALANGALA,2024,1090,980,2070,25
KALANGALA,2025,1120,1020,2140,25
KALIRO,2015,1370,1790,3160,25
KALIRO,2016,1430,1890,3320,25
KALIRO,2017,1490,1980,3470,25
KALIRO,2018,1580,2040,3620,25
KALIRO,2019,1680,2090,3770,25
KALIRO,2020,1770,2140,3910,25
KALIRO,2021,1880,2190,4070,25
KALIRO,2022,1980,2260,4240,25
KALIRO,2023,2090,2350,4440,25
KALIRO,2024,2210,2450,4660,25
KALIRO,2025,2330,2560,4890,25
KALUNGU,2015,1130,1340,2470,25
KALUNGU,2016,1150,1380,2530,25
KALUNGU,2017,1180,1420,2600,25
KALUNGU,2018,1220,1430,2650,25
KALUNGU,2019,1270,1430,2700,25
KALUNGU,2020,1310,1420,2730,25
KALUNGU,2021,1350,1420,2770,25
KALUNGU,2022,1390,1430,2820,25
KALUNGU,2023,1430,1450,2880,25
KALUNGU,2024,1470,1480,2950,25
KALUNGU,2025,1520,1510,3030,25
KAMPALA,2015,22070,26170,48240,25
KAMPALA,2016,22510,26690,49200,25
KAMPALA,2017,22960,27200,50160,25
KAMPALA,2018,23400,27720,51120,25
KAMPALA,2019,23840,28230,52070,25
KAMPALA,2020,24270,28740,53010,25
KAMPALA,2021,24700,29240,53940,25
KAMPALA,2022,25120,29730,54850,25
KAMPALA,2023,25520,30210,55730,25
KAMPALA,2024,25910,30670,56580,25
KAMPALA,2025,26280,31120,57400,25
KAMULI,2015,2820,3540,6360,25
KAMULI,2016,2920,3700,6620,25
KAMULI,2017,3040,3820,6860,25
KAMULI,2018,3180,3900,7080,25
KAMULI,2019,3350,3960,7310,25
KAMULI,2020,3510,4000,7510,25
KAMULI,2021,3670,4050,7720,25
KAMULI,2022,3840,4120,7960,25
KAMULI,2023,4020,4240,8260,25
KAMULI,2024,4210,4370,8580,25
KAMULI,2025,4390,4510,8900,25
KAMWENGE,2015,2130,2400,4530,25
KAMWENGE,2016,2220,2490,4710,25
KAMWENGE,2017,2300,2570,4870,25
KAMWENGE,2018,2400,2660,5060,25
KAMWENGE,2019,2490,2760,5250,25
KAMWENGE,2020,2590,2850,5440,25
KAMWENGE,2021,2690,2940,5630,25
KAMWENGE,2022,2790,3040,5830,25
KAMWENGE,2023,2890,3140,6030,25
KAMWENGE,2024,3000,3240,6240,25
KAMWENGE,2025,3110,3340,6450,25
KANUNGU,2015,1770,2150,3920,25
KANUNGU,2016,1800,2190,3990,25
KANUNGU,2017,1840,2220,4060,25
KANUNGU,2018,1870,2260,4130,25
KANUNGU,2019,1900,2290,4190,25
KANUNGU,2020,1930,2330,4260,25
KANUNGU,2021,1960,2360,4320,25
KANUNGU,2022,1990,2390,4380,25
KANUNGU,2023,2020,2420,4440,25
KANUNGU,2024,2050,2450,4500,25
KANUNGU,2025,2080,2480,4560,25
KAPCHORWA,2015,610,730,1340,25
KAPCHORWA,2016,630,750,1380,25
KAPCHORWA,2017,650,770,1420,25
KAPCHORWA,2018,660,790,1450,25
KAPCHORWA,2019,680,810,1490,25
KAPCHORWA,2020,700,830,1530,25
KAPCHORWA,2021,720,850,1570,25
KAPCHORWA,2022,740,880,1620,25
KAPCHORWA,2023,760,900,1660,25
KAPCHORWA,2024,780,920,1700,25
KAPCHORWA,2025,800,940,1740,25
KAPELEBYONG,2015,480,600,1080,25
KAPELEBYONG,2016,500,640,1140,25
KAPELEBYONG,2017,510,660,1170,25
KAPELEBYONG,2018,540,680,1220,25
KAPELEBYONG,2019,580,690,1270,25
KAPELEBYONG,2020,610,700,1310,25
KAPELEBYONG,2021,640,710,1350,25
KAPELEBYONG,2022,670,730,1400,25
KAPELEBYONG,2023,710,760,1470,25
KAPELEBYONG,2024,750,780,1530,25
KAPELEBYONG,2025,790,810,1600,25
KASESE,2015,5150,6630,11780,25
KASESE,2016,5320,6920,12240,25
KASESE,2017,5530,7150,12680,25
KASESE,2018,5790,7300,13090,25
KASESE,2019,6070,7390,13460,25
KASESE,2020,6360,7460,13820,25
KASESE,2021,6640,7550,14190,25
KASESE,2022,6940,7680,14620,25
KASESE,2023,7260,7890,15150,25
KASESE,2024,7590,8140,15730,25
KASESE,2025,7910,8400,16310,25
KASSANDA,2015,2370,2160,4530,25
KASSANDA,2016,2440,2210,4650,25
KASSANDA,2017,2510,2260,4770,25
KASSANDA,2018,2580,2300,4880,25
KASSANDA,2019,2650,2350,5000,25
KASSANDA,2020,2730,2400,5130,25
KASSANDA,2021,2800,2450,5250,25
KASSANDA,2022,2870,2490,5360,25
KASSANDA,2023,2940,2540,5480,25
KASSANDA,2024,3010,2580,5590,25
KASSANDA,2025,3080,2620,5700,25
KATAKWI,2015,1060,1250,2310,25
KATAKWI,2016,1100,1300,2400,25
KATAKWI,2017,1150,1350,2500,25
KATAKWI,2018,1210,1380,2590,25
KATAKWI,2019,1270,1410,2680,25
KATAKWI,2020,1340,1420,2760,25
KATAKWI,2021,1400,1440,2840,25
KATAKWI,2022,1470,1480,2950,25
KATAKWI,2023,1550,1520,3070,25
KATAKWI,2024,1620,1570,3190,25
KATAKWI,2025,1700,1630,3330,25
KAYUNGA,2015,2170,2640,4810,25
KAYUNGA,2016,2230,2730,4960,25
KAYUNGA,2017,2300,2810,5110,25
KAYUNGA,2018,2400,2850,5250,25
KAYUNGA,2019,2500,2870,5370,25
KAYUNGA,2020,2600,2890,5490,25
KAYUNGA,2021,2710,2910,5620,25
KAYUNGA,2022,2830,2940,5770,25
KAYUNGA,2023,2940,3010,5950,25
KAYUNGA,2024,3050,3080,6130,25
KAYUNGA,2025,3160,3160,6320,25
KAZO,2015,1350,1420,2770,25
KAZO,2016,1400,1470,2870,25
KAZO,2017,1450,1520,2970,25
KAZO,2018,1510,1580,3090,25
KAZO,2019,1560,1630,3190,25
KAZO,2020,1620,1690,3310,25
KAZO,2021,1680,1740,3420,25
KAZO,2022,1740,1800,3540,25
KAZO,2023,1790,1860,3650,25
KAZO,2024,1860,1920,3780,25
KAZO,2025,1920,1980,3900,25
KIBAALE,2015,1130,1200,2330,25
KIBAALE,2016,1210,1270,2480,25
KIBAALE,2017,1280,1340,2620,25
KIBAALE,2018,1370,1420,2790,25
KIBAALE,2019,1450,1500,2950,25
KIBAALE,2020,1540,1580,3120,25
KIBAALE,2021,1630,1670,3300,25
KIBAALE,2022,1730,1760,3490,25
KIBAALE,2023,1840,1860,3700,25
KIBAALE,2024,1950,1960,3910,25
KIBAALE,2025,2060,2060,4120,25
KIBOGA,2015,1240,1160,2400,25
KIBOGA,2016,1280,1200,2480,25
KIBOGA,2017,1340,1240,2580,25
KIBOGA,2018,1410,1270,2680,25
KIBOGA,2019,1470,1290,2760,25
KIBOGA,2020,1550,1310,2860,25
KIBOGA,2021,1620,1330,2950,25
KIBOGA,2022,1700,1350,3050,25
KIBOGA,2023,1770,1390,3160,25
KIBOGA,2024,1860,1440,3300,25
KIBOGA,2025,1950,1490,3440,25
KIBUKU,2015,1020,1380,2400,25
KIBUKU,2016,1060,1460,2520,25
KIBUKU,2017,1130,1530,2660,25
KIBUKU,2018,1190,1590,2780,25
KIBUKU,2019,1270,1630,2900,25
KIBUKU,2020,1340,1670,3010,25
KIBUKU,2021,1420,1720,3140,25
KIBUKU,2022,1500,1770,3270,25
KIBUKU,2023,1600,1850,3450,25
KIBUKU,2024,1690,1930,3620,25
KIBUKU,2025,1790,2020,3810,25
KIKUUBE,2015,2270,2390,4660,25
KIKUUBE,2016,2390,2510,4900,25
KIKUUBE,2017,2520,2640,5160,25
KIKUUBE,2018,2650,2770,5420,25
KIKUUBE,2019,2790,2910,5700,25
KIKUUBE,2020,2930,3060,5990,25
KIKUUBE,2021,3080,3210,6290,25
KIKUUBE,2022,3240,3360,6600,25
KIKUUBE,2023,3400,3520,6920,25
KIKUUBE,2024,3570,3690,7260,25
KIKUUBE,2025,3740,3860,7600,25
KIRUHURA,2015,1490,1380,2870,25
KIRUHURA,2016,1550,1430,2980,25
KIRUHURA,2017,1600,1480,3080,25
KIRUHURA,2018,1670,1530,3200,25
KIRUHURA,2019,1720,1580,3300,25
KIRUHURA,2020,1790,1640,3430,25
KIRUHURA,2021,1850,1690,3540,25
KIRUHURA,2022,1920,1750,3670,25
KIRUHURA,2023,1990,1800,3790,25
KIRUHURA,2024,2050,1860,3910,25
KIRUHURA,2025,2110,1910,4020,25
KIRYANDONGO,2015,1940,2230,4170,25
KIRYANDONGO,2016,2010,2340,4350,25
KIRYANDONGO,2017,2110,2430,4540,25
KIRYANDONGO,2018,2220,2500,4720,25
KIRYANDONGO,2019,2330,2540,4870,25
KIRYANDONGO,2020,2460,2570,5030,25
KIRYANDONGO,2021,2580,2620,5200,25
KIRYANDONGO,2022,2720,2680,5400,25
KIRYANDONGO,2023,2860,2770,5630,25
KIRYANDONGO,2024,3000,2870,5870,25
KIRYANDONGO,2025,3150,2970,6120,25
KISORO,2015,1540,2940,4480,25
KISORO,2016,1590,3060,4650,25
KISORO,2017,1640,3150,4790,25
KISORO,2018,1710,3210,4920,25
KISORO,2019,1780,3250,5030,25
KISORO,2020,1870,3270,5140,25
KISORO,2021,1940,3300,5240,25
KISORO,2022,2010,3350,5360,25
KISORO,2023,2090,3440,5530,25
KISORO,2024,2180,3530,5710,25
KISORO,2025,2260,3630,5890,25
KITAGWENDA,2015,960,1190,2150,25
KITAGWENDA,2016,1000,1230,2230,25
KITAGWENDA,2017,1040,1280,2320,25
KITAGWENDA,2018,1080,1320,2400,25
KITAGWENDA,2019,1130,1370,2500,25
KITAGWENDA,2020,1170,1420,2590,25
KITAGWENDA,2021,1210,1460,2670,25
KITAGWENDA,2022,1260,1510,2770,25
KITAGWENDA,2023,1310,1560,2870,25
KITAGWENDA,2024,1350,1610,2960,25
KITAGWENDA,2025,1400,1660,3060,25
KITGUM,2015,1250,1660,2910,25
KITGUM,2016,1270,1710,2980,25
KITGUM,2017,1320,1760,3080,25
KITGUM,2018,1370,1790,3160,25
KITGUM,2019,1420,1800,3220,25
KITGUM,2020,1470,1810,3280,25
KITGUM,2021,1540,1820,3360,25
KITGUM,2022,1590,1830,3420,25
KITGUM,2023,1650,1880,3530,25
KITGUM,2024,1710,1920,3630,25
KITGUM,2025,1760,1970,3730,25
KOBOKO,2015,1610,2150,3760,25
KOBOKO,2016,1690,2280,3970,25
KOBOKO,2017,1790,2390,4180,25
KOBOKO,2018,1890,2480,4370,25
KOBOKO,2019,2020,2550,4570,25
KOBOKO,2020,2150,2620,4770,25
KOBOKO,2021,2280,2690,4970,25
KOBOKO,2022,2410,2790,5200,25
KOBOKO,2023,2560,2900,5460,25
KOBOKO,2024,2710,3040,5750,25
KOBOKO,2025,2870,3180,6050,25
KOLE,2015,1640,1830,3470,25
KOLE,2016,1700,1890,3590,25
KOLE,2017,1750,1940,3690,25
KOLE,2018,1810,1990,3800,25
KOLE,2019,1870,2050,3920,25
KOLE,2020,1930,2110,4040,25
KOLE,2021,1990,2160,4150,25
KOLE,2022,2040,2220,4260,25
KOLE,2023,2100,2280,4380,25
KOLE,2024,2160,2330,4490,25
KOLE,2025,2220,2390,4610,25
KOTIDO,2015,1440,1930,3370,25
KOTIDO,2016,1480,2020,3500,25
KOTIDO,2017,1540,2080,3620,25
KOTIDO,2018,1600,2120,3720,25
KOTIDO,2019,1680,2150,3830,25
KOTIDO,2020,1760,2170,3930,25
KOTIDO,2021,1840,2190,4030,25
KOTIDO,2022,1930,2230,4160,25
KOTIDO,2023,2020,2300,4320,25
KOTIDO,2024,2110,2370,4480,25
KOTIDO,2025,2200,2440,4640,25
KUMI,2015,1350,1690,3040,25
KUMI,2016,1400,1780,3180,25
KUMI,2017,1470,1850,3320,25
KUMI,2018,1540,1900,3440,25
KUMI,2019,1630,1930,3560,25
KUMI,2020,1720,1970,3690,25
KUMI,2021,1810,2000,3810,25
KUMI,2022,1920,2050,3970,25
KUMI,2023,2020,2130,4150,25
KUMI,2024,2120,2210,4330,25
KUMI,2025,2230,2290,4520,25
KWANIA,2015,1260,1360,2620,25
KWANIA,2016,1300,1400,2700,25
KWANIA,2017,1340,1440,2780,25
KWANIA,2018,1380,1480,2860,25
KWANIA,2019,1420,1520,2940,25
KWANIA,2020,1460,1560,3020,25
KWANIA,2021,1500,1600,3100,25
KWANIA,2022,1550,1650,3200,25
KWANIA,2023,1590,1690,3280,25
KWANIA,2024,1630,1730,3360,25
KWANIA,2025,1670,1770,3440,25
KWEEN,2015,580,610,1190,25
KWEEN,2016,590,630,1220,25
KWEEN,2017,610,640,1250,25
KWEEN,2018,630,660,1290,25
KWEEN,2019,650,670,1320,25
KWEEN,2020,670,690,1360,25
KWEEN,2021,690,700,1390,25
KWEEN,2022,710,720,1430,25
KWEEN,2023,730,730,1460,25
KWEEN,2024,750,750,1500,25
KWEEN,2025,760,760,1520,25
KYANKWANZI,2015,2030,1820,3850,25
KYANKWANZI,2016,2130,1900,4030,25
KYANKWANZI,2017,2240,1990,4230,25
KYANKWANZI,2018,2350,2080,4430,25
KYANKWANZI,2019,2470,2180,4650,25
KYANKWANZI,2020,2590,2280,4870,25
KYANKWANZI,2021,2720,2380,5100,25
KYANKWANZI,2022,2850,2480,5330,25
KYANKWANZI,2023,2990,2590,5580,25
KYANKWANZI,2024,3130,2700,5830,25
KYANKWANZI,2025,3270,2810,6080,25
KYEGEGWA,2015,2200,2440,4640,25
KYEGEGWA,2016,2380,2640,5020,25
KYEGEGWA,2017,2570,2840,5410,25
KYEGEGWA,2018,2790,3070,5860,25
KYEGEGWA,2019,3010,3310,6320,25
KYEGEGWA,2020,3250,3560,6810,25
KYEGEGWA,2021,3510,3840,7350,25
KYEGEGWA,2022,3790,4130,7920,25
KYEGEGWA,2023,4090,4440,8530,25
KYEGEGWA,2024,4400,4770,9170,25
KYEGEGWA,2025,4740,5130,9870,25
KYENJOJO,2015,3350,3310,6660,25
KYENJOJO,2016,3490,3440,6930,25
KYENJOJO,2017,3630,3560,7190,25
KYENJOJO,2018,3780,3690,7470,25
KYENJOJO,2019,3930,3830,7760,25
KYENJOJO,2020,4080,3960,8040,25
KYENJOJO,2021,4240,4100,8340,25
KYENJOJO,2022,4400,4240,8640,25
KYENJOJO,2023,4560,4380,8940,25
KYENJOJO,2024,4730,4530,9260,25
KYENJOJO,2025,4900,4670,9570,25
KYOTERA,2015,1480,1850,3330,25
KYOTERA,2016,1510,1910,3420,25
KYOTERA,2017,1560,1960,3520,25
KYOTERA,2018,1620,1980,3600,25
KYOTERA,2019,1690,1990,3680,25
KYOTERA,2020,1750,1990,3740,25
KYOTERA,2021,1820,2000,3820,25
KYOTERA,2022,1880,2020,3900,25
KYOTERA,2023,1960,2060,4020,25
KYOTERA,2024,2030,2110,4140,25
KYOTERA,2025,2100,2160,4260,25
KARENGA,2015,560,530,1090,25
KARENGA,2016,580,540,1120,25
KARENGA,2017,590,550,1140,25
KARENGA,2018,610,570,1180,25
KARENGA,2019,620,580,1200,25
KARENGA,2020,640,590,1230,25
KARENGA,2021,650,610,1260,25
KARENGA,2022,670,620,1290,25
KARENGA,2023,690,630,1320,25
KARENGA,2024,700,650,1350,25
KARENGA,2025,720,660,1380,25
LAMWO,2015,760,1050,1810,25
LAMWO,2016,780,1080,1860,25
LAMWO,2017,800,1110,1910,25
LAMWO,2018,810,1120,1930,25
LAMWO,2019,840,1130,1970,25
LAMWO,2020,870,1130,2000,25
LAMWO,2021,900,1140,2040,25
LAMWO,2022,920,1150,2070,25
LAMWO,2023,950,1170,2120,25
LAMWO,2024,980,1210,2190,25
LAMWO,2025,1010,1230,2240,25
LIRA,2015,3760,4340,8100,25
LIRA,2016,3870,4460,8330,25
LIRA,2017,3980,4590,8570,25
LIRA,2018,4090,4720,8810,25
LIRA,2019,4200,4850,9050,25
LIRA,2020,4310,4980,9290,25
LIRA,2021,4420,5120,9540,25
LIRA,2022,4530,5250,9780,25
LIRA,2023,4640,5380,10020,25
LIRA,2024,4750,5510,10260,25
LIRA,2025,4860,5640,10500,25
LUUKA,2015,1280,1760,3040,25
LUUKA,2016,1320,1840,3160,25
LUUKA,2017,1370,1890,3260,25
LUUKA,2018,1430,1930,3360,25
LUUKA,2019,1490,1950,3440,25
LUUKA,2020,1560,1960,3520,25
LUUKA,2021,1620,1980,3600,25
LUUKA,2022,1690,2010,3700,25
LUUKA,2023,1760,2060,3820,25
LUUKA,2024,1830,2130,3960,25
LUUKA,2025,1900,2190,4090,25
LUWERO,2015,3500,3710,7210,25
LUWERO,2016,3620,3870,7490,25
LUWERO,2017,3770,4000,7770,25
LUWERO,2018,3940,4090,8030,25
LUWERO,2019,4140,4150,8290,25
LUWERO,2020,4340,4180,8520,25
LUWERO,2021,4530,4240,8770,25
LUWERO,2022,4740,4310,9050,25
LUWERO,2023,4960,4440,9400,25
LUWERO,2024,5180,4580,9760,25
LUWERO,2025,5410,4720,10130,25
LWENGO,2015,1510,2010,3520,25
LWENGO,2016,1540,2070,3610,25
LWENGO,2017,1580,2110,3690,25
LWENGO,2018,1630,2130,3760,25
LWENGO,2019,1680,2120,3800,25
LWENGO,2020,1740,2120,3860,25
LWENGO,2021,1790,2120,3910,25
LWENGO,2022,1850,2130,3980,25
LWENGO,2023,1910,2160,4070,25
LWENGO,2024,1960,2200,4160,25
LWENGO,2025,2030,2240,4270,25
LYANTONDE,2015,670,730,1400,25
LYANTONDE,2016,700,770,1470,25
LYANTONDE,2017,720,810,1530,25
LYANTONDE,2018,750,850,1600,25
LYANTONDE,2019,780,890,1670,25
LYANTONDE,2020,820,910,1730,25
LYANTONDE,2021,860,930,1790,25
LYANTONDE,2022,910,940,1850,25
LYANTONDE,2023,960,960,1920,25
LYANTONDE,2024,1010,980,1990,25
LYANTONDE,2025,1060,1010,2070,25
MANAFWA,2015,670,910,1580,25
MANAFWA,2016,690,930,1620,25
MANAFWA,2017,710,950,1660,25
MANAFWA,2018,720,970,1690,25
MANAFWA,2019,740,990,1730,25
MANAFWA,2020,760,1010,1770,25
MANAFWA,2021,780,1030,1810,25
MANAFWA,2022,790,1060,1850,25
MANAFWA,2023,810,1070,1880,25
MANAFWA,2024,830,1100,1930,25
MANAFWA,2025,840,1110,1950,25
MARACHA,2015,1040,1500,2540,25
MARACHA,2016,1060,1530,2590,25
MARACHA,2017,1080,1560,2640,25
MARACHA,2018,1100,1590,2690,25
MARACHA,2019,1120,1610,2730,25
MARACHA,2020,1150,1640,2790,25
MARACHA,2021,1170,1670,2840,25
MARACHA,2022,1190,1700,2890,25
MARACHA,2023,1210,1730,2940,25
MARACHA,2024,1230,1750,2980,25
MARACHA,2025,1250,1780,3030,25
MASAKA,2015,2570,3000,5570,25
MASAKA,2016,2650,3130,5780,25
MASAKA,2017,2750,3220,5970,25
MASAKA,2018,2870,3280,6150,25
MASAKA,2019,3000,3320,6320,25
MASAKA,2020,3140,3350,6490,25
MASAKA,2021,3270,3380,6650,25
MASAKA,2022,3410,3440,6850,25
MASAKA,2023,3570,3530,7100,25
MASAKA,2024,3720,3640,7360,25
MASAKA,2025,3870,3740,7610,25
MASINDI,2015,2820,2640,5460,25
MASINDI,2016,2900,2710,5610,25
MASINDI,2017,2980,2790,5770,25
MASINDI,2018,3070,2860,5930,25
MASINDI,2019,3150,2940,6090,25
MASINDI,2020,3240,3010,6250,25
MASINDI,2021,3330,3080,6410,25
MASINDI,2022,3420,3160,6580,25
MASINDI,2023,3500,3230,6730,25
MASINDI,2024,3590,3300,6890,25
MASINDI,2025,3680,3380,7060,25
MAYUGE,2015,2920,3780,6700,25
MAYUGE,2016,3040,3970,7010,25
MAYUGE,2017,3180,4140,7320,25
MAYUGE,2018,3350,4260,7610,25
MAYUGE,2019,3540,4360,7900,25
MAYUGE,2020,3730,4430,8160,25
MAYUGE,2021,3930,4530,8460,25
MAYUGE,2022,4140,4640,8780,25
MAYUGE,2023,4360,4810,9170,25
MAYUGE,2024,4580,5000,9580,25
MAYUGE,2025,4810,5210,10020,25
MBALE,2015,3290,4140,7430,25
MBALE,2016,3420,4370,7790,25
MBALE,2017,3570,4570,8140,25
MBALE,2018,3760,4710,8470,25
MBALE,2019,3970,4830,8800,25
MBALE,2020,4180,4920,9100,25
MBALE,2021,4400,5030,9430,25
MBALE,2022,4620,5180,9800,25
MBALE,2023,4870,5380,10250,25
MBALE,2024,5100,5610,10710,25
MBALE,2025,5360,5850,11210,25
MBARARA,2015,3570,4090,7660,25
MBARARA,2016,3650,4180,7830,25
MBARARA,2017,3730,4270,8000,25
MBARARA,2018,3820,4360,8180,25
MBARARA,2019,3910,4450,8360,25
MBARARA,2020,3990,4540,8530,25
MBARARA,2021,4070,4630,8700,25
MBARARA,2022,4150,4720,8870,25
MBARARA,2023,4240,4800,9040,25
MBARARA,2024,4310,4880,9190,25
MBARARA,2025,4390,4970,9360,25
MITOOMA,2015,1080,1480,2560,25
MITOOMA,2016,1100,1500,2600,25
MITOOMA,2017,1110,1510,2620,25
MITOOMA,2018,1120,1520,2640,25
MITOOMA,2019,1140,1540,2680,25
MITOOMA,2020,1150,1550,2700,25
MITOOMA,2021,1160,1560,2720,25
MITOOMA,2022,1170,1570,2740,25
MITOOMA,2023,1180,1580,2760,25
MITOOMA,2024,1190,1590,2780,25
MITOOMA,2025,1200,1600,2800,25
MITYANA,2015,2470,2700,5170,25
MITYANA,2016,2540,2790,5330,25
MITYANA,2017,2620,2870,5490,25
MITYANA,2018,2720,2920,5640,25
MITYANA,2019,2840,2930,5770,25
MITYANA,2020,2960,2940,5900,25
MITYANA,2021,3070,2960,6030,25
MITYANA,2022,3190,2990,6180,25
MITYANA,2023,3320,3060,6380,25
MITYANA,2024,3450,3130,6580,25
MITYANA,2025,3570,3210,6780,25
MOROTO,2015,1020,1320,2340,25
MOROTO,2016,1040,1390,2430,25
MOROTO,2017,1090,1440,2530,25
MOROTO,2018,1130,1470,2600,25
MOROTO,2019,1190,1500,2690,25
MOROTO,2020,1230,1510,2740,25
MOROTO,2021,1290,1540,2830,25
MOROTO,2022,1340,1570,2910,25
MOROTO,2023,1410,1620,3030,25
MOROTO,2024,1460,1670,3130,25
MOROTO,2025,1530,1720,3250,25
MOYO,2015,730,810,1540,25
MOYO,2016,740,830,1570,25
MOYO,2017,760,840,1600,25
MOYO,2018,780,860,1640,25
MOYO,2019,800,880,1680,25
MOYO,2020,820,900,1720,25
MOYO,2021,840,910,1750,25
MOYO,2022,860,930,1790,25
MOYO,2023,880,950,1830,25
MOYO,2024,900,970,1870,25
MOYO,2025,910,980,1890,25
MPIGI,2015,2030,2200,4230,25
MPIGI,2016,2100,2300,4400,25
MPIGI,2017,2180,2380,4560,25
MPIGI,2018,2280,2430,4710,25
MPIGI,2019,2390,2470,4860,25
MPIGI,2020,2500,2490,4990,25
MPIGI,2021,2620,2520,5140,25
MPIGI,2022,2730,2570,5300,25
MPIGI,2023,2860,2640,5500,25
MPIGI,2024,2980,2720,5700,25
MPIGI,2025,3110,2810,5920,25
MUBENDE,2015,3600,3920,7520,25
MUBENDE,2016,3820,4210,8030,25
MUBENDE,2017,4090,4480,8570,25
MUBENDE,2018,4400,4700,9100,25
MUBENDE,2019,4740,4900,9640,25
MUBENDE,2020,5100,5080,10180,25
MUBENDE,2021,5480,5300,10780,25
MUBENDE,2022,5890,5540,11430,25
MUBENDE,2023,6330,5860,12190,25
MUBENDE,2024,6790,6220,13010,25
MUBENDE,2025,7280,6590,13870,25
MUKONO,2015,5090,6370,11460,25
MUKONO,2016,5280,6690,11970,25
MUKONO,2017,5490,6950,12440,25
MUKONO,2018,5760,7160,12920,25
MUKONO,2019,6060,7300,13360,25
MUKONO,2020,6370,7420,13790,25
MUKONO,2021,6670,7560,14230,25
MUKONO,2022,6990,7760,14750,25
MUKONO,2023,7340,8020,15360,25
MUKONO,2024,7680,8330,16010,25
MUKONO,2025,8030,8650,16680,25
MADI OKOLLO,2015,1020,1270,2290,25
MADI OKOLLO,2016,1050,1310,2360,25
MADI OKOLLO,2017,1090,1340,2430,25
MADI OKOLLO,2018,1120,1380,2500,25
MADI OKOLLO,2019,1150,1420,2570,25
MADI OKOLLO,2020,1180,1450,2630,25
MADI OKOLLO,2021,1210,1490,2700,25
MADI OKOLLO,2022,1240,1530,2770,25
MADI OKOLLO,2023,1270,1560,2830,25
MADI OKOLLO,2024,1300,1600,2900,25
MADI OKOLLO,2025,1340,1630,2970,25
NABILATUK,2015,570,730,1300,25
NABILATUK,2016,600,790,1390,25
NABILATUK,2017,640,830,1470,25
NABILATUK,2018,690,870,1560,25
NABILATUK,2019,740,890,1630,25
NABILATUK,2020,800,920,1720,25
NABILATUK,2021,850,950,1800,25
NABILATUK,2022,920,990,1910,25
NABILATUK,2023,980,1040,2020,25
NABILATUK,2024,1050,1100,2150,25
NABILATUK,2025,1120,1160,2280,25
NAKAPIRIPIRIT,2015,780,970,1750,25
NAKAPIRIPIRIT,2016,820,1030,1850,25
NAKAPIRIPIRIT,2017,870,1080,1950,25
NAKAPIRIPIRIT,2018,930,1130,2060,25
NAKAPIRIPIRIT,2019,990,1170,2160,25
NAKAPIRIPIRIT,2020,1070,1210,2280,25
NAKAPIRIPIRIT,2021,1130,1250,2380,25
NAKAPIRIPIRIT,2022,1210,1300,2510,25
NAKAPIRIPIRIT,2023,1290,1360,2650,25
NAKAPIRIPIRIT,2024,1370,1440,2810,25
NAKAPIRIPIRIT,2025,1460,1510,2970,25
NAKASEKE,2015,2010,1570,3580,25
NAKASEKE,2016,2090,1600,3690,25
NAKASEKE,2017,2160,1640,3800,25
NAKASEKE,2018,2240,1680,3920,25
NAKASEKE,2019,2320,1720,4040,25
NAKASEKE,2020,2410,1760,4170,25
NAKASEKE,2021,2490,1800,4290,25
NAKASEKE,2022,2570,1830,4400,25
NAKASEKE,2023,2660,1870,4530,25
NAKASEKE,2024,2740,1910,4650,25
NAKASEKE,2025,2830,1950,4780,25
NAKASONGOLA,2015,1430,1240,2670,25
NAKASONGOLA,2016,1490,1290,2780,25
NAKASONGOLA,2017,1560,1350,2910,25
NAKASONGOLA,2018,1640,1380,3020,25
NAKASONGOLA,2019,1730,1410,3140,25
NAKASONGOLA,2020,1840,1420,3260,25
NAKASONGOLA,2021,1930,1450,3380,25
NAKASONGOLA,2022,2040,1480,3520,25
NAKASONGOLA,2023,2140,1530,3670,25
NAKASONGOLA,2024,2260,1580,3840,25
NAKASONGOLA,2025,2360,1640,4000,25
NAMAYINGO,2015,1250,1580,2830,25
NAMAYINGO,2016,1280,1640,2920,25
NAMAYINGO,2017,1320,1680,3000,25
NAMAYINGO,2018,1380,1710,3090,25
NAMAYINGO,2019,1440,1720,3160,25
NAMAYINGO,2020,1490,1720,3210,25
NAMAYINGO,2021,1560,1730,3290,25
NAMAYINGO,2022,1610,1740,3350,25
NAMAYINGO,2023,1680,1790,3470,25
NAMAYINGO,2024,1750,1820,3570,25
NAMAYINGO,2025,1810,1870,3680,25
NAMISINDWA,2015,1000,1120,2120,25
NAMISINDWA,2016,1030,1150,2180,25
NAMISINDWA,2017,1050,1170,2220,25
NAMISINDWA,2018,1080,1200,2280,25
NAMISINDWA,2019,1110,1230,2340,25
NAMISINDWA,2020,1140,1250,2390,25
NAMISINDWA,2021,1170,1280,2450,25
NAMISINDWA,2022,1200,1310,2510,25
NAMISINDWA,2023,1230,1340,2570,25
NAMISINDWA,2024,1260,1360,2620,25
NAMISINDWA,2025,1290,1390,2680,25
NAMUTUMBA,2015,1420,1830,3250,25
NAMUTUMBA,2016,1480,1930,3410,25
NAMUTUMBA,2017,1550,2010,3560,25
NAMUTUMBA,2018,1640,2080,3720,25
NAMUTUMBA,2019,1740,2120,3860,25
NAMUTUMBA,2020,1850,2170,4020,25
NAMUTUMBA,2021,1950,2210,4160,25
NAMUTUMBA,2022,2060,2280,4340,25
NAMUTUMBA,2023,2170,2370,4540,25
NAMUTUMBA,2024,2300,2460,4760,25
NAMUTUMBA,2025,2420,2570,4990,25
NAPAK,2015,1110,1590,2700,25
NAPAK,2016,1140,1650,2790,25
NAPAK,2017,1170,1710,2880,25
NAPAK,2018,1220,1740,2960,25
NAPAK,2019,1280,1770,3050,25
NAPAK,2020,1320,1780,3100,25
NAPAK,2021,1370,1800,3170,25
NAPAK,2022,1420,1830,3250,25
NAPAK,2023,1470,1880,3350,25
NAPAK,2024,1530,1930,3460,25
NAPAK,2025,1590,1990,3580,25
NEBBI,2015,1480,1920,3400,25
NEBBI,2016,1530,1980,3510,25
NEBBI,2017,1580,2040,3620,25
NEBBI,2018,1630,2090,3720,25
NEBBI,2019,1680,2150,3830,25
NEBBI,2020,1730,2210,3940,25
NEBBI,2021,1780,2270,4050,25
NEBBI,2022,1830,2320,4150,25
NEBBI,2023,1880,2380,4260,25
NEBBI,2024,1930,2440,4370,25
NEBBI,2025,1980,2500,4480,25
NGORA,2015,810,1070,1880,25
NGORA,2016,840,1120,1960,25
NGORA,2017,870,1160,2030,25
NGORA,2018,920,1180,2100,25
NGORA,2019,970,1200,2170,25
NGORA,2020,1020,1220,2240,25
NGORA,2021,1070,1240,2310,25
NGORA,2022,1130,1270,2400,25
NGORA,2023,1170,1310,2480,25
NGORA,2024,1240,1360,2600,25
NGORA,2025,1300,1410,2710,25
NTOROKO,2015,550,620,1170,25
NTOROKO,2016,570,650,1220,25
NTOROKO,2017,590,660,1250,25
NTOROKO,2018,620,670,1290,25
NTOROKO,2019,650,680,1330,25
NTOROKO,2020,680,680,1360,25
NTOROKO,2021,720,690,1410,25
NTOROKO,2022,750,700,1450,25
NTOROKO,2023,790,720,1510,25
NTOROKO,2024,820,740,1560,25
NTOROKO,2025,860,760,1620,25
NTUNGAMO,2015,3350,4010,7360,25
NTUNGAMO,2016,3420,4090,7510,25
NTUNGAMO,2017,3490,4160,7650,25
NTUNGAMO,2018,3570,4240,7810,25
NTUNGAMO,2019,3640,4310,7950,25
NTUNGAMO,2020,3710,4390,8100,25
NTUNGAMO,2021,3790,4460,8250,25
NTUNGAMO,2022,3860,4530,8390,25
NTUNGAMO,2023,3930,4600,8530,25
NTUNGAMO,2024,3990,4670,8660,25
NTUNGAMO,2025,4060,4730,8790,25
NWOYA,2015,1070,1070,2140,25
NWOYA,2016,1180,1180,2360,25
NWOYA,2017,1310,1300,2610,25
NWOYA,2018,1440,1440,2880,25
NWOYA,2019,1590,1580,3170,25
NWOYA,2020,1760,1740,3500,25
NWOYA,2021,1940,1910,3850,25
NWOYA,2022,2130,2100,4230,25
NWOYA,2023,2350,2310,4660,25
NWOYA,2024,2580,2530,5110,25
NWOYA,2025,2840,2780,5620,25
OBONGI,2015,310,360,670,25
OBONGI,2016,330,370,700,25
OBONGI,2017,340,390,730,25
OBONGI,2018,360,390,750,25
OBONGI,2019,380,390,770,25
OBONGI,2020,380,400,780,25
OBONGI,2021,400,410,810,25
OBONGI,2022,420,420,840,25
OBONGI,2023,440,420,860,25
OBONGI,2024,460,440,900,25
OBONGI,2025,490,450,940,25
OMORO,2015,1020,1200,2220,25
OMORO,2016,1060,1260,2320,25
OMORO,2017,1120,1320,2440,25
OMORO,2018,1180,1370,2550,25
OMORO,2019,1260,1400,2660,25
OMORO,2020,1330,1430,2760,25
OMORO,2021,1410,1460,2870,25
OMORO,2022,1480,1510,2990,25
OMORO,2023,1570,1570,3140,25
OMORO,2024,1660,1640,3300,25
OMORO,2025,1750,1700,3450,25
OTUKE,2015,650,910,1560,25
OTUKE,2016,680,950,1630,25
OTUKE,2017,710,990,1700,25
OTUKE,2018,750,1030,1780,25
OTUKE,2019,780,1080,1860,25
OTUKE,2020,810,1120,1930,25
OTUKE,2021,850,1170,2020,25
OTUKE,2022,880,1210,2090,25
OTUKE,2023,920,1260,2180,25
OTUKE,2024,960,1310,2270,25
OTUKE,2025,1000,1360,2360,25
OYAM,2015,2560,2900,5460,25
OYAM,2016,2630,2980,5610,25
OYAM,2017,2710,3070,5780,25
OYAM,2018,2800,3160,5960,25
OYAM,2019,2880,3250,6130,25
OYAM,2020,2960,3340,6300,25
OYAM,2021,3050,3430,6480,25
OYAM,2022,3130,3520,6650,25
OYAM,2023,3220,3610,6830,25
OYAM,2024,3300,3700,7000,25
OYAM,2025,3380,3790,7170,25
PADER,2015,1070,1530,2600,25
PADER,2016,1100,1590,2690,25
PADER,2017,1140,1640,2780,25
PADER,2018,1180,1670,2850,25
PADER,2019,1230,1690,2920,25
PADER,2020,1280,1700,2980,25
PADER,2021,1320,1710,3030,25
PADER,2022,1380,1730,3110,25
PADER,2023,1430,1780,3210,25
PADER,2024,1490,1830,3320,25
PADER,2025,1530,1880,3410,25
PAKWACH,2015,1180,1410,2590,25
PAKWACH,2016,1230,1460,2690,25
PAKWACH,2017,1280,1510,2790,25
PAKWACH,2018,1340,1570,2910,25
PAKWACH,2019,1390,1630,3020,25
PAKWACH,2020,1440,1680,3120,25
PAKWACH,2021,1500,1740,3240,25
PAKWACH,2022,1560,1800,3360,25
PAKWACH,2023,1620,1860,3480,25
PAKWACH,2024,1680,1920,3600,25
PAKWACH,2025,1740,1980,3720,25
PALLISA,2015,1590,2090,3680,25
PALLISA,2016,1680,2220,3900,25
PALLISA,2017,1780,2340,4120,25
PALLISA,2018,1890,2440,4330,25
PALLISA,2019,2030,2520,4550,25
PALLISA,2020,2170,2600,4770,25
PALLISA,2021,2310,2690,5000,25
PALLISA,2022,2460,2790,5250,25
PALLISA,2023,2630,2930,5560,25
PALLISA,2024,2800,3080,5880,25
PALLISA,2025,2980,3240,6220,25
RAKAI,2015,1610,1980,3590,25
RAKAI,2016,1670,2070,3740,25
RAKAI,2017,1740,2140,3880,25
RAKAI,2018,1810,2180,3990,25
RAKAI,2019,1910,2220,4130,25
RAKAI,2020,2000,2240,4240,25
RAKAI,2021,2090,2260,4350,25
RAKAI,2022,2190,2310,4500,25
RAKAI,2023,2290,2370,4660,25
RAKAI,2024,2390,2450,4840,25
RAKAI,2025,2500,2530,5030,25
RUBANDA,2015,1280,1690,2970,25
RUBANDA,2016,1300,1700,3000,25
RUBANDA,2017,1320,1710,3030,25
RUBANDA,2018,1330,1730,3060,25
RUBANDA,2019,1350,1740,3090,25
RUBANDA,2020,1370,1750,3120,25
RUBANDA,2021,1380,1760,3140,25
RUBANDA,2022,1400,1770,3170,25
RUBANDA,2023,1410,1780,3190,25
RUBANDA,2024,1420,1790,3210,25
RUBANDA,2025,1440,1790,3230,25
RUBIRIZI,2015,800,1070,1870,25
RUBIRIZI,2016,820,1090,1910,25
RUBIRIZI,2017,830,1110,1940,25
RUBIRIZI,2018,850,1130,1980,25
RUBIRIZI,2019,870,1150,2020,25
RUBIRIZI,2020,880,1170,2050,25
RUBIRIZI,2021,900,1190,2090,25
RUBIRIZI,2022,910,1210,2120,25
RUBIRIZI,2023,930,1230,2160,25
RUBIRIZI,2024,940,1250,2190,25
RUBIRIZI,2025,960,1260,2220,25
RUKIGA,2015,730,840,1570,25
RUKIGA,2016,740,850,1590,25
RUKIGA,2017,750,850,1600,25
RUKIGA,2018,750,860,1610,25
RUKIGA,2019,760,860,1620,25
RUKIGA,2020,770,870,1640,25
RUKIGA,2021,770,870,1640,25
RUKIGA,2022,780,880,1660,25
RUKIGA,2023,780,880,1660,25
RUKIGA,2024,790,880,1670,25
RUKIGA,2025,790,880,1670,25
RUKUNGIRI,2015,2000,2420,4420,25
RUKUNGIRI,2016,2030,2450,4480,25
RUKUNGIRI,2017,2050,2470,4520,25
RUKUNGIRI,2018,2070,2500,4570,25
RUKUNGIRI,2019,2100,2520,4620,25
RUKUNGIRI,2020,2120,2540,4660,25
RUKUNGIRI,2021,2140,2560,4700,25
RUKUNGIRI,2022,2160,2580,4740,25
RUKUNGIRI,2023,2180,2590,4770,25
RUKUNGIRI,2024,2190,2610,4800,25
RUKUNGIRI,2025,2210,2620,4830,25
RWAMPARA,2015,950,1100,2050,25
RWAMPARA,2016,970,1120,2090,25
RWAMPARA,2017,1000,1140,2140,25
RWAMPARA,2018,1020,1170,2190,25
RWAMPARA,2019,1040,1190,2230,25
RWAMPARA,2020,1060,1220,2280,25
RWAMPARA,2021,1080,1240,2320,25
RWAMPARA,2022,1110,1260,2370,25
RWAMPARA,2023,1130,1290,2420,25
RWAMPARA,2024,1150,1310,2460,25
RWAMPARA,2025,1170,1330,2500,25
SERERE,2015,1690,2170,3860,25
SERERE,2016,1770,2300,4070,25
SERERE,2017,1870,2430,4300,25
SERERE,2018,1990,2520,4510,25
SERERE,2019,2120,2590,4710,25
SERERE,2020,2260,2660,4920,25
SERERE,2021,2390,2740,5130,25
SERERE,2022,2540,2840,5380,25
SERERE,2023,2700,2960,5660,25
SERERE,2024,2870,3110,5980,25
SERERE,2025,3050,3250,6300,25
SHEEMA,2015,1410,1700,3110,25
SHEEMA,2016,1430,1720,3150,25
SHEEMA,2017,1450,1740,3190,25
SHEEMA,2018,1460,1760,3220,25
SHEEMA,2019,1480,1770,3250,25
SHEEMA,2020,1500,1790,3290,25
SHEEMA,2021,1510,1800,3310,25
SHEEMA,2022,1530,1820,3350,25
SHEEMA,2023,1540,1830,3370,25
SHEEMA,2024,1550,1840,3390,25
SHEEMA,2025,1560,1850,3410,25
SIRONKO,2015,1290,1470,2760,25
SIRONKO,2016,1320,1500,2820,25
SIRONKO,2017,1350,1530,2880,25
SIRONKO,2018,1380,1560,2940,25
SIRONKO,2019,1420,1590,3010,25
SIRONKO,2020,1450,1620,3070,25
SIRONKO,2021,1480,1650,3130,25
SIRONKO,2022,1510,1680,3190,25
SIRONKO,2023,1540,1710,3250,25
SIRONKO,2024,1570,1740,3310,25
SIRONKO,2025,1600,1770,3370,25
SOROTI,2015,2090,2640,4730,25
SOROTI,2016,2190,2790,4980,25
SOROTI,2017,2300,2920,5220,25
SOROTI,2018,2440,3020,5460,25
SOROTI,2019,2590,3100,5690,25
SOROTI,2020,2740,3160,5900,25
SOROTI,2021,2890,3250,6140,25
SOROTI,2022,3060,3340,6400,25
SOROTI,2023,3240,3480,6720,25
SOROTI,2024,3420,3640,7060,25
SOROTI,2025,3620,3790,7410,25
SSEMBABULE,2015,1620,1960,3580,25
SSEMBABULE,2016,1680,2050,3730,25
SSEMBABULE,2017,1760,2130,3890,25
SSEMBABULE,2018,1840,2180,4020,25
SSEMBABULE,2019,1940,2230,4170,25
SSEMBABULE,2020,2040,2250,4290,25
SSEMBABULE,2021,2140,2290,4430,25
SSEMBABULE,2022,2250,2350,4600,25
SSEMBABULE,2023,2360,2420,4780,25
SSEMBABULE,2024,2480,2500,4980,25
SSEMBABULE,2025,2600,2600,5200,25
TORORO,2015,3070,3540,6610,25
TORORO,2016,3150,3630,6780,25
TORORO,2017,3230,3720,6950,25
TORORO,2018,3320,3810,7130,25
TORORO,2019,3400,3900,7300,25
TORORO,2020,3490,3990,7480,25
TORORO,2021,3570,4080,7650,25
TORORO,2022,3660,4170,7830,25
TORORO,2023,3740,4260,8000,25
TORORO,2024,3830,4350,8180,25
TORORO,2025,3910,4440,8350,25
WAKISO,2015,23820,30940,54760,25
WAKISO,2016,25420,33050,58470,25
WAKISO,2017,27120,35310,62430,25
WAKISO,2018,28920,37700,66620,25
WAKISO,2019,30850,40230,71080,25
WAKISO,2020,32860,42910,75770,25
WAKISO,2021,34970,45760,80730,25
WAKISO,2022,37210,48780,85990,25
WAKISO,2023,39570,51910,91480,25
WAKISO,2024,42030,55220,97250,25
WAKISO,2025,44620,58730,103350,25
YUMBE,2015,2940,4360,7300,25
YUMBE,2016,3120,4710,7830,25
YUMBE,2017,3330,5050,8380,25
YUMBE,2018,3570,5340,8910,25
YUMBE,2019,3840,5600,9440,25
YUMBE,2020,4140,5860,10000,25
YUMBE,2021,4440,6140,10580,25
YUMBE,2022,4750,6480,11230,25
YUMBE,2023,5110,6900,12010,25
YUMBE,2024,5480,7380,12860,25
YUMBE,2025,5850,7880,13730,25
ZOMBO,2015,1460,1910,3370,25
ZOMBO,2016,1500,1960,3460,25
ZOMBO,2017,1550,2020,3570,25
ZOMBO,2018,1600,2070,3670,25
ZOMBO,2019,1640,2130,3770,25
ZOMBO,2020,1690,2180,3870,25
ZOMBO,2021,1740,2240,3980,25
ZOMBO,2022,1790,2300,4090,25
ZOMBO,2023,1840,2350,4190,25
ZOMBO,2024,1890,2410,4300,25
ZOMBO,2025,1930,2470,4400,25
ABIM,2015,710,840,1550,26
ABIM,2016,760,920,1680,26
ABIM,2017,810,1000,1810,26
ABIM,2018,880,1070,1950,26
ABIM,2019,950,1130,2080,26
ABIM,2020,1040,1190,2230,26
ABIM,2021,1130,1250,2380,26
ABIM,2022,1220,1310,2530,26
ABIM,2023,1330,1390,2720,26
ABIM,2024,1450,1470,2920,26
ABIM,2025,1560,1580,3140,26
ADJUMANI,2015,1230,1630,2860,26
ADJUMANI,2016,1240,1650,2890,26
ADJUMANI,2017,1240,1660,2900,26
ADJUMANI,2018,1250,1680,2930,26
ADJUMANI,2019,1260,1700,2960,26
ADJUMANI,2020,1270,1710,2980,26
ADJUMANI,2021,1280,1720,3000,26
ADJUMANI,2022,1280,1730,3010,26
ADJUMANI,2023,1290,1750,3040,26
ADJUMANI,2024,1290,1760,3050,26
ADJUMANI,2025,1290,1770,3060,26
AGAGO,2015,990,1290,2280,26
AGAGO,2016,1010,1310,2320,26
AGAGO,2017,1030,1340,2370,26
AGAGO,2018,1040,1360,2400,26
AGAGO,2019,1060,1380,2440,26
AGAGO,2020,1080,1400,2480,26
AGAGO,2021,1090,1430,2520,26
AGAGO,2022,1110,1450,2560,26
AGAGO,2023,1130,1470,2600,26
AGAGO,2024,1140,1490,2630,26
AGAGO,2025,1160,1510,2670,26
ALEBTONG,2015,1310,1580,2890,26
ALEBTONG,2016,1360,1670,3030,26
ALEBTONG,2017,1420,1750,3170,26
ALEBTONG,2018,1470,1820,3290,26
ALEBTONG,2019,1550,1870,3420,26
ALEBTONG,2020,1620,1900,3520,26
ALEBTONG,2021,1710,1930,3640,26
ALEBTONG,2022,1800,1960,3760,26
ALEBTONG,2023,1870,2000,3870,26
ALEBTONG,2024,1970,2070,4040,26
ALEBTONG,2025,2060,2140,4200,26
AMOLATAR,2015,960,1120,2080,26
AMOLATAR,2016,980,1180,2160,26
AMOLATAR,2017,1020,1230,2250,26
AMOLATAR,2018,1060,1270,2330,26
AMOLATAR,2019,1110,1310,2420,26
AMOLATAR,2020,1170,1320,2490,26
AMOLATAR,2021,1220,1340,2560,26
AMOLATAR,2022,1280,1360,2640,26
AMOLATAR,2023,1340,1390,2730,26
AMOLATAR,2024,1410,1430,2840,26
AMOLATAR,2025,1470,1470,2940,26
AMUDAT,2015,640,850,1490,26
AMUDAT,2016,680,920,1600,26
AMUDAT,2017,710,980,1690,26
AMUDAT,2018,740,1030,1770,26
AMUDAT,2019,790,1080,1870,26
AMUDAT,2020,850,1120,1970,26
AMUDAT,2021,890,1160,2050,26
AMUDAT,2022,950,1210,2160,26
AMUDAT,2023,1010,1250,2260,26
AMUDAT,2024,1070,1320,2390,26
AMUDAT,2025,1140,1390,2530,26
AMURIA,2015,960,1170,2130,26
AMURIA,2016,1000,1240,2240,26
AMURIA,2017,1050,1320,2370,26
AMURIA,2018,1110,1380,2490,26
AMURIA,2019,1160,1430,2590,26
AMURIA,2020,1240,1460,2700,26
AMURIA,2021,1320,1500,2820,26
AMURIA,2022,1400,1530,2930,26
AMURIA,2023,1480,1580,3060,26
AMURIA,2024,1570,1640,3210,26
AMURIA,2025,1640,1710,3350,26
AMURU,2015,1180,1330,2510,26
AMURU,2016,1220,1390,2610,26
AMURU,2017,1260,1470,2730,26
AMURU,2018,1310,1520,2830,26
AMURU,2019,1370,1560,2930,26
AMURU,2020,1440,1580,3020,26
AMURU,2021,1510,1610,3120,26
AMURU,2022,1580,1630,3210,26
AMURU,2023,1660,1670,3330,26
AMURU,2024,1740,1720,3460,26
AMURU,2025,1820,1780,3600,26
APAC,2015,1220,1370,2590,26
APAC,2016,1260,1420,2680,26
APAC,2017,1310,1470,2780,26
APAC,2018,1360,1520,2880,26
APAC,2019,1410,1570,2980,26
APAC,2020,1460,1620,3080,26
APAC,2021,1510,1670,3180,26
APAC,2022,1560,1730,3290,26
APAC,2023,1610,1780,3390,26
APAC,2024,1660,1840,3500,26
APAC,2025,1710,1890,3600,26
ARUA,2015,3910,4790,8700,26
ARUA,2016,4020,4920,8940,26
ARUA,2017,4140,5050,9190,26
ARUA,2018,4260,5190,9450,26
ARUA,2019,4370,5320,9690,26
ARUA,2020,4490,5460,9950,26
ARUA,2021,4620,5600,10220,26
ARUA,2022,4730,5730,10460,26
ARUA,2023,4850,5870,10720,26
ARUA,2024,4970,6010,10980,26
ARUA,2025,5090,6140,11230,26
BUDAKA,2015,1010,1400,2410,26
BUDAKA,2016,1060,1490,2550,26
BUDAKA,2017,1100,1580,2680,26
BUDAKA,2018,1160,1640,2800,26
BUDAKA,2019,1230,1700,2930,26
BUDAKA,2020,1300,1740,3040,26
BUDAKA,2021,1380,1780,3160,26
BUDAKA,2022,1460,1820,3280,26
BUDAKA,2023,1540,1880,3420,26
BUDAKA,2024,1630,1940,3570,26
BUDAKA,2025,1720,2030,3750,26
BUDUDA,2015,1440,1610,3050,26
BUDUDA,2016,1520,1720,3240,26
BUDUDA,2017,1600,1830,3430,26
BUDUDA,2018,1700,1940,3640,26
BUDUDA,2019,1800,2020,3820,26
BUDUDA,2020,1930,2090,4020,26
BUDUDA,2021,2060,2150,4210,26
BUDUDA,2022,2210,2230,4440,26
BUDUDA,2023,2350,2320,4670,26
BUDUDA,2024,2510,2430,4940,26
BUDUDA,2025,2670,2560,5230,26
BUGIRI,2015,2030,2740,4770,26
BUGIRI,2016,2130,2910,5040,26
BUGIRI,2017,2240,3090,5330,26
BUGIRI,2018,2370,3250,5620,26
BUGIRI,2019,2510,3360,5870,26
BUGIRI,2020,2680,3470,6150,26
BUGIRI,2021,2860,3560,6420,26
BUGIRI,2022,3030,3660,6690,26
BUGIRI,2023,3210,3790,7000,26
BUGIRI,2024,3420,3950,7370,26
BUGIRI,2025,3620,4150,7770,26
BUGWERI,2015,790,1170,1960,26
BUGWERI,2016,810,1220,2030,26
BUGWERI,2017,840,1280,2120,26
BUGWERI,2018,880,1330,2210,26
BUGWERI,2019,920,1370,2290,26
BUGWERI,2020,980,1380,2360,26
BUGWERI,2021,1020,1400,2420,26
BUGWERI,2022,1070,1430,2500,26
BUGWERI,2023,1120,1460,2580,26
BUGWERI,2024,1180,1500,2680,26
BUGWERI,2025,1230,1550,2780,26
BUHWEJU,2015,850,920,1770,26
BUHWEJU,2016,880,950,1830,26
BUHWEJU,2017,910,980,1890,26
BUHWEJU,2018,940,1010,1950,26
BUHWEJU,2019,970,1040,2010,26
BUHWEJU,2020,1000,1070,2070,26
BUHWEJU,2021,1030,1100,2130,26
BUHWEJU,2022,1060,1130,2190,26
BUHWEJU,2023,1090,1160,2250,26
BUHWEJU,2024,1120,1190,2310,26
BUHWEJU,2025,1150,1220,2370,26
BUIKWE,2015,3040,3670,6710,26
BUIKWE,2016,3120,3850,6970,26
BUIKWE,2017,3220,4000,7220,26
BUIKWE,2018,3330,4130,7460,26
BUIKWE,2019,3460,4200,7660,26
BUIKWE,2020,3610,4250,7860,26
BUIKWE,2021,3770,4290,8060,26
BUIKWE,2022,3930,4320,8250,26
BUIKWE,2023,4080,4390,8470,26
BUIKWE,2024,4250,4500,8750,26
BUIKWE,2025,4420,4630,9050,26
BUKEDEA,2015,1090,1360,2450,26
BUKEDEA,2016,1150,1450,2600,26
BUKEDEA,2017,1210,1540,2750,26
BUKEDEA,2018,1280,1620,2900,26
BUKEDEA,2019,1360,1690,3050,26
BUKEDEA,2020,1450,1740,3190,26
BUKEDEA,2021,1560,1790,3350,26
BUKEDEA,2022,1660,1840,3500,26
BUKEDEA,2023,1770,1900,3670,26
BUKEDEA,2024,1880,2000,3880,26
BUKEDEA,2025,2010,2100,4110,26
BUKOMANSIMBI,2015,740,940,1680,26
BUKOMANSIMBI,2016,760,970,1730,26
BUKOMANSIMBI,2017,760,1000,1760,26
BUKOMANSIMBI,2018,790,1010,1800,26
BUKOMANSIMBI,2019,810,1010,1820,26
BUKOMANSIMBI,2020,830,1020,1850,26
BUKOMANSIMBI,2021,870,1000,1870,26
BUKOMANSIMBI,2022,890,1000,1890,26
BUKOMANSIMBI,2023,910,1000,1910,26
BUKOMANSIMBI,2024,940,1010,1950,26
BUKOMANSIMBI,2025,960,1020,1980,26
BUKWO,2015,630,740,1370,26
BUKWO,2016,670,770,1440,26
BUKWO,2017,700,810,1510,26
BUKWO,2018,740,850,1590,26
BUKWO,2019,780,890,1670,26
BUKWO,2020,820,930,1750,26
BUKWO,2021,860,980,1840,26
BUKWO,2022,910,1020,1930,26
BUKWO,2023,950,1070,2020,26
BUKWO,2024,1000,1120,2120,26
BUKWO,2025,1040,1170,2210,26
BULAMBULI,2015,1120,1290,2410,26
BULAMBULI,2016,1190,1380,2570,26
BULAMBULI,2017,1260,1480,2740,26
BULAMBULI,2018,1350,1570,2920,26
BULAMBULI,2019,1430,1650,3080,26
BULAMBULI,2020,1540,1710,3250,26
BULAMBULI,2021,1660,1780,3440,26
BULAMBULI,2022,1770,1840,3610,26
BULAMBULI,2023,1900,1920,3820,26
BULAMBULI,2024,2020,2030,4050,26
BULAMBULI,2025,2170,2140,4310,26
BULIISA,2015,1040,760,1800,26
BULIISA,2016,1090,790,1880,26
BULIISA,2017,1160,830,1990,26
BULIISA,2018,1220,870,2090,26
BULIISA,2019,1280,900,2180,26
BULIISA,2020,1350,940,2290,26
BULIISA,2021,1420,980,2400,26
BULIISA,2022,1490,1020,2510,26
BULIISA,2023,1570,1060,2630,26
BULIISA,2024,1640,1110,2750,26
BULIISA,2025,1720,1150,2870,26
BUNDIBUGYO,2015,1460,1710,3170,26
BUNDIBUGYO,2016,1510,1800,3310,26
BUNDIBUGYO,2017,1560,1880,3440,26
BUNDIBUGYO,2018,1630,1960,3590,26
BUNDIBUGYO,2019,1710,2010,3720,26
BUNDIBUGYO,2020,1810,2040,3850,26
BUNDIBUGYO,2021,1900,2070,3970,26
BUNDIBUGYO,2022,1990,2110,4100,26
BUNDIBUGYO,2023,2100,2160,4260,26
BUNDIBUGYO,2024,2210,2220,4430,26
BUNDIBUGYO,2025,2310,2310,4620,26
BUNYANGABU,2015,1260,1310,2570,26
BUNYANGABU,2016,1290,1370,2660,26
BUNYANGABU,2017,1340,1430,2770,26
BUNYANGABU,2018,1390,1490,2880,26
BUNYANGABU,2019,1470,1510,2980,26
BUNYANGABU,2020,1540,1540,3080,26
BUNYANGABU,2021,1610,1550,3160,26
BUNYANGABU,2022,1680,1570,3250,26
BUNYANGABU,2023,1760,1600,3360,26
BUNYANGABU,2024,1840,1640,3480,26
BUNYANGABU,2025,1920,1690,3610,26
BUSHENYI,2015,1530,1860,3390,26
BUSHENYI,2016,1550,1880,3430,26
BUSHENYI,2017,1570,1900,3470,26
BUSHENYI,2018,1590,1910,3500,26
BUSHENYI,2019,1600,1930,3530,26
BUSHENYI,2020,1620,1940,3560,26
BUSHENYI,2021,1640,1960,3600,26
BUSHENYI,2022,1650,1970,3620,26
BUSHENYI,2023,1670,1980,3650,26
BUSHENYI,2024,1680,1990,3670,26
BUSHENYI,2025,1690,2000,3690,26
BUSIA,2015,1960,2520,4480,26
BUSIA,2016,2030,2660,4690,26
BUSIA,2017,2110,2790,4900,26
BUSIA,2018,2210,2900,5110,26
BUSIA,2019,2330,2980,5310,26
BUSIA,2020,2460,3050,5510,26
BUSIA,2021,2590,3100,5690,26
BUSIA,2022,2730,3140,5870,26
BUSIA,2023,2870,3220,6090,26
BUSIA,2024,3020,3330,6350,26
BUSIA,2025,3170,3460,6630,26
BUTALEJA,2015,1360,1710,3070,26
BUTALEJA,2016,1420,1820,3240,26
BUTALEJA,2017,1480,1920,3400,26
BUTALEJA,2018,1560,2010,3570,26
BUTALEJA,2019,1650,2080,3730,26
BUTALEJA,2020,1750,2140,3890,26
BUTALEJA,2021,1850,2180,4030,26
BUTALEJA,2022,1970,2240,4210,26
BUTALEJA,2023,2080,2310,4390,26
BUTALEJA,2024,2210,2400,4610,26
BUTALEJA,2025,2330,2500,4830,26
BUTAMBALA,2015,480,610,1090,26
BUTAMBALA,2016,490,630,1120,26
BUTAMBALA,2017,490,650,1140,26
BUTAMBALA,2018,510,670,1180,26
BUTAMBALA,2019,520,670,1190,26
BUTAMBALA,2020,550,670,1220,26
BUTAMBALA,2021,560,670,1230,26
BUTAMBALA,2022,590,670,1260,26
BUTAMBALA,2023,600,670,1270,26
BUTAMBALA,2024,630,690,1320,26
BUTAMBALA,2025,640,700,1340,26
BUTEBO,2015,580,740,1320,26
BUTEBO,2016,590,770,1360,26
BUTEBO,2017,610,790,1400,26
BUTEBO,2018,630,810,1440,26
BUTEBO,2019,650,820,1470,26
BUTEBO,2020,670,830,1500,26
BUTEBO,2021,700,830,1530,26
BUTEBO,2022,720,820,1540,26
BUTEBO,2023,750,830,1580,26
BUTEBO,2024,770,850,1620,26
BUTEBO,2025,800,870,1670,26
BUVUMA,2015,880,740,1620,26
BUVUMA,2016,940,800,1740,26
BUVUMA,2017,990,850,1840,26
BUVUMA,2018,1050,910,1960,26
BUVUMA,2019,1120,970,2090,26
BUVUMA,2020,1190,1030,2220,26
BUVUMA,2021,1260,1100,2360,26
BUVUMA,2022,1330,1170,2500,26
BUVUMA,2023,1410,1240,2650,26
BUVUMA,2024,1490,1320,2810,26
BUVUMA,2025,1570,1410,2980,26
BUYENDE,2015,1910,2190,4100,26
BUYENDE,2016,2010,2350,4360,26
BUYENDE,2017,2110,2500,4610,26
BUYENDE,2018,2250,2640,4890,26
BUYENDE,2019,2400,2750,5150,26
BUYENDE,2020,2560,2850,5410,26
BUYENDE,2021,2730,2920,5650,26
BUYENDE,2022,2920,3030,5950,26
BUYENDE,2023,3100,3140,6240,26
BUYENDE,2024,3300,3280,6580,26
BUYENDE,2025,3530,3460,6990,26
DOKOLO,2015,950,1210,2160,26
DOKOLO,2016,980,1240,2220,26
DOKOLO,2017,1010,1280,2290,26
DOKOLO,2018,1040,1310,2350,26
DOKOLO,2019,1070,1350,2420,26
DOKOLO,2020,1100,1380,2480,26
DOKOLO,2021,1130,1420,2550,26
DOKOLO,2022,1160,1450,2610,26
DOKOLO,2023,1190,1490,2680,26
DOKOLO,2024,1230,1520,2750,26
DOKOLO,2025,1260,1560,2820,26
GOMBA,2015,930,970,1900,26
GOMBA,2016,950,1000,1950,26
GOMBA,2017,980,1030,2010,26
GOMBA,2018,1000,1060,2060,26
GOMBA,2019,1050,1070,2120,26
GOMBA,2020,1080,1070,2150,26
GOMBA,2021,1130,1070,2200,26
GOMBA,2022,1170,1080,2250,26
GOMBA,2023,1220,1090,2310,26
GOMBA,2024,1270,1100,2370,26
GOMBA,2025,1310,1130,2440,26
GULU,2015,2150,2330,4480,26
GULU,2016,2220,2400,4620,26
GULU,2017,2290,2470,4760,26
GULU,2018,2350,2540,4890,26
GULU,2019,2420,2620,5040,26
GULU,2020,2490,2690,5180,26
GULU,2021,2560,2760,5320,26
GULU,2022,2630,2830,5460,26
GULU,2023,2700,2910,5610,26
GULU,2024,2770,2980,5750,26
GULU,2025,2840,3050,5890,26
HOIMA,2015,2310,2550,4860,26
HOIMA,2016,2400,2630,5030,26
HOIMA,2017,2490,2730,5220,26
HOIMA,2018,2580,2820,5400,26
HOIMA,2019,2680,2910,5590,26
HOIMA,2020,2770,3010,5780,26
HOIMA,2021,2870,3110,5980,26
HOIMA,2022,2970,3210,6180,26
HOIMA,2023,3070,3310,6380,26
HOIMA,2024,3170,3410,6580,26
HOIMA,2025,3280,3510,6790,26
IBANDA,2015,1670,1960,3630,26
IBANDA,2016,1710,2000,3710,26
IBANDA,2017,1740,2030,3770,26
IBANDA,2018,1770,2070,3840,26
IBANDA,2019,1810,2110,3920,26
IBANDA,2020,1840,2140,3980,26
IBANDA,2021,1870,2180,4050,26
IBANDA,2022,1900,2210,4110,26
IBANDA,2023,1930,2240,4170,26
IBANDA,2024,1960,2270,4230,26
IBANDA,2025,1990,2300,4290,26
IGANGA,2015,2140,2710,4850,26
IGANGA,2016,2230,2850,5080,26
IGANGA,2017,2320,2990,5310,26
IGANGA,2018,2430,3120,5550,26
IGANGA,2019,2560,3200,5760,26
IGANGA,2020,2690,3260,5950,26
IGANGA,2021,2840,3320,6160,26
IGANGA,2022,2990,3370,6360,26
IGANGA,2023,3150,3450,6600,26
IGANGA,2024,3320,3580,6900,26
IGANGA,2025,3490,3710,7200,26
ISINGIRO,2015,2890,3630,6520,26
ISINGIRO,2016,3000,3760,6760,26
ISINGIRO,2017,3110,3890,7000,26
ISINGIRO,2018,3220,4020,7240,26
ISINGIRO,2019,3340,4160,7500,26
ISINGIRO,2020,3460,4300,7760,26
ISINGIRO,2021,3580,4440,8020,26
ISINGIRO,2022,3710,4590,8300,26
ISINGIRO,2023,3830,4730,8560,26
ISINGIRO,2024,3960,4880,8840,26
ISINGIRO,2025,4080,5030,9110,26
JINJA,2015,3390,3700,7090,26
JINJA,2016,3450,3760,7210,26
JINJA,2017,3510,3810,7320,26
JINJA,2018,3570,3870,7440,26
JINJA,2019,3620,3930,7550,26
JINJA,2020,3680,3980,7660,26
JINJA,2021,3730,4040,7770,26
JINJA,2022,3780,4090,7870,26
JINJA,2023,3830,4140,7970,26
JINJA,2024,3880,4180,8060,26
JINJA,2025,3920,4230,8150,26
KAABONG,2015,580,970,1550,26
KAABONG,2016,600,990,1590,26
KAABONG,2017,610,1020,1630,26
KAABONG,2018,630,1040,1670,26
KAABONG,2019,640,1060,1700,26
KAABONG,2020,660,1090,1750,26
KAABONG,2021,680,1110,1790,26
KAABONG,2022,690,1140,1830,26
KAABONG,2023,710,1160,1870,26
KAABONG,2024,730,1180,1910,26
KAABONG,2025,740,1210,1950,26
KABALE,2015,1560,1830,3390,26
KABALE,2016,1580,1850,3430,26
KABALE,2017,1610,1880,3490,26
KABALE,2018,1630,1900,3530,26
KABALE,2019,1660,1920,3580,26
KABALE,2020,1680,1940,3620,26
KABALE,2021,1700,1960,3660,26
KABALE,2022,1720,1980,3700,26
KABALE,2023,1740,1990,3730,26
KABALE,2024,1760,2010,3770,26
KABALE,2025,1780,2020,3800,26
KABAROLE,2015,2320,2340,4660,26
KABAROLE,2016,2370,2390,4760,26
KABAROLE,2017,2420,2440,4860,26
KABAROLE,2018,2480,2490,4970,26
KABAROLE,2019,2530,2540,5070,26
KABAROLE,2020,2580,2590,5170,26
KABAROLE,2021,2630,2640,5270,26
KABAROLE,2022,2680,2690,5370,26
KABAROLE,2023,2730,2740,5470,26
KABAROLE,2024,2780,2790,5570,26
KABAROLE,2025,2830,2840,5670,26
KABERAMAIDO,2015,630,690,1320,26
KABERAMAIDO,2016,660,730,1390,26
KABERAMAIDO,2017,690,780,1470,26
KABERAMAIDO,2018,730,810,1540,26
KABERAMAIDO,2019,780,840,1620,26
KABERAMAIDO,2020,830,870,1700,26
KABERAMAIDO,2021,890,890,1780,26
KABERAMAIDO,2022,950,920,1870,26
KABERAMAIDO,2023,1010,950,1960,26
KABERAMAIDO,2024,1070,990,2060,26
KABERAMAIDO,2025,1140,1040,2180,26
KAGADI,2015,2280,2600,4880,26
KAGADI,2016,2360,2690,5050,26
KAGADI,2017,2450,2790,5240,26
KAGADI,2018,2540,2880,5420,26
KAGADI,2019,2630,2980,5610,26
KAGADI,2020,2730,3080,5810,26
KAGADI,2021,2820,3190,6010,26
KAGADI,2022,2920,3290,6210,26
KAGADI,2023,3010,3400,6410,26
KAGADI,2024,3110,3500,6610,26
KAGADI,2025,3210,3610,6820,26
KAKUMIRO,2015,2390,2410,4800,26
KAKUMIRO,2016,2600,2610,5210,26
KAKUMIRO,2017,2830,2830,5660,26
KAKUMIRO,2018,3080,3070,6150,26
KAKUMIRO,2019,3350,3330,6680,26
KAKUMIRO,2020,3640,3600,7240,26
KAKUMIRO,2021,3950,3900,7850,26
KAKUMIRO,2022,4290,4210,8500,26
KAKUMIRO,2023,4650,4550,9200,26
KAKUMIRO,2024,5040,4920,9960,26
KAKUMIRO,2025,5460,5310,10770,26
KALAKI,2015,520,610,1130,26
KALAKI,2016,540,630,1170,26
KALAKI,2017,560,660,1220,26
KALAKI,2018,590,680,1270,26
KALAKI,2019,610,710,1320,26
KALAKI,2020,640,730,1370,26
KALAKI,2021,660,760,1420,26
KALAKI,2022,690,790,1480,26
KALAKI,2023,720,820,1540,26
KALAKI,2024,740,850,1590,26
KALAKI,2025,770,880,1650,26
KALANGALA,2015,760,640,1400,26
KALANGALA,2016,790,670,1460,26
KALANGALA,2017,810,700,1510,26
KALANGALA,2018,840,720,1560,26
KALANGALA,2019,870,750,1620,26
KALANGALA,2020,900,780,1680,26
KALANGALA,2021,930,810,1740,26
KALANGALA,2022,960,840,1800,26
KALANGALA,2023,990,880,1870,26
KALANGALA,2024,1020,910,1930,26
KALANGALA,2025,1050,940,1990,26
KALIRO,2015,1360,1600,2960,26
KALIRO,2016,1410,1690,3100,26
KALIRO,2017,1470,1790,3260,26
KALIRO,2018,1540,1870,3410,26
KALIRO,2019,1630,1940,3570,26
KALIRO,2020,1730,1980,3710,26
KALIRO,2021,1830,2020,3850,26
KALIRO,2022,1930,2080,4010,26
KALIRO,2023,2040,2140,4180,26
KALIRO,2024,2160,2220,4380,26
KALIRO,2025,2290,2320,4610,26
KALUNGU,2015,1020,1250,2270,26
KALUNGU,2016,1050,1290,2340,26
KALUNGU,2017,1070,1330,2400,26
KALUNGU,2018,1090,1370,2460,26
KALUNGU,2019,1130,1370,2500,26
KALUNGU,2020,1170,1370,2540,26
KALUNGU,2021,1210,1370,2580,26
KALUNGU,2022,1250,1370,2620,26
KALUNGU,2023,1290,1380,2670,26
KALUNGU,2024,1320,1390,2710,26
KALUNGU,2025,1360,1420,2780,26
KAMPALA,2015,17410,20790,38200,26
KAMPALA,2016,17760,21200,38960,26
KAMPALA,2017,18110,21610,39720,26
KAMPALA,2018,18460,22020,40480,26
KAMPALA,2019,18810,22420,41230,26
KAMPALA,2020,19150,22830,41980,26
KAMPALA,2021,19480,23220,42700,26
KAMPALA,2022,19810,23610,43420,26
KAMPALA,2023,20130,23990,44120,26
KAMPALA,2024,20440,24360,44800,26
KAMPALA,2025,20730,24720,45450,26
KAMULI,2015,2610,3250,5860,26
KAMULI,2016,2700,3410,6110,26
KAMULI,2017,2790,3560,6350,26
KAMULI,2018,2910,3670,6580,26
KAMULI,2019,3050,3760,6810,26
KAMULI,2020,3200,3810,7010,26
KAMULI,2021,3360,3840,7200,26
KAMULI,2022,3500,3900,7400,26
KAMULI,2023,3670,3960,7630,26
KAMULI,2024,3840,4080,7920,26
KAMULI,2025,4020,4210,8230,26
KAMWENGE,2015,1740,2120,3860,26
KAMWENGE,2016,1810,2200,4010,26
KAMWENGE,2017,1880,2280,4160,26
KAMWENGE,2018,1960,2360,4320,26
KAMWENGE,2019,2040,2440,4480,26
KAMWENGE,2020,2120,2520,4640,26
KAMWENGE,2021,2200,2600,4800,26
KAMWENGE,2022,2280,2690,4970,26
KAMWENGE,2023,2360,2780,5140,26
KAMWENGE,2024,2450,2870,5320,26
KAMWENGE,2025,2540,2950,5490,26
KANUNGU,2015,1470,1850,3320,26
KANUNGU,2016,1500,1880,3380,26
KANUNGU,2017,1530,1910,3440,26
KANUNGU,2018,1550,1940,3490,26
KANUNGU,2019,1580,1970,3550,26
KANUNGU,2020,1610,2000,3610,26
KANUNGU,2021,1630,2030,3660,26
KANUNGU,2022,1660,2050,3710,26
KANUNGU,2023,1680,2080,3760,26
KANUNGU,2024,1700,2110,3810,26
KANUNGU,2025,1730,2130,3860,26
KAPCHORWA,2015,680,850,1530,26
KAPCHORWA,2016,700,870,1570,26
KAPCHORWA,2017,720,900,1620,26
KAPCHORWA,2018,740,920,1660,26
KAPCHORWA,2019,770,950,1720,26
KAPCHORWA,2020,790,970,1760,26
KAPCHORWA,2021,810,1000,1810,26
KAPCHORWA,2022,830,1020,1850,26
KAPCHORWA,2023,850,1050,1900,26
KAPCHORWA,2024,880,1070,1950,26
KAPCHORWA,2025,900,1100,2000,26
KAPELEBYONG,2015,440,550,990,26
KAPELEBYONG,2016,460,580,1040,26
KAPELEBYONG,2017,470,610,1080,26
KAPELEBYONG,2018,500,630,1130,26
KAPELEBYONG,2019,520,650,1170,26
KAPELEBYONG,2020,560,660,1220,26
KAPELEBYONG,2021,590,670,1260,26
KAPELEBYONG,2022,610,680,1290,26
KAPELEBYONG,2023,650,700,1350,26
KAPELEBYONG,2024,680,720,1400,26
KAPELEBYONG,2025,720,750,1470,26
KASESE,2015,4710,6010,10720,26
KASESE,2016,4850,6300,11150,26
KASESE,2017,5020,6570,11590,26
KASESE,2018,5210,6790,12000,26
KASESE,2019,5460,6930,12390,26
KASESE,2020,5720,7030,12750,26
KASESE,2021,5990,7090,13080,26
KASESE,2022,6260,7180,13440,26
KASESE,2023,6540,7300,13840,26
KASESE,2024,6830,7500,14330,26
KASESE,2025,7140,7730,14870,26
KASSANDA,2015,1870,1780,3650,26
KASSANDA,2016,1920,1820,3740,26
KASSANDA,2017,1980,1860,3840,26
KASSANDA,2018,2030,1900,3930,26
KASSANDA,2019,2090,1940,4030,26
KASSANDA,2020,2140,1980,4120,26
KASSANDA,2021,2200,2010,4210,26
KASSANDA,2022,2260,2050,4310,26
KASSANDA,2023,2310,2090,4400,26
KASSANDA,2024,2370,2130,4500,26
KASSANDA,2025,2420,2160,4580,26
KATAKWI,2015,970,1100,2070,26
KATAKWI,2016,1000,1160,2160,26
KATAKWI,2017,1030,1210,2240,26
KATAKWI,2018,1080,1260,2340,26
KATAKWI,2019,1140,1300,2440,26
KATAKWI,2020,1200,1310,2510,26
KATAKWI,2021,1270,1330,2600,26
KATAKWI,2022,1330,1340,2670,26
KATAKWI,2023,1390,1380,2770,26
KATAKWI,2024,1460,1410,2870,26
KATAKWI,2025,1540,1470,3010,26
KAYUNGA,2015,1990,2450,4440,26
KAYUNGA,2016,2030,2550,4580,26
KAYUNGA,2017,2090,2650,4740,26
KAYUNGA,2018,2170,2710,4880,26
KAYUNGA,2019,2250,2760,5010,26
KAYUNGA,2020,2350,2780,5130,26
KAYUNGA,2021,2450,2790,5240,26
KAYUNGA,2022,2540,2810,5350,26
KAYUNGA,2023,2650,2840,5490,26
KAYUNGA,2024,2760,2900,5660,26
KAYUNGA,2025,2860,2970,5830,26
KAZO,2015,1160,1250,2410,26
KAZO,2016,1210,1300,2510,26
KAZO,2017,1250,1340,2590,26
KAZO,2018,1300,1390,2690,26
KAZO,2019,1350,1440,2790,26
KAZO,2020,1390,1490,2880,26
KAZO,2021,1450,1540,2990,26
KAZO,2022,1490,1590,3080,26
KAZO,2023,1550,1640,3190,26
KAZO,2024,1600,1690,3290,26
KAZO,2025,1650,1740,3390,26
KIBAALE,2015,1090,1130,2220,26
KIBAALE,2016,1160,1200,2360,26
KIBAALE,2017,1230,1270,2500,26
KIBAALE,2018,1310,1340,2650,26
KIBAALE,2019,1400,1420,2820,26
KIBAALE,2020,1480,1490,2970,26
KIBAALE,2021,1570,1580,3150,26
KIBAALE,2022,1670,1660,3330,26
KIBAALE,2023,1770,1760,3530,26
KIBAALE,2024,1870,1850,3720,26
KIBAALE,2025,1980,1950,3930,26
KIBOGA,2015,1160,1160,2320,26
KIBOGA,2016,1190,1210,2400,26
KIBOGA,2017,1240,1270,2510,26
KIBOGA,2018,1290,1310,2600,26
KIBOGA,2019,1340,1340,2680,26
KIBOGA,2020,1420,1360,2780,26
KIBOGA,2021,1490,1380,2870,26
KIBOGA,2022,1560,1390,2950,26
KIBOGA,2023,1630,1430,3060,26
KIBOGA,2024,1700,1460,3160,26
KIBOGA,2025,1780,1510,3290,26
KIBUKU,2015,1100,1380,2480,26
KIBUKU,2016,1150,1470,2620,26
KIBUKU,2017,1200,1560,2760,26
KIBUKU,2018,1270,1630,2900,26
KIBUKU,2019,1340,1690,3030,26
KIBUKU,2020,1430,1740,3170,26
KIBUKU,2021,1510,1790,3300,26
KIBUKU,2022,1610,1830,3440,26
KIBUKU,2023,1700,1890,3590,26
KIBUKU,2024,1800,1960,3760,26
KIBUKU,2025,1910,2060,3970,26
KIKUUBE,2015,1950,2060,4010,26
KIKUUBE,2016,2060,2170,4230,26
KIKUUBE,2017,2170,2280,4450,26
KIKUUBE,2018,2280,2400,4680,26
KIKUUBE,2019,2400,2510,4910,26
KIKUUBE,2020,2530,2640,5170,26
KIKUUBE,2021,2650,2770,5420,26
KIKUUBE,2022,2790,2900,5690,26
KIKUUBE,2023,2930,3040,5970,26
KIKUUBE,2024,3070,3180,6250,26
KIKUUBE,2025,3220,3330,6550,26
KIRUHURA,2015,1230,1220,2450,26
KIRUHURA,2016,1280,1270,2550,26
KIRUHURA,2017,1320,1310,2630,26
KIRUHURA,2018,1380,1360,2740,26
KIRUHURA,2019,1430,1400,2830,26
KIRUHURA,2020,1480,1450,2930,26
KIRUHURA,2021,1530,1500,3030,26
KIRUHURA,2022,1590,1550,3140,26
KIRUHURA,2023,1640,1600,3240,26
KIRUHURA,2024,1690,1650,3340,26
KIRUHURA,2025,1750,1700,3450,26
KIRYANDONGO,2015,1870,2030,3900,26
KIRYANDONGO,2016,1930,2140,4070,26
KIRYANDONGO,2017,2000,2250,4250,26
KIRYANDONGO,2018,2100,2330,4430,26
KIRYANDONGO,2019,2210,2390,4600,26
KIRYANDONGO,2020,2320,2440,4760,26
KIRYANDONGO,2021,2450,2480,4930,26
KIRYANDONGO,2022,2580,2520,5100,26
KIRYANDONGO,2023,2700,2570,5270,26
KIRYANDONGO,2024,2850,2650,5500,26
KIRYANDONGO,2025,2990,2750,5740,26
KISORO,2015,1400,2250,3650,26
KISORO,2016,1430,2350,3780,26
KISORO,2017,1470,2450,3920,26
KISORO,2018,1530,2520,4050,26
KISORO,2019,1580,2570,4150,26
KISORO,2020,1660,2600,4260,26
KISORO,2021,1730,2620,4350,26
KISORO,2022,1800,2640,4440,26
KISORO,2023,1870,2680,4550,26
KISORO,2024,1950,2750,4700,26
KISORO,2025,2020,2830,4850,26
KITAGWENDA,2015,860,1140,2000,26
KITAGWENDA,2016,900,1180,2080,26
KITAGWENDA,2017,930,1220,2150,26
KITAGWENDA,2018,970,1270,2240,26
KITAGWENDA,2019,1010,1310,2320,26
KITAGWENDA,2020,1050,1350,2400,26
KITAGWENDA,2021,1090,1400,2490,26
KITAGWENDA,2022,1130,1450,2580,26
KITAGWENDA,2023,1170,1490,2660,26
KITAGWENDA,2024,1210,1540,2750,26
KITAGWENDA,2025,1250,1590,2840,26
KITGUM,2015,1180,1490,2670,26
KITGUM,2016,1210,1560,2770,26
KITGUM,2017,1240,1610,2850,26
KITGUM,2018,1280,1660,2940,26
KITGUM,2019,1330,1690,3020,26
KITGUM,2020,1380,1700,3080,26
KITGUM,2021,1430,1710,3140,26
KITGUM,2022,1480,1700,3180,26
KITGUM,2023,1540,1730,3270,26
KITGUM,2024,1590,1760,3350,26
KITGUM,2025,1660,1810,3470,26
KOBOKO,2015,1440,1580,3020,26
KOBOKO,2016,1510,1690,3200,26
KOBOKO,2017,1570,1790,3360,26
KOBOKO,2018,1660,1880,3540,26
KOBOKO,2019,1770,1950,3720,26
KOBOKO,2020,1880,2010,3890,26
KOBOKO,2021,2000,2060,4060,26
KOBOKO,2022,2120,2110,4230,26
KOBOKO,2023,2260,2180,4440,26
KOBOKO,2024,2390,2280,4670,26
KOBOKO,2025,2540,2380,4920,26
KOLE,2015,1490,1610,3100,26
KOLE,2016,1540,1660,3200,26
KOLE,2017,1590,1710,3300,26
KOLE,2018,1640,1750,3390,26
KOLE,2019,1690,1800,3490,26
KOLE,2020,1740,1850,3590,26
KOLE,2021,1800,1900,3700,26
KOLE,2022,1850,1950,3800,26
KOLE,2023,1900,2000,3900,26
KOLE,2024,1960,2050,4010,26
KOLE,2025,2010,2100,4110,26
KOTIDO,2015,1340,1670,3010,26
KOTIDO,2016,1390,1750,3140,26
KOTIDO,2017,1440,1830,3270,26
KOTIDO,2018,1490,1890,3380,26
KOTIDO,2019,1560,1930,3490,26
KOTIDO,2020,1630,1960,3590,26
KOTIDO,2021,1710,1970,3680,26
KOTIDO,2022,1800,1990,3790,26
KOTIDO,2023,1870,2030,3900,26
KOTIDO,2024,1960,2090,4050,26
KOTIDO,2025,2050,2140,4190,26
KUMI,2015,1330,1700,3030,26
KUMI,2016,1380,1800,3180,26
KUMI,2017,1440,1880,3320,26
KUMI,2018,1510,1960,3470,26
KUMI,2019,1590,2010,3600,26
KUMI,2020,1680,2050,3730,26
KUMI,2021,1770,2090,3860,26
KUMI,2022,1870,2120,3990,26
KUMI,2023,1960,2180,4140,26
KUMI,2024,2080,2260,4340,26
KUMI,2025,2180,2330,4510,26
KWANIA,2015,1090,1210,2300,26
KWANIA,2016,1130,1250,2380,26
KWANIA,2017,1160,1280,2440,26
KWANIA,2018,1200,1320,2520,26
KWANIA,2019,1230,1360,2590,26
KWANIA,2020,1270,1390,2660,26
KWANIA,2021,1300,1430,2730,26
KWANIA,2022,1340,1470,2810,26
KWANIA,2023,1380,1500,2880,26
KWANIA,2024,1410,1540,2950,26
KWANIA,2025,1450,1580,3030,26
KWEEN,2015,660,670,1330,26
KWEEN,2016,680,690,1370,26
KWEEN,2017,700,710,1410,26
KWEEN,2018,720,730,1450,26
KWEEN,2019,740,740,1480,26
KWEEN,2020,770,760,1530,26
KWEEN,2021,790,780,1570,26
KWEEN,2022,810,800,1610,26
KWEEN,2023,830,810,1640,26
KWEEN,2024,850,830,1680,26
KWEEN,2025,880,850,1730,26
KYANKWANZI,2015,1610,1640,3250,26
KYANKWANZI,2016,1700,1720,3420,26
KYANKWANZI,2017,1780,1800,3580,26
KYANKWANZI,2018,1880,1880,3760,26
KYANKWANZI,2019,1970,1970,3940,26
KYANKWANZI,2020,2070,2060,4130,26
KYANKWANZI,2021,2170,2150,4320,26
KYANKWANZI,2022,2270,2240,4510,26
KYANKWANZI,2023,2380,2340,4720,26
KYANKWANZI,2024,2490,2440,4930,26
KYANKWANZI,2025,2610,2540,5150,26
KYEGEGWA,2015,2000,2240,4240,26
KYEGEGWA,2016,2160,2420,4580,26
KYEGEGWA,2017,2340,2610,4950,26
KYEGEGWA,2018,2530,2810,5340,26
KYEGEGWA,2019,2730,3030,5760,26
KYEGEGWA,2020,2950,3270,6220,26
KYEGEGWA,2021,3190,3520,6710,26
KYEGEGWA,2022,3440,3790,7230,26
KYEGEGWA,2023,3710,4070,7780,26
KYEGEGWA,2024,4000,4380,8380,26
KYEGEGWA,2025,4300,4700,9000,26
KYENJOJO,2015,2980,3090,6070,26
KYENJOJO,2016,3110,3200,6310,26
KYENJOJO,2017,3230,3320,6550,26
KYENJOJO,2018,3370,3440,6810,26
KYENJOJO,2019,3500,3570,7070,26
KYENJOJO,2020,3640,3690,7330,26
KYENJOJO,2021,3780,3820,7600,26
KYENJOJO,2022,3920,3950,7870,26
KYENJOJO,2023,4070,4080,8150,26
KYENJOJO,2024,4220,4220,8440,26
KYENJOJO,2025,4360,4350,8710,26
KYOTERA,2015,1490,1800,3290,26
KYOTERA,2016,1520,1870,3390,26
KYOTERA,2017,1560,1930,3490,26
KYOTERA,2018,1610,1970,3580,26
KYOTERA,2019,1660,2010,3670,26
KYOTERA,2020,1740,2020,3760,26
KYOTERA,2021,1810,2010,3820,26
KYOTERA,2022,1870,2020,3890,26
KYOTERA,2023,1940,2040,3980,26
KYOTERA,2024,2010,2080,4090,26
KYOTERA,2025,2090,2130,4220,26
KARENGA,2015,400,390,790,26
KARENGA,2016,410,400,810,26
KARENGA,2017,420,410,830,26
KARENGA,2018,430,420,850,26
KARENGA,2019,440,430,870,26
KARENGA,2020,460,440,900,26
KARENGA,2021,460,450,910,26
KARENGA,2022,480,460,940,26
KARENGA,2023,490,470,960,26
KARENGA,2024,500,480,980,26
KARENGA,2025,510,490,1000,26
LAMWO,2015,780,950,1730,26
LAMWO,2016,790,990,1780,26
LAMWO,2017,810,1030,1840,26
LAMWO,2018,830,1060,1890,26
LAMWO,2019,850,1070,1920,26
LAMWO,2020,880,1070,1950,26
LAMWO,2021,920,1070,1990,26
LAMWO,2022,940,1080,2020,26
LAMWO,2023,970,1090,2060,26
LAMWO,2024,990,1110,2100,26
LAMWO,2025,1020,1140,2160,26
LIRA,2015,2940,3590,6530,26
LIRA,2016,3020,3690,6710,26
LIRA,2017,3110,3800,6910,26
LIRA,2018,3190,3900,7090,26
LIRA,2019,3280,4010,7290,26
LIRA,2020,3370,4120,7490,26
LIRA,2021,3450,4230,7680,26
LIRA,2022,3540,4340,7880,26
LIRA,2023,3630,4450,8080,26
LIRA,2024,3710,4560,8270,26
LIRA,2025,3800,4660,8460,26
LUUKA,2015,1180,1570,2750,26
LUUKA,2016,1210,1650,2860,26
LUUKA,2017,1250,1720,2970,26
LUUKA,2018,1290,1770,3060,26
LUUKA,2019,1340,1810,3150,26
LUUKA,2020,1410,1820,3230,26
LUUKA,2021,1460,1830,3290,26
LUUKA,2022,1520,1860,3380,26
LUUKA,2023,1580,1880,3460,26
LUUKA,2024,1650,1930,3580,26
LUUKA,2025,1710,1980,3690,26
LUWERO,2015,2970,3570,6540,26
LUWERO,2016,3060,3740,6800,26
LUWERO,2017,3160,3920,7080,26
LUWERO,2018,3280,4040,7320,26
LUWERO,2019,3440,4130,7570,26
LUWERO,2020,3610,4190,7800,26
LUWERO,2021,3780,4230,8010,26
LUWERO,2022,3970,4280,8250,26
LUWERO,2023,4150,4360,8510,26
LUWERO,2024,4340,4480,8820,26
LUWERO,2025,4530,4620,9150,26
LWENGO,2015,1460,1900,3360,26
LWENGO,2016,1470,1960,3430,26
LWENGO,2017,1510,2020,3530,26
LWENGO,2018,1540,2060,3600,26
LWENGO,2019,1590,2080,3670,26
LWENGO,2020,1650,2080,3730,26
LWENGO,2021,1700,2070,3770,26
LWENGO,2022,1750,2080,3830,26
LWENGO,2023,1800,2090,3890,26
LWENGO,2024,1850,2100,3950,26
LWENGO,2025,1910,2140,4050,26
LYANTONDE,2015,680,730,1410,26
LYANTONDE,2016,700,770,1470,26
LYANTONDE,2017,720,810,1530,26
LYANTONDE,2018,750,850,1600,26
LYANTONDE,2019,780,900,1680,26
LYANTONDE,2020,810,930,1740,26
LYANTONDE,2021,850,960,1810,26
LYANTONDE,2022,900,970,1870,26
LYANTONDE,2023,950,990,1940,26
LYANTONDE,2024,990,1000,1990,26
LYANTONDE,2025,1040,1030,2070,26
MANAFWA,2015,820,1010,1830,26
MANAFWA,2016,840,1030,1870,26
MANAFWA,2017,860,1060,1920,26
MANAFWA,2018,880,1080,1960,26
MANAFWA,2019,900,1100,2000,26
MANAFWA,2020,920,1130,2050,26
MANAFWA,2021,950,1150,2100,26
MANAFWA,2022,970,1170,2140,26
MANAFWA,2023,990,1190,2180,26
MANAFWA,2024,1010,1220,2230,26
MANAFWA,2025,1030,1240,2270,26
MARACHA,2015,960,1160,2120,26
MARACHA,2016,980,1180,2160,26
MARACHA,2017,1000,1210,2210,26
MARACHA,2018,1020,1230,2250,26
MARACHA,2019,1040,1250,2290,26
MARACHA,2020,1060,1280,2340,26
MARACHA,2021,1080,1300,2380,26
MARACHA,2022,1100,1320,2420,26
MARACHA,2023,1120,1340,2460,26
MARACHA,2024,1140,1360,2500,26
MARACHA,2025,1160,1380,2540,26
MASAKA,2015,2260,2680,4940,26
MASAKA,2016,2310,2810,5120,26
MASAKA,2017,2380,2930,5310,26
MASAKA,2018,2470,3020,5490,26
MASAKA,2019,2580,3080,5660,26
MASAKA,2020,2710,3120,5830,26
MASAKA,2021,2830,3140,5970,26
MASAKA,2022,2940,3180,6120,26
MASAKA,2023,3070,3220,6290,26
MASAKA,2024,3210,3310,6520,26
MASAKA,2025,3340,3410,6750,26
MASINDI,2015,2430,2330,4760,26
MASINDI,2016,2500,2390,4890,26
MASINDI,2017,2570,2450,5020,26
MASINDI,2018,2650,2520,5170,26
MASINDI,2019,2720,2580,5300,26
MASINDI,2020,2800,2650,5450,26
MASINDI,2021,2870,2710,5580,26
MASINDI,2022,2950,2780,5730,26
MASINDI,2023,3020,2840,5860,26
MASINDI,2024,3100,2910,6010,26
MASINDI,2025,3170,2970,6140,26
MAYUGE,2015,2860,3830,6690,26
MAYUGE,2016,2970,4060,7030,26
MAYUGE,2017,3080,4260,7340,26
MAYUGE,2018,3230,4440,7670,26
MAYUGE,2019,3400,4570,7970,26
MAYUGE,2020,3590,4680,8270,26
MAYUGE,2021,3780,4750,8530,26
MAYUGE,2022,3980,4850,8830,26
MAYUGE,2023,4180,4980,9160,26
MAYUGE,2024,4410,5150,9560,26
MAYUGE,2025,4640,5360,10000,26
MBALE,2015,3540,4590,8130,26
MBALE,2016,3670,4870,8540,26
MBALE,2017,3820,5140,8960,26
MBALE,2018,3990,5360,9350,26
MBALE,2019,4200,5530,9730,26
MBALE,2020,4440,5670,10110,26
MBALE,2021,4670,5780,10450,26
MBALE,2022,4910,5910,10820,26
MBALE,2023,5150,6080,11230,26
MBALE,2024,5420,6310,11730,26
MBALE,2025,5690,6590,12280,26
MBARARA,2015,2900,3480,6380,26
MBARARA,2016,2970,3560,6530,26
MBARARA,2017,3040,3630,6670,26
MBARARA,2018,3110,3710,6820,26
MBARARA,2019,3170,3790,6960,26
MBARARA,2020,3240,3860,7100,26
MBARARA,2021,3310,3940,7250,26
MBARARA,2022,3370,4010,7380,26
MBARARA,2023,3440,4090,7530,26
MBARARA,2024,3500,4150,7650,26
MBARARA,2025,3570,4220,7790,26
MITOOMA,2015,900,1310,2210,26
MITOOMA,2016,910,1320,2230,26
MITOOMA,2017,920,1330,2250,26
MITOOMA,2018,930,1350,2280,26
MITOOMA,2019,940,1360,2300,26
MITOOMA,2020,950,1370,2320,26
MITOOMA,2021,960,1380,2340,26
MITOOMA,2022,970,1390,2360,26
MITOOMA,2023,970,1400,2370,26
MITOOMA,2024,980,1400,2380,26
MITOOMA,2025,990,1410,2400,26
MITYANA,2015,2290,2470,4760,26
MITYANA,2016,2340,2580,4920,26
MITYANA,2017,2410,2670,5080,26
MITYANA,2018,2490,2750,5240,26
MITYANA,2019,2580,2780,5360,26
MITYANA,2020,2690,2810,5500,26
MITYANA,2021,2790,2820,5610,26
MITYANA,2022,2910,2830,5740,26
MITYANA,2023,3020,2860,5880,26
MITYANA,2024,3130,2920,6050,26
MITYANA,2025,3260,3000,6260,26
MOROTO,2015,730,780,1510,26
MOROTO,2016,760,810,1570,26
MOROTO,2017,780,850,1630,26
MOROTO,2018,810,880,1690,26
MOROTO,2019,840,900,1740,26
MOROTO,2020,880,910,1790,26
MOROTO,2021,920,920,1840,26
MOROTO,2022,960,940,1900,26
MOROTO,2023,990,960,1950,26
MOROTO,2024,1040,980,2020,26
MOROTO,2025,1080,1020,2100,26
MOYO,2015,530,660,1190,26
MOYO,2016,540,680,1220,26
MOYO,2017,560,690,1250,26
MOYO,2018,570,710,1280,26
MOYO,2019,580,720,1300,26
MOYO,2020,600,740,1340,26
MOYO,2021,610,750,1360,26
MOYO,2022,620,770,1390,26
MOYO,2023,640,780,1420,26
MOYO,2024,650,790,1440,26
MOYO,2025,660,810,1470,26
MPIGI,2015,1720,1940,3660,26
MPIGI,2016,1770,2040,3810,26
MPIGI,2017,1830,2130,3960,26
MPIGI,2018,1900,2200,4100,26
MPIGI,2019,1990,2250,4240,26
MPIGI,2020,2090,2280,4370,26
MPIGI,2021,2180,2300,4480,26
MPIGI,2022,2280,2330,4610,26
MPIGI,2023,2390,2380,4770,26
MPIGI,2024,2490,2440,4930,26
MPIGI,2025,2590,2520,5110,26
MUBENDE,2015,3510,3640,7150,26
MUBENDE,2016,3720,3930,7650,26
MUBENDE,2017,3950,4210,8160,26
MUBENDE,2018,4220,4480,8700,26
MUBENDE,2019,4540,4710,9250,26
MUBENDE,2020,4890,4900,9790,26
MUBENDE,2021,5260,5090,10350,26
MUBENDE,2022,5650,5300,10950,26
MUBENDE,2023,6070,5550,11620,26
MUBENDE,2024,6530,5860,12390,26
MUBENDE,2025,7000,6210,13210,26
MUKONO,2015,4530,5740,10270,26
MUKONO,2016,4680,6050,10730,26
MUKONO,2017,4850,6360,11210,26
MUKONO,2018,5050,6620,11670,26
MUKONO,2019,5290,6800,12090,26
MUKONO,2020,5570,6940,12510,26
MUKONO,2021,5860,7060,12920,26
MUKONO,2022,6130,7190,13320,26
MUKONO,2023,6430,7370,13800,26
MUKONO,2024,6740,7620,14360,26
MUKONO,2025,7060,7920,14980,26
MADI OKOLLO,2015,860,960,1820,26
MADI OKOLLO,2016,890,990,1880,26
MADI OKOLLO,2017,920,1010,1930,26
MADI OKOLLO,2018,940,1050,1990,26
MADI OKOLLO,2019,970,1070,2040,26
MADI OKOLLO,2020,1000,1100,2100,26
MADI OKOLLO,2021,1020,1130,2150,26
MADI OKOLLO,2022,1050,1160,2210,26
MADI OKOLLO,2023,1080,1180,2260,26
MADI OKOLLO,2024,1100,1210,2310,26
MADI OKOLLO,2025,1130,1240,2370,26
NABILATUK,2015,410,570,980,26
NABILATUK,2016,420,610,1030,26
NABILATUK,2017,450,650,1100,26
NABILATUK,2018,490,690,1180,26
NABILATUK,2019,520,710,1230,26
NABILATUK,2020,560,740,1300,26
NABILATUK,2021,600,770,1370,26
NABILATUK,2022,650,800,1450,26
NABILATUK,2023,690,820,1510,26
NABILATUK,2024,740,860,1600,26
NABILATUK,2025,790,910,1700,26
NAKAPIRIPIRIT,2015,610,810,1420,26
NAKAPIRIPIRIT,2016,650,860,1510,26
NAKAPIRIPIRIT,2017,670,920,1590,26
NAKAPIRIPIRIT,2018,720,960,1680,26
NAKAPIRIPIRIT,2019,770,1010,1780,26
NAKAPIRIPIRIT,2020,820,1040,1860,26
NAKAPIRIPIRIT,2021,880,1070,1950,26
NAKAPIRIPIRIT,2022,940,1110,2050,26
NAKAPIRIPIRIT,2023,990,1160,2150,26
NAKAPIRIPIRIT,2024,1060,1220,2280,26
NAKAPIRIPIRIT,2025,1120,1280,2400,26
NAKASEKE,2015,1670,1220,2890,26
NAKASEKE,2016,1730,1240,2970,26
NAKASEKE,2017,1790,1270,3060,26
NAKASEKE,2018,1860,1310,3170,26
NAKASEKE,2019,1930,1330,3260,26
NAKASEKE,2020,1990,1360,3350,26
NAKASEKE,2021,2060,1400,3460,26
NAKASEKE,2022,2130,1430,3560,26
NAKASEKE,2023,2200,1450,3650,26
NAKASEKE,2024,2270,1480,3750,26
NAKASEKE,2025,2340,1510,3850,26
NAKASONGOLA,2015,1420,1310,2730,26
NAKASONGOLA,2016,1470,1380,2850,26
NAKASONGOLA,2017,1530,1450,2980,26
NAKASONGOLA,2018,1610,1500,3110,26
NAKASONGOLA,2019,1690,1550,3240,26
NAKASONGOLA,2020,1790,1570,3360,26
NAKASONGOLA,2021,1880,1590,3470,26
NAKASONGOLA,2022,1980,1610,3590,26
NAKASONGOLA,2023,2090,1660,3750,26
NAKASONGOLA,2024,2190,1710,3900,26
NAKASONGOLA,2025,2310,1770,4080,26
NAMAYINGO,2015,1380,1730,3110,26
NAMAYINGO,2016,1420,1810,3230,26
NAMAYINGO,2017,1450,1870,3320,26
NAMAYINGO,2018,1510,1910,3420,26
NAMAYINGO,2019,1560,1940,3500,26
NAMAYINGO,2020,1630,1960,3590,26
NAMAYINGO,2021,1700,1960,3660,26
NAMAYINGO,2022,1770,1970,3740,26
NAMAYINGO,2023,1840,1990,3830,26
NAMAYINGO,2024,1910,2020,3930,26
NAMAYINGO,2025,1980,2070,4050,26
NAMISINDWA,2015,1120,1410,2530,26
NAMISINDWA,2016,1150,1450,2600,26
NAMISINDWA,2017,1190,1480,2670,26
NAMISINDWA,2018,1220,1520,2740,26
NAMISINDWA,2019,1250,1550,2800,26
NAMISINDWA,2020,1280,1590,2870,26
NAMISINDWA,2021,1320,1620,2940,26
NAMISINDWA,2022,1350,1650,3000,26
NAMISINDWA,2023,1380,1690,3070,26
NAMISINDWA,2024,1420,1720,3140,26
NAMISINDWA,2025,1450,1750,3200,26
NAMUTUMBA,2015,1370,1790,3160,26
NAMUTUMBA,2016,1420,1890,3310,26
NAMUTUMBA,2017,1480,1990,3470,26
NAMUTUMBA,2018,1560,2080,3640,26
NAMUTUMBA,2019,1650,2140,3790,26
NAMUTUMBA,2020,1750,2200,3950,26
NAMUTUMBA,2021,1850,2240,4090,26
NAMUTUMBA,2022,1960,2280,4240,26
NAMUTUMBA,2023,2070,2350,4420,26
NAMUTUMBA,2024,2180,2440,4620,26
NAMUTUMBA,2025,2300,2550,4850,26
NAPAK,2015,790,1110,1900,26
NAPAK,2016,800,1160,1960,26
NAPAK,2017,830,1210,2040,26
NAPAK,2018,860,1250,2110,26
NAPAK,2019,880,1270,2150,26
NAPAK,2020,920,1290,2210,26
NAPAK,2021,950,1300,2250,26
NAPAK,2022,990,1310,2300,26
NAPAK,2023,1030,1330,2360,26
NAPAK,2024,1070,1370,2440,26
NAPAK,2025,1110,1410,2520,26
NEBBI,2015,1240,1530,2770,26
NEBBI,2016,1280,1570,2850,26
NEBBI,2017,1330,1610,2940,26
NEBBI,2018,1370,1660,3030,26
NEBBI,2019,1410,1710,3120,26
NEBBI,2020,1450,1750,3200,26
NEBBI,2021,1490,1800,3290,26
NEBBI,2022,1540,1840,3380,26
NEBBI,2023,1580,1890,3470,26
NEBBI,2024,1620,1940,3560,26
NEBBI,2025,1670,1980,3650,26
NGORA,2015,730,980,1710,26
NGORA,2016,760,1030,1790,26
NGORA,2017,790,1080,1870,26
NGORA,2018,820,1120,1940,26
NGORA,2019,860,1140,2000,26
NGORA,2020,910,1170,2080,26
NGORA,2021,950,1180,2130,26
NGORA,2022,1000,1190,2190,26
NGORA,2023,1050,1230,2280,26
NGORA,2024,1110,1260,2370,26
NGORA,2025,1160,1300,2460,26
NTOROKO,2015,510,520,1030,26
NTOROKO,2016,540,540,1080,26
NTOROKO,2017,550,560,1110,26
NTOROKO,2018,570,580,1150,26
NTOROKO,2019,590,580,1170,26
NTOROKO,2020,620,590,1210,26
NTOROKO,2021,660,600,1260,26
NTOROKO,2022,690,600,1290,26
NTOROKO,2023,710,610,1320,26
NTOROKO,2024,740,620,1360,26
NTOROKO,2025,790,640,1430,26
NTUNGAMO,2015,2850,3400,6250,26
NTUNGAMO,2016,2910,3460,6370,26
NTUNGAMO,2017,2980,3520,6500,26
NTUNGAMO,2018,3040,3590,6630,26
NTUNGAMO,2019,3100,3650,6750,26
NTUNGAMO,2020,3160,3710,6870,26
NTUNGAMO,2021,3220,3770,6990,26
NTUNGAMO,2022,3280,3830,7110,26
NTUNGAMO,2023,3340,3890,7230,26
NTUNGAMO,2024,3400,3950,7350,26
NTUNGAMO,2025,3450,4000,7450,26
NWOYA,2015,790,810,1600,26
NWOYA,2016,880,890,1770,26
NWOYA,2017,970,980,1950,26
NWOYA,2018,1070,1080,2150,26
NWOYA,2019,1180,1190,2370,26
NWOYA,2020,1300,1310,2610,26
NWOYA,2021,1430,1440,2870,26
NWOYA,2022,1580,1580,3160,26
NWOYA,2023,1740,1740,3480,26
NWOYA,2024,1910,1910,3820,26
NWOYA,2025,2100,2090,4190,26
OBONGI,2015,300,340,640,26
OBONGI,2016,310,360,670,26
OBONGI,2017,330,380,710,26
OBONGI,2018,340,380,720,26
OBONGI,2019,350,390,740,26
OBONGI,2020,370,390,760,26
OBONGI,2021,390,400,790,26
OBONGI,2022,410,410,820,26
OBONGI,2023,420,410,830,26
OBONGI,2024,440,420,860,26
OBONGI,2025,470,440,910,26
OMORO,2015,1010,1180,2190,26
OMORO,2016,1050,1240,2290,26
OMORO,2017,1100,1320,2420,26
OMORO,2018,1150,1380,2530,26
OMORO,2019,1220,1430,2650,26
OMORO,2020,1300,1460,2760,26
OMORO,2021,1370,1500,2870,26
OMORO,2022,1450,1530,2980,26
OMORO,2023,1530,1580,3110,26
OMORO,2024,1620,1640,3260,26
OMORO,2025,1710,1710,3420,26
OTUKE,2015,510,710,1220,26
OTUKE,2016,540,740,1280,26
OTUKE,2017,560,770,1330,26
OTUKE,2018,590,800,1390,26
OTUKE,2019,610,830,1440,26
OTUKE,2020,640,870,1510,26
OTUKE,2021,670,900,1570,26
OTUKE,2022,690,940,1630,26
OTUKE,2023,720,980,1700,26
OTUKE,2024,750,1020,1770,26
OTUKE,2025,780,1050,1830,26
OYAM,2015,2440,2880,5320,26
OYAM,2016,2520,2970,5490,26
OYAM,2017,2590,3060,5650,26
OYAM,2018,2670,3140,5810,26
OYAM,2019,2750,3230,5980,26
OYAM,2020,2830,3320,6150,26
OYAM,2021,2910,3410,6320,26
OYAM,2022,2990,3500,6490,26
OYAM,2023,3070,3590,6660,26
OYAM,2024,3150,3680,6830,26
OYAM,2025,3230,3780,7010,26
PADER,2015,1010,1220,2230,26
PADER,2016,1040,1280,2320,26
PADER,2017,1060,1330,2390,26
PADER,2018,1090,1370,2460,26
PADER,2019,1140,1390,2530,26
PADER,2020,1180,1410,2590,26
PADER,2021,1230,1410,2640,26
PADER,2022,1270,1430,2700,26
PADER,2023,1330,1450,2780,26
PADER,2024,1370,1480,2850,26
PADER,2025,1420,1520,2940,26
PAKWACH,2015,880,1050,1930,26
PAKWACH,2016,920,1080,2000,26
PAKWACH,2017,960,1120,2080,26
PAKWACH,2018,1000,1160,2160,26
PAKWACH,2019,1040,1200,2240,26
PAKWACH,2020,1080,1250,2330,26
PAKWACH,2021,1130,1290,2420,26
PAKWACH,2022,1170,1330,2500,26
PAKWACH,2023,1210,1380,2590,26
PAKWACH,2024,1260,1420,2680,26
PAKWACH,2025,1310,1470,2780,26
PALLISA,2015,1500,1910,3410,26
PALLISA,2016,1570,2040,3610,26
PALLISA,2017,1660,2180,3840,26
PALLISA,2018,1760,2280,4040,26
PALLISA,2019,1870,2390,4260,26
PALLISA,2020,2000,2470,4470,26
PALLISA,2021,2150,2550,4700,26
PALLISA,2022,2280,2620,4900,26
PALLISA,2023,2440,2720,5160,26
PALLISA,2024,2600,2860,5460,26
PALLISA,2025,2770,3010,5780,26
RAKAI,2015,1590,1940,3530,26
RAKAI,2016,1640,2040,3680,26
RAKAI,2017,1700,2130,3830,26
RAKAI,2018,1770,2200,3970,26
RAKAI,2019,1850,2250,4100,26
RAKAI,2020,1940,2280,4220,26
RAKAI,2021,2030,2300,4330,26
RAKAI,2022,2120,2330,4450,26
RAKAI,2023,2220,2360,4580,26
RAKAI,2024,2330,2430,4760,26
RAKAI,2025,2430,2510,4940,26
RUBANDA,2015,1180,1510,2690,26
RUBANDA,2016,1190,1520,2710,26
RUBANDA,2017,1210,1530,2740,26
RUBANDA,2018,1220,1540,2760,26
RUBANDA,2019,1240,1560,2800,26
RUBANDA,2020,1250,1570,2820,26
RUBANDA,2021,1270,1580,2850,26
RUBANDA,2022,1280,1580,2860,26
RUBANDA,2023,1290,1590,2880,26
RUBANDA,2024,1300,1600,2900,26
RUBANDA,2025,1320,1600,2920,26
RUBIRIZI,2015,700,970,1670,26
RUBIRIZI,2016,710,990,1700,26
RUBIRIZI,2017,730,1010,1740,26
RUBIRIZI,2018,740,1030,1770,26
RUBIRIZI,2019,760,1040,1800,26
RUBIRIZI,2020,770,1060,1830,26
RUBIRIZI,2021,790,1080,1870,26
RUBIRIZI,2022,800,1100,1900,26
RUBIRIZI,2023,810,1120,1930,26
RUBIRIZI,2024,830,1130,1960,26
RUBIRIZI,2025,840,1150,1990,26
RUKIGA,2015,660,700,1360,26
RUKIGA,2016,670,710,1380,26
RUKIGA,2017,670,710,1380,26
RUKIGA,2018,680,710,1390,26
RUKIGA,2019,690,720,1410,26
RUKIGA,2020,690,720,1410,26
RUKIGA,2021,700,730,1430,26
RUKIGA,2022,700,730,1430,26
RUKIGA,2023,710,730,1440,26
RUKIGA,2024,710,740,1450,26
RUKIGA,2025,720,740,1460,26
RUKUNGIRI,2015,1730,2170,3900,26
RUKUNGIRI,2016,1760,2200,3960,26
RUKUNGIRI,2017,1780,2220,4000,26
RUKUNGIRI,2018,1800,2240,4040,26
RUKUNGIRI,2019,1820,2260,4080,26
RUKUNGIRI,2020,1840,2280,4120,26
RUKUNGIRI,2021,1860,2290,4150,26
RUKUNGIRI,2022,1870,2310,4180,26
RUKUNGIRI,2023,1890,2330,4220,26
RUKUNGIRI,2024,1900,2340,4240,26
RUKUNGIRI,2025,1920,2350,4270,26
RWAMPARA,2015,820,910,1730,26
RWAMPARA,2016,840,930,1770,26
RWAMPARA,2017,860,950,1810,26
RWAMPARA,2018,880,970,1850,26
RWAMPARA,2019,900,990,1890,26
RWAMPARA,2020,920,1010,1930,26
RWAMPARA,2021,930,1030,1960,26
RWAMPARA,2022,950,1050,2000,26
RWAMPARA,2023,970,1070,2040,26
RWAMPARA,2024,990,1100,2090,26
RWAMPARA,2025,1010,1110,2120,26
SERERE,2015,1740,1970,3710,26
SERERE,2016,1820,2100,3920,26
SERERE,2017,1910,2220,4130,26
SERERE,2018,2020,2330,4350,26
SERERE,2019,2150,2430,4580,26
SERERE,2020,2290,2500,4790,26
SERERE,2021,2440,2560,5000,26
SERERE,2022,2590,2630,5220,26
SERERE,2023,2750,2730,5480,26
SERERE,2024,2930,2850,5780,26
SERERE,2025,3100,2990,6090,26
SHEEMA,2015,1340,1550,2890,26
SHEEMA,2016,1350,1570,2920,26
SHEEMA,2017,1370,1580,2950,26
SHEEMA,2018,1390,1600,2990,26
SHEEMA,2019,1400,1620,3020,26
SHEEMA,2020,1420,1630,3050,26
SHEEMA,2021,1430,1640,3070,26
SHEEMA,2022,1440,1660,3100,26
SHEEMA,2023,1460,1670,3130,26
SHEEMA,2024,1470,1680,3150,26
SHEEMA,2025,1480,1690,3170,26
SIRONKO,2015,1360,1520,2880,26
SIRONKO,2016,1390,1550,2940,26
SIRONKO,2017,1420,1580,3000,26
SIRONKO,2018,1460,1610,3070,26
SIRONKO,2019,1490,1640,3130,26
SIRONKO,2020,1520,1670,3190,26
SIRONKO,2021,1560,1710,3270,26
SIRONKO,2022,1590,1740,3330,26
SIRONKO,2023,1620,1770,3390,26
SIRONKO,2024,1650,1790,3440,26
SIRONKO,2025,1680,1820,3500,26
SOROTI,2015,1920,2390,4310,26
SOROTI,2016,2000,2550,4550,26
SOROTI,2017,2090,2690,4780,26
SOROTI,2018,2200,2810,5010,26
SOROTI,2019,2330,2900,5230,26
SOROTI,2020,2470,2990,5460,26
SOROTI,2021,2610,3050,5660,26
SOROTI,2022,2770,3120,5890,26
SOROTI,2023,2920,3220,6140,26
SOROTI,2024,3100,3340,6440,26
SOROTI,2025,3260,3500,6760,26
SSEMBABULE,2015,1580,1800,3380,26
SSEMBABULE,2016,1630,1900,3530,26
SSEMBABULE,2017,1700,1990,3690,26
SSEMBABULE,2018,1770,2060,3830,26
SSEMBABULE,2019,1860,2120,3980,26
SSEMBABULE,2020,1960,2150,4110,26
SSEMBABULE,2021,2060,2180,4240,26
SSEMBABULE,2022,2160,2210,4370,26
SSEMBABULE,2023,2270,2270,4540,26
SSEMBABULE,2024,2380,2340,4720,26
SSEMBABULE,2025,2500,2430,4930,26
TORORO,2015,2590,3230,5820,26
TORORO,2016,2660,3320,5980,26
TORORO,2017,2730,3400,6130,26
TORORO,2018,2800,3480,6280,26
TORORO,2019,2870,3570,6440,26
TORORO,2020,2940,3650,6590,26
TORORO,2021,3010,3730,6740,26
TORORO,2022,3090,3820,6910,26
TORORO,2023,3160,3900,7060,26
TORORO,2024,3230,3980,7210,26
TORORO,2025,3290,4060,7350,26
WAKISO,2015,18180,24430,42610,26
WAKISO,2016,19390,26100,45490,26
WAKISO,2017,20690,27890,48580,26
WAKISO,2018,22060,29780,51840,26
WAKISO,2019,23530,31780,55310,26
WAKISO,2020,25070,33890,58960,26
WAKISO,2021,26680,36140,62820,26
WAKISO,2022,28390,38520,66910,26
WAKISO,2023,30190,41000,71190,26
WAKISO,2024,32070,43610,75680,26
WAKISO,2025,34040,46390,80430,26
YUMBE,2015,2360,3410,5770,26
YUMBE,2016,2490,3710,6200,26
YUMBE,2017,2640,4010,6650,26
YUMBE,2018,2820,4300,7120,26
YUMBE,2019,3030,4550,7580,26
YUMBE,2020,3250,4780,8030,26
YUMBE,2021,3500,5000,8500,26
YUMBE,2022,3750,5240,8990,26
YUMBE,2023,4020,5530,9550,26
YUMBE,2024,4320,5880,10200,26
YUMBE,2025,4630,6280,10910,26
ZOMBO,2015,1090,1380,2470,26
ZOMBO,2016,1120,1420,2540,26
ZOMBO,2017,1160,1460,2620,26
ZOMBO,2018,1190,1500,2690,26
ZOMBO,2019,1230,1540,2770,26
ZOMBO,2020,1260,1580,2840,26
ZOMBO,2021,1300,1620,2920,26
ZOMBO,2022,1340,1670,3010,26
ZOMBO,2023,1370,1710,3080,26
ZOMBO,2024,1410,1750,3160,26
ZOMBO,2025,1440,1790,3230,26
ABIM,2015,640,690,1330,27
ABIM,2016,690,750,1440,27
ABIM,2017,730,810,1540,27
ABIM,2018,780,890,1670,27
ABIM,2019,850,940,1790,27
ABIM,2020,920,1000,1920,27
ABIM,2021,1010,1050,2060,27
ABIM,2022,1090,1110,2200,27
ABIM,2023,1180,1160,2340,27
ABIM,2024,1280,1230,2510,27
ABIM,2025,1390,1310,2700,27
ADJUMANI,2015,1240,1670,2910,27
ADJUMANI,2016,1250,1690,2940,27
ADJUMANI,2017,1260,1700,2960,27
ADJUMANI,2018,1270,1720,2990,27
ADJUMANI,2019,1280,1740,3020,27
ADJUMANI,2020,1280,1750,3030,27
ADJUMANI,2021,1290,1760,3050,27
ADJUMANI,2022,1290,1780,3070,27
ADJUMANI,2023,1300,1790,3090,27
ADJUMANI,2024,1300,1800,3100,27
ADJUMANI,2025,1310,1810,3120,27
AGAGO,2015,1120,1390,2510,27
AGAGO,2016,1140,1410,2550,27
AGAGO,2017,1160,1430,2590,27
AGAGO,2018,1180,1460,2640,27
AGAGO,2019,1200,1480,2680,27
AGAGO,2020,1220,1510,2730,27
AGAGO,2021,1230,1530,2760,27
AGAGO,2022,1250,1550,2800,27
AGAGO,2023,1270,1580,2850,27
AGAGO,2024,1290,1600,2890,27
AGAGO,2025,1300,1620,2920,27
ALEBTONG,2015,1120,1500,2620,27
ALEBTONG,2016,1160,1590,2750,27
ALEBTONG,2017,1190,1670,2860,27
ALEBTONG,2018,1250,1750,3000,27
ALEBTONG,2019,1300,1810,3110,27
ALEBTONG,2020,1350,1870,3220,27
ALEBTONG,2021,1430,1890,3320,27
ALEBTONG,2022,1500,1920,3420,27
ALEBTONG,2023,1570,1950,3520,27
ALEBTONG,2024,1650,1990,3640,27
ALEBTONG,2025,1730,2060,3790,27
AMOLATAR,2015,960,1110,2070,27
AMOLATAR,2016,990,1170,2160,27
AMOLATAR,2017,1030,1230,2260,27
AMOLATAR,2018,1060,1280,2340,27
AMOLATAR,2019,1100,1330,2430,27
AMOLATAR,2020,1160,1350,2510,27
AMOLATAR,2021,1210,1380,2590,27
AMOLATAR,2022,1270,1400,2670,27
AMOLATAR,2023,1340,1410,2750,27
AMOLATAR,2024,1390,1450,2840,27
AMOLATAR,2025,1460,1480,2940,27
AMUDAT,2015,610,690,1300,27
AMUDAT,2016,640,740,1380,27
AMUDAT,2017,670,790,1460,27
AMUDAT,2018,700,840,1540,27
AMUDAT,2019,740,890,1630,27
AMUDAT,2020,780,930,1710,27
AMUDAT,2021,830,960,1790,27
AMUDAT,2022,880,1000,1880,27
AMUDAT,2023,940,1040,1980,27
AMUDAT,2024,990,1080,2070,27
AMUDAT,2025,1040,1130,2170,27
AMURIA,2015,870,1120,1990,27
AMURIA,2016,910,1190,2100,27
AMURIA,2017,950,1260,2210,27
AMURIA,2018,990,1340,2330,27
AMURIA,2019,1050,1400,2450,27
AMURIA,2020,1100,1450,2550,27
AMURIA,2021,1180,1480,2660,27
AMURIA,2022,1250,1510,2760,27
AMURIA,2023,1310,1550,2860,27
AMURIA,2024,1390,1590,2980,27
AMURIA,2025,1470,1650,3120,27
AMURU,2015,900,1100,2000,27
AMURU,2016,930,1160,2090,27
AMURU,2017,960,1220,2180,27
AMURU,2018,990,1270,2260,27
AMURU,2019,1030,1320,2350,27
AMURU,2020,1080,1350,2430,27
AMURU,2021,1130,1380,2510,27
AMURU,2022,1190,1400,2590,27
AMURU,2023,1240,1410,2650,27
AMURU,2024,1310,1450,2760,27
AMURU,2025,1360,1490,2850,27
APAC,2015,1160,1330,2490,27
APAC,2016,1200,1370,2570,27
APAC,2017,1240,1420,2660,27
APAC,2018,1290,1470,2760,27
APAC,2019,1330,1520,2850,27
APAC,2020,1380,1570,2950,27
APAC,2021,1430,1620,3050,27
APAC,2022,1480,1670,3150,27
APAC,2023,1530,1730,3260,27
APAC,2024,1580,1780,3360,27
APAC,2025,1630,1830,3460,27
ARUA,2015,4030,4800,8830,27
ARUA,2016,4150,4930,9080,27
ARUA,2017,4270,5070,9340,27
ARUA,2018,4390,5200,9590,27
ARUA,2019,4520,5340,9860,27
ARUA,2020,4640,5480,10120,27
ARUA,2021,4760,5610,10370,27
ARUA,2022,4890,5750,10640,27
ARUA,2023,5010,5890,10900,27
ARUA,2024,5130,6030,11160,27
ARUA,2025,5250,6160,11410,27
BUDAKA,2015,990,1390,2380,27
BUDAKA,2016,1030,1460,2490,27
BUDAKA,2017,1080,1550,2630,27
BUDAKA,2018,1120,1640,2760,27
BUDAKA,2019,1180,1710,2890,27
BUDAKA,2020,1250,1760,3010,27
BUDAKA,2021,1320,1810,3130,27
BUDAKA,2022,1400,1850,3250,27
BUDAKA,2023,1480,1890,3370,27
BUDAKA,2024,1560,1950,3510,27
BUDAKA,2025,1650,2020,3670,27
BUDUDA,2015,1140,1190,2330,27
BUDUDA,2016,1200,1280,2480,27
BUDUDA,2017,1260,1370,2630,27
BUDUDA,2018,1330,1460,2790,27
BUDUDA,2019,1410,1540,2950,27
BUDUDA,2020,1500,1610,3110,27
BUDUDA,2021,1610,1670,3280,27
BUDUDA,2022,1720,1720,3440,27
BUDUDA,2023,1830,1780,3610,27
BUDUDA,2024,1950,1840,3790,27
BUDUDA,2025,2080,1940,4020,27
BUGIRI,2015,1910,2620,4530,27
BUGIRI,2016,2000,2780,4780,27
BUGIRI,2017,2090,2970,5060,27
BUGIRI,2018,2200,3150,5350,27
BUGIRI,2019,2320,3300,5620,27
BUGIRI,2020,2470,3430,5900,27
BUGIRI,2021,2630,3530,6160,27
BUGIRI,2022,2800,3620,6420,27
BUGIRI,2023,2960,3720,6680,27
BUGIRI,2024,3150,3850,7000,27
BUGIRI,2025,3340,4020,7360,27
BUGWERI,2015,740,1000,1740,27
BUGWERI,2016,760,1060,1820,27
BUGWERI,2017,800,1110,1910,27
BUGWERI,2018,820,1160,1980,27
BUGWERI,2019,860,1200,2060,27
BUGWERI,2020,900,1220,2120,27
BUGWERI,2021,940,1250,2190,27
BUGWERI,2022,990,1260,2250,27
BUGWERI,2023,1030,1290,2320,27
BUGWERI,2024,1080,1310,2390,27
BUGWERI,2025,1130,1360,2490,27
BUHWEJU,2015,780,870,1650,27
BUHWEJU,2016,810,900,1710,27
BUHWEJU,2017,830,920,1750,27
BUHWEJU,2018,860,950,1810,27
BUHWEJU,2019,890,980,1870,27
BUHWEJU,2020,920,1010,1930,27
BUHWEJU,2021,940,1040,1980,27
BUHWEJU,2022,970,1070,2040,27
BUHWEJU,2023,1000,1100,2100,27
BUHWEJU,2024,1030,1120,2150,27
BUHWEJU,2025,1060,1150,2210,27
BUIKWE,2015,2960,3410,6370,27
BUIKWE,2016,3030,3570,6600,27
BUIKWE,2017,3110,3730,6840,27
BUIKWE,2018,3200,3890,7090,27
BUIKWE,2019,3310,4000,7310,27
BUIKWE,2020,3440,4080,7520,27
BUIKWE,2021,3590,4130,7720,27
BUIKWE,2022,3750,4150,7900,27
BUIKWE,2023,3900,4190,8090,27
BUIKWE,2024,4050,4260,8310,27
BUIKWE,2025,4210,4370,8580,27
BUKEDEA,2015,1060,1360,2420,27
BUKEDEA,2016,1100,1450,2550,27
BUKEDEA,2017,1160,1550,2710,27
BUKEDEA,2018,1220,1650,2870,27
BUKEDEA,2019,1300,1740,3040,27
BUKEDEA,2020,1390,1800,3190,27
BUKEDEA,2021,1480,1850,3330,27
BUKEDEA,2022,1580,1900,3480,27
BUKEDEA,2023,1670,1970,3640,27
BUKEDEA,2024,1790,2040,3830,27
BUKEDEA,2025,1900,2130,4030,27
BUKOMANSIMBI,2015,740,900,1640,27
BUKOMANSIMBI,2016,750,920,1670,27
BUKOMANSIMBI,2017,750,960,1710,27
BUKOMANSIMBI,2018,770,980,1750,27
BUKOMANSIMBI,2019,790,990,1780,27
BUKOMANSIMBI,2020,810,1000,1810,27
BUKOMANSIMBI,2021,840,1000,1840,27
BUKOMANSIMBI,2022,860,990,1850,27
BUKOMANSIMBI,2023,890,980,1870,27
BUKOMANSIMBI,2024,910,980,1890,27
BUKOMANSIMBI,2025,930,990,1920,27
BUKWO,2015,600,610,1210,27
BUKWO,2016,630,640,1270,27
BUKWO,2017,660,670,1330,27
BUKWO,2018,700,700,1400,27
BUKWO,2019,730,740,1470,27
BUKWO,2020,770,770,1540,27
BUKWO,2021,810,810,1620,27
BUKWO,2022,850,840,1690,27
BUKWO,2023,890,880,1770,27
BUKWO,2024,940,920,1860,27
BUKWO,2025,980,960,1940,27
BULAMBULI,2015,950,1090,2040,27
BULAMBULI,2016,1000,1170,2170,27
BULAMBULI,2017,1060,1260,2320,27
BULAMBULI,2018,1120,1350,2470,27
BULAMBULI,2019,1200,1430,2630,27
BULAMBULI,2020,1280,1490,2770,27
BULAMBULI,2021,1380,1550,2930,27
BULAMBULI,2022,1470,1620,3090,27
BULAMBULI,2023,1570,1670,3240,27
BULAMBULI,2024,1680,1750,3430,27
BULAMBULI,2025,1810,1840,3650,27
BULIISA,2015,1050,850,1900,27
BULIISA,2016,1100,890,1990,27
BULIISA,2017,1160,920,2080,27
BULIISA,2018,1230,970,2200,27
BULIISA,2019,1290,1010,2300,27
BULIISA,2020,1360,1050,2410,27
BULIISA,2021,1430,1090,2520,27
BULIISA,2022,1500,1140,2640,27
BULIISA,2023,1580,1190,2770,27
BULIISA,2024,1660,1240,2900,27
BULIISA,2025,1740,1280,3020,27
BUNDIBUGYO,2015,1460,1770,3230,27
BUNDIBUGYO,2016,1520,1870,3390,27
BUNDIBUGYO,2017,1570,1960,3530,27
BUNDIBUGYO,2018,1640,2060,3700,27
BUNDIBUGYO,2019,1700,2130,3830,27
BUNDIBUGYO,2020,1790,2190,3980,27
BUNDIBUGYO,2021,1890,2240,4130,27
BUNDIBUGYO,2022,1980,2260,4240,27
BUNDIBUGYO,2023,2080,2300,4380,27
BUNDIBUGYO,2024,2190,2360,4550,27
BUNDIBUGYO,2025,2300,2420,4720,27
BUNYANGABU,2015,1200,1350,2550,27
BUNYANGABU,2016,1240,1420,2660,27
BUNYANGABU,2017,1280,1490,2770,27
BUNYANGABU,2018,1330,1550,2880,27
BUNYANGABU,2019,1380,1600,2980,27
BUNYANGABU,2020,1440,1630,3070,27
BUNYANGABU,2021,1510,1660,3170,27
BUNYANGABU,2022,1580,1670,3250,27
BUNYANGABU,2023,1650,1700,3350,27
BUNYANGABU,2024,1740,1720,3460,27
BUNYANGABU,2025,1820,1770,3590,27
BUSHENYI,2015,1610,1720,3330,27
BUSHENYI,2016,1630,1740,3370,27
BUSHENYI,2017,1650,1750,3400,27
BUSHENYI,2018,1670,1770,3440,27
BUSHENYI,2019,1690,1780,3470,27
BUSHENYI,2020,1710,1800,3510,27
BUSHENYI,2021,1720,1810,3530,27
BUSHENYI,2022,1740,1820,3560,27
BUSHENYI,2023,1760,1830,3590,27
BUSHENYI,2024,1770,1840,3610,27
BUSHENYI,2025,1780,1850,3630,27
BUSIA,2015,1890,2470,4360,27
BUSIA,2016,1960,2610,4570,27
BUSIA,2017,2030,2760,4790,27
BUSIA,2018,2110,2890,5000,27
BUSIA,2019,2220,3010,5230,27
BUSIA,2020,2330,3090,5420,27
BUSIA,2021,2450,3150,5600,27
BUSIA,2022,2590,3200,5790,27
BUSIA,2023,2720,3260,5980,27
BUSIA,2024,2860,3330,6190,27
BUSIA,2025,3010,3450,6460,27
BUTALEJA,2015,1190,1630,2820,27
BUTALEJA,2016,1250,1740,2990,27
BUTALEJA,2017,1300,1840,3140,27
BUTALEJA,2018,1360,1950,3310,27
BUTALEJA,2019,1430,2040,3470,27
BUTALEJA,2020,1520,2110,3630,27
BUTALEJA,2021,1610,2170,3780,27
BUTALEJA,2022,1710,2210,3920,27
BUTALEJA,2023,1800,2270,4070,27
BUTALEJA,2024,1920,2330,4250,27
BUTALEJA,2025,2030,2420,4450,27
BUTAMBALA,2015,560,660,1220,27
BUTAMBALA,2016,570,680,1250,27
BUTAMBALA,2017,590,710,1300,27
BUTAMBALA,2018,590,730,1320,27
BUTAMBALA,2019,610,750,1360,27
BUTAMBALA,2020,630,750,1380,27
BUTAMBALA,2021,660,750,1410,27
BUTAMBALA,2022,680,750,1430,27
BUTAMBALA,2023,700,750,1450,27
BUTAMBALA,2024,720,750,1470,27
BUTAMBALA,2025,750,760,1510,27
BUTEBO,2015,520,680,1200,27
BUTEBO,2016,530,700,1230,27
BUTEBO,2017,540,730,1270,27
BUTEBO,2018,550,750,1300,27
BUTEBO,2019,570,770,1340,27
BUTEBO,2020,590,780,1370,27
BUTEBO,2021,620,790,1410,27
BUTEBO,2022,630,780,1410,27
BUTEBO,2023,660,790,1450,27
BUTEBO,2024,680,800,1480,27
BUTEBO,2025,700,800,1500,27
BUVUMA,2015,980,870,1850,27
BUVUMA,2016,1040,930,1970,27
BUVUMA,2017,1110,1000,2110,27
BUVUMA,2018,1180,1060,2240,27
BUVUMA,2019,1250,1140,2390,27
BUVUMA,2020,1320,1210,2530,27
BUVUMA,2021,1400,1290,2690,27
BUVUMA,2022,1480,1370,2850,27
BUVUMA,2023,1570,1460,3030,27
BUVUMA,2024,1660,1550,3210,27
BUVUMA,2025,1750,1650,3400,27
BUYENDE,2015,1760,2160,3920,27
BUYENDE,2016,1850,2310,4160,27
BUYENDE,2017,1950,2470,4420,27
BUYENDE,2018,2050,2630,4680,27
BUYENDE,2019,2170,2760,4930,27
BUYENDE,2020,2320,2880,5200,27
BUYENDE,2021,2480,2990,5470,27
BUYENDE,2022,2650,3070,5720,27
BUYENDE,2023,2810,3180,5990,27
BUYENDE,2024,3000,3290,6290,27
BUYENDE,2025,3190,3450,6640,27
DOKOLO,2015,1080,1330,2410,27
DOKOLO,2016,1110,1360,2470,27
DOKOLO,2017,1150,1400,2550,27
DOKOLO,2018,1180,1440,2620,27
DOKOLO,2019,1220,1480,2700,27
DOKOLO,2020,1250,1520,2770,27
DOKOLO,2021,1290,1550,2840,27
DOKOLO,2022,1320,1590,2910,27
DOKOLO,2023,1360,1630,2990,27
DOKOLO,2024,1390,1670,3060,27
DOKOLO,2025,1430,1710,3140,27
GOMBA,2015,1050,1060,2110,27
GOMBA,2016,1070,1100,2170,27
GOMBA,2017,1100,1140,2240,27
GOMBA,2018,1130,1180,2310,27
GOMBA,2019,1160,1200,2360,27
GOMBA,2020,1200,1210,2410,27
GOMBA,2021,1250,1220,2470,27
GOMBA,2022,1310,1220,2530,27
GOMBA,2023,1350,1220,2570,27
GOMBA,2024,1400,1230,2630,27
GOMBA,2025,1460,1250,2710,27
GULU,2015,2000,2130,4130,27
GULU,2016,2060,2200,4260,27
GULU,2017,2120,2260,4380,27
GULU,2018,2190,2320,4510,27
GULU,2019,2250,2390,4640,27
GULU,2020,2310,2460,4770,27
GULU,2021,2380,2520,4900,27
GULU,2022,2440,2590,5030,27
GULU,2023,2510,2660,5170,27
GULU,2024,2570,2720,5290,27
GULU,2025,2640,2790,5430,27
HOIMA,2015,2450,2620,5070,27
HOIMA,2016,2540,2710,5250,27
HOIMA,2017,2640,2810,5450,27
HOIMA,2018,2740,2900,5640,27
HOIMA,2019,2840,3000,5840,27
HOIMA,2020,2940,3100,6040,27
HOIMA,2021,3040,3200,6240,27
HOIMA,2022,3150,3300,6450,27
HOIMA,2023,3260,3410,6670,27
HOIMA,2024,3360,3510,6870,27
HOIMA,2025,3470,3620,7090,27
IBANDA,2015,1670,1720,3390,27
IBANDA,2016,1710,1750,3460,27
IBANDA,2017,1740,1780,3520,27
IBANDA,2018,1770,1810,3580,27
IBANDA,2019,1810,1850,3660,27
IBANDA,2020,1840,1880,3720,27
IBANDA,2021,1870,1910,3780,27
IBANDA,2022,1900,1940,3840,27
IBANDA,2023,1930,1960,3890,27
IBANDA,2024,1960,1990,3950,27
IBANDA,2025,1990,2020,4010,27
IGANGA,2015,2010,2500,4510,27
IGANGA,2016,2090,2630,4720,27
IGANGA,2017,2170,2780,4950,27
IGANGA,2018,2260,2920,5180,27
IGANGA,2019,2370,3030,5400,27
IGANGA,2020,2480,3110,5590,27
IGANGA,2021,2620,3180,5800,27
IGANGA,2022,2760,3220,5980,27
IGANGA,2023,2900,3280,6180,27
IGANGA,2024,3060,3370,6430,27
IGANGA,2025,3220,3480,6700,27
ISINGIRO,2015,2710,3480,6190,27
ISINGIRO,2016,2810,3610,6420,27
ISINGIRO,2017,2910,3740,6650,27
ISINGIRO,2018,3020,3870,6890,27
ISINGIRO,2019,3130,4000,7130,27
ISINGIRO,2020,3240,4130,7370,27
ISINGIRO,2021,3360,4270,7630,27
ISINGIRO,2022,3470,4410,7880,27
ISINGIRO,2023,3590,4550,8140,27
ISINGIRO,2024,3710,4690,8400,27
ISINGIRO,2025,3830,4830,8660,27
JINJA,2015,3540,3580,7120,27
JINJA,2016,3600,3630,7230,27
JINJA,2017,3660,3690,7350,27
JINJA,2018,3720,3750,7470,27
JINJA,2019,3770,3800,7570,27
JINJA,2020,3830,3850,7680,27
JINJA,2021,3890,3900,7790,27
JINJA,2022,3940,3950,7890,27
JINJA,2023,3990,4000,7990,27
JINJA,2024,4040,4050,8090,27
JINJA,2025,4090,4090,8180,27
KAABONG,2015,610,860,1470,27
KAABONG,2016,630,880,1510,27
KAABONG,2017,650,910,1560,27
KAABONG,2018,660,930,1590,27
KAABONG,2019,680,950,1630,27
KAABONG,2020,690,970,1660,27
KAABONG,2021,720,990,1710,27
KAABONG,2022,730,1010,1740,27
KAABONG,2023,750,1030,1780,27
KAABONG,2024,760,1050,1810,27
KAABONG,2025,780,1070,1850,27
KABALE,2015,1590,1870,3460,27
KABALE,2016,1620,1900,3520,27
KABALE,2017,1640,1920,3560,27
KABALE,2018,1670,1940,3610,27
KABALE,2019,1690,1960,3650,27
KABALE,2020,1720,1980,3700,27
KABALE,2021,1740,2000,3740,27
KABALE,2022,1760,2020,3780,27
KABALE,2023,1780,2040,3820,27
KABALE,2024,1800,2060,3860,27
KABALE,2025,1820,2070,3890,27
KABAROLE,2015,2400,2340,4740,27
KABAROLE,2016,2450,2390,4840,27
KABAROLE,2017,2500,2450,4950,27
KABAROLE,2018,2560,2500,5060,27
KABAROLE,2019,2610,2550,5160,27
KABAROLE,2020,2660,2600,5260,27
KABAROLE,2021,2720,2650,5370,27
KABAROLE,2022,2770,2700,5470,27
KABAROLE,2023,2820,2750,5570,27
KABAROLE,2024,2870,2800,5670,27
KABAROLE,2025,2920,2850,5770,27
KABERAMAIDO,2015,640,730,1370,27
KABERAMAIDO,2016,670,770,1440,27
KABERAMAIDO,2017,700,820,1520,27
KABERAMAIDO,2018,740,880,1620,27
KABERAMAIDO,2019,780,920,1700,27
KABERAMAIDO,2020,830,960,1790,27
KABERAMAIDO,2021,880,980,1860,27
KABERAMAIDO,2022,950,1010,1960,27
KABERAMAIDO,2023,1010,1040,2050,27
KABERAMAIDO,2024,1070,1080,2150,27
KABERAMAIDO,2025,1140,1130,2270,27
KAGADI,2015,2150,2420,4570,27
KAGADI,2016,2230,2500,4730,27
KAGADI,2017,2310,2590,4900,27
KAGADI,2018,2400,2680,5080,27
KAGADI,2019,2480,2780,5260,27
KAGADI,2020,2570,2870,5440,27
KAGADI,2021,2660,2970,5630,27
KAGADI,2022,2750,3060,5810,27
KAGADI,2023,2840,3160,6000,27
KAGADI,2024,2930,3260,6190,27
KAGADI,2025,3030,3360,6390,27
KAKUMIRO,2015,2390,2380,4770,27
KAKUMIRO,2016,2610,2580,5190,27
KAKUMIRO,2017,2840,2800,5640,27
KAKUMIRO,2018,3090,3030,6120,27
KAKUMIRO,2019,3360,3280,6640,27
KAKUMIRO,2020,3650,3550,7200,27
KAKUMIRO,2021,3960,3840,7800,27
KAKUMIRO,2022,4300,4160,8460,27
KAKUMIRO,2023,4660,4490,9150,27
KAKUMIRO,2024,5060,4850,9910,27
KAKUMIRO,2025,5470,5230,10700,27
KALAKI,2015,560,720,1280,27
KALAKI,2016,580,750,1330,27
KALAKI,2017,610,780,1390,27
KALAKI,2018,630,810,1440,27
KALAKI,2019,660,840,1500,27
KALAKI,2020,690,870,1560,27
KALAKI,2021,710,900,1610,27
KALAKI,2022,740,940,1680,27
KALAKI,2023,770,970,1740,27
KALAKI,2024,800,1010,1810,27
KALAKI,2025,830,1040,1870,27
KALANGALA,2015,870,650,1520,27
KALANGALA,2016,900,680,1580,27
KALANGALA,2017,930,700,1630,27
KALANGALA,2018,960,730,1690,27
KALANGALA,2019,990,760,1750,27
KALANGALA,2020,1030,790,1820,27
KALANGALA,2021,1060,820,1880,27
KALANGALA,2022,1100,850,1950,27
KALANGALA,2023,1130,890,2020,27
KALANGALA,2024,1170,920,2090,27
KALANGALA,2025,1200,950,2150,27
KALIRO,2015,1220,1510,2730,27
KALIRO,2016,1270,1610,2880,27
KALIRO,2017,1330,1700,3030,27
KALIRO,2018,1380,1800,3180,27
KALIRO,2019,1460,1880,3340,27
KALIRO,2020,1540,1940,3480,27
KALIRO,2021,1620,1990,3610,27
KALIRO,2022,1720,2030,3750,27
KALIRO,2023,1820,2080,3900,27
KALIRO,2024,1920,2150,4070,27
KALIRO,2025,2030,2230,4260,27
KALUNGU,2015,1030,1130,2160,27
KALUNGU,2016,1050,1170,2220,27
KALUNGU,2017,1070,1210,2280,27
KALUNGU,2018,1090,1250,2340,27
KALUNGU,2019,1110,1270,2380,27
KALUNGU,2020,1150,1280,2430,27
KALUNGU,2021,1190,1290,2480,27
KALUNGU,2022,1230,1280,2510,27
KALUNGU,2023,1260,1280,2540,27
KALUNGU,2024,1310,1290,2600,27
KALUNGU,2025,1350,1300,2650,27
KAMPALA,2015,18180,20520,38700,27
KAMPALA,2016,18540,20920,39460,27
KAMPALA,2017,18910,21330,40240,27
KAMPALA,2018,19270,21730,41000,27
KAMPALA,2019,19640,22130,41770,27
KAMPALA,2020,19990,22530,42520,27
KAMPALA,2021,20340,22920,43260,27
KAMPALA,2022,20690,23300,43990,27
KAMPALA,2023,21020,23680,44700,27
KAMPALA,2024,21340,24040,45380,27
KAMPALA,2025,21650,24390,46040,27
KAMULI,2015,2590,3040,5630,27
KAMULI,2016,2680,3190,5870,27
KAMULI,2017,2760,3340,6100,27
KAMULI,2018,2860,3490,6350,27
KAMULI,2019,2980,3600,6580,27
KAMULI,2020,3110,3690,6800,27
KAMULI,2021,3270,3730,7000,27
KAMULI,2022,3430,3770,7200,27
KAMULI,2023,3580,3810,7390,27
KAMULI,2024,3750,3880,7630,27
KAMULI,2025,3930,3990,7920,27
KAMWENGE,2015,1920,2140,4060,27
KAMWENGE,2016,2000,2210,4210,27
KAMWENGE,2017,2080,2290,4370,27
KAMWENGE,2018,2160,2370,4530,27
KAMWENGE,2019,2250,2460,4710,27
KAMWENGE,2020,2330,2540,4870,27
KAMWENGE,2021,2430,2620,5050,27
KAMWENGE,2022,2520,2710,5230,27
KAMWENGE,2023,2610,2800,5410,27
KAMWENGE,2024,2700,2890,5590,27
KAMWENGE,2025,2800,2970,5770,27
KANUNGU,2015,1570,1840,3410,27
KANUNGU,2016,1600,1870,3470,27
KANUNGU,2017,1630,1900,3530,27
KANUNGU,2018,1650,1930,3580,27
KANUNGU,2019,1680,1960,3640,27
KANUNGU,2020,1710,1990,3700,27
KANUNGU,2021,1740,2020,3760,27
KANUNGU,2022,1760,2040,3800,27
KANUNGU,2023,1790,2070,3860,27
KANUNGU,2024,1810,2100,3910,27
KANUNGU,2025,1840,2120,3960,27
KAPCHORWA,2015,620,700,1320,27
KAPCHORWA,2016,640,720,1360,27
KAPCHORWA,2017,660,740,1400,27
KAPCHORWA,2018,680,760,1440,27
KAPCHORWA,2019,700,780,1480,27
KAPCHORWA,2020,720,800,1520,27
KAPCHORWA,2021,740,820,1560,27
KAPCHORWA,2022,760,840,1600,27
KAPCHORWA,2023,780,870,1650,27
KAPCHORWA,2024,800,890,1690,27
KAPCHORWA,2025,820,900,1720,27
KAPELEBYONG,2015,390,490,880,27
KAPELEBYONG,2016,420,530,950,27
KAPELEBYONG,2017,430,550,980,27
KAPELEBYONG,2018,440,580,1020,27
KAPELEBYONG,2019,470,610,1080,27
KAPELEBYONG,2020,490,620,1110,27
KAPELEBYONG,2021,520,630,1150,27
KAPELEBYONG,2022,550,640,1190,27
KAPELEBYONG,2023,570,650,1220,27
KAPELEBYONG,2024,610,660,1270,27
KAPELEBYONG,2025,640,690,1330,27
KASESE,2015,4630,5660,10290,27
KASESE,2016,4770,5930,10700,27
KASESE,2017,4910,6220,11130,27
KASESE,2018,5080,6490,11570,27
KASESE,2019,5280,6690,11970,27
KASESE,2020,5510,6830,12340,27
KASESE,2021,5780,6930,12710,27
KASESE,2022,6050,6980,13030,27
KASESE,2023,6310,7070,13380,27
KASESE,2024,6600,7190,13790,27
KASESE,2025,6900,7390,14290,27
KASSANDA,2015,1910,1840,3750,27
KASSANDA,2016,1970,1890,3860,27
KASSANDA,2017,2030,1930,3960,27
KASSANDA,2018,2080,1970,4050,27
KASSANDA,2019,2140,2010,4150,27
KASSANDA,2020,2200,2050,4250,27
KASSANDA,2021,2260,2090,4350,27
KASSANDA,2022,2310,2130,4440,27
KASSANDA,2023,2370,2160,4530,27
KASSANDA,2024,2430,2200,4630,27
KASSANDA,2025,2480,2240,4720,27
KATAKWI,2015,1000,1100,2100,27
KATAKWI,2016,1030,1140,2170,27
KATAKWI,2017,1070,1210,2280,27
KATAKWI,2018,1110,1270,2380,27
KATAKWI,2019,1170,1310,2480,27
KATAKWI,2020,1220,1340,2560,27
KATAKWI,2021,1290,1370,2660,27
KATAKWI,2022,1350,1380,2730,27
KATAKWI,2023,1420,1400,2820,27
KATAKWI,2024,1490,1430,2920,27
KATAKWI,2025,1570,1470,3040,27
KAYUNGA,2015,1940,2370,4310,27
KAYUNGA,2016,1990,2470,4460,27
KAYUNGA,2017,2040,2570,4610,27
KAYUNGA,2018,2090,2660,4750,27
KAYUNGA,2019,2160,2740,4900,27
KAYUNGA,2020,2250,2790,5040,27
KAYUNGA,2021,2350,2800,5150,27
KAYUNGA,2022,2450,2810,5260,27
KAYUNGA,2023,2540,2840,5380,27
KAYUNGA,2024,2650,2870,5520,27
KAYUNGA,2025,2750,2920,5670,27
KAZO,2015,1170,1300,2470,27
KAZO,2016,1210,1340,2550,27
KAZO,2017,1260,1390,2650,27
KAZO,2018,1300,1440,2740,27
KAZO,2019,1350,1490,2840,27
KAZO,2020,1400,1540,2940,27
KAZO,2021,1450,1590,3040,27
KAZO,2022,1500,1640,3140,27
KAZO,2023,1550,1690,3240,27
KAZO,2024,1600,1750,3350,27
KAZO,2025,1660,1800,3460,27
KIBAALE,2015,1030,1010,2040,27
KIBAALE,2016,1090,1070,2160,27
KIBAALE,2017,1160,1130,2290,27
KIBAALE,2018,1240,1200,2440,27
KIBAALE,2019,1310,1270,2580,27
KIBAALE,2020,1390,1340,2730,27
KIBAALE,2021,1480,1410,2890,27
KIBAALE,2022,1570,1490,3060,27
KIBAALE,2023,1660,1570,3230,27
KIBAALE,2024,1760,1660,3420,27
KIBAALE,2025,1860,1740,3600,27
KIBOGA,2015,1070,1090,2160,27
KIBOGA,2016,1100,1130,2230,27
KIBOGA,2017,1140,1190,2330,27
KIBOGA,2018,1180,1250,2430,27
KIBOGA,2019,1230,1280,2510,27
KIBOGA,2020,1290,1320,2610,27
KIBOGA,2021,1360,1330,2690,27
KIBOGA,2022,1420,1350,2770,27
KIBOGA,2023,1490,1370,2860,27
KIBOGA,2024,1550,1390,2940,27
KIBOGA,2025,1620,1440,3060,27
KIBUKU,2015,1000,1240,2240,27
KIBUKU,2016,1040,1310,2350,27
KIBUKU,2017,1090,1390,2480,27
KIBUKU,2018,1140,1480,2620,27
KIBUKU,2019,1200,1540,2740,27
KIBUKU,2020,1270,1600,2870,27
KIBUKU,2021,1360,1650,3010,27
KIBUKU,2022,1430,1690,3120,27
KIBUKU,2023,1520,1730,3250,27
KIBUKU,2024,1610,1790,3400,27
KIBUKU,2025,1710,1860,3570,27
KIKUUBE,2015,1990,1990,3980,27
KIKUUBE,2016,2100,2090,4190,27
KIKUUBE,2017,2210,2190,4400,27
KIKUUBE,2018,2330,2300,4630,27
KIKUUBE,2019,2450,2420,4870,27
KIKUUBE,2020,2580,2540,5120,27
KIKUUBE,2021,2710,2660,5370,27
KIKUUBE,2022,2850,2790,5640,27
KIKUUBE,2023,2990,2920,5910,27
KIKUUBE,2024,3140,3060,6200,27
KIKUUBE,2025,3290,3200,6490,27
KIRUHURA,2015,1340,1200,2540,27
KIRUHURA,2016,1390,1240,2630,27
KIRUHURA,2017,1450,1290,2740,27
KIRUHURA,2018,1500,1330,2830,27
KIRUHURA,2019,1560,1380,2940,27
KIRUHURA,2020,1620,1420,3040,27
KIRUHURA,2021,1670,1470,3140,27
KIRUHURA,2022,1730,1520,3250,27
KIRUHURA,2023,1790,1570,3360,27
KIRUHURA,2024,1850,1620,3470,27
KIRUHURA,2025,1910,1660,3570,27
KIRYANDONGO,2015,1820,1940,3760,27
KIRYANDONGO,2016,1890,2050,3940,27
KIRYANDONGO,2017,1960,2160,4120,27
KIRYANDONGO,2018,2030,2260,4290,27
KIRYANDONGO,2019,2120,2360,4480,27
KIRYANDONGO,2020,2230,2410,4640,27
KIRYANDONGO,2021,2350,2460,4810,27
KIRYANDONGO,2022,2480,2490,4970,27
KIRYANDONGO,2023,2600,2530,5130,27
KIRYANDONGO,2024,2730,2580,5310,27
KIRYANDONGO,2025,2870,2670,5540,27
KISORO,2015,1370,2420,3790,27
KISORO,2016,1410,2530,3940,27
KISORO,2017,1440,2640,4080,27
KISORO,2018,1490,2760,4250,27
KISORO,2019,1530,2830,4360,27
KISORO,2020,1600,2890,4490,27
KISORO,2021,1670,2920,4590,27
KISORO,2022,1740,2950,4690,27
KISORO,2023,1800,2970,4770,27
KISORO,2024,1880,3020,4900,27
KISORO,2025,1950,3090,5040,27
KITAGWENDA,2015,860,1040,1900,27
KITAGWENDA,2016,900,1070,1970,27
KITAGWENDA,2017,930,1110,2040,27
KITAGWENDA,2018,970,1150,2120,27
KITAGWENDA,2019,1010,1190,2200,27
KITAGWENDA,2020,1050,1230,2280,27
KITAGWENDA,2021,1090,1280,2370,27
KITAGWENDA,2022,1130,1320,2450,27
KITAGWENDA,2023,1170,1360,2530,27
KITAGWENDA,2024,1210,1400,2610,27
KITAGWENDA,2025,1260,1440,2700,27
KITGUM,2015,1140,1360,2500,27
KITGUM,2016,1170,1420,2590,27
KITGUM,2017,1190,1480,2670,27
KITGUM,2018,1220,1530,2750,27
KITGUM,2019,1260,1570,2830,27
KITGUM,2020,1310,1600,2910,27
KITGUM,2021,1370,1610,2980,27
KITGUM,2022,1410,1620,3030,27
KITGUM,2023,1460,1630,3090,27
KITGUM,2024,1520,1650,3170,27
KITGUM,2025,1570,1680,3250,27
KOBOKO,2015,1310,1470,2780,27
KOBOKO,2016,1370,1560,2930,27
KOBOKO,2017,1430,1670,3100,27
KOBOKO,2018,1500,1760,3260,27
KOBOKO,2019,1580,1850,3430,27
KOBOKO,2020,1680,1920,3600,27
KOBOKO,2021,1790,1980,3770,27
KOBOKO,2022,1900,2030,3930,27
KOBOKO,2023,2010,2080,4090,27
KOBOKO,2024,2130,2150,4280,27
KOBOKO,2025,2260,2250,4510,27
KOLE,2015,1330,1440,2770,27
KOLE,2016,1370,1490,2860,27
KOLE,2017,1420,1530,2950,27
KOLE,2018,1460,1570,3030,27
KOLE,2019,1510,1610,3120,27
KOLE,2020,1560,1660,3220,27
KOLE,2021,1600,1700,3300,27
KOLE,2022,1650,1750,3400,27
KOLE,2023,1700,1790,3490,27
KOLE,2024,1750,1840,3590,27
KOLE,2025,1790,1880,3670,27
KOTIDO,2015,1130,1400,2530,27
KOTIDO,2016,1170,1460,2630,27
KOTIDO,2017,1200,1540,2740,27
KOTIDO,2018,1250,1590,2840,27
KOTIDO,2019,1300,1640,2940,27
KOTIDO,2020,1350,1680,3030,27
KOTIDO,2021,1420,1700,3120,27
KOTIDO,2022,1480,1720,3200,27
KOTIDO,2023,1550,1740,3290,27
KOTIDO,2024,1620,1760,3380,27
KOTIDO,2025,1690,1810,3500,27
KUMI,2015,1230,1600,2830,27
KUMI,2016,1280,1680,2960,27
KUMI,2017,1340,1770,3110,27
KUMI,2018,1390,1870,3260,27
KUMI,2019,1460,1940,3400,27
KUMI,2020,1530,1990,3520,27
KUMI,2021,1620,2040,3660,27
KUMI,2022,1710,2060,3770,27
KUMI,2023,1790,2110,3900,27
KUMI,2024,1890,2150,4040,27
KUMI,2025,1990,2230,4220,27
KWANIA,2015,1170,1320,2490,27
KWANIA,2016,1210,1360,2570,27
KWANIA,2017,1240,1400,2640,27
KWANIA,2018,1280,1440,2720,27
KWANIA,2019,1320,1480,2800,27
KWANIA,2020,1360,1520,2880,27
KWANIA,2021,1400,1560,2960,27
KWANIA,2022,1440,1600,3040,27
KWANIA,2023,1480,1640,3120,27
KWANIA,2024,1510,1680,3190,27
KWANIA,2025,1550,1720,3270,27
KWEEN,2015,560,650,1210,27
KWEEN,2016,580,660,1240,27
KWEEN,2017,600,680,1280,27
KWEEN,2018,620,700,1320,27
KWEEN,2019,630,710,1340,27
KWEEN,2020,650,730,1380,27
KWEEN,2021,670,750,1420,27
KWEEN,2022,690,760,1450,27
KWEEN,2023,710,780,1490,27
KWEEN,2024,730,800,1530,27
KWEEN,2025,750,810,1560,27
KYANKWANZI,2015,1710,1550,3260,27
KYANKWANZI,2016,1790,1620,3410,27
KYANKWANZI,2017,1880,1690,3570,27
KYANKWANZI,2018,1980,1770,3750,27
KYANKWANZI,2019,2080,1850,3930,27
KYANKWANZI,2020,2180,1940,4120,27
KYANKWANZI,2021,2290,2020,4310,27
KYANKWANZI,2022,2400,2110,4510,27
KYANKWANZI,2023,2520,2200,4720,27
KYANKWANZI,2024,2630,2300,4930,27
KYANKWANZI,2025,2750,2390,5140,27
KYEGEGWA,2015,2080,2130,4210,27
KYEGEGWA,2016,2260,2300,4560,27
KYEGEGWA,2017,2440,2480,4920,27
KYEGEGWA,2018,2640,2670,5310,27
KYEGEGWA,2019,2860,2880,5740,27
KYEGEGWA,2020,3080,3100,6180,27
KYEGEGWA,2021,3330,3340,6670,27
KYEGEGWA,2022,3590,3600,7190,27
KYEGEGWA,2023,3880,3870,7750,27
KYEGEGWA,2024,4180,4160,8340,27
KYEGEGWA,2025,4500,4460,8960,27
KYENJOJO,2015,2950,3010,5960,27
KYENJOJO,2016,3070,3120,6190,27
KYENJOJO,2017,3190,3230,6420,27
KYENJOJO,2018,3320,3350,6670,27
KYENJOJO,2019,3460,3470,6930,27
KYENJOJO,2020,3590,3590,7180,27
KYENJOJO,2021,3730,3720,7450,27
KYENJOJO,2022,3870,3850,7720,27
KYENJOJO,2023,4020,3970,7990,27
KYENJOJO,2024,4160,4100,8260,27
KYENJOJO,2025,4310,4240,8550,27
KYOTERA,2015,1470,1830,3300,27
KYOTERA,2016,1510,1890,3400,27
KYOTERA,2017,1550,1960,3510,27
KYOTERA,2018,1580,2040,3620,27
KYOTERA,2019,1630,2090,3720,27
KYOTERA,2020,1690,2110,3800,27
KYOTERA,2021,1760,2120,3880,27
KYOTERA,2022,1830,2120,3950,27
KYOTERA,2023,1900,2130,4030,27
KYOTERA,2024,1970,2150,4120,27
KYOTERA,2025,2040,2190,4230,27
KARENGA,2015,400,420,820,27
KARENGA,2016,410,420,830,27
KARENGA,2017,420,430,850,27
KARENGA,2018,430,440,870,27
KARENGA,2019,440,460,900,27
KARENGA,2020,460,470,930,27
KARENGA,2021,470,480,950,27
KARENGA,2022,480,480,960,27
KARENGA,2023,490,500,990,27
KARENGA,2024,500,510,1010,27
KARENGA,2025,510,520,1030,27
LAMWO,2015,670,850,1520,27
LAMWO,2016,690,880,1570,27
LAMWO,2017,700,910,1610,27
LAMWO,2018,710,950,1660,27
LAMWO,2019,730,970,1700,27
LAMWO,2020,750,980,1730,27
LAMWO,2021,770,1000,1770,27
LAMWO,2022,800,1000,1800,27
LAMWO,2023,820,990,1810,27
LAMWO,2024,850,1000,1850,27
LAMWO,2025,870,1020,1890,27
LIRA,2015,2980,3500,6480,27
LIRA,2016,3070,3600,6670,27
LIRA,2017,3150,3710,6860,27
LIRA,2018,3240,3810,7050,27
LIRA,2019,3330,3920,7250,27
LIRA,2020,3420,4020,7440,27
LIRA,2021,3500,4130,7630,27
LIRA,2022,3590,4240,7830,27
LIRA,2023,3680,4340,8020,27
LIRA,2024,3760,4450,8210,27
LIRA,2025,3850,4560,8410,27
LUUKA,2015,1040,1460,2500,27
LUUKA,2016,1070,1530,2600,27
LUUKA,2017,1100,1590,2690,27
LUUKA,2018,1130,1660,2790,27
LUUKA,2019,1170,1710,2880,27
LUUKA,2020,1220,1750,2970,27
LUUKA,2021,1280,1760,3040,27
LUUKA,2022,1330,1780,3110,27
LUUKA,2023,1380,1790,3170,27
LUUKA,2024,1440,1820,3260,27
LUUKA,2025,1500,1860,3360,27
LUWERO,2015,2970,3440,6410,27
LUWERO,2016,3060,3600,6660,27
LUWERO,2017,3160,3780,6940,27
LUWERO,2018,3260,3940,7200,27
LUWERO,2019,3390,4070,7460,27
LUWERO,2020,3550,4160,7710,27
LUWERO,2021,3730,4220,7950,27
LUWERO,2022,3900,4250,8150,27
LUWERO,2023,4080,4300,8380,27
LUWERO,2024,4270,4380,8650,27
LUWERO,2025,4460,4500,8960,27
LWENGO,2015,1380,1850,3230,27
LWENGO,2016,1400,1920,3320,27
LWENGO,2017,1420,1980,3400,27
LWENGO,2018,1450,2040,3490,27
LWENGO,2019,1490,2080,3570,27
LWENGO,2020,1530,2090,3620,27
LWENGO,2021,1580,2100,3680,27
LWENGO,2022,1630,2090,3720,27
LWENGO,2023,1670,2080,3750,27
LWENGO,2024,1730,2090,3820,27
LWENGO,2025,1780,2130,3910,27
LYANTONDE,2015,640,660,1300,27
LYANTONDE,2016,670,680,1350,27
LYANTONDE,2017,680,720,1400,27
LYANTONDE,2018,710,750,1460,27
LYANTONDE,2019,740,800,1540,27
LYANTONDE,2020,770,840,1610,27
LYANTONDE,2021,800,870,1670,27
LYANTONDE,2022,840,890,1730,27
LYANTONDE,2023,890,920,1810,27
LYANTONDE,2024,940,920,1860,27
LYANTONDE,2025,970,940,1910,27
MANAFWA,2015,730,880,1610,27
MANAFWA,2016,750,900,1650,27
MANAFWA,2017,770,920,1690,27
MANAFWA,2018,790,940,1730,27
MANAFWA,2019,810,960,1770,27
MANAFWA,2020,830,980,1810,27
MANAFWA,2021,840,1000,1840,27
MANAFWA,2022,860,1020,1880,27
MANAFWA,2023,880,1040,1920,27
MANAFWA,2024,900,1060,1960,27
MANAFWA,2025,920,1080,2000,27
MARACHA,2015,980,1280,2260,27
MARACHA,2016,1000,1310,2310,27
MARACHA,2017,1020,1340,2360,27
MARACHA,2018,1040,1360,2400,27
MARACHA,2019,1060,1390,2450,27
MARACHA,2020,1080,1410,2490,27
MARACHA,2021,1100,1440,2540,27
MARACHA,2022,1120,1460,2580,27
MARACHA,2023,1140,1480,2620,27
MARACHA,2024,1160,1510,2670,27
MARACHA,2025,1180,1530,2710,27
MASAKA,2015,2280,2850,5130,27
MASAKA,2016,2340,2980,5320,27
MASAKA,2017,2410,3130,5540,27
MASAKA,2018,2490,3250,5740,27
MASAKA,2019,2580,3360,5940,27
MASAKA,2020,2690,3420,6110,27
MASAKA,2021,2820,3450,6270,27
MASAKA,2022,2950,3490,6440,27
MASAKA,2023,3070,3520,6590,27
MASAKA,2024,3200,3570,6770,27
MASAKA,2025,3340,3660,7000,27
MASINDI,2015,2560,2290,4850,27
MASINDI,2016,2640,2350,4990,27
MASINDI,2017,2710,2410,5120,27
MASINDI,2018,2790,2480,5270,27
MASINDI,2019,2870,2540,5410,27
MASINDI,2020,2950,2600,5550,27
MASINDI,2021,3030,2670,5700,27
MASINDI,2022,3110,2730,5840,27
MASINDI,2023,3190,2800,5990,27
MASINDI,2024,3270,2860,6130,27
MASINDI,2025,3340,2920,6260,27
MAYUGE,2015,2580,3420,6000,27
MAYUGE,2016,2680,3610,6290,27
MAYUGE,2017,2790,3820,6610,27
MAYUGE,2018,2890,4010,6900,27
MAYUGE,2019,3030,4190,7220,27
MAYUGE,2020,3190,4300,7490,27
MAYUGE,2021,3370,4390,7760,27
MAYUGE,2022,3540,4470,8010,27
MAYUGE,2023,3720,4570,8290,27
MAYUGE,2024,3920,4680,8600,27
MAYUGE,2025,4130,4850,8980,27
MBALE,2015,2880,3770,6650,27
MBALE,2016,2980,4000,6980,27
MBALE,2017,3090,4230,7320,27
MBALE,2018,3220,4460,7680,27
MBALE,2019,3360,4650,8010,27
MBALE,2020,3530,4810,8340,27
MBALE,2021,3730,4920,8650,27
MBALE,2022,3920,5020,8940,27
MBALE,2023,4120,5140,9260,27
MBALE,2024,4330,5280,9610,27
MBALE,2025,4560,5480,10040,27
MBARARA,2015,3030,3290,6320,27
MBARARA,2016,3110,3360,6470,27
MBARARA,2017,3170,3430,6600,27
MBARARA,2018,3250,3500,6750,27
MBARARA,2019,3320,3580,6900,27
MBARARA,2020,3390,3650,7040,27
MBARARA,2021,3460,3720,7180,27
MBARARA,2022,3530,3790,7320,27
MBARARA,2023,3600,3860,7460,27
MBARARA,2024,3660,3920,7580,27
MBARARA,2025,3730,3990,7720,27
MITOOMA,2015,910,1340,2250,27
MITOOMA,2016,920,1350,2270,27
MITOOMA,2017,930,1360,2290,27
MITOOMA,2018,940,1380,2320,27
MITOOMA,2019,950,1390,2340,27
MITOOMA,2020,960,1400,2360,27
MITOOMA,2021,970,1410,2380,27
MITOOMA,2022,980,1420,2400,27
MITOOMA,2023,990,1430,2420,27
MITOOMA,2024,1000,1430,2430,27
MITOOMA,2025,1000,1440,2440,27
MITYANA,2015,2310,2490,4800,27
MITYANA,2016,2380,2600,4980,27
MITYANA,2017,2430,2700,5130,27
MITYANA,2018,2500,2800,5300,27
MITYANA,2019,2580,2880,5460,27
MITYANA,2020,2680,2920,5600,27
MITYANA,2021,2790,2940,5730,27
MITYANA,2022,2910,2950,5860,27
MITYANA,2023,3010,2960,5970,27
MITYANA,2024,3130,2990,6120,27
MITYANA,2025,3250,3060,6310,27
MOROTO,2015,670,750,1420,27
MOROTO,2016,700,790,1490,27
MOROTO,2017,710,840,1550,27
MOROTO,2018,740,860,1600,27
MOROTO,2019,760,900,1660,27
MOROTO,2020,800,920,1720,27
MOROTO,2021,830,940,1770,27
MOROTO,2022,870,950,1820,27
MOROTO,2023,900,970,1870,27
MOROTO,2024,950,980,1930,27
MOROTO,2025,980,1010,1990,27
MOYO,2015,630,670,1300,27
MOYO,2016,650,690,1340,27
MOYO,2017,660,700,1360,27
MOYO,2018,680,720,1400,27
MOYO,2019,700,730,1430,27
MOYO,2020,710,750,1460,27
MOYO,2021,730,760,1490,27
MOYO,2022,750,780,1530,27
MOYO,2023,760,790,1550,27
MOYO,2024,780,800,1580,27
MOYO,2025,790,820,1610,27
MPIGI,2015,1830,1960,3790,27
MPIGI,2016,1880,2050,3930,27
MPIGI,2017,1940,2160,4100,27
MPIGI,2018,2000,2250,4250,27
MPIGI,2019,2080,2320,4400,27
MPIGI,2020,2170,2380,4550,27
MPIGI,2021,2270,2410,4680,27
MPIGI,2022,2380,2430,4810,27
MPIGI,2023,2480,2460,4940,27
MPIGI,2024,2590,2500,5090,27
MPIGI,2025,2710,2570,5280,27
MUBENDE,2015,3290,3430,6720,27
MUBENDE,2016,3490,3700,7190,27
MUBENDE,2017,3700,3990,7690,27
MUBENDE,2018,3930,4280,8210,27
MUBENDE,2019,4200,4550,8750,27
MUBENDE,2020,4500,4770,9270,27
MUBENDE,2021,4860,4970,9830,27
MUBENDE,2022,5230,5160,10390,27
MUBENDE,2023,5610,5360,10970,27
MUBENDE,2024,6020,5620,11640,27
MUBENDE,2025,6470,5930,12400,27
MUKONO,2015,4510,5620,10130,27
MUKONO,2016,4660,5920,10580,27
MUKONO,2017,4820,6260,11080,27
MUKONO,2018,4990,6570,11560,27
MUKONO,2019,5200,6830,12030,27
MUKONO,2020,5450,7030,12480,27
MUKONO,2021,5730,7170,12900,27
MUKONO,2022,6020,7280,13300,27
MUKONO,2023,6300,7420,13720,27
MUKONO,2024,6590,7600,14190,27
MUKONO,2025,6910,7870,14780,27
MADI OKOLLO,2015,830,880,1710,27
MADI OKOLLO,2016,850,910,1760,27
MADI OKOLLO,2017,880,930,1810,27
MADI OKOLLO,2018,900,960,1860,27
MADI OKOLLO,2019,930,980,1910,27
MADI OKOLLO,2020,950,1010,1960,27
MADI OKOLLO,2021,980,1030,2010,27
MADI OKOLLO,2022,1000,1060,2060,27
MADI OKOLLO,2023,1030,1080,2110,27
MADI OKOLLO,2024,1050,1110,2160,27
MADI OKOLLO,2025,1080,1130,2210,27
NABILATUK,2015,340,430,770,27
NABILATUK,2016,360,460,820,27
NABILATUK,2017,390,500,890,27
NABILATUK,2018,410,520,930,27
NABILATUK,2019,440,550,990,27
NABILATUK,2020,470,580,1050,27
NABILATUK,2021,500,600,1100,27
NABILATUK,2022,540,620,1160,27
NABILATUK,2023,590,640,1230,27
NABILATUK,2024,620,660,1280,27
NABILATUK,2025,660,700,1360,27
NAKAPIRIPIRIT,2015,590,660,1250,27
NAKAPIRIPIRIT,2016,610,700,1310,27
NAKAPIRIPIRIT,2017,650,760,1410,27
NAKAPIRIPIRIT,2018,690,810,1500,27
NAKAPIRIPIRIT,2019,730,850,1580,27
NAKAPIRIPIRIT,2020,780,870,1650,27
NAKAPIRIPIRIT,2021,830,920,1750,27
NAKAPIRIPIRIT,2022,880,940,1820,27
NAKAPIRIPIRIT,2023,940,970,1910,27
NAKAPIRIPIRIT,2024,990,1010,2000,27
NAKAPIRIPIRIT,2025,1060,1060,2120,27
NAKASEKE,2015,1790,1310,3100,27
NAKASEKE,2016,1850,1340,3190,27
NAKASEKE,2017,1920,1370,3290,27
NAKASEKE,2018,1990,1410,3400,27
NAKASEKE,2019,2060,1440,3500,27
NAKASEKE,2020,2130,1470,3600,27
NAKASEKE,2021,2210,1510,3720,27
NAKASEKE,2022,2280,1540,3820,27
NAKASEKE,2023,2360,1570,3930,27
NAKASEKE,2024,2430,1600,4030,27
NAKASEKE,2025,2510,1630,4140,27
NAKASONGOLA,2015,1340,1260,2600,27
NAKASONGOLA,2016,1390,1320,2710,27
NAKASONGOLA,2017,1440,1400,2840,27
NAKASONGOLA,2018,1500,1460,2960,27
NAKASONGOLA,2019,1570,1520,3090,27
NAKASONGOLA,2020,1650,1560,3210,27
NAKASONGOLA,2021,1750,1590,3340,27
NAKASONGOLA,2022,1850,1610,3460,27
NAKASONGOLA,2023,1940,1640,3580,27
NAKASONGOLA,2024,2040,1670,3710,27
NAKASONGOLA,2025,2150,1720,3870,27
NAMAYINGO,2015,1120,1550,2670,27
NAMAYINGO,2016,1150,1610,2760,27
NAMAYINGO,2017,1170,1670,2840,27
NAMAYINGO,2018,1200,1730,2930,27
NAMAYINGO,2019,1240,1770,3010,27
NAMAYINGO,2020,1300,1800,3100,27
NAMAYINGO,2021,1360,1810,3170,27
NAMAYINGO,2022,1410,1810,3220,27
NAMAYINGO,2023,1460,1820,3280,27
NAMAYINGO,2024,1520,1830,3350,27
NAMAYINGO,2025,1570,1870,3440,27
NAMISINDWA,2015,930,1100,2030,27
NAMISINDWA,2016,960,1130,2090,27
NAMISINDWA,2017,980,1160,2140,27
NAMISINDWA,2018,1010,1180,2190,27
NAMISINDWA,2019,1040,1210,2250,27
NAMISINDWA,2020,1070,1240,2310,27
NAMISINDWA,2021,1090,1260,2350,27
NAMISINDWA,2022,1120,1290,2410,27
NAMISINDWA,2023,1150,1320,2470,27
NAMISINDWA,2024,1180,1340,2520,27
NAMISINDWA,2025,1200,1370,2570,27
NAMUTUMBA,2015,1220,1450,2670,27
NAMUTUMBA,2016,1270,1530,2800,27
NAMUTUMBA,2017,1330,1630,2960,27
NAMUTUMBA,2018,1380,1710,3090,27
NAMUTUMBA,2019,1460,1780,3240,27
NAMUTUMBA,2020,1540,1840,3380,27
NAMUTUMBA,2021,1640,1890,3530,27
NAMUTUMBA,2022,1730,1920,3650,27
NAMUTUMBA,2023,1820,1960,3780,27
NAMUTUMBA,2024,1920,2010,3930,27
NAMUTUMBA,2025,2030,2090,4120,27
NAPAK,2015,690,1160,1850,27
NAPAK,2016,710,1210,1920,27
NAPAK,2017,720,1260,1980,27
NAPAK,2018,750,1330,2080,27
NAPAK,2019,770,1360,2130,27
NAPAK,2020,800,1390,2190,27
NAPAK,2021,830,1400,2230,27
NAPAK,2022,860,1410,2270,27
NAPAK,2023,890,1430,2320,27
NAPAK,2024,920,1460,2380,27
NAPAK,2025,960,1490,2450,27
NEBBI,2015,1300,1490,2790,27
NEBBI,2016,1340,1530,2870,27
NEBBI,2017,1380,1580,2960,27
NEBBI,2018,1420,1620,3040,27
NEBBI,2019,1470,1660,3130,27
NEBBI,2020,1510,1710,3220,27
NEBBI,2021,1560,1750,3310,27
NEBBI,2022,1600,1800,3400,27
NEBBI,2023,1650,1840,3490,27
NEBBI,2024,1690,1890,3580,27
NEBBI,2025,1740,1930,3670,27
NGORA,2015,770,920,1690,27
NGORA,2016,790,980,1770,27
NGORA,2017,830,1030,1860,27
NGORA,2018,860,1070,1930,27
NGORA,2019,890,1120,2010,27
NGORA,2020,940,1140,2080,27
NGORA,2021,990,1160,2150,27
NGORA,2022,1030,1180,2210,27
NGORA,2023,1090,1200,2290,27
NGORA,2024,1140,1220,2360,27
NGORA,2025,1190,1260,2450,27
NTOROKO,2015,510,530,1040,27
NTOROKO,2016,530,550,1080,27
NTOROKO,2017,540,580,1120,27
NTOROKO,2018,560,600,1160,27
NTOROKO,2019,590,620,1210,27
NTOROKO,2020,610,630,1240,27
NTOROKO,2021,640,640,1280,27
NTOROKO,2022,680,640,1320,27
NTOROKO,2023,700,640,1340,27
NTOROKO,2024,730,650,1380,27
NTOROKO,2025,770,670,1440,27
NTUNGAMO,2015,2990,3370,6360,27
NTUNGAMO,2016,3050,3440,6490,27
NTUNGAMO,2017,3120,3500,6620,27
NTUNGAMO,2018,3180,3560,6740,27
NTUNGAMO,2019,3250,3630,6880,27
NTUNGAMO,2020,3310,3690,7000,27
NTUNGAMO,2021,3380,3750,7130,27
NTUNGAMO,2022,3440,3810,7250,27
NTUNGAMO,2023,3500,3870,7370,27
NTUNGAMO,2024,3560,3920,7480,27
NTUNGAMO,2025,3620,3980,7600,27
NWOYA,2015,820,900,1720,27
NWOYA,2016,900,990,1890,27
NWOYA,2017,990,1090,2080,27
NWOYA,2018,1100,1200,2300,27
NWOYA,2019,1210,1330,2540,27
NWOYA,2020,1340,1460,2800,27
NWOYA,2021,1470,1610,3080,27
NWOYA,2022,1620,1760,3380,27
NWOYA,2023,1790,1940,3730,27
NWOYA,2024,1960,2130,4090,27
NWOYA,2025,2160,2330,4490,27
OBONGI,2015,260,310,570,27
OBONGI,2016,270,320,590,27
OBONGI,2017,280,340,620,27
OBONGI,2018,290,350,640,27
OBONGI,2019,300,360,660,27
OBONGI,2020,320,370,690,27
OBONGI,2021,320,370,690,27
OBONGI,2022,340,380,720,27
OBONGI,2023,360,390,750,27
OBONGI,2024,370,390,760,27
OBONGI,2025,390,400,790,27
OMORO,2015,840,1020,1860,27
OMORO,2016,880,1080,1960,27
OMORO,2017,910,1150,2060,27
OMORO,2018,950,1210,2160,27
OMORO,2019,1000,1270,2270,27
OMORO,2020,1060,1310,2370,27
OMORO,2021,1120,1340,2460,27
OMORO,2022,1180,1360,2540,27
OMORO,2023,1250,1400,2650,27
OMORO,2024,1320,1450,2770,27
OMORO,2025,1400,1500,2900,27
OTUKE,2015,620,670,1290,27
OTUKE,2016,650,700,1350,27
OTUKE,2017,680,730,1410,27
OTUKE,2018,710,760,1470,27
OTUKE,2019,740,800,1540,27
OTUKE,2020,770,830,1600,27
OTUKE,2021,810,860,1670,27
OTUKE,2022,840,900,1740,27
OTUKE,2023,870,930,1800,27
OTUKE,2024,910,970,1880,27
OTUKE,2025,940,1010,1950,27
OYAM,2015,2220,2470,4690,27
OYAM,2016,2290,2540,4830,27
OYAM,2017,2360,2610,4970,27
OYAM,2018,2430,2690,5120,27
OYAM,2019,2500,2770,5270,27
OYAM,2020,2580,2840,5420,27
OYAM,2021,2650,2920,5570,27
OYAM,2022,2720,3000,5720,27
OYAM,2023,2800,3070,5870,27
OYAM,2024,2870,3150,6020,27
OYAM,2025,2940,3230,6170,27
PADER,2015,850,1100,1950,27
PADER,2016,880,1140,2020,27
PADER,2017,890,1200,2090,27
PADER,2018,920,1250,2170,27
PADER,2019,940,1280,2220,27
PADER,2020,980,1310,2290,27
PADER,2021,1020,1310,2330,27
PADER,2022,1070,1320,2390,27
PADER,2023,1100,1330,2430,27
PADER,2024,1140,1350,2490,27
PADER,2025,1180,1380,2560,27
PAKWACH,2015,860,1020,1880,27
PAKWACH,2016,900,1060,1960,27
PAKWACH,2017,940,1100,2040,27
PAKWACH,2018,980,1140,2120,27
PAKWACH,2019,1010,1180,2190,27
PAKWACH,2020,1050,1220,2270,27
PAKWACH,2021,1100,1260,2360,27
PAKWACH,2022,1140,1300,2440,27
PAKWACH,2023,1180,1350,2530,27
PAKWACH,2024,1230,1390,2620,27
PAKWACH,2025,1270,1440,2710,27
PALLISA,2015,1450,1740,3190,27
PALLISA,2016,1520,1860,3380,27
PALLISA,2017,1600,1990,3590,27
PALLISA,2018,1690,2120,3810,27
PALLISA,2019,1790,2230,4020,27
PALLISA,2020,1900,2330,4230,27
PALLISA,2021,2040,2410,4450,27
PALLISA,2022,2180,2480,4660,27
PALLISA,2023,2320,2560,4880,27
PALLISA,2024,2470,2650,5120,27
PALLISA,2025,2630,2780,5410,27
RAKAI,2015,1540,1820,3360,27
RAKAI,2016,1580,1900,3480,27
RAKAI,2017,1630,2000,3630,27
RAKAI,2018,1690,2090,3780,27
RAKAI,2019,1760,2160,3920,27
RAKAI,2020,1850,2200,4050,27
RAKAI,2021,1940,2220,4160,27
RAKAI,2022,2030,2250,4280,27
RAKAI,2023,2120,2280,4400,27
RAKAI,2024,2220,2320,4540,27
RAKAI,2025,2320,2380,4700,27
RUBANDA,2015,1100,1370,2470,27
RUBANDA,2016,1110,1390,2500,27
RUBANDA,2017,1130,1400,2530,27
RUBANDA,2018,1140,1410,2550,27
RUBANDA,2019,1160,1420,2580,27
RUBANDA,2020,1170,1430,2600,27
RUBANDA,2021,1180,1440,2620,27
RUBANDA,2022,1200,1440,2640,27
RUBANDA,2023,1210,1450,2660,27
RUBANDA,2024,1220,1460,2680,27
RUBANDA,2025,1230,1460,2690,27
RUBIRIZI,2015,710,930,1640,27
RUBIRIZI,2016,720,940,1660,27
RUBIRIZI,2017,740,960,1700,27
RUBIRIZI,2018,750,980,1730,27
RUBIRIZI,2019,770,1000,1770,27
RUBIRIZI,2020,780,1010,1790,27
RUBIRIZI,2021,790,1030,1820,27
RUBIRIZI,2022,810,1050,1860,27
RUBIRIZI,2023,820,1070,1890,27
RUBIRIZI,2024,830,1080,1910,27
RUBIRIZI,2025,850,1100,1950,27
RUKIGA,2015,600,700,1300,27
RUKIGA,2016,610,710,1320,27
RUKIGA,2017,610,710,1320,27
RUKIGA,2018,620,710,1330,27
RUKIGA,2019,620,720,1340,27
RUKIGA,2020,630,720,1350,27
RUKIGA,2021,630,730,1360,27
RUKIGA,2022,640,730,1370,27
RUKIGA,2023,640,730,1370,27
RUKIGA,2024,650,740,1390,27
RUKIGA,2025,650,740,1390,27
RUKUNGIRI,2015,1680,2160,3840,27
RUKUNGIRI,2016,1700,2180,3880,27
RUKUNGIRI,2017,1720,2210,3930,27
RUKUNGIRI,2018,1740,2220,3960,27
RUKUNGIRI,2019,1760,2240,4000,27
RUKUNGIRI,2020,1770,2260,4030,27
RUKUNGIRI,2021,1790,2280,4070,27
RUKUNGIRI,2022,1810,2300,4110,27
RUKUNGIRI,2023,1820,2310,4130,27
RUKUNGIRI,2024,1840,2330,4170,27
RUKUNGIRI,2025,1850,2340,4190,27
RWAMPARA,2015,860,930,1790,27
RWAMPARA,2016,880,950,1830,27
RWAMPARA,2017,900,970,1870,27
RWAMPARA,2018,920,990,1910,27
RWAMPARA,2019,940,1010,1950,27
RWAMPARA,2020,960,1030,1990,27
RWAMPARA,2021,980,1050,2030,27
RWAMPARA,2022,1000,1070,2070,27
RWAMPARA,2023,1010,1090,2100,27
RWAMPARA,2024,1040,1120,2160,27
RWAMPARA,2025,1050,1130,2180,27
SERERE,2015,1640,2020,3660,27
SERERE,2016,1710,2160,3870,27
SERERE,2017,1790,2290,4080,27
SERERE,2018,1880,2430,4310,27
SERERE,2019,1990,2570,4560,27
SERERE,2020,2110,2660,4770,27
SERERE,2021,2250,2730,4980,27
SERERE,2022,2400,2810,5210,27
SERERE,2023,2540,2890,5430,27
SERERE,2024,2700,2990,5690,27
SERERE,2025,2860,3120,5980,27
SHEEMA,2015,1270,1550,2820,27
SHEEMA,2016,1290,1560,2850,27
SHEEMA,2017,1300,1580,2880,27
SHEEMA,2018,1320,1590,2910,27
SHEEMA,2019,1330,1610,2940,27
SHEEMA,2020,1350,1620,2970,27
SHEEMA,2021,1360,1640,3000,27
SHEEMA,2022,1370,1650,3020,27
SHEEMA,2023,1380,1660,3040,27
SHEEMA,2024,1400,1670,3070,27
SHEEMA,2025,1400,1680,3080,27
SIRONKO,2015,1240,1490,2730,27
SIRONKO,2016,1270,1520,2790,27
SIRONKO,2017,1300,1550,2850,27
SIRONKO,2018,1330,1580,2910,27
SIRONKO,2019,1370,1610,2980,27
SIRONKO,2020,1400,1640,3040,27
SIRONKO,2021,1430,1670,3100,27
SIRONKO,2022,1460,1700,3160,27
SIRONKO,2023,1490,1730,3220,27
SIRONKO,2024,1510,1760,3270,27
SIRONKO,2025,1540,1790,3330,27
SOROTI,2015,1980,2290,4270,27
SOROTI,2016,2060,2420,4480,27
SOROTI,2017,2160,2570,4730,27
SOROTI,2018,2250,2720,4970,27
SOROTI,2019,2370,2850,5220,27
SOROTI,2020,2500,2940,5440,27
SOROTI,2021,2650,3010,5660,27
SOROTI,2022,2810,3080,5890,27
SOROTI,2023,2960,3150,6110,27
SOROTI,2024,3140,3250,6390,27
SOROTI,2025,3320,3380,6700,27
SSEMBABULE,2015,1650,1790,3440,27
SSEMBABULE,2016,1710,1890,3600,27
SSEMBABULE,2017,1770,1990,3760,27
SSEMBABULE,2018,1840,2090,3930,27
SSEMBABULE,2019,1920,2170,4090,27
SSEMBABULE,2020,2010,2220,4230,27
SSEMBABULE,2021,2120,2260,4380,27
SSEMBABULE,2022,2220,2290,4510,27
SSEMBABULE,2023,2330,2320,4650,27
SSEMBABULE,2024,2440,2380,4820,27
SSEMBABULE,2025,2580,2450,5030,27
TORORO,2015,2740,3380,6120,27
TORORO,2016,2810,3470,6280,27
TORORO,2017,2890,3550,6440,27
TORORO,2018,2960,3640,6600,27
TORORO,2019,3040,3730,6770,27
TORORO,2020,3110,3810,6920,27
TORORO,2021,3190,3900,7090,27
TORORO,2022,3270,3990,7260,27
TORORO,2023,3340,4080,7420,27
TORORO,2024,3420,4160,7580,27
TORORO,2025,3490,4250,7740,27
WAKISO,2015,20460,24860,45320,27
WAKISO,2016,21830,26560,48390,27
WAKISO,2017,23290,28380,51670,27
WAKISO,2018,24830,30300,55130,27
WAKISO,2019,26490,32340,58830,27
WAKISO,2020,28210,34480,62690,27
WAKISO,2021,30020,36770,66790,27
WAKISO,2022,31950,39200,71150,27
WAKISO,2023,33980,41720,75700,27
WAKISO,2024,36090,44380,80470,27
WAKISO,2025,38310,47200,85510,27
YUMBE,2015,2390,3000,5390,27
YUMBE,2016,2520,3260,5780,27
YUMBE,2017,2660,3530,6190,27
YUMBE,2018,2830,3830,6660,27
YUMBE,2019,3010,4090,7100,27
YUMBE,2020,3230,4330,7560,27
YUMBE,2021,3470,4540,8010,27
YUMBE,2022,3740,4750,8490,27
YUMBE,2023,4010,4980,8990,27
YUMBE,2024,4290,5260,9550,27
YUMBE,2025,4610,5580,10190,27
ZOMBO,2015,1200,1420,2620,27
ZOMBO,2016,1240,1460,2700,27
ZOMBO,2017,1280,1500,2780,27
ZOMBO,2018,1320,1540,2860,27
ZOMBO,2019,1350,1580,2930,27
ZOMBO,2020,1390,1620,3010,27
ZOMBO,2021,1430,1660,3090,27
ZOMBO,2022,1470,1710,3180,27
ZOMBO,2023,1510,1750,3260,27
ZOMBO,2024,1550,1790,3340,27
ZOMBO,2025,1590,1830,3420,27
ABIM,2015,670,850,1520,28
ABIM,2016,710,920,1630,28
ABIM,2017,770,1010,1780,28
ABIM,2018,820,1100,1920,28
ABIM,2019,880,1180,2060,28
ABIM,2020,940,1270,2210,28
ABIM,2021,1030,1350,2380,28
ABIM,2022,1130,1410,2540,28
ABIM,2023,1220,1480,2700,28
ABIM,2024,1320,1550,2870,28
ABIM,2025,1430,1630,3060,28
ADJUMANI,2015,1380,2110,3490,28
ADJUMANI,2016,1390,2130,3520,28
ADJUMANI,2017,1400,2150,3550,28
ADJUMANI,2018,1410,2170,3580,28
ADJUMANI,2019,1420,2190,3610,28
ADJUMANI,2020,1430,2210,3640,28
ADJUMANI,2021,1440,2220,3660,28
ADJUMANI,2022,1440,2240,3680,28
ADJUMANI,2023,1450,2260,3710,28
ADJUMANI,2024,1450,2270,3720,28
ADJUMANI,2025,1460,2280,3740,28
AGAGO,2015,1500,1960,3460,28
AGAGO,2016,1520,1990,3510,28
AGAGO,2017,1550,2030,3580,28
AGAGO,2018,1580,2060,3640,28
AGAGO,2019,1600,2100,3700,28
AGAGO,2020,1630,2130,3760,28
AGAGO,2021,1650,2160,3810,28
AGAGO,2022,1680,2200,3880,28
AGAGO,2023,1700,2230,3930,28
AGAGO,2024,1720,2260,3980,28
AGAGO,2025,1740,2290,4030,28
ALEBTONG,2015,1290,1520,2810,28
ALEBTONG,2016,1330,1600,2930,28
ALEBTONG,2017,1380,1680,3060,28
ALEBTONG,2018,1430,1770,3200,28
ALEBTONG,2019,1480,1850,3330,28
ALEBTONG,2020,1540,1920,3460,28
ALEBTONG,2021,1620,1970,3590,28
ALEBTONG,2022,1700,2000,3700,28
ALEBTONG,2023,1780,2030,3810,28
ALEBTONG,2024,1870,2060,3930,28
ALEBTONG,2025,1970,2110,4080,28
AMOLATAR,2015,880,930,1810,28
AMOLATAR,2016,910,980,1890,28
AMOLATAR,2017,940,1030,1970,28
AMOLATAR,2018,970,1090,2060,28
AMOLATAR,2019,1000,1130,2130,28
AMOLATAR,2020,1050,1170,2220,28
AMOLATAR,2021,1090,1200,2290,28
AMOLATAR,2022,1140,1220,2360,28
AMOLATAR,2023,1200,1230,2430,28
AMOLATAR,2024,1250,1240,2490,28
AMOLATAR,2025,1310,1270,2580,28
AMUDAT,2015,660,770,1430,28
AMUDAT,2016,690,820,1510,28
AMUDAT,2017,720,880,1600,28
AMUDAT,2018,750,940,1690,28
AMUDAT,2019,790,1010,1800,28
AMUDAT,2020,830,1070,1900,28
AMUDAT,2021,890,1110,2000,28
AMUDAT,2022,940,1150,2090,28
AMUDAT,2023,990,1200,2190,28
AMUDAT,2024,1050,1240,2290,28
AMUDAT,2025,1120,1290,2410,28
AMURIA,2015,880,1130,2010,28
AMURIA,2016,920,1190,2110,28
AMURIA,2017,960,1270,2230,28
AMURIA,2018,1010,1350,2360,28
AMURIA,2019,1050,1420,2470,28
AMURIA,2020,1110,1480,2590,28
AMURIA,2021,1170,1530,2700,28
AMURIA,2022,1240,1570,2810,28
AMURIA,2023,1320,1610,2930,28
AMURIA,2024,1400,1640,3040,28
AMURIA,2025,1470,1690,3160,28
AMURU,2015,1110,1330,2440,28
AMURU,2016,1140,1410,2550,28
AMURU,2017,1180,1480,2660,28
AMURU,2018,1220,1550,2770,28
AMURU,2019,1260,1630,2890,28
AMURU,2020,1310,1690,3000,28
AMURU,2021,1370,1730,3100,28
AMURU,2022,1440,1760,3200,28
AMURU,2023,1510,1780,3290,28
AMURU,2024,1580,1810,3390,28
AMURU,2025,1650,1850,3500,28
APAC,2015,1360,1460,2820,28
APAC,2016,1410,1510,2920,28
APAC,2017,1470,1570,3040,28
APAC,2018,1520,1620,3140,28
APAC,2019,1570,1670,3240,28
APAC,2020,1630,1730,3360,28
APAC,2021,1690,1790,3480,28
APAC,2022,1740,1840,3580,28
APAC,2023,1800,1900,3700,28
APAC,2024,1860,1960,3820,28
APAC,2025,1920,2020,3940,28
ARUA,2015,4630,6130,10760,28
ARUA,2016,4770,6290,11060,28
ARUA,2017,4900,6470,11370,28
ARUA,2018,5050,6640,11690,28
ARUA,2019,5190,6820,12010,28
ARUA,2020,5330,6990,12320,28
ARUA,2021,5470,7160,12630,28
ARUA,2022,5610,7340,12950,28
ARUA,2023,5750,7520,13270,28
ARUA,2024,5890,7690,13580,28
ARUA,2025,6030,7860,13890,28
BUDAKA,2015,940,1180,2120,28
BUDAKA,2016,980,1250,2230,28
BUDAKA,2017,1020,1330,2350,28
BUDAKA,2018,1070,1410,2480,28
BUDAKA,2019,1110,1490,2600,28
BUDAKA,2020,1170,1560,2730,28
BUDAKA,2021,1240,1610,2850,28
BUDAKA,2022,1310,1640,2950,28
BUDAKA,2023,1390,1680,3070,28
BUDAKA,2024,1460,1720,3180,28
BUDAKA,2025,1550,1760,3310,28
BUDUDA,2015,1100,1170,2270,28
BUDUDA,2016,1160,1250,2410,28
BUDUDA,2017,1220,1340,2560,28
BUDUDA,2018,1280,1430,2710,28
BUDUDA,2019,1350,1520,2870,28
BUDUDA,2020,1430,1610,3040,28
BUDUDA,2021,1530,1680,3210,28
BUDUDA,2022,1630,1740,3370,28
BUDUDA,2023,1750,1790,3540,28
BUDUDA,2024,1860,1850,3710,28
BUDUDA,2025,1980,1930,3910,28
BUGIRI,2015,1850,2440,4290,28
BUGIRI,2016,1940,2590,4530,28
BUGIRI,2017,2030,2760,4790,28
BUGIRI,2018,2130,2950,5080,28
BUGIRI,2019,2230,3130,5360,28
BUGIRI,2020,2350,3290,5640,28
BUGIRI,2021,2500,3410,5910,28
BUGIRI,2022,2660,3510,6170,28
BUGIRI,2023,2830,3590,6420,28
BUGIRI,2024,3000,3700,6700,28
BUGIRI,2025,3180,3820,7000,28
BUGWERI,2015,790,1080,1870,28
BUGWERI,2016,810,1130,1940,28
BUGWERI,2017,840,1200,2040,28
BUGWERI,2018,870,1260,2130,28
BUGWERI,2019,910,1310,2220,28
BUGWERI,2020,940,1360,2300,28
BUGWERI,2021,980,1390,2370,28
BUGWERI,2022,1030,1420,2450,28
BUGWERI,2023,1090,1430,2520,28
BUGWERI,2024,1140,1450,2590,28
BUGWERI,2025,1190,1490,2680,28
BUHWEJU,2015,920,1020,1940,28
BUHWEJU,2016,950,1050,2000,28
BUHWEJU,2017,980,1080,2060,28
BUHWEJU,2018,1010,1110,2120,28
BUHWEJU,2019,1040,1140,2180,28
BUHWEJU,2020,1080,1180,2260,28
BUHWEJU,2021,1110,1210,2320,28
BUHWEJU,2022,1140,1240,2380,28
BUHWEJU,2023,1180,1280,2460,28
BUHWEJU,2024,1210,1310,2520,28
BUHWEJU,2025,1240,1340,2580,28
BUIKWE,2015,2930,3380,6310,28
BUIKWE,2016,3000,3520,6520,28
BUIKWE,2017,3080,3680,6760,28
BUIKWE,2018,3160,3850,7010,28
BUIKWE,2019,3260,4010,7270,28
BUIKWE,2020,3360,4140,7500,28
BUIKWE,2021,3500,4220,7720,28
BUIKWE,2022,3660,4260,7920,28
BUIKWE,2023,3810,4290,8100,28
BUIKWE,2024,3960,4330,8290,28
BUIKWE,2025,4120,4400,8520,28
BUKEDEA,2015,980,1280,2260,28
BUKEDEA,2016,1020,1370,2390,28
BUKEDEA,2017,1080,1460,2540,28
BUKEDEA,2018,1130,1560,2690,28
BUKEDEA,2019,1190,1660,2850,28
BUKEDEA,2020,1260,1740,3000,28
BUKEDEA,2021,1350,1810,3160,28
BUKEDEA,2022,1430,1870,3300,28
BUKEDEA,2023,1530,1920,3450,28
BUKEDEA,2024,1630,1980,3610,28
BUKEDEA,2025,1730,2050,3780,28
BUKOMANSIMBI,2015,750,860,1610,28
BUKOMANSIMBI,2016,750,890,1640,28
BUKOMANSIMBI,2017,770,910,1680,28
BUKOMANSIMBI,2018,780,940,1720,28
BUKOMANSIMBI,2019,790,960,1750,28
BUKOMANSIMBI,2020,810,970,1780,28
BUKOMANSIMBI,2021,830,980,1810,28
BUKOMANSIMBI,2022,850,980,1830,28
BUKOMANSIMBI,2023,880,970,1850,28
BUKOMANSIMBI,2024,900,960,1860,28
BUKOMANSIMBI,2025,930,960,1890,28
BUKWO,2015,630,720,1350,28
BUKWO,2016,670,750,1420,28
BUKWO,2017,700,790,1490,28
BUKWO,2018,740,830,1570,28
BUKWO,2019,780,870,1650,28
BUKWO,2020,820,910,1730,28
BUKWO,2021,860,950,1810,28
BUKWO,2022,910,1000,1910,28
BUKWO,2023,950,1040,1990,28
BUKWO,2024,1000,1090,2090,28
BUKWO,2025,1050,1140,2190,28
BULAMBULI,2015,1020,1170,2190,28
BULAMBULI,2016,1080,1260,2340,28
BULAMBULI,2017,1140,1360,2500,28
BULAMBULI,2018,1200,1450,2650,28
BULAMBULI,2019,1270,1560,2830,28
BULAMBULI,2020,1350,1650,3000,28
BULAMBULI,2021,1450,1730,3180,28
BULAMBULI,2022,1550,1800,3350,28
BULAMBULI,2023,1660,1860,3520,28
BULAMBULI,2024,1790,1930,3720,28
BULAMBULI,2025,1910,2020,3930,28
BULIISA,2015,1210,1160,2370,28
BULIISA,2016,1270,1210,2480,28
BULIISA,2017,1340,1260,2600,28
BULIISA,2018,1410,1320,2730,28
BULIISA,2019,1490,1380,2870,28
BULIISA,2020,1570,1430,3000,28
BULIISA,2021,1650,1490,3140,28
BULIISA,2022,1730,1560,3290,28
BULIISA,2023,1820,1620,3440,28
BULIISA,2024,1910,1690,3600,28
BULIISA,2025,2000,1750,3750,28
BUNDIBUGYO,2015,1490,1740,3230,28
BUNDIBUGYO,2016,1540,1830,3370,28
BUNDIBUGYO,2017,1600,1920,3520,28
BUNDIBUGYO,2018,1660,2030,3690,28
BUNDIBUGYO,2019,1730,2130,3860,28
BUNDIBUGYO,2020,1800,2210,4010,28
BUNDIBUGYO,2021,1890,2270,4160,28
BUNDIBUGYO,2022,1990,2310,4300,28
BUNDIBUGYO,2023,2090,2340,4430,28
BUNDIBUGYO,2024,2200,2380,4580,28
BUNDIBUGYO,2025,2310,2430,4740,28
BUNYANGABU,2015,1080,1170,2250,28
BUNYANGABU,2016,1120,1220,2340,28
BUNYANGABU,2017,1150,1280,2430,28
BUNYANGABU,2018,1190,1340,2530,28
BUNYANGABU,2019,1230,1390,2620,28
BUNYANGABU,2020,1280,1450,2730,28
BUNYANGABU,2021,1340,1480,2820,28
BUNYANGABU,2022,1410,1500,2910,28
BUNYANGABU,2023,1470,1510,2980,28
BUNYANGABU,2024,1540,1530,3070,28
BUNYANGABU,2025,1610,1550,3160,28
BUSHENYI,2015,1830,2000,3830,28
BUSHENYI,2016,1850,2020,3870,28
BUSHENYI,2017,1870,2040,3910,28
BUSHENYI,2018,1900,2050,3950,28
BUSHENYI,2019,1920,2070,3990,28
BUSHENYI,2020,1940,2090,4030,28
BUSHENYI,2021,1960,2100,4060,28
BUSHENYI,2022,1980,2110,4090,28
BUSHENYI,2023,1990,2130,4120,28
BUSHENYI,2024,2010,2140,4150,28
BUSHENYI,2025,2020,2150,4170,28
BUSIA,2015,1780,2220,4000,28
BUSIA,2016,1840,2340,4180,28
BUSIA,2017,1910,2470,4380,28
BUSIA,2018,1980,2600,4580,28
BUSIA,2019,2070,2730,4800,28
BUSIA,2020,2160,2840,5000,28
BUSIA,2021,2270,2920,5190,28
BUSIA,2022,2400,2970,5370,28
BUSIA,2023,2530,3020,5550,28
BUSIA,2024,2650,3070,5720,28
BUSIA,2025,2790,3150,5940,28
BUTALEJA,2015,1110,1410,2520,28
BUTALEJA,2016,1160,1490,2650,28
BUTALEJA,2017,1200,1580,2780,28
BUTALEJA,2018,1260,1680,2940,28
BUTALEJA,2019,1320,1770,3090,28
BUTALEJA,2020,1390,1860,3250,28
BUTALEJA,2021,1470,1920,3390,28
BUTALEJA,2022,1560,1970,3530,28
BUTALEJA,2023,1650,2010,3660,28
BUTALEJA,2024,1750,2060,3810,28
BUTALEJA,2025,1850,2130,3980,28
BUTAMBALA,2015,500,610,1110,28
BUTAMBALA,2016,510,630,1140,28
BUTAMBALA,2017,520,660,1180,28
BUTAMBALA,2018,530,680,1210,28
BUTAMBALA,2019,550,700,1250,28
BUTAMBALA,2020,560,710,1270,28
BUTAMBALA,2021,580,720,1300,28
BUTAMBALA,2022,600,720,1320,28
BUTAMBALA,2023,620,720,1340,28
BUTAMBALA,2024,650,720,1370,28
BUTAMBALA,2025,660,730,1390,28
BUTEBO,2015,490,630,1120,28
BUTEBO,2016,500,650,1150,28
BUTEBO,2017,510,670,1180,28
BUTEBO,2018,530,700,1230,28
BUTEBO,2019,540,720,1260,28
BUTEBO,2020,550,740,1290,28
BUTEBO,2021,580,750,1330,28
BUTEBO,2022,600,760,1360,28
BUTEBO,2023,620,750,1370,28
BUTEBO,2024,640,750,1390,28
BUTEBO,2025,660,760,1420,28
BUVUMA,2015,1270,960,2230,28
BUVUMA,2016,1350,1020,2370,28
BUVUMA,2017,1430,1090,2520,28
BUVUMA,2018,1520,1170,2690,28
BUVUMA,2019,1610,1240,2850,28
BUVUMA,2020,1710,1330,3040,28
BUVUMA,2021,1810,1410,3220,28
BUVUMA,2022,1920,1500,3420,28
BUVUMA,2023,2030,1600,3630,28
BUVUMA,2024,2150,1700,3850,28
BUVUMA,2025,2270,1810,4080,28
BUYENDE,2015,1790,2140,3930,28
BUYENDE,2016,1890,2300,4190,28
BUYENDE,2017,1980,2450,4430,28
BUYENDE,2018,2080,2620,4700,28
BUYENDE,2019,2200,2790,4990,28
BUYENDE,2020,2320,2940,5260,28
BUYENDE,2021,2480,3070,5550,28
BUYENDE,2022,2650,3170,5820,28
BUYENDE,2023,2830,3260,6090,28
BUYENDE,2024,3010,3370,6380,28
BUYENDE,2025,3200,3500,6700,28
DOKOLO,2015,1170,1480,2650,28
DOKOLO,2016,1210,1520,2730,28
DOKOLO,2017,1240,1570,2810,28
DOKOLO,2018,1280,1610,2890,28
DOKOLO,2019,1320,1650,2970,28
DOKOLO,2020,1350,1700,3050,28
DOKOLO,2021,1390,1740,3130,28
DOKOLO,2022,1430,1780,3210,28
DOKOLO,2023,1470,1820,3290,28
DOKOLO,2024,1510,1870,3380,28
DOKOLO,2025,1550,1910,3460,28
GOMBA,2015,980,880,1860,28
GOMBA,2016,1010,910,1920,28
GOMBA,2017,1030,950,1980,28
GOMBA,2018,1050,990,2040,28
GOMBA,2019,1090,1020,2110,28
GOMBA,2020,1120,1040,2160,28
GOMBA,2021,1160,1050,2210,28
GOMBA,2022,1210,1050,2260,28
GOMBA,2023,1250,1050,2300,28
GOMBA,2024,1290,1050,2340,28
GOMBA,2025,1340,1060,2400,28
GULU,2015,2570,2850,5420,28
GULU,2016,2650,2930,5580,28
GULU,2017,2730,3020,5750,28
GULU,2018,2810,3100,5910,28
GULU,2019,2900,3190,6090,28
GULU,2020,2980,3280,6260,28
GULU,2021,3060,3370,6430,28
GULU,2022,3150,3460,6610,28
GULU,2023,3230,3550,6780,28
GULU,2024,3310,3630,6940,28
GULU,2025,3390,3720,7110,28
HOIMA,2015,2740,3000,5740,28
HOIMA,2016,2850,3110,5960,28
HOIMA,2017,2950,3210,6160,28
HOIMA,2018,3060,3330,6390,28
HOIMA,2019,3170,3440,6610,28
HOIMA,2020,3290,3550,6840,28
HOIMA,2021,3410,3670,7080,28
HOIMA,2022,3520,3780,7300,28
HOIMA,2023,3640,3900,7540,28
HOIMA,2024,3770,4020,7790,28
HOIMA,2025,3890,4140,8030,28
IBANDA,2015,1960,2220,4180,28
IBANDA,2016,2000,2260,4260,28
IBANDA,2017,2040,2300,4340,28
IBANDA,2018,2080,2340,4420,28
IBANDA,2019,2120,2380,4500,28
IBANDA,2020,2160,2420,4580,28
IBANDA,2021,2190,2460,4650,28
IBANDA,2022,2230,2500,4730,28
IBANDA,2023,2270,2540,4810,28
IBANDA,2024,2300,2570,4870,28
IBANDA,2025,2330,2610,4940,28
IGANGA,2015,2000,2560,4560,28
IGANGA,2016,2080,2700,4780,28
IGANGA,2017,2160,2840,5000,28
IGANGA,2018,2240,3000,5240,28
IGANGA,2019,2330,3150,5480,28
IGANGA,2020,2430,3280,5710,28
IGANGA,2021,2570,3360,5930,28
IGANGA,2022,2700,3420,6120,28
IGANGA,2023,2850,3480,6330,28
IGANGA,2024,2990,3540,6530,28
IGANGA,2025,3150,3620,6770,28
ISINGIRO,2015,3330,4220,7550,28
ISINGIRO,2016,3460,4370,7830,28
ISINGIRO,2017,3590,4530,8120,28
ISINGIRO,2018,3720,4690,8410,28
ISINGIRO,2019,3860,4850,8710,28
ISINGIRO,2020,3990,5010,9000,28
ISINGIRO,2021,4130,5180,9310,28
ISINGIRO,2022,4280,5340,9620,28
ISINGIRO,2023,4420,5510,9930,28
ISINGIRO,2024,4570,5690,10260,28
ISINGIRO,2025,4710,5860,10570,28
JINJA,2015,4120,4340,8460,28
JINJA,2016,4190,4410,8600,28
JINJA,2017,4270,4470,8740,28
JINJA,2018,4330,4540,8870,28
JINJA,2019,4400,4610,9010,28
JINJA,2020,4470,4670,9140,28
JINJA,2021,4540,4730,9270,28
JINJA,2022,4600,4790,9390,28
JINJA,2023,4660,4850,9510,28
JINJA,2024,4720,4910,9630,28
JINJA,2025,4770,4960,9730,28
KAABONG,2015,840,1340,2180,28
KAABONG,2016,870,1380,2250,28
KAABONG,2017,890,1420,2310,28
KAABONG,2018,910,1450,2360,28
KAABONG,2019,940,1480,2420,28
KAABONG,2020,960,1510,2470,28
KAABONG,2021,990,1550,2540,28
KAABONG,2022,1010,1590,2600,28
KAABONG,2023,1030,1610,2640,28
KAABONG,2024,1060,1650,2710,28
KAABONG,2025,1080,1680,2760,28
KABALE,2015,1780,1870,3650,28
KABALE,2016,1810,1890,3700,28
KABALE,2017,1840,1920,3760,28
KABALE,2018,1860,1940,3800,28
KABALE,2019,1890,1960,3850,28
KABALE,2020,1920,1980,3900,28
KABALE,2021,1940,2000,3940,28
KABALE,2022,1970,2020,3990,28
KABALE,2023,1990,2040,4030,28
KABALE,2024,2020,2050,4070,28
KABALE,2025,2040,2070,4110,28
KABAROLE,2015,2890,2880,5770,28
KABAROLE,2016,2960,2940,5900,28
KABAROLE,2017,3020,3000,6020,28
KABAROLE,2018,3090,3070,6160,28
KABAROLE,2019,3150,3130,6280,28
KABAROLE,2020,3220,3200,6420,28
KABAROLE,2021,3280,3260,6540,28
KABAROLE,2022,3340,3320,6660,28
KABAROLE,2023,3400,3380,6780,28
KABAROLE,2024,3460,3440,6900,28
KABAROLE,2025,3520,3500,7020,28
KABERAMAIDO,2015,570,690,1260,28
KABERAMAIDO,2016,600,740,1340,28
KABERAMAIDO,2017,620,790,1410,28
KABERAMAIDO,2018,650,840,1490,28
KABERAMAIDO,2019,680,890,1570,28
KABERAMAIDO,2020,720,940,1660,28
KABERAMAIDO,2021,770,980,1750,28
KABERAMAIDO,2022,830,1010,1840,28
KABERAMAIDO,2023,870,1020,1890,28
KABERAMAIDO,2024,930,1050,1980,28
KABERAMAIDO,2025,990,1090,2080,28
KAGADI,2015,2610,2910,5520,28
KAGADI,2016,2710,3020,5730,28
KAGADI,2017,2810,3120,5930,28
KAGADI,2018,2910,3230,6140,28
KAGADI,2019,3010,3340,6350,28
KAGADI,2020,3120,3460,6580,28
KAGADI,2021,3230,3570,6800,28
KAGADI,2022,3340,3690,7030,28
KAGADI,2023,3450,3810,7260,28
KAGADI,2024,3560,3920,7480,28
KAGADI,2025,3680,4040,7720,28
KAKUMIRO,2015,2580,2710,5290,28
KAKUMIRO,2016,2810,2940,5750,28
KAKUMIRO,2017,3050,3190,6240,28
KAKUMIRO,2018,3320,3450,6770,28
KAKUMIRO,2019,3620,3740,7360,28
KAKUMIRO,2020,3930,4050,7980,28
KAKUMIRO,2021,4270,4380,8650,28
KAKUMIRO,2022,4630,4740,9370,28
KAKUMIRO,2023,5020,5120,10140,28
KAKUMIRO,2024,5440,5530,10970,28
KAKUMIRO,2025,5890,5970,11860,28
KALAKI,2015,670,820,1490,28
KALAKI,2016,700,850,1550,28
KALAKI,2017,730,880,1610,28
KALAKI,2018,760,920,1680,28
KALAKI,2019,800,950,1750,28
KALAKI,2020,830,990,1820,28
KALAKI,2021,860,1030,1890,28
KALAKI,2022,900,1070,1970,28
KALAKI,2023,930,1110,2040,28
KALAKI,2024,970,1140,2110,28
KALAKI,2025,1010,1180,2190,28
KALANGALA,2015,1150,830,1980,28
KALANGALA,2016,1190,860,2050,28
KALANGALA,2017,1240,890,2130,28
KALANGALA,2018,1280,930,2210,28
KALANGALA,2019,1320,970,2290,28
KALANGALA,2020,1370,1010,2380,28
KALANGALA,2021,1410,1040,2450,28
KALANGALA,2022,1460,1090,2550,28
KALANGALA,2023,1510,1130,2640,28
KALANGALA,2024,1550,1170,2720,28
KALANGALA,2025,1600,1210,2810,28
KALIRO,2015,1180,1500,2680,28
KALIRO,2016,1230,1590,2820,28
KALIRO,2017,1280,1680,2960,28
KALIRO,2018,1340,1790,3130,28
KALIRO,2019,1400,1890,3290,28
KALIRO,2020,1460,1970,3430,28
KALIRO,2021,1550,2030,3580,28
KALIRO,2022,1640,2090,3730,28
KALIRO,2023,1740,2130,3870,28
KALIRO,2024,1830,2190,4020,28
KALIRO,2025,1940,2250,4190,28
KALUNGU,2015,920,1100,2020,28
KALUNGU,2016,930,1130,2060,28
KALUNGU,2017,950,1180,2130,28
KALUNGU,2018,970,1220,2190,28
KALUNGU,2019,980,1260,2240,28
KALUNGU,2020,1010,1280,2290,28
KALUNGU,2021,1040,1290,2330,28
KALUNGU,2022,1070,1290,2360,28
KALUNGU,2023,1110,1290,2400,28
KALUNGU,2024,1140,1290,2430,28
KALUNGU,2025,1180,1290,2470,28
KAMPALA,2015,19980,23120,43100,28
KAMPALA,2016,20380,23570,43950,28
KAMPALA,2017,20780,24030,44810,28
KAMPALA,2018,21180,24490,45670,28
KAMPALA,2019,21580,24940,46520,28
KAMPALA,2020,21970,25390,47360,28
KAMPALA,2021,22360,25830,48190,28
KAMPALA,2022,22740,26260,49000,28
KAMPALA,2023,23100,26680,49780,28
KAMPALA,2024,23450,27090,50540,28
KAMPALA,2025,23790,27490,51280,28
KAMULI,2015,2480,3070,5550,28
KAMULI,2016,2570,3210,5780,28
KAMULI,2017,2650,3370,6020,28
KAMULI,2018,2730,3530,6260,28
KAMULI,2019,2830,3690,6520,28
KAMULI,2020,2940,3810,6750,28
KAMULI,2021,3080,3890,6970,28
KAMULI,2022,3230,3940,7170,28
KAMULI,2023,3380,3980,7360,28
KAMULI,2024,3540,4020,7560,28
KAMULI,2025,3700,4100,7800,28
KAMWENGE,2015,2100,2440,4540,28
KAMWENGE,2016,2190,2530,4720,28
KAMWENGE,2017,2280,2620,4900,28
KAMWENGE,2018,2370,2710,5080,28
KAMWENGE,2019,2460,2810,5270,28
KAMWENGE,2020,2560,2900,5460,28
KAMWENGE,2021,2660,3000,5660,28
KAMWENGE,2022,2760,3100,5860,28
KAMWENGE,2023,2860,3200,6060,28
KAMWENGE,2024,2960,3300,6260,28
KAMWENGE,2025,3070,3400,6470,28
KANUNGU,2015,1680,2020,3700,28
KANUNGU,2016,1710,2050,3760,28
KANUNGU,2017,1740,2080,3820,28
KANUNGU,2018,1770,2120,3890,28
KANUNGU,2019,1800,2150,3950,28
KANUNGU,2020,1830,2180,4010,28
KANUNGU,2021,1860,2210,4070,28
KANUNGU,2022,1890,2240,4130,28
KANUNGU,2023,1920,2270,4190,28
KANUNGU,2024,1950,2300,4250,28
KANUNGU,2025,1970,2330,4300,28
KAPCHORWA,2015,720,920,1640,28
KAPCHORWA,2016,740,940,1680,28
KAPCHORWA,2017,770,970,1740,28
KAPCHORWA,2018,790,1000,1790,28
KAPCHORWA,2019,810,1020,1830,28
KAPCHORWA,2020,840,1050,1890,28
KAPCHORWA,2021,860,1080,1940,28
KAPCHORWA,2022,890,1110,2000,28
KAPCHORWA,2023,910,1130,2040,28
KAPCHORWA,2024,930,1160,2090,28
KAPCHORWA,2025,960,1180,2140,28
KAPELEBYONG,2015,420,530,950,28
KAPELEBYONG,2016,430,550,980,28
KAPELEBYONG,2017,450,580,1030,28
KAPELEBYONG,2018,470,610,1080,28
KAPELEBYONG,2019,490,640,1130,28
KAPELEBYONG,2020,500,670,1170,28
KAPELEBYONG,2021,530,690,1220,28
KAPELEBYONG,2022,560,690,1250,28
KAPELEBYONG,2023,590,700,1290,28
KAPELEBYONG,2024,620,720,1340,28
KAPELEBYONG,2025,650,740,1390,28
KASESE,2015,4330,5330,9660,28
KASESE,2016,4470,5580,10050,28
KASESE,2017,4600,5840,10440,28
KASESE,2018,4750,6120,10870,28
KASESE,2019,4900,6390,11290,28
KASESE,2020,5090,6600,11690,28
KASESE,2021,5320,6730,12050,28
KASESE,2022,5570,6820,12390,28
KASESE,2023,5840,6880,12720,28
KASESE,2024,6090,6970,13060,28
KASESE,2025,6360,7080,13440,28
KASSANDA,2015,2250,2130,4380,28
KASSANDA,2016,2310,2180,4490,28
KASSANDA,2017,2380,2230,4610,28
KASSANDA,2018,2440,2270,4710,28
KASSANDA,2019,2510,2320,4830,28
KASSANDA,2020,2580,2370,4950,28
KASSANDA,2021,2650,2410,5060,28
KASSANDA,2022,2720,2460,5180,28
KASSANDA,2023,2780,2500,5280,28
KASSANDA,2024,2850,2550,5400,28
KASSANDA,2025,2920,2590,5510,28
KATAKWI,2015,930,1080,2010,28
KATAKWI,2016,960,1130,2090,28
KATAKWI,2017,990,1200,2190,28
KATAKWI,2018,1030,1260,2290,28
KATAKWI,2019,1070,1320,2390,28
KATAKWI,2020,1120,1360,2480,28
KATAKWI,2021,1180,1390,2570,28
KATAKWI,2022,1230,1420,2650,28
KATAKWI,2023,1300,1430,2730,28
KATAKWI,2024,1370,1460,2830,28
KATAKWI,2025,1430,1490,2920,28
KAYUNGA,2015,2020,2500,4520,28
KAYUNGA,2016,2070,2600,4670,28
KAYUNGA,2017,2120,2710,4830,28
KAYUNGA,2018,2180,2830,5010,28
KAYUNGA,2019,2240,2930,5170,28
KAYUNGA,2020,2310,3010,5320,28
KAYUNGA,2021,2410,3060,5470,28
KAYUNGA,2022,2500,3080,5580,28
KAYUNGA,2023,2610,3090,5700,28
KAYUNGA,2024,2710,3110,5820,28
KAYUNGA,2025,2820,3140,5960,28
KAZO,2015,1400,1470,2870,28
KAZO,2016,1450,1520,2970,28
KAZO,2017,1500,1580,3080,28
KAZO,2018,1560,1640,3200,28
KAZO,2019,1620,1690,3310,28
KAZO,2020,1670,1750,3420,28
KAZO,2021,1730,1800,3530,28
KAZO,2022,1790,1860,3650,28
KAZO,2023,1860,1930,3790,28
KAZO,2024,1920,1990,3910,28
KAZO,2025,1980,2050,4030,28
KIBAALE,2015,1220,1110,2330,28
KIBAALE,2016,1300,1180,2480,28
KIBAALE,2017,1380,1250,2630,28
KIBAALE,2018,1470,1320,2790,28
KIBAALE,2019,1560,1390,2950,28
KIBAALE,2020,1660,1470,3130,28
KIBAALE,2021,1760,1550,3310,28
KIBAALE,2022,1870,1640,3510,28
KIBAALE,2023,1980,1730,3710,28
KIBAALE,2024,2100,1820,3920,28
KIBAALE,2025,2220,1920,4140,28
KIBOGA,2015,950,940,1890,28
KIBOGA,2016,1000,980,1980,28
KIBOGA,2017,1030,1030,2060,28
KIBOGA,2018,1060,1080,2140,28
KIBOGA,2019,1090,1130,2220,28
KIBOGA,2020,1130,1190,2320,28
KIBOGA,2021,1180,1230,2410,28
KIBOGA,2022,1230,1260,2490,28
KIBOGA,2023,1300,1270,2570,28
KIBOGA,2024,1360,1290,2650,28
KIBOGA,2025,1420,1310,2730,28
KIBUKU,2015,920,1170,2090,28
KIBUKU,2016,960,1240,2200,28
KIBUKU,2017,1000,1320,2320,28
KIBUKU,2018,1040,1400,2440,28
KIBUKU,2019,1090,1490,2580,28
KIBUKU,2020,1150,1560,2710,28
KIBUKU,2021,1220,1610,2830,28
KIBUKU,2022,1300,1650,2950,28
KIBUKU,2023,1380,1690,3070,28
KIBUKU,2024,1450,1730,3180,28
KIBUKU,2025,1550,1800,3350,28
KIKUUBE,2015,2340,2450,4790,28
KIKUUBE,2016,2460,2570,5030,28
KIKUUBE,2017,2590,2700,5290,28
KIKUUBE,2018,2730,2840,5570,28
KIKUUBE,2019,2870,2980,5850,28
KIKUUBE,2020,3020,3130,6150,28
KIKUUBE,2021,3180,3280,6460,28
KIKUUBE,2022,3340,3440,6780,28
KIKUUBE,2023,3500,3600,7100,28
KIKUUBE,2024,3680,3770,7450,28
KIKUUBE,2025,3850,3950,7800,28
KIRUHURA,2015,1510,1390,2900,28
KIRUHURA,2016,1570,1440,3010,28
KIRUHURA,2017,1630,1490,3120,28
KIRUHURA,2018,1690,1540,3230,28
KIRUHURA,2019,1750,1590,3340,28
KIRUHURA,2020,1820,1650,3470,28
KIRUHURA,2021,1880,1700,3580,28
KIRUHURA,2022,1950,1760,3710,28
KIRUHURA,2023,2020,1820,3840,28
KIRUHURA,2024,2080,1870,3950,28
KIRUHURA,2025,2150,1930,4080,28
KIRYANDONGO,2015,1690,2070,3760,28
KIRYANDONGO,2016,1760,2180,3940,28
KIRYANDONGO,2017,1830,2280,4110,28
KIRYANDONGO,2018,1890,2410,4300,28
KIRYANDONGO,2019,1970,2520,4490,28
KIRYANDONGO,2020,2050,2630,4680,28
KIRYANDONGO,2021,2160,2690,4850,28
KIRYANDONGO,2022,2280,2740,5020,28
KIRYANDONGO,2023,2390,2780,5170,28
KIRYANDONGO,2024,2520,2820,5340,28
KIRYANDONGO,2025,2640,2890,5530,28
KISORO,2015,1280,2090,3370,28
KISORO,2016,1320,2180,3500,28
KISORO,2017,1360,2280,3640,28
KISORO,2018,1390,2400,3790,28
KISORO,2019,1430,2490,3920,28
KISORO,2020,1480,2570,4050,28
KISORO,2021,1540,2620,4160,28
KISORO,2022,1610,2640,4250,28
KISORO,2023,1670,2660,4330,28
KISORO,2024,1740,2690,4430,28
KISORO,2025,1810,2720,4530,28
KITAGWENDA,2015,1040,1230,2270,28
KITAGWENDA,2016,1090,1270,2360,28
KITAGWENDA,2017,1130,1320,2450,28
KITAGWENDA,2018,1180,1370,2550,28
KITAGWENDA,2019,1220,1410,2630,28
KITAGWENDA,2020,1270,1460,2730,28
KITAGWENDA,2021,1320,1510,2830,28
KITAGWENDA,2022,1370,1560,2930,28
KITAGWENDA,2023,1420,1610,3030,28
KITAGWENDA,2024,1470,1660,3130,28
KITAGWENDA,2025,1520,1710,3230,28
KITGUM,2015,1270,1580,2850,28
KITGUM,2016,1290,1640,2930,28
KITGUM,2017,1320,1710,3030,28
KITGUM,2018,1360,1780,3140,28
KITGUM,2019,1380,1840,3220,28
KITGUM,2020,1430,1890,3320,28
KITGUM,2021,1480,1910,3390,28
KITGUM,2022,1540,1930,3470,28
KITGUM,2023,1600,1940,3540,28
KITGUM,2024,1650,1940,3590,28
KITGUM,2025,1720,1970,3690,28
KOBOKO,2015,1430,1650,3080,28
KOBOKO,2016,1500,1750,3250,28
KOBOKO,2017,1580,1860,3440,28
KOBOKO,2018,1640,1980,3620,28
KOBOKO,2019,1730,2100,3830,28
KOBOKO,2020,1820,2210,4030,28
KOBOKO,2021,1930,2290,4220,28
KOBOKO,2022,2050,2350,4400,28
KOBOKO,2023,2180,2410,4590,28
KOBOKO,2024,2310,2480,4790,28
KOBOKO,2025,2450,2560,5010,28
KOLE,2015,1640,1740,3380,28
KOLE,2016,1690,1790,3480,28
KOLE,2017,1750,1840,3590,28
KOLE,2018,1800,1890,3690,28
KOLE,2019,1860,1950,3810,28
KOLE,2020,1920,2000,3920,28
KOLE,2021,1980,2050,4030,28
KOLE,2022,2040,2110,4150,28
KOLE,2023,2090,2160,4250,28
KOLE,2024,2150,2210,4360,28
KOLE,2025,2210,2270,4480,28
KOTIDO,2015,1410,1850,3260,28
KOTIDO,2016,1460,1940,3400,28
KOTIDO,2017,1500,2030,3530,28
KOTIDO,2018,1550,2130,3680,28
KOTIDO,2019,1600,2220,3820,28
KOTIDO,2020,1650,2290,3940,28
KOTIDO,2021,1730,2340,4070,28
KOTIDO,2022,1810,2370,4180,28
KOTIDO,2023,1910,2390,4300,28
KOTIDO,2024,1990,2420,4410,28
KOTIDO,2025,2070,2450,4520,28
KUMI,2015,1180,1550,2730,28
KUMI,2016,1220,1630,2850,28
KUMI,2017,1270,1720,2990,28
KUMI,2018,1320,1810,3130,28
KUMI,2019,1380,1910,3290,28
KUMI,2020,1440,1990,3430,28
KUMI,2021,1510,2030,3540,28
KUMI,2022,1600,2080,3680,28
KUMI,2023,1680,2110,3790,28
KUMI,2024,1770,2140,3910,28
KUMI,2025,1860,2200,4060,28
KWANIA,2015,1230,1320,2550,28
KWANIA,2016,1270,1360,2630,28
KWANIA,2017,1310,1400,2710,28
KWANIA,2018,1350,1440,2790,28
KWANIA,2019,1390,1470,2860,28
KWANIA,2020,1430,1510,2940,28
KWANIA,2021,1470,1550,3020,28
KWANIA,2022,1510,1590,3100,28
KWANIA,2023,1550,1630,3180,28
KWANIA,2024,1590,1670,3260,28
KWANIA,2025,1640,1710,3350,28
KWEEN,2015,770,700,1470,28
KWEEN,2016,790,720,1510,28
KWEEN,2017,820,740,1560,28
KWEEN,2018,840,760,1600,28
KWEEN,2019,870,770,1640,28
KWEEN,2020,890,790,1680,28
KWEEN,2021,920,810,1730,28
KWEEN,2022,950,830,1780,28
KWEEN,2023,970,840,1810,28
KWEEN,2024,1000,860,1860,28
KWEEN,2025,1020,880,1900,28
KYANKWANZI,2015,2140,1790,3930,28
KYANKWANZI,2016,2250,1880,4130,28
KYANKWANZI,2017,2370,1970,4340,28
KYANKWANZI,2018,2490,2060,4550,28
KYANKWANZI,2019,2610,2150,4760,28
KYANKWANZI,2020,2740,2250,4990,28
KYANKWANZI,2021,2880,2350,5230,28
KYANKWANZI,2022,3020,2450,5470,28
KYANKWANZI,2023,3160,2560,5720,28
KYANKWANZI,2024,3310,2660,5970,28
KYANKWANZI,2025,3460,2780,6240,28
KYEGEGWA,2015,2440,2570,5010,28
KYEGEGWA,2016,2640,2780,5420,28
KYEGEGWA,2017,2860,3000,5860,28
KYEGEGWA,2018,3090,3230,6320,28
KYEGEGWA,2019,3340,3480,6820,28
KYEGEGWA,2020,3610,3750,7360,28
KYEGEGWA,2021,3900,4040,7940,28
KYEGEGWA,2022,4210,4350,8560,28
KYEGEGWA,2023,4540,4680,9220,28
KYEGEGWA,2024,4890,5030,9920,28
KYEGEGWA,2025,5260,5400,10660,28
KYENJOJO,2015,3480,3560,7040,28
KYENJOJO,2016,3620,3690,7310,28
KYENJOJO,2017,3770,3830,7600,28
KYENJOJO,2018,3920,3970,7890,28
KYENJOJO,2019,4080,4110,8190,28
KYENJOJO,2020,4240,4260,8500,28
KYENJOJO,2021,4400,4400,8800,28
KYENJOJO,2022,4570,4560,9130,28
KYENJOJO,2023,4740,4710,9450,28
KYENJOJO,2024,4910,4860,9770,28
KYENJOJO,2025,5090,5020,10110,28
KYOTERA,2015,1430,1640,3070,28
KYOTERA,2016,1460,1710,3170,28
KYOTERA,2017,1490,1780,3270,28
KYOTERA,2018,1530,1840,3370,28
KYOTERA,2019,1560,1910,3470,28
KYOTERA,2020,1610,1950,3560,28
KYOTERA,2021,1670,1980,3650,28
KYOTERA,2022,1730,1980,3710,28
KYOTERA,2023,1800,1990,3790,28
KYOTERA,2024,1870,2000,3870,28
KYOTERA,2025,1940,2020,3960,28
KARENGA,2015,610,590,1200,28
KARENGA,2016,630,600,1230,28
KARENGA,2017,640,610,1250,28
KARENGA,2018,670,630,1300,28
KARENGA,2019,680,640,1320,28
KARENGA,2020,700,660,1360,28
KARENGA,2021,710,670,1380,28
KARENGA,2022,730,680,1410,28
KARENGA,2023,750,700,1450,28
KARENGA,2024,770,720,1490,28
KARENGA,2025,780,730,1510,28
LAMWO,2015,770,1020,1790,28
LAMWO,2016,780,1060,1840,28
LAMWO,2017,790,1090,1880,28
LAMWO,2018,800,1140,1940,28
LAMWO,2019,810,1180,1990,28
LAMWO,2020,830,1210,2040,28
LAMWO,2021,860,1230,2090,28
LAMWO,2022,890,1240,2130,28
LAMWO,2023,910,1230,2140,28
LAMWO,2024,940,1240,2180,28
LAMWO,2025,970,1250,2220,28
LIRA,2015,3640,4270,7910,28
LIRA,2016,3750,4390,8140,28
LIRA,2017,3850,4520,8370,28
LIRA,2018,3960,4640,8600,28
LIRA,2019,4070,4770,8840,28
LIRA,2020,4180,4900,9080,28
LIRA,2021,4280,5030,9310,28
LIRA,2022,4390,5160,9550,28
LIRA,2023,4500,5290,9790,28
LIRA,2024,4600,5420,10020,28
LIRA,2025,4710,5550,10260,28
LUUKA,2015,1130,1430,2560,28
LUUKA,2016,1170,1490,2660,28
LUUKA,2017,1200,1560,2760,28
LUUKA,2018,1230,1630,2860,28
LUUKA,2019,1270,1700,2970,28
LUUKA,2020,1310,1740,3050,28
LUUKA,2021,1360,1780,3140,28
LUUKA,2022,1420,1800,3220,28
LUUKA,2023,1490,1810,3300,28
LUUKA,2024,1550,1830,3380,28
LUUKA,2025,1610,1850,3460,28
LUWERO,2015,2880,3300,6180,28
LUWERO,2016,2970,3460,6430,28
LUWERO,2017,3060,3620,6680,28
LUWERO,2018,3160,3810,6970,28
LUWERO,2019,3260,3970,7230,28
LUWERO,2020,3400,4100,7500,28
LUWERO,2021,3550,4190,7740,28
LUWERO,2022,3720,4250,7970,28
LUWERO,2023,3900,4280,8180,28
LUWERO,2024,4080,4330,8410,28
LUWERO,2025,4260,4410,8670,28
LWENGO,2015,1380,1720,3100,28
LWENGO,2016,1410,1770,3180,28
LWENGO,2017,1430,1840,3270,28
LWENGO,2018,1460,1900,3360,28
LWENGO,2019,1490,1960,3450,28
LWENGO,2020,1530,2000,3530,28
LWENGO,2021,1570,2020,3590,28
LWENGO,2022,1620,2020,3640,28
LWENGO,2023,1670,2010,3680,28
LWENGO,2024,1720,2010,3730,28
LWENGO,2025,1780,2020,3800,28
LYANTONDE,2015,590,650,1240,28
LYANTONDE,2016,610,680,1290,28
LYANTONDE,2017,630,710,1340,28
LYANTONDE,2018,660,740,1400,28
LYANTONDE,2019,680,780,1460,28
LYANTONDE,2020,710,820,1530,28
LYANTONDE,2021,740,870,1610,28
LYANTONDE,2022,760,900,1660,28
LYANTONDE,2023,800,920,1720,28
LYANTONDE,2024,850,940,1790,28
LYANTONDE,2025,890,960,1850,28
MANAFWA,2015,850,1030,1880,28
MANAFWA,2016,870,1050,1920,28
MANAFWA,2017,890,1080,1970,28
MANAFWA,2018,910,1100,2010,28
MANAFWA,2019,930,1120,2050,28
MANAFWA,2020,950,1150,2100,28
MANAFWA,2021,980,1170,2150,28
MANAFWA,2022,1000,1190,2190,28
MANAFWA,2023,1020,1220,2240,28
MANAFWA,2024,1040,1240,2280,28
MANAFWA,2025,1060,1260,2320,28
MARACHA,2015,1090,1670,2760,28
MARACHA,2016,1110,1700,2810,28
MARACHA,2017,1140,1740,2880,28
MARACHA,2018,1160,1770,2930,28
MARACHA,2019,1180,1800,2980,28
MARACHA,2020,1210,1840,3050,28
MARACHA,2021,1230,1870,3100,28
MARACHA,2022,1250,1900,3150,28
MARACHA,2023,1270,1930,3200,28
MARACHA,2024,1300,1960,3260,28
MARACHA,2025,1320,1990,3310,28
MASAKA,2015,2130,2510,4640,28
MASAKA,2016,2190,2620,4810,28
MASAKA,2017,2250,2740,4990,28
MASAKA,2018,2310,2860,5170,28
MASAKA,2019,2380,2990,5370,28
MASAKA,2020,2480,3080,5560,28
MASAKA,2021,2580,3140,5720,28
MASAKA,2022,2700,3170,5870,28
MASAKA,2023,2830,3200,6030,28
MASAKA,2024,2940,3230,6170,28
MASAKA,2025,3060,3280,6340,28
MASINDI,2015,2890,2670,5560,28
MASINDI,2016,2970,2740,5710,28
MASINDI,2017,3060,2820,5880,28
MASINDI,2018,3150,2890,6040,28
MASINDI,2019,3230,2970,6200,28
MASINDI,2020,3320,3040,6360,28
MASINDI,2021,3410,3110,6520,28
MASINDI,2022,3500,3190,6690,28
MASINDI,2023,3590,3260,6850,28
MASINDI,2024,3680,3340,7020,28
MASINDI,2025,3770,3410,7180,28
MAYUGE,2015,2600,3330,5930,28
MAYUGE,2016,2700,3510,6210,28
MAYUGE,2017,2800,3710,6510,28
MAYUGE,2018,2910,3910,6820,28
MAYUGE,2019,3020,4130,7150,28
MAYUGE,2020,3160,4300,7460,28
MAYUGE,2021,3330,4420,7750,28
MAYUGE,2022,3510,4510,8020,28
MAYUGE,2023,3700,4590,8290,28
MAYUGE,2024,3900,4690,8590,28
MAYUGE,2025,4100,4800,8900,28
MBALE,2015,2940,3760,6700,28
MBALE,2016,3050,3980,7030,28
MBALE,2017,3170,4210,7380,28
MBALE,2018,3280,4460,7740,28
MBALE,2019,3410,4710,8120,28
MBALE,2020,3560,4910,8470,28
MBALE,2021,3740,5070,8810,28
MBALE,2022,3950,5190,9140,28
MBALE,2023,4160,5290,9450,28
MBALE,2024,4360,5410,9770,28
MBALE,2025,4580,5570,10150,28
MBARARA,2015,3590,3790,7380,28
MBARARA,2016,3680,3870,7550,28
MBARARA,2017,3760,3960,7720,28
MBARARA,2018,3850,4040,7890,28
MBARARA,2019,3930,4130,8060,28
MBARARA,2020,4020,4210,8230,28
MBARARA,2021,4100,4290,8390,28
MBARARA,2022,4180,4370,8550,28
MBARARA,2023,4270,4450,8720,28
MBARARA,2024,4340,4520,8860,28
MBARARA,2025,4420,4600,9020,28
MITOOMA,2015,1010,1410,2420,28
MITOOMA,2016,1020,1430,2450,28
MITOOMA,2017,1030,1440,2470,28
MITOOMA,2018,1050,1450,2500,28
MITOOMA,2019,1060,1460,2520,28
MITOOMA,2020,1070,1480,2550,28
MITOOMA,2021,1080,1490,2570,28
MITOOMA,2022,1090,1500,2590,28
MITOOMA,2023,1100,1500,2600,28
MITOOMA,2024,1110,1510,2620,28
MITOOMA,2025,1120,1520,2640,28
MITYANA,2015,2030,2140,4170,28
MITYANA,2016,2090,2230,4320,28
MITYANA,2017,2140,2320,4460,28
MITYANA,2018,2190,2420,4610,28
MITYANA,2019,2250,2500,4750,28
MITYANA,2020,2320,2570,4890,28
MITYANA,2021,2420,2610,5030,28
MITYANA,2022,2510,2620,5130,28
MITYANA,2023,2610,2630,5240,28
MITYANA,2024,2720,2640,5360,28
MITYANA,2025,2820,2670,5490,28
MOROTO,2015,780,800,1580,28
MOROTO,2016,800,840,1640,28
MOROTO,2017,830,880,1710,28
MOROTO,2018,850,930,1780,28
MOROTO,2019,880,970,1850,28
MOROTO,2020,910,1000,1910,28
MOROTO,2021,950,1030,1980,28
MOROTO,2022,990,1050,2040,28
MOROTO,2023,1030,1060,2090,28
MOROTO,2024,1080,1070,2150,28
MOROTO,2025,1130,1100,2230,28
MOYO,2015,690,790,1480,28
MOYO,2016,710,810,1520,28
MOYO,2017,730,820,1550,28
MOYO,2018,750,840,1590,28
MOYO,2019,770,860,1630,28
MOYO,2020,780,880,1660,28
MOYO,2021,800,890,1690,28
MOYO,2022,820,910,1730,28
MOYO,2023,840,930,1770,28
MOYO,2024,860,940,1800,28
MOYO,2025,870,960,1830,28
MPIGI,2015,1700,1810,3510,28
MPIGI,2016,1750,1890,3640,28
MPIGI,2017,1800,1990,3790,28
MPIGI,2018,1860,2080,3940,28
MPIGI,2019,1920,2180,4100,28
MPIGI,2020,1990,2260,4250,28
MPIGI,2021,2080,2300,4380,28
MPIGI,2022,2180,2330,4510,28
MPIGI,2023,2290,2360,4650,28
MPIGI,2024,2380,2390,4770,28
MPIGI,2025,2480,2420,4900,28
MUBENDE,2015,3180,3180,6360,28
MUBENDE,2016,3360,3410,6770,28
MUBENDE,2017,3560,3680,7240,28
MUBENDE,2018,3780,3970,7750,28
MUBENDE,2019,4010,4260,8270,28
MUBENDE,2020,4280,4520,8800,28
MUBENDE,2021,4600,4750,9350,28
MUBENDE,2022,4950,4950,9900,28
MUBENDE,2023,5340,5140,10480,28
MUBENDE,2024,5720,5340,11060,28
MUBENDE,2025,6150,5590,11740,28
MUKONO,2015,4400,5200,9600,28
MUKONO,2016,4560,5470,10030,28
MUKONO,2017,4710,5770,10480,28
MUKONO,2018,4860,6100,10960,28
MUKONO,2019,5040,6410,11450,28
MUKONO,2020,5250,6660,11910,28
MUKONO,2021,5510,6850,12360,28
MUKONO,2022,5780,6990,12770,28
MUKONO,2023,6070,7100,13170,28
MUKONO,2024,6360,7230,13590,28
MUKONO,2025,6650,7410,14060,28
MADI OKOLLO,2015,990,1330,2320,28
MADI OKOLLO,2016,1020,1370,2390,28
MADI OKOLLO,2017,1050,1400,2450,28
MADI OKOLLO,2018,1080,1440,2520,28
MADI OKOLLO,2019,1110,1480,2590,28
MADI OKOLLO,2020,1140,1520,2660,28
MADI OKOLLO,2021,1170,1560,2730,28
MADI OKOLLO,2022,1200,1600,2800,28
MADI OKOLLO,2023,1240,1630,2870,28
MADI OKOLLO,2024,1260,1670,2930,28
MADI OKOLLO,2025,1290,1700,2990,28
NABILATUK,2015,480,670,1150,28
NABILATUK,2016,510,720,1230,28
NABILATUK,2017,540,770,1310,28
NABILATUK,2018,570,830,1400,28
NABILATUK,2019,610,880,1490,28
NABILATUK,2020,640,930,1570,28
NABILATUK,2021,690,970,1660,28
NABILATUK,2022,740,1000,1740,28
NABILATUK,2023,800,1030,1830,28
NABILATUK,2024,860,1070,1930,28
NABILATUK,2025,910,1110,2020,28
NAKAPIRIPIRIT,2015,680,780,1460,28
NAKAPIRIPIRIT,2016,710,840,1550,28
NAKAPIRIPIRIT,2017,750,890,1640,28
NAKAPIRIPIRIT,2018,790,960,1750,28
NAKAPIRIPIRIT,2019,840,1020,1860,28
NAKAPIRIPIRIT,2020,880,1080,1960,28
NAKAPIRIPIRIT,2021,940,1110,2050,28
NAKAPIRIPIRIT,2022,1010,1150,2160,28
NAKAPIRIPIRIT,2023,1070,1190,2260,28
NAKAPIRIPIRIT,2024,1140,1240,2380,28
NAKAPIRIPIRIT,2025,1220,1280,2500,28
NAKASEKE,2015,2040,1610,3650,28
NAKASEKE,2016,2110,1650,3760,28
NAKASEKE,2017,2190,1690,3880,28
NAKASEKE,2018,2270,1730,4000,28
NAKASEKE,2019,2350,1770,4120,28
NAKASEKE,2020,2430,1810,4240,28
NAKASEKE,2021,2510,1850,4360,28
NAKASEKE,2022,2600,1890,4490,28
NAKASEKE,2023,2680,1930,4610,28
NAKASEKE,2024,2770,1970,4740,28
NAKASEKE,2025,2850,2000,4850,28
NAKASONGOLA,2015,1390,1270,2660,28
NAKASONGOLA,2016,1450,1330,2780,28
NAKASONGOLA,2017,1500,1400,2900,28
NAKASONGOLA,2018,1560,1470,3030,28
NAKASONGOLA,2019,1620,1540,3160,28
NAKASONGOLA,2020,1700,1610,3310,28
NAKASONGOLA,2021,1790,1640,3430,28
NAKASONGOLA,2022,1890,1670,3560,28
NAKASONGOLA,2023,1990,1690,3680,28
NAKASONGOLA,2024,2090,1730,3820,28
NAKASONGOLA,2025,2200,1760,3960,28
NAMAYINGO,2015,1280,1490,2770,28
NAMAYINGO,2016,1320,1540,2860,28
NAMAYINGO,2017,1350,1600,2950,28
NAMAYINGO,2018,1380,1670,3050,28
NAMAYINGO,2019,1420,1730,3150,28
NAMAYINGO,2020,1460,1770,3230,28
NAMAYINGO,2021,1520,1800,3320,28
NAMAYINGO,2022,1590,1810,3400,28
NAMAYINGO,2023,1650,1810,3460,28
NAMAYINGO,2024,1710,1820,3530,28
NAMAYINGO,2025,1780,1830,3610,28
NAMISINDWA,2015,1160,1370,2530,28
NAMISINDWA,2016,1200,1400,2600,28
NAMISINDWA,2017,1230,1430,2660,28
NAMISINDWA,2018,1260,1460,2720,28
NAMISINDWA,2019,1300,1500,2800,28
NAMISINDWA,2020,1330,1530,2860,28
NAMISINDWA,2021,1370,1570,2940,28
NAMISINDWA,2022,1400,1600,3000,28
NAMISINDWA,2023,1440,1630,3070,28
NAMISINDWA,2024,1470,1660,3130,28
NAMISINDWA,2025,1500,1690,3190,28
NAMUTUMBA,2015,1150,1520,2670,28
NAMUTUMBA,2016,1200,1600,2800,28
NAMUTUMBA,2017,1250,1700,2950,28
NAMUTUMBA,2018,1300,1800,3100,28
NAMUTUMBA,2019,1360,1890,3250,28
NAMUTUMBA,2020,1430,1980,3410,28
NAMUTUMBA,2021,1500,2030,3530,28
NAMUTUMBA,2022,1600,2090,3690,28
NAMUTUMBA,2023,1690,2120,3810,28
NAMUTUMBA,2024,1790,2170,3960,28
NAMUTUMBA,2025,1880,2230,4110,28
NAPAK,2015,1000,1470,2470,28
NAPAK,2016,1020,1530,2550,28
NAPAK,2017,1040,1600,2640,28
NAPAK,2018,1070,1680,2750,28
NAPAK,2019,1090,1740,2830,28
NAPAK,2020,1130,1800,2930,28
NAPAK,2021,1170,1840,3010,28
NAPAK,2022,1220,1850,3070,28
NAPAK,2023,1260,1870,3130,28
NAPAK,2024,1310,1890,3200,28
NAPAK,2025,1350,1920,3270,28
NEBBI,2015,1440,1880,3320,28
NEBBI,2016,1490,1930,3420,28
NEBBI,2017,1530,1990,3520,28
NEBBI,2018,1580,2040,3620,28
NEBBI,2019,1630,2100,3730,28
NEBBI,2020,1680,2150,3830,28
NEBBI,2021,1730,2210,3940,28
NEBBI,2022,1780,2270,4050,28
NEBBI,2023,1830,2330,4160,28
NEBBI,2024,1880,2380,4260,28
NEBBI,2025,1930,2440,4370,28
NGORA,2015,760,890,1650,28
NGORA,2016,780,940,1720,28
NGORA,2017,810,990,1800,28
NGORA,2018,840,1040,1880,28
NGORA,2019,870,1090,1960,28
NGORA,2020,910,1130,2040,28
NGORA,2021,950,1160,2110,28
NGORA,2022,1000,1180,2180,28
NGORA,2023,1050,1190,2240,28
NGORA,2024,1100,1210,2310,28
NGORA,2025,1160,1240,2400,28
NTOROKO,2015,520,530,1050,28
NTOROKO,2016,540,550,1090,28
NTOROKO,2017,550,580,1130,28
NTOROKO,2018,570,600,1170,28
NTOROKO,2019,590,620,1210,28
NTOROKO,2020,610,640,1250,28
NTOROKO,2021,640,650,1290,28
NTOROKO,2022,670,660,1330,28
NTOROKO,2023,700,670,1370,28
NTOROKO,2024,730,670,1400,28
NTOROKO,2025,760,680,1440,28
NTUNGAMO,2015,3330,3870,7200,28
NTUNGAMO,2016,3410,3940,7350,28
NTUNGAMO,2017,3480,4010,7490,28
NTUNGAMO,2018,3550,4090,7640,28
NTUNGAMO,2019,3630,4160,7790,28
NTUNGAMO,2020,3700,4230,7930,28
NTUNGAMO,2021,3770,4300,8070,28
NTUNGAMO,2022,3840,4370,8210,28
NTUNGAMO,2023,3910,4430,8340,28
NTUNGAMO,2024,3970,4500,8470,28
NTUNGAMO,2025,4040,4560,8600,28
NWOYA,2015,1000,1110,2110,28
NWOYA,2016,1110,1230,2340,28
NWOYA,2017,1220,1350,2570,28
NWOYA,2018,1350,1490,2840,28
NWOYA,2019,1490,1640,3130,28
NWOYA,2020,1650,1800,3450,28
NWOYA,2021,1810,1980,3790,28
NWOYA,2022,2000,2180,4180,28
NWOYA,2023,2200,2390,4590,28
NWOYA,2024,2420,2630,5050,28
NWOYA,2025,2660,2880,5540,28
OBONGI,2015,260,300,560,28
OBONGI,2016,270,320,590,28
OBONGI,2017,280,330,610,28
OBONGI,2018,290,350,640,28
OBONGI,2019,300,360,660,28
OBONGI,2020,310,370,680,28
OBONGI,2021,320,380,700,28
OBONGI,2022,340,390,730,28
OBONGI,2023,350,390,740,28
OBONGI,2024,370,390,760,28
OBONGI,2025,390,400,790,28
OMORO,2015,950,1070,2020,28
OMORO,2016,990,1130,2120,28
OMORO,2017,1030,1200,2230,28
OMORO,2018,1080,1270,2350,28
OMORO,2019,1120,1350,2470,28
OMORO,2020,1180,1400,2580,28
OMORO,2021,1250,1460,2710,28
OMORO,2022,1320,1490,2810,28
OMORO,2023,1390,1520,2910,28
OMORO,2024,1470,1560,3030,28
OMORO,2025,1560,1610,3170,28
OTUKE,2015,750,940,1690,28
OTUKE,2016,780,980,1760,28
OTUKE,2017,810,1020,1830,28
OTUKE,2018,850,1060,1910,28
OTUKE,2019,890,1110,2000,28
OTUKE,2020,930,1160,2090,28
OTUKE,2021,970,1200,2170,28
OTUKE,2022,1010,1250,2260,28
OTUKE,2023,1050,1300,2350,28
OTUKE,2024,1090,1350,2440,28
OTUKE,2025,1130,1400,2530,28
OYAM,2015,2630,3010,5640,28
OYAM,2016,2710,3100,5810,28
OYAM,2017,2800,3190,5990,28
OYAM,2018,2880,3290,6170,28
OYAM,2019,2970,3380,6350,28
OYAM,2020,3050,3470,6520,28
OYAM,2021,3140,3570,6710,28
OYAM,2022,3230,3660,6890,28
OYAM,2023,3310,3760,7070,28
OYAM,2024,3400,3850,7250,28
OYAM,2025,3490,3950,7440,28
PADER,2015,1040,1310,2350,28
PADER,2016,1060,1370,2430,28
PADER,2017,1090,1430,2520,28
PADER,2018,1120,1490,2610,28
PADER,2019,1140,1550,2690,28
PADER,2020,1180,1600,2780,28
PADER,2021,1220,1630,2850,28
PADER,2022,1270,1640,2910,28
PADER,2023,1320,1650,2970,28
PADER,2024,1370,1670,3040,28
PADER,2025,1420,1690,3110,28
PAKWACH,2015,1090,1450,2540,28
PAKWACH,2016,1140,1510,2650,28
PAKWACH,2017,1190,1560,2750,28
PAKWACH,2018,1240,1620,2860,28
PAKWACH,2019,1290,1680,2970,28
PAKWACH,2020,1340,1730,3070,28
PAKWACH,2021,1390,1790,3180,28
PAKWACH,2022,1440,1850,3290,28
PAKWACH,2023,1500,1920,3420,28
PAKWACH,2024,1560,1980,3540,28
PAKWACH,2025,1610,2040,3650,28
PALLISA,2015,1300,1610,2910,28
PALLISA,2016,1370,1710,3080,28
PALLISA,2017,1440,1840,3280,28
PALLISA,2018,1520,1970,3490,28
PALLISA,2019,1600,2090,3690,28
PALLISA,2020,1690,2210,3900,28
PALLISA,2021,1800,2300,4100,28
PALLISA,2022,1920,2380,4300,28
PALLISA,2023,2050,2450,4500,28
PALLISA,2024,2190,2520,4710,28
PALLISA,2025,2340,2620,4960,28
RAKAI,2015,1520,1890,3410,28
RAKAI,2016,1560,1970,3530,28
RAKAI,2017,1610,2070,3680,28
RAKAI,2018,1670,2170,3840,28
RAKAI,2019,1730,2270,4000,28
RAKAI,2020,1790,2340,4130,28
RAKAI,2021,1880,2400,4280,28
RAKAI,2022,1970,2430,4400,28
RAKAI,2023,2060,2450,4510,28
RAKAI,2024,2150,2480,4630,28
RAKAI,2025,2250,2520,4770,28
RUBANDA,2015,1210,1550,2760,28
RUBANDA,2016,1220,1560,2780,28
RUBANDA,2017,1240,1570,2810,28
RUBANDA,2018,1250,1580,2830,28
RUBANDA,2019,1270,1590,2860,28
RUBANDA,2020,1290,1610,2900,28
RUBANDA,2021,1300,1620,2920,28
RUBANDA,2022,1310,1620,2930,28
RUBANDA,2023,1330,1630,2960,28
RUBANDA,2024,1340,1640,2980,28
RUBANDA,2025,1350,1640,2990,28
RUBIRIZI,2015,860,1190,2050,28
RUBIRIZI,2016,880,1210,2090,28
RUBIRIZI,2017,900,1230,2130,28
RUBIRIZI,2018,910,1260,2170,28
RUBIRIZI,2019,930,1280,2210,28
RUBIRIZI,2020,950,1300,2250,28
RUBIRIZI,2021,970,1320,2290,28
RUBIRIZI,2022,980,1350,2330,28
RUBIRIZI,2023,1000,1370,2370,28
RUBIRIZI,2024,1020,1390,2410,28
RUBIRIZI,2025,1030,1410,2440,28
RUKIGA,2015,660,760,1420,28
RUKIGA,2016,670,770,1440,28
RUKIGA,2017,680,780,1460,28
RUKIGA,2018,680,780,1460,28
RUKIGA,2019,690,790,1480,28
RUKIGA,2020,700,790,1490,28
RUKIGA,2021,700,790,1490,28
RUKIGA,2022,710,800,1510,28
RUKIGA,2023,710,800,1510,28
RUKIGA,2024,720,800,1520,28
RUKIGA,2025,720,810,1530,28
RUKUNGIRI,2015,2030,2550,4580,28
RUKUNGIRI,2016,2060,2570,4630,28
RUKUNGIRI,2017,2080,2600,4680,28
RUKUNGIRI,2018,2110,2620,4730,28
RUKUNGIRI,2019,2130,2640,4770,28
RUKUNGIRI,2020,2150,2670,4820,28
RUKUNGIRI,2021,2170,2690,4860,28
RUKUNGIRI,2022,2190,2710,4900,28
RUKUNGIRI,2023,2210,2720,4930,28
RUKUNGIRI,2024,2230,2740,4970,28
RUKUNGIRI,2025,2250,2750,5000,28
RWAMPARA,2015,880,1040,1920,28
RWAMPARA,2016,900,1060,1960,28
RWAMPARA,2017,930,1080,2010,28
RWAMPARA,2018,940,1110,2050,28
RWAMPARA,2019,970,1130,2100,28
RWAMPARA,2020,990,1150,2140,28
RWAMPARA,2021,1010,1170,2180,28
RWAMPARA,2022,1030,1200,2230,28
RWAMPARA,2023,1050,1220,2270,28
RWAMPARA,2024,1070,1240,2310,28
RWAMPARA,2025,1080,1260,2340,28
SERERE,2015,1570,1850,3420,28
SERERE,2016,1640,1970,3610,28
SERERE,2017,1730,2100,3830,28
SERERE,2018,1800,2240,4040,28
SERERE,2019,1900,2380,4280,28
SERERE,2020,2000,2490,4490,28
SERERE,2021,2120,2580,4700,28
SERERE,2022,2260,2670,4930,28
SERERE,2023,2410,2730,5140,28
SERERE,2024,2560,2820,5380,28
SERERE,2025,2700,2910,5610,28
SHEEMA,2015,1420,1740,3160,28
SHEEMA,2016,1440,1760,3200,28
SHEEMA,2017,1460,1780,3240,28
SHEEMA,2018,1470,1790,3260,28
SHEEMA,2019,1490,1810,3300,28
SHEEMA,2020,1510,1830,3340,28
SHEEMA,2021,1520,1840,3360,28
SHEEMA,2022,1540,1860,3400,28
SHEEMA,2023,1550,1870,3420,28
SHEEMA,2024,1560,1880,3440,28
SHEEMA,2025,1570,1900,3470,28
SIRONKO,2015,1530,1550,3080,28
SIRONKO,2016,1570,1580,3150,28
SIRONKO,2017,1600,1610,3210,28
SIRONKO,2018,1640,1640,3280,28
SIRONKO,2019,1680,1670,3350,28
SIRONKO,2020,1720,1710,3430,28
SIRONKO,2021,1750,1740,3490,28
SIRONKO,2022,1790,1770,3560,28
SIRONKO,2023,1830,1800,3630,28
SIRONKO,2024,1860,1830,3690,28
SIRONKO,2025,1900,1860,3760,28
SOROTI,2015,1930,2220,4150,28
SOROTI,2016,2010,2350,4360,28
SOROTI,2017,2100,2490,4590,28
SOROTI,2018,2190,2640,4830,28
SOROTI,2019,2290,2790,5080,28
SOROTI,2020,2400,2920,5320,28
SOROTI,2021,2540,3020,5560,28
SOROTI,2022,2700,3090,5790,28
SOROTI,2023,2850,3160,6010,28
SOROTI,2024,3010,3240,6250,28
SOROTI,2025,3180,3330,6510,28
SSEMBABULE,2015,1520,1680,3200,28
SSEMBABULE,2016,1570,1760,3330,28
SSEMBABULE,2017,1630,1850,3480,28
SSEMBABULE,2018,1680,1950,3630,28
SSEMBABULE,2019,1740,2040,3780,28
SSEMBABULE,2020,1820,2120,3940,28
SSEMBABULE,2021,1910,2170,4080,28
SSEMBABULE,2022,2010,2210,4220,28
SSEMBABULE,2023,2120,2240,4360,28
SSEMBABULE,2024,2210,2270,4480,28
SSEMBABULE,2025,2330,2320,4650,28
TORORO,2015,2890,3580,6470,28
TORORO,2016,2960,3670,6630,28
TORORO,2017,3040,3760,6800,28
TORORO,2018,3120,3860,6980,28
TORORO,2019,3200,3950,7150,28
TORORO,2020,3280,4040,7320,28
TORORO,2021,3360,4130,7490,28
TORORO,2022,3440,4230,7670,28
TORORO,2023,3520,4320,7840,28
TORORO,2024,3600,4410,8010,28
TORORO,2025,3680,4500,8180,28
WAKISO,2015,23620,27920,51540,28
WAKISO,2016,25200,29830,55030,28
WAKISO,2017,26890,31870,58760,28
WAKISO,2018,28670,34030,62700,28
WAKISO,2019,30580,36310,66890,28
WAKISO,2020,32570,38730,71300,28
WAKISO,2021,34670,41300,75970,28
WAKISO,2022,36890,44020,80910,28
WAKISO,2023,39230,46850,86080,28
WAKISO,2024,41670,49830,91500,28
WAKISO,2025,44240,53010,97250,28
YUMBE,2015,2380,3620,6000,28
YUMBE,2016,2520,3920,6440,28
YUMBE,2017,2660,4260,6920,28
YUMBE,2018,2820,4630,7450,28
YUMBE,2019,2990,5010,8000,28
YUMBE,2020,3190,5360,8550,28
YUMBE,2021,3420,5670,9090,28
YUMBE,2022,3680,5950,9630,28
YUMBE,2023,3950,6220,10170,28
YUMBE,2024,4230,6520,10750,28
YUMBE,2025,4530,6870,11400,28
ZOMBO,2015,1470,1960,3430,28
ZOMBO,2016,1510,2020,3530,28
ZOMBO,2017,1560,2080,3640,28
ZOMBO,2018,1610,2130,3740,28
ZOMBO,2019,1660,2190,3850,28
ZOMBO,2020,1700,2250,3950,28
ZOMBO,2021,1750,2310,4060,28
ZOMBO,2022,1800,2360,4160,28
ZOMBO,2023,1850,2420,4270,28
ZOMBO,2024,1900,2480,4380,28
ZOMBO,2025,1950,2540,4490,28
ABIM,2015,630,670,1300,29
ABIM,2016,670,730,1400,29
ABIM,2017,720,800,1520,29
ABIM,2018,770,870,1640,29
ABIM,2019,830,940,1770,29
ABIM,2020,890,1010,1900,29
ABIM,2021,960,1090,2050,29
ABIM,2022,1030,1150,2180,29
ABIM,2023,1130,1210,2340,29
ABIM,2024,1220,1260,2480,29
ABIM,2025,1340,1330,2670,29
ADJUMANI,2015,990,1560,2550,29
ADJUMANI,2016,1000,1580,2580,29
ADJUMANI,2017,1010,1590,2600,29
ADJUMANI,2018,1020,1610,2630,29
ADJUMANI,2019,1020,1630,2650,29
ADJUMANI,2020,1030,1640,2670,29
ADJUMANI,2021,1030,1650,2680,29
ADJUMANI,2022,1040,1660,2700,29
ADJUMANI,2023,1040,1670,2710,29
ADJUMANI,2024,1050,1680,2730,29
ADJUMANI,2025,1050,1690,2740,29
AGAGO,2015,890,1290,2180,29
AGAGO,2016,900,1320,2220,29
AGAGO,2017,920,1340,2260,29
AGAGO,2018,940,1360,2300,29
AGAGO,2019,950,1390,2340,29
AGAGO,2020,970,1410,2380,29
AGAGO,2021,980,1430,2410,29
AGAGO,2022,1000,1450,2450,29
AGAGO,2023,1010,1470,2480,29
AGAGO,2024,1020,1490,2510,29
AGAGO,2025,1040,1510,2550,29
ALEBTONG,2015,1350,1600,2950,29
ALEBTONG,2016,1400,1670,3070,29
ALEBTONG,2017,1450,1750,3200,29
ALEBTONG,2018,1500,1840,3340,29
ALEBTONG,2019,1540,1950,3490,29
ALEBTONG,2020,1610,2040,3650,29
ALEBTONG,2021,1670,2120,3790,29
ALEBTONG,2022,1760,2160,3920,29
ALEBTONG,2023,1840,2200,4040,29
ALEBTONG,2024,1940,2240,4180,29
ALEBTONG,2025,2030,2280,4310,29
AMOLATAR,2015,910,980,1890,29
AMOLATAR,2016,960,1020,1980,29
AMOLATAR,2017,990,1090,2080,29
AMOLATAR,2018,1020,1140,2160,29
AMOLATAR,2019,1060,1200,2260,29
AMOLATAR,2020,1100,1270,2370,29
AMOLATAR,2021,1150,1310,2460,29
AMOLATAR,2022,1210,1340,2550,29
AMOLATAR,2023,1270,1370,2640,29
AMOLATAR,2024,1340,1390,2730,29
AMOLATAR,2025,1400,1400,2800,29
AMUDAT,2015,660,620,1280,29
AMUDAT,2016,690,660,1350,29
AMUDAT,2017,720,710,1430,29
AMUDAT,2018,760,750,1510,29
AMUDAT,2019,790,810,1600,29
AMUDAT,2020,840,870,1710,29
AMUDAT,2021,870,920,1790,29
AMUDAT,2022,930,960,1890,29
AMUDAT,2023,990,1000,1990,29
AMUDAT,2024,1050,1030,2080,29
AMUDAT,2025,1110,1060,2170,29
AMURIA,2015,930,1100,2030,29
AMURIA,2016,970,1170,2140,29
AMURIA,2017,1010,1240,2250,29
AMURIA,2018,1060,1320,2380,29
AMURIA,2019,1100,1390,2490,29
AMURIA,2020,1150,1480,2630,29
AMURIA,2021,1220,1530,2750,29
AMURIA,2022,1280,1590,2870,29
AMURIA,2023,1370,1630,3000,29
AMURIA,2024,1440,1660,3100,29
AMURIA,2025,1530,1700,3230,29
AMURU,2015,930,1150,2080,29
AMURU,2016,960,1200,2160,29
AMURU,2017,990,1260,2250,29
AMURU,2018,1020,1320,2340,29
AMURU,2019,1050,1390,2440,29
AMURU,2020,1080,1460,2540,29
AMURU,2021,1140,1510,2650,29
AMURU,2022,1190,1550,2740,29
AMURU,2023,1250,1580,2830,29
AMURU,2024,1310,1590,2900,29
AMURU,2025,1360,1620,2980,29
APAC,2015,1110,1230,2340,29
APAC,2016,1150,1270,2420,29
APAC,2017,1190,1310,2500,29
APAC,2018,1240,1360,2600,29
APAC,2019,1280,1400,2680,29
APAC,2020,1330,1450,2780,29
APAC,2021,1370,1500,2870,29
APAC,2022,1420,1550,2970,29
APAC,2023,1470,1590,3060,29
APAC,2024,1510,1640,3150,29
APAC,2025,1560,1690,3250,29
ARUA,2015,3090,3930,7020,29
ARUA,2016,3180,4030,7210,29
ARUA,2017,3270,4150,7420,29
ARUA,2018,3370,4260,7630,29
ARUA,2019,3460,4370,7830,29
ARUA,2020,3550,4480,8030,29
ARUA,2021,3650,4590,8240,29
ARUA,2022,3740,4700,8440,29
ARUA,2023,3840,4820,8660,29
ARUA,2024,3930,4930,8860,29
ARUA,2025,4030,5040,9070,29
BUDAKA,2015,960,1260,2220,29
BUDAKA,2016,1010,1320,2330,29
BUDAKA,2017,1050,1390,2440,29
BUDAKA,2018,1110,1480,2590,29
BUDAKA,2019,1150,1570,2720,29
BUDAKA,2020,1200,1660,2860,29
BUDAKA,2021,1250,1730,2980,29
BUDAKA,2022,1330,1790,3120,29
BUDAKA,2023,1410,1830,3240,29
BUDAKA,2024,1500,1870,3370,29
BUDAKA,2025,1570,1910,3480,29
BUDUDA,2015,1160,1160,2320,29
BUDUDA,2016,1230,1240,2470,29
BUDUDA,2017,1300,1320,2620,29
BUDUDA,2018,1350,1420,2770,29
BUDUDA,2019,1420,1520,2940,29
BUDUDA,2020,1510,1620,3130,29
BUDUDA,2021,1590,1710,3300,29
BUDUDA,2022,1690,1780,3470,29
BUDUDA,2023,1820,1850,3670,29
BUDUDA,2024,1940,1890,3830,29
BUDUDA,2025,2060,1960,4020,29
BUGIRI,2015,1890,2490,4380,29
BUGIRI,2016,1990,2630,4620,29
BUGIRI,2017,2090,2800,4890,29
BUGIRI,2018,2190,2990,5180,29
BUGIRI,2019,2290,3180,5470,29
BUGIRI,2020,2410,3370,5780,29
BUGIRI,2021,2540,3530,6070,29
BUGIRI,2022,2690,3670,6360,29
BUGIRI,2023,2870,3770,6640,29
BUGIRI,2024,3050,3870,6920,29
BUGIRI,2025,3240,3980,7220,29
BUGWERI,2015,650,1070,1720,29
BUGWERI,2016,670,1110,1780,29
BUGWERI,2017,700,1170,1870,29
BUGWERI,2018,720,1230,1950,29
BUGWERI,2019,740,1290,2030,29
BUGWERI,2020,770,1360,2130,29
BUGWERI,2021,800,1400,2200,29
BUGWERI,2022,840,1440,2280,29
BUGWERI,2023,890,1460,2350,29
BUGWERI,2024,920,1470,2390,29
BUGWERI,2025,970,1500,2470,29
BUHWEJU,2015,610,720,1330,29
BUHWEJU,2016,630,740,1370,29
BUHWEJU,2017,650,760,1410,29
BUHWEJU,2018,680,780,1460,29
BUHWEJU,2019,700,810,1510,29
BUHWEJU,2020,720,830,1550,29
BUHWEJU,2021,740,850,1590,29
BUHWEJU,2022,760,880,1640,29
BUHWEJU,2023,780,900,1680,29
BUHWEJU,2024,810,920,1730,29
BUHWEJU,2025,830,950,1780,29
BUIKWE,2015,2680,3080,5760,29
BUIKWE,2016,2760,3190,5950,29
BUIKWE,2017,2830,3330,6160,29
BUIKWE,2018,2910,3490,6400,29
BUIKWE,2019,2980,3650,6630,29
BUIKWE,2020,3070,3790,6860,29
BUIKWE,2021,3180,3910,7090,29
BUIKWE,2022,3300,3980,7280,29
BUIKWE,2023,3450,4020,7470,29
BUIKWE,2024,3590,4050,7640,29
BUIKWE,2025,3730,4090,7820,29
BUKEDEA,2015,990,1200,2190,29
BUKEDEA,2016,1040,1270,2310,29
BUKEDEA,2017,1090,1350,2440,29
BUKEDEA,2018,1140,1440,2580,29
BUKEDEA,2019,1210,1530,2740,29
BUKEDEA,2020,1270,1630,2900,29
BUKEDEA,2021,1340,1720,3060,29
BUKEDEA,2022,1440,1790,3230,29
BUKEDEA,2023,1530,1850,3380,29
BUKEDEA,2024,1630,1890,3520,29
BUKEDEA,2025,1740,1950,3690,29
BUKOMANSIMBI,2015,660,820,1480,29
BUKOMANSIMBI,2016,680,840,1520,29
BUKOMANSIMBI,2017,680,870,1550,29
BUKOMANSIMBI,2018,700,890,1590,29
BUKOMANSIMBI,2019,700,910,1610,29
BUKOMANSIMBI,2020,720,940,1660,29
BUKOMANSIMBI,2021,730,950,1680,29
BUKOMANSIMBI,2022,750,960,1710,29
BUKOMANSIMBI,2023,780,960,1740,29
BUKOMANSIMBI,2024,800,950,1750,29
BUKOMANSIMBI,2025,820,940,1760,29
BUKWO,2015,470,560,1030,29
BUKWO,2016,500,590,1090,29
BUKWO,2017,520,620,1140,29
BUKWO,2018,550,650,1200,29
BUKWO,2019,580,680,1260,29
BUKWO,2020,610,710,1320,29
BUKWO,2021,640,740,1380,29
BUKWO,2022,670,780,1450,29
BUKWO,2023,710,810,1520,29
BUKWO,2024,740,850,1590,29
BUKWO,2025,780,890,1670,29
BULAMBULI,2015,920,1050,1970,29
BULAMBULI,2016,970,1120,2090,29
BULAMBULI,2017,1030,1200,2230,29
BULAMBULI,2018,1090,1290,2380,29
BULAMBULI,2019,1150,1390,2540,29
BULAMBULI,2020,1210,1490,2700,29
BULAMBULI,2021,1290,1570,2860,29
BULAMBULI,2022,1380,1660,3040,29
BULAMBULI,2023,1490,1710,3200,29
BULAMBULI,2024,1590,1780,3370,29
BULAMBULI,2025,1700,1840,3540,29
BULIISA,2015,780,710,1490,29
BULIISA,2016,820,750,1570,29
BULIISA,2017,870,780,1650,29
BULIISA,2018,910,810,1720,29
BULIISA,2019,960,850,1810,29
BULIISA,2020,1010,880,1890,29
BULIISA,2021,1060,920,1980,29
BULIISA,2022,1120,960,2080,29
BULIISA,2023,1170,1000,2170,29
BULIISA,2024,1230,1040,2270,29
BULIISA,2025,1290,1080,2370,29
BUNDIBUGYO,2015,1370,1550,2920,29
BUNDIBUGYO,2016,1430,1610,3040,29
BUNDIBUGYO,2017,1480,1700,3180,29
BUNDIBUGYO,2018,1540,1790,3330,29
BUNDIBUGYO,2019,1590,1880,3470,29
BUNDIBUGYO,2020,1660,1980,3640,29
BUNDIBUGYO,2021,1720,2050,3770,29
BUNDIBUGYO,2022,1810,2110,3920,29
BUNDIBUGYO,2023,1910,2140,4050,29
BUNDIBUGYO,2024,2010,2170,4180,29
BUNDIBUGYO,2025,2100,2210,4310,29
BUNYANGABU,2015,1070,1200,2270,29
BUNYANGABU,2016,1120,1260,2380,29
BUNYANGABU,2017,1150,1310,2460,29
BUNYANGABU,2018,1190,1370,2560,29
BUNYANGABU,2019,1220,1440,2660,29
BUNYANGABU,2020,1260,1500,2760,29
BUNYANGABU,2021,1320,1550,2870,29
BUNYANGABU,2022,1370,1590,2960,29
BUNYANGABU,2023,1450,1610,3060,29
BUNYANGABU,2024,1510,1620,3130,29
BUNYANGABU,2025,1570,1630,3200,29
BUSHENYI,2015,1190,1430,2620,29
BUSHENYI,2016,1210,1450,2660,29
BUSHENYI,2017,1220,1460,2680,29
BUSHENYI,2018,1240,1470,2710,29
BUSHENYI,2019,1250,1480,2730,29
BUSHENYI,2020,1270,1490,2760,29
BUSHENYI,2021,1280,1510,2790,29
BUSHENYI,2022,1290,1510,2800,29
BUSHENYI,2023,1300,1520,2820,29
BUSHENYI,2024,1310,1530,2840,29
BUSHENYI,2025,1320,1540,2860,29
BUSIA,2015,1900,2230,4130,29
BUSIA,2016,1980,2330,4310,29
BUSIA,2017,2060,2460,4520,29
BUSIA,2018,2140,2600,4740,29
BUSIA,2019,2210,2730,4940,29
BUSIA,2020,2310,2870,5180,29
BUSIA,2021,2400,2990,5390,29
BUSIA,2022,2530,3070,5600,29
BUSIA,2023,2680,3130,5810,29
BUSIA,2024,2810,3170,5980,29
BUSIA,2025,2960,3230,6190,29
BUTALEJA,2015,1170,1610,2780,29
BUTALEJA,2016,1230,1700,2930,29
BUTALEJA,2017,1270,1800,3070,29
BUTALEJA,2018,1330,1910,3240,29
BUTALEJA,2019,1400,2020,3420,29
BUTALEJA,2020,1460,2150,3610,29
BUTALEJA,2021,1530,2240,3770,29
BUTALEJA,2022,1620,2320,3940,29
BUTALEJA,2023,1720,2380,4100,29
BUTALEJA,2024,1820,2430,4250,29
BUTALEJA,2025,1920,2490,4410,29
BUTAMBALA,2015,420,510,930,29
BUTAMBALA,2016,440,510,950,29
BUTAMBALA,2017,440,540,980,29
BUTAMBALA,2018,450,550,1000,29
BUTAMBALA,2019,460,580,1040,29
BUTAMBALA,2020,470,590,1060,29
BUTAMBALA,2021,480,610,1090,29
BUTAMBALA,2022,500,610,1110,29
BUTAMBALA,2023,520,610,1130,29
BUTAMBALA,2024,540,610,1150,29
BUTAMBALA,2025,560,610,1170,29
BUTEBO,2015,490,620,1110,29
BUTEBO,2016,500,650,1150,29
BUTEBO,2017,510,670,1180,29
BUTEBO,2018,530,700,1230,29
BUTEBO,2019,530,720,1250,29
BUTEBO,2020,550,750,1300,29
BUTEBO,2021,570,770,1340,29
BUTEBO,2022,580,770,1350,29
BUTEBO,2023,610,780,1390,29
BUTEBO,2024,630,780,1410,29
BUTEBO,2025,650,780,1430,29
BUVUMA,2015,750,730,1480,29
BUVUMA,2016,790,780,1570,29
BUVUMA,2017,840,830,1670,29
BUVUMA,2018,890,890,1780,29
BUVUMA,2019,950,940,1890,29
BUVUMA,2020,1000,1010,2010,29
BUVUMA,2021,1060,1070,2130,29
BUVUMA,2022,1130,1140,2270,29
BUVUMA,2023,1190,1210,2400,29
BUVUMA,2024,1260,1290,2550,29
BUVUMA,2025,1330,1370,2700,29
BUYENDE,2015,1540,1900,3440,29
BUYENDE,2016,1630,2020,3650,29
BUYENDE,2017,1710,2150,3860,29
BUYENDE,2018,1790,2310,4100,29
BUYENDE,2019,1890,2460,4350,29
BUYENDE,2020,1990,2620,4610,29
BUYENDE,2021,2110,2760,4870,29
BUYENDE,2022,2250,2880,5130,29
BUYENDE,2023,2400,2970,5370,29
BUYENDE,2024,2560,3070,5630,29
BUYENDE,2025,2730,3170,5900,29
DOKOLO,2015,860,1040,1900,29
DOKOLO,2016,890,1070,1960,29
DOKOLO,2017,920,1100,2020,29
DOKOLO,2018,940,1130,2070,29
DOKOLO,2019,970,1160,2130,29
DOKOLO,2020,1000,1190,2190,29
DOKOLO,2021,1030,1220,2250,29
DOKOLO,2022,1060,1250,2310,29
DOKOLO,2023,1090,1280,2370,29
DOKOLO,2024,1110,1310,2420,29
DOKOLO,2025,1140,1340,2480,29
GOMBA,2015,770,870,1640,29
GOMBA,2016,790,900,1690,29
GOMBA,2017,810,930,1740,29
GOMBA,2018,820,970,1790,29
GOMBA,2019,840,990,1830,29
GOMBA,2020,860,1030,1890,29
GOMBA,2021,900,1050,1950,29
GOMBA,2022,930,1070,2000,29
GOMBA,2023,970,1060,2030,29
GOMBA,2024,1010,1070,2080,29
GOMBA,2025,1040,1060,2100,29
GULU,2015,1690,1840,3530,29
GULU,2016,1740,1890,3630,29
GULU,2017,1790,1950,3740,29
GULU,2018,1850,2010,3860,29
GULU,2019,1900,2060,3960,29
GULU,2020,1950,2120,4070,29
GULU,2021,2010,2180,4190,29
GULU,2022,2060,2230,4290,29
GULU,2023,2120,2290,4410,29
GULU,2024,2170,2350,4520,29
GULU,2025,2230,2410,4640,29
HOIMA,2015,1920,2010,3930,29
HOIMA,2016,2000,2080,4080,29
HOIMA,2017,2070,2160,4230,29
HOIMA,2018,2150,2230,4380,29
HOIMA,2019,2230,2300,4530,29
HOIMA,2020,2310,2380,4690,29
HOIMA,2021,2390,2460,4850,29
HOIMA,2022,2470,2540,5010,29
HOIMA,2023,2550,2620,5170,29
HOIMA,2024,2640,2700,5340,29
HOIMA,2025,2720,2780,5500,29
IBANDA,2015,1260,1500,2760,29
IBANDA,2016,1290,1520,2810,29
IBANDA,2017,1310,1550,2860,29
IBANDA,2018,1340,1580,2920,29
IBANDA,2019,1360,1610,2970,29
IBANDA,2020,1390,1630,3020,29
IBANDA,2021,1410,1660,3070,29
IBANDA,2022,1440,1680,3120,29
IBANDA,2023,1460,1710,3170,29
IBANDA,2024,1480,1730,3210,29
IBANDA,2025,1500,1760,3260,29
IGANGA,2015,1780,2520,4300,29
IGANGA,2016,1860,2630,4490,29
IGANGA,2017,1930,2780,4710,29
IGANGA,2018,2000,2920,4920,29
IGANGA,2019,2080,3090,5170,29
IGANGA,2020,2160,3240,5400,29
IGANGA,2021,2270,3370,5640,29
IGANGA,2022,2380,3460,5840,29
IGANGA,2023,2510,3530,6040,29
IGANGA,2024,2640,3580,6220,29
IGANGA,2025,2770,3650,6420,29
ISINGIRO,2015,2420,3070,5490,29
ISINGIRO,2016,2510,3180,5690,29
ISINGIRO,2017,2610,3290,5900,29
ISINGIRO,2018,2710,3400,6110,29
ISINGIRO,2019,2800,3520,6320,29
ISINGIRO,2020,2900,3640,6540,29
ISINGIRO,2021,3010,3760,6770,29
ISINGIRO,2022,3110,3880,6990,29
ISINGIRO,2023,3210,4000,7210,29
ISINGIRO,2024,3320,4130,7450,29
ISINGIRO,2025,3430,4260,7690,29
JINJA,2015,2740,3020,5760,29
JINJA,2016,2790,3070,5860,29
JINJA,2017,2840,3120,5960,29
JINJA,2018,2880,3160,6040,29
JINJA,2019,2930,3210,6140,29
JINJA,2020,2980,3250,6230,29
JINJA,2021,3020,3300,6320,29
JINJA,2022,3060,3340,6400,29
JINJA,2023,3100,3380,6480,29
JINJA,2024,3140,3420,6560,29
JINJA,2025,3170,3450,6620,29
KAABONG,2015,620,1080,1700,29
KAABONG,2016,640,1110,1750,29
KAABONG,2017,660,1130,1790,29
KAABONG,2018,670,1160,1830,29
KAABONG,2019,690,1180,1870,29
KAABONG,2020,710,1210,1920,29
KAABONG,2021,730,1240,1970,29
KAABONG,2022,750,1270,2020,29
KAABONG,2023,760,1290,2050,29
KAABONG,2024,780,1320,2100,29
KAABONG,2025,800,1350,2150,29
KABALE,2015,1260,1420,2680,29
KABALE,2016,1280,1440,2720,29
KABALE,2017,1300,1460,2760,29
KABALE,2018,1320,1470,2790,29
KABALE,2019,1340,1490,2830,29
KABALE,2020,1360,1510,2870,29
KABALE,2021,1380,1520,2900,29
KABALE,2022,1400,1540,2940,29
KABALE,2023,1410,1550,2960,29
KABALE,2024,1430,1560,2990,29
KABALE,2025,1440,1570,3010,29
KABAROLE,2015,1790,1970,3760,29
KABAROLE,2016,1830,2020,3850,29
KABAROLE,2017,1870,2060,3930,29
KABAROLE,2018,1910,2110,4020,29
KABAROLE,2019,1950,2150,4100,29
KABAROLE,2020,1990,2190,4180,29
KABAROLE,2021,2030,2240,4270,29
KABAROLE,2022,2070,2280,4350,29
KABAROLE,2023,2110,2320,4430,29
KABAROLE,2024,2140,2360,4500,29
KABAROLE,2025,2180,2400,4580,29
KABERAMAIDO,2015,590,690,1280,29
KABERAMAIDO,2016,620,740,1360,29
KABERAMAIDO,2017,650,780,1430,29
KABERAMAIDO,2018,690,840,1530,29
KABERAMAIDO,2019,720,890,1610,29
KABERAMAIDO,2020,760,950,1710,29
KABERAMAIDO,2021,800,990,1790,29
KABERAMAIDO,2022,850,1030,1880,29
KABERAMAIDO,2023,900,1060,1960,29
KABERAMAIDO,2024,970,1090,2060,29
KABERAMAIDO,2025,1030,1120,2150,29
KAGADI,2015,1790,2120,3910,29
KAGADI,2016,1860,2190,4050,29
KAGADI,2017,1930,2270,4200,29
KAGADI,2018,2000,2350,4350,29
KAGADI,2019,2070,2430,4500,29
KAGADI,2020,2140,2510,4650,29
KAGADI,2021,2220,2590,4810,29
KAGADI,2022,2300,2680,4980,29
KAGADI,2023,2370,2760,5130,29
KAGADI,2024,2450,2850,5300,29
KAGADI,2025,2530,2940,5470,29
KAKUMIRO,2015,1760,1950,3710,29
KAKUMIRO,2016,1910,2110,4020,29
KAKUMIRO,2017,2080,2290,4370,29
KAKUMIRO,2018,2260,2480,4740,29
KAKUMIRO,2019,2460,2690,5150,29
KAKUMIRO,2020,2680,2910,5590,29
KAKUMIRO,2021,2910,3150,6060,29
KAKUMIRO,2022,3150,3410,6560,29
KAKUMIRO,2023,3420,3680,7100,29
KAKUMIRO,2024,3710,3980,7690,29
KAKUMIRO,2025,4010,4290,8300,29
KALAKI,2015,520,580,1100,29
KALAKI,2016,540,600,1140,29
KALAKI,2017,570,620,1190,29
KALAKI,2018,590,650,1240,29
KALAKI,2019,620,670,1290,29
KALAKI,2020,640,700,1340,29
KALAKI,2021,670,730,1400,29
KALAKI,2022,700,750,1450,29
KALAKI,2023,720,780,1500,29
KALAKI,2024,750,810,1560,29
KALAKI,2025,780,840,1620,29
KALANGALA,2015,780,530,1310,29
KALANGALA,2016,810,550,1360,29
KALANGALA,2017,840,580,1420,29
KALANGALA,2018,870,600,1470,29
KALANGALA,2019,900,620,1520,29
KALANGALA,2020,930,650,1580,29
KALANGALA,2021,960,670,1630,29
KALANGALA,2022,990,700,1690,29
KALANGALA,2023,1030,730,1760,29
KALANGALA,2024,1060,750,1810,29
KALANGALA,2025,1090,780,1870,29
KALIRO,2015,1190,1410,2600,29
KALIRO,2016,1250,1480,2730,29
KALIRO,2017,1310,1580,2890,29
KALIRO,2018,1350,1670,3020,29
KALIRO,2019,1410,1770,3180,29
KALIRO,2020,1470,1870,3340,29
KALIRO,2021,1540,1960,3500,29
KALIRO,2022,1640,2020,3660,29
KALIRO,2023,1740,2070,3810,29
KALIRO,2024,1840,2120,3960,29
KALIRO,2025,1930,2170,4100,29
KALUNGU,2015,830,1020,1850,29
KALUNGU,2016,840,1050,1890,29
KALUNGU,2017,860,1090,1950,29
KALUNGU,2018,870,1130,2000,29
KALUNGU,2019,890,1170,2060,29
KALUNGU,2020,910,1200,2110,29
KALUNGU,2021,920,1230,2150,29
KALUNGU,2022,960,1240,2200,29
KALUNGU,2023,990,1230,2220,29
KALUNGU,2024,1020,1240,2260,29
KALUNGU,2025,1060,1230,2290,29
KAMPALA,2015,13340,14750,28090,29
KAMPALA,2016,13610,15040,28650,29
KAMPALA,2017,13870,15330,29200,29
KAMPALA,2018,14140,15620,29760,29
KAMPALA,2019,14410,15910,30320,29
KAMPALA,2020,14670,16200,30870,29
KAMPALA,2021,14930,16480,31410,29
KAMPALA,2022,15180,16750,31930,29
KAMPALA,2023,15420,17020,32440,29
KAMPALA,2024,15660,17290,32950,29
KAMPALA,2025,15890,17540,33430,29
KAMULI,2015,2240,3030,5270,29
KAMULI,2016,2320,3160,5480,29
KAMULI,2017,2390,3300,5690,29
KAMULI,2018,2470,3460,5930,29
KAMULI,2019,2550,3630,6180,29
KAMULI,2020,2640,3790,6430,29
KAMULI,2021,2750,3920,6670,29
KAMULI,2022,2870,4010,6880,29
KAMULI,2023,3010,4060,7070,29
KAMULI,2024,3150,4090,7240,29
KAMULI,2025,3300,4150,7450,29
KAMWENGE,2015,1460,1720,3180,29
KAMWENGE,2016,1520,1780,3300,29
KAMWENGE,2017,1580,1840,3420,29
KAMWENGE,2018,1640,1910,3550,29
KAMWENGE,2019,1710,1970,3680,29
KAMWENGE,2020,1770,2040,3810,29
KAMWENGE,2021,1840,2110,3950,29
KAMWENGE,2022,1910,2170,4080,29
KAMWENGE,2023,1980,2250,4230,29
KAMWENGE,2024,2050,2320,4370,29
KAMWENGE,2025,2120,2390,4510,29
KANUNGU,2015,1260,1570,2830,29
KANUNGU,2016,1280,1600,2880,29
KANUNGU,2017,1310,1630,2940,29
KANUNGU,2018,1330,1650,2980,29
KANUNGU,2019,1350,1680,3030,29
KANUNGU,2020,1380,1700,3080,29
KANUNGU,2021,1400,1730,3130,29
KANUNGU,2022,1420,1750,3170,29
KANUNGU,2023,1440,1770,3210,29
KANUNGU,2024,1460,1790,3250,29
KANUNGU,2025,1480,1810,3290,29
KAPCHORWA,2015,540,610,1150,29
KAPCHORWA,2016,560,620,1180,29
KAPCHORWA,2017,580,640,1220,29
KAPCHORWA,2018,600,660,1260,29
KAPCHORWA,2019,610,680,1290,29
KAPCHORWA,2020,630,690,1320,29
KAPCHORWA,2021,650,710,1360,29
KAPCHORWA,2022,670,730,1400,29
KAPCHORWA,2023,680,750,1430,29
KAPCHORWA,2024,700,770,1470,29
KAPCHORWA,2025,720,780,1500,29
KAPELEBYONG,2015,360,490,850,29
KAPELEBYONG,2016,380,510,890,29
KAPELEBYONG,2017,390,540,930,29
KAPELEBYONG,2018,410,560,970,29
KAPELEBYONG,2019,420,590,1010,29
KAPELEBYONG,2020,440,620,1060,29
KAPELEBYONG,2021,460,650,1110,29
KAPELEBYONG,2022,490,670,1160,29
KAPELEBYONG,2023,520,680,1200,29
KAPELEBYONG,2024,540,680,1220,29
KAPELEBYONG,2025,570,710,1280,29
KASESE,2015,3820,4610,8430,29
KASESE,2016,3950,4780,8730,29
KASESE,2017,4080,5000,9080,29
KASESE,2018,4200,5250,9450,29
KASESE,2019,4330,5500,9830,29
KASESE,2020,4480,5740,10220,29
KASESE,2021,4650,5920,10570,29
KASESE,2022,4850,6050,10900,29
KASESE,2023,5080,6120,11200,29
KASESE,2024,5320,6180,11500,29
KASESE,2025,5550,6250,11800,29
KASSANDA,2015,1390,1330,2720,29
KASSANDA,2016,1430,1360,2790,29
KASSANDA,2017,1470,1380,2850,29
KASSANDA,2018,1510,1410,2920,29
KASSANDA,2019,1550,1440,2990,29
KASSANDA,2020,1590,1470,3060,29
KASSANDA,2021,1630,1500,3130,29
KASSANDA,2022,1680,1530,3210,29
KASSANDA,2023,1720,1560,3280,29
KASSANDA,2024,1760,1580,3340,29
KASSANDA,2025,1800,1610,3410,29
KATAKWI,2015,840,930,1770,29
KATAKWI,2016,870,970,1840,29
KATAKWI,2017,900,1020,1920,29
KATAKWI,2018,930,1070,2000,29
KATAKWI,2019,980,1120,2100,29
KATAKWI,2020,1010,1190,2200,29
KATAKWI,2021,1050,1230,2280,29
KATAKWI,2022,1110,1260,2370,29
KATAKWI,2023,1170,1270,2440,29
KATAKWI,2024,1220,1290,2510,29
KATAKWI,2025,1290,1310,2600,29
KAYUNGA,2015,1760,2230,3990,29
KAYUNGA,2016,1810,2310,4120,29
KAYUNGA,2017,1860,2410,4270,29
KAYUNGA,2018,1900,2510,4410,29
KAYUNGA,2019,1950,2620,4570,29
KAYUNGA,2020,2010,2710,4720,29
KAYUNGA,2021,2080,2790,4870,29
KAYUNGA,2022,2150,2830,4980,29
KAYUNGA,2023,2240,2840,5080,29
KAYUNGA,2024,2340,2860,5200,29
KAYUNGA,2025,2440,2880,5320,29
KAZO,2015,910,1060,1970,29
KAZO,2016,940,1090,2030,29
KAZO,2017,980,1130,2110,29
KAZO,2018,1010,1170,2180,29
KAZO,2019,1050,1220,2270,29
KAZO,2020,1090,1260,2350,29
KAZO,2021,1130,1300,2430,29
KAZO,2022,1170,1340,2510,29
KAZO,2023,1210,1380,2590,29
KAZO,2024,1250,1430,2680,29
KAZO,2025,1290,1470,2760,29
KIBAALE,2015,840,900,1740,29
KIBAALE,2016,890,950,1840,29
KIBAALE,2017,950,1000,1950,29
KIBAALE,2018,1010,1060,2070,29
KIBAALE,2019,1070,1120,2190,29
KIBAALE,2020,1140,1180,2320,29
KIBAALE,2021,1210,1250,2460,29
KIBAALE,2022,1280,1320,2600,29
KIBAALE,2023,1360,1390,2750,29
KIBAALE,2024,1440,1470,2910,29
KIBAALE,2025,1520,1540,3060,29
KIBOGA,2015,920,840,1760,29
KIBOGA,2016,950,870,1820,29
KIBOGA,2017,990,900,1890,29
KIBOGA,2018,1020,940,1960,29
KIBOGA,2019,1060,990,2050,29
KIBOGA,2020,1090,1040,2130,29
KIBOGA,2021,1130,1090,2220,29
KIBOGA,2022,1180,1130,2310,29
KIBOGA,2023,1230,1150,2380,29
KIBOGA,2024,1290,1170,2460,29
KIBOGA,2025,1360,1190,2550,29
KIBUKU,2015,920,1220,2140,29
KIBUKU,2016,960,1290,2250,29
KIBUKU,2017,1000,1370,2370,29
KIBUKU,2018,1040,1460,2500,29
KIBUKU,2019,1090,1550,2640,29
KIBUKU,2020,1150,1630,2780,29
KIBUKU,2021,1200,1710,2910,29
KIBUKU,2022,1280,1780,3060,29
KIBUKU,2023,1350,1820,3170,29
KIBUKU,2024,1440,1870,3310,29
KIBUKU,2025,1520,1910,3430,29
KIKUUBE,2015,1730,1690,3420,29
KIKUUBE,2016,1820,1780,3600,29
KIKUUBE,2017,1920,1870,3790,29
KIKUUBE,2018,2020,1970,3990,29
KIKUUBE,2019,2130,2060,4190,29
KIKUUBE,2020,2240,2170,4410,29
KIKUUBE,2021,2350,2270,4620,29
KIKUUBE,2022,2470,2380,4850,29
KIKUUBE,2023,2600,2500,5100,29
KIKUUBE,2024,2720,2610,5330,29
KIKUUBE,2025,2850,2730,5580,29
KIRUHURA,2015,980,910,1890,29
KIRUHURA,2016,1020,940,1960,29
KIRUHURA,2017,1050,980,2030,29
KIRUHURA,2018,1090,1010,2100,29
KIRUHURA,2019,1130,1040,2170,29
KIRUHURA,2020,1180,1080,2260,29
KIRUHURA,2021,1220,1120,2340,29
KIRUHURA,2022,1260,1150,2410,29
KIRUHURA,2023,1300,1190,2490,29
KIRUHURA,2024,1350,1230,2580,29
KIRUHURA,2025,1390,1260,2650,29
KIRYANDONGO,2015,1580,1810,3390,29
KIRYANDONGO,2016,1650,1900,3550,29
KIRYANDONGO,2017,1710,1990,3700,29
KIRYANDONGO,2018,1770,2100,3870,29
KIRYANDONGO,2019,1840,2220,4060,29
KIRYANDONGO,2020,1910,2320,4230,29
KIRYANDONGO,2021,1990,2410,4400,29
KIRYANDONGO,2022,2090,2470,4560,29
KIRYANDONGO,2023,2200,2510,4710,29
KIRYANDONGO,2024,2320,2550,4870,29
KIRYANDONGO,2025,2440,2590,5030,29
KISORO,2015,1180,1860,3040,29
KISORO,2016,1210,1930,3140,29
KISORO,2017,1250,2020,3270,29
KISORO,2018,1280,2110,3390,29
KISORO,2019,1310,2200,3510,29
KISORO,2020,1350,2290,3640,29
KISORO,2021,1390,2360,3750,29
KISORO,2022,1450,2400,3850,29
KISORO,2023,1510,2430,3940,29
KISORO,2024,1580,2450,4030,29
KISORO,2025,1640,2470,4110,29
KITAGWENDA,2015,690,860,1550,29
KITAGWENDA,2016,710,890,1600,29
KITAGWENDA,2017,740,920,1660,29
KITAGWENDA,2018,770,950,1720,29
KITAGWENDA,2019,800,980,1780,29
KITAGWENDA,2020,840,1020,1860,29
KITAGWENDA,2021,870,1050,1920,29
KITAGWENDA,2022,900,1090,1990,29
KITAGWENDA,2023,930,1120,2050,29
KITAGWENDA,2024,970,1160,2130,29
KITAGWENDA,2025,1000,1190,2190,29
KITGUM,2015,1240,1470,2710,29
KITGUM,2016,1280,1520,2800,29
KITGUM,2017,1300,1580,2880,29
KITGUM,2018,1330,1640,2970,29
KITGUM,2019,1360,1710,3070,29
KITGUM,2020,1400,1780,3180,29
KITGUM,2021,1430,1810,3240,29
KITGUM,2022,1490,1840,3330,29
KITGUM,2023,1550,1860,3410,29
KITGUM,2024,1600,1870,3470,29
KITGUM,2025,1670,1870,3540,29
KOBOKO,2015,1250,1340,2590,29
KOBOKO,2016,1310,1410,2720,29
KOBOKO,2017,1380,1500,2880,29
KOBOKO,2018,1440,1590,3030,29
KOBOKO,2019,1510,1700,3210,29
KOBOKO,2020,1580,1800,3380,29
KOBOKO,2021,1670,1890,3560,29
KOBOKO,2022,1770,1960,3730,29
KOBOKO,2023,1880,2020,3900,29
KOBOKO,2024,2000,2070,4070,29
KOBOKO,2025,2120,2120,4240,29
KOLE,2015,1180,1510,2690,29
KOLE,2016,1220,1560,2780,29
KOLE,2017,1260,1600,2860,29
KOLE,2018,1310,1650,2960,29
KOLE,2019,1350,1690,3040,29
KOLE,2020,1390,1740,3130,29
KOLE,2021,1430,1790,3220,29
KOLE,2022,1470,1830,3300,29
KOLE,2023,1520,1880,3400,29
KOLE,2024,1560,1930,3490,29
KOLE,2025,1600,1970,3570,29
KOTIDO,2015,1070,1260,2330,29
KOTIDO,2016,1120,1300,2420,29
KOTIDO,2017,1150,1360,2510,29
KOTIDO,2018,1180,1430,2610,29
KOTIDO,2019,1220,1490,2710,29
KOTIDO,2020,1260,1550,2810,29
KOTIDO,2021,1300,1610,2910,29
KOTIDO,2022,1370,1640,3010,29
KOTIDO,2023,1430,1660,3090,29
KOTIDO,2024,1500,1680,3180,29
KOTIDO,2025,1560,1700,3260,29
KUMI,2015,1240,1520,2760,29
KUMI,2016,1290,1590,2880,29
KUMI,2017,1340,1680,3020,29
KUMI,2018,1390,1770,3160,29
KUMI,2019,1450,1860,3310,29
KUMI,2020,1510,1960,3470,29
KUMI,2021,1570,2030,3600,29
KUMI,2022,1650,2080,3730,29
KUMI,2023,1750,2120,3870,29
KUMI,2024,1850,2160,4010,29
KUMI,2025,1930,2200,4130,29
KWANIA,2015,1010,1120,2130,29
KWANIA,2016,1040,1150,2190,29
KWANIA,2017,1080,1180,2260,29
KWANIA,2018,1110,1220,2330,29
KWANIA,2019,1140,1250,2390,29
KWANIA,2020,1180,1280,2460,29
KWANIA,2021,1210,1320,2530,29
KWANIA,2022,1240,1350,2590,29
KWANIA,2023,1280,1390,2670,29
KWANIA,2024,1310,1420,2730,29
KWANIA,2025,1340,1450,2790,29
KWEEN,2015,580,590,1170,29
KWEEN,2016,590,610,1200,29
KWEEN,2017,610,620,1230,29
KWEEN,2018,630,640,1270,29
KWEEN,2019,650,650,1300,29
KWEEN,2020,670,670,1340,29
KWEEN,2021,690,680,1370,29
KWEEN,2022,710,700,1410,29
KWEEN,2023,730,710,1440,29
KWEEN,2024,740,730,1470,29
KWEEN,2025,760,740,1500,29
KYANKWANZI,2015,1330,1170,2500,29
KYANKWANZI,2016,1400,1220,2620,29
KYANKWANZI,2017,1470,1280,2750,29
KYANKWANZI,2018,1550,1340,2890,29
KYANKWANZI,2019,1630,1400,3030,29
KYANKWANZI,2020,1710,1460,3170,29
KYANKWANZI,2021,1790,1530,3320,29
KYANKWANZI,2022,1880,1590,3470,29
KYANKWANZI,2023,1970,1660,3630,29
KYANKWANZI,2024,2060,1730,3790,29
KYANKWANZI,2025,2150,1810,3960,29
KYEGEGWA,2015,1610,1790,3400,29
KYEGEGWA,2016,1740,1930,3670,29
KYEGEGWA,2017,1880,2080,3960,29
KYEGEGWA,2018,2030,2240,4270,29
KYEGEGWA,2019,2200,2420,4620,29
KYEGEGWA,2020,2380,2610,4990,29
KYEGEGWA,2021,2570,2810,5380,29
KYEGEGWA,2022,2770,3020,5790,29
KYEGEGWA,2023,2990,3250,6240,29
KYEGEGWA,2024,3220,3490,6710,29
KYEGEGWA,2025,3460,3750,7210,29
KYENJOJO,2015,2370,2500,4870,29
KYENJOJO,2016,2470,2600,5070,29
KYENJOJO,2017,2570,2690,5260,29
KYENJOJO,2018,2680,2790,5470,29
KYENJOJO,2019,2780,2890,5670,29
KYENJOJO,2020,2890,2990,5880,29
KYENJOJO,2021,3000,3100,6100,29
KYENJOJO,2022,3120,3200,6320,29
KYENJOJO,2023,3230,3310,6540,29
KYENJOJO,2024,3350,3420,6770,29
KYENJOJO,2025,3470,3520,6990,29
KYOTERA,2015,1250,1520,2770,29
KYOTERA,2016,1290,1550,2840,29
KYOTERA,2017,1310,1610,2920,29
KYOTERA,2018,1340,1680,3020,29
KYOTERA,2019,1370,1750,3120,29
KYOTERA,2020,1410,1800,3210,29
KYOTERA,2021,1460,1850,3310,29
KYOTERA,2022,1500,1870,3370,29
KYOTERA,2023,1570,1890,3460,29
KYOTERA,2024,1620,1880,3500,29
KYOTERA,2025,1680,1880,3560,29
KARENGA,2015,390,390,780,29
KARENGA,2016,400,400,800,29
KARENGA,2017,410,410,820,29
KARENGA,2018,420,420,840,29
KARENGA,2019,430,430,860,29
KARENGA,2020,440,440,880,29
KARENGA,2021,450,450,900,29
KARENGA,2022,460,450,910,29
KARENGA,2023,470,460,930,29
KARENGA,2024,490,470,960,29
KARENGA,2025,500,480,980,29
LAMWO,2015,640,920,1560,29
LAMWO,2016,640,940,1580,29
LAMWO,2017,660,980,1640,29
LAMWO,2018,660,1020,1680,29
LAMWO,2019,680,1060,1740,29
LAMWO,2020,690,1090,1780,29
LAMWO,2021,710,1130,1840,29
LAMWO,2022,720,1150,1870,29
LAMWO,2023,760,1140,1900,29
LAMWO,2024,770,1140,1910,29
LAMWO,2025,790,1150,1940,29
LIRA,2015,2330,2790,5120,29
LIRA,2016,2400,2870,5270,29
LIRA,2017,2470,2960,5430,29
LIRA,2018,2540,3040,5580,29
LIRA,2019,2600,3120,5720,29
LIRA,2020,2670,3210,5880,29
LIRA,2021,2740,3290,6030,29
LIRA,2022,2810,3380,6190,29
LIRA,2023,2880,3460,6340,29
LIRA,2024,2950,3550,6500,29
LIRA,2025,3020,3630,6650,29
LUUKA,2015,960,1400,2360,29
LUUKA,2016,1000,1450,2450,29
LUUKA,2017,1030,1520,2550,29
LUUKA,2018,1060,1580,2640,29
LUUKA,2019,1080,1660,2740,29
LUUKA,2020,1110,1730,2840,29
LUUKA,2021,1150,1770,2920,29
LUUKA,2022,1200,1800,3000,29
LUUKA,2023,1250,1830,3080,29
LUUKA,2024,1310,1840,3150,29
LUUKA,2025,1350,1860,3210,29
LUWERO,2015,2510,3000,5510,29
LUWERO,2016,2590,3110,5700,29
LUWERO,2017,2680,3250,5930,29
LUWERO,2018,2750,3410,6160,29
LUWERO,2019,2840,3580,6420,29
LUWERO,2020,2940,3740,6680,29
LUWERO,2021,3050,3870,6920,29
LUWERO,2022,3190,3940,7130,29
LUWERO,2023,3360,4000,7360,29
LUWERO,2024,3510,4030,7540,29
LUWERO,2025,3660,4080,7740,29
LWENGO,2015,1280,1670,2950,29
LWENGO,2016,1300,1720,3020,29
LWENGO,2017,1330,1770,3100,29
LWENGO,2018,1350,1830,3180,29
LWENGO,2019,1370,1910,3280,29
LWENGO,2020,1400,1960,3360,29
LWENGO,2021,1430,2000,3430,29
LWENGO,2022,1470,2020,3490,29
LWENGO,2023,1530,2020,3550,29
LWENGO,2024,1580,2000,3580,29
LWENGO,2025,1610,2000,3610,29
LYANTONDE,2015,550,630,1180,29
LYANTONDE,2016,570,650,1220,29
LYANTONDE,2017,600,680,1280,29
LYANTONDE,2018,620,720,1340,29
LYANTONDE,2019,640,750,1390,29
LYANTONDE,2020,670,780,1450,29
LYANTONDE,2021,690,840,1530,29
LYANTONDE,2022,710,870,1580,29
LYANTONDE,2023,750,900,1650,29
LYANTONDE,2024,780,930,1710,29
LYANTONDE,2025,840,940,1780,29
MANAFWA,2015,650,740,1390,29
MANAFWA,2016,670,760,1430,29
MANAFWA,2017,680,780,1460,29
MANAFWA,2018,700,790,1490,29
MANAFWA,2019,720,810,1530,29
MANAFWA,2020,730,830,1560,29
MANAFWA,2021,750,840,1590,29
MANAFWA,2022,770,860,1630,29
MANAFWA,2023,780,880,1660,29
MANAFWA,2024,800,890,1690,29
MANAFWA,2025,810,910,1720,29
MARACHA,2015,700,1020,1720,29
MARACHA,2016,710,1040,1750,29
MARACHA,2017,730,1060,1790,29
MARACHA,2018,740,1080,1820,29
MARACHA,2019,760,1100,1860,29
MARACHA,2020,770,1120,1890,29
MARACHA,2021,790,1140,1930,29
MARACHA,2022,800,1160,1960,29
MARACHA,2023,810,1180,1990,29
MARACHA,2024,830,1190,2020,29
MARACHA,2025,840,1210,2050,29
MASAKA,2015,1860,2280,4140,29
MASAKA,2016,1920,2370,4290,29
MASAKA,2017,1980,2470,4450,29
MASAKA,2018,2040,2580,4620,29
MASAKA,2019,2090,2710,4800,29
MASAKA,2020,2160,2820,4980,29
MASAKA,2021,2240,2910,5150,29
MASAKA,2022,2330,2950,5280,29
MASAKA,2023,2440,2990,5430,29
MASAKA,2024,2540,3010,5550,29
MASAKA,2025,2660,3050,5710,29
MASINDI,2015,1970,1880,3850,29
MASINDI,2016,2030,1930,3960,29
MASINDI,2017,2090,1990,4080,29
MASINDI,2018,2140,2040,4180,29
MASINDI,2019,2200,2090,4290,29
MASINDI,2020,2270,2140,4410,29
MASINDI,2021,2330,2200,4530,29
MASINDI,2022,2390,2250,4640,29
MASINDI,2023,2450,2300,4750,29
MASINDI,2024,2510,2350,4860,29
MASINDI,2025,2570,2410,4980,29
MAYUGE,2015,2530,3230,5760,29
MAYUGE,2016,2640,3380,6020,29
MAYUGE,2017,2740,3570,6310,29
MAYUGE,2018,2840,3780,6620,29
MAYUGE,2019,2940,3990,6930,29
MAYUGE,2020,3050,4200,7250,29
MAYUGE,2021,3200,4370,7570,29
MAYUGE,2022,3360,4500,7860,29
MAYUGE,2023,3550,4590,8140,29
MAYUGE,2024,3740,4670,8410,29
MAYUGE,2025,3940,4760,8700,29
MBALE,2015,2880,3560,6440,29
MBALE,2016,3000,3740,6740,29
MBALE,2017,3120,3960,7080,29
MBALE,2018,3230,4190,7420,29
MBALE,2019,3350,4440,7790,29
MBALE,2020,3480,4690,8170,29
MBALE,2021,3630,4890,8520,29
MBALE,2022,3810,5050,8860,29
MBALE,2023,4020,5160,9180,29
MBALE,2024,4230,5280,9510,29
MBALE,2025,4450,5390,9840,29
MBARARA,2015,2220,2560,4780,29
MBARARA,2016,2280,2610,4890,29
MBARARA,2017,2330,2670,5000,29
MBARARA,2018,2380,2730,5110,29
MBARARA,2019,2440,2780,5220,29
MBARARA,2020,2490,2840,5330,29
MBARARA,2021,2540,2890,5430,29
MBARARA,2022,2590,2950,5540,29
MBARARA,2023,2640,3000,5640,29
MBARARA,2024,2690,3050,5740,29
MBARARA,2025,2740,3110,5850,29
MITOOMA,2015,800,1050,1850,29
MITOOMA,2016,810,1060,1870,29
MITOOMA,2017,820,1070,1890,29
MITOOMA,2018,830,1080,1910,29
MITOOMA,2019,840,1090,1930,29
MITOOMA,2020,850,1100,1950,29
MITOOMA,2021,860,1100,1960,29
MITOOMA,2022,870,1110,1980,29
MITOOMA,2023,870,1120,1990,29
MITOOMA,2024,880,1120,2000,29
MITOOMA,2025,890,1130,2020,29
MITYANA,2015,1810,1960,3770,29
MITYANA,2016,1860,2030,3890,29
MITYANA,2017,1910,2120,4030,29
MITYANA,2018,1950,2200,4150,29
MITYANA,2019,2000,2290,4290,29
MITYANA,2020,2060,2370,4430,29
MITYANA,2021,2130,2440,4570,29
MITYANA,2022,2200,2470,4670,29
MITYANA,2023,2290,2500,4790,29
MITYANA,2024,2380,2500,4880,29
MITYANA,2025,2480,2510,4990,29
MOROTO,2015,700,670,1370,29
MOROTO,2016,720,690,1410,29
MOROTO,2017,730,730,1460,29
MOROTO,2018,760,770,1530,29
MOROTO,2019,780,810,1590,29
MOROTO,2020,810,840,1650,29
MOROTO,2021,840,880,1720,29
MOROTO,2022,870,890,1760,29
MOROTO,2023,900,900,1800,29
MOROTO,2024,950,920,1870,29
MOROTO,2025,990,930,1920,29
MOYO,2015,510,630,1140,29
MOYO,2016,520,650,1170,29
MOYO,2017,530,660,1190,29
MOYO,2018,540,680,1220,29
MOYO,2019,560,690,1250,29
MOYO,2020,570,710,1280,29
MOYO,2021,580,720,1300,29
MOYO,2022,600,730,1330,29
MOYO,2023,610,750,1360,29
MOYO,2024,620,760,1380,29
MOYO,2025,630,770,1400,29
MPIGI,2015,1390,1570,2960,29
MPIGI,2016,1420,1640,3060,29
MPIGI,2017,1470,1710,3180,29
MPIGI,2018,1510,1790,3300,29
MPIGI,2019,1560,1880,3440,29
MPIGI,2020,1610,1960,3570,29
MPIGI,2021,1670,2030,3700,29
MPIGI,2022,1750,2080,3830,29
MPIGI,2023,1830,2110,3940,29
MPIGI,2024,1920,2130,4050,29
MPIGI,2025,2000,2160,4160,29
MUBENDE,2015,2940,2940,5880,29
MUBENDE,2016,3120,3140,6260,29
MUBENDE,2017,3310,3380,6690,29
MUBENDE,2018,3510,3640,7150,29
MUBENDE,2019,3720,3930,7650,29
MUBENDE,2020,3950,4210,8160,29
MUBENDE,2021,4210,4480,8690,29
MUBENDE,2022,4530,4700,9230,29
MUBENDE,2023,4880,4900,9780,29
MUBENDE,2024,5250,5080,10330,29
MUBENDE,2025,5640,5280,10920,29
MUKONO,2015,4030,4750,8780,29
MUKONO,2016,4180,4970,9150,29
MUKONO,2017,4310,5240,9550,29
MUKONO,2018,4460,5520,9980,29
MUKONO,2019,4610,5840,10450,29
MUKONO,2020,4780,6120,10900,29
MUKONO,2021,4970,6370,11340,29
MUKONO,2022,5210,6560,11770,29
MUKONO,2023,5480,6680,12160,29
MUKONO,2024,5750,6790,12540,29
MUKONO,2025,6010,6910,12920,29
MADI OKOLLO,2015,660,780,1440,29
MADI OKOLLO,2016,670,800,1470,29
MADI OKOLLO,2017,700,820,1520,29
MADI OKOLLO,2018,720,850,1570,29
MADI OKOLLO,2019,740,870,1610,29
MADI OKOLLO,2020,760,890,1650,29
MADI OKOLLO,2021,770,910,1680,29
MADI OKOLLO,2022,800,940,1740,29
MADI OKOLLO,2023,820,960,1780,29
MADI OKOLLO,2024,840,980,1820,29
MADI OKOLLO,2025,860,1000,1860,29
NABILATUK,2015,400,510,910,29
NABILATUK,2016,430,540,970,29
NABILATUK,2017,450,570,1020,29
NABILATUK,2018,480,610,1090,29
NABILATUK,2019,510,660,1170,29
NABILATUK,2020,540,710,1250,29
NABILATUK,2021,570,750,1320,29
NABILATUK,2022,610,770,1380,29
NABILATUK,2023,660,810,1470,29
NABILATUK,2024,710,830,1540,29
NABILATUK,2025,750,860,1610,29
NAKAPIRIPIRIT,2015,600,610,1210,29
NAKAPIRIPIRIT,2016,640,660,1300,29
NAKAPIRIPIRIT,2017,670,700,1370,29
NAKAPIRIPIRIT,2018,710,750,1460,29
NAKAPIRIPIRIT,2019,740,800,1540,29
NAKAPIRIPIRIT,2020,790,860,1650,29
NAKAPIRIPIRIT,2021,820,890,1710,29
NAKAPIRIPIRIT,2022,880,930,1810,29
NAKAPIRIPIRIT,2023,940,970,1910,29
NAKAPIRIPIRIT,2024,1010,1000,2010,29
NAKAPIRIPIRIT,2025,1070,1030,2100,29
NAKASEKE,2015,1170,910,2080,29
NAKASEKE,2016,1220,930,2150,29
NAKASEKE,2017,1260,950,2210,29
NAKASEKE,2018,1310,980,2290,29
NAKASEKE,2019,1350,1000,2350,29
NAKASEKE,2020,1400,1020,2420,29
NAKASEKE,2021,1450,1040,2490,29
NAKASEKE,2022,1500,1060,2560,29
NAKASEKE,2023,1550,1090,2640,29
NAKASEKE,2024,1600,1110,2710,29
NAKASEKE,2025,1640,1130,2770,29
NAKASONGOLA,2015,1370,1150,2520,29
NAKASONGOLA,2016,1420,1200,2620,29
NAKASONGOLA,2017,1480,1260,2740,29
NAKASONGOLA,2018,1540,1330,2870,29
NAKASONGOLA,2019,1590,1400,2990,29
NAKASONGOLA,2020,1660,1460,3120,29
NAKASONGOLA,2021,1730,1520,3250,29
NAKASONGOLA,2022,1840,1560,3400,29
NAKASONGOLA,2023,1940,1590,3530,29
NAKASONGOLA,2024,2040,1610,3650,29
NAKASONGOLA,2025,2140,1630,3770,29
NAMAYINGO,2015,1330,1570,2900,29
NAMAYINGO,2016,1360,1630,2990,29
NAMAYINGO,2017,1390,1690,3080,29
NAMAYINGO,2018,1430,1760,3190,29
NAMAYINGO,2019,1460,1830,3290,29
NAMAYINGO,2020,1500,1900,3400,29
NAMAYINGO,2021,1560,1930,3490,29
NAMAYINGO,2022,1620,1960,3580,29
NAMAYINGO,2023,1680,1980,3660,29
NAMAYINGO,2024,1750,1970,3720,29
NAMAYINGO,2025,1810,1990,3800,29
NAMISINDWA,2015,840,1070,1910,29
NAMISINDWA,2016,860,1100,1960,29
NAMISINDWA,2017,890,1120,2010,29
NAMISINDWA,2018,910,1150,2060,29
NAMISINDWA,2019,940,1180,2120,29
NAMISINDWA,2020,960,1200,2160,29
NAMISINDWA,2021,990,1230,2220,29
NAMISINDWA,2022,1010,1250,2260,29
NAMISINDWA,2023,1040,1280,2320,29
NAMISINDWA,2024,1060,1300,2360,29
NAMISINDWA,2025,1080,1330,2410,29
NAMUTUMBA,2015,1180,1530,2710,29
NAMUTUMBA,2016,1230,1600,2830,29
NAMUTUMBA,2017,1280,1700,2980,29
NAMUTUMBA,2018,1340,1790,3130,29
NAMUTUMBA,2019,1400,1910,3310,29
NAMUTUMBA,2020,1460,2000,3460,29
NAMUTUMBA,2021,1530,2090,3620,29
NAMUTUMBA,2022,1620,2150,3770,29
NAMUTUMBA,2023,1710,2200,3910,29
NAMUTUMBA,2024,1810,2250,4060,29
NAMUTUMBA,2025,1910,2300,4210,29
NAPAK,2015,640,900,1540,29
NAPAK,2016,660,940,1600,29
NAPAK,2017,660,980,1640,29
NAPAK,2018,680,1030,1710,29
NAPAK,2019,690,1080,1770,29
NAPAK,2020,710,1120,1830,29
NAPAK,2021,730,1160,1890,29
NAPAK,2022,760,1180,1940,29
NAPAK,2023,800,1190,1990,29
NAPAK,2024,830,1200,2030,29
NAPAK,2025,850,1220,2070,29
NEBBI,2015,990,1260,2250,29
NEBBI,2016,1020,1300,2320,29
NEBBI,2017,1050,1330,2380,29
NEBBI,2018,1090,1370,2460,29
NEBBI,2019,1120,1410,2530,29
NEBBI,2020,1150,1450,2600,29
NEBBI,2021,1190,1490,2680,29
NEBBI,2022,1220,1520,2740,29
NEBBI,2023,1260,1560,2820,29
NEBBI,2024,1290,1600,2890,29
NEBBI,2025,1320,1640,2960,29
NGORA,2015,640,820,1460,29
NGORA,2016,660,860,1520,29
NGORA,2017,680,910,1590,29
NGORA,2018,700,950,1650,29
NGORA,2019,730,1000,1730,29
NGORA,2020,760,1050,1810,29
NGORA,2021,780,1080,1860,29
NGORA,2022,830,1110,1940,29
NGORA,2023,880,1130,2010,29
NGORA,2024,910,1140,2050,29
NGORA,2025,960,1160,2120,29
NTOROKO,2015,480,470,950,29
NTOROKO,2016,500,480,980,29
NTOROKO,2017,510,500,1010,29
NTOROKO,2018,530,530,1060,29
NTOROKO,2019,540,550,1090,29
NTOROKO,2020,560,570,1130,29
NTOROKO,2021,590,590,1180,29
NTOROKO,2022,620,600,1220,29
NTOROKO,2023,650,610,1260,29
NTOROKO,2024,680,610,1290,29
NTOROKO,2025,710,610,1320,29
NTUNGAMO,2015,2300,2800,5100,29
NTUNGAMO,2016,2350,2850,5200,29
NTUNGAMO,2017,2400,2910,5310,29
NTUNGAMO,2018,2450,2960,5410,29
NTUNGAMO,2019,2500,3010,5510,29
NTUNGAMO,2020,2550,3060,5610,29
NTUNGAMO,2021,2600,3110,5710,29
NTUNGAMO,2022,2650,3160,5810,29
NTUNGAMO,2023,2690,3210,5900,29
NTUNGAMO,2024,2740,3260,6000,29
NTUNGAMO,2025,2780,3300,6080,29
NWOYA,2015,690,790,1480,29
NWOYA,2016,760,870,1630,29
NWOYA,2017,840,960,1800,29
NWOYA,2018,930,1050,1980,29
NWOYA,2019,1030,1160,2190,29
NWOYA,2020,1130,1280,2410,29
NWOYA,2021,1250,1400,2650,29
NWOYA,2022,1380,1540,2920,29
NWOYA,2023,1520,1700,3220,29
NWOYA,2024,1670,1860,3530,29
NWOYA,2025,1830,2040,3870,29
OBONGI,2015,240,290,530,29
OBONGI,2016,260,300,560,29
OBONGI,2017,260,320,580,29
OBONGI,2018,270,330,600,29
OBONGI,2019,270,350,620,29
OBONGI,2020,290,360,650,29
OBONGI,2021,290,370,660,29
OBONGI,2022,310,390,700,29
OBONGI,2023,320,390,710,29
OBONGI,2024,340,390,730,29
OBONGI,2025,350,390,740,29
OMORO,2015,920,1100,2020,29
OMORO,2016,960,1160,2120,29
OMORO,2017,1000,1220,2220,29
OMORO,2018,1040,1310,2350,29
OMORO,2019,1090,1380,2470,29
OMORO,2020,1130,1460,2590,29
OMORO,2021,1190,1520,2710,29
OMORO,2022,1270,1580,2850,29
OMORO,2023,1340,1620,2960,29
OMORO,2024,1410,1640,3050,29
OMORO,2025,1490,1690,3180,29
OTUKE,2015,540,600,1140,29
OTUKE,2016,570,620,1190,29
OTUKE,2017,590,650,1240,29
OTUKE,2018,620,680,1300,29
OTUKE,2019,650,710,1360,29
OTUKE,2020,670,740,1410,29
OTUKE,2021,700,770,1470,29
OTUKE,2022,730,800,1530,29
OTUKE,2023,760,830,1590,29
OTUKE,2024,790,860,1650,29
OTUKE,2025,820,890,1710,29
OYAM,2015,2070,2380,4450,29
OYAM,2016,2130,2450,4580,29
OYAM,2017,2200,2520,4720,29
OYAM,2018,2260,2590,4850,29
OYAM,2019,2330,2670,5000,29
OYAM,2020,2400,2740,5140,29
OYAM,2021,2470,2820,5290,29
OYAM,2022,2540,2890,5430,29
OYAM,2023,2600,2960,5560,29
OYAM,2024,2670,3040,5710,29
OYAM,2025,2740,3110,5850,29
PADER,2015,950,1280,2230,29
PADER,2016,980,1330,2310,29
PADER,2017,1000,1380,2380,29
PADER,2018,1030,1440,2470,29
PADER,2019,1050,1510,2560,29
PADER,2020,1080,1570,2650,29
PADER,2021,1110,1610,2720,29
PADER,2022,1150,1640,2790,29
PADER,2023,1210,1660,2870,29
PADER,2024,1250,1670,2920,29
PADER,2025,1290,1690,2980,29
PAKWACH,2015,710,910,1620,29
PAKWACH,2016,740,940,1680,29
PAKWACH,2017,770,970,1740,29
PAKWACH,2018,800,1010,1810,29
PAKWACH,2019,840,1050,1890,29
PAKWACH,2020,870,1080,1950,29
PAKWACH,2021,910,1120,2030,29
PAKWACH,2022,940,1160,2100,29
PAKWACH,2023,980,1200,2180,29
PAKWACH,2024,1010,1230,2240,29
PAKWACH,2025,1050,1270,2320,29
PALLISA,2015,1350,1630,2980,29
PALLISA,2016,1420,1730,3150,29
PALLISA,2017,1500,1850,3350,29
PALLISA,2018,1570,1970,3540,29
PALLISA,2019,1660,2110,3770,29
PALLISA,2020,1750,2250,4000,29
PALLISA,2021,1850,2370,4220,29
PALLISA,2022,1970,2470,4440,29
PALLISA,2023,2110,2560,4670,29
PALLISA,2024,2240,2630,4870,29
PALLISA,2025,2390,2720,5110,29
RAKAI,2015,1400,1620,3020,29
RAKAI,2016,1450,1690,3140,29
RAKAI,2017,1490,1760,3250,29
RAKAI,2018,1540,1840,3380,29
RAKAI,2019,1580,1950,3530,29
RAKAI,2020,1630,2030,3660,29
RAKAI,2021,1710,2090,3800,29
RAKAI,2022,1780,2140,3920,29
RAKAI,2023,1870,2160,4030,29
RAKAI,2024,1960,2180,4140,29
RAKAI,2025,2050,2210,4260,29
RUBANDA,2015,900,1210,2110,29
RUBANDA,2016,920,1220,2140,29
RUBANDA,2017,930,1230,2160,29
RUBANDA,2018,940,1240,2180,29
RUBANDA,2019,950,1250,2200,29
RUBANDA,2020,960,1260,2220,29
RUBANDA,2021,970,1270,2240,29
RUBANDA,2022,980,1270,2250,29
RUBANDA,2023,990,1280,2270,29
RUBANDA,2024,1000,1290,2290,29
RUBANDA,2025,1010,1290,2300,29
RUBIRIZI,2015,550,750,1300,29
RUBIRIZI,2016,560,760,1320,29
RUBIRIZI,2017,580,780,1360,29
RUBIRIZI,2018,590,790,1380,29
RUBIRIZI,2019,600,810,1410,29
RUBIRIZI,2020,610,820,1430,29
RUBIRIZI,2021,620,840,1460,29
RUBIRIZI,2022,630,850,1480,29
RUBIRIZI,2023,640,860,1500,29
RUBIRIZI,2024,650,880,1530,29
RUBIRIZI,2025,660,890,1550,29
RUKIGA,2015,520,640,1160,29
RUKIGA,2016,530,640,1170,29
RUKIGA,2017,530,650,1180,29
RUKIGA,2018,540,650,1190,29
RUKIGA,2019,540,660,1200,29
RUKIGA,2020,550,660,1210,29
RUKIGA,2021,550,660,1210,29
RUKIGA,2022,560,670,1230,29
RUKIGA,2023,560,670,1230,29
RUKIGA,2024,560,670,1230,29
RUKIGA,2025,560,670,1230,29
RUKUNGIRI,2015,1390,1850,3240,29
RUKUNGIRI,2016,1410,1870,3280,29
RUKUNGIRI,2017,1420,1880,3300,29
RUKUNGIRI,2018,1440,1900,3340,29
RUKUNGIRI,2019,1460,1920,3380,29
RUKUNGIRI,2020,1470,1930,3400,29
RUKUNGIRI,2021,1490,1950,3440,29
RUKUNGIRI,2022,1500,1960,3460,29
RUKUNGIRI,2023,1510,1980,3490,29
RUKUNGIRI,2024,1520,1990,3510,29
RUKUNGIRI,2025,1540,2000,3540,29
RWAMPARA,2015,670,730,1400,29
RWAMPARA,2016,690,750,1440,29
RWAMPARA,2017,710,760,1470,29
RWAMPARA,2018,720,780,1500,29
RWAMPARA,2019,740,800,1540,29
RWAMPARA,2020,750,810,1560,29
RWAMPARA,2021,770,830,1600,29
RWAMPARA,2022,780,850,1630,29
RWAMPARA,2023,800,860,1660,29
RWAMPARA,2024,810,880,1690,29
RWAMPARA,2025,830,890,1720,29
SERERE,2015,1590,1850,3440,29
SERERE,2016,1680,1950,3630,29
SERERE,2017,1760,2070,3830,29
SERERE,2018,1840,2210,4050,29
SERERE,2019,1930,2360,4290,29
SERERE,2020,2020,2500,4520,29
SERERE,2021,2140,2630,4770,29
SERERE,2022,2260,2720,4980,29
SERERE,2023,2410,2800,5210,29
SERERE,2024,2570,2880,5450,29
SERERE,2025,2730,2960,5690,29
SHEEMA,2015,1000,1230,2230,29
SHEEMA,2016,1010,1250,2260,29
SHEEMA,2017,1020,1260,2280,29
SHEEMA,2018,1040,1270,2310,29
SHEEMA,2019,1050,1290,2340,29
SHEEMA,2020,1060,1300,2360,29
SHEEMA,2021,1070,1310,2380,29
SHEEMA,2022,1080,1320,2400,29
SHEEMA,2023,1090,1330,2420,29
SHEEMA,2024,1100,1340,2440,29
SHEEMA,2025,1100,1340,2440,29
SIRONKO,2015,970,1190,2160,29
SIRONKO,2016,990,1220,2210,29
SIRONKO,2017,1020,1240,2260,29
SIRONKO,2018,1040,1270,2310,29
SIRONKO,2019,1070,1290,2360,29
SIRONKO,2020,1090,1320,2410,29
SIRONKO,2021,1110,1340,2450,29
SIRONKO,2022,1140,1370,2510,29
SIRONKO,2023,1160,1390,2550,29
SIRONKO,2024,1180,1410,2590,29
SIRONKO,2025,1200,1430,2630,29
SOROTI,2015,1740,1950,3690,29
SOROTI,2016,1820,2060,3880,29
SOROTI,2017,1890,2180,4070,29
SOROTI,2018,1980,2310,4290,29
SOROTI,2019,2060,2460,4520,29
SOROTI,2020,2160,2590,4750,29
SOROTI,2021,2270,2710,4980,29
SOROTI,2022,2390,2800,5190,29
SOROTI,2023,2530,2870,5400,29
SOROTI,2024,2690,2930,5620,29
SOROTI,2025,2840,3010,5850,29
SSEMBABULE,2015,1460,1660,3120,29
SSEMBABULE,2016,1510,1720,3230,29
SSEMBABULE,2017,1560,1810,3370,29
SSEMBABULE,2018,1620,1910,3530,29
SSEMBABULE,2019,1680,2010,3690,29
SSEMBABULE,2020,1730,2110,3840,29
SSEMBABULE,2021,1810,2190,4000,29
SSEMBABULE,2022,1900,2240,4140,29
SSEMBABULE,2023,2000,2280,4280,29
SSEMBABULE,2024,2110,2300,4410,29
SSEMBABULE,2025,2210,2340,4550,29
TORORO,2015,2190,2930,5120,29
TORORO,2016,2250,3010,5260,29
TORORO,2017,2310,3080,5390,29
TORORO,2018,2370,3160,5530,29
TORORO,2019,2430,3230,5660,29
TORORO,2020,2500,3310,5810,29
TORORO,2021,2560,3380,5940,29
TORORO,2022,2620,3460,6080,29
TORORO,2023,2680,3540,6220,29
TORORO,2024,2740,3610,6350,29
TORORO,2025,2790,3680,6470,29
WAKISO,2015,14900,17960,32860,29
WAKISO,2016,15890,19180,35070,29
WAKISO,2017,16960,20500,37460,29
WAKISO,2018,18080,21880,39960,29
WAKISO,2019,19290,23350,42640,29
WAKISO,2020,20540,24910,45450,29
WAKISO,2021,21860,26560,48420,29
WAKISO,2022,23260,28310,51570,29
WAKISO,2023,24740,30130,54870,29
WAKISO,2024,26280,32050,58330,29
WAKISO,2025,27900,34090,61990,29
YUMBE,2015,2170,2790,4960,29
YUMBE,2016,2300,3000,5300,29
YUMBE,2017,2430,3250,5680,29
YUMBE,2018,2570,3530,6100,29
YUMBE,2019,2720,3840,6560,29
YUMBE,2020,2880,4150,7030,29
YUMBE,2021,3080,4440,7520,29
YUMBE,2022,3300,4690,7990,29
YUMBE,2023,3540,4930,8470,29
YUMBE,2024,3810,5140,8950,29
YUMBE,2025,4080,5400,9480,29
ZOMBO,2015,960,1190,2150,29
ZOMBO,2016,990,1220,2210,29
ZOMBO,2017,1020,1250,2270,29
ZOMBO,2018,1050,1290,2340,29
ZOMBO,2019,1080,1320,2400,29
ZOMBO,2020,1110,1360,2470,29
ZOMBO,2021,1140,1390,2530,29
ZOMBO,2022,1180,1430,2610,29
ZOMBO,2023,1210,1460,2670,29
ZOMBO,2024,1240,1500,2740,29
ZOMBO,2025,1270,1530,2800,29
ABIM,2015,1830,1810,3640,3
ABIM,2016,1940,1900,3840,3
ABIM,2017,2110,2050,4160,3
ABIM,2018,2190,2240,4430,3
ABIM,2019,2310,2350,4660,3
ABIM,2020,2430,2470,4900,3
ABIM,2021,2550,2590,5140,3
ABIM,2022,2680,2710,5390,3
ABIM,2023,2800,2840,5640,3
ABIM,2024,2940,2970,5910,3
ABIM,2025,3080,3100,6180,3
ADJUMANI,2015,4540,4120,8660,3
ADJUMANI,2016,4580,4160,8740,3
ADJUMANI,2017,4610,4200,8810,3
ADJUMANI,2018,4640,4240,8880,3
ADJUMANI,2019,4680,4280,8960,3
ADJUMANI,2020,4700,4320,9020,3
ADJUMANI,2021,4730,4350,9080,3
ADJUMANI,2022,4750,4380,9130,3
ADJUMANI,2023,4760,4410,9170,3
ADJUMANI,2024,4780,4440,9220,3
ADJUMANI,2025,4790,4460,9250,3
AGAGO,2015,4630,4440,9070,3
AGAGO,2016,4710,4510,9220,3
AGAGO,2017,4800,4590,9390,3
AGAGO,2018,4880,4680,9560,3
AGAGO,2019,4960,4750,9710,3
AGAGO,2020,5040,4830,9870,3
AGAGO,2021,5110,4900,10010,3
AGAGO,2022,5190,4980,10170,3
AGAGO,2023,5260,5050,10310,3
AGAGO,2024,5330,5120,10450,3
AGAGO,2025,5400,5180,10580,3
ALEBTONG,2015,4070,3860,7930,3
ALEBTONG,2016,4150,3930,8080,3
ALEBTONG,2017,4370,4090,8460,3
ALEBTONG,2018,4390,4350,8740,3
ALEBTONG,2019,4470,4410,8880,3
ALEBTONG,2020,4540,4490,9030,3
ALEBTONG,2021,4610,4550,9160,3
ALEBTONG,2022,4660,4610,9270,3
ALEBTONG,2023,4730,4670,9400,3
ALEBTONG,2024,4790,4730,9520,3
ALEBTONG,2025,4840,4790,9630,3
AMOLATAR,2015,2650,2370,5020,3
AMOLATAR,2016,2690,2410,5100,3
AMOLATAR,2017,2830,2510,5340,3
AMOLATAR,2018,2840,2660,5500,3
AMOLATAR,2019,2880,2700,5580,3
AMOLATAR,2020,2920,2730,5650,3
AMOLATAR,2021,2970,2770,5740,3
AMOLATAR,2022,3000,2790,5790,3
AMOLATAR,2023,3030,2830,5860,3
AMOLATAR,2024,3070,2850,5920,3
AMOLATAR,2025,3090,2870,5960,3
AMUDAT,2015,1700,1760,3460,3
AMUDAT,2016,1750,1830,3580,3
AMUDAT,2017,1860,1950,3810,3
AMUDAT,2018,1890,2100,3990,3
AMUDAT,2019,1940,2170,4110,3
AMUDAT,2020,2000,2250,4250,3
AMUDAT,2021,2050,2320,4370,3
AMUDAT,2022,2100,2410,4510,3
AMUDAT,2023,2150,2480,4630,3
AMUDAT,2024,2200,2560,4760,3
AMUDAT,2025,2250,2640,4890,3
AMURIA,2015,3450,3160,6610,3
AMURIA,2016,3550,3250,6800,3
AMURIA,2017,3760,3410,7170,3
AMURIA,2018,3820,3650,7470,3
AMURIA,2019,3920,3740,7660,3
AMURIA,2020,4020,3820,7840,3
AMURIA,2021,4120,3910,8030,3
AMURIA,2022,4210,3990,8200,3
AMURIA,2023,4310,4070,8380,3
AMURIA,2024,4400,4150,8550,3
AMURIA,2025,4490,4230,8720,3
AMURU,2015,3440,3260,6700,3
AMURU,2016,3500,3320,6820,3
AMURU,2017,3660,3450,7110,3
AMURU,2018,3690,3670,7360,3
AMURU,2019,3740,3730,7470,3
AMURU,2020,3790,3790,7580,3
AMURU,2021,3840,3830,7670,3
AMURU,2022,3880,3880,7760,3
AMURU,2023,3930,3930,7860,3
AMURU,2024,3970,3980,7950,3
AMURU,2025,4000,4020,8020,3
APAC,2015,3390,3120,6510,3
APAC,2016,3510,3230,6740,3
APAC,2017,3640,3340,6980,3
APAC,2018,3780,3450,7230,3
APAC,2019,3910,3570,7480,3
APAC,2020,4050,3690,7740,3
APAC,2021,4190,3810,8000,3
APAC,2022,4330,3930,8260,3
APAC,2023,4470,4050,8520,3
APAC,2024,4620,4180,8800,3
APAC,2025,4770,4300,9070,3
ARUA,2015,12240,11650,23890,3
ARUA,2016,12600,11970,24570,3
ARUA,2017,12950,12300,25250,3
ARUA,2018,13330,12620,25950,3
ARUA,2019,13700,12960,26660,3
ARUA,2020,14070,13290,27360,3
ARUA,2021,14460,13620,28080,3
ARUA,2022,14830,13950,28780,3
ARUA,2023,15200,14290,29490,3
ARUA,2024,15570,14620,30190,3
ARUA,2025,15940,14950,30890,3
BUDAKA,2015,3920,3650,7570,3
BUDAKA,2016,4030,3740,7770,3
BUDAKA,2017,4260,3920,8180,3
BUDAKA,2018,4330,4190,8520,3
BUDAKA,2019,4430,4290,8720,3
BUDAKA,2020,4540,4390,8930,3
BUDAKA,2021,4640,4480,9120,3
BUDAKA,2022,4740,4580,9320,3
BUDAKA,2023,4840,4660,9500,3
BUDAKA,2024,4940,4750,9690,3
BUDAKA,2025,5030,4840,9870,3
BUDUDA,2015,3560,3310,6870,3
BUDUDA,2016,3690,3420,7110,3
BUDUDA,2017,3940,3630,7570,3
BUDUDA,2018,4030,3910,7940,3
BUDUDA,2019,4170,4050,8220,3
BUDUDA,2020,4310,4180,8490,3
BUDUDA,2021,4450,4320,8770,3
BUDUDA,2022,4580,4450,9030,3
BUDUDA,2023,4720,4590,9310,3
BUDUDA,2024,4860,4720,9580,3
BUDUDA,2025,4990,4860,9850,3
BUGIRI,2015,7540,6960,14500,3
BUGIRI,2016,7800,7180,14980,3
BUGIRI,2017,8290,7560,15850,3
BUGIRI,2018,8460,8130,16590,3
BUGIRI,2019,8710,8350,17060,3
BUGIRI,2020,8960,8590,17550,3
BUGIRI,2021,9200,8820,18020,3
BUGIRI,2022,9460,9040,18500,3
BUGIRI,2023,9690,9260,18950,3
BUGIRI,2024,9940,9490,19430,3
BUGIRI,2025,10180,9710,19890,3
BUGWERI,2015,3030,2960,5990,3
BUGWERI,2016,3080,3020,6100,3
BUGWERI,2017,3240,3130,6370,3
BUGWERI,2018,3260,3330,6590,3
BUGWERI,2019,3310,3370,6680,3
BUGWERI,2020,3360,3420,6780,3
BUGWERI,2021,3410,3460,6870,3
BUGWERI,2022,3450,3510,6960,3
BUGWERI,2023,3500,3550,7050,3
BUGWERI,2024,3530,3590,7120,3
BUGWERI,2025,3570,3620,7190,3
BUHWEJU,2015,2460,2290,4750,3
BUHWEJU,2016,2540,2350,4890,3
BUHWEJU,2017,2620,2430,5050,3
BUHWEJU,2018,2710,2500,5210,3
BUHWEJU,2019,2790,2580,5370,3
BUHWEJU,2020,2880,2650,5530,3
BUHWEJU,2021,2970,2720,5690,3
BUHWEJU,2022,3060,2800,5860,3
BUHWEJU,2023,3150,2880,6030,3
BUHWEJU,2024,3230,2950,6180,3
BUHWEJU,2025,3320,3030,6350,3
BUIKWE,2015,7230,6720,13950,3
BUIKWE,2016,7330,6800,14130,3
BUIKWE,2017,7640,7030,14670,3
BUIKWE,2018,7640,7420,15060,3
BUIKWE,2019,7700,7490,15190,3
BUIKWE,2020,7760,7560,15320,3
BUIKWE,2021,7820,7630,15450,3
BUIKWE,2022,7860,7680,15540,3
BUIKWE,2023,7900,7720,15620,3
BUIKWE,2024,7940,7770,15710,3
BUIKWE,2025,7970,7800,15770,3
BUKEDEA,2015,3630,3510,7140,3
BUKEDEA,2016,3770,3630,7400,3
BUKEDEA,2017,4010,3830,7840,3
BUKEDEA,2018,4110,4120,8230,3
BUKEDEA,2019,4250,4250,8500,3
BUKEDEA,2020,4380,4380,8760,3
BUKEDEA,2021,4520,4500,9020,3
BUKEDEA,2022,4650,4630,9280,3
BUKEDEA,2023,4790,4750,9540,3
BUKEDEA,2024,4920,4880,9800,3
BUKEDEA,2025,5060,5000,10060,3
BUKOMANSIMBI,2015,2630,2430,5060,3
BUKOMANSIMBI,2016,2630,2420,5050,3
BUKOMANSIMBI,2017,2710,2470,5180,3
BUKOMANSIMBI,2018,2670,2560,5230,3
BUKOMANSIMBI,2019,2660,2550,5210,3
BUKOMANSIMBI,2020,2660,2530,5190,3
BUKOMANSIMBI,2021,2640,2520,5160,3
BUKOMANSIMBI,2022,2630,2490,5120,3
BUKOMANSIMBI,2023,2610,2480,5090,3
BUKOMANSIMBI,2024,2580,2450,5030,3
BUKOMANSIMBI,2025,2560,2430,4990,3
BUKWO,2015,1980,1770,3750,3
BUKWO,2016,2090,1860,3950,3
BUKWO,2017,2200,1940,4140,3
BUKWO,2018,2320,2040,4360,3
BUKWO,2019,2440,2140,4580,3
BUKWO,2020,2560,2240,4800,3
BUKWO,2021,2690,2340,5030,3
BUKWO,2022,2830,2450,5280,3
BUKWO,2023,2970,2560,5530,3
BUKWO,2024,3110,2680,5790,3
BUKWO,2025,3270,2800,6070,3
BULAMBULI,2015,2840,2810,5650,3
BULAMBULI,2016,2970,2930,5900,3
BULAMBULI,2017,3170,3110,6280,3
BULAMBULI,2018,3270,3380,6650,3
BULAMBULI,2019,3390,3510,6900,3
BULAMBULI,2020,3520,3640,7160,3
BULAMBULI,2021,3640,3780,7420,3
BULAMBULI,2022,3770,3910,7680,3
BULAMBULI,2023,3900,4040,7940,3
BULAMBULI,2024,4030,4190,8220,3
BULAMBULI,2025,4150,4320,8470,3
BULIISA,2015,2390,2110,4500,3
BULIISA,2016,2520,2200,4720,3
BULIISA,2017,2660,2300,4960,3
BULIISA,2018,2800,2400,5200,3
BULIISA,2019,2950,2500,5450,3
BULIISA,2020,3100,2610,5710,3
BULIISA,2021,3260,2720,5980,3
BULIISA,2022,3430,2840,6270,3
BULIISA,2023,3600,2950,6550,3
BULIISA,2024,3780,3070,6850,3
BULIISA,2025,3960,3190,7150,3
BUNDIBUGYO,2015,4480,4270,8750,3
BUNDIBUGYO,2016,4580,4350,8930,3
BUNDIBUGYO,2017,4820,4530,9350,3
BUNDIBUGYO,2018,4870,4810,9680,3
BUNDIBUGYO,2019,4950,4890,9840,3
BUNDIBUGYO,2020,5040,4970,10010,3
BUNDIBUGYO,2021,5120,5040,10160,3
BUNDIBUGYO,2022,5200,5110,10310,3
BUNDIBUGYO,2023,5280,5180,10460,3
BUNDIBUGYO,2024,5360,5250,10610,3
BUNDIBUGYO,2025,5420,5310,10730,3
BUNYANGABU,2015,3110,2910,6020,3
BUNYANGABU,2016,3160,2950,6110,3
BUNYANGABU,2017,3310,3060,6370,3
BUNYANGABU,2018,3330,3240,6570,3
BUNYANGABU,2019,3380,3280,6660,3
BUNYANGABU,2020,3420,3310,6730,3
BUNYANGABU,2021,3470,3340,6810,3
BUNYANGABU,2022,3500,3380,6880,3
BUNYANGABU,2023,3540,3410,6950,3
BUNYANGABU,2024,3570,3440,7010,3
BUNYANGABU,2025,3600,3460,7060,3
BUSHENYI,2015,3830,3640,7470,3
BUSHENYI,2016,3880,3680,7560,3
BUSHENYI,2017,3930,3710,7640,3
BUSHENYI,2018,3980,3740,7720,3
BUSHENYI,2019,4020,3770,7790,3
BUSHENYI,2020,4070,3800,7870,3
BUSHENYI,2021,4110,3830,7940,3
BUSHENYI,2022,4150,3850,8000,3
BUSHENYI,2023,4180,3870,8050,3
BUSHENYI,2024,4210,3890,8100,3
BUSHENYI,2025,4240,3910,8150,3
BUSIA,2015,5900,5480,11380,3
BUSIA,2016,6040,5580,11620,3
BUSIA,2017,6360,5830,12190,3
BUSIA,2018,6430,6200,12630,3
BUSIA,2019,6560,6310,12870,3
BUSIA,2020,6680,6430,13110,3
BUSIA,2021,6800,6530,13330,3
BUSIA,2022,6920,6630,13550,3
BUSIA,2023,7030,6730,13760,3
BUSIA,2024,7150,6830,13980,3
BUSIA,2025,7250,6910,14160,3
BUTALEJA,2015,4980,4620,9600,3
BUTALEJA,2016,5130,4750,9880,3
BUTALEJA,2017,5430,4980,10410,3
BUTALEJA,2018,5530,5330,10860,3
BUTALEJA,2019,5670,5470,11140,3
BUTALEJA,2020,5810,5600,11410,3
BUTALEJA,2021,5950,5730,11680,3
BUTALEJA,2022,6090,5860,11950,3
BUTALEJA,2023,6230,5990,12220,3
BUTALEJA,2024,6370,6110,12480,3
BUTALEJA,2025,6500,6230,12730,3
BUTAMBALA,2015,1930,1720,3650,3
BUTAMBALA,2016,1950,1720,3670,3
BUTAMBALA,2017,2020,1770,3790,3
BUTAMBALA,2018,1990,1840,3830,3
BUTAMBALA,2019,2000,1840,3840,3
BUTAMBALA,2020,2000,1850,3850,3
BUTAMBALA,2021,2010,1850,3860,3
BUTAMBALA,2022,2010,1840,3850,3
BUTAMBALA,2023,2000,1830,3830,3
BUTAMBALA,2024,2000,1830,3830,3
BUTAMBALA,2025,1990,1820,3810,3
BUTEBO,2015,2110,1960,4070,3
BUTEBO,2016,2130,1970,4100,3
BUTEBO,2017,2210,2030,4240,3
BUTEBO,2018,2190,2130,4320,3
BUTEBO,2019,2200,2130,4330,3
BUTEBO,2020,2210,2130,4340,3
BUTEBO,2021,2220,2140,4360,3
BUTEBO,2022,2220,2140,4360,3
BUTEBO,2023,2220,2130,4350,3
BUTEBO,2024,2220,2140,4360,3
BUTEBO,2025,2220,2130,4350,3
BUVUMA,2015,2010,1780,3790,3
BUVUMA,2016,2130,1900,4030,3
BUVUMA,2017,2270,2030,4300,3
BUVUMA,2018,2400,2170,4570,3
BUVUMA,2019,2550,2310,4860,3
BUVUMA,2020,2700,2470,5170,3
BUVUMA,2021,2870,2630,5500,3
BUVUMA,2022,3030,2800,5830,3
BUVUMA,2023,3210,2970,6180,3
BUVUMA,2024,3390,3170,6560,3
BUVUMA,2025,3580,3360,6940,3
BUYENDE,2015,6960,6630,13590,3
BUYENDE,2016,7220,6860,14080,3
BUYENDE,2017,7700,7250,14950,3
BUYENDE,2018,7880,7830,15710,3
BUYENDE,2019,8140,8080,16220,3
BUYENDE,2020,8410,8340,16750,3
BUYENDE,2021,8670,8600,17270,3
BUYENDE,2022,8940,8860,17800,3
BUYENDE,2023,9190,9110,18300,3
BUYENDE,2024,9460,9370,18830,3
BUYENDE,2025,9720,9630,19350,3
DOKOLO,2015,3300,3090,6390,3
DOKOLO,2016,3410,3180,6590,3
DOKOLO,2017,3510,3270,6780,3
DOKOLO,2018,3620,3360,6980,3
DOKOLO,2019,3730,3450,7180,3
DOKOLO,2020,3830,3540,7370,3
DOKOLO,2021,3940,3630,7570,3
DOKOLO,2022,4050,3710,7760,3
DOKOLO,2023,4160,3800,7960,3
DOKOLO,2024,4270,3900,8170,3
DOKOLO,2025,4380,3980,8360,3
GOMBA,2015,2930,2720,5650,3
GOMBA,2016,2960,2740,5700,3
GOMBA,2017,3070,2800,5870,3
GOMBA,2018,3060,2940,6000,3
GOMBA,2019,3080,2940,6020,3
GOMBA,2020,3090,2950,6040,3
GOMBA,2021,3110,2950,6060,3
GOMBA,2022,3120,2940,6060,3
GOMBA,2023,3130,2930,6060,3
GOMBA,2024,3130,2930,6060,3
GOMBA,2025,3130,2920,6050,3
GULU,2015,4770,4490,9260,3
GULU,2016,4910,4620,9530,3
GULU,2017,5060,4750,9810,3
GULU,2018,5210,4890,10100,3
GULU,2019,5360,5030,10390,3
GULU,2020,5520,5170,10690,3
GULU,2021,5670,5310,10980,3
GULU,2022,5820,5450,11270,3
GULU,2023,5980,5590,11570,3
GULU,2024,6130,5730,11860,3
GULU,2025,6280,5870,12150,3
HOIMA,2015,5910,5600,11510,3
HOIMA,2016,6130,5790,11920,3
HOIMA,2017,6360,6000,12360,3
HOIMA,2018,6600,6200,12800,3
HOIMA,2019,6840,6410,13250,3
HOIMA,2020,7090,6630,13720,3
HOIMA,2021,7340,6840,14180,3
HOIMA,2022,7590,7060,14650,3
HOIMA,2023,7850,7280,15130,3
HOIMA,2024,8110,7500,15610,3
HOIMA,2025,8370,7730,16100,3
IBANDA,2015,4410,4210,8620,3
IBANDA,2016,4500,4280,8780,3
IBANDA,2017,4580,4360,8940,3
IBANDA,2018,4670,4440,9110,3
IBANDA,2019,4760,4520,9280,3
IBANDA,2020,4850,4590,9440,3
IBANDA,2021,4940,4660,9600,3
IBANDA,2022,5020,4730,9750,3
IBANDA,2023,5100,4800,9900,3
IBANDA,2024,5170,4870,10040,3
IBANDA,2025,5250,4940,10190,3
IGANGA,2015,6150,5640,11790,3
IGANGA,2016,6300,5750,12050,3
IGANGA,2017,6630,6000,12630,3
IGANGA,2018,6700,6390,13090,3
IGANGA,2019,6840,6510,13350,3
IGANGA,2020,6970,6620,13590,3
IGANGA,2021,7100,6730,13830,3
IGANGA,2022,7220,6830,14050,3
IGANGA,2023,7330,6930,14260,3
IGANGA,2024,7450,7040,14490,3
IGANGA,2025,7560,7130,14690,3
ISINGIRO,2015,9800,9570,19370,3
ISINGIRO,2016,10170,9910,20080,3
ISINGIRO,2017,10550,10260,20810,3
ISINGIRO,2018,10940,10620,21560,3
ISINGIRO,2019,11340,10980,22320,3
ISINGIRO,2020,11740,11350,23090,3
ISINGIRO,2021,12160,11730,23890,3
ISINGIRO,2022,12570,12110,24680,3
ISINGIRO,2023,13000,12490,25490,3
ISINGIRO,2024,13420,12890,26310,3
ISINGIRO,2025,13850,13280,27130,3
JINJA,2015,8170,7870,16040,3
JINJA,2016,8310,7990,16300,3
JINJA,2017,8450,8110,16560,3
JINJA,2018,8590,8240,16830,3
JINJA,2019,8730,8360,17090,3
JINJA,2020,8860,8470,17330,3
JINJA,2021,8990,8590,17580,3
JINJA,2022,9110,8700,17810,3
JINJA,2023,9230,8800,18030,3
JINJA,2024,9350,8900,18250,3
JINJA,2025,9450,8990,18440,3
KAABONG,2015,1970,1820,3790,3
KAABONG,2016,2030,1870,3900,3
KAABONG,2017,2090,1920,4010,3
KAABONG,2018,2130,1960,4090,3
KAABONG,2019,2200,2000,4200,3
KAABONG,2020,2250,2050,4300,3
KAABONG,2021,2310,2100,4410,3
KAABONG,2022,2360,2150,4510,3
KAABONG,2023,2420,2190,4610,3
KAABONG,2024,2470,2230,4700,3
KAABONG,2025,2530,2280,4810,3
KABALE,2015,3910,3680,7590,3
KABALE,2016,3970,3730,7700,3
KABALE,2017,4040,3770,7810,3
KABALE,2018,4100,3820,7920,3
KABALE,2019,4160,3860,8020,3
KABALE,2020,4220,3900,8120,3
KABALE,2021,4270,3940,8210,3
KABALE,2022,4320,3980,8300,3
KABALE,2023,4380,4010,8390,3
KABALE,2024,4430,4040,8470,3
KABALE,2025,4470,4070,8540,3
KABAROLE,2015,5510,5070,10580,3
KABAROLE,2016,5630,5180,10810,3
KABAROLE,2017,5750,5300,11050,3
KABAROLE,2018,5880,5410,11290,3
KABAROLE,2019,6000,5520,11520,3
KABAROLE,2020,6120,5640,11760,3
KABAROLE,2021,6250,5750,12000,3
KABAROLE,2022,6370,5850,12220,3
KABAROLE,2023,6480,5960,12440,3
KABAROLE,2024,6590,6070,12660,3
KABAROLE,2025,6710,6170,12880,3
KABERAMAIDO,2015,1880,1820,3700,3
KABERAMAIDO,2016,1950,1860,3810,3
KABERAMAIDO,2017,2070,1970,4040,3
KABERAMAIDO,2018,2120,2130,4250,3
KABERAMAIDO,2019,2190,2180,4370,3
KABERAMAIDO,2020,2250,2250,4500,3
KABERAMAIDO,2021,2310,2310,4620,3
KABERAMAIDO,2022,2380,2370,4750,3
KABERAMAIDO,2023,2440,2420,4860,3
KABERAMAIDO,2024,2520,2490,5010,3
KABERAMAIDO,2025,2580,2540,5120,3
KAGADI,2015,7610,7280,14890,3
KAGADI,2016,7900,7540,15440,3
KAGADI,2017,8190,7810,16000,3
KAGADI,2018,8490,8080,16570,3
KAGADI,2019,8800,8360,17160,3
KAGADI,2020,9110,8640,17750,3
KAGADI,2021,9430,8930,18360,3
KAGADI,2022,9750,9220,18970,3
KAGADI,2023,10070,9520,19590,3
KAGADI,2024,10400,9810,20210,3
KAGADI,2025,10730,10110,20840,3
KAKUMIRO,2015,6760,6360,13120,3
KAKUMIRO,2016,7360,6890,14250,3
KAKUMIRO,2017,8010,7470,15480,3
KAKUMIRO,2018,8720,8100,16820,3
KAKUMIRO,2019,9480,8770,18250,3
KAKUMIRO,2020,10310,9490,19800,3
KAKUMIRO,2021,11190,10270,21460,3
KAKUMIRO,2022,12150,11110,23260,3
KAKUMIRO,2023,13170,12010,25180,3
KAKUMIRO,2024,14280,12960,27240,3
KAKUMIRO,2025,15460,13990,29450,3
KALAKI,2015,2140,2100,4240,3
KALAKI,2016,2230,2180,4410,3
KALAKI,2017,2330,2260,4590,3
KALAKI,2018,2430,2350,4780,3
KALAKI,2019,2530,2440,4970,3
KALAKI,2020,2630,2540,5170,3
KALAKI,2021,2750,2630,5380,3
KALAKI,2022,2850,2730,5580,3
KALAKI,2023,2970,2830,5800,3
KALAKI,2024,3080,2930,6010,3
KALAKI,2025,3200,3030,6230,3
KALANGALA,2015,950,820,1770,3
KALANGALA,2016,990,860,1850,3
KALANGALA,2017,1020,890,1910,3
KALANGALA,2018,1060,930,1990,3
KALANGALA,2019,1090,960,2050,3
KALANGALA,2020,1130,1000,2130,3
KALANGALA,2021,1170,1040,2210,3
KALANGALA,2022,1210,1080,2290,3
KALANGALA,2023,1240,1120,2360,3
KALANGALA,2024,1280,1170,2450,3
KALANGALA,2025,1320,1210,2530,3
KALIRO,2015,4590,4500,9090,3
KALIRO,2016,4720,4630,9350,3
KALIRO,2017,5000,4850,9850,3
KALIRO,2018,5070,5190,10260,3
KALIRO,2019,5190,5320,10510,3
KALIRO,2020,5310,5450,10760,3
KALIRO,2021,5430,5570,11000,3
KALIRO,2022,5550,5690,11240,3
KALIRO,2023,5660,5810,11470,3
KALIRO,2024,5770,5930,11700,3
KALIRO,2025,5880,6030,11910,3
KALUNGU,2015,3250,2890,6140,3
KALUNGU,2016,3260,2890,6150,3
KALUNGU,2017,3360,2960,6320,3
KALUNGU,2018,3330,3090,6420,3
KALUNGU,2019,3320,3090,6410,3
KALUNGU,2020,3320,3080,6400,3
KALUNGU,2021,3320,3080,6400,3
KALUNGU,2022,3310,3070,6380,3
KALUNGU,2023,3290,3050,6340,3
KALUNGU,2024,3280,3040,6320,3
KALUNGU,2025,3260,3020,6280,3
KAMPALA,2015,22570,20670,43240,3
KAMPALA,2016,23020,21080,44100,3
KAMPALA,2017,23470,21490,44960,3
KAMPALA,2018,23930,21890,45820,3
KAMPALA,2019,24370,22300,46670,3
KAMPALA,2020,24820,22700,47520,3
KAMPALA,2021,25250,23090,48340,3
KAMPALA,2022,25680,23480,49160,3
KAMPALA,2023,26090,23860,49950,3
KAMPALA,2024,26490,24220,50710,3
KAMPALA,2025,26870,24580,51450,3
KAMULI,2015,9010,8550,17560,3
KAMULI,2016,9180,8670,17850,3
KAMULI,2017,9610,9000,18610,3
KAMULI,2018,9670,9520,19190,3
KAMULI,2019,9800,9640,19440,3
KAMULI,2020,9940,9740,19680,3
KAMULI,2021,10070,9850,19920,3
KAMULI,2022,10190,9940,20130,3
KAMULI,2023,10300,10030,20330,3
KAMULI,2024,10410,10120,20530,3
KAMULI,2025,10500,10190,20690,3
KAMWENGE,2015,6010,5750,11760,3
KAMWENGE,2016,6260,5960,12220,3
KAMWENGE,2017,6510,6160,12670,3
KAMWENGE,2018,6770,6380,13150,3
KAMWENGE,2019,7050,6600,13650,3
KAMWENGE,2020,7310,6830,14140,3
KAMWENGE,2021,7600,7050,14650,3
KAMWENGE,2022,7880,7280,15160,3
KAMWENGE,2023,8170,7530,15700,3
KAMWENGE,2024,8470,7760,16230,3
KAMWENGE,2025,8770,8000,16770,3
KANUNGU,2015,4750,4390,9140,3
KANUNGU,2016,4830,4470,9300,3
KANUNGU,2017,4920,4540,9460,3
KANUNGU,2018,5010,4610,9620,3
KANUNGU,2019,5090,4680,9770,3
KANUNGU,2020,5180,4750,9930,3
KANUNGU,2021,5260,4820,10080,3
KANUNGU,2022,5340,4880,10220,3
KANUNGU,2023,5420,4950,10370,3
KANUNGU,2024,5490,5010,10500,3
KANUNGU,2025,5560,5070,10630,3
KAPCHORWA,2015,1870,1730,3600,3
KAPCHORWA,2016,1930,1780,3710,3
KAPCHORWA,2017,1990,1830,3820,3
KAPCHORWA,2018,2050,1880,3930,3
KAPCHORWA,2019,2110,1930,4040,3
KAPCHORWA,2020,2170,1980,4150,3
KAPCHORWA,2021,2230,2030,4260,3
KAPCHORWA,2022,2290,2080,4370,3
KAPCHORWA,2023,2350,2130,4480,3
KAPCHORWA,2024,2410,2180,4590,3
KAPCHORWA,2025,2470,2230,4700,3
KAPELEBYONG,2015,1670,1530,3200,3
KAPELEBYONG,2016,1710,1560,3270,3
KAPELEBYONG,2017,1800,1630,3430,3
KAPELEBYONG,2018,1820,1730,3550,3
KAPELEBYONG,2019,1860,1760,3620,3
KAPELEBYONG,2020,1900,1790,3690,3
KAPELEBYONG,2021,1940,1810,3750,3
KAPELEBYONG,2022,1960,1840,3800,3
KAPELEBYONG,2023,2000,1860,3860,3
KAPELEBYONG,2024,2040,1890,3930,3
KAPELEBYONG,2025,2070,1910,3980,3
KASESE,2015,13120,12450,25570,3
KASESE,2016,13340,12620,25960,3
KASESE,2017,13960,13090,27050,3
KASESE,2018,14010,13840,27850,3
KASESE,2019,14190,13990,28180,3
KASESE,2020,14370,14150,28520,3
KASESE,2021,14530,14290,28820,3
KASESE,2022,14680,14420,29100,3
KASESE,2023,14820,14540,29360,3
KASESE,2024,14950,14650,29600,3
KASESE,2025,15060,14750,29810,3
KASSANDA,2015,5580,4990,10570,3
KASSANDA,2016,5750,5100,10850,3
KASSANDA,2017,5910,5200,11110,3
KASSANDA,2018,6080,5320,11400,3
KASSANDA,2019,6250,5420,11670,3
KASSANDA,2020,6410,5530,11940,3
KASSANDA,2021,6580,5640,12220,3
KASSANDA,2022,6750,5740,12490,3
KASSANDA,2023,6920,5850,12770,3
KASSANDA,2024,7090,5950,13040,3
KASSANDA,2025,7250,6050,13300,3
KATAKWI,2015,2770,2460,5230,3
KATAKWI,2016,2840,2500,5340,3
KATAKWI,2017,2980,2600,5580,3
KATAKWI,2018,3010,2760,5770,3
KATAKWI,2019,3060,2800,5860,3
KATAKWI,2020,3120,2850,5970,3
KATAKWI,2021,3170,2890,6060,3
KATAKWI,2022,3220,2920,6140,3
KATAKWI,2023,3260,2950,6210,3
KATAKWI,2024,3310,2990,6300,3
KATAKWI,2025,3350,3020,6370,3
KAYUNGA,2015,6930,6300,13230,3
KAYUNGA,2016,7010,6350,13360,3
KAYUNGA,2017,7300,6550,13850,3
KAYUNGA,2018,7290,6880,14170,3
KAYUNGA,2019,7350,6920,14270,3
KAYUNGA,2020,7410,6960,14370,3
KAYUNGA,2021,7450,6990,14440,3
KAYUNGA,2022,7490,7020,14510,3
KAYUNGA,2023,7520,7040,14560,3
KAYUNGA,2024,7560,7050,14610,3
KAYUNGA,2025,7570,7060,14630,3
KAZO,2015,3330,3100,6430,3
KAZO,2016,3450,3210,6660,3
KAZO,2017,3590,3330,6920,3
KAZO,2018,3720,3450,7170,3
KAZO,2019,3860,3570,7430,3
KAZO,2020,3990,3690,7680,3
KAZO,2021,4140,3800,7940,3
KAZO,2022,4280,3930,8210,3
KAZO,2023,4430,4060,8490,3
KAZO,2024,4580,4190,8770,3
KAZO,2025,4730,4320,9050,3
KIBAALE,2015,3260,2980,6240,3
KIBAALE,2016,3470,3160,6630,3
KIBAALE,2017,3690,3340,7030,3
KIBAALE,2018,3930,3530,7460,3
KIBAALE,2019,4180,3740,7920,3
KIBAALE,2020,4430,3940,8370,3
KIBAALE,2021,4710,4170,8880,3
KIBAALE,2022,4990,4400,9390,3
KIBAALE,2023,5290,4640,9930,3
KIBAALE,2024,5600,4890,10490,3
KIBAALE,2025,5930,5140,11070,3
KIBOGA,2015,2630,2420,5050,3
KIBOGA,2016,2680,2450,5130,3
KIBOGA,2017,2810,2540,5350,3
KIBOGA,2018,2830,2690,5520,3
KIBOGA,2019,2880,2730,5610,3
KIBOGA,2020,2910,2760,5670,3
KIBOGA,2021,2950,2790,5740,3
KIBOGA,2022,2990,2830,5820,3
KIBOGA,2023,3030,2850,5880,3
KIBOGA,2024,3060,2880,5940,3
KIBOGA,2025,3090,2900,5990,3
KIBUKU,2015,4060,3790,7850,3
KIBUKU,2016,4190,3890,8080,3
KIBUKU,2017,4440,4090,8530,3
KIBUKU,2018,4520,4390,8910,3
KIBUKU,2019,4650,4500,9150,3
KIBUKU,2020,4770,4620,9390,3
KIBUKU,2021,4890,4730,9620,3
KIBUKU,2022,5010,4850,9860,3
KIBUKU,2023,5130,4960,10090,3
KIBUKU,2024,5250,5070,10320,3
KIBUKU,2025,5360,5180,10540,3
KIKUUBE,2015,5800,5710,11510,3
KIKUUBE,2016,6110,6010,12120,3
KIKUUBE,2017,6440,6310,12750,3
KIKUUBE,2018,6780,6630,13410,3
KIKUUBE,2019,7130,6960,14090,3
KIKUUBE,2020,7500,7310,14810,3
KIKUUBE,2021,7890,7660,15550,3
KIKUUBE,2022,8280,8030,16310,3
KIKUUBE,2023,8700,8410,17110,3
KIKUUBE,2024,9120,8810,17930,3
KIKUUBE,2025,9550,9210,18760,3
KIRUHURA,2015,2750,2500,5250,3
KIRUHURA,2016,2850,2590,5440,3
KIRUHURA,2017,2960,2680,5640,3
KIRUHURA,2018,3070,2770,5840,3
KIRUHURA,2019,3180,2870,6050,3
KIRUHURA,2020,3310,2970,6280,3
KIRUHURA,2021,3420,3070,6490,3
KIRUHURA,2022,3540,3170,6710,3
KIRUHURA,2023,3660,3270,6930,3
KIRUHURA,2024,3780,3370,7150,3
KIRUHURA,2025,3900,3470,7370,3
KIRYANDONGO,2015,5000,4620,9620,3
KIRYANDONGO,2016,5120,4710,9830,3
KIRYANDONGO,2017,5390,4910,10300,3
KIRYANDONGO,2018,5440,5220,10660,3
KIRYANDONGO,2019,5550,5300,10850,3
KIRYANDONGO,2020,5640,5390,11030,3
KIRYANDONGO,2021,5740,5480,11220,3
KIRYANDONGO,2022,5830,5550,11380,3
KIRYANDONGO,2023,5920,5620,11540,3
KIRYANDONGO,2024,6010,5700,11710,3
KIRYANDONGO,2025,6090,5760,11850,3
KISORO,2015,5340,5040,10380,3
KISORO,2016,5400,5100,10500,3
KISORO,2017,5620,5270,10890,3
KISORO,2018,5630,5570,11200,3
KISORO,2019,5670,5620,11290,3
KISORO,2020,5710,5670,11380,3
KISORO,2021,5750,5720,11470,3
KISORO,2022,5790,5750,11540,3
KISORO,2023,5810,5790,11600,3
KISORO,2024,5840,5820,11660,3
KISORO,2025,5860,5850,11710,3
KITAGWENDA,2015,2960,2870,5830,3
KITAGWENDA,2016,3090,2970,6060,3
KITAGWENDA,2017,3210,3080,6290,3
KITAGWENDA,2018,3350,3190,6540,3
KITAGWENDA,2019,3470,3300,6770,3
KITAGWENDA,2020,3620,3420,7040,3
KITAGWENDA,2021,3750,3540,7290,3
KITAGWENDA,2022,3890,3650,7540,3
KITAGWENDA,2023,4040,3770,7810,3
KITAGWENDA,2024,4180,3880,8060,3
KITAGWENDA,2025,4330,4000,8330,3
KITGUM,2015,3440,3220,6660,3
KITGUM,2016,3460,3250,6710,3
KITGUM,2017,3600,3340,6940,3
KITGUM,2018,3590,3520,7110,3
KITGUM,2019,3600,3530,7130,3
KITGUM,2020,3610,3550,7160,3
KITGUM,2021,3620,3570,7190,3
KITGUM,2022,3630,3570,7200,3
KITGUM,2023,3640,3580,7220,3
KITGUM,2024,3640,3590,7230,3
KITGUM,2025,3650,3590,7240,3
KOBOKO,2015,3990,3700,7690,3
KOBOKO,2016,4120,3820,7940,3
KOBOKO,2017,4370,4020,8390,3
KOBOKO,2018,4460,4310,8770,3
KOBOKO,2019,4580,4440,9020,3
KOBOKO,2020,4700,4560,9260,3
KOBOKO,2021,4830,4680,9510,3
KOBOKO,2022,4960,4790,9750,3
KOBOKO,2023,5080,4910,9990,3
KOBOKO,2024,5200,5030,10230,3
KOBOKO,2025,5320,5140,10460,3
KOLE,2015,4690,4320,9010,3
KOLE,2016,4850,4440,9290,3
KOLE,2017,5010,4570,9580,3
KOLE,2018,5170,4700,9870,3
KOLE,2019,5330,4830,10160,3
KOLE,2020,5500,4960,10460,3
KOLE,2021,5670,5090,10760,3
KOLE,2022,5830,5220,11050,3
KOLE,2023,6000,5360,11360,3
KOLE,2024,6170,5490,11660,3
KOLE,2025,6340,5620,11960,3
KOTIDO,2015,3080,3260,6340,3
KOTIDO,2016,3130,3300,6430,3
KOTIDO,2017,3270,3430,6700,3
KOTIDO,2018,3290,3610,6900,3
KOTIDO,2019,3330,3660,6990,3
KOTIDO,2020,3370,3690,7060,3
KOTIDO,2021,3410,3730,7140,3
KOTIDO,2022,3440,3770,7210,3
KOTIDO,2023,3480,3800,7280,3
KOTIDO,2024,3510,3820,7330,3
KOTIDO,2025,3540,3850,7390,3
KUMI,2015,4080,3860,7940,3
KUMI,2016,4180,3940,8120,3
KUMI,2017,4410,4110,8520,3
KUMI,2018,4460,4380,8840,3
KUMI,2019,4550,4460,9010,3
KUMI,2020,4640,4540,9180,3
KUMI,2021,4730,4610,9340,3
KUMI,2022,4820,4690,9510,3
KUMI,2023,4900,4760,9660,3
KUMI,2024,4980,4830,9810,3
KUMI,2025,5060,4890,9950,3
KWANIA,2015,3390,3260,6650,3
KWANIA,2016,3490,3350,6840,3
KWANIA,2017,3600,3450,7050,3
KWANIA,2018,3710,3550,7260,3
KWANIA,2019,3820,3640,7460,3
KWANIA,2020,3940,3740,7680,3
KWANIA,2021,4050,3840,7890,3
KWANIA,2022,4160,3940,8100,3
KWANIA,2023,4280,4040,8320,3
KWANIA,2024,4390,4140,8530,3
KWANIA,2025,4500,4240,8740,3
KWEEN,2015,1780,1600,3380,3
KWEEN,2016,1830,1640,3470,3
KWEEN,2017,1890,1680,3570,3
KWEEN,2018,1950,1720,3670,3
KWEEN,2019,2010,1760,3770,3
KWEEN,2020,2060,1810,3870,3
KWEEN,2021,2120,1850,3970,3
KWEEN,2022,2190,1890,4080,3
KWEEN,2023,2240,1930,4170,3
KWEEN,2024,2300,1970,4270,3
KWEEN,2025,2360,2010,4370,3
KYANKWANZI,2015,4620,4240,8860,3
KYANKWANZI,2016,4860,4440,9300,3
KYANKWANZI,2017,5110,4640,9750,3
KYANKWANZI,2018,5370,4860,10230,3
KYANKWANZI,2019,5640,5080,10720,3
KYANKWANZI,2020,5920,5310,11230,3
KYANKWANZI,2021,6210,5550,11760,3
KYANKWANZI,2022,6510,5790,12300,3
KYANKWANZI,2023,6820,6040,12860,3
KYANKWANZI,2024,7140,6290,13430,3
KYANKWANZI,2025,7470,6560,14030,3
KYEGEGWA,2015,6410,6120,12530,3
KYEGEGWA,2016,6930,6610,13540,3
KYEGEGWA,2017,7500,7130,14630,3
KYEGEGWA,2018,8120,7690,15810,3
KYEGEGWA,2019,8770,8290,17060,3
KYEGEGWA,2020,9480,8930,18410,3
KYEGEGWA,2021,10240,9620,19860,3
KYEGEGWA,2022,11040,10350,21390,3
KYEGEGWA,2023,11910,11130,23040,3
KYEGEGWA,2024,12830,11970,24800,3
KYEGEGWA,2025,13810,12850,26660,3
KYENJOJO,2015,9520,8810,18330,3
KYENJOJO,2016,9910,9140,19050,3
KYENJOJO,2017,10320,9470,19790,3
KYENJOJO,2018,10740,9820,20560,3
KYENJOJO,2019,11170,10170,21340,3
KYENJOJO,2020,11600,10530,22130,3
KYENJOJO,2021,12050,10900,22950,3
KYENJOJO,2022,12510,11270,23780,3
KYENJOJO,2023,12980,11650,24630,3
KYENJOJO,2024,13450,12030,25480,3
KYENJOJO,2025,13930,12410,26340,3
KYOTERA,2015,4110,3800,7910,3
KYOTERA,2016,4140,3820,7960,3
KYOTERA,2017,4300,3920,8220,3
KYOTERA,2018,4290,4110,8400,3
KYOTERA,2019,4310,4130,8440,3
KYOTERA,2020,4320,4140,8460,3
KYOTERA,2021,4340,4140,8480,3
KYOTERA,2022,4350,4150,8500,3
KYOTERA,2023,4360,4150,8510,3
KYOTERA,2024,4370,4140,8510,3
KYOTERA,2025,4360,4140,8500,3
KARENGA,2015,1160,1260,2420,3
KARENGA,2016,1190,1290,2480,3
KARENGA,2017,1220,1320,2540,3
KARENGA,2018,1260,1350,2610,3
KARENGA,2019,1290,1390,2680,3
KARENGA,2020,1330,1420,2750,3
KARENGA,2021,1350,1450,2800,3
KARENGA,2022,1390,1470,2860,3
KARENGA,2023,1420,1510,2930,3
KARENGA,2024,1460,1540,3000,3
KARENGA,2025,1480,1570,3050,3
LAMWO,2015,2430,2290,4720,3
LAMWO,2016,2440,2300,4740,3
LAMWO,2017,2520,2370,4890,3
LAMWO,2018,2490,2490,4980,3
LAMWO,2019,2480,2490,4970,3
LAMWO,2020,2480,2500,4980,3
LAMWO,2021,2470,2510,4980,3
LAMWO,2022,2460,2510,4970,3
LAMWO,2023,2440,2510,4950,3
LAMWO,2024,2430,2510,4940,3
LAMWO,2025,2410,2510,4920,3
LIRA,2015,7040,6780,13820,3
LIRA,2016,7240,6980,14220,3
LIRA,2017,7440,7180,14620,3
LIRA,2018,7650,7380,15030,3
LIRA,2019,7860,7580,15440,3
LIRA,2020,8070,7790,15860,3
LIRA,2021,8270,8000,16270,3
LIRA,2022,8480,8200,16680,3
LIRA,2023,8690,8410,17100,3
LIRA,2024,8890,8610,17500,3
LIRA,2025,9100,8820,17920,3
LUUKA,2015,4340,4120,8460,3
LUUKA,2016,4410,4170,8580,3
LUUKA,2017,4590,4310,8900,3
LUUKA,2018,4590,4550,9140,3
LUUKA,2019,4630,4590,9220,3
LUUKA,2020,4680,4630,9310,3
LUUKA,2021,4710,4670,9380,3
LUUKA,2022,4740,4690,9430,3
LUUKA,2023,4770,4730,9500,3
LUUKA,2024,4790,4750,9540,3
LUUKA,2025,4810,4770,9580,3
LUWERO,2015,8210,7530,15740,3
LUWERO,2016,8360,7640,16000,3
LUWERO,2017,8750,7920,16670,3
LUWERO,2018,8790,8370,17160,3
LUWERO,2019,8910,8470,17380,3
LUWERO,2020,9030,8570,17600,3
LUWERO,2021,9130,8670,17800,3
LUWERO,2022,9240,8740,17980,3
LUWERO,2023,9330,8820,18150,3
LUWERO,2024,9420,8900,18320,3
LUWERO,2025,9500,8950,18450,3
LWENGO,2015,5100,4700,9800,3
LWENGO,2016,5120,4710,9830,3
LWENGO,2017,5280,4810,10090,3
LWENGO,2018,5230,5030,10260,3
LWENGO,2019,5230,5020,10250,3
LWENGO,2020,5220,5010,10230,3
LWENGO,2021,5200,5000,10200,3
LWENGO,2022,5190,4980,10170,3
LWENGO,2023,5160,4960,10120,3
LWENGO,2024,5140,4940,10080,3
LWENGO,2025,5110,4900,10010,3
LYANTONDE,2015,1650,1610,3260,3
LYANTONDE,2016,1700,1640,3340,3
LYANTONDE,2017,1780,1710,3490,3
LYANTONDE,2018,1790,1810,3600,3
LYANTONDE,2019,1830,1840,3670,3
LYANTONDE,2020,1860,1870,3730,3
LYANTONDE,2021,1890,1900,3790,3
LYANTONDE,2022,1920,1930,3850,3
LYANTONDE,2023,1960,1960,3920,3
LYANTONDE,2024,1990,1990,3980,3
LYANTONDE,2025,2010,2010,4020,3
MANAFWA,2015,2950,2810,5760,3
MANAFWA,2016,3030,2880,5910,3
MANAFWA,2017,3100,2940,6040,3
MANAFWA,2018,3180,3000,6180,3
MANAFWA,2019,3250,3070,6320,3
MANAFWA,2020,3330,3130,6460,3
MANAFWA,2021,3410,3200,6610,3
MANAFWA,2022,3480,3260,6740,3
MANAFWA,2023,3560,3320,6880,3
MANAFWA,2024,3630,3380,7010,3
MANAFWA,2025,3700,3440,7140,3
MARACHA,2015,3700,3570,7270,3
MARACHA,2016,3780,3640,7420,3
MARACHA,2017,3860,3710,7570,3
MARACHA,2018,3940,3780,7720,3
MARACHA,2019,4020,3850,7870,3
MARACHA,2020,4100,3920,8020,3
MARACHA,2021,4180,3990,8170,3
MARACHA,2022,4250,4050,8300,3
MARACHA,2023,4320,4120,8440,3
MARACHA,2024,4390,4180,8570,3
MARACHA,2025,4470,4240,8710,3
MASAKA,2015,4970,4590,9560,3
MASAKA,2016,5040,4650,9690,3
MASAKA,2017,5270,4810,10080,3
MASAKA,2018,5280,5070,10350,3
MASAKA,2019,5340,5130,10470,3
MASAKA,2020,5390,5180,10570,3
MASAKA,2021,5450,5230,10680,3
MASAKA,2022,5490,5270,10760,3
MASAKA,2023,5530,5290,10820,3
MASAKA,2024,5570,5330,10900,3
MASAKA,2025,5600,5350,10950,3
MASINDI,2015,5490,5260,10750,3
MASINDI,2016,5650,5400,11050,3
MASINDI,2017,5820,5540,11360,3
MASINDI,2018,5980,5690,11670,3
MASINDI,2019,6150,5840,11990,3
MASINDI,2020,6320,5980,12300,3
MASINDI,2021,6490,6130,12620,3
MASINDI,2022,6660,6280,12940,3
MASINDI,2023,6830,6420,13250,3
MASINDI,2024,7000,6570,13570,3
MASINDI,2025,7170,6710,13880,3
MAYUGE,2015,9020,8520,17540,3
MAYUGE,2016,9240,8720,17960,3
MAYUGE,2017,9730,9110,18840,3
MAYUGE,2018,9840,9710,19550,3
MAYUGE,2019,10030,9910,19940,3
MAYUGE,2020,10230,10100,20330,3
MAYUGE,2021,10420,10290,20710,3
MAYUGE,2022,10610,10470,21080,3
MAYUGE,2023,10780,10640,21420,3
MAYUGE,2024,10950,10810,21760,3
MAYUGE,2025,11110,10980,22090,3
MBALE,2015,7680,7520,15200,3
MBALE,2016,7860,7700,15560,3
MBALE,2017,8270,8070,16340,3
MBALE,2018,8350,8620,16970,3
MBALE,2019,8510,8820,17330,3
MBALE,2020,8670,9010,17680,3
MBALE,2021,8820,9210,18030,3
MBALE,2022,8960,9390,18350,3
MBALE,2023,9100,9570,18670,3
MBALE,2024,9230,9750,18980,3
MBALE,2025,9360,9920,19280,3
MBARARA,2015,5850,5490,11340,3
MBARARA,2016,6000,5610,11610,3
MBARARA,2017,6130,5730,11860,3
MBARARA,2018,6270,5850,12120,3
MBARARA,2019,6410,5970,12380,3
MBARARA,2020,6550,6090,12640,3
MBARARA,2021,6680,6210,12890,3
MBARARA,2022,6810,6330,13140,3
MBARARA,2023,6950,6440,13390,3
MBARARA,2024,7080,6550,13630,3
MBARARA,2025,7200,6660,13860,3
MITOOMA,2015,3620,3230,6850,3
MITOOMA,2016,3670,3260,6930,3
MITOOMA,2017,3710,3290,7000,3
MITOOMA,2018,3760,3320,7080,3
MITOOMA,2019,3800,3350,7150,3
MITOOMA,2020,3840,3370,7210,3
MITOOMA,2021,3870,3400,7270,3
MITOOMA,2022,3910,3420,7330,3
MITOOMA,2023,3940,3440,7380,3
MITOOMA,2024,3970,3460,7430,3
MITOOMA,2025,4000,3480,7480,3
MITYANA,2015,5950,5210,11160,3
MITYANA,2016,6020,5250,11270,3
MITYANA,2017,6260,5420,11680,3
MITYANA,2018,6240,5690,11930,3
MITYANA,2019,6290,5710,12000,3
MITYANA,2020,6320,5740,12060,3
MITYANA,2021,6360,5770,12130,3
MITYANA,2022,6390,5790,12180,3
MITYANA,2023,6410,5800,12210,3
MITYANA,2024,6430,5800,12230,3
MITYANA,2025,6430,5800,12230,3
MOROTO,2015,1910,2020,3930,3
MOROTO,2016,1940,2050,3990,3
MOROTO,2017,2030,2130,4160,3
MOROTO,2018,2030,2260,4290,3
MOROTO,2019,2050,2290,4340,3
MOROTO,2020,2070,2320,4390,3
MOROTO,2021,2090,2360,4450,3
MOROTO,2022,2110,2380,4490,3
MOROTO,2023,2120,2410,4530,3
MOROTO,2024,2140,2430,4570,3
MOROTO,2025,2150,2460,4610,3
MOYO,2015,1580,1430,3010,3
MOYO,2016,1620,1460,3080,3
MOYO,2017,1660,1490,3150,3
MOYO,2018,1700,1530,3230,3
MOYO,2019,1750,1560,3310,3
MOYO,2020,1790,1590,3380,3
MOYO,2021,1830,1620,3450,3
MOYO,2022,1870,1650,3520,3
MOYO,2023,1910,1680,3590,3
MOYO,2024,1950,1710,3660,3
MOYO,2025,1990,1740,3730,3
MPIGI,2015,4530,3900,8430,3
MPIGI,2016,4600,3960,8560,3
MPIGI,2017,4810,4100,8910,3
MPIGI,2018,4820,4350,9170,3
MPIGI,2019,4890,4400,9290,3
MPIGI,2020,4940,4450,9390,3
MPIGI,2021,5000,4500,9500,3
MPIGI,2022,5040,4550,9590,3
MPIGI,2023,5090,4590,9680,3
MPIGI,2024,5140,4630,9770,3
MPIGI,2025,5170,4670,9840,3
MUBENDE,2015,8140,7450,15590,3
MUBENDE,2016,8510,7770,16280,3
MUBENDE,2017,9150,8290,17440,3
MUBENDE,2018,9440,9020,18460,3
MUBENDE,2019,9830,9380,19210,3
MUBENDE,2020,10230,9750,19980,3
MUBENDE,2021,10640,10140,20780,3
MUBENDE,2022,11050,10520,21570,3
MUBENDE,2023,11460,10910,22370,3
MUBENDE,2024,11880,11310,23190,3
MUBENDE,2025,12310,11710,24020,3
MUKONO,2015,10510,9550,20060,3
MUKONO,2016,10720,9750,20470,3
MUKONO,2017,11250,10180,21430,3
MUKONO,2018,11320,10840,22160,3
MUKONO,2019,11490,11040,22530,3
MUKONO,2020,11680,11240,22920,3
MUKONO,2021,11840,11440,23280,3
MUKONO,2022,11990,11630,23620,3
MUKONO,2023,12130,11800,23930,3
MUKONO,2024,12280,11980,24260,3
MUKONO,2025,12400,12140,24540,3
MADI OKOLLO,2015,2740,2580,5320,3
MADI OKOLLO,2016,2820,2660,5480,3
MADI OKOLLO,2017,2910,2720,5630,3
MADI OKOLLO,2018,2990,2800,5790,3
MADI OKOLLO,2019,3070,2870,5940,3
MADI OKOLLO,2020,3160,2940,6100,3
MADI OKOLLO,2021,3240,3020,6260,3
MADI OKOLLO,2022,3330,3100,6430,3
MADI OKOLLO,2023,3410,3160,6570,3
MADI OKOLLO,2024,3490,3240,6730,3
MADI OKOLLO,2025,3570,3310,6880,3
NABILATUK,2015,1280,1380,2660,3
NABILATUK,2016,1330,1420,2750,3
NABILATUK,2017,1420,1520,2940,3
NABILATUK,2018,1480,1630,3110,3
NABILATUK,2019,1530,1690,3220,3
NABILATUK,2020,1590,1740,3330,3
NABILATUK,2021,1650,1800,3450,3
NABILATUK,2022,1710,1860,3570,3
NABILATUK,2023,1770,1920,3690,3
NABILATUK,2024,1830,1980,3810,3
NABILATUK,2025,1890,2040,3930,3
NAKAPIRIPIRIT,2015,1640,1540,3180,3
NAKAPIRIPIRIT,2016,1700,1590,3290,3
NAKAPIRIPIRIT,2017,1810,1690,3500,3
NAKAPIRIPIRIT,2018,1850,1820,3670,3
NAKAPIRIPIRIT,2019,1910,1880,3790,3
NAKAPIRIPIRIT,2020,1980,1940,3920,3
NAKAPIRIPIRIT,2021,2030,2000,4030,3
NAKAPIRIPIRIT,2022,2090,2060,4150,3
NAKAPIRIPIRIT,2023,2150,2120,4270,3
NAKAPIRIPIRIT,2024,2220,2190,4410,3
NAKAPIRIPIRIT,2025,2280,2250,4530,3
NAKASEKE,2015,3810,3280,7090,3
NAKASEKE,2016,3950,3360,7310,3
NAKASEKE,2017,4090,3440,7530,3
NAKASEKE,2018,4240,3520,7760,3
NAKASEKE,2019,4390,3600,7990,3
NAKASEKE,2020,4550,3680,8230,3
NAKASEKE,2021,4700,3760,8460,3
NAKASEKE,2022,4860,3840,8700,3
NAKASEKE,2023,5020,3920,8940,3
NAKASEKE,2024,5180,4000,9180,3
NAKASEKE,2025,5340,4080,9420,3
NAKASONGOLA,2015,3260,3010,6270,3
NAKASONGOLA,2016,3350,3060,6410,3
NAKASONGOLA,2017,3520,3190,6710,3
NAKASONGOLA,2018,3570,3390,6960,3
NAKASONGOLA,2019,3640,3450,7090,3
NAKASONGOLA,2020,3710,3500,7210,3
NAKASONGOLA,2021,3780,3560,7340,3
NAKASONGOLA,2022,3850,3600,7450,3
NAKASONGOLA,2023,3910,3650,7560,3
NAKASONGOLA,2024,3980,3700,7680,3
NAKASONGOLA,2025,4040,3740,7780,3
NAMAYINGO,2015,4190,4000,8190,3
NAMAYINGO,2016,4240,4030,8270,3
NAMAYINGO,2017,4410,4150,8560,3
NAMAYINGO,2018,4400,4350,8750,3
NAMAYINGO,2019,4430,4360,8790,3
NAMAYINGO,2020,4460,4390,8850,3
NAMAYINGO,2021,4490,4400,8890,3
NAMAYINGO,2022,4510,4400,8910,3
NAMAYINGO,2023,4530,4410,8940,3
NAMAYINGO,2024,4540,4410,8950,3
NAMAYINGO,2025,4550,4410,8960,3
NAMISINDWA,2015,4140,3880,8020,3
NAMISINDWA,2016,4260,3970,8230,3
NAMISINDWA,2017,4380,4070,8450,3
NAMISINDWA,2018,4500,4160,8660,3
NAMISINDWA,2019,4620,4260,8880,3
NAMISINDWA,2020,4740,4350,9090,3
NAMISINDWA,2021,4870,4440,9310,3
NAMISINDWA,2022,4990,4540,9530,3
NAMISINDWA,2023,5110,4630,9740,3
NAMISINDWA,2024,5230,4720,9950,3
NAMISINDWA,2025,5350,4810,10160,3
NAMUTUMBA,2015,5190,4660,9850,3
NAMUTUMBA,2016,5340,4770,10110,3
NAMUTUMBA,2017,5640,5000,10640,3
NAMUTUMBA,2018,5730,5340,11070,3
NAMUTUMBA,2019,5870,5460,11330,3
NAMUTUMBA,2020,6010,5580,11590,3
NAMUTUMBA,2021,6140,5690,11830,3
NAMUTUMBA,2022,6260,5800,12060,3
NAMUTUMBA,2023,6390,5900,12290,3
NAMUTUMBA,2024,6520,6020,12540,3
NAMUTUMBA,2025,6630,6120,12750,3
NAPAK,2015,2770,2720,5490,3
NAPAK,2016,2790,2760,5550,3
NAPAK,2017,2900,2860,5760,3
NAPAK,2018,2880,3010,5890,3
NAPAK,2019,2900,3040,5940,3
NAPAK,2020,2910,3080,5990,3
NAPAK,2021,2920,3110,6030,3
NAPAK,2022,2930,3130,6060,3
NAPAK,2023,2940,3150,6090,3
NAPAK,2024,2940,3170,6110,3
NAPAK,2025,2940,3180,6120,3
NEBBI,2015,4660,4290,8950,3
NEBBI,2016,4810,4410,9220,3
NEBBI,2017,4970,4540,9510,3
NEBBI,2018,5120,4660,9780,3
NEBBI,2019,5280,4790,10070,3
NEBBI,2020,5440,4920,10360,3
NEBBI,2021,5600,5050,10650,3
NEBBI,2022,5760,5180,10940,3
NEBBI,2023,5920,5310,11230,3
NEBBI,2024,6080,5440,11520,3
NEBBI,2025,6250,5560,11810,3
NGORA,2015,2400,2270,4670,3
NGORA,2016,2460,2310,4770,3
NGORA,2017,2580,2400,4980,3
NGORA,2018,2600,2540,5140,3
NGORA,2019,2650,2580,5230,3
NGORA,2020,2690,2630,5320,3
NGORA,2021,2730,2660,5390,3
NGORA,2022,2780,2700,5480,3
NGORA,2023,2800,2730,5530,3
NGORA,2024,2850,2760,5610,3
NGORA,2025,2880,2800,5680,3
NTOROKO,2015,1230,1210,2440,3
NTOROKO,2016,1260,1220,2480,3
NTOROKO,2017,1310,1260,2570,3
NTOROKO,2018,1320,1330,2650,3
NTOROKO,2019,1330,1340,2670,3
NTOROKO,2020,1360,1350,2710,3
NTOROKO,2021,1370,1360,2730,3
NTOROKO,2022,1380,1370,2750,3
NTOROKO,2023,1400,1380,2780,3
NTOROKO,2024,1410,1380,2790,3
NTOROKO,2025,1430,1380,2810,3
NTUNGAMO,2015,9080,8750,17830,3
NTUNGAMO,2016,9280,8910,18190,3
NTUNGAMO,2017,9480,9080,18560,3
NTUNGAMO,2018,9680,9240,18920,3
NTUNGAMO,2019,9880,9410,19290,3
NTUNGAMO,2020,10070,9560,19630,3
NTUNGAMO,2021,10270,9720,19990,3
NTUNGAMO,2022,10460,9880,20340,3
NTUNGAMO,2023,10640,10030,20670,3
NTUNGAMO,2024,10820,10180,21000,3
NTUNGAMO,2025,11000,10320,21320,3
NWOYA,2015,2800,2670,5470,3
NWOYA,2016,3090,2940,6030,3
NWOYA,2017,3420,3240,6660,3
NWOYA,2018,3770,3570,7340,3
NWOYA,2019,4170,3930,8100,3
NWOYA,2020,4600,4330,8930,3
NWOYA,2021,5060,4760,9820,3
NWOYA,2022,5580,5230,10810,3
NWOYA,2023,6140,5740,11880,3
NWOYA,2024,6750,6300,13050,3
NWOYA,2025,7420,6910,14330,3
OBONGI,2015,790,730,1520,3
OBONGI,2016,800,730,1530,3
OBONGI,2017,840,770,1610,3
OBONGI,2018,840,800,1640,3
OBONGI,2019,850,810,1660,3
OBONGI,2020,860,820,1680,3
OBONGI,2021,880,840,1720,3
OBONGI,2022,880,840,1720,3
OBONGI,2023,890,850,1740,3
OBONGI,2024,900,850,1750,3
OBONGI,2025,910,860,1770,3
OMORO,2015,2930,2660,5590,3
OMORO,2016,3020,2730,5750,3
OMORO,2017,3190,2860,6050,3
OMORO,2018,3240,3060,6300,3
OMORO,2019,3320,3140,6460,3
OMORO,2020,3400,3210,6610,3
OMORO,2021,3480,3290,6770,3
OMORO,2022,3550,3360,6910,3
OMORO,2023,3620,3420,7040,3
OMORO,2024,3700,3490,7190,3
OMORO,2025,3770,3560,7330,3
OTUKE,2015,2070,2000,4070,3
OTUKE,2016,2170,2080,4250,3
OTUKE,2017,2260,2170,4430,3
OTUKE,2018,2370,2260,4630,3
OTUKE,2019,2470,2360,4830,3
OTUKE,2020,2580,2460,5040,3
OTUKE,2021,2690,2560,5250,3
OTUKE,2022,2800,2660,5460,3
OTUKE,2023,2920,2770,5690,3
OTUKE,2024,3030,2880,5910,3
OTUKE,2025,3150,2990,6140,3
OYAM,2015,7590,6990,14580,3
OYAM,2016,7820,7200,15020,3
OYAM,2017,8060,7410,15470,3
OYAM,2018,8300,7620,15920,3
OYAM,2019,8550,7840,16390,3
OYAM,2020,8790,8050,16840,3
OYAM,2021,9040,8270,17310,3
OYAM,2022,9290,8490,17780,3
OYAM,2023,9540,8710,18250,3
OYAM,2024,9790,8930,18720,3
OYAM,2025,10040,9150,19190,3
PADER,2015,3150,2860,6010,3
PADER,2016,3170,2890,6060,3
PADER,2017,3290,3000,6290,3
PADER,2018,3290,3160,6450,3
PADER,2019,3310,3180,6490,3
PADER,2020,3320,3210,6530,3
PADER,2021,3340,3230,6570,3
PADER,2022,3350,3250,6600,3
PADER,2023,3350,3270,6620,3
PADER,2024,3350,3280,6630,3
PADER,2025,3350,3290,6640,3
PAKWACH,2015,3230,3000,6230,3
PAKWACH,2016,3370,3110,6480,3
PAKWACH,2017,3500,3220,6720,3
PAKWACH,2018,3650,3340,6990,3
PAKWACH,2019,3800,3460,7260,3
PAKWACH,2020,3950,3580,7530,3
PAKWACH,2021,4110,3700,7810,3
PAKWACH,2022,4270,3820,8090,3
PAKWACH,2023,4430,3950,8380,3
PAKWACH,2024,4600,4080,8680,3
PAKWACH,2025,4760,4210,8970,3
PALLISA,2015,5150,4880,10030,3
PALLISA,2016,5330,5050,10380,3
PALLISA,2017,5700,5330,11030,3
PALLISA,2018,5830,5760,11590,3
PALLISA,2019,6030,5950,11980,3
PALLISA,2020,6220,6140,12360,3
PALLISA,2021,6420,6330,12750,3
PALLISA,2022,6620,6520,13140,3
PALLISA,2023,6810,6720,13530,3
PALLISA,2024,7010,6910,13920,3
PALLISA,2025,7200,7090,14290,3
RAKAI,2015,5320,4860,10180,3
RAKAI,2016,5420,4930,10350,3
RAKAI,2017,5680,5120,10800,3
RAKAI,2018,5710,5410,11120,3
RAKAI,2019,5790,5480,11270,3
RAKAI,2020,5860,5540,11400,3
RAKAI,2021,5940,5600,11540,3
RAKAI,2022,6000,5660,11660,3
RAKAI,2023,6070,5710,11780,3
RAKAI,2024,6130,5750,11880,3
RAKAI,2025,6180,5790,11970,3
RUBANDA,2015,3670,3610,7280,3
RUBANDA,2016,3720,3640,7360,3
RUBANDA,2017,3770,3670,7440,3
RUBANDA,2018,3820,3700,7520,3
RUBANDA,2019,3870,3720,7590,3
RUBANDA,2020,3910,3750,7660,3
RUBANDA,2021,3960,3770,7730,3
RUBANDA,2022,4000,3790,7790,3
RUBANDA,2023,4040,3810,7850,3
RUBANDA,2024,4070,3830,7900,3
RUBANDA,2025,4110,3840,7950,3
RUBIRIZI,2015,2520,2330,4850,3
RUBIRIZI,2016,2570,2380,4950,3
RUBIRIZI,2017,2630,2420,5050,3
RUBIRIZI,2018,2680,2470,5150,3
RUBIRIZI,2019,2730,2510,5240,3
RUBIRIZI,2020,2780,2550,5330,3
RUBIRIZI,2021,2830,2600,5430,3
RUBIRIZI,2022,2880,2640,5520,3
RUBIRIZI,2023,2930,2680,5610,3
RUBIRIZI,2024,2980,2720,5700,3
RUBIRIZI,2025,3020,2760,5780,3
RUKIGA,2015,1710,1650,3360,3
RUKIGA,2016,1720,1660,3380,3
RUKIGA,2017,1740,1670,3410,3
RUKIGA,2018,1760,1680,3440,3
RUKIGA,2019,1780,1690,3470,3
RUKIGA,2020,1790,1700,3490,3
RUKIGA,2021,1810,1710,3520,3
RUKIGA,2022,1820,1720,3540,3
RUKIGA,2023,1830,1720,3550,3
RUKIGA,2024,1840,1730,3570,3
RUKIGA,2025,1850,1730,3580,3
RUKUNGIRI,2015,5710,5320,11030,3
RUKUNGIRI,2016,5780,5370,11150,3
RUKUNGIRI,2017,5850,5430,11280,3
RUKUNGIRI,2018,5910,5470,11380,3
RUKUNGIRI,2019,5980,5520,11500,3
RUKUNGIRI,2020,6040,5570,11610,3
RUKUNGIRI,2021,6100,5610,11710,3
RUKUNGIRI,2022,6160,5650,11810,3
RUKUNGIRI,2023,6210,5690,11900,3
RUKUNGIRI,2024,6260,5720,11980,3
RUKUNGIRI,2025,6300,5750,12050,3
RWAMPARA,2015,2380,2230,4610,3
RWAMPARA,2016,2430,2280,4710,3
RWAMPARA,2017,2490,2330,4820,3
RWAMPARA,2018,2540,2380,4920,3
RWAMPARA,2019,2600,2430,5030,3
RWAMPARA,2020,2650,2480,5130,3
RWAMPARA,2021,2710,2530,5240,3
RWAMPARA,2022,2770,2580,5350,3
RWAMPARA,2023,2810,2620,5430,3
RWAMPARA,2024,2870,2680,5550,3
RWAMPARA,2025,2920,2720,5640,3
SERERE,2015,5320,5180,10500,3
SERERE,2016,5500,5350,10850,3
SERERE,2017,5850,5640,11490,3
SERERE,2018,5970,6060,12030,3
SERERE,2019,6150,6240,12390,3
SERERE,2020,6320,6410,12730,3
SERERE,2021,6500,6590,13090,3
SERERE,2022,6670,6770,13440,3
SERERE,2023,6840,6930,13770,3
SERERE,2024,7020,7100,14120,3
SERERE,2025,7180,7280,14460,3
SHEEMA,2015,3420,3220,6640,3
SHEEMA,2016,3460,3250,6710,3
SHEEMA,2017,3500,3290,6790,3
SHEEMA,2018,3540,3320,6860,3
SHEEMA,2019,3590,3360,6950,3
SHEEMA,2020,3620,3380,7000,3
SHEEMA,2021,3660,3410,7070,3
SHEEMA,2022,3690,3440,7130,3
SHEEMA,2023,3730,3470,7200,3
SHEEMA,2024,3760,3490,7250,3
SHEEMA,2025,3780,3510,7290,3
SIRONKO,2015,4530,4120,8650,3
SIRONKO,2016,4640,4200,8840,3
SIRONKO,2017,4750,4290,9040,3
SIRONKO,2018,4860,4380,9240,3
SIRONKO,2019,4970,4460,9430,3
SIRONKO,2020,5080,4550,9630,3
SIRONKO,2021,5190,4630,9820,3
SIRONKO,2022,5300,4710,10010,3
SIRONKO,2023,5410,4790,10200,3
SIRONKO,2024,5510,4870,10380,3
SIRONKO,2025,5610,4950,10560,3
SOROTI,2015,5210,4680,9890,3
SOROTI,2016,5360,4790,10150,3
SOROTI,2017,5680,5030,10710,3
SOROTI,2018,5760,5390,11150,3
SOROTI,2019,5900,5520,11420,3
SOROTI,2020,6050,5650,11700,3
SOROTI,2021,6190,5780,11970,3
SOROTI,2022,6320,5900,12220,3
SOROTI,2023,6460,6020,12480,3
SOROTI,2024,6600,6150,12750,3
SOROTI,2025,6720,6260,12980,3
SSEMBABULE,2015,4510,4170,8680,3
SSEMBABULE,2016,4610,4240,8850,3
SSEMBABULE,2017,4840,4420,9260,3
SSEMBABULE,2018,4880,4690,9570,3
SSEMBABULE,2019,4970,4770,9740,3
SSEMBABULE,2020,5050,4840,9890,3
SSEMBABULE,2021,5130,4920,10050,3
SSEMBABULE,2022,5210,4980,10190,3
SSEMBABULE,2023,5280,5040,10320,3
SSEMBABULE,2024,5360,5110,10470,3
SSEMBABULE,2025,5410,5160,10570,3
TORORO,2015,9690,9030,18720,3
TORORO,2016,9950,9260,19210,3
TORORO,2017,10210,9490,19700,3
TORORO,2018,10480,9730,20210,3
TORORO,2019,10750,9960,20710,3
TORORO,2020,11020,10200,21220,3
TORORO,2021,11290,10430,21720,3
TORORO,2022,11550,10660,22210,3
TORORO,2023,11820,10890,22710,3
TORORO,2024,12080,11120,23200,3
TORORO,2025,12340,11350,23690,3
WAKISO,2015,37680,34820,72500,3
WAKISO,2016,40200,37200,77400,3
WAKISO,2017,42900,39750,82650,3
WAKISO,2018,45750,42440,88190,3
WAKISO,2019,48790,45290,94080,3
WAKISO,2020,51970,48300,100270,3
WAKISO,2021,55300,51500,106800,3
WAKISO,2022,58850,54900,113750,3
WAKISO,2023,62590,58430,121020,3
WAKISO,2024,66480,62150,128630,3
WAKISO,2025,70570,66110,136680,3
YUMBE,2015,8720,8880,17600,3
YUMBE,2016,9100,9330,18430,3
YUMBE,2017,9780,10030,19810,3
YUMBE,2018,10070,10990,21060,3
YUMBE,2019,10470,11520,21990,3
YUMBE,2020,10890,12070,22960,3
YUMBE,2021,11300,12630,23930,3
YUMBE,2022,11720,13220,24940,3
YUMBE,2023,12130,13800,25930,3
YUMBE,2024,12570,14420,26990,3
YUMBE,2025,13000,15040,28040,3
ZOMBO,2015,4890,4680,9570,3
ZOMBO,2016,5040,4810,9850,3
ZOMBO,2017,5190,4950,10140,3
ZOMBO,2018,5350,5080,10430,3
ZOMBO,2019,5520,5220,10740,3
ZOMBO,2020,5680,5360,11040,3
ZOMBO,2021,5840,5500,11340,3
ZOMBO,2022,6000,5640,11640,3
ZOMBO,2023,6160,5770,11930,3
ZOMBO,2024,6330,5910,12240,3
ZOMBO,2025,6490,6050,12540,3
ABIM,2015,600,780,1380,30
ABIM,2016,650,830,1480,30
ABIM,2017,690,890,1580,30
ABIM,2018,740,970,1710,30
ABIM,2019,800,1060,1860,30
ABIM,2020,860,1150,2010,30
ABIM,2021,920,1250,2170,30
ABIM,2022,990,1340,2330,30
ABIM,2023,1070,1410,2480,30
ABIM,2024,1170,1490,2660,30
ABIM,2025,1270,1560,2830,30
ADJUMANI,2015,1290,2450,3740,30
ADJUMANI,2016,1300,2480,3780,30
ADJUMANI,2017,1310,2500,3810,30
ADJUMANI,2018,1320,2520,3840,30
ADJUMANI,2019,1330,2550,3880,30
ADJUMANI,2020,1340,2570,3910,30
ADJUMANI,2021,1350,2590,3940,30
ADJUMANI,2022,1350,2610,3960,30
ADJUMANI,2023,1360,2620,3980,30
ADJUMANI,2024,1360,2640,4000,30
ADJUMANI,2025,1360,2650,4010,30
AGAGO,2015,1280,2090,3370,30
AGAGO,2016,1300,2130,3430,30
AGAGO,2017,1320,2160,3480,30
AGAGO,2018,1350,2200,3550,30
AGAGO,2019,1370,2240,3610,30
AGAGO,2020,1390,2270,3660,30
AGAGO,2021,1410,2310,3720,30
AGAGO,2022,1430,2340,3770,30
AGAGO,2023,1450,2380,3830,30
AGAGO,2024,1470,2410,3880,30
AGAGO,2025,1490,2440,3930,30
ALEBTONG,2015,1010,1320,2330,30
ALEBTONG,2016,1050,1370,2420,30
ALEBTONG,2017,1100,1440,2540,30
ALEBTONG,2018,1130,1510,2640,30
ALEBTONG,2019,1170,1590,2760,30
ALEBTONG,2020,1210,1680,2890,30
ALEBTONG,2021,1250,1760,3010,30
ALEBTONG,2022,1310,1820,3130,30
ALEBTONG,2023,1370,1860,3230,30
ALEBTONG,2024,1440,1900,3340,30
ALEBTONG,2025,1510,1930,3440,30
AMOLATAR,2015,790,870,1660,30
AMOLATAR,2016,810,900,1710,30
AMOLATAR,2017,840,940,1780,30
AMOLATAR,2018,870,980,1850,30
AMOLATAR,2019,900,1030,1930,30
AMOLATAR,2020,930,1090,2020,30
AMOLATAR,2021,960,1130,2090,30
AMOLATAR,2022,1000,1180,2180,30
AMOLATAR,2023,1040,1200,2240,30
AMOLATAR,2024,1090,1220,2310,30
AMOLATAR,2025,1150,1230,2380,30
AMUDAT,2015,890,850,1740,30
AMUDAT,2016,930,910,1840,30
AMUDAT,2017,970,960,1930,30
AMUDAT,2018,1020,1030,2050,30
AMUDAT,2019,1060,1100,2160,30
AMUDAT,2020,1120,1190,2310,30
AMUDAT,2021,1170,1260,2430,30
AMUDAT,2022,1230,1340,2570,30
AMUDAT,2023,1310,1400,2710,30
AMUDAT,2024,1380,1450,2830,30
AMUDAT,2025,1470,1500,2970,30
AMURIA,2015,800,1190,1990,30
AMURIA,2016,840,1250,2090,30
AMURIA,2017,880,1320,2200,30
AMURIA,2018,920,1390,2310,30
AMURIA,2019,960,1480,2440,30
AMURIA,2020,1000,1570,2570,30
AMURIA,2021,1050,1650,2700,30
AMURIA,2022,1100,1730,2830,30
AMURIA,2023,1160,1790,2950,30
AMURIA,2024,1230,1830,3060,30
AMURIA,2025,1310,1870,3180,30
AMURU,2015,940,1370,2310,30
AMURU,2016,980,1430,2410,30
AMURU,2017,1010,1490,2500,30
AMURU,2018,1040,1560,2600,30
AMURU,2019,1080,1640,2720,30
AMURU,2020,1110,1730,2840,30
AMURU,2021,1150,1810,2960,30
AMURU,2022,1200,1880,3080,30
AMURU,2023,1250,1930,3180,30
AMURU,2024,1320,1960,3280,30
AMURU,2025,1370,1980,3350,30
APAC,2015,1270,1570,2840,30
APAC,2016,1320,1630,2950,30
APAC,2017,1370,1680,3050,30
APAC,2018,1420,1740,3160,30
APAC,2019,1470,1800,3270,30
APAC,2020,1520,1860,3380,30
APAC,2021,1570,1920,3490,30
APAC,2022,1630,1980,3610,30
APAC,2023,1680,2040,3720,30
APAC,2024,1730,2110,3840,30
APAC,2025,1790,2170,3960,30
ARUA,2015,4380,6660,11040,30
ARUA,2016,4510,6840,11350,30
ARUA,2017,4640,7030,11670,30
ARUA,2018,4770,7220,11990,30
ARUA,2019,4910,7410,12320,30
ARUA,2020,5040,7600,12640,30
ARUA,2021,5180,7790,12970,30
ARUA,2022,5310,7980,13290,30
ARUA,2023,5440,8170,13610,30
ARUA,2024,5580,8360,13940,30
ARUA,2025,5710,8550,14260,30
BUDAKA,2015,820,1120,1940,30
BUDAKA,2016,860,1170,2030,30
BUDAKA,2017,900,1230,2130,30
BUDAKA,2018,940,1300,2240,30
BUDAKA,2019,980,1380,2360,30
BUDAKA,2020,1020,1460,2480,30
BUDAKA,2021,1070,1540,2610,30
BUDAKA,2022,1120,1610,2730,30
BUDAKA,2023,1180,1660,2840,30
BUDAKA,2024,1250,1700,2950,30
BUDAKA,2025,1320,1740,3060,30
BUDUDA,2015,940,980,1920,30
BUDUDA,2016,990,1030,2020,30
BUDUDA,2017,1040,1090,2130,30
BUDUDA,2018,1100,1170,2270,30
BUDUDA,2019,1150,1260,2410,30
BUDUDA,2020,1220,1340,2560,30
BUDUDA,2021,1280,1430,2710,30
BUDUDA,2022,1350,1510,2860,30
BUDUDA,2023,1450,1580,3030,30
BUDUDA,2024,1540,1640,3180,30
BUDUDA,2025,1650,1690,3340,30
BUGIRI,2015,1830,2480,4310,30
BUGIRI,2016,1930,2610,4540,30
BUGIRI,2017,2030,2770,4800,30
BUGIRI,2018,2120,2930,5050,30
BUGIRI,2019,2230,3130,5360,30
BUGIRI,2020,2330,3330,5660,30
BUGIRI,2021,2450,3540,5990,30
BUGIRI,2022,2580,3700,6280,30
BUGIRI,2023,2740,3850,6590,30
BUGIRI,2024,2920,3960,6880,30
BUGIRI,2025,3100,4060,7160,30
BUGWERI,2015,880,1230,2110,30
BUGWERI,2016,910,1270,2180,30
BUGWERI,2017,950,1330,2280,30
BUGWERI,2018,980,1400,2380,30
BUGWERI,2019,1010,1470,2480,30
BUGWERI,2020,1050,1550,2600,30
BUGWERI,2021,1080,1610,2690,30
BUGWERI,2022,1130,1680,2810,30
BUGWERI,2023,1180,1720,2900,30
BUGWERI,2024,1240,1740,2980,30
BUGWERI,2025,1300,1770,3070,30
BUHWEJU,2015,870,890,1760,30
BUHWEJU,2016,890,920,1810,30
BUHWEJU,2017,920,940,1860,30
BUHWEJU,2018,950,970,1920,30
BUHWEJU,2019,980,1000,1980,30
BUHWEJU,2020,1010,1030,2040,30
BUHWEJU,2021,1040,1060,2100,30
BUHWEJU,2022,1080,1090,2170,30
BUHWEJU,2023,1110,1120,2230,30
BUHWEJU,2024,1140,1150,2290,30
BUHWEJU,2025,1170,1180,2350,30
BUIKWE,2015,2940,3190,6130,30
BUIKWE,2016,3020,3300,6320,30
BUIKWE,2017,3110,3420,6530,30
BUIKWE,2018,3190,3570,6760,30
BUIKWE,2019,3280,3740,7020,30
BUIKWE,2020,3360,3910,7270,30
BUIKWE,2021,3460,4070,7530,30
BUIKWE,2022,3570,4200,7770,30
BUIKWE,2023,3720,4280,8000,30
BUIKWE,2024,3880,4320,8200,30
BUIKWE,2025,4040,4360,8400,30
BUKEDEA,2015,940,1290,2230,30
BUKEDEA,2016,990,1350,2340,30
BUKEDEA,2017,1040,1430,2470,30
BUKEDEA,2018,1100,1530,2630,30
BUKEDEA,2019,1150,1630,2780,30
BUKEDEA,2020,1220,1740,2960,30
BUKEDEA,2021,1270,1850,3120,30
BUKEDEA,2022,1350,1950,3300,30
BUKEDEA,2023,1440,2030,3470,30
BUKEDEA,2024,1540,2090,3630,30
BUKEDEA,2025,1640,2140,3780,30
BUKOMANSIMBI,2015,760,850,1610,30
BUKOMANSIMBI,2016,770,860,1630,30
BUKOMANSIMBI,2017,780,880,1660,30
BUKOMANSIMBI,2018,790,910,1700,30
BUKOMANSIMBI,2019,800,930,1730,30
BUKOMANSIMBI,2020,810,960,1770,30
BUKOMANSIMBI,2021,830,990,1820,30
BUKOMANSIMBI,2022,840,1000,1840,30
BUKOMANSIMBI,2023,870,1000,1870,30
BUKOMANSIMBI,2024,890,1000,1890,30
BUKOMANSIMBI,2025,920,990,1910,30
BUKWO,2015,570,580,1150,30
BUKWO,2016,600,610,1210,30
BUKWO,2017,640,640,1280,30
BUKWO,2018,670,670,1340,30
BUKWO,2019,710,700,1410,30
BUKWO,2020,740,730,1470,30
BUKWO,2021,780,770,1550,30
BUKWO,2022,820,800,1620,30
BUKWO,2023,860,840,1700,30
BUKWO,2024,900,870,1770,30
BUKWO,2025,950,910,1860,30
BULAMBULI,2015,830,910,1740,30
BULAMBULI,2016,880,970,1850,30
BULAMBULI,2017,930,1030,1960,30
BULAMBULI,2018,980,1110,2090,30
BULAMBULI,2019,1030,1190,2220,30
BULAMBULI,2020,1090,1280,2370,30
BULAMBULI,2021,1160,1380,2540,30
BULAMBULI,2022,1230,1460,2690,30
BULAMBULI,2023,1310,1530,2840,30
BULAMBULI,2024,1410,1580,2990,30
BULAMBULI,2025,1520,1640,3160,30
BULIISA,2015,1100,1200,2300,30
BULIISA,2016,1160,1250,2410,30
BULIISA,2017,1220,1310,2530,30
BULIISA,2018,1290,1360,2650,30
BULIISA,2019,1350,1420,2770,30
BULIISA,2020,1430,1480,2910,30
BULIISA,2021,1500,1550,3050,30
BULIISA,2022,1580,1610,3190,30
BULIISA,2023,1660,1680,3340,30
BULIISA,2024,1740,1740,3480,30
BULIISA,2025,1820,1810,3630,30
BUNDIBUGYO,2015,1380,1940,3320,30
BUNDIBUGYO,2016,1440,2020,3460,30
BUNDIBUGYO,2017,1490,2110,3600,30
BUNDIBUGYO,2018,1550,2210,3760,30
BUNDIBUGYO,2019,1600,2330,3930,30
BUNDIBUGYO,2020,1660,2460,4120,30
BUNDIBUGYO,2021,1720,2580,4300,30
BUNDIBUGYO,2022,1800,2670,4470,30
BUNDIBUGYO,2023,1890,2740,4630,30
BUNDIBUGYO,2024,1990,2790,4780,30
BUNDIBUGYO,2025,2090,2830,4920,30
BUNYANGABU,2015,950,1090,2040,30
BUNYANGABU,2016,990,1130,2120,30
BUNYANGABU,2017,1020,1170,2190,30
BUNYANGABU,2018,1060,1230,2290,30
BUNYANGABU,2019,1090,1290,2380,30
BUNYANGABU,2020,1120,1350,2470,30
BUNYANGABU,2021,1170,1420,2590,30
BUNYANGABU,2022,1210,1460,2670,30
BUNYANGABU,2023,1270,1490,2760,30
BUNYANGABU,2024,1320,1510,2830,30
BUNYANGABU,2025,1390,1520,2910,30
BUSHENYI,2015,1730,2050,3780,30
BUSHENYI,2016,1750,2070,3820,30
BUSHENYI,2017,1770,2090,3860,30
BUSHENYI,2018,1790,2110,3900,30
BUSHENYI,2019,1810,2120,3930,30
BUSHENYI,2020,1830,2140,3970,30
BUSHENYI,2021,1850,2150,4000,30
BUSHENYI,2022,1870,2170,4040,30
BUSHENYI,2023,1880,2180,4060,30
BUSHENYI,2024,1900,2190,4090,30
BUSHENYI,2025,1910,2200,4110,30
BUSIA,2015,1500,1910,3410,30
BUSIA,2016,1550,1990,3540,30
BUSIA,2017,1620,2080,3700,30
BUSIA,2018,1680,2190,3870,30
BUSIA,2019,1740,2310,4050,30
BUSIA,2020,1810,2440,4250,30
BUSIA,2021,1880,2560,4440,30
BUSIA,2022,1970,2660,4630,30
BUSIA,2023,2070,2730,4800,30
BUSIA,2024,2180,2790,4970,30
BUSIA,2025,2300,2830,5130,30
BUTALEJA,2015,1030,1330,2360,30
BUTALEJA,2016,1090,1400,2490,30
BUTALEJA,2017,1140,1480,2620,30
BUTALEJA,2018,1190,1560,2750,30
BUTALEJA,2019,1240,1660,2900,30
BUTALEJA,2020,1290,1760,3050,30
BUTALEJA,2021,1360,1860,3220,30
BUTALEJA,2022,1420,1950,3370,30
BUTALEJA,2023,1500,2020,3520,30
BUTALEJA,2024,1600,2060,3660,30
BUTALEJA,2025,1690,2110,3800,30
BUTAMBALA,2015,650,760,1410,30
BUTAMBALA,2016,670,780,1450,30
BUTAMBALA,2017,680,800,1480,30
BUTAMBALA,2018,690,830,1520,30
BUTAMBALA,2019,710,860,1570,30
BUTAMBALA,2020,720,890,1610,30
BUTAMBALA,2021,740,910,1650,30
BUTAMBALA,2022,760,930,1690,30
BUTAMBALA,2023,780,940,1720,30
BUTAMBALA,2024,810,950,1760,30
BUTAMBALA,2025,840,940,1780,30
BUTEBO,2015,430,620,1050,30
BUTEBO,2016,440,640,1080,30
BUTEBO,2017,450,660,1110,30
BUTEBO,2018,460,690,1150,30
BUTEBO,2019,470,710,1180,30
BUTEBO,2020,480,740,1220,30
BUTEBO,2021,490,760,1250,30
BUTEBO,2022,510,780,1290,30
BUTEBO,2023,530,790,1320,30
BUTEBO,2024,540,790,1330,30
BUTEBO,2025,560,800,1360,30
BUVUMA,2015,1320,1210,2530,30
BUVUMA,2016,1400,1300,2700,30
BUVUMA,2017,1490,1380,2870,30
BUVUMA,2018,1580,1480,3060,30
BUVUMA,2019,1670,1580,3250,30
BUVUMA,2020,1770,1680,3450,30
BUVUMA,2021,1880,1790,3670,30
BUVUMA,2022,1990,1900,3890,30
BUVUMA,2023,2100,2030,4130,30
BUVUMA,2024,2220,2160,4380,30
BUVUMA,2025,2350,2290,4640,30
BUYENDE,2015,1750,2260,4010,30
BUYENDE,2016,1840,2390,4230,30
BUYENDE,2017,1940,2540,4480,30
BUYENDE,2018,2040,2710,4750,30
BUYENDE,2019,2140,2900,5040,30
BUYENDE,2020,2260,3100,5360,30
BUYENDE,2021,2380,3300,5680,30
BUYENDE,2022,2510,3480,5990,30
BUYENDE,2023,2670,3620,6290,30
BUYENDE,2024,2860,3750,6610,30
BUYENDE,2025,3050,3860,6910,30
DOKOLO,2015,1100,1480,2580,30
DOKOLO,2016,1130,1520,2650,30
DOKOLO,2017,1170,1570,2740,30
DOKOLO,2018,1200,1610,2810,30
DOKOLO,2019,1240,1650,2890,30
DOKOLO,2020,1270,1700,2970,30
DOKOLO,2021,1310,1740,3050,30
DOKOLO,2022,1350,1780,3130,30
DOKOLO,2023,1380,1820,3200,30
DOKOLO,2024,1420,1870,3290,30
DOKOLO,2025,1450,1910,3360,30
GOMBA,2015,920,940,1860,30
GOMBA,2016,950,960,1910,30
GOMBA,2017,980,990,1970,30
GOMBA,2018,1000,1030,2030,30
GOMBA,2019,1030,1070,2100,30
GOMBA,2020,1050,1100,2150,30
GOMBA,2021,1070,1140,2210,30
GOMBA,2022,1110,1170,2280,30
GOMBA,2023,1150,1180,2330,30
GOMBA,2024,1190,1180,2370,30
GOMBA,2025,1240,1180,2420,30
GULU,2015,2550,3010,5560,30
GULU,2016,2630,3100,5730,30
GULU,2017,2710,3190,5900,30
GULU,2018,2790,3280,6070,30
GULU,2019,2870,3370,6240,30
GULU,2020,2950,3460,6410,30
GULU,2021,3030,3560,6590,30
GULU,2022,3120,3650,6770,30
GULU,2023,3200,3750,6950,30
GULU,2024,3280,3840,7120,30
GULU,2025,3360,3930,7290,30
HOIMA,2015,2750,2890,5640,30
HOIMA,2016,2860,2990,5850,30
HOIMA,2017,2960,3090,6050,30
HOIMA,2018,3070,3200,6270,30
HOIMA,2019,3190,3310,6500,30
HOIMA,2020,3300,3420,6720,30
HOIMA,2021,3420,3530,6950,30
HOIMA,2022,3540,3640,7180,30
HOIMA,2023,3660,3760,7420,30
HOIMA,2024,3780,3870,7650,30
HOIMA,2025,3900,3990,7890,30
IBANDA,2015,1690,2040,3730,30
IBANDA,2016,1720,2080,3800,30
IBANDA,2017,1750,2120,3870,30
IBANDA,2018,1790,2160,3950,30
IBANDA,2019,1820,2190,4010,30
IBANDA,2020,1860,2230,4090,30
IBANDA,2021,1890,2260,4150,30
IBANDA,2022,1920,2300,4220,30
IBANDA,2023,1950,2330,4280,30
IBANDA,2024,1980,2370,4350,30
IBANDA,2025,2010,2400,4410,30
IGANGA,2015,2160,2680,4840,30
IGANGA,2016,2240,2790,5030,30
IGANGA,2017,2330,2920,5250,30
IGANGA,2018,2420,3070,5490,30
IGANGA,2019,2510,3240,5750,30
IGANGA,2020,2610,3420,6030,30
IGANGA,2021,2720,3590,6310,30
IGANGA,2022,2830,3730,6560,30
IGANGA,2023,2990,3830,6820,30
IGANGA,2024,3150,3900,7050,30
IGANGA,2025,3320,3970,7290,30
ISINGIRO,2015,3460,4320,7780,30
ISINGIRO,2016,3590,4470,8060,30
ISINGIRO,2017,3720,4630,8350,30
ISINGIRO,2018,3860,4790,8650,30
ISINGIRO,2019,4000,4960,8960,30
ISINGIRO,2020,4140,5130,9270,30
ISINGIRO,2021,4290,5290,9580,30
ISINGIRO,2022,4430,5470,9900,30
ISINGIRO,2023,4580,5640,10220,30
ISINGIRO,2024,4730,5820,10550,30
ISINGIRO,2025,4890,5990,10880,30
JINJA,2015,4380,4870,9250,30
JINJA,2016,4460,4940,9400,30
JINJA,2017,4530,5020,9550,30
JINJA,2018,4600,5090,9690,30
JINJA,2019,4680,5170,9850,30
JINJA,2020,4750,5240,9990,30
JINJA,2021,4820,5310,10130,30
JINJA,2022,4880,5380,10260,30
JINJA,2023,4950,5440,10390,30
JINJA,2024,5010,5500,10510,30
JINJA,2025,5070,5560,10630,30
KAABONG,2015,1260,1910,3170,30
KAABONG,2016,1290,1960,3250,30
KAABONG,2017,1330,2010,3340,30
KAABONG,2018,1360,2050,3410,30
KAABONG,2019,1400,2100,3500,30
KAABONG,2020,1430,2150,3580,30
KAABONG,2021,1470,2200,3670,30
KAABONG,2022,1500,2250,3750,30
KAABONG,2023,1540,2290,3830,30
KAABONG,2024,1570,2330,3900,30
KAABONG,2025,1610,2380,3990,30
KABALE,2015,1760,2110,3870,30
KABALE,2016,1790,2130,3920,30
KABALE,2017,1820,2160,3980,30
KABALE,2018,1850,2180,4030,30
KABALE,2019,1880,2210,4090,30
KABALE,2020,1900,2230,4130,30
KABALE,2021,1930,2250,4180,30
KABALE,2022,1950,2270,4220,30
KABALE,2023,1980,2290,4270,30
KABALE,2024,2000,2310,4310,30
KABALE,2025,2020,2330,4350,30
KABAROLE,2015,2970,3010,5980,30
KABAROLE,2016,3040,3070,6110,30
KABAROLE,2017,3110,3140,6250,30
KABAROLE,2018,3170,3210,6380,30
KABAROLE,2019,3240,3270,6510,30
KABAROLE,2020,3310,3340,6650,30
KABAROLE,2021,3370,3400,6770,30
KABAROLE,2022,3440,3470,6910,30
KABAROLE,2023,3500,3530,7030,30
KABAROLE,2024,3560,3590,7150,30
KABAROLE,2025,3620,3660,7280,30
KABERAMAIDO,2015,470,540,1010,30
KABERAMAIDO,2016,500,570,1070,30
KABERAMAIDO,2017,510,610,1120,30
KABERAMAIDO,2018,550,650,1200,30
KABERAMAIDO,2019,570,690,1260,30
KABERAMAIDO,2020,600,740,1340,30
KABERAMAIDO,2021,630,780,1410,30
KABERAMAIDO,2022,670,820,1490,30
KABERAMAIDO,2023,710,860,1570,30
KABERAMAIDO,2024,760,880,1640,30
KABERAMAIDO,2025,800,900,1700,30
KAGADI,2015,2480,3010,5490,30
KAGADI,2016,2570,3110,5680,30
KAGADI,2017,2660,3220,5880,30
KAGADI,2018,2760,3330,6090,30
KAGADI,2019,2860,3450,6310,30
KAGADI,2020,2960,3570,6530,30
KAGADI,2021,3070,3690,6760,30
KAGADI,2022,3170,3800,6970,30
KAGADI,2023,3280,3930,7210,30
KAGADI,2024,3380,4050,7430,30
KAGADI,2025,3490,4170,7660,30
KAKUMIRO,2015,2520,2500,5020,30
KAKUMIRO,2016,2740,2720,5460,30
KAKUMIRO,2017,2990,2950,5940,30
KAKUMIRO,2018,3250,3190,6440,30
KAKUMIRO,2019,3540,3460,7000,30
KAKUMIRO,2020,3840,3740,7580,30
KAKUMIRO,2021,4170,4050,8220,30
KAKUMIRO,2022,4530,4380,8910,30
KAKUMIRO,2023,4910,4730,9640,30
KAKUMIRO,2024,5320,5110,10430,30
KAKUMIRO,2025,5760,5510,11270,30
KALAKI,2015,610,870,1480,30
KALAKI,2016,640,900,1540,30
KALAKI,2017,670,940,1610,30
KALAKI,2018,700,970,1670,30
KALAKI,2019,730,1010,1740,30
KALAKI,2020,760,1050,1810,30
KALAKI,2021,790,1090,1880,30
KALAKI,2022,820,1130,1950,30
KALAKI,2023,850,1170,2020,30
KALAKI,2024,880,1210,2090,30
KALAKI,2025,920,1250,2170,30
KALANGALA,2015,1110,780,1890,30
KALANGALA,2016,1150,820,1970,30
KALANGALA,2017,1190,850,2040,30
KALANGALA,2018,1230,880,2110,30
KALANGALA,2019,1270,920,2190,30
KALANGALA,2020,1320,960,2280,30
KALANGALA,2021,1360,990,2350,30
KALANGALA,2022,1400,1030,2430,30
KALANGALA,2023,1450,1070,2520,30
KALANGALA,2024,1490,1110,2600,30
KALANGALA,2025,1540,1150,2690,30
KALIRO,2015,1200,1650,2850,30
KALIRO,2016,1250,1730,2980,30
KALIRO,2017,1300,1820,3120,30
KALIRO,2018,1370,1920,3290,30
KALIRO,2019,1420,2040,3460,30
KALIRO,2020,1480,2170,3650,30
KALIRO,2021,1540,2290,3830,30
KALIRO,2022,1620,2400,4020,30
KALIRO,2023,1710,2480,4190,30
KALIRO,2024,1810,2540,4350,30
KALIRO,2025,1920,2600,4520,30
KALUNGU,2015,950,1080,2030,30
KALUNGU,2016,980,1100,2080,30
KALUNGU,2017,990,1130,2120,30
KALUNGU,2018,1010,1160,2170,30
KALUNGU,2019,1030,1210,2240,30
KALUNGU,2020,1050,1250,2300,30
KALUNGU,2021,1070,1290,2360,30
KALUNGU,2022,1090,1310,2400,30
KALUNGU,2023,1120,1320,2440,30
KALUNGU,2024,1160,1320,2480,30
KALUNGU,2025,1200,1320,2520,30
KAMPALA,2015,20300,20980,41280,30
KAMPALA,2016,20710,21390,42100,30
KAMPALA,2017,21120,21800,42920,30
KAMPALA,2018,21530,22220,43750,30
KAMPALA,2019,21930,22630,44560,30
KAMPALA,2020,22330,23040,45370,30
KAMPALA,2021,22720,23430,46150,30
KAMPALA,2022,23100,23830,46930,30
KAMPALA,2023,23470,24210,47680,30
KAMPALA,2024,23830,24580,48410,30
KAMPALA,2025,24180,24940,49120,30
KAMULI,2015,2510,3270,5780,30
KAMULI,2016,2600,3390,5990,30
KAMULI,2017,2690,3530,6220,30
KAMULI,2018,2780,3690,6470,30
KAMULI,2019,2880,3870,6750,30
KAMULI,2020,2960,4060,7020,30
KAMULI,2021,3070,4240,7310,30
KAMULI,2022,3180,4380,7560,30
KAMULI,2023,3340,4470,7810,30
KAMULI,2024,3500,4530,8030,30
KAMULI,2025,3670,4570,8240,30
KAMWENGE,2015,2080,2610,4690,30
KAMWENGE,2016,2160,2710,4870,30
KAMWENGE,2017,2250,2800,5050,30
KAMWENGE,2018,2340,2900,5240,30
KAMWENGE,2019,2430,3000,5430,30
KAMWENGE,2020,2530,3100,5630,30
KAMWENGE,2021,2630,3210,5840,30
KAMWENGE,2022,2720,3310,6030,30
KAMWENGE,2023,2820,3420,6240,30
KAMWENGE,2024,2930,3530,6460,30
KAMWENGE,2025,3030,3640,6670,30
KANUNGU,2015,1640,2200,3840,30
KANUNGU,2016,1670,2230,3900,30
KANUNGU,2017,1700,2270,3970,30
KANUNGU,2018,1730,2310,4040,30
KANUNGU,2019,1760,2340,4100,30
KANUNGU,2020,1790,2380,4170,30
KANUNGU,2021,1820,2410,4230,30
KANUNGU,2022,1850,2440,4290,30
KANUNGU,2023,1870,2470,4340,30
KANUNGU,2024,1900,2510,4410,30
KANUNGU,2025,1920,2530,4450,30
KAPCHORWA,2015,600,840,1440,30
KAPCHORWA,2016,620,860,1480,30
KAPCHORWA,2017,640,880,1520,30
KAPCHORWA,2018,650,910,1560,30
KAPCHORWA,2019,670,930,1600,30
KAPCHORWA,2020,690,960,1650,30
KAPCHORWA,2021,710,980,1690,30
KAPCHORWA,2022,730,1010,1740,30
KAPCHORWA,2023,750,1030,1780,30
KAPCHORWA,2024,770,1060,1830,30
KAPCHORWA,2025,790,1080,1870,30
KAPELEBYONG,2015,390,590,980,30
KAPELEBYONG,2016,410,610,1020,30
KAPELEBYONG,2017,430,640,1070,30
KAPELEBYONG,2018,440,670,1110,30
KAPELEBYONG,2019,450,700,1150,30
KAPELEBYONG,2020,470,750,1220,30
KAPELEBYONG,2021,490,780,1270,30
KAPELEBYONG,2022,510,810,1320,30
KAPELEBYONG,2023,540,830,1370,30
KAPELEBYONG,2024,570,850,1420,30
KAPELEBYONG,2025,600,860,1460,30
KASESE,2015,4320,5280,9600,30
KASESE,2016,4480,5470,9950,30
KASESE,2017,4620,5690,10310,30
KASESE,2018,4770,5950,10720,30
KASESE,2019,4910,6230,11140,30
KASESE,2020,5060,6530,11590,30
KASESE,2021,5230,6810,12040,30
KASESE,2022,5430,7040,12470,30
KASESE,2023,5670,7180,12850,30
KASESE,2024,5940,7270,13210,30
KASESE,2025,6220,7330,13550,30
KASSANDA,2015,2360,2520,4880,30
KASSANDA,2016,2430,2580,5010,30
KASSANDA,2017,2500,2630,5130,30
KASSANDA,2018,2570,2690,5260,30
KASSANDA,2019,2640,2740,5380,30
KASSANDA,2020,2710,2800,5510,30
KASSANDA,2021,2780,2850,5630,30
KASSANDA,2022,2850,2900,5750,30
KASSANDA,2023,2920,2960,5880,30
KASSANDA,2024,3000,3010,6010,30
KASSANDA,2025,3070,3060,6130,30
KATAKWI,2015,800,1050,1850,30
KATAKWI,2016,830,1090,1920,30
KATAKWI,2017,860,1140,2000,30
KATAKWI,2018,890,1190,2080,30
KATAKWI,2019,920,1260,2180,30
KATAKWI,2020,960,1320,2280,30
KATAKWI,2021,990,1380,2370,30
KATAKWI,2022,1040,1430,2470,30
KATAKWI,2023,1090,1470,2560,30
KATAKWI,2024,1140,1490,2630,30
KATAKWI,2025,1210,1510,2720,30
KAYUNGA,2015,2150,2470,4620,30
KAYUNGA,2016,2210,2550,4760,30
KAYUNGA,2017,2270,2640,4910,30
KAYUNGA,2018,2330,2740,5070,30
KAYUNGA,2019,2390,2860,5250,30
KAYUNGA,2020,2450,2980,5430,30
KAYUNGA,2021,2520,3090,5610,30
KAYUNGA,2022,2600,3170,5770,30
KAYUNGA,2023,2710,3220,5930,30
KAYUNGA,2024,2820,3240,6060,30
KAYUNGA,2025,2940,3260,6200,30
KAZO,2015,1360,1520,2880,30
KAZO,2016,1410,1570,2980,30
KAZO,2017,1470,1630,3100,30
KAZO,2018,1520,1690,3210,30
KAZO,2019,1580,1750,3330,30
KAZO,2020,1640,1810,3450,30
KAZO,2021,1700,1860,3560,30
KAZO,2022,1750,1930,3680,30
KAZO,2023,1810,1990,3800,30
KAZO,2024,1880,2050,3930,30
KAZO,2025,1940,2120,4060,30
KIBAALE,2015,1030,1060,2090,30
KIBAALE,2016,1100,1120,2220,30
KIBAALE,2017,1170,1190,2360,30
KIBAALE,2018,1240,1260,2500,30
KIBAALE,2019,1320,1330,2650,30
KIBAALE,2020,1400,1400,2800,30
KIBAALE,2021,1490,1480,2970,30
KIBAALE,2022,1580,1560,3140,30
KIBAALE,2023,1680,1650,3330,30
KIBAALE,2024,1770,1740,3510,30
KIBAALE,2025,1880,1830,3710,30
KIBOGA,2015,850,910,1760,30
KIBOGA,2016,880,930,1810,30
KIBOGA,2017,920,970,1890,30
KIBOGA,2018,950,1020,1970,30
KIBOGA,2019,970,1060,2030,30
KIBOGA,2020,1010,1110,2120,30
KIBOGA,2021,1040,1160,2200,30
KIBOGA,2022,1080,1220,2300,30
KIBOGA,2023,1130,1270,2400,30
KIBOGA,2024,1180,1290,2470,30
KIBOGA,2025,1230,1310,2540,30
KIBUKU,2015,750,1170,1920,30
KIBUKU,2016,780,1220,2000,30
KIBUKU,2017,830,1300,2130,30
KIBUKU,2018,860,1370,2230,30
KIBUKU,2019,900,1460,2360,30
KIBUKU,2020,940,1550,2490,30
KIBUKU,2021,990,1650,2640,30
KIBUKU,2022,1040,1720,2760,30
KIBUKU,2023,1100,1780,2880,30
KIBUKU,2024,1170,1830,3000,30
KIBUKU,2025,1240,1870,3110,30
KIKUUBE,2015,2320,2530,4850,30
KIKUUBE,2016,2440,2660,5100,30
KIKUUBE,2017,2580,2800,5380,30
KIKUUBE,2018,2710,2940,5650,30
KIKUUBE,2019,2850,3090,5940,30
KIKUUBE,2020,3000,3240,6240,30
KIKUUBE,2021,3160,3400,6560,30
KIKUUBE,2022,3320,3560,6880,30
KIKUUBE,2023,3480,3730,7210,30
KIKUUBE,2024,3650,3910,7560,30
KIKUUBE,2025,3820,4090,7910,30
KIRUHURA,2015,1590,1390,2980,30
KIRUHURA,2016,1650,1440,3090,30
KIRUHURA,2017,1710,1490,3200,30
KIRUHURA,2018,1780,1540,3320,30
KIRUHURA,2019,1840,1600,3440,30
KIRUHURA,2020,1910,1650,3560,30
KIRUHURA,2021,1980,1710,3690,30
KIRUHURA,2022,2050,1770,3820,30
KIRUHURA,2023,2120,1820,3940,30
KIRUHURA,2024,2190,1880,4070,30
KIRUHURA,2025,2260,1930,4190,30
KIRYANDONGO,2015,1450,1950,3400,30
KIRYANDONGO,2016,1510,2020,3530,30
KIRYANDONGO,2017,1570,2120,3690,30
KIRYANDONGO,2018,1630,2230,3860,30
KIRYANDONGO,2019,1690,2350,4040,30
KIRYANDONGO,2020,1750,2470,4220,30
KIRYANDONGO,2021,1820,2590,4410,30
KIRYANDONGO,2022,1900,2690,4590,30
KIRYANDONGO,2023,1990,2760,4750,30
KIRYANDONGO,2024,2100,2810,4910,30
KIRYANDONGO,2025,2210,2850,5060,30
KISORO,2015,1230,2390,3620,30
KISORO,2016,1270,2470,3740,30
KISORO,2017,1300,2560,3860,30
KISORO,2018,1340,2680,4020,30
KISORO,2019,1370,2800,4170,30
KISORO,2020,1410,2930,4340,30
KISORO,2021,1440,3050,4490,30
KISORO,2022,1490,3140,4630,30
KISORO,2023,1550,3200,4750,30
KISORO,2024,1620,3240,4860,30
KISORO,2025,1680,3260,4940,30
KITAGWENDA,2015,960,1160,2120,30
KITAGWENDA,2016,1000,1200,2200,30
KITAGWENDA,2017,1040,1240,2280,30
KITAGWENDA,2018,1080,1290,2370,30
KITAGWENDA,2019,1120,1330,2450,30
KITAGWENDA,2020,1170,1380,2550,30
KITAGWENDA,2021,1210,1420,2630,30
KITAGWENDA,2022,1260,1470,2730,30
KITAGWENDA,2023,1310,1520,2830,30
KITAGWENDA,2024,1350,1560,2910,30
KITAGWENDA,2025,1400,1610,3010,30
KITGUM,2015,1070,1450,2520,30
KITGUM,2016,1100,1490,2590,30
KITGUM,2017,1130,1530,2660,30
KITGUM,2018,1160,1590,2750,30
KITGUM,2019,1190,1660,2850,30
KITGUM,2020,1210,1730,2940,30
KITGUM,2021,1230,1800,3030,30
KITGUM,2022,1280,1840,3120,30
KITGUM,2023,1320,1870,3190,30
KITGUM,2024,1370,1880,3250,30
KITGUM,2025,1420,1890,3310,30
KOBOKO,2015,1160,1630,2790,30
KOBOKO,2016,1220,1720,2940,30
KOBOKO,2017,1280,1810,3090,30
KOBOKO,2018,1340,1930,3270,30
KOBOKO,2019,1400,2050,3450,30
KOBOKO,2020,1470,2180,3650,30
KOBOKO,2021,1530,2320,3850,30
KOBOKO,2022,1620,2430,4050,30
KOBOKO,2023,1720,2520,4240,30
KOBOKO,2024,1830,2590,4420,30
KOBOKO,2025,1940,2660,4600,30
KOLE,2015,1370,1910,3280,30
KOLE,2016,1410,1960,3370,30
KOLE,2017,1460,2020,3480,30
KOLE,2018,1510,2080,3590,30
KOLE,2019,1560,2130,3690,30
KOLE,2020,1600,2190,3790,30
KOLE,2021,1650,2250,3900,30
KOLE,2022,1700,2310,4010,30
KOLE,2023,1750,2370,4120,30
KOLE,2024,1800,2430,4230,30
KOLE,2025,1850,2490,4340,30
KOTIDO,2015,1260,1520,2780,30
KOTIDO,2016,1310,1570,2880,30
KOTIDO,2017,1350,1630,2980,30
KOTIDO,2018,1400,1700,3100,30
KOTIDO,2019,1430,1790,3220,30
KOTIDO,2020,1480,1870,3350,30
KOTIDO,2021,1530,1960,3490,30
KOTIDO,2022,1590,2010,3600,30
KOTIDO,2023,1660,2060,3720,30
KOTIDO,2024,1740,2090,3830,30
KOTIDO,2025,1820,2100,3920,30
KUMI,2015,1140,1540,2680,30
KUMI,2016,1200,1600,2800,30
KUMI,2017,1250,1680,2930,30
KUMI,2018,1290,1770,3060,30
KUMI,2019,1340,1860,3200,30
KUMI,2020,1400,1970,3370,30
KUMI,2021,1450,2070,3520,30
KUMI,2022,1520,2150,3670,30
KUMI,2023,1600,2200,3800,30
KUMI,2024,1690,2250,3940,30
KUMI,2025,1780,2290,4070,30
KWANIA,2015,1100,1440,2540,30
KWANIA,2016,1130,1490,2620,30
KWANIA,2017,1170,1530,2700,30
KWANIA,2018,1200,1570,2770,30
KWANIA,2019,1240,1610,2850,30
KWANIA,2020,1280,1660,2940,30
KWANIA,2021,1310,1700,3010,30
KWANIA,2022,1350,1750,3100,30
KWANIA,2023,1390,1790,3180,30
KWANIA,2024,1420,1830,3250,30
KWANIA,2025,1460,1880,3340,30
KWEEN,2015,680,650,1330,30
KWEEN,2016,700,670,1370,30
KWEEN,2017,720,680,1400,30
KWEEN,2018,740,700,1440,30
KWEEN,2019,760,710,1470,30
KWEEN,2020,790,730,1520,30
KWEEN,2021,810,750,1560,30
KWEEN,2022,830,760,1590,30
KWEEN,2023,850,780,1630,30
KWEEN,2024,880,800,1680,30
KWEEN,2025,900,810,1710,30
KYANKWANZI,2015,2030,1990,4020,30
KYANKWANZI,2016,2140,2090,4230,30
KYANKWANZI,2017,2240,2180,4420,30
KYANKWANZI,2018,2360,2280,4640,30
KYANKWANZI,2019,2480,2390,4870,30
KYANKWANZI,2020,2600,2500,5100,30
KYANKWANZI,2021,2730,2610,5340,30
KYANKWANZI,2022,2860,2720,5580,30
KYANKWANZI,2023,2990,2840,5830,30
KYANKWANZI,2024,3130,2960,6090,30
KYANKWANZI,2025,3280,3090,6370,30
KYEGEGWA,2015,2380,2480,4860,30
KYEGEGWA,2016,2570,2670,5240,30
KYEGEGWA,2017,2790,2890,5680,30
KYEGEGWA,2018,3010,3110,6120,30
KYEGEGWA,2019,3260,3350,6610,30
KYEGEGWA,2020,3520,3620,7140,30
KYEGEGWA,2021,3800,3890,7690,30
KYEGEGWA,2022,4100,4190,8290,30
KYEGEGWA,2023,4420,4510,8930,30
KYEGEGWA,2024,4760,4840,9600,30
KYEGEGWA,2025,5130,5200,10330,30
KYENJOJO,2015,3240,3670,6910,30
KYENJOJO,2016,3380,3800,7180,30
KYENJOJO,2017,3510,3940,7450,30
KYENJOJO,2018,3660,4090,7750,30
KYENJOJO,2019,3800,4230,8030,30
KYENJOJO,2020,3950,4380,8330,30
KYENJOJO,2021,4110,4540,8650,30
KYENJOJO,2022,4260,4690,8950,30
KYENJOJO,2023,4420,4850,9270,30
KYENJOJO,2024,4580,5010,9590,30
KYENJOJO,2025,4740,5170,9910,30
KYOTERA,2015,1410,1630,3040,30
KYOTERA,2016,1440,1680,3120,30
KYOTERA,2017,1480,1730,3210,30
KYOTERA,2018,1520,1790,3310,30
KYOTERA,2019,1550,1870,3420,30
KYOTERA,2020,1590,1940,3530,30
KYOTERA,2021,1630,2000,3630,30
KYOTERA,2022,1670,2050,3720,30
KYOTERA,2023,1740,2080,3820,30
KYOTERA,2024,1810,2090,3900,30
KYOTERA,2025,1870,2090,3960,30
KARENGA,2015,620,640,1260,30
KARENGA,2016,630,650,1280,30
KARENGA,2017,650,670,1320,30
KARENGA,2018,670,690,1360,30
KARENGA,2019,690,710,1400,30
KARENGA,2020,710,720,1430,30
KARENGA,2021,720,740,1460,30
KARENGA,2022,740,750,1490,30
KARENGA,2023,750,770,1520,30
KARENGA,2024,770,780,1550,30
KARENGA,2025,790,800,1590,30
LAMWO,2015,690,1080,1770,30
LAMWO,2016,700,1100,1800,30
LAMWO,2017,720,1140,1860,30
LAMWO,2018,730,1190,1920,30
LAMWO,2019,740,1230,1970,30
LAMWO,2020,750,1280,2030,30
LAMWO,2021,760,1330,2090,30
LAMWO,2022,780,1360,2140,30
LAMWO,2023,800,1380,2180,30
LAMWO,2024,830,1390,2220,30
LAMWO,2025,850,1390,2240,30
LIRA,2015,3340,4090,7430,30
LIRA,2016,3440,4210,7650,30
LIRA,2017,3530,4330,7860,30
LIRA,2018,3630,4450,8080,30
LIRA,2019,3730,4570,8300,30
LIRA,2020,3830,4700,8530,30
LIRA,2021,3930,4820,8750,30
LIRA,2022,4030,4950,8980,30
LIRA,2023,4130,5070,9200,30
LIRA,2024,4220,5200,9420,30
LIRA,2025,4320,5320,9640,30
LUUKA,2015,1190,1590,2780,30
LUUKA,2016,1220,1650,2870,30
LUUKA,2017,1260,1710,2970,30
LUUKA,2018,1290,1780,3070,30
LUUKA,2019,1330,1860,3190,30
LUUKA,2020,1360,1950,3310,30
LUUKA,2021,1400,2030,3430,30
LUUKA,2022,1450,2090,3540,30
LUUKA,2023,1510,2130,3640,30
LUUKA,2024,1580,2150,3730,30
LUUKA,2025,1640,2170,3810,30
LUWERO,2015,2750,2870,5620,30
LUWERO,2016,2850,2970,5820,30
LUWERO,2017,2950,3090,6040,30
LUWERO,2018,3040,3240,6280,30
LUWERO,2019,3130,3390,6520,30
LUWERO,2020,3230,3560,6790,30
LUWERO,2021,3340,3710,7050,30
LUWERO,2022,3470,3830,7300,30
LUWERO,2023,3630,3910,7540,30
LUWERO,2024,3800,3970,7770,30
LUWERO,2025,3980,4010,7990,30
LWENGO,2015,1330,1670,3000,30
LWENGO,2016,1350,1710,3060,30
LWENGO,2017,1380,1760,3140,30
LWENGO,2018,1400,1810,3210,30
LWENGO,2019,1430,1880,3310,30
LWENGO,2020,1450,1940,3390,30
LWENGO,2021,1480,2000,3480,30
LWENGO,2022,1510,2040,3550,30
LWENGO,2023,1560,2060,3620,30
LWENGO,2024,1610,2060,3670,30
LWENGO,2025,1660,2050,3710,30
LYANTONDE,2015,590,590,1180,30
LYANTONDE,2016,610,610,1220,30
LYANTONDE,2017,630,640,1270,30
LYANTONDE,2018,660,660,1320,30
LYANTONDE,2019,680,690,1370,30
LYANTONDE,2020,710,730,1440,30
LYANTONDE,2021,740,770,1510,30
LYANTONDE,2022,760,820,1580,30
LYANTONDE,2023,800,860,1660,30
LYANTONDE,2024,830,880,1710,30
LYANTONDE,2025,870,910,1780,30
MANAFWA,2015,760,920,1680,30
MANAFWA,2016,780,950,1730,30
MANAFWA,2017,800,970,1770,30
MANAFWA,2018,810,990,1800,30
MANAFWA,2019,830,1010,1840,30
MANAFWA,2020,850,1030,1880,30
MANAFWA,2021,870,1050,1920,30
MANAFWA,2022,890,1070,1960,30
MANAFWA,2023,910,1090,2000,30
MANAFWA,2024,930,1110,2040,30
MANAFWA,2025,950,1130,2080,30
MARACHA,2015,1010,1910,2920,30
MARACHA,2016,1040,1950,2990,30
MARACHA,2017,1060,1990,3050,30
MARACHA,2018,1080,2030,3110,30
MARACHA,2019,1100,2060,3160,30
MARACHA,2020,1120,2100,3220,30
MARACHA,2021,1140,2140,3280,30
MARACHA,2022,1160,2170,3330,30
MARACHA,2023,1180,2210,3390,30
MARACHA,2024,1200,2240,3440,30
MARACHA,2025,1220,2270,3490,30
MASAKA,2015,2230,2180,4410,30
MASAKA,2016,2310,2250,4560,30
MASAKA,2017,2380,2340,4720,30
MASAKA,2018,2450,2440,4890,30
MASAKA,2019,2520,2560,5080,30
MASAKA,2020,2590,2670,5260,30
MASAKA,2021,2670,2790,5460,30
MASAKA,2022,2760,2880,5640,30
MASAKA,2023,2880,2930,5810,30
MASAKA,2024,3010,2960,5970,30
MASAKA,2025,3150,2980,6130,30
MASINDI,2015,2700,2910,5610,30
MASINDI,2016,2780,2990,5770,30
MASINDI,2017,2860,3070,5930,30
MASINDI,2018,2940,3150,6090,30
MASINDI,2019,3030,3230,6260,30
MASINDI,2020,3110,3310,6420,30
MASINDI,2021,3190,3390,6580,30
MASINDI,2022,3280,3480,6760,30
MASINDI,2023,3360,3560,6920,30
MASINDI,2024,3450,3640,7090,30
MASINDI,2025,3530,3720,7250,30
MAYUGE,2015,2740,3540,6280,30
MAYUGE,2016,2860,3690,6550,30
MAYUGE,2017,2980,3870,6850,30
MAYUGE,2018,3090,4080,7170,30
MAYUGE,2019,3210,4310,7520,30
MAYUGE,2020,3330,4560,7890,30
MAYUGE,2021,3460,4790,8250,30
MAYUGE,2022,3610,4990,8600,30
MAYUGE,2023,3810,5140,8950,30
MAYUGE,2024,4010,5250,9260,30
MAYUGE,2025,4230,5340,9570,30
MBALE,2015,2710,3180,5890,30
MBALE,2016,2820,3320,6140,30
MBALE,2017,2930,3490,6420,30
MBALE,2018,3040,3690,6730,30
MBALE,2019,3150,3910,7060,30
MBALE,2020,3270,4150,7420,30
MBALE,2021,3390,4370,7760,30
MBALE,2022,3540,4570,8110,30
MBALE,2023,3720,4710,8430,30
MBALE,2024,3920,4830,8750,30
MBALE,2025,4120,4920,9040,30
MBARARA,2015,3250,3510,6760,30
MBARARA,2016,3330,3590,6920,30
MBARARA,2017,3400,3660,7060,30
MBARARA,2018,3480,3740,7220,30
MBARARA,2019,3560,3820,7380,30
MBARARA,2020,3630,3900,7530,30
MBARARA,2021,3710,3970,7680,30
MBARARA,2022,3780,4050,7830,30
MBARARA,2023,3860,4120,7980,30
MBARARA,2024,3930,4190,8120,30
MBARARA,2025,4000,4260,8260,30
MITOOMA,2015,1050,1430,2480,30
MITOOMA,2016,1060,1450,2510,30
MITOOMA,2017,1070,1460,2530,30
MITOOMA,2018,1090,1470,2560,30
MITOOMA,2019,1100,1490,2590,30
MITOOMA,2020,1110,1500,2610,30
MITOOMA,2021,1120,1510,2630,30
MITOOMA,2022,1130,1520,2650,30
MITOOMA,2023,1140,1530,2670,30
MITOOMA,2024,1150,1540,2690,30
MITOOMA,2025,1160,1540,2700,30
MITYANA,2015,2110,1990,4100,30
MITYANA,2016,2180,2050,4230,30
MITYANA,2017,2230,2120,4350,30
MITYANA,2018,2290,2200,4490,30
MITYANA,2019,2350,2290,4640,30
MITYANA,2020,2400,2390,4790,30
MITYANA,2021,2470,2480,4950,30
MITYANA,2022,2550,2540,5090,30
MITYANA,2023,2640,2580,5220,30
MITYANA,2024,2750,2600,5350,30
MITYANA,2025,2860,2600,5460,30
MOROTO,2015,960,960,1920,30
MOROTO,2016,990,1000,1990,30
MOROTO,2017,1020,1040,2060,30
MOROTO,2018,1050,1090,2140,30
MOROTO,2019,1080,1140,2220,30
MOROTO,2020,1110,1200,2310,30
MOROTO,2021,1140,1260,2400,30
MOROTO,2022,1180,1300,2480,30
MOROTO,2023,1230,1330,2560,30
MOROTO,2024,1290,1360,2650,30
MOROTO,2025,1350,1370,2720,30
MOYO,2015,640,840,1480,30
MOYO,2016,650,860,1510,30
MOYO,2017,670,880,1550,30
MOYO,2018,680,900,1580,30
MOYO,2019,700,920,1620,30
MOYO,2020,720,940,1660,30
MOYO,2021,730,960,1690,30
MOYO,2022,750,980,1730,30
MOYO,2023,770,990,1760,30
MOYO,2024,780,1010,1790,30
MOYO,2025,800,1030,1830,30
MPIGI,2015,1720,1700,3420,30
MPIGI,2016,1780,1750,3530,30
MPIGI,2017,1830,1830,3660,30
MPIGI,2018,1890,1910,3800,30
MPIGI,2019,1950,2010,3960,30
MPIGI,2020,2010,2110,4120,30
MPIGI,2021,2070,2200,4270,30
MPIGI,2022,2150,2270,4420,30
MPIGI,2023,2240,2320,4560,30
MPIGI,2024,2350,2350,4700,30
MPIGI,2025,2450,2380,4830,30
MUBENDE,2015,2690,2860,5550,30
MUBENDE,2016,2860,3040,5900,30
MUBENDE,2017,3030,3250,6280,30
MUBENDE,2018,3220,3500,6720,30
MUBENDE,2019,3400,3780,7180,30
MUBENDE,2020,3610,4060,7670,30
MUBENDE,2021,3840,4370,8210,30
MUBENDE,2022,4090,4640,8730,30
MUBENDE,2023,4390,4870,9260,30
MUBENDE,2024,4730,5070,9800,30
MUBENDE,2025,5080,5260,10340,30
MUKONO,2015,4360,4830,9190,30
MUKONO,2016,4520,5030,9550,30
MUKONO,2017,4690,5270,9960,30
MUKONO,2018,4850,5550,10400,30
MUKONO,2019,5010,5860,10870,30
MUKONO,2020,5170,6190,11360,30
MUKONO,2021,5360,6500,11860,30
MUKONO,2022,5580,6760,12340,30
MUKONO,2023,5850,6950,12800,30
MUKONO,2024,6140,7090,13230,30
MUKONO,2025,6440,7200,13640,30
NABILATUK,2015,500,570,1070,30
NABILATUK,2016,530,610,1140,30
NABILATUK,2017,560,650,1210,30
NABILATUK,2018,590,690,1280,30
NABILATUK,2019,630,740,1370,30
NABILATUK,2020,660,790,1450,30
NABILATUK,2021,700,840,1540,30
NABILATUK,2022,750,890,1640,30
NABILATUK,2023,800,930,1730,30
NABILATUK,2024,860,960,1820,30
NABILATUK,2025,920,1000,1920,30
NAKAPIRIPIRIT,2015,780,850,1630,30
NAKAPIRIPIRIT,2016,820,900,1720,30
NAKAPIRIPIRIT,2017,860,960,1820,30
NAKAPIRIPIRIT,2018,910,1020,1930,30
NAKAPIRIPIRIT,2019,960,1100,2060,30
NAKAPIRIPIRIT,2020,1000,1170,2170,30
NAKAPIRIPIRIT,2021,1060,1250,2310,30
NAKAPIRIPIRIT,2022,1120,1310,2430,30
NAKAPIRIPIRIT,2023,1190,1370,2560,30
NAKAPIRIPIRIT,2024,1270,1420,2690,30
NAKAPIRIPIRIT,2025,1360,1460,2820,30
NAKASEKE,2015,2180,1830,4010,30
NAKASEKE,2016,2260,1870,4130,30
NAKASEKE,2017,2340,1910,4250,30
NAKASEKE,2018,2420,1960,4380,30
NAKASEKE,2019,2510,2000,4510,30
NAKASEKE,2020,2600,2050,4650,30
NAKASEKE,2021,2690,2090,4780,30
NAKASEKE,2022,2780,2140,4920,30
NAKASEKE,2023,2870,2180,5050,30
NAKASEKE,2024,2960,2230,5190,30
NAKASEKE,2025,3050,2270,5320,30
NAKASONGOLA,2015,1220,1120,2340,30
NAKASONGOLA,2016,1270,1170,2440,30
NAKASONGOLA,2017,1320,1220,2540,30
NAKASONGOLA,2018,1370,1280,2650,30
NAKASONGOLA,2019,1430,1350,2780,30
NAKASONGOLA,2020,1480,1420,2900,30
NAKASONGOLA,2021,1540,1490,3030,30
NAKASONGOLA,2022,1610,1550,3160,30
NAKASONGOLA,2023,1700,1590,3290,30
NAKASONGOLA,2024,1790,1610,3400,30
NAKASONGOLA,2025,1880,1640,3520,30
NAMAYINGO,2015,1140,1460,2600,30
NAMAYINGO,2016,1170,1500,2670,30
NAMAYINGO,2017,1200,1550,2750,30
NAMAYINGO,2018,1230,1610,2840,30
NAMAYINGO,2019,1260,1670,2930,30
NAMAYINGO,2020,1290,1740,3030,30
NAMAYINGO,2021,1330,1800,3130,30
NAMAYINGO,2022,1370,1850,3220,30
NAMAYINGO,2023,1420,1870,3290,30
NAMAYINGO,2024,1490,1890,3380,30
NAMAYINGO,2025,1540,1890,3430,30
NAMISINDWA,2015,1040,1230,2270,30
NAMISINDWA,2016,1070,1260,2330,30
NAMISINDWA,2017,1100,1290,2390,30
NAMISINDWA,2018,1130,1320,2450,30
NAMISINDWA,2019,1160,1350,2510,30
NAMISINDWA,2020,1190,1380,2570,30
NAMISINDWA,2021,1220,1410,2630,30
NAMISINDWA,2022,1250,1440,2690,30
NAMISINDWA,2023,1280,1470,2750,30
NAMISINDWA,2024,1310,1500,2810,30
NAMISINDWA,2025,1340,1530,2870,30
NAMUTUMBA,2015,1220,1630,2850,30
NAMUTUMBA,2016,1270,1710,2980,30
NAMUTUMBA,2017,1330,1790,3120,30
NAMUTUMBA,2018,1390,1900,3290,30
NAMUTUMBA,2019,1440,2010,3450,30
NAMUTUMBA,2020,1500,2130,3630,30
NAMUTUMBA,2021,1570,2240,3810,30
NAMUTUMBA,2022,1650,2340,3990,30
NAMUTUMBA,2023,1740,2410,4150,30
NAMUTUMBA,2024,1840,2470,4310,30
NAMUTUMBA,2025,1940,2520,4460,30
NAPAK,2015,910,1210,2120,30
NAPAK,2016,930,1250,2180,30
NAPAK,2017,950,1300,2250,30
NAPAK,2018,980,1360,2340,30
NAPAK,2019,1000,1420,2420,30
NAPAK,2020,1030,1480,2510,30
NAPAK,2021,1050,1540,2590,30
NAPAK,2022,1080,1590,2670,30
NAPAK,2023,1120,1620,2740,30
NAPAK,2024,1170,1650,2820,30
NAPAK,2025,1210,1660,2870,30
NEBBI,2015,1290,2050,3340,30
NEBBI,2016,1330,2100,3430,30
NEBBI,2017,1380,2160,3540,30
NEBBI,2018,1420,2230,3650,30
NEBBI,2019,1460,2290,3750,30
NEBBI,2020,1510,2350,3860,30
NEBBI,2021,1550,2410,3960,30
NEBBI,2022,1600,2470,4070,30
NEBBI,2023,1640,2530,4170,30
NEBBI,2024,1680,2600,4280,30
NEBBI,2025,1730,2660,4390,30
NGORA,2015,720,990,1710,30
NGORA,2016,740,1030,1770,30
NGORA,2017,770,1070,1840,30
NGORA,2018,800,1130,1930,30
NGORA,2019,820,1190,2010,30
NGORA,2020,860,1250,2110,30
NGORA,2021,890,1300,2190,30
NGORA,2022,930,1350,2280,30
NGORA,2023,970,1390,2360,30
NGORA,2024,1020,1410,2430,30
NGORA,2025,1070,1430,2500,30
NTOROKO,2015,480,560,1040,30
NTOROKO,2016,500,580,1080,30
NTOROKO,2017,520,600,1120,30
NTOROKO,2018,530,630,1160,30
NTOROKO,2019,550,650,1200,30
NTOROKO,2020,570,680,1250,30
NTOROKO,2021,590,710,1300,30
NTOROKO,2022,620,730,1350,30
NTOROKO,2023,640,740,1380,30
NTOROKO,2024,670,750,1420,30
NTOROKO,2025,700,760,1460,30
NTUNGAMO,2015,3350,4040,7390,30
NTUNGAMO,2016,3420,4110,7530,30
NTUNGAMO,2017,3490,4190,7680,30
NTUNGAMO,2018,3560,4260,7820,30
NTUNGAMO,2019,3640,4340,7980,30
NTUNGAMO,2020,3710,4410,8120,30
NTUNGAMO,2021,3780,4490,8270,30
NTUNGAMO,2022,3850,4560,8410,30
NTUNGAMO,2023,3920,4630,8550,30
NTUNGAMO,2024,3990,4690,8680,30
NTUNGAMO,2025,4050,4760,8810,30
NWOYA,2015,980,1410,2390,30
NWOYA,2016,1080,1560,2640,30
NWOYA,2017,1190,1710,2900,30
NWOYA,2018,1320,1890,3210,30
NWOYA,2019,1450,2080,3530,30
NWOYA,2020,1600,2290,3890,30
NWOYA,2021,1770,2510,4280,30
NWOYA,2022,1950,2760,4710,30
NWOYA,2023,2140,3030,5170,30
NWOYA,2024,2350,3330,5680,30
NWOYA,2025,2590,3650,6240,30
OBONGI,2015,230,310,540,30
OBONGI,2016,240,320,560,30
OBONGI,2017,250,330,580,30
OBONGI,2018,260,350,610,30
OBONGI,2019,260,360,620,30
OBONGI,2020,270,380,650,30
OBONGI,2021,280,400,680,30
OBONGI,2022,300,410,710,30
OBONGI,2023,300,420,720,30
OBONGI,2024,320,430,750,30
OBONGI,2025,340,430,770,30
OMORO,2015,820,1080,1900,30
OMORO,2016,870,1130,2000,30
OMORO,2017,900,1200,2100,30
OMORO,2018,940,1270,2210,30
OMORO,2019,980,1340,2320,30
OMORO,2020,1020,1420,2440,30
OMORO,2021,1070,1500,2570,30
OMORO,2022,1120,1570,2690,30
OMORO,2023,1180,1620,2800,30
OMORO,2024,1250,1670,2920,30
OMORO,2025,1320,1700,3020,30
OTUKE,2015,720,1040,1760,30
OTUKE,2016,750,1080,1830,30
OTUKE,2017,780,1130,1910,30
OTUKE,2018,820,1180,2000,30
OTUKE,2019,850,1230,2080,30
OTUKE,2020,890,1280,2170,30
OTUKE,2021,930,1330,2260,30
OTUKE,2022,970,1380,2350,30
OTUKE,2023,1010,1440,2450,30
OTUKE,2024,1050,1490,2540,30
OTUKE,2025,1090,1550,2640,30
OYAM,2015,2300,2920,5220,30
OYAM,2016,2370,3010,5380,30
OYAM,2017,2440,3100,5540,30
OYAM,2018,2520,3190,5710,30
OYAM,2019,2590,3280,5870,30
OYAM,2020,2660,3370,6030,30
OYAM,2021,2740,3460,6200,30
OYAM,2022,2820,3550,6370,30
OYAM,2023,2890,3650,6540,30
OYAM,2024,2970,3740,6710,30
OYAM,2025,3040,3830,6870,30
PADER,2015,900,1470,2370,30
PADER,2016,920,1520,2440,30
PADER,2017,950,1580,2530,30
PADER,2018,980,1640,2620,30
PADER,2019,1000,1720,2720,30
PADER,2020,1020,1800,2820,30
PADER,2021,1040,1870,2910,30
PADER,2022,1080,1920,3000,30
PADER,2023,1120,1960,3080,30
PADER,2024,1160,1980,3140,30
PADER,2025,1210,1990,3200,30
PAKWACH,2015,1090,1610,2700,30
PAKWACH,2016,1140,1660,2800,30
PAKWACH,2017,1190,1720,2910,30
PAKWACH,2018,1240,1790,3030,30
PAKWACH,2019,1290,1850,3140,30
PAKWACH,2020,1340,1920,3260,30
PAKWACH,2021,1390,1980,3370,30
PAKWACH,2022,1450,2050,3500,30
PAKWACH,2023,1500,2120,3620,30
PAKWACH,2024,1560,2180,3740,30
PAKWACH,2025,1610,2250,3860,30
PALLISA,2015,1220,1720,2940,30
PALLISA,2016,1290,1820,3110,30
PALLISA,2017,1360,1930,3290,30
PALLISA,2018,1430,2060,3490,30
PALLISA,2019,1500,2210,3710,30
PALLISA,2020,1570,2360,3930,30
PALLISA,2021,1660,2510,4170,30
PALLISA,2022,1760,2650,4410,30
PALLISA,2023,1870,2760,4630,30
PALLISA,2024,2000,2860,4860,30
PALLISA,2025,2140,2940,5080,30
RAKAI,2015,1490,1780,3270,30
RAKAI,2016,1550,1850,3400,30
RAKAI,2017,1600,1920,3520,30
RAKAI,2018,1650,2010,3660,30
RAKAI,2019,1710,2110,3820,30
RAKAI,2020,1760,2220,3980,30
RAKAI,2021,1820,2310,4130,30
RAKAI,2022,1880,2380,4260,30
RAKAI,2023,1970,2440,4410,30
RAKAI,2024,2070,2470,4540,30
RAKAI,2025,2170,2490,4660,30
RUBANDA,2015,1240,1660,2900,30
RUBANDA,2016,1250,1680,2930,30
RUBANDA,2017,1270,1690,2960,30
RUBANDA,2018,1290,1700,2990,30
RUBANDA,2019,1300,1710,3010,30
RUBANDA,2020,1320,1730,3050,30
RUBANDA,2021,1330,1740,3070,30
RUBANDA,2022,1350,1750,3100,30
RUBANDA,2023,1360,1750,3110,30
RUBANDA,2024,1370,1760,3130,30
RUBANDA,2025,1380,1770,3150,30
RUBIRIZI,2015,840,1210,2050,30
RUBIRIZI,2016,850,1230,2080,30
RUBIRIZI,2017,870,1250,2120,30
RUBIRIZI,2018,890,1280,2170,30
RUBIRIZI,2019,910,1300,2210,30
RUBIRIZI,2020,920,1320,2240,30
RUBIRIZI,2021,940,1350,2290,30
RUBIRIZI,2022,960,1370,2330,30
RUBIRIZI,2023,970,1390,2360,30
RUBIRIZI,2024,990,1410,2400,30
RUBIRIZI,2025,1000,1430,2430,30
RUKIGA,2015,640,850,1490,30
RUKIGA,2016,650,860,1510,30
RUKIGA,2017,650,860,1510,30
RUKIGA,2018,660,870,1530,30
RUKIGA,2019,670,870,1540,30
RUKIGA,2020,670,880,1550,30
RUKIGA,2021,680,880,1560,30
RUKIGA,2022,680,890,1570,30
RUKIGA,2023,690,890,1580,30
RUKIGA,2024,690,890,1580,30
RUKIGA,2025,690,890,1580,30
RUKUNGIRI,2015,1990,2520,4510,30
RUKUNGIRI,2016,2020,2540,4560,30
RUKUNGIRI,2017,2040,2570,4610,30
RUKUNGIRI,2018,2070,2590,4660,30
RUKUNGIRI,2019,2090,2620,4710,30
RUKUNGIRI,2020,2110,2640,4750,30
RUKUNGIRI,2021,2130,2660,4790,30
RUKUNGIRI,2022,2150,2680,4830,30
RUKUNGIRI,2023,2170,2700,4870,30
RUKUNGIRI,2024,2190,2710,4900,30
RUKUNGIRI,2025,2200,2720,4920,30
RWAMPARA,2015,890,1000,1890,30
RWAMPARA,2016,910,1020,1930,30
RWAMPARA,2017,930,1040,1970,30
RWAMPARA,2018,950,1060,2010,30
RWAMPARA,2019,970,1080,2050,30
RWAMPARA,2020,990,1110,2100,30
RWAMPARA,2021,1010,1130,2140,30
RWAMPARA,2022,1040,1150,2190,30
RWAMPARA,2023,1050,1170,2220,30
RWAMPARA,2024,1070,1190,2260,30
RWAMPARA,2025,1090,1210,2300,30
SERERE,2015,1470,1890,3360,30
SERERE,2016,1550,1990,3540,30
SERERE,2017,1630,2110,3740,30
SERERE,2018,1710,2250,3960,30
SERERE,2019,1790,2390,4180,30
SERERE,2020,1880,2550,4430,30
SERERE,2021,1970,2710,4680,30
SERERE,2022,2080,2840,4920,30
SERERE,2023,2200,2950,5150,30
SERERE,2024,2350,3040,5390,30
SERERE,2025,2500,3120,5620,30
SHEEMA,2015,1320,1750,3070,30
SHEEMA,2016,1340,1770,3110,30
SHEEMA,2017,1360,1790,3150,30
SHEEMA,2018,1370,1810,3180,30
SHEEMA,2019,1390,1820,3210,30
SHEEMA,2020,1400,1840,3240,30
SHEEMA,2021,1420,1860,3280,30
SHEEMA,2022,1430,1870,3300,30
SHEEMA,2023,1440,1880,3320,30
SHEEMA,2024,1460,1900,3360,30
SHEEMA,2025,1460,1910,3370,30
SIRONKO,2015,1410,1700,3110,30
SIRONKO,2016,1450,1730,3180,30
SIRONKO,2017,1480,1770,3250,30
SIRONKO,2018,1510,1810,3320,30
SIRONKO,2019,1550,1840,3390,30
SIRONKO,2020,1580,1880,3460,30
SIRONKO,2021,1620,1910,3530,30
SIRONKO,2022,1650,1940,3590,30
SIRONKO,2023,1690,1980,3670,30
SIRONKO,2024,1720,2010,3730,30
SIRONKO,2025,1750,2040,3790,30
SOROTI,2015,1700,2140,3840,30
SOROTI,2016,1780,2240,4020,30
SOROTI,2017,1860,2350,4210,30
SOROTI,2018,1950,2500,4450,30
SOROTI,2019,2030,2650,4680,30
SOROTI,2020,2120,2810,4930,30
SOROTI,2021,2210,2970,5180,30
SOROTI,2022,2320,3100,5420,30
SOROTI,2023,2450,3200,5650,30
SOROTI,2024,2610,3290,5900,30
SOROTI,2025,2760,3360,6120,30
SSEMBABULE,2015,1380,1560,2940,30
SSEMBABULE,2016,1430,1620,3050,30
SSEMBABULE,2017,1480,1690,3170,30
SSEMBABULE,2018,1540,1780,3320,30
SSEMBABULE,2019,1590,1880,3470,30
SSEMBABULE,2020,1650,1970,3620,30
SSEMBABULE,2021,1710,2070,3780,30
SSEMBABULE,2022,1780,2140,3920,30
SSEMBABULE,2023,1870,2200,4070,30
SSEMBABULE,2024,1970,2240,4210,30
SSEMBABULE,2025,2070,2270,4340,30
TORORO,2015,2970,3700,6670,30
TORORO,2016,3050,3800,6850,30
TORORO,2017,3130,3890,7020,30
TORORO,2018,3210,3990,7200,30
TORORO,2019,3300,4090,7390,30
TORORO,2020,3380,4180,7560,30
TORORO,2021,3460,4280,7740,30
TORORO,2022,3540,4370,7910,30
TORORO,2023,3620,4470,8090,30
TORORO,2024,3700,4560,8260,30
TORORO,2025,3780,4650,8430,30
WAKISO,2015,26090,26970,53060,30
WAKISO,2016,27830,28810,56640,30
WAKISO,2017,29700,30780,60480,30
WAKISO,2018,31670,32860,64530,30
WAKISO,2019,33770,35070,68840,30
WAKISO,2020,35970,37400,73370,30
WAKISO,2021,38290,39880,78170,30
WAKISO,2022,40740,42520,83260,30
WAKISO,2023,43330,45250,88580,30
WAKISO,2024,46020,48130,94150,30
WAKISO,2025,48850,51190,100040,30
YUMBE,2015,2490,3460,5950,30
YUMBE,2016,2640,3710,6350,30
YUMBE,2017,2800,4000,6800,30
YUMBE,2018,2960,4340,7300,30
YUMBE,2019,3130,4710,7840,30
YUMBE,2020,3310,5120,8430,30
YUMBE,2021,3510,5530,9040,30
YUMBE,2022,3750,5920,9670,30
YUMBE,2023,4010,6260,10270,30
YUMBE,2024,4320,6580,10900,30
YUMBE,2025,4630,6870,11500,30
ZOMBO,2015,1350,2280,3630,30
ZOMBO,2016,1390,2340,3730,30
ZOMBO,2017,1430,2410,3840,30
ZOMBO,2018,1480,2470,3950,30
ZOMBO,2019,1520,2540,4060,30
ZOMBO,2020,1570,2610,4180,30
ZOMBO,2021,1610,2670,4280,30
ZOMBO,2022,1660,2740,4400,30
ZOMBO,2023,1700,2810,4510,30
ZOMBO,2024,1750,2880,4630,30
ZOMBO,2025,1790,2940,4730,30
MADI OKOLLO,2015,900,1620,2520,30
MADI OKOLLO,2016,920,1670,2590,30
MADI OKOLLO,2017,950,1700,2650,30
MADI OKOLLO,2018,980,1750,2730,30
MADI OKOLLO,2019,1010,1800,2810,30
MADI OKOLLO,2020,1030,1850,2880,30
MADI OKOLLO,2021,1060,1890,2950,30
MADI OKOLLO,2022,1090,1940,3030,30
MADI OKOLLO,2023,1120,1980,3100,30
MADI OKOLLO,2024,1140,2030,3170,30
MADI OKOLLO,2025,1170,2070,3240,30
ABIM,2015,470,590,1060,31
ABIM,2016,500,620,1120,31
ABIM,2017,550,680,1230,31
ABIM,2018,580,730,1310,31
ABIM,2019,630,790,1420,31
ABIM,2020,670,860,1530,31
ABIM,2021,720,940,1660,31
ABIM,2022,770,1010,1780,31
ABIM,2023,830,1090,1920,31
ABIM,2024,900,1160,2060,31
ABIM,2025,990,1220,2210,31
ADJUMANI,2015,900,1150,2050,31
ADJUMANI,2016,910,1160,2070,31
ADJUMANI,2017,910,1170,2080,31
ADJUMANI,2018,920,1180,2100,31
ADJUMANI,2019,920,1200,2120,31
ADJUMANI,2020,930,1210,2140,31
ADJUMANI,2021,930,1210,2140,31
ADJUMANI,2022,940,1220,2160,31
ADJUMANI,2023,940,1230,2170,31
ADJUMANI,2024,950,1240,2190,31
ADJUMANI,2025,950,1240,2190,31
AGAGO,2015,1000,1130,2130,31
AGAGO,2016,1020,1150,2170,31
AGAGO,2017,1040,1170,2210,31
AGAGO,2018,1060,1190,2250,31
AGAGO,2019,1080,1210,2290,31
AGAGO,2020,1090,1230,2320,31
AGAGO,2021,1110,1250,2360,31
AGAGO,2022,1130,1270,2400,31
AGAGO,2023,1140,1290,2430,31
AGAGO,2024,1160,1310,2470,31
AGAGO,2025,1170,1320,2490,31
ALEBTONG,2015,1210,1280,2490,31
ALEBTONG,2016,1260,1330,2590,31
ALEBTONG,2017,1320,1380,2700,31
ALEBTONG,2018,1350,1450,2800,31
ALEBTONG,2019,1410,1530,2940,31
ALEBTONG,2020,1460,1600,3060,31
ALEBTONG,2021,1510,1690,3200,31
ALEBTONG,2022,1550,1760,3310,31
ALEBTONG,2023,1620,1830,3450,31
ALEBTONG,2024,1700,1880,3580,31
ALEBTONG,2025,1790,1910,3700,31
AMOLATAR,2015,920,980,1900,31
AMOLATAR,2016,950,1010,1960,31
AMOLATAR,2017,990,1040,2030,31
AMOLATAR,2018,1020,1090,2110,31
AMOLATAR,2019,1060,1140,2200,31
AMOLATAR,2020,1090,1200,2290,31
AMOLATAR,2021,1130,1250,2380,31
AMOLATAR,2022,1170,1310,2480,31
AMOLATAR,2023,1220,1360,2580,31
AMOLATAR,2024,1270,1400,2670,31
AMOLATAR,2025,1340,1410,2750,31
AMUDAT,2015,500,510,1010,31
AMUDAT,2016,530,540,1070,31
AMUDAT,2017,550,580,1130,31
AMUDAT,2018,580,600,1180,31
AMUDAT,2019,600,650,1250,31
AMUDAT,2020,630,690,1320,31
AMUDAT,2021,660,740,1400,31
AMUDAT,2022,700,790,1490,31
AMUDAT,2023,720,850,1570,31
AMUDAT,2024,770,880,1650,31
AMUDAT,2025,820,910,1730,31
AMURIA,2015,920,960,1880,31
AMURIA,2016,950,1000,1950,31
AMURIA,2017,1000,1060,2060,31
AMURIA,2018,1050,1100,2150,31
AMURIA,2019,1090,1170,2260,31
AMURIA,2020,1130,1250,2380,31
AMURIA,2021,1190,1320,2510,31
AMURIA,2022,1240,1390,2630,31
AMURIA,2023,1300,1460,2760,31
AMURIA,2024,1380,1500,2880,31
AMURIA,2025,1460,1540,3000,31
AMURU,2015,820,1020,1840,31
AMURU,2016,850,1060,1910,31
AMURU,2017,890,1100,1990,31
AMURU,2018,910,1150,2060,31
AMURU,2019,950,1200,2150,31
AMURU,2020,980,1270,2250,31
AMURU,2021,1020,1330,2350,31
AMURU,2022,1040,1390,2430,31
AMURU,2023,1090,1440,2530,31
AMURU,2024,1140,1480,2620,31
AMURU,2025,1190,1510,2700,31
APAC,2015,940,950,1890,31
APAC,2016,980,980,1960,31
APAC,2017,1010,1020,2030,31
APAC,2018,1050,1050,2100,31
APAC,2019,1090,1090,2180,31
APAC,2020,1130,1120,2250,31
APAC,2021,1170,1160,2330,31
APAC,2022,1210,1200,2410,31
APAC,2023,1250,1240,2490,31
APAC,2024,1290,1270,2560,31
APAC,2025,1330,1310,2640,31
ARUA,2015,2500,2690,5190,31
ARUA,2016,2570,2770,5340,31
ARUA,2017,2640,2840,5480,31
ARUA,2018,2720,2920,5640,31
ARUA,2019,2800,3000,5800,31
ARUA,2020,2870,3070,5940,31
ARUA,2021,2950,3150,6100,31
ARUA,2022,3030,3220,6250,31
ARUA,2023,3100,3300,6400,31
ARUA,2024,3180,3380,6560,31
ARUA,2025,3250,3460,6710,31
BUDAKA,2015,930,1220,2150,31
BUDAKA,2016,960,1280,2240,31
BUDAKA,2017,1010,1340,2350,31
BUDAKA,2018,1060,1420,2480,31
BUDAKA,2019,1100,1500,2600,31
BUDAKA,2020,1150,1580,2730,31
BUDAKA,2021,1200,1670,2870,31
BUDAKA,2022,1250,1770,3020,31
BUDAKA,2023,1320,1840,3160,31
BUDAKA,2024,1390,1910,3300,31
BUDAKA,2025,1480,1950,3430,31
BUDUDA,2015,1150,1180,2330,31
BUDUDA,2016,1210,1250,2460,31
BUDUDA,2017,1270,1320,2590,31
BUDUDA,2018,1340,1400,2740,31
BUDUDA,2019,1410,1500,2910,31
BUDUDA,2020,1480,1610,3090,31
BUDUDA,2021,1570,1720,3290,31
BUDUDA,2022,1640,1840,3480,31
BUDUDA,2023,1740,1940,3680,31
BUDUDA,2024,1850,2010,3860,31
BUDUDA,2025,1980,2080,4060,31
BUGIRI,2015,1750,2280,4030,31
BUGIRI,2016,1850,2400,4250,31
BUGIRI,2017,1950,2520,4470,31
BUGIRI,2018,2030,2660,4690,31
BUGIRI,2019,2130,2830,4960,31
BUGIRI,2020,2240,3030,5270,31
BUGIRI,2021,2340,3220,5560,31
BUGIRI,2022,2470,3400,5870,31
BUGIRI,2023,2590,3580,6170,31
BUGIRI,2024,2750,3720,6470,31
BUGIRI,2025,2940,3830,6770,31
BUGWERI,2015,550,820,1370,31
BUGWERI,2016,570,850,1420,31
BUGWERI,2017,590,890,1480,31
BUGWERI,2018,610,920,1530,31
BUGWERI,2019,640,970,1610,31
BUGWERI,2020,660,1010,1670,31
BUGWERI,2021,680,1070,1750,31
BUGWERI,2022,700,1120,1820,31
BUGWERI,2023,720,1150,1870,31
BUGWERI,2024,770,1190,1960,31
BUGWERI,2025,810,1200,2010,31
BUHWEJU,2015,540,550,1090,31
BUHWEJU,2016,560,570,1130,31
BUHWEJU,2017,580,590,1170,31
BUHWEJU,2018,600,600,1200,31
BUHWEJU,2019,620,620,1240,31
BUHWEJU,2020,640,640,1280,31
BUHWEJU,2021,660,660,1320,31
BUHWEJU,2022,680,680,1360,31
BUHWEJU,2023,700,700,1400,31
BUHWEJU,2024,720,710,1430,31
BUHWEJU,2025,740,730,1470,31
BUIKWE,2015,2010,2390,4400,31
BUIKWE,2016,2060,2470,4530,31
BUIKWE,2017,2120,2550,4670,31
BUIKWE,2018,2180,2650,4830,31
BUIKWE,2019,2240,2760,5000,31
BUIKWE,2020,2310,2890,5200,31
BUIKWE,2021,2370,3020,5390,31
BUIKWE,2022,2440,3150,5590,31
BUIKWE,2023,2520,3240,5760,31
BUIKWE,2024,2620,3300,5920,31
BUIKWE,2025,2720,3330,6050,31
BUKEDEA,2015,1020,1250,2270,31
BUKEDEA,2016,1090,1320,2410,31
BUKEDEA,2017,1140,1380,2520,31
BUKEDEA,2018,1200,1460,2660,31
BUKEDEA,2019,1270,1570,2840,31
BUKEDEA,2020,1330,1670,3000,31
BUKEDEA,2021,1400,1780,3180,31
BUKEDEA,2022,1470,1880,3350,31
BUKEDEA,2023,1550,1990,3540,31
BUKEDEA,2024,1660,2060,3720,31
BUKEDEA,2025,1760,2130,3890,31
BUKOMANSIMBI,2015,590,780,1370,31
BUKOMANSIMBI,2016,600,790,1390,31
BUKOMANSIMBI,2017,620,800,1420,31
BUKOMANSIMBI,2018,620,820,1440,31
BUKOMANSIMBI,2019,630,850,1480,31
BUKOMANSIMBI,2020,640,870,1510,31
BUKOMANSIMBI,2021,650,900,1550,31
BUKOMANSIMBI,2022,660,920,1580,31
BUKOMANSIMBI,2023,680,930,1610,31
BUKOMANSIMBI,2024,700,930,1630,31
BUKOMANSIMBI,2025,710,930,1640,31
BUKWO,2015,460,490,950,31
BUKWO,2016,480,520,1000,31
BUKWO,2017,510,540,1050,31
BUKWO,2018,540,570,1110,31
BUKWO,2019,560,590,1150,31
BUKWO,2020,590,620,1210,31
BUKWO,2021,620,650,1270,31
BUKWO,2022,660,680,1340,31
BUKWO,2023,690,710,1400,31
BUKWO,2024,720,740,1460,31
BUKWO,2025,760,780,1540,31
BULAMBULI,2015,890,1130,2020,31
BULAMBULI,2016,940,1210,2150,31
BULAMBULI,2017,990,1280,2270,31
BULAMBULI,2018,1050,1360,2410,31
BULAMBULI,2019,1110,1470,2580,31
BULAMBULI,2020,1180,1570,2750,31
BULAMBULI,2021,1240,1690,2930,31
BULAMBULI,2022,1310,1810,3120,31
BULAMBULI,2023,1390,1920,3310,31
BULAMBULI,2024,1490,2010,3500,31
BULAMBULI,2025,1600,2080,3680,31
BULIISA,2015,630,530,1160,31
BULIISA,2016,660,560,1220,31
BULIISA,2017,700,580,1280,31
BULIISA,2018,740,610,1350,31
BULIISA,2019,780,630,1410,31
BULIISA,2020,820,660,1480,31
BULIISA,2021,860,690,1550,31
BULIISA,2022,900,710,1610,31
BULIISA,2023,950,740,1690,31
BULIISA,2024,1000,770,1770,31
BULIISA,2025,1040,800,1840,31
BUNDIBUGYO,2015,1150,1070,2220,31
BUNDIBUGYO,2016,1190,1110,2300,31
BUNDIBUGYO,2017,1230,1150,2380,31
BUNDIBUGYO,2018,1290,1200,2490,31
BUNDIBUGYO,2019,1340,1260,2600,31
BUNDIBUGYO,2020,1390,1330,2720,31
BUNDIBUGYO,2021,1430,1410,2840,31
BUNDIBUGYO,2022,1480,1470,2950,31
BUNDIBUGYO,2023,1550,1520,3070,31
BUNDIBUGYO,2024,1630,1560,3190,31
BUNDIBUGYO,2025,1720,1590,3310,31
BUNYANGABU,2015,880,1030,1910,31
BUNYANGABU,2016,910,1070,1980,31
BUNYANGABU,2017,950,1100,2050,31
BUNYANGABU,2018,980,1150,2130,31
BUNYANGABU,2019,1000,1200,2200,31
BUNYANGABU,2020,1040,1250,2290,31
BUNYANGABU,2021,1070,1320,2390,31
BUNYANGABU,2022,1110,1380,2490,31
BUNYANGABU,2023,1160,1410,2570,31
BUNYANGABU,2024,1200,1450,2650,31
BUNYANGABU,2025,1260,1470,2730,31
BUSHENYI,2015,940,1170,2110,31
BUSHENYI,2016,950,1180,2130,31
BUSHENYI,2017,960,1190,2150,31
BUSHENYI,2018,970,1200,2170,31
BUSHENYI,2019,990,1210,2200,31
BUSHENYI,2020,1000,1220,2220,31
BUSHENYI,2021,1010,1230,2240,31
BUSHENYI,2022,1020,1240,2260,31
BUSHENYI,2023,1020,1250,2270,31
BUSHENYI,2024,1030,1250,2280,31
BUSHENYI,2025,1040,1260,2300,31
BUSIA,2015,1790,2270,4060,31
BUSIA,2016,1870,2360,4230,31
BUSIA,2017,1950,2450,4400,31
BUSIA,2018,2030,2560,4590,31
BUSIA,2019,2100,2700,4800,31
BUSIA,2020,2180,2850,5030,31
BUSIA,2021,2270,3000,5270,31
BUSIA,2022,2350,3150,5500,31
BUSIA,2023,2460,3270,5730,31
BUSIA,2024,2590,3360,5950,31
BUSIA,2025,2740,3430,6170,31
BUTALEJA,2015,1210,1460,2670,31
BUTALEJA,2016,1280,1530,2810,31
BUTALEJA,2017,1330,1590,2920,31
BUTALEJA,2018,1400,1680,3080,31
BUTALEJA,2019,1460,1770,3230,31
BUTALEJA,2020,1530,1900,3430,31
BUTALEJA,2021,1590,2010,3600,31
BUTALEJA,2022,1670,2120,3790,31
BUTALEJA,2023,1750,2210,3960,31
BUTALEJA,2024,1850,2280,4130,31
BUTALEJA,2025,1960,2350,4310,31
BUTAMBALA,2015,300,370,670,31
BUTAMBALA,2016,310,390,700,31
BUTAMBALA,2017,320,390,710,31
BUTAMBALA,2018,320,400,720,31
BUTAMBALA,2019,330,430,760,31
BUTAMBALA,2020,340,440,780,31
BUTAMBALA,2021,340,450,790,31
BUTAMBALA,2022,340,460,800,31
BUTAMBALA,2023,360,470,830,31
BUTAMBALA,2024,370,480,850,31
BUTAMBALA,2025,380,480,860,31
BUTEBO,2015,500,650,1150,31
BUTEBO,2016,500,650,1150,31
BUTEBO,2017,520,680,1200,31
BUTEBO,2018,540,690,1230,31
BUTEBO,2019,540,720,1260,31
BUTEBO,2020,560,750,1310,31
BUTEBO,2021,560,770,1330,31
BUTEBO,2022,580,810,1390,31
BUTEBO,2023,610,820,1430,31
BUTEBO,2024,620,840,1460,31
BUTEBO,2025,640,830,1470,31
BUVUMA,2015,660,520,1180,31
BUVUMA,2016,700,560,1260,31
BUVUMA,2017,740,600,1340,31
BUVUMA,2018,790,640,1430,31
BUVUMA,2019,840,680,1520,31
BUVUMA,2020,890,730,1620,31
BUVUMA,2021,940,770,1710,31
BUVUMA,2022,990,820,1810,31
BUVUMA,2023,1050,880,1930,31
BUVUMA,2024,1110,930,2040,31
BUVUMA,2025,1170,990,2160,31
BUYENDE,2015,1410,1700,3110,31
BUYENDE,2016,1490,1800,3290,31
BUYENDE,2017,1580,1900,3480,31
BUYENDE,2018,1660,2020,3680,31
BUYENDE,2019,1750,2160,3910,31
BUYENDE,2020,1830,2300,4130,31
BUYENDE,2021,1930,2460,4390,31
BUYENDE,2022,2040,2630,4670,31
BUYENDE,2023,2160,2760,4920,31
BUYENDE,2024,2290,2880,5170,31
BUYENDE,2025,2450,2980,5430,31
DOKOLO,2015,810,770,1580,31
DOKOLO,2016,830,790,1620,31
DOKOLO,2017,860,820,1680,31
DOKOLO,2018,890,840,1730,31
DOKOLO,2019,910,860,1770,31
DOKOLO,2020,940,880,1820,31
DOKOLO,2021,970,910,1880,31
DOKOLO,2022,990,930,1920,31
DOKOLO,2023,1020,950,1970,31
DOKOLO,2024,1040,970,2010,31
DOKOLO,2025,1070,1000,2070,31
GOMBA,2015,840,890,1730,31
GOMBA,2016,850,920,1770,31
GOMBA,2017,880,940,1820,31
GOMBA,2018,900,970,1870,31
GOMBA,2019,930,1000,1930,31
GOMBA,2020,950,1040,1990,31
GOMBA,2021,970,1080,2050,31
GOMBA,2022,1000,1110,2110,31
GOMBA,2023,1030,1140,2170,31
GOMBA,2024,1070,1160,2230,31
GOMBA,2025,1110,1150,2260,31
GULU,2015,1310,1440,2750,31
GULU,2016,1350,1480,2830,31
GULU,2017,1390,1520,2910,31
GULU,2018,1430,1570,3000,31
GULU,2019,1470,1610,3080,31
GULU,2020,1510,1660,3170,31
GULU,2021,1560,1700,3260,31
GULU,2022,1600,1750,3350,31
GULU,2023,1640,1790,3430,31
GULU,2024,1680,1840,3520,31
GULU,2025,1720,1880,3600,31
HOIMA,2015,1620,1620,3240,31
HOIMA,2016,1690,1670,3360,31
HOIMA,2017,1750,1730,3480,31
HOIMA,2018,1810,1790,3600,31
HOIMA,2019,1880,1850,3730,31
HOIMA,2020,1950,1910,3860,31
HOIMA,2021,2020,1980,4000,31
HOIMA,2022,2090,2040,4130,31
HOIMA,2023,2160,2100,4260,31
HOIMA,2024,2230,2170,4400,31
HOIMA,2025,2300,2230,4530,31
IBANDA,2015,1090,1280,2370,31
IBANDA,2016,1120,1310,2430,31
IBANDA,2017,1140,1330,2470,31
IBANDA,2018,1160,1360,2520,31
IBANDA,2019,1180,1380,2560,31
IBANDA,2020,1200,1400,2600,31
IBANDA,2021,1220,1420,2640,31
IBANDA,2022,1240,1450,2690,31
IBANDA,2023,1260,1470,2730,31
IBANDA,2024,1280,1490,2770,31
IBANDA,2025,1300,1510,2810,31
IGANGA,2015,1370,1900,3270,31
IGANGA,2016,1440,1970,3410,31
IGANGA,2017,1490,2050,3540,31
IGANGA,2018,1550,2150,3700,31
IGANGA,2019,1610,2260,3870,31
IGANGA,2020,1680,2390,4070,31
IGANGA,2021,1740,2520,4260,31
IGANGA,2022,1810,2640,4450,31
IGANGA,2023,1880,2740,4620,31
IGANGA,2024,1980,2830,4810,31
IGANGA,2025,2100,2880,4980,31
ISINGIRO,2015,2040,2650,4690,31
ISINGIRO,2016,2110,2740,4850,31
ISINGIRO,2017,2190,2840,5030,31
ISINGIRO,2018,2270,2940,5210,31
ISINGIRO,2019,2360,3040,5400,31
ISINGIRO,2020,2440,3140,5580,31
ISINGIRO,2021,2530,3250,5780,31
ISINGIRO,2022,2610,3350,5960,31
ISINGIRO,2023,2700,3460,6160,31
ISINGIRO,2024,2790,3570,6360,31
ISINGIRO,2025,2880,3680,6560,31
JINJA,2015,1870,2130,4000,31
JINJA,2016,1900,2160,4060,31
JINJA,2017,1930,2190,4120,31
JINJA,2018,1960,2230,4190,31
JINJA,2019,1990,2260,4250,31
JINJA,2020,2020,2290,4310,31
JINJA,2021,2050,2320,4370,31
JINJA,2022,2080,2350,4430,31
JINJA,2023,2110,2380,4490,31
JINJA,2024,2140,2400,4540,31
JINJA,2025,2160,2430,4590,31
KAABONG,2015,450,590,1040,31
KAABONG,2016,470,610,1080,31
KAABONG,2017,480,630,1110,31
KAABONG,2018,490,640,1130,31
KAABONG,2019,510,650,1160,31
KAABONG,2020,520,670,1190,31
KAABONG,2021,530,680,1210,31
KAABONG,2022,540,700,1240,31
KAABONG,2023,560,710,1270,31
KAABONG,2024,570,730,1300,31
KAABONG,2025,580,740,1320,31
KABALE,2015,1180,1330,2510,31
KABALE,2016,1200,1350,2550,31
KABALE,2017,1210,1370,2580,31
KABALE,2018,1230,1380,2610,31
KABALE,2019,1250,1400,2650,31
KABALE,2020,1270,1410,2680,31
KABALE,2021,1290,1430,2720,31
KABALE,2022,1300,1440,2740,31
KABALE,2023,1320,1450,2770,31
KABALE,2024,1330,1460,2790,31
KABALE,2025,1350,1470,2820,31
KABAROLE,2015,1440,1560,3000,31
KABAROLE,2016,1470,1590,3060,31
KABAROLE,2017,1510,1630,3140,31
KABAROLE,2018,1540,1660,3200,31
KABAROLE,2019,1570,1700,3270,31
KABAROLE,2020,1600,1730,3330,31
KABAROLE,2021,1630,1770,3400,31
KABAROLE,2022,1670,1800,3470,31
KABAROLE,2023,1700,1830,3530,31
KABAROLE,2024,1730,1870,3600,31
KABAROLE,2025,1750,1900,3650,31
KABERAMAIDO,2015,590,650,1240,31
KABERAMAIDO,2016,610,680,1290,31
KABERAMAIDO,2017,640,700,1340,31
KABERAMAIDO,2018,680,760,1440,31
KABERAMAIDO,2019,720,810,1530,31
KABERAMAIDO,2020,760,860,1620,31
KABERAMAIDO,2021,790,910,1700,31
KABERAMAIDO,2022,830,970,1800,31
KABERAMAIDO,2023,880,1010,1890,31
KABERAMAIDO,2024,930,1050,1980,31
KABERAMAIDO,2025,990,1070,2060,31
KAGADI,2015,1580,1890,3470,31
KAGADI,2016,1630,1950,3580,31
KAGADI,2017,1690,2020,3710,31
KAGADI,2018,1760,2090,3850,31
KAGADI,2019,1820,2160,3980,31
KAGADI,2020,1880,2240,4120,31
KAGADI,2021,1950,2310,4260,31
KAGADI,2022,2020,2390,4410,31
KAGADI,2023,2080,2460,4540,31
KAGADI,2024,2150,2540,4690,31
KAGADI,2025,2220,2620,4840,31
KAKUMIRO,2015,1600,1700,3300,31
KAKUMIRO,2016,1740,1840,3580,31
KAKUMIRO,2017,1890,1990,3880,31
KAKUMIRO,2018,2060,2160,4220,31
KAKUMIRO,2019,2240,2340,4580,31
KAKUMIRO,2020,2430,2530,4960,31
KAKUMIRO,2021,2640,2740,5380,31
KAKUMIRO,2022,2870,2960,5830,31
KAKUMIRO,2023,3110,3200,6310,31
KAKUMIRO,2024,3370,3460,6830,31
KAKUMIRO,2025,3650,3730,7380,31
KALAKI,2015,450,480,930,31
KALAKI,2016,470,500,970,31
KALAKI,2017,490,520,1010,31
KALAKI,2018,510,540,1050,31
KALAKI,2019,530,560,1090,31
KALAKI,2020,560,580,1140,31
KALAKI,2021,580,600,1180,31
KALAKI,2022,600,620,1220,31
KALAKI,2023,630,650,1280,31
KALAKI,2024,650,670,1320,31
KALAKI,2025,670,690,1360,31
KALANGALA,2015,660,400,1060,31
KALANGALA,2016,680,410,1090,31
KALANGALA,2017,710,430,1140,31
KALANGALA,2018,730,450,1180,31
KALANGALA,2019,750,460,1210,31
KALANGALA,2020,780,480,1260,31
KALANGALA,2021,810,500,1310,31
KALANGALA,2022,830,520,1350,31
KALANGALA,2023,860,540,1400,31
KALANGALA,2024,880,560,1440,31
KALANGALA,2025,910,580,1490,31
KALIRO,2015,1130,1300,2430,31
KALIRO,2016,1180,1360,2540,31
KALIRO,2017,1230,1430,2660,31
KALIRO,2018,1300,1500,2800,31
KALIRO,2019,1350,1600,2950,31
KALIRO,2020,1410,1690,3100,31
KALIRO,2021,1470,1800,3270,31
KALIRO,2022,1520,1900,3420,31
KALIRO,2023,1610,1990,3600,31
KALIRO,2024,1700,2040,3740,31
KALIRO,2025,1790,2100,3890,31
KALUNGU,2015,710,960,1670,31
KALUNGU,2016,730,970,1700,31
KALUNGU,2017,750,1000,1750,31
KALUNGU,2018,760,1030,1790,31
KALUNGU,2019,780,1060,1840,31
KALUNGU,2020,800,1100,1900,31
KALUNGU,2021,800,1150,1950,31
KALUNGU,2022,830,1170,2000,31
KALUNGU,2023,840,1190,2030,31
KALUNGU,2024,870,1210,2080,31
KALUNGU,2025,900,1200,2100,31
KAMPALA,2015,9360,10280,19640,31
KAMPALA,2016,9550,10480,20030,31
KAMPALA,2017,9730,10680,20410,31
KAMPALA,2018,9920,10880,20800,31
KAMPALA,2019,10110,11090,21200,31
KAMPALA,2020,10290,11280,21570,31
KAMPALA,2021,10470,11480,21950,31
KAMPALA,2022,10650,11670,22320,31
KAMPALA,2023,10820,11860,22680,31
KAMPALA,2024,10990,12040,23030,31
KAMPALA,2025,11140,12220,23360,31
KAMULI,2015,1860,2500,4360,31
KAMULI,2016,1930,2600,4530,31
KAMULI,2017,2000,2690,4690,31
KAMULI,2018,2070,2790,4860,31
KAMULI,2019,2140,2920,5060,31
KAMULI,2020,2210,3060,5270,31
KAMULI,2021,2290,3220,5510,31
KAMULI,2022,2350,3360,5710,31
KAMULI,2023,2450,3460,5910,31
KAMULI,2024,2560,3540,6100,31
KAMULI,2025,2690,3590,6280,31
KAMWENGE,2015,1240,1370,2610,31
KAMWENGE,2016,1290,1420,2710,31
KAMWENGE,2017,1350,1460,2810,31
KAMWENGE,2018,1400,1520,2920,31
KAMWENGE,2019,1460,1570,3030,31
KAMWENGE,2020,1510,1620,3130,31
KAMWENGE,2021,1570,1680,3250,31
KAMWENGE,2022,1630,1730,3360,31
KAMWENGE,2023,1690,1790,3480,31
KAMWENGE,2024,1750,1840,3590,31
KAMWENGE,2025,1810,1900,3710,31
KANUNGU,2015,1120,1380,2500,31
KANUNGU,2016,1140,1400,2540,31
KANUNGU,2017,1160,1420,2580,31
KANUNGU,2018,1180,1450,2630,31
KANUNGU,2019,1200,1470,2670,31
KANUNGU,2020,1220,1490,2710,31
KANUNGU,2021,1240,1510,2750,31
KANUNGU,2022,1260,1530,2790,31
KANUNGU,2023,1280,1550,2830,31
KANUNGU,2024,1300,1570,2870,31
KANUNGU,2025,1310,1590,2900,31
KAPCHORWA,2015,480,600,1080,31
KAPCHORWA,2016,500,610,1110,31
KAPCHORWA,2017,510,630,1140,31
KAPCHORWA,2018,530,650,1180,31
KAPCHORWA,2019,550,670,1220,31
KAPCHORWA,2020,560,680,1240,31
KAPCHORWA,2021,580,700,1280,31
KAPCHORWA,2022,590,720,1310,31
KAPCHORWA,2023,610,740,1350,31
KAPCHORWA,2024,630,750,1380,31
KAPCHORWA,2025,640,770,1410,31
KAPELEBYONG,2015,420,470,890,31
KAPELEBYONG,2016,430,490,920,31
KAPELEBYONG,2017,450,490,940,31
KAPELEBYONG,2018,470,520,990,31
KAPELEBYONG,2019,490,540,1030,31
KAPELEBYONG,2020,500,570,1070,31
KAPELEBYONG,2021,520,600,1120,31
KAPELEBYONG,2022,540,630,1170,31
KAPELEBYONG,2023,560,660,1220,31
KAPELEBYONG,2024,610,680,1290,31
KAPELEBYONG,2025,640,690,1330,31
KASESE,2015,3310,3930,7240,31
KASESE,2016,3420,4050,7470,31
KASESE,2017,3550,4210,7760,31
KASESE,2018,3660,4370,8030,31
KASESE,2019,3780,4580,8360,31
KASESE,2020,3890,4790,8680,31
KASESE,2021,4020,5020,9040,31
KASESE,2022,4150,5240,9390,31
KASESE,2023,4300,5410,9710,31
KASESE,2024,4480,5520,10000,31
KASESE,2025,4700,5590,10290,31
KASSANDA,2015,1060,1090,2150,31
KASSANDA,2016,1090,1120,2210,31
KASSANDA,2017,1120,1140,2260,31
KASSANDA,2018,1150,1170,2320,31
KASSANDA,2019,1180,1190,2370,31
KASSANDA,2020,1210,1220,2430,31
KASSANDA,2021,1240,1240,2480,31
KASSANDA,2022,1280,1260,2540,31
KASSANDA,2023,1310,1290,2600,31
KASSANDA,2024,1340,1310,2650,31
KASSANDA,2025,1370,1330,2700,31
KATAKWI,2015,880,880,1760,31
KATAKWI,2016,920,900,1820,31
KATAKWI,2017,960,940,1900,31
KATAKWI,2018,1000,970,1970,31
KATAKWI,2019,1030,1030,2060,31
KATAKWI,2020,1060,1080,2140,31
KATAKWI,2021,1100,1130,2230,31
KATAKWI,2022,1140,1190,2330,31
KATAKWI,2023,1190,1240,2430,31
KATAKWI,2024,1260,1250,2510,31
KATAKWI,2025,1320,1280,2600,31
KAYUNGA,2015,1360,1850,3210,31
KAYUNGA,2016,1400,1900,3300,31
KAYUNGA,2017,1450,1960,3410,31
KAYUNGA,2018,1490,2020,3510,31
KAYUNGA,2019,1530,2100,3630,31
KAYUNGA,2020,1570,2200,3770,31
KAYUNGA,2021,1610,2290,3900,31
KAYUNGA,2022,1650,2380,4030,31
KAYUNGA,2023,1710,2440,4150,31
KAYUNGA,2024,1780,2480,4260,31
KAYUNGA,2025,1860,2480,4340,31
KAZO,2015,860,940,1800,31
KAZO,2016,900,980,1880,31
KAZO,2017,930,1010,1940,31
KAZO,2018,970,1050,2020,31
KAZO,2019,1000,1080,2080,31
KAZO,2020,1040,1120,2160,31
KAZO,2021,1070,1160,2230,31
KAZO,2022,1110,1190,2300,31
KAZO,2023,1150,1230,2380,31
KAZO,2024,1190,1270,2460,31
KAZO,2025,1230,1310,2540,31
KIBAALE,2015,760,780,1540,31
KIBAALE,2016,810,820,1630,31
KIBAALE,2017,860,870,1730,31
KIBAALE,2018,910,920,1830,31
KIBAALE,2019,970,970,1940,31
KIBAALE,2020,1030,1030,2060,31
KIBAALE,2021,1100,1080,2180,31
KIBAALE,2022,1160,1140,2300,31
KIBAALE,2023,1230,1210,2440,31
KIBAALE,2024,1300,1270,2570,31
KIBAALE,2025,1380,1340,2720,31
KIBOGA,2015,850,830,1680,31
KIBOGA,2016,870,860,1730,31
KIBOGA,2017,900,890,1790,31
KIBOGA,2018,940,930,1870,31
KIBOGA,2019,960,960,1920,31
KIBOGA,2020,1000,1010,2010,31
KIBOGA,2021,1030,1070,2100,31
KIBOGA,2022,1070,1120,2190,31
KIBOGA,2023,1110,1170,2280,31
KIBOGA,2024,1150,1210,2360,31
KIBOGA,2025,1200,1230,2430,31
KIBUKU,2015,890,1220,2110,31
KIBUKU,2016,940,1290,2230,31
KIBUKU,2017,990,1350,2340,31
KIBUKU,2018,1020,1420,2440,31
KIBUKU,2019,1070,1510,2580,31
KIBUKU,2020,1120,1610,2730,31
KIBUKU,2021,1170,1700,2870,31
KIBUKU,2022,1230,1810,3040,31
KIBUKU,2023,1300,1890,3190,31
KIBUKU,2024,1380,1960,3340,31
KIBUKU,2025,1460,2020,3480,31
KIKUUBE,2015,1480,1400,2880,31
KIKUUBE,2016,1560,1470,3030,31
KIKUUBE,2017,1640,1550,3190,31
KIKUUBE,2018,1730,1620,3350,31
KIKUUBE,2019,1820,1710,3530,31
KIKUUBE,2020,1920,1790,3710,31
KIKUUBE,2021,2010,1880,3890,31
KIKUUBE,2022,2120,1970,4090,31
KIKUUBE,2023,2220,2060,4280,31
KIKUUBE,2024,2330,2160,4490,31
KIKUUBE,2025,2440,2260,4700,31
KIRUHURA,2015,840,780,1620,31
KIRUHURA,2016,870,810,1680,31
KIRUHURA,2017,900,840,1740,31
KIRUHURA,2018,940,870,1810,31
KIRUHURA,2019,970,900,1870,31
KIRUHURA,2020,1010,930,1940,31
KIRUHURA,2021,1040,960,2000,31
KIRUHURA,2022,1080,990,2070,31
KIRUHURA,2023,1120,1020,2140,31
KIRUHURA,2024,1150,1050,2200,31
KIRUHURA,2025,1190,1080,2270,31
KIRYANDONGO,2015,1510,1650,3160,31
KIRYANDONGO,2016,1570,1720,3290,31
KIRYANDONGO,2017,1640,1790,3430,31
KIRYANDONGO,2018,1700,1860,3560,31
KIRYANDONGO,2019,1770,1970,3740,31
KIRYANDONGO,2020,1830,2060,3890,31
KIRYANDONGO,2021,1900,2180,4080,31
KIRYANDONGO,2022,1970,2280,4250,31
KIRYANDONGO,2023,2060,2370,4430,31
KIRYANDONGO,2024,2160,2430,4590,31
KIRYANDONGO,2025,2280,2470,4750,31
KISORO,2015,1090,1850,2940,31
KISORO,2016,1130,1920,3050,31
KISORO,2017,1150,1980,3130,31
KISORO,2018,1190,2050,3240,31
KISORO,2019,1220,2140,3360,31
KISORO,2020,1260,2240,3500,31
KISORO,2021,1280,2340,3620,31
KISORO,2022,1330,2440,3770,31
KISORO,2023,1360,2520,3880,31
KISORO,2024,1420,2560,3980,31
KISORO,2025,1480,2580,4060,31
KITAGWENDA,2015,600,730,1330,31
KITAGWENDA,2016,620,750,1370,31
KITAGWENDA,2017,650,780,1430,31
KITAGWENDA,2018,670,810,1480,31
KITAGWENDA,2019,700,840,1540,31
KITAGWENDA,2020,730,870,1600,31
KITAGWENDA,2021,750,900,1650,31
KITAGWENDA,2022,780,930,1710,31
KITAGWENDA,2023,810,950,1760,31
KITAGWENDA,2024,840,980,1820,31
KITAGWENDA,2025,870,1020,1890,31
KITGUM,2015,1210,1280,2490,31
KITGUM,2016,1230,1320,2550,31
KITGUM,2017,1270,1350,2620,31
KITGUM,2018,1300,1400,2700,31
KITGUM,2019,1340,1450,2790,31
KITGUM,2020,1360,1520,2880,31
KITGUM,2021,1400,1580,2980,31
KITGUM,2022,1420,1630,3050,31
KITGUM,2023,1480,1680,3160,31
KITGUM,2024,1520,1710,3230,31
KITGUM,2025,1580,1710,3290,31
KOBOKO,2015,1020,1100,2120,31
KOBOKO,2016,1070,1150,2220,31
KOBOKO,2017,1120,1210,2330,31
KOBOKO,2018,1170,1270,2440,31
KOBOKO,2019,1240,1360,2600,31
KOBOKO,2020,1290,1450,2740,31
KOBOKO,2021,1350,1530,2880,31
KOBOKO,2022,1410,1630,3040,31
KOBOKO,2023,1490,1700,3190,31
KOBOKO,2024,1580,1770,3350,31
KOBOKO,2025,1690,1830,3520,31
KOLE,2015,1100,1170,2270,31
KOLE,2016,1140,1210,2350,31
KOLE,2017,1170,1240,2410,31
KOLE,2018,1210,1280,2490,31
KOLE,2019,1250,1310,2560,31
KOLE,2020,1290,1350,2640,31
KOLE,2021,1330,1380,2710,31
KOLE,2022,1370,1420,2790,31
KOLE,2023,1400,1460,2860,31
KOLE,2024,1450,1490,2940,31
KOLE,2025,1480,1530,3010,31
KOTIDO,2015,750,890,1640,31
KOTIDO,2016,790,930,1720,31
KOTIDO,2017,810,960,1770,31
KOTIDO,2018,840,1000,1840,31
KOTIDO,2019,860,1040,1900,31
KOTIDO,2020,900,1100,2000,31
KOTIDO,2021,920,1150,2070,31
KOTIDO,2022,950,1200,2150,31
KOTIDO,2023,980,1240,2220,31
KOTIDO,2024,1040,1250,2290,31
KOTIDO,2025,1080,1280,2360,31
KUMI,2015,1170,1520,2690,31
KUMI,2016,1220,1580,2800,31
KUMI,2017,1270,1650,2920,31
KUMI,2018,1330,1720,3050,31
KUMI,2019,1380,1820,3200,31
KUMI,2020,1430,1910,3340,31
KUMI,2021,1480,2030,3510,31
KUMI,2022,1550,2120,3670,31
KUMI,2023,1620,2200,3820,31
KUMI,2024,1700,2270,3970,31
KUMI,2025,1790,2310,4100,31
KWANIA,2015,840,930,1770,31
KWANIA,2016,870,960,1830,31
KWANIA,2017,890,990,1880,31
KWANIA,2018,920,1020,1940,31
KWANIA,2019,950,1050,2000,31
KWANIA,2020,970,1070,2040,31
KWANIA,2021,1000,1100,2100,31
KWANIA,2022,1030,1130,2160,31
KWANIA,2023,1060,1160,2220,31
KWANIA,2024,1090,1190,2280,31
KWANIA,2025,1110,1220,2330,31
KWEEN,2015,440,460,900,31
KWEEN,2016,450,480,930,31
KWEEN,2017,460,490,950,31
KWEEN,2018,480,500,980,31
KWEEN,2019,490,510,1000,31
KWEEN,2020,510,520,1030,31
KWEEN,2021,520,540,1060,31
KWEEN,2022,540,550,1090,31
KWEEN,2023,550,560,1110,31
KWEEN,2024,570,570,1140,31
KWEEN,2025,580,580,1160,31
KYANKWANZI,2015,1090,960,2050,31
KYANKWANZI,2016,1150,1010,2160,31
KYANKWANZI,2017,1210,1050,2260,31
KYANKWANZI,2018,1270,1100,2370,31
KYANKWANZI,2019,1340,1150,2490,31
KYANKWANZI,2020,1400,1210,2610,31
KYANKWANZI,2021,1470,1260,2730,31
KYANKWANZI,2022,1540,1310,2850,31
KYANKWANZI,2023,1620,1370,2990,31
KYANKWANZI,2024,1690,1430,3120,31
KYANKWANZI,2025,1770,1490,3260,31
KYEGEGWA,2015,1350,1480,2830,31
KYEGEGWA,2016,1460,1600,3060,31
KYEGEGWA,2017,1580,1720,3300,31
KYEGEGWA,2018,1710,1860,3570,31
KYEGEGWA,2019,1840,2000,3840,31
KYEGEGWA,2020,1990,2160,4150,31
KYEGEGWA,2021,2150,2320,4470,31
KYEGEGWA,2022,2320,2500,4820,31
KYEGEGWA,2023,2500,2690,5190,31
KYEGEGWA,2024,2700,2890,5590,31
KYEGEGWA,2025,2900,3110,6010,31
KYENJOJO,2015,2020,2040,4060,31
KYENJOJO,2016,2110,2120,4230,31
KYENJOJO,2017,2190,2190,4380,31
KYENJOJO,2018,2280,2270,4550,31
KYENJOJO,2019,2370,2350,4720,31
KYENJOJO,2020,2470,2440,4910,31
KYENJOJO,2021,2560,2520,5080,31
KYENJOJO,2022,2660,2610,5270,31
KYENJOJO,2023,2760,2700,5460,31
KYENJOJO,2024,2860,2790,5650,31
KYENJOJO,2025,2960,2870,5830,31
KYOTERA,2015,1170,1570,2740,31
KYOTERA,2016,1210,1610,2820,31
KYOTERA,2017,1230,1650,2880,31
KYOTERA,2018,1270,1700,2970,31
KYOTERA,2019,1290,1760,3050,31
KYOTERA,2020,1330,1840,3170,31
KYOTERA,2021,1350,1900,3250,31
KYOTERA,2022,1400,1980,3380,31
KYOTERA,2023,1430,2020,3450,31
KYOTERA,2024,1480,2040,3520,31
KYOTERA,2025,1540,2050,3590,31
KARENGA,2015,230,260,490,31
KARENGA,2016,240,260,500,31
KARENGA,2017,240,270,510,31
KARENGA,2018,250,280,530,31
KARENGA,2019,260,280,540,31
KARENGA,2020,260,290,550,31
KARENGA,2021,270,300,570,31
KARENGA,2022,270,300,570,31
KARENGA,2023,280,310,590,31
KARENGA,2024,290,310,600,31
KARENGA,2025,290,320,610,31
LAMWO,2015,650,740,1390,31
LAMWO,2016,660,760,1420,31
LAMWO,2017,670,790,1460,31
LAMWO,2018,690,800,1490,31
LAMWO,2019,700,840,1540,31
LAMWO,2020,710,870,1580,31
LAMWO,2021,720,910,1630,31
LAMWO,2022,730,930,1660,31
LAMWO,2023,750,960,1710,31
LAMWO,2024,770,970,1740,31
LAMWO,2025,790,980,1770,31
LIRA,2015,2080,2190,4270,31
LIRA,2016,2140,2250,4390,31
LIRA,2017,2200,2320,4520,31
LIRA,2018,2260,2380,4640,31
LIRA,2019,2320,2450,4770,31
LIRA,2020,2380,2520,4900,31
LIRA,2021,2440,2580,5020,31
LIRA,2022,2500,2650,5150,31
LIRA,2023,2560,2720,5280,31
LIRA,2024,2620,2780,5400,31
LIRA,2025,2680,2850,5530,31
LUUKA,2015,820,1110,1930,31
LUUKA,2016,840,1140,1980,31
LUUKA,2017,880,1180,2060,31
LUUKA,2018,900,1230,2130,31
LUUKA,2019,920,1280,2200,31
LUUKA,2020,950,1340,2290,31
LUUKA,2021,970,1390,2360,31
LUUKA,2022,1000,1460,2460,31
LUUKA,2023,1030,1510,2540,31
LUUKA,2024,1080,1530,2610,31
LUUKA,2025,1130,1540,2670,31
LUWERO,2015,2160,2600,4760,31
LUWERO,2016,2240,2690,4930,31
LUWERO,2017,2320,2790,5110,31
LUWERO,2018,2390,2890,5280,31
LUWERO,2019,2480,3040,5520,31
LUWERO,2020,2550,3180,5730,31
LUWERO,2021,2620,3330,5950,31
LUWERO,2022,2720,3480,6200,31
LUWERO,2023,2820,3590,6410,31
LUWERO,2024,2950,3670,6620,31
LUWERO,2025,3090,3720,6810,31
LWENGO,2015,1330,1700,3030,31
LWENGO,2016,1370,1750,3120,31
LWENGO,2017,1400,1790,3190,31
LWENGO,2018,1420,1830,3250,31
LWENGO,2019,1450,1890,3340,31
LWENGO,2020,1470,1960,3430,31
LWENGO,2021,1500,2030,3530,31
LWENGO,2022,1520,2090,3610,31
LWENGO,2023,1560,2120,3680,31
LWENGO,2024,1600,2140,3740,31
LWENGO,2025,1660,2150,3810,31
LYANTONDE,2015,500,570,1070,31
LYANTONDE,2016,520,610,1130,31
LYANTONDE,2017,550,630,1180,31
LYANTONDE,2018,570,660,1230,31
LYANTONDE,2019,590,680,1270,31
LYANTONDE,2020,610,710,1320,31
LYANTONDE,2021,640,740,1380,31
LYANTONDE,2022,660,780,1440,31
LYANTONDE,2023,680,820,1500,31
LYANTONDE,2024,700,860,1560,31
LYANTONDE,2025,730,910,1640,31
MANAFWA,2015,660,740,1400,31
MANAFWA,2016,680,760,1440,31
MANAFWA,2017,690,780,1470,31
MANAFWA,2018,710,790,1500,31
MANAFWA,2019,730,810,1540,31
MANAFWA,2020,750,830,1580,31
MANAFWA,2021,760,840,1600,31
MANAFWA,2022,780,860,1640,31
MANAFWA,2023,800,880,1680,31
MANAFWA,2024,810,890,1700,31
MANAFWA,2025,830,910,1740,31
MARACHA,2015,610,820,1430,31
MARACHA,2016,620,840,1460,31
MARACHA,2017,630,850,1480,31
MARACHA,2018,650,870,1520,31
MARACHA,2019,660,890,1550,31
MARACHA,2020,670,900,1570,31
MARACHA,2021,690,920,1610,31
MARACHA,2022,700,930,1630,31
MARACHA,2023,710,950,1660,31
MARACHA,2024,720,960,1680,31
MARACHA,2025,730,980,1710,31
MASAKA,2015,1750,2140,3890,31
MASAKA,2016,1800,2210,4010,31
MASAKA,2017,1860,2280,4140,31
MASAKA,2018,1940,2380,4320,31
MASAKA,2019,1990,2480,4470,31
MASAKA,2020,2040,2590,4630,31
MASAKA,2021,2100,2710,4810,31
MASAKA,2022,2170,2820,4990,31
MASAKA,2023,2240,2900,5140,31
MASAKA,2024,2340,2960,5300,31
MASAKA,2025,2450,3000,5450,31
MASINDI,2015,1540,1470,3010,31
MASINDI,2016,1590,1510,3100,31
MASINDI,2017,1640,1550,3190,31
MASINDI,2018,1680,1590,3270,31
MASINDI,2019,1730,1630,3360,31
MASINDI,2020,1780,1670,3450,31
MASINDI,2021,1820,1710,3530,31
MASINDI,2022,1870,1760,3630,31
MASINDI,2023,1920,1800,3720,31
MASINDI,2024,1970,1840,3810,31
MASINDI,2025,2010,1880,3890,31
MAYUGE,2015,1990,2610,4600,31
MAYUGE,2016,2080,2720,4800,31
MAYUGE,2017,2170,2840,5010,31
MAYUGE,2018,2250,2980,5230,31
MAYUGE,2019,2340,3140,5480,31
MAYUGE,2020,2420,3310,5730,31
MAYUGE,2021,2510,3500,6010,31
MAYUGE,2022,2620,3690,6310,31
MAYUGE,2023,2740,3830,6570,31
MAYUGE,2024,2870,3940,6810,31
MAYUGE,2025,3040,4040,7080,31
MBALE,2015,2800,3430,6230,31
MBALE,2016,2920,3600,6520,31
MBALE,2017,3030,3760,6790,31
MBALE,2018,3150,3950,7100,31
MBALE,2019,3270,4180,7450,31
MBALE,2020,3390,4430,7820,31
MBALE,2021,3510,4690,8200,31
MBALE,2022,3650,4940,8590,31
MBALE,2023,3810,5160,8970,31
MBALE,2024,4010,5330,9340,31
MBALE,2025,4230,5450,9680,31
MBARARA,2015,1750,2020,3770,31
MBARARA,2016,1790,2070,3860,31
MBARARA,2017,1830,2110,3940,31
MBARARA,2018,1870,2160,4030,31
MBARARA,2019,1910,2200,4110,31
MBARARA,2020,1950,2250,4200,31
MBARARA,2021,2000,2290,4290,31
MBARARA,2022,2030,2330,4360,31
MBARARA,2023,2080,2380,4460,31
MBARARA,2024,2110,2410,4520,31
MBARARA,2025,2150,2460,4610,31
MITOOMA,2015,660,1000,1660,31
MITOOMA,2016,670,1010,1680,31
MITOOMA,2017,670,1020,1690,31
MITOOMA,2018,680,1030,1710,31
MITOOMA,2019,690,1030,1720,31
MITOOMA,2020,700,1040,1740,31
MITOOMA,2021,700,1050,1750,31
MITOOMA,2022,710,1060,1770,31
MITOOMA,2023,720,1060,1780,31
MITOOMA,2024,720,1070,1790,31
MITOOMA,2025,730,1070,1800,31
MITYANA,2015,1600,1830,3430,31
MITYANA,2016,1640,1890,3530,31
MITYANA,2017,1700,1940,3640,31
MITYANA,2018,1740,2000,3740,31
MITYANA,2019,1780,2080,3860,31
MITYANA,2020,1830,2170,4000,31
MITYANA,2021,1880,2260,4140,31
MITYANA,2022,1920,2340,4260,31
MITYANA,2023,1980,2410,4390,31
MITYANA,2024,2060,2430,4490,31
MITYANA,2025,2140,2450,4590,31
MOROTO,2015,610,600,1210,31
MOROTO,2016,620,640,1260,31
MOROTO,2017,640,660,1300,31
MOROTO,2018,660,690,1350,31
MOROTO,2019,680,720,1400,31
MOROTO,2020,700,750,1450,31
MOROTO,2021,720,790,1510,31
MOROTO,2022,740,820,1560,31
MOROTO,2023,770,870,1640,31
MOROTO,2024,810,880,1690,31
MOROTO,2025,840,900,1740,31
MOYO,2015,440,470,910,31
MOYO,2016,450,490,940,31
MOYO,2017,470,500,970,31
MOYO,2018,480,510,990,31
MOYO,2019,490,520,1010,31
MOYO,2020,500,530,1030,31
MOYO,2021,510,540,1050,31
MOYO,2022,520,550,1070,31
MOYO,2023,540,560,1100,31
MOYO,2024,550,570,1120,31
MOYO,2025,560,580,1140,31
MPIGI,2015,1320,1500,2820,31
MPIGI,2016,1370,1550,2920,31
MPIGI,2017,1410,1600,3010,31
MPIGI,2018,1470,1680,3150,31
MPIGI,2019,1500,1750,3250,31
MPIGI,2020,1550,1840,3390,31
MPIGI,2021,1610,1920,3530,31
MPIGI,2022,1650,2010,3660,31
MPIGI,2023,1720,2090,3810,31
MPIGI,2024,1790,2120,3910,31
MPIGI,2025,1870,2150,4020,31
MUBENDE,2015,2600,2870,5470,31
MUBENDE,2016,2770,3050,5820,31
MUBENDE,2017,2950,3250,6200,31
MUBENDE,2018,3120,3480,6600,31
MUBENDE,2019,3310,3740,7050,31
MUBENDE,2020,3510,4040,7550,31
MUBENDE,2021,3720,4350,8070,31
MUBENDE,2022,3950,4670,8620,31
MUBENDE,2023,4210,4960,9170,31
MUBENDE,2024,4530,5210,9740,31
MUBENDE,2025,4880,5410,10290,31
MUKONO,2015,3180,3760,6940,31
MUKONO,2016,3280,3910,7190,31
MUKONO,2017,3410,4080,7490,31
MUKONO,2018,3540,4280,7820,31
MUKONO,2019,3660,4500,8160,31
MUKONO,2020,3780,4760,8540,31
MUKONO,2021,3910,5020,8930,31
MUKONO,2022,4050,5270,9320,31
MUKONO,2023,4210,5470,9680,31
MUKONO,2024,4410,5630,10040,31
MUKONO,2025,4640,5730,10370,31
NABILATUK,2015,310,360,670,31
NABILATUK,2016,330,370,700,31
NABILATUK,2017,340,390,730,31
NABILATUK,2018,370,420,790,31
NABILATUK,2019,390,450,840,31
NABILATUK,2020,420,480,900,31
NABILATUK,2021,440,510,950,31
NABILATUK,2022,470,550,1020,31
NABILATUK,2023,490,580,1070,31
NABILATUK,2024,530,610,1140,31
NABILATUK,2025,560,620,1180,31
NAKAPIRIPIRIT,2015,510,560,1070,31
NAKAPIRIPIRIT,2016,540,600,1140,31
NAKAPIRIPIRIT,2017,560,630,1190,31
NAKAPIRIPIRIT,2018,590,670,1260,31
NAKAPIRIPIRIT,2019,630,720,1350,31
NAKAPIRIPIRIT,2020,660,770,1430,31
NAKAPIRIPIRIT,2021,690,820,1510,31
NAKAPIRIPIRIT,2022,730,870,1600,31
NAKAPIRIPIRIT,2023,770,930,1700,31
NAKAPIRIPIRIT,2024,830,970,1800,31
NAKAPIRIPIRIT,2025,880,990,1870,31
NAKASEKE,2015,1030,760,1790,31
NAKASEKE,2016,1060,780,1840,31
NAKASEKE,2017,1100,800,1900,31
NAKASEKE,2018,1140,820,1960,31
NAKASEKE,2019,1180,840,2020,31
NAKASEKE,2020,1230,850,2080,31
NAKASEKE,2021,1270,870,2140,31
NAKASEKE,2022,1310,890,2200,31
NAKASEKE,2023,1350,910,2260,31
NAKASEKE,2024,1400,930,2330,31
NAKASEKE,2025,1440,950,2390,31
NAKASONGOLA,2015,1090,1060,2150,31
NAKASONGOLA,2016,1130,1110,2240,31
NAKASONGOLA,2017,1180,1150,2330,31
NAKASONGOLA,2018,1230,1200,2430,31
NAKASONGOLA,2019,1280,1260,2540,31
NAKASONGOLA,2020,1330,1330,2660,31
NAKASONGOLA,2021,1370,1390,2760,31
NAKASONGOLA,2022,1420,1470,2890,31
NAKASONGOLA,2023,1490,1520,3010,31
NAKASONGOLA,2024,1570,1560,3130,31
NAKASONGOLA,2025,1660,1590,3250,31
NAMAYINGO,2015,1190,1480,2670,31
NAMAYINGO,2016,1220,1530,2750,31
NAMAYINGO,2017,1260,1560,2820,31
NAMAYINGO,2018,1300,1620,2920,31
NAMAYINGO,2019,1320,1670,2990,31
NAMAYINGO,2020,1360,1750,3110,31
NAMAYINGO,2021,1400,1810,3210,31
NAMAYINGO,2022,1420,1880,3300,31
NAMAYINGO,2023,1480,1920,3400,31
NAMAYINGO,2024,1520,1950,3470,31
NAMAYINGO,2025,1600,1970,3570,31
NAMISINDWA,2015,840,1020,1860,31
NAMISINDWA,2016,860,1040,1900,31
NAMISINDWA,2017,890,1070,1960,31
NAMISINDWA,2018,910,1090,2000,31
NAMISINDWA,2019,940,1120,2060,31
NAMISINDWA,2020,960,1140,2100,31
NAMISINDWA,2021,980,1170,2150,31
NAMISINDWA,2022,1010,1190,2200,31
NAMISINDWA,2023,1030,1220,2250,31
NAMISINDWA,2024,1060,1240,2300,31
NAMISINDWA,2025,1080,1260,2340,31
NAMUTUMBA,2015,1020,1400,2420,31
NAMUTUMBA,2016,1070,1460,2530,31
NAMUTUMBA,2017,1120,1530,2650,31
NAMUTUMBA,2018,1170,1600,2770,31
NAMUTUMBA,2019,1220,1700,2920,31
NAMUTUMBA,2020,1270,1810,3080,31
NAMUTUMBA,2021,1330,1900,3230,31
NAMUTUMBA,2022,1380,2010,3390,31
NAMUTUMBA,2023,1450,2100,3550,31
NAMUTUMBA,2024,1520,2160,3680,31
NAMUTUMBA,2025,1610,2210,3820,31
NAPAK,2015,550,780,1330,31
NAPAK,2016,570,820,1390,31
NAPAK,2017,580,840,1420,31
NAPAK,2018,590,870,1460,31
NAPAK,2019,610,910,1520,31
NAPAK,2020,620,960,1580,31
NAPAK,2021,630,1010,1640,31
NAPAK,2022,660,1050,1710,31
NAPAK,2023,670,1070,1740,31
NAPAK,2024,700,1090,1790,31
NAPAK,2025,730,1110,1840,31
NEBBI,2015,990,1140,2130,31
NEBBI,2016,1020,1180,2200,31
NEBBI,2017,1060,1210,2270,31
NEBBI,2018,1090,1240,2330,31
NEBBI,2019,1120,1280,2400,31
NEBBI,2020,1160,1310,2470,31
NEBBI,2021,1190,1350,2540,31
NEBBI,2022,1220,1380,2600,31
NEBBI,2023,1260,1420,2680,31
NEBBI,2024,1290,1450,2740,31
NEBBI,2025,1330,1480,2810,31
NGORA,2015,660,770,1430,31
NGORA,2016,690,790,1480,31
NGORA,2017,710,830,1540,31
NGORA,2018,750,860,1610,31
NGORA,2019,770,910,1680,31
NGORA,2020,800,950,1750,31
NGORA,2021,820,1010,1830,31
NGORA,2022,850,1060,1910,31
NGORA,2023,880,1090,1970,31
NGORA,2024,930,1130,2060,31
NGORA,2025,970,1140,2110,31
NTOROKO,2015,420,360,780,31
NTOROKO,2016,430,360,790,31
NTOROKO,2017,450,380,830,31
NTOROKO,2018,460,390,850,31
NTOROKO,2019,470,410,880,31
NTOROKO,2020,490,420,910,31
NTOROKO,2021,510,450,960,31
NTOROKO,2022,530,460,990,31
NTOROKO,2023,550,480,1030,31
NTOROKO,2024,560,480,1040,31
NTOROKO,2025,590,500,1090,31
NTUNGAMO,2015,2010,2520,4530,31
NTUNGAMO,2016,2050,2570,4620,31
NTUNGAMO,2017,2100,2620,4720,31
NTUNGAMO,2018,2140,2670,4810,31
NTUNGAMO,2019,2190,2710,4900,31
NTUNGAMO,2020,2230,2760,4990,31
NTUNGAMO,2021,2270,2800,5070,31
NTUNGAMO,2022,2320,2850,5170,31
NTUNGAMO,2023,2360,2890,5250,31
NTUNGAMO,2024,2400,2930,5330,31
NTUNGAMO,2025,2440,2980,5420,31
NWOYA,2015,620,700,1320,31
NWOYA,2016,690,770,1460,31
NWOYA,2017,760,850,1610,31
NWOYA,2018,840,930,1770,31
NWOYA,2019,930,1030,1960,31
NWOYA,2020,1020,1130,2150,31
NWOYA,2021,1130,1240,2370,31
NWOYA,2022,1240,1370,2610,31
NWOYA,2023,1370,1500,2870,31
NWOYA,2024,1500,1650,3150,31
NWOYA,2025,1650,1810,3460,31
OBONGI,2015,230,230,460,31
OBONGI,2016,240,240,480,31
OBONGI,2017,250,250,500,31
OBONGI,2018,260,260,520,31
OBONGI,2019,260,260,520,31
OBONGI,2020,270,290,560,31
OBONGI,2021,280,290,570,31
OBONGI,2022,280,300,580,31
OBONGI,2023,300,320,620,31
OBONGI,2024,310,320,630,31
OBONGI,2025,330,320,650,31
OMORO,2015,840,1000,1840,31
OMORO,2016,870,1040,1910,31
OMORO,2017,900,1100,2000,31
OMORO,2018,950,1160,2110,31
OMORO,2019,990,1220,2210,31
OMORO,2020,1040,1300,2340,31
OMORO,2021,1070,1380,2450,31
OMORO,2022,1130,1460,2590,31
OMORO,2023,1190,1520,2710,31
OMORO,2024,1240,1560,2800,31
OMORO,2025,1320,1600,2920,31
OTUKE,2015,450,420,870,31
OTUKE,2016,470,440,910,31
OTUKE,2017,490,460,950,31
OTUKE,2018,510,480,990,31
OTUKE,2019,530,500,1030,31
OTUKE,2020,560,520,1080,31
OTUKE,2021,580,540,1120,31
OTUKE,2022,600,560,1160,31
OTUKE,2023,630,580,1210,31
OTUKE,2024,650,600,1250,31
OTUKE,2025,680,630,1310,31
OYAM,2015,1820,2100,3920,31
OYAM,2016,1880,2160,4040,31
OYAM,2017,1930,2220,4150,31
OYAM,2018,1990,2280,4270,31
OYAM,2019,2050,2350,4400,31
OYAM,2020,2110,2410,4520,31
OYAM,2021,2170,2480,4650,31
OYAM,2022,2230,2550,4780,31
OYAM,2023,2290,2610,4900,31
OYAM,2024,2350,2680,5030,31
OYAM,2025,2410,2740,5150,31
PADER,2015,960,1060,2020,31
PADER,2016,980,1100,2080,31
PADER,2017,1000,1130,2130,31
PADER,2018,1040,1170,2210,31
PADER,2019,1060,1220,2280,31
PADER,2020,1080,1280,2360,31
PADER,2021,1100,1330,2430,31
PADER,2022,1140,1390,2530,31
PADER,2023,1170,1430,2600,31
PADER,2024,1210,1450,2660,31
PADER,2025,1260,1470,2730,31
PAKWACH,2015,680,740,1420,31
PAKWACH,2016,710,770,1480,31
PAKWACH,2017,740,800,1540,31
PAKWACH,2018,770,830,1600,31
PAKWACH,2019,800,850,1650,31
PAKWACH,2020,830,880,1710,31
PAKWACH,2021,870,910,1780,31
PAKWACH,2022,900,950,1850,31
PAKWACH,2023,940,980,1920,31
PAKWACH,2024,970,1010,1980,31
PAKWACH,2025,1010,1040,2050,31
PALLISA,2015,1350,1410,2760,31
PALLISA,2016,1410,1500,2910,31
PALLISA,2017,1490,1590,3080,31
PALLISA,2018,1580,1680,3260,31
PALLISA,2019,1660,1790,3450,31
PALLISA,2020,1740,1910,3650,31
PALLISA,2021,1830,2060,3890,31
PALLISA,2022,1920,2190,4110,31
PALLISA,2023,2040,2310,4350,31
PALLISA,2024,2180,2400,4580,31
PALLISA,2025,2330,2480,4810,31
RAKAI,2015,1270,1760,3030,31
RAKAI,2016,1300,1820,3120,31
RAKAI,2017,1360,1890,3250,31
RAKAI,2018,1400,1960,3360,31
RAKAI,2019,1450,2050,3500,31
RAKAI,2020,1480,2150,3630,31
RAKAI,2021,1540,2260,3800,31
RAKAI,2022,1600,2360,3960,31
RAKAI,2023,1650,2440,4090,31
RAKAI,2024,1730,2480,4210,31
RAKAI,2025,1810,2510,4320,31
RUBANDA,2015,850,1140,1990,31
RUBANDA,2016,860,1150,2010,31
RUBANDA,2017,870,1160,2030,31
RUBANDA,2018,880,1170,2050,31
RUBANDA,2019,890,1180,2070,31
RUBANDA,2020,900,1190,2090,31
RUBANDA,2021,910,1200,2110,31
RUBANDA,2022,920,1200,2120,31
RUBANDA,2023,930,1210,2140,31
RUBANDA,2024,940,1210,2150,31
RUBANDA,2025,950,1220,2170,31
RUBIRIZI,2015,510,620,1130,31
RUBIRIZI,2016,520,640,1160,31
RUBIRIZI,2017,530,650,1180,31
RUBIRIZI,2018,540,660,1200,31
RUBIRIZI,2019,550,670,1220,31
RUBIRIZI,2020,560,680,1240,31
RUBIRIZI,2021,570,700,1270,31
RUBIRIZI,2022,580,710,1290,31
RUBIRIZI,2023,590,720,1310,31
RUBIRIZI,2024,600,730,1330,31
RUBIRIZI,2025,610,740,1350,31
RUKIGA,2015,410,480,890,31
RUKIGA,2016,420,490,910,31
RUKIGA,2017,420,490,910,31
RUKIGA,2018,430,490,920,31
RUKIGA,2019,430,500,930,31
RUKIGA,2020,440,500,940,31
RUKIGA,2021,440,500,940,31
RUKIGA,2022,440,510,950,31
RUKIGA,2023,440,510,950,31
RUKIGA,2024,450,510,960,31
RUKIGA,2025,450,510,960,31
RUKUNGIRI,2015,1270,1690,2960,31
RUKUNGIRI,2016,1290,1700,2990,31
RUKUNGIRI,2017,1300,1720,3020,31
RUKUNGIRI,2018,1320,1730,3050,31
RUKUNGIRI,2019,1330,1750,3080,31
RUKUNGIRI,2020,1350,1760,3110,31
RUKUNGIRI,2021,1360,1780,3140,31
RUKUNGIRI,2022,1370,1790,3160,31
RUKUNGIRI,2023,1380,1800,3180,31
RUKUNGIRI,2024,1390,1810,3200,31
RUKUNGIRI,2025,1400,1820,3220,31
RWAMPARA,2015,560,670,1230,31
RWAMPARA,2016,570,680,1250,31
RWAMPARA,2017,580,700,1280,31
RWAMPARA,2018,590,710,1300,31
RWAMPARA,2019,610,730,1340,31
RWAMPARA,2020,620,740,1360,31
RWAMPARA,2021,630,760,1390,31
RWAMPARA,2022,650,770,1420,31
RWAMPARA,2023,660,790,1450,31
RWAMPARA,2024,670,800,1470,31
RWAMPARA,2025,680,810,1490,31
SERERE,2015,1410,1550,2960,31
SERERE,2016,1490,1620,3110,31
SERERE,2017,1560,1720,3280,31
SERERE,2018,1640,1820,3460,31
SERERE,2019,1730,1940,3670,31
SERERE,2020,1810,2060,3870,31
SERERE,2021,1890,2200,4090,31
SERERE,2022,1990,2330,4320,31
SERERE,2023,2100,2440,4540,31
SERERE,2024,2220,2540,4760,31
SERERE,2025,2370,2610,4980,31
SHEEMA,2015,850,1070,1920,31
SHEEMA,2016,860,1080,1940,31
SHEEMA,2017,870,1090,1960,31
SHEEMA,2018,880,1110,1990,31
SHEEMA,2019,890,1120,2010,31
SHEEMA,2020,900,1130,2030,31
SHEEMA,2021,910,1140,2050,31
SHEEMA,2022,920,1140,2060,31
SHEEMA,2023,930,1150,2080,31
SHEEMA,2024,940,1160,2100,31
SHEEMA,2025,940,1170,2110,31
SIRONKO,2015,910,1060,1970,31
SIRONKO,2016,930,1080,2010,31
SIRONKO,2017,950,1110,2060,31
SIRONKO,2018,970,1130,2100,31
SIRONKO,2019,1000,1150,2150,31
SIRONKO,2020,1020,1170,2190,31
SIRONKO,2021,1040,1190,2230,31
SIRONKO,2022,1060,1210,2270,31
SIRONKO,2023,1080,1230,2310,31
SIRONKO,2024,1100,1250,2350,31
SIRONKO,2025,1120,1270,2390,31
SOROTI,2015,1790,1730,3520,31
SOROTI,2016,1870,1800,3670,31
SOROTI,2017,1960,1900,3860,31
SOROTI,2018,2060,2000,4060,31
SOROTI,2019,2140,2110,4250,31
SOROTI,2020,2240,2240,4480,31
SOROTI,2021,2330,2380,4710,31
SOROTI,2022,2440,2520,4960,31
SOROTI,2023,2560,2630,5190,31
SOROTI,2024,2710,2720,5430,31
SOROTI,2025,2860,2790,5650,31
SSEMBABULE,2015,1480,1660,3140,31
SSEMBABULE,2016,1530,1720,3250,31
SSEMBABULE,2017,1590,1790,3380,31
SSEMBABULE,2018,1660,1880,3540,31
SSEMBABULE,2019,1710,1970,3680,31
SSEMBABULE,2020,1780,2060,3840,31
SSEMBABULE,2021,1830,2180,4010,31
SSEMBABULE,2022,1910,2280,4190,31
SSEMBABULE,2023,1980,2360,4340,31
SSEMBABULE,2024,2090,2430,4520,31
SSEMBABULE,2025,2190,2470,4660,31
TORORO,2015,2240,2700,4940,31
TORORO,2016,2300,2770,5070,31
TORORO,2017,2360,2840,5200,31
TORORO,2018,2420,2910,5330,31
TORORO,2019,2480,2980,5460,31
TORORO,2020,2540,3050,5590,31
TORORO,2021,2610,3120,5730,31
TORORO,2022,2670,3190,5860,31
TORORO,2023,2730,3260,5990,31
TORORO,2024,2790,3330,6120,31
TORORO,2025,2850,3400,6250,31
WAKISO,2015,10970,12670,23640,31
WAKISO,2016,11700,13540,25240,31
WAKISO,2017,12480,14470,26950,31
WAKISO,2018,13310,15450,28760,31
WAKISO,2019,14200,16480,30680,31
WAKISO,2020,15120,17580,32700,31
WAKISO,2021,16090,18740,34830,31
WAKISO,2022,17130,19980,37110,31
WAKISO,2023,18210,21270,39480,31
WAKISO,2024,19350,22620,41970,31
WAKISO,2025,20540,24060,44600,31
YUMBE,2015,1720,1950,3670,31
YUMBE,2016,1830,2100,3930,31
YUMBE,2017,1950,2250,4200,31
YUMBE,2018,2070,2420,4490,31
YUMBE,2019,2180,2630,4810,31
YUMBE,2020,2310,2850,5160,31
YUMBE,2021,2460,3100,5560,31
YUMBE,2022,2590,3340,5930,31
YUMBE,2023,2760,3580,6340,31
YUMBE,2024,2960,3780,6740,31
YUMBE,2025,3190,3970,7160,31
ZOMBO,2015,950,1050,2000,31
ZOMBO,2016,980,1080,2060,31
ZOMBO,2017,1010,1110,2120,31
ZOMBO,2018,1040,1140,2180,31
ZOMBO,2019,1080,1170,2250,31
ZOMBO,2020,1110,1200,2310,31
ZOMBO,2021,1140,1230,2370,31
ZOMBO,2022,1170,1260,2430,31
ZOMBO,2023,1200,1290,2490,31
ZOMBO,2024,1230,1320,2550,31
ZOMBO,2025,1260,1360,2620,31
MADI OKOLLO,2015,510,550,1060,31
MADI OKOLLO,2016,520,560,1080,31
MADI OKOLLO,2017,540,570,1110,31
MADI OKOLLO,2018,560,590,1150,31
MADI OKOLLO,2019,570,610,1180,31
MADI OKOLLO,2020,590,620,1210,31
MADI OKOLLO,2021,600,640,1240,31
MADI OKOLLO,2022,620,650,1270,31
MADI OKOLLO,2023,630,670,1300,31
MADI OKOLLO,2024,650,680,1330,31
MADI OKOLLO,2025,660,700,1360,31
ABIM,2015,470,570,1040,32
ABIM,2016,500,610,1110,32
ABIM,2017,540,660,1200,32
ABIM,2018,580,710,1290,32
ABIM,2019,620,760,1380,32
ABIM,2020,670,830,1500,32
ABIM,2021,710,900,1610,32
ABIM,2022,760,980,1740,32
ABIM,2023,820,1060,1880,32
ABIM,2024,880,1140,2020,32
ABIM,2025,960,1210,2170,32
ADJUMANI,2015,1080,1350,2430,32
ADJUMANI,2016,1080,1360,2440,32
ADJUMANI,2017,1090,1370,2460,32
ADJUMANI,2018,1100,1390,2490,32
ADJUMANI,2019,1110,1400,2510,32
ADJUMANI,2020,1110,1410,2520,32
ADJUMANI,2021,1120,1420,2540,32
ADJUMANI,2022,1120,1430,2550,32
ADJUMANI,2023,1130,1440,2570,32
ADJUMANI,2024,1130,1450,2580,32
ADJUMANI,2025,1130,1460,2590,32
AGAGO,2015,1220,1310,2530,32
AGAGO,2016,1240,1330,2570,32
AGAGO,2017,1260,1350,2610,32
AGAGO,2018,1280,1380,2660,32
AGAGO,2019,1300,1400,2700,32
AGAGO,2020,1320,1420,2740,32
AGAGO,2021,1340,1440,2780,32
AGAGO,2022,1360,1470,2830,32
AGAGO,2023,1380,1490,2870,32
AGAGO,2024,1400,1510,2910,32
AGAGO,2025,1420,1530,2950,32
ALEBTONG,2015,1060,1340,2400,32
ALEBTONG,2016,1090,1380,2470,32
ALEBTONG,2017,1130,1440,2570,32
ALEBTONG,2018,1170,1500,2670,32
ALEBTONG,2019,1220,1570,2790,32
ALEBTONG,2020,1260,1650,2910,32
ALEBTONG,2021,1300,1730,3030,32
ALEBTONG,2022,1350,1830,3180,32
ALEBTONG,2023,1400,1910,3310,32
ALEBTONG,2024,1450,1990,3440,32
ALEBTONG,2025,1520,2040,3560,32
AMOLATAR,2015,770,910,1680,32
AMOLATAR,2016,790,950,1740,32
AMOLATAR,2017,810,980,1790,32
AMOLATAR,2018,850,1020,1870,32
AMOLATAR,2019,870,1060,1930,32
AMOLATAR,2020,910,1120,2030,32
AMOLATAR,2021,930,1170,2100,32
AMOLATAR,2022,970,1230,2200,32
AMOLATAR,2023,1000,1290,2290,32
AMOLATAR,2024,1040,1330,2370,32
AMOLATAR,2025,1080,1360,2440,32
AMUDAT,2015,440,520,960,32
AMUDAT,2016,460,560,1020,32
AMUDAT,2017,480,580,1060,32
AMUDAT,2018,500,620,1120,32
AMUDAT,2019,530,660,1190,32
AMUDAT,2020,560,710,1270,32
AMUDAT,2021,580,760,1340,32
AMUDAT,2022,600,820,1420,32
AMUDAT,2023,640,870,1510,32
AMUDAT,2024,670,920,1590,32
AMUDAT,2025,710,960,1670,32
AMURIA,2015,780,910,1690,32
AMURIA,2016,820,950,1770,32
AMURIA,2017,860,990,1850,32
AMURIA,2018,900,1040,1940,32
AMURIA,2019,950,1100,2050,32
AMURIA,2020,980,1160,2140,32
AMURIA,2021,1020,1240,2260,32
AMURIA,2022,1070,1300,2370,32
AMURIA,2023,1120,1380,2500,32
AMURIA,2024,1170,1440,2610,32
AMURIA,2025,1240,1490,2730,32
AMURU,2015,980,1170,2150,32
AMURU,2016,1010,1220,2230,32
AMURU,2017,1040,1260,2300,32
AMURU,2018,1080,1310,2390,32
AMURU,2019,1130,1380,2510,32
AMURU,2020,1160,1440,2600,32
AMURU,2021,1200,1510,2710,32
AMURU,2022,1240,1600,2840,32
AMURU,2023,1280,1670,2950,32
AMURU,2024,1330,1730,3060,32
AMURU,2025,1390,1780,3170,32
APAC,2015,1210,1280,2490,32
APAC,2016,1260,1330,2590,32
APAC,2017,1300,1370,2670,32
APAC,2018,1350,1420,2770,32
APAC,2019,1400,1470,2870,32
APAC,2020,1450,1520,2970,32
APAC,2021,1500,1560,3060,32
APAC,2022,1550,1610,3160,32
APAC,2023,1600,1670,3270,32
APAC,2024,1650,1720,3370,32
APAC,2025,1700,1770,3470,32
ARUA,2015,3980,4800,8780,32
ARUA,2016,4100,4930,9030,32
ARUA,2017,4210,5070,9280,32
ARUA,2018,4330,5200,9530,32
ARUA,2019,4460,5340,9800,32
ARUA,2020,4570,5470,10040,32
ARUA,2021,4700,5610,10310,32
ARUA,2022,4820,5750,10570,32
ARUA,2023,4940,5890,10830,32
ARUA,2024,5060,6020,11080,32
ARUA,2025,5180,6160,11340,32
BUDAKA,2015,770,1070,1840,32
BUDAKA,2016,810,1120,1930,32
BUDAKA,2017,840,1180,2020,32
BUDAKA,2018,870,1230,2100,32
BUDAKA,2019,920,1300,2220,32
BUDAKA,2020,950,1370,2320,32
BUDAKA,2021,1000,1450,2450,32
BUDAKA,2022,1040,1530,2570,32
BUDAKA,2023,1090,1620,2710,32
BUDAKA,2024,1140,1690,2830,32
BUDAKA,2025,1200,1740,2940,32
BUDUDA,2015,940,1000,1940,32
BUDUDA,2016,990,1060,2050,32
BUDUDA,2017,1040,1120,2160,32
BUDUDA,2018,1110,1180,2290,32
BUDUDA,2019,1160,1270,2430,32
BUDUDA,2020,1230,1350,2580,32
BUDUDA,2021,1290,1440,2730,32
BUDUDA,2022,1360,1540,2900,32
BUDUDA,2023,1430,1650,3080,32
BUDUDA,2024,1510,1740,3250,32
BUDUDA,2025,1610,1810,3420,32
BUGIRI,2015,1630,2040,3670,32
BUGIRI,2016,1700,2150,3850,32
BUGIRI,2017,1790,2270,4060,32
BUGIRI,2018,1880,2380,4260,32
BUGIRI,2019,1970,2520,4490,32
BUGIRI,2020,2070,2670,4740,32
BUGIRI,2021,2170,2850,5020,32
BUGIRI,2022,2270,3030,5300,32
BUGIRI,2023,2380,3210,5590,32
BUGIRI,2024,2510,3370,5880,32
BUGIRI,2025,2670,3500,6170,32
BUGWERI,2015,700,940,1640,32
BUGWERI,2016,720,970,1690,32
BUGWERI,2017,740,1010,1750,32
BUGWERI,2018,770,1040,1810,32
BUGWERI,2019,800,1090,1890,32
BUGWERI,2020,820,1150,1970,32
BUGWERI,2021,850,1200,2050,32
BUGWERI,2022,880,1270,2150,32
BUGWERI,2023,910,1320,2230,32
BUGWERI,2024,950,1380,2330,32
BUGWERI,2025,1000,1410,2410,32
BUHWEJU,2015,680,720,1400,32
BUHWEJU,2016,700,740,1440,32
BUHWEJU,2017,730,760,1490,32
BUHWEJU,2018,750,780,1530,32
BUHWEJU,2019,770,810,1580,32
BUHWEJU,2020,800,830,1630,32
BUHWEJU,2021,820,850,1670,32
BUHWEJU,2022,850,880,1730,32
BUHWEJU,2023,870,900,1770,32
BUHWEJU,2024,890,920,1810,32
BUHWEJU,2025,920,950,1870,32
BUIKWE,2015,2320,2660,4980,32
BUIKWE,2016,2380,2760,5140,32
BUIKWE,2017,2460,2840,5300,32
BUIKWE,2018,2530,2940,5470,32
BUIKWE,2019,2600,3050,5650,32
BUIKWE,2020,2680,3180,5860,32
BUIKWE,2021,2740,3330,6070,32
BUIKWE,2022,2820,3480,6300,32
BUIKWE,2023,2890,3630,6520,32
BUIKWE,2024,2990,3730,6720,32
BUIKWE,2025,3110,3800,6910,32
BUKEDEA,2015,920,1060,1980,32
BUKEDEA,2016,970,1110,2080,32
BUKEDEA,2017,1030,1180,2210,32
BUKEDEA,2018,1080,1240,2320,32
BUKEDEA,2019,1140,1320,2460,32
BUKEDEA,2020,1200,1400,2600,32
BUKEDEA,2021,1260,1490,2750,32
BUKEDEA,2022,1320,1600,2920,32
BUKEDEA,2023,1390,1690,3080,32
BUKEDEA,2024,1470,1780,3250,32
BUKEDEA,2025,1560,1860,3420,32
BUKOMANSIMBI,2015,640,840,1480,32
BUKOMANSIMBI,2016,650,860,1510,32
BUKOMANSIMBI,2017,660,880,1540,32
BUKOMANSIMBI,2018,680,890,1570,32
BUKOMANSIMBI,2019,680,900,1580,32
BUKOMANSIMBI,2020,700,940,1640,32
BUKOMANSIMBI,2021,710,960,1670,32
BUKOMANSIMBI,2022,720,990,1710,32
BUKOMANSIMBI,2023,720,1010,1730,32
BUKOMANSIMBI,2024,740,1030,1770,32
BUKOMANSIMBI,2025,760,1030,1790,32
BUKWO,2015,520,540,1060,32
BUKWO,2016,550,570,1120,32
BUKWO,2017,580,600,1180,32
BUKWO,2018,610,620,1230,32
BUKWO,2019,640,660,1300,32
BUKWO,2020,680,690,1370,32
BUKWO,2021,710,720,1430,32
BUKWO,2022,750,750,1500,32
BUKWO,2023,790,780,1570,32
BUKWO,2024,820,820,1640,32
BUKWO,2025,860,860,1720,32
BULAMBULI,2015,830,940,1770,32
BULAMBULI,2016,880,1000,1880,32
BULAMBULI,2017,930,1060,1990,32
BULAMBULI,2018,980,1120,2100,32
BULAMBULI,2019,1050,1200,2250,32
BULAMBULI,2020,1100,1290,2390,32
BULAMBULI,2021,1160,1380,2540,32
BULAMBULI,2022,1230,1490,2720,32
BULAMBULI,2023,1300,1590,2890,32
BULAMBULI,2024,1380,1690,3070,32
BULAMBULI,2025,1480,1760,3240,32
BULIISA,2015,880,830,1710,32
BULIISA,2016,930,870,1800,32
BULIISA,2017,980,900,1880,32
BULIISA,2018,1040,940,1980,32
BULIISA,2019,1090,980,2070,32
BULIISA,2020,1150,1030,2180,32
BULIISA,2021,1210,1070,2280,32
BULIISA,2022,1270,1110,2380,32
BULIISA,2023,1340,1160,2500,32
BULIISA,2024,1400,1210,2610,32
BULIISA,2025,1470,1250,2720,32
BUNDIBUGYO,2015,1280,1370,2650,32
BUNDIBUGYO,2016,1330,1430,2760,32
BUNDIBUGYO,2017,1380,1490,2870,32
BUNDIBUGYO,2018,1430,1550,2980,32
BUNDIBUGYO,2019,1490,1620,3110,32
BUNDIBUGYO,2020,1550,1710,3260,32
BUNDIBUGYO,2021,1610,1800,3410,32
BUNDIBUGYO,2022,1650,1890,3540,32
BUNDIBUGYO,2023,1720,1980,3700,32
BUNDIBUGYO,2024,1790,2050,3840,32
BUNDIBUGYO,2025,1890,2100,3990,32
BUNYANGABU,2015,920,990,1910,32
BUNYANGABU,2016,950,1030,1980,32
BUNYANGABU,2017,980,1060,2040,32
BUNYANGABU,2018,1020,1090,2110,32
BUNYANGABU,2019,1050,1140,2190,32
BUNYANGABU,2020,1090,1190,2280,32
BUNYANGABU,2021,1130,1260,2390,32
BUNYANGABU,2022,1150,1320,2470,32
BUNYANGABU,2023,1190,1370,2560,32
BUNYANGABU,2024,1240,1420,2660,32
BUNYANGABU,2025,1300,1450,2750,32
BUSHENYI,2015,1370,1540,2910,32
BUSHENYI,2016,1390,1550,2940,32
BUSHENYI,2017,1410,1570,2980,32
BUSHENYI,2018,1430,1580,3010,32
BUSHENYI,2019,1440,1600,3040,32
BUSHENYI,2020,1460,1610,3070,32
BUSHENYI,2021,1470,1620,3090,32
BUSHENYI,2022,1490,1630,3120,32
BUSHENYI,2023,1500,1640,3140,32
BUSHENYI,2024,1510,1650,3160,32
BUSHENYI,2025,1520,1650,3170,32
BUSIA,2015,1540,1950,3490,32
BUSIA,2016,1590,2040,3630,32
BUSIA,2017,1660,2120,3780,32
BUSIA,2018,1730,2210,3940,32
BUSIA,2019,1800,2320,4120,32
BUSIA,2020,1870,2440,4310,32
BUSIA,2021,1940,2570,4510,32
BUSIA,2022,2020,2710,4730,32
BUSIA,2023,2090,2850,4940,32
BUSIA,2024,2190,2960,5150,32
BUSIA,2025,2300,3030,5330,32
BUTAMBALA,2015,390,510,900,32
BUTAMBALA,2016,400,530,930,32
BUTAMBALA,2017,400,540,940,32
BUTAMBALA,2018,410,550,960,32
BUTAMBALA,2019,430,560,990,32
BUTAMBALA,2020,430,590,1020,32
BUTAMBALA,2021,440,600,1040,32
BUTAMBALA,2022,450,630,1080,32
BUTAMBALA,2023,460,640,1100,32
BUTAMBALA,2024,470,670,1140,32
BUTAMBALA,2025,490,670,1160,32
BUTEBO,2015,400,490,890,32
BUTEBO,2016,410,510,920,32
BUTEBO,2017,410,520,930,32
BUTEBO,2018,420,530,950,32
BUTEBO,2019,440,550,990,32
BUTEBO,2020,450,570,1020,32
BUTEBO,2021,450,590,1040,32
BUTEBO,2022,460,610,1070,32
BUTEBO,2023,480,630,1110,32
BUTEBO,2024,490,640,1130,32
BUTEBO,2025,510,660,1170,32
BUVUMA,2015,1020,650,1670,32
BUVUMA,2016,1080,690,1770,32
BUVUMA,2017,1150,740,1890,32
BUVUMA,2018,1220,790,2010,32
BUVUMA,2019,1290,840,2130,32
BUVUMA,2020,1370,900,2270,32
BUVUMA,2021,1450,950,2400,32
BUVUMA,2022,1540,1020,2560,32
BUVUMA,2023,1630,1080,2710,32
BUVUMA,2024,1720,1150,2870,32
BUVUMA,2025,1810,1220,3030,32
BUYENDE,2015,1290,1460,2750,32
BUYENDE,2016,1350,1550,2900,32
BUYENDE,2017,1430,1630,3060,32
BUYENDE,2018,1510,1720,3230,32
BUYENDE,2019,1590,1830,3420,32
BUYENDE,2020,1670,1950,3620,32
BUYENDE,2021,1750,2090,3840,32
BUYENDE,2022,1850,2230,4080,32
BUYENDE,2023,1940,2380,4320,32
BUYENDE,2024,2050,2500,4550,32
BUYENDE,2025,2190,2600,4790,32
DOKOLO,2015,910,1010,1920,32
DOKOLO,2016,940,1040,1980,32
DOKOLO,2017,970,1060,2030,32
DOKOLO,2018,1000,1090,2090,32
DOKOLO,2019,1030,1120,2150,32
DOKOLO,2020,1060,1150,2210,32
DOKOLO,2021,1090,1180,2270,32
DOKOLO,2022,1120,1210,2330,32
DOKOLO,2023,1150,1240,2390,32
DOKOLO,2024,1180,1270,2450,32
DOKOLO,2025,1210,1300,2510,32
GOMBA,2015,790,800,1590,32
GOMBA,2016,810,820,1630,32
GOMBA,2017,830,840,1670,32
GOMBA,2018,860,860,1720,32
GOMBA,2019,880,880,1760,32
GOMBA,2020,900,920,1820,32
GOMBA,2021,920,950,1870,32
GOMBA,2022,940,990,1930,32
GOMBA,2023,970,1020,1990,32
GOMBA,2024,990,1040,2030,32
GOMBA,2025,1040,1050,2090,32
GULU,2015,2020,2020,4040,32
GULU,2016,2080,2080,4160,32
GULU,2017,2140,2140,4280,32
GULU,2018,2200,2200,4400,32
GULU,2019,2270,2270,4540,32
GULU,2020,2330,2330,4660,32
GULU,2021,2400,2390,4790,32
GULU,2022,2470,2450,4920,32
GULU,2023,2530,2520,5050,32
GULU,2024,2600,2580,5180,32
GULU,2025,2660,2640,5300,32
HOIMA,2015,2280,2100,4380,32
HOIMA,2016,2370,2170,4540,32
HOIMA,2017,2460,2250,4710,32
HOIMA,2018,2550,2320,4870,32
HOIMA,2019,2640,2400,5040,32
HOIMA,2020,2740,2480,5220,32
HOIMA,2021,2840,2560,5400,32
HOIMA,2022,2930,2640,5570,32
HOIMA,2023,3030,2730,5760,32
HOIMA,2024,3130,2810,5940,32
HOIMA,2025,3240,2890,6130,32
IBANDA,2015,1610,1680,3290,32
IBANDA,2016,1650,1710,3360,32
IBANDA,2017,1680,1740,3420,32
IBANDA,2018,1710,1780,3490,32
IBANDA,2019,1740,1810,3550,32
IBANDA,2020,1770,1840,3610,32
IBANDA,2021,1810,1860,3670,32
IBANDA,2022,1840,1890,3730,32
IBANDA,2023,1870,1920,3790,32
IBANDA,2024,1890,1950,3840,32
IBANDA,2025,1920,1970,3890,32
IGANGA,2015,1550,2090,3640,32
IGANGA,2016,1610,2170,3780,32
IGANGA,2017,1680,2270,3950,32
IGANGA,2018,1750,2360,4110,32
IGANGA,2019,1820,2470,4290,32
IGANGA,2020,1890,2600,4490,32
IGANGA,2021,1960,2740,4700,32
IGANGA,2022,2030,2890,4920,32
IGANGA,2023,2110,3040,5150,32
IGANGA,2024,2210,3160,5370,32
IGANGA,2025,2320,3240,5560,32
ISINGIRO,2015,2980,3570,6550,32
ISINGIRO,2016,3090,3700,6790,32
ISINGIRO,2017,3210,3830,7040,32
ISINGIRO,2018,3330,3970,7300,32
ISINGIRO,2019,3450,4100,7550,32
ISINGIRO,2020,3570,4240,7810,32
ISINGIRO,2021,3700,4380,8080,32
ISINGIRO,2022,3820,4520,8340,32
ISINGIRO,2023,3950,4670,8620,32
ISINGIRO,2024,4080,4810,8890,32
ISINGIRO,2025,4210,4960,9170,32
JINJA,2015,3090,2970,6060,32
JINJA,2016,3150,3010,6160,32
JINJA,2017,3200,3060,6260,32
JINJA,2018,3250,3110,6360,32
JINJA,2019,3300,3150,6450,32
JINJA,2020,3350,3190,6540,32
JINJA,2021,3400,3240,6640,32
JINJA,2022,3450,3280,6730,32
JINJA,2023,3490,3320,6810,32
JINJA,2024,3540,3360,6900,32
JINJA,2025,3580,3390,6970,32
KAABONG,2015,600,660,1260,32
KAABONG,2016,620,680,1300,32
KAABONG,2017,640,700,1340,32
KAABONG,2018,650,710,1360,32
KAABONG,2019,670,730,1400,32
KAABONG,2020,690,750,1440,32
KAABONG,2021,710,760,1470,32
KAABONG,2022,720,780,1500,32
KAABONG,2023,740,800,1540,32
KAABONG,2024,760,810,1570,32
KAABONG,2025,770,830,1600,32
KABALE,2015,1460,1700,3160,32
KABALE,2016,1480,1720,3200,32
KABALE,2017,1500,1740,3240,32
KABALE,2018,1530,1760,3290,32
KABALE,2019,1550,1780,3330,32
KABALE,2020,1570,1800,3370,32
KABALE,2021,1590,1820,3410,32
KABALE,2022,1610,1830,3440,32
KABALE,2023,1630,1850,3480,32
KABALE,2024,1650,1860,3510,32
KABALE,2025,1670,1880,3550,32
KABAROLE,2015,2340,2140,4480,32
KABAROLE,2016,2390,2180,4570,32
KABAROLE,2017,2440,2230,4670,32
KABAROLE,2018,2490,2280,4770,32
KABAROLE,2019,2550,2320,4870,32
KABAROLE,2020,2600,2370,4970,32
KABAROLE,2021,2650,2420,5070,32
KABAROLE,2022,2700,2460,5160,32
KABAROLE,2023,2750,2510,5260,32
KABAROLE,2024,2800,2550,5350,32
KABAROLE,2025,2850,2600,5450,32
KABERAMAIDO,2015,490,560,1050,32
KABERAMAIDO,2016,510,590,1100,32
KABERAMAIDO,2017,540,620,1160,32
KABERAMAIDO,2018,570,650,1220,32
KABERAMAIDO,2019,600,690,1290,32
KABERAMAIDO,2020,630,730,1360,32
KABERAMAIDO,2021,660,780,1440,32
KABERAMAIDO,2022,690,840,1530,32
KABERAMAIDO,2023,720,880,1600,32
KABERAMAIDO,2024,760,920,1680,32
KABERAMAIDO,2025,810,960,1770,32
KAGADI,2015,2280,2420,4700,32
KAGADI,2016,2370,2500,4870,32
KAGADI,2017,2450,2590,5040,32
KAGADI,2018,2540,2680,5220,32
KAGADI,2019,2640,2770,5410,32
KAGADI,2020,2730,2870,5600,32
KAGADI,2021,2820,2960,5780,32
KAGADI,2022,2920,3060,5980,32
KAGADI,2023,3020,3160,6180,32
KAGADI,2024,3120,3260,6380,32
KAGADI,2025,3220,3360,6580,32
KAKUMIRO,2015,2210,2040,4250,32
KAKUMIRO,2016,2410,2210,4620,32
KAKUMIRO,2017,2620,2400,5020,32
KAKUMIRO,2018,2850,2600,5450,32
KAKUMIRO,2019,3100,2810,5910,32
KAKUMIRO,2020,3370,3040,6410,32
KAKUMIRO,2021,3660,3290,6950,32
KAKUMIRO,2022,3970,3560,7530,32
KAKUMIRO,2023,4310,3850,8160,32
KAKUMIRO,2024,4670,4160,8830,32
KAKUMIRO,2025,5060,4490,9550,32
KALAKI,2015,550,530,1080,32
KALAKI,2016,570,550,1120,32
KALAKI,2017,600,570,1170,32
KALAKI,2018,620,600,1220,32
KALAKI,2019,650,620,1270,32
KALAKI,2020,670,640,1310,32
KALAKI,2021,700,670,1370,32
KALAKI,2022,730,690,1420,32
KALAKI,2023,760,720,1480,32
KALAKI,2024,790,740,1530,32
KALAKI,2025,820,770,1590,32
KALANGALA,2015,960,540,1500,32
KALANGALA,2016,1000,560,1560,32
KALANGALA,2017,1030,590,1620,32
KALANGALA,2018,1070,610,1680,32
KALANGALA,2019,1100,630,1730,32
KALANGALA,2020,1140,660,1800,32
KALANGALA,2021,1180,690,1870,32
KALANGALA,2022,1220,710,1930,32
KALANGALA,2023,1260,740,2000,32
KALANGALA,2024,1290,770,2060,32
KALANGALA,2025,1330,790,2120,32
KALIRO,2015,910,1110,2020,32
KALIRO,2016,950,1160,2110,32
KALIRO,2017,990,1220,2210,32
KALIRO,2018,1040,1280,2320,32
KALIRO,2019,1080,1350,2430,32
KALIRO,2020,1130,1420,2550,32
KALIRO,2021,1170,1510,2680,32
KALIRO,2022,1230,1600,2830,32
KALIRO,2023,1280,1690,2970,32
KALIRO,2024,1340,1770,3110,32
KALIRO,2025,1420,1820,3240,32
KALUNGU,2015,800,1000,1800,32
KALUNGU,2016,810,1020,1830,32
KALUNGU,2017,830,1040,1870,32
KALUNGU,2018,850,1060,1910,32
KALUNGU,2019,860,1090,1950,32
KALUNGU,2020,880,1130,2010,32
KALUNGU,2021,900,1160,2060,32
KALUNGU,2022,910,1210,2120,32
KALUNGU,2023,930,1250,2180,32
KALUNGU,2024,950,1260,2210,32
KALUNGU,2025,980,1280,2260,32
KAMPALA,2015,14040,13850,27890,32
KAMPALA,2016,14320,14120,28440,32
KAMPALA,2017,14610,14390,29000,32
KAMPALA,2018,14890,14660,29550,32
KAMPALA,2019,15170,14940,30110,32
KAMPALA,2020,15440,15200,30640,32
KAMPALA,2021,15720,15470,31190,32
KAMPALA,2022,15980,15730,31710,32
KAMPALA,2023,16240,15980,32220,32
KAMPALA,2024,16480,16220,32700,32
KAMPALA,2025,16720,16460,33180,32
KAMULI,2015,1860,2460,4320,32
KAMULI,2016,1920,2550,4470,32
KAMULI,2017,1990,2640,4630,32
KAMULI,2018,2070,2730,4800,32
KAMULI,2019,2130,2840,4970,32
KAMULI,2020,2200,2960,5160,32
KAMULI,2021,2270,3110,5380,32
KAMULI,2022,2340,3260,5600,32
KAMULI,2023,2420,3400,5820,32
KAMULI,2024,2520,3520,6040,32
KAMULI,2025,2640,3590,6230,32
KAMWENGE,2015,1830,1930,3760,32
KAMWENGE,2016,1910,2000,3910,32
KAMWENGE,2017,1980,2070,4050,32
KAMWENGE,2018,2060,2150,4210,32
KAMWENGE,2019,2150,2220,4370,32
KAMWENGE,2020,2230,2290,4520,32
KAMWENGE,2021,2320,2370,4690,32
KAMWENGE,2022,2400,2450,4850,32
KAMWENGE,2023,2490,2530,5020,32
KAMWENGE,2024,2580,2610,5190,32
KAMWENGE,2025,2670,2690,5360,32
KANUNGU,2015,1460,1860,3320,32
KANUNGU,2016,1490,1900,3390,32
KANUNGU,2017,1520,1930,3450,32
KANUNGU,2018,1540,1960,3500,32
KANUNGU,2019,1570,1990,3560,32
KANUNGU,2020,1590,2020,3610,32
KANUNGU,2021,1620,2040,3660,32
KANUNGU,2022,1640,2070,3710,32
KANUNGU,2023,1670,2100,3770,32
KANUNGU,2024,1690,2130,3820,32
KANUNGU,2025,1710,2150,3860,32
KAPCHORWA,2015,630,710,1340,32
KAPCHORWA,2016,650,730,1380,32
KAPCHORWA,2017,670,750,1420,32
KAPCHORWA,2018,690,770,1460,32
KAPCHORWA,2019,710,790,1500,32
KAPCHORWA,2020,730,810,1540,32
KAPCHORWA,2021,750,830,1580,32
KAPCHORWA,2022,780,850,1630,32
KAPCHORWA,2023,800,870,1670,32
KAPCHORWA,2024,820,890,1710,32
KAPCHORWA,2025,840,910,1750,32
KAPELEBYONG,2015,370,400,770,32
KAPELEBYONG,2016,380,420,800,32
KAPELEBYONG,2017,400,440,840,32
KAPELEBYONG,2018,410,450,860,32
KAPELEBYONG,2019,440,470,910,32
KAPELEBYONG,2020,450,500,950,32
KAPELEBYONG,2021,470,530,1000,32
KAPELEBYONG,2022,480,550,1030,32
KAPELEBYONG,2023,510,580,1090,32
KAPELEBYONG,2024,530,600,1130,32
KAPELEBYONG,2025,560,620,1180,32
KASESE,2015,3980,4610,8590,32
KASESE,2016,4100,4780,8880,32
KASESE,2017,4240,4940,9180,32
KASESE,2018,4390,5110,9500,32
KASESE,2019,4540,5310,9850,32
KASESE,2020,4680,5550,10230,32
KASESE,2021,4830,5820,10650,32
KASESE,2022,4960,6110,11070,32
KASESE,2023,5130,6360,11490,32
KASESE,2024,5320,6580,11900,32
KASESE,2025,5550,6700,12250,32
KASSANDA,2015,1820,1650,3470,32
KASSANDA,2016,1880,1690,3570,32
KASSANDA,2017,1930,1720,3650,32
KASSANDA,2018,1990,1760,3750,32
KASSANDA,2019,2040,1800,3840,32
KASSANDA,2020,2100,1830,3930,32
KASSANDA,2021,2150,1870,4020,32
KASSANDA,2022,2210,1900,4110,32
KASSANDA,2023,2260,1940,4200,32
KASSANDA,2024,2320,1970,4290,32
KASSANDA,2025,2370,2010,4380,32
KATAKWI,2015,710,780,1490,32
KATAKWI,2016,730,810,1540,32
KATAKWI,2017,770,840,1610,32
KATAKWI,2018,790,870,1660,32
KATAKWI,2019,830,910,1740,32
KATAKWI,2020,860,960,1820,32
KATAKWI,2021,890,1000,1890,32
KATAKWI,2022,920,1050,1970,32
KATAKWI,2023,960,1100,2060,32
KATAKWI,2024,990,1140,2130,32
KATAKWI,2025,1050,1170,2220,32
KAYUNGA,2015,1440,1950,3390,32
KAYUNGA,2016,1470,2010,3480,32
KAYUNGA,2017,1510,2060,3570,32
KAYUNGA,2018,1560,2130,3690,32
KAYUNGA,2019,1600,2200,3800,32
KAYUNGA,2020,1640,2280,3920,32
KAYUNGA,2021,1690,2390,4080,32
KAYUNGA,2022,1730,2490,4220,32
KAYUNGA,2023,1770,2580,4350,32
KAYUNGA,2024,1830,2650,4480,32
KAYUNGA,2025,1910,2680,4590,32
KAZO,2015,1040,1190,2230,32
KAZO,2016,1080,1240,2320,32
KAZO,2017,1120,1280,2400,32
KAZO,2018,1160,1330,2490,32
KAZO,2019,1210,1370,2580,32
KAZO,2020,1250,1420,2670,32
KAZO,2021,1290,1460,2750,32
KAZO,2022,1340,1510,2850,32
KAZO,2023,1380,1560,2940,32
KAZO,2024,1430,1610,3040,32
KAZO,2025,1480,1660,3140,32
KIBAALE,2015,970,930,1900,32
KIBAALE,2016,1040,980,2020,32
KIBAALE,2017,1100,1040,2140,32
KIBAALE,2018,1170,1100,2270,32
KIBAALE,2019,1250,1160,2410,32
KIBAALE,2020,1320,1230,2550,32
KIBAALE,2021,1400,1300,2700,32
KIBAALE,2022,1490,1370,2860,32
KIBAALE,2023,1580,1450,3030,32
KIBAALE,2024,1670,1520,3190,32
KIBAALE,2025,1770,1600,3370,32
KIBOGA,2015,880,850,1730,32
KIBOGA,2016,910,880,1790,32
KIBOGA,2017,930,910,1840,32
KIBOGA,2018,970,950,1920,32
KIBOGA,2019,1010,980,1990,32
KIBOGA,2020,1040,1020,2060,32
KIBOGA,2021,1080,1080,2160,32
KIBOGA,2022,1120,1120,2240,32
KIBOGA,2023,1150,1170,2320,32
KIBOGA,2024,1190,1240,2430,32
KIBOGA,2025,1240,1270,2510,32
KIBUKU,2015,700,1010,1710,32
KIBUKU,2016,730,1070,1800,32
KIBUKU,2017,780,1120,1900,32
KIBUKU,2018,810,1180,1990,32
KIBUKU,2019,850,1250,2100,32
KIBUKU,2020,890,1320,2210,32
KIBUKU,2021,930,1410,2340,32
KIBUKU,2022,970,1490,2460,32
KIBUKU,2023,1010,1580,2590,32
KIBUKU,2024,1070,1660,2730,32
KIBUKU,2025,1130,1710,2840,32
KIKUUBE,2015,2100,1770,3870,32
KIKUUBE,2016,2210,1860,4070,32
KIKUUBE,2017,2330,1950,4280,32
KIKUUBE,2018,2450,2050,4500,32
KIKUUBE,2019,2580,2150,4730,32
KIKUUBE,2020,2710,2260,4970,32
KIKUUBE,2021,2850,2370,5220,32
KIKUUBE,2022,2990,2480,5470,32
KIKUUBE,2023,3140,2600,5740,32
KIKUUBE,2024,3300,2720,6020,32
KIKUUBE,2025,3450,2850,6300,32
KIRUHURA,2015,1120,1040,2160,32
KIRUHURA,2016,1160,1080,2240,32
KIRUHURA,2017,1200,1120,2320,32
KIRUHURA,2018,1250,1160,2410,32
KIRUHURA,2019,1290,1200,2490,32
KIRUHURA,2020,1340,1240,2580,32
KIRUHURA,2021,1390,1280,2670,32
KIRUHURA,2022,1440,1320,2760,32
KIRUHURA,2023,1490,1370,2860,32
KIRUHURA,2024,1540,1410,2950,32
KIRUHURA,2025,1590,1450,3040,32
KIRYANDONGO,2015,1510,1720,3230,32
KIRYANDONGO,2016,1570,1790,3360,32
KIRYANDONGO,2017,1620,1860,3480,32
KIRYANDONGO,2018,1700,1930,3630,32
KIRYANDONGO,2019,1760,2020,3780,32
KIRYANDONGO,2020,1830,2130,3960,32
KIRYANDONGO,2021,1890,2240,4130,32
KIRYANDONGO,2022,1960,2360,4320,32
KIRYANDONGO,2023,2040,2470,4510,32
KIRYANDONGO,2024,2130,2560,4690,32
KIRYANDONGO,2025,2230,2620,4850,32
KISORO,2015,1190,1950,3140,32
KISORO,2016,1220,2030,3250,32
KISORO,2017,1260,2090,3350,32
KISORO,2018,1300,2160,3460,32
KISORO,2019,1340,2240,3580,32
KISORO,2020,1370,2330,3700,32
KISORO,2021,1400,2440,3840,32
KISORO,2022,1440,2550,3990,32
KISORO,2023,1480,2660,4140,32
KISORO,2024,1530,2740,4270,32
KISORO,2025,1590,2790,4380,32
KITAGWENDA,2015,900,1050,1950,32
KITAGWENDA,2016,940,1090,2030,32
KITAGWENDA,2017,970,1130,2100,32
KITAGWENDA,2018,1010,1170,2180,32
KITAGWENDA,2019,1050,1210,2260,32
KITAGWENDA,2020,1100,1250,2350,32
KITAGWENDA,2021,1140,1290,2430,32
KITAGWENDA,2022,1180,1330,2510,32
KITAGWENDA,2023,1220,1370,2590,32
KITAGWENDA,2024,1270,1420,2690,32
KITAGWENDA,2025,1310,1460,2770,32
KITGUM,2015,1050,1260,2310,32
KITGUM,2016,1080,1310,2390,32
KITGUM,2017,1110,1340,2450,32
KITGUM,2018,1140,1380,2520,32
KITGUM,2019,1160,1430,2590,32
KITGUM,2020,1190,1480,2670,32
KITGUM,2021,1220,1540,2760,32
KITGUM,2022,1250,1610,2860,32
KITGUM,2023,1280,1670,2950,32
KITGUM,2024,1310,1700,3010,32
KITGUM,2025,1360,1730,3090,32
KOBOKO,2015,1080,1280,2360,32
KOBOKO,2016,1130,1350,2480,32
KOBOKO,2017,1190,1410,2600,32
KOBOKO,2018,1250,1490,2740,32
KOBOKO,2019,1310,1570,2880,32
KOBOKO,2020,1370,1670,3040,32
KOBOKO,2021,1440,1780,3220,32
KOBOKO,2022,1510,1890,3400,32
KOBOKO,2023,1580,2000,3580,32
KOBOKO,2024,1660,2100,3760,32
KOBOKO,2025,1760,2170,3930,32
KOLE,2015,1310,1450,2760,32
KOLE,2016,1350,1490,2840,32
KOLE,2017,1400,1530,2930,32
KOLE,2018,1440,1580,3020,32
KOLE,2019,1490,1620,3110,32
KOLE,2020,1530,1670,3200,32
KOLE,2021,1580,1710,3290,32
KOLE,2022,1630,1760,3390,32
KOLE,2023,1670,1800,3470,32
KOLE,2024,1720,1840,3560,32
KOLE,2025,1770,1890,3660,32
KOTIDO,2015,770,990,1760,32
KOTIDO,2016,790,1030,1820,32
KOTIDO,2017,810,1060,1870,32
KOTIDO,2018,850,1090,1940,32
KOTIDO,2019,870,1140,2010,32
KOTIDO,2020,900,1190,2090,32
KOTIDO,2021,930,1250,2180,32
KOTIDO,2022,960,1320,2280,32
KOTIDO,2023,990,1370,2360,32
KOTIDO,2024,1020,1410,2430,32
KOTIDO,2025,1060,1440,2500,32
KUMI,2015,1110,1330,2440,32
KUMI,2016,1150,1390,2540,32
KUMI,2017,1210,1450,2660,32
KUMI,2018,1250,1510,2760,32
KUMI,2019,1310,1580,2890,32
KUMI,2020,1360,1670,3030,32
KUMI,2021,1410,1750,3160,32
KUMI,2022,1460,1850,3310,32
KUMI,2023,1520,1950,3470,32
KUMI,2024,1590,2020,3610,32
KUMI,2025,1670,2070,3740,32
KWANIA,2015,1010,1150,2160,32
KWANIA,2016,1040,1180,2220,32
KWANIA,2017,1070,1210,2280,32
KWANIA,2018,1110,1250,2360,32
KWANIA,2019,1140,1280,2420,32
KWANIA,2020,1170,1320,2490,32
KWANIA,2021,1210,1350,2560,32
KWANIA,2022,1240,1390,2630,32
KWANIA,2023,1280,1420,2700,32
KWANIA,2024,1310,1460,2770,32
KWANIA,2025,1340,1490,2830,32
KWEEN,2015,580,530,1110,32
KWEEN,2016,600,550,1150,32
KWEEN,2017,620,560,1180,32
KWEEN,2018,640,570,1210,32
KWEEN,2019,660,590,1250,32
KWEEN,2020,680,600,1280,32
KWEEN,2021,700,620,1320,32
KWEEN,2022,720,630,1350,32
KWEEN,2023,740,640,1380,32
KWEEN,2024,760,660,1420,32
KWEEN,2025,770,670,1440,32
KYANKWANZI,2015,1760,1380,3140,32
KYANKWANZI,2016,1860,1450,3310,32
KYANKWANZI,2017,1950,1510,3460,32
KYANKWANZI,2018,2050,1580,3630,32
KYANKWANZI,2019,2150,1650,3800,32
KYANKWANZI,2020,2260,1730,3990,32
KYANKWANZI,2021,2370,1810,4180,32
KYANKWANZI,2022,2480,1890,4370,32
KYANKWANZI,2023,2600,1970,4570,32
KYANKWANZI,2024,2720,2050,4770,32
KYANKWANZI,2025,2850,2140,4990,32
KYEGEGWA,2015,1970,1990,3960,32
KYEGEGWA,2016,2130,2150,4280,32
KYEGEGWA,2017,2310,2320,4630,32
KYEGEGWA,2018,2500,2500,5000,32
KYEGEGWA,2019,2700,2690,5390,32
KYEGEGWA,2020,2920,2900,5820,32
KYEGEGWA,2021,3150,3130,6280,32
KYEGEGWA,2022,3400,3360,6760,32
KYEGEGWA,2023,3670,3620,7290,32
KYEGEGWA,2024,3950,3890,7840,32
KYEGEGWA,2025,4250,4180,8430,32
KYENJOJO,2015,2890,2790,5680,32
KYENJOJO,2016,3010,2900,5910,32
KYENJOJO,2017,3130,3000,6130,32
KYENJOJO,2018,3260,3110,6370,32
KYENJOJO,2019,3390,3220,6610,32
KYENJOJO,2020,3520,3340,6860,32
KYENJOJO,2021,3660,3450,7110,32
KYENJOJO,2022,3800,3570,7370,32
KYENJOJO,2023,3940,3690,7630,32
KYENJOJO,2024,4080,3810,7890,32
KYENJOJO,2025,4220,3930,8150,32
KYOTERA,2015,1350,1680,3030,32
KYOTERA,2016,1370,1720,3090,32
KYOTERA,2017,1410,1770,3180,32
KYOTERA,2018,1450,1810,3260,32
KYOTERA,2019,1480,1870,3350,32
KYOTERA,2020,1520,1940,3460,32
KYOTERA,2021,1550,2020,3570,32
KYOTERA,2022,1590,2100,3690,32
KYOTERA,2023,1620,2170,3790,32
KYOTERA,2024,1670,2220,3890,32
KYOTERA,2025,1740,2250,3990,32
KARENGA,2015,270,310,580,32
KARENGA,2016,280,320,600,32
KARENGA,2017,280,330,610,32
KARENGA,2018,290,340,630,32
KARENGA,2019,300,340,640,32
KARENGA,2020,310,350,660,32
KARENGA,2021,310,360,670,32
KARENGA,2022,320,370,690,32
KARENGA,2023,330,370,700,32
KARENGA,2024,340,380,720,32
KARENGA,2025,340,390,730,32
LAMWO,2015,660,880,1540,32
LAMWO,2016,670,900,1570,32
LAMWO,2017,690,920,1610,32
LAMWO,2018,690,960,1650,32
LAMWO,2019,710,980,1690,32
LAMWO,2020,720,1020,1740,32
LAMWO,2021,730,1060,1790,32
LAMWO,2022,740,1110,1850,32
LAMWO,2023,760,1150,1910,32
LAMWO,2024,770,1170,1940,32
LAMWO,2025,790,1190,1980,32
LIRA,2015,2690,2620,5310,32
LIRA,2016,2760,2690,5450,32
LIRA,2017,2840,2770,5610,32
LIRA,2018,2920,2850,5770,32
LIRA,2019,3000,2930,5930,32
LIRA,2020,3080,3010,6090,32
LIRA,2021,3160,3090,6250,32
LIRA,2022,3240,3170,6410,32
LIRA,2023,3320,3250,6570,32
LIRA,2024,3400,3330,6730,32
LIRA,2025,3470,3400,6870,32
LUUKA,2015,830,1240,2070,32
LUUKA,2016,850,1280,2130,32
LUUKA,2017,870,1320,2190,32
LUUKA,2018,900,1360,2260,32
LUUKA,2019,930,1420,2350,32
LUUKA,2020,950,1480,2430,32
LUUKA,2021,980,1540,2520,32
LUUKA,2022,1000,1610,2610,32
LUUKA,2023,1030,1680,2710,32
LUUKA,2024,1070,1730,2800,32
LUUKA,2025,1100,1760,2860,32
LUWERO,2015,2320,2680,5000,32
LUWERO,2016,2400,2780,5180,32
LUWERO,2017,2480,2880,5360,32
LUWERO,2018,2570,2990,5560,32
LUWERO,2019,2660,3100,5760,32
LUWERO,2020,2750,3250,6000,32
LUWERO,2021,2830,3400,6230,32
LUWERO,2022,2920,3570,6490,32
LUWERO,2023,3010,3730,6740,32
LUWERO,2024,3130,3850,6980,32
LUWERO,2025,3270,3930,7200,32
LWENGO,2015,1300,1690,2990,32
LWENGO,2016,1330,1730,3060,32
LWENGO,2017,1360,1760,3120,32
LWENGO,2018,1380,1800,3180,32
LWENGO,2019,1410,1850,3260,32
LWENGO,2020,1430,1910,3340,32
LWENGO,2021,1460,1980,3440,32
LWENGO,2022,1480,2040,3520,32
LWENGO,2023,1500,2110,3610,32
LWENGO,2024,1540,2140,3680,32
LWENGO,2025,1580,2160,3740,32
LYANTONDE,2015,500,580,1080,32
LYANTONDE,2016,530,610,1140,32
LYANTONDE,2017,540,640,1180,32
LYANTONDE,2018,570,660,1230,32
LYANTONDE,2019,590,690,1280,32
LYANTONDE,2020,620,720,1340,32
LYANTONDE,2021,640,740,1380,32
LYANTONDE,2022,660,790,1450,32
LYANTONDE,2023,690,830,1520,32
LYANTONDE,2024,700,870,1570,32
LYANTONDE,2025,730,920,1650,32
MANAFWA,2015,740,870,1610,32
MANAFWA,2016,750,890,1640,32
MANAFWA,2017,770,910,1680,32
MANAFWA,2018,790,930,1720,32
MANAFWA,2019,810,950,1760,32
MANAFWA,2020,830,970,1800,32
MANAFWA,2021,850,990,1840,32
MANAFWA,2022,870,1010,1880,32
MANAFWA,2023,890,1030,1920,32
MANAFWA,2024,910,1050,1960,32
MANAFWA,2025,920,1070,1990,32
MARACHA,2015,980,1360,2340,32
MARACHA,2016,1010,1390,2400,32
MARACHA,2017,1030,1420,2450,32
MARACHA,2018,1050,1440,2490,32
MARACHA,2019,1070,1470,2540,32
MARACHA,2020,1090,1490,2580,32
MARACHA,2021,1110,1520,2630,32
MARACHA,2022,1130,1550,2680,32
MARACHA,2023,1150,1570,2720,32
MARACHA,2024,1170,1600,2770,32
MARACHA,2025,1190,1620,2810,32
MASAKA,2015,1730,1970,3700,32
MASAKA,2016,1780,2040,3820,32
MASAKA,2017,1840,2110,3950,32
MASAKA,2018,1900,2180,4080,32
MASAKA,2019,1960,2260,4220,32
MASAKA,2020,2020,2370,4390,32
MASAKA,2021,2080,2470,4550,32
MASAKA,2022,2130,2590,4720,32
MASAKA,2023,2200,2690,4890,32
MASAKA,2024,2270,2770,5040,32
MASAKA,2025,2370,2830,5200,32
MASINDI,2015,2220,1870,4090,32
MASINDI,2016,2280,1920,4200,32
MASINDI,2017,2350,1970,4320,32
MASINDI,2018,2420,2030,4450,32
MASINDI,2019,2490,2080,4570,32
MASINDI,2020,2560,2130,4690,32
MASINDI,2021,2620,2180,4800,32
MASINDI,2022,2690,2240,4930,32
MASINDI,2023,2760,2290,5050,32
MASINDI,2024,2830,2340,5170,32
MASINDI,2025,2900,2390,5290,32
MAYUGE,2015,2030,2640,4670,32
MAYUGE,2016,2110,2760,4870,32
MAYUGE,2017,2200,2880,5080,32
MAYUGE,2018,2290,3010,5300,32
MAYUGE,2019,2380,3150,5530,32
MAYUGE,2020,2470,3320,5790,32
MAYUGE,2021,2570,3510,6080,32
MAYUGE,2022,2670,3720,6390,32
MAYUGE,2023,2770,3900,6670,32
MAYUGE,2024,2890,4060,6950,32
MAYUGE,2025,3040,4190,7230,32
MBALE,2015,2690,3290,5980,32
MBALE,2016,2790,3440,6230,32
MBALE,2017,2900,3600,6500,32
MBALE,2018,3020,3760,6780,32
MBALE,2019,3140,3970,7110,32
MBALE,2020,3260,4190,7450,32
MBALE,2021,3380,4440,7820,32
MBALE,2022,3500,4700,8200,32
MBALE,2023,3630,4950,8580,32
MBALE,2024,3790,5170,8960,32
MBALE,2025,3990,5330,9320,32
MBARARA,2015,2670,2680,5350,32
MBARARA,2016,2740,2730,5470,32
MBARARA,2017,2800,2790,5590,32
MBARARA,2018,2870,2850,5720,32
MBARARA,2019,2930,2910,5840,32
MBARARA,2020,2990,2970,5960,32
MBARARA,2021,3050,3030,6080,32
MBARARA,2022,3110,3090,6200,32
MBARARA,2023,3180,3140,6320,32
MBARARA,2024,3230,3190,6420,32
MBARARA,2025,3290,3250,6540,32
MITOOMA,2015,820,1200,2020,32
MITOOMA,2016,830,1210,2040,32
MITOOMA,2017,840,1220,2060,32
MITOOMA,2018,850,1240,2090,32
MITOOMA,2019,860,1240,2100,32
MITOOMA,2020,870,1250,2120,32
MITOOMA,2021,880,1260,2140,32
MITOOMA,2022,890,1270,2160,32
MITOOMA,2023,900,1280,2180,32
MITOOMA,2024,900,1290,2190,32
MITOOMA,2025,910,1290,2200,32
MITYANA,2015,1800,1870,3670,32
MITYANA,2016,1840,1920,3760,32
MITYANA,2017,1890,1970,3860,32
MITYANA,2018,1950,2030,3980,32
MITYANA,2019,2000,2100,4100,32
MITYANA,2020,2050,2180,4230,32
MITYANA,2021,2100,2270,4370,32
MITYANA,2022,2150,2370,4520,32
MITYANA,2023,2210,2460,4670,32
MITYANA,2024,2270,2520,4790,32
MITYANA,2025,2350,2560,4910,32
MOROTO,2015,540,500,1040,32
MOROTO,2016,560,520,1080,32
MOROTO,2017,570,540,1110,32
MOROTO,2018,600,560,1160,32
MOROTO,2019,610,580,1190,32
MOROTO,2020,630,610,1240,32
MOROTO,2021,650,640,1290,32
MOROTO,2022,670,670,1340,32
MOROTO,2023,690,710,1400,32
MOROTO,2024,720,730,1450,32
MOROTO,2025,740,750,1490,32
MOYO,2015,450,570,1020,32
MOYO,2016,460,590,1050,32
MOYO,2017,470,600,1070,32
MOYO,2018,480,610,1090,32
MOYO,2019,490,620,1110,32
MOYO,2020,500,640,1140,32
MOYO,2021,510,650,1160,32
MOYO,2022,530,660,1190,32
MOYO,2023,540,670,1210,32
MOYO,2024,550,680,1230,32
MOYO,2025,560,700,1260,32
MPIGI,2015,1280,1420,2700,32
MPIGI,2016,1320,1470,2790,32
MPIGI,2017,1370,1530,2900,32
MPIGI,2018,1410,1580,2990,32
MPIGI,2019,1450,1650,3100,32
MPIGI,2020,1500,1720,3220,32
MPIGI,2021,1550,1810,3360,32
MPIGI,2022,1590,1890,3480,32
MPIGI,2023,1640,1980,3620,32
MPIGI,2024,1710,2040,3750,32
MPIGI,2025,1780,2080,3860,32
MUBENDE,2015,2630,2790,5420,32
MUBENDE,2016,2790,2980,5770,32
MUBENDE,2017,2960,3170,6130,32
MUBENDE,2018,3160,3370,6530,32
MUBENDE,2019,3350,3610,6960,32
MUBENDE,2020,3560,3880,7440,32
MUBENDE,2021,3770,4190,7960,32
MUBENDE,2022,3990,4510,8500,32
MUBENDE,2023,4230,4840,9070,32
MUBENDE,2024,4510,5130,9640,32
MUBENDE,2025,4840,5380,10220,32
MUKONO,2015,3640,4090,7730,32
MUKONO,2016,3760,4260,8020,32
MUKONO,2017,3900,4440,8340,32
MUKONO,2018,4050,4630,8680,32
MUKONO,2019,4190,4850,9040,32
MUKONO,2020,4330,5100,9430,32
MUKONO,2021,4490,5390,9880,32
MUKONO,2022,4630,5690,10320,32
MUKONO,2023,4790,5970,10760,32
MUKONO,2024,4980,6200,11180,32
MUKONO,2025,5220,6380,11600,32
MADI OKOLLO,2015,880,1090,1970,32
MADI OKOLLO,2016,900,1120,2020,32
MADI OKOLLO,2017,930,1150,2080,32
MADI OKOLLO,2018,960,1180,2140,32
MADI OKOLLO,2019,990,1210,2200,32
MADI OKOLLO,2020,1010,1240,2250,32
MADI OKOLLO,2021,1040,1270,2310,32
MADI OKOLLO,2022,1070,1310,2380,32
MADI OKOLLO,2023,1100,1330,2430,32
MADI OKOLLO,2024,1120,1360,2480,32
MADI OKOLLO,2025,1150,1400,2550,32
NABILATUK,2015,230,310,540,32
NABILATUK,2016,240,340,580,32
NABILATUK,2017,250,350,600,32
NABILATUK,2018,270,370,640,32
NABILATUK,2019,280,390,670,32
NABILATUK,2020,300,420,720,32
NABILATUK,2021,320,450,770,32
NABILATUK,2022,330,490,820,32
NABILATUK,2023,360,520,880,32
NABILATUK,2024,380,550,930,32
NABILATUK,2025,410,570,980,32
NAKAPIRIPIRIT,2015,440,520,960,32
NAKAPIRIPIRIT,2016,460,560,1020,32
NAKAPIRIPIRIT,2017,480,580,1060,32
NAKAPIRIPIRIT,2018,510,620,1130,32
NAKAPIRIPIRIT,2019,540,660,1200,32
NAKAPIRIPIRIT,2020,570,700,1270,32
NAKAPIRIPIRIT,2021,590,750,1340,32
NAKAPIRIPIRIT,2022,620,800,1420,32
NAKAPIRIPIRIT,2023,660,860,1520,32
NAKAPIRIPIRIT,2024,700,900,1600,32
NAKAPIRIPIRIT,2025,740,940,1680,32
NAKASEKE,2015,1600,1140,2740,32
NAKASEKE,2016,1660,1170,2830,32
NAKASEKE,2017,1720,1190,2910,32
NAKASEKE,2018,1780,1220,3000,32
NAKASEKE,2019,1840,1250,3090,32
NAKASEKE,2020,1910,1280,3190,32
NAKASEKE,2021,1970,1310,3280,32
NAKASEKE,2022,2040,1330,3370,32
NAKASEKE,2023,2110,1360,3470,32
NAKASEKE,2024,2170,1390,3560,32
NAKASEKE,2025,2240,1420,3660,32
NAKASONGOLA,2015,1150,1050,2200,32
NAKASONGOLA,2016,1190,1100,2290,32
NAKASONGOLA,2017,1250,1150,2400,32
NAKASONGOLA,2018,1300,1190,2490,32
NAKASONGOLA,2019,1350,1250,2600,32
NAKASONGOLA,2020,1410,1310,2720,32
NAKASONGOLA,2021,1470,1370,2840,32
NAKASONGOLA,2022,1520,1450,2970,32
NAKASONGOLA,2023,1580,1510,3090,32
NAKASONGOLA,2024,1650,1570,3220,32
NAKASONGOLA,2025,1740,1620,3360,32
NAMAYINGO,2015,1200,1400,2600,32
NAMAYINGO,2016,1220,1450,2670,32
NAMAYINGO,2017,1260,1490,2750,32
NAMAYINGO,2018,1300,1530,2830,32
NAMAYINGO,2019,1330,1580,2910,32
NAMAYINGO,2020,1370,1640,3010,32
NAMAYINGO,2021,1400,1700,3100,32
NAMAYINGO,2022,1430,1770,3200,32
NAMAYINGO,2023,1470,1830,3300,32
NAMAYINGO,2024,1520,1880,3400,32
NAMAYINGO,2025,1570,1910,3480,32
NAMISINDWA,2015,1040,1190,2230,32
NAMISINDWA,2016,1070,1220,2290,32
NAMISINDWA,2017,1100,1250,2350,32
NAMISINDWA,2018,1120,1280,2400,32
NAMISINDWA,2019,1160,1310,2470,32
NAMISINDWA,2020,1190,1330,2520,32
NAMISINDWA,2021,1220,1360,2580,32
NAMISINDWA,2022,1250,1390,2640,32
NAMISINDWA,2023,1280,1420,2700,32
NAMISINDWA,2024,1310,1450,2760,32
NAMISINDWA,2025,1340,1480,2820,32
NAMUTUMBA,2015,910,1200,2110,32
NAMUTUMBA,2016,950,1260,2210,32
NAMUTUMBA,2017,990,1310,2300,32
NAMUTUMBA,2018,1040,1370,2410,32
NAMUTUMBA,2019,1080,1450,2530,32
NAMUTUMBA,2020,1130,1520,2650,32
NAMUTUMBA,2021,1170,1620,2790,32
NAMUTUMBA,2022,1220,1710,2930,32
NAMUTUMBA,2023,1270,1800,3070,32
NAMUTUMBA,2024,1340,1870,3210,32
NAMUTUMBA,2025,1410,1930,3340,32
NAPAK,2015,550,830,1380,32
NAPAK,2016,560,860,1420,32
NAPAK,2017,570,890,1460,32
NAPAK,2018,600,920,1520,32
NAPAK,2019,610,950,1560,32
NAPAK,2020,620,1000,1620,32
NAPAK,2021,640,1050,1690,32
NAPAK,2022,650,1090,1740,32
NAPAK,2023,670,1130,1800,32
NAPAK,2024,690,1170,1860,32
NAPAK,2025,700,1190,1890,32
NEBBI,2015,1280,1630,2910,32
NEBBI,2016,1320,1680,3000,32
NEBBI,2017,1360,1730,3090,32
NEBBI,2018,1410,1780,3190,32
NEBBI,2019,1450,1830,3280,32
NEBBI,2020,1490,1880,3370,32
NEBBI,2021,1540,1920,3460,32
NEBBI,2022,1580,1970,3550,32
NEBBI,2023,1630,2020,3650,32
NEBBI,2024,1670,2070,3740,32
NEBBI,2025,1710,2120,3830,32
NGORA,2015,610,610,1220,32
NGORA,2016,630,620,1250,32
NGORA,2017,650,650,1300,32
NGORA,2018,680,680,1360,32
NGORA,2019,700,700,1400,32
NGORA,2020,720,740,1460,32
NGORA,2021,750,780,1530,32
NGORA,2022,770,830,1600,32
NGORA,2023,800,860,1660,32
NGORA,2024,840,890,1730,32
NGORA,2025,880,920,1800,32
NTOROKO,2015,470,460,930,32
NTOROKO,2016,480,470,950,32
NTOROKO,2017,500,490,990,32
NTOROKO,2018,510,500,1010,32
NTOROKO,2019,540,520,1060,32
NTOROKO,2020,550,550,1100,32
NTOROKO,2021,560,570,1130,32
NTOROKO,2022,590,600,1190,32
NTOROKO,2023,600,620,1220,32
NTOROKO,2024,630,630,1260,32
NTOROKO,2025,650,640,1290,32
NTUNGAMO,2015,2670,3290,5960,32
NTUNGAMO,2016,2720,3350,6070,32
NTUNGAMO,2017,2780,3410,6190,32
NTUNGAMO,2018,2840,3480,6320,32
NTUNGAMO,2019,2900,3540,6440,32
NTUNGAMO,2020,2960,3600,6560,32
NTUNGAMO,2021,3010,3660,6670,32
NTUNGAMO,2022,3070,3710,6780,32
NTUNGAMO,2023,3120,3770,6890,32
NTUNGAMO,2024,3180,3830,7010,32
NTUNGAMO,2025,3230,3880,7110,32
NWOYA,2015,800,850,1650,32
NWOYA,2016,890,940,1830,32
NWOYA,2017,980,1030,2010,32
NWOYA,2018,1080,1140,2220,32
NWOYA,2019,1200,1250,2450,32
NWOYA,2020,1320,1380,2700,32
NWOYA,2021,1450,1520,2970,32
NWOYA,2022,1600,1670,3270,32
NWOYA,2023,1760,1830,3590,32
NWOYA,2024,1940,2010,3950,32
NWOYA,2025,2130,2200,4330,32
OBONGI,2015,220,240,460,32
OBONGI,2016,230,250,480,32
OBONGI,2017,230,250,480,32
OBONGI,2018,240,270,510,32
OBONGI,2019,250,270,520,32
OBONGI,2020,260,290,550,32
OBONGI,2021,270,310,580,32
OBONGI,2022,270,320,590,32
OBONGI,2023,280,330,610,32
OBONGI,2024,300,340,640,32
OBONGI,2025,300,350,650,32
OMORO,2015,850,1030,1880,32
OMORO,2016,880,1090,1970,32
OMORO,2017,920,1140,2060,32
OMORO,2018,960,1190,2150,32
OMORO,2019,1000,1260,2260,32
OMORO,2020,1040,1330,2370,32
OMORO,2021,1090,1410,2500,32
OMORO,2022,1130,1490,2620,32
OMORO,2023,1180,1580,2760,32
OMORO,2024,1240,1650,2890,32
OMORO,2025,1310,1700,3010,32
OTUKE,2015,600,610,1210,32
OTUKE,2016,630,630,1260,32
OTUKE,2017,660,660,1320,32
OTUKE,2018,690,690,1380,32
OTUKE,2019,720,720,1440,32
OTUKE,2020,750,750,1500,32
OTUKE,2021,780,770,1550,32
OTUKE,2022,810,810,1620,32
OTUKE,2023,850,840,1690,32
OTUKE,2024,880,870,1750,32
OTUKE,2025,910,900,1810,32
OYAM,2015,2250,2460,4710,32
OYAM,2016,2320,2530,4850,32
OYAM,2017,2390,2600,4990,32
OYAM,2018,2460,2680,5140,32
OYAM,2019,2540,2750,5290,32
OYAM,2020,2610,2830,5440,32
OYAM,2021,2680,2910,5590,32
OYAM,2022,2760,2980,5740,32
OYAM,2023,2830,3060,5890,32
OYAM,2024,2910,3140,6050,32
OYAM,2025,2980,3220,6200,32
PADER,2015,950,1150,2100,32
PADER,2016,970,1190,2160,32
PADER,2017,1000,1230,2230,32
PADER,2018,1030,1260,2290,32
PADER,2019,1050,1320,2370,32
PADER,2020,1080,1370,2450,32
PADER,2021,1110,1430,2540,32
PADER,2022,1130,1490,2620,32
PADER,2023,1150,1560,2710,32
PADER,2024,1190,1600,2790,32
PADER,2025,1230,1630,2860,32
PAKWACH,2015,940,1160,2100,32
PAKWACH,2016,980,1200,2180,32
PAKWACH,2017,1020,1240,2260,32
PAKWACH,2018,1060,1290,2350,32
PAKWACH,2019,1110,1330,2440,32
PAKWACH,2020,1150,1380,2530,32
PAKWACH,2021,1200,1430,2630,32
PAKWACH,2022,1240,1480,2720,32
PAKWACH,2023,1290,1530,2820,32
PAKWACH,2024,1340,1570,2910,32
PAKWACH,2025,1390,1630,3020,32
PALLISA,2015,1090,1320,2410,32
PALLISA,2016,1150,1390,2540,32
PALLISA,2017,1210,1470,2680,32
PALLISA,2018,1280,1550,2830,32
PALLISA,2019,1350,1650,3000,32
PALLISA,2020,1420,1760,3180,32
PALLISA,2021,1500,1880,3380,32
PALLISA,2022,1570,2010,3580,32
PALLISA,2023,1650,2150,3800,32
PALLISA,2024,1750,2260,4010,32
PALLISA,2025,1870,2350,4220,32
RAKAI,2015,1440,1800,3240,32
RAKAI,2016,1480,1870,3350,32
RAKAI,2017,1530,1940,3470,32
RAKAI,2018,1590,2000,3590,32
RAKAI,2019,1640,2090,3730,32
RAKAI,2020,1700,2180,3880,32
RAKAI,2021,1740,2290,4030,32
RAKAI,2022,1800,2400,4200,32
RAKAI,2023,1860,2500,4360,32
RAKAI,2024,1940,2580,4520,32
RAKAI,2025,2020,2650,4670,32
RUBANDA,2015,1140,1420,2560,32
RUBANDA,2016,1160,1440,2600,32
RUBANDA,2017,1170,1450,2620,32
RUBANDA,2018,1190,1460,2650,32
RUBANDA,2019,1200,1470,2670,32
RUBANDA,2020,1220,1480,2700,32
RUBANDA,2021,1230,1490,2720,32
RUBANDA,2022,1240,1500,2740,32
RUBANDA,2023,1260,1500,2760,32
RUBANDA,2024,1270,1510,2780,32
RUBANDA,2025,1280,1510,2790,32
RUBIRIZI,2015,710,960,1670,32
RUBIRIZI,2016,730,980,1710,32
RUBIRIZI,2017,740,1000,1740,32
RUBIRIZI,2018,760,1020,1780,32
RUBIRIZI,2019,770,1040,1810,32
RUBIRIZI,2020,790,1060,1850,32
RUBIRIZI,2021,800,1070,1870,32
RUBIRIZI,2022,820,1090,1910,32
RUBIRIZI,2023,830,1110,1940,32
RUBIRIZI,2024,840,1130,1970,32
RUBIRIZI,2025,860,1140,2000,32
RUKIGA,2015,570,660,1230,32
RUKIGA,2016,580,670,1250,32
RUKIGA,2017,590,670,1260,32
RUKIGA,2018,590,680,1270,32
RUKIGA,2019,600,680,1280,32
RUKIGA,2020,600,690,1290,32
RUKIGA,2021,610,690,1300,32
RUKIGA,2022,610,690,1300,32
RUKIGA,2023,620,700,1320,32
RUKIGA,2024,620,700,1320,32
RUKIGA,2025,620,700,1320,32
RUKUNGIRI,2015,1600,2110,3710,32
RUKUNGIRI,2016,1620,2130,3750,32
RUKUNGIRI,2017,1640,2160,3800,32
RUKUNGIRI,2018,1660,2180,3840,32
RUKUNGIRI,2019,1680,2190,3870,32
RUKUNGIRI,2020,1690,2210,3900,32
RUKUNGIRI,2021,1710,2230,3940,32
RUKUNGIRI,2022,1730,2250,3980,32
RUKUNGIRI,2023,1740,2260,4000,32
RUKUNGIRI,2024,1750,2270,4020,32
RUKUNGIRI,2025,1770,2280,4050,32
RWAMPARA,2015,740,810,1550,32
RWAMPARA,2016,760,830,1590,32
RWAMPARA,2017,770,840,1610,32
RWAMPARA,2018,790,860,1650,32
RWAMPARA,2019,810,880,1690,32
RWAMPARA,2020,820,900,1720,32
RWAMPARA,2021,840,910,1750,32
RWAMPARA,2022,860,930,1790,32
RWAMPARA,2023,870,950,1820,32
RWAMPARA,2024,890,970,1860,32
RWAMPARA,2025,910,980,1890,32
SERERE,2015,1210,1370,2580,32
SERERE,2016,1270,1450,2720,32
SERERE,2017,1340,1530,2870,32
SERERE,2018,1410,1610,3020,32
SERERE,2019,1470,1710,3180,32
SERERE,2020,1550,1810,3360,32
SERERE,2021,1620,1930,3550,32
SERERE,2022,1690,2050,3740,32
SERERE,2023,1770,2180,3950,32
SERERE,2024,1870,2290,4160,32
SERERE,2025,1990,2380,4370,32
SHEEMA,2015,1100,1380,2480,32
SHEEMA,2016,1120,1390,2510,32
SHEEMA,2017,1130,1410,2540,32
SHEEMA,2018,1140,1420,2560,32
SHEEMA,2019,1160,1430,2590,32
SHEEMA,2020,1170,1450,2620,32
SHEEMA,2021,1180,1460,2640,32
SHEEMA,2022,1190,1470,2660,32
SHEEMA,2023,1200,1480,2680,32
SHEEMA,2024,1210,1490,2700,32
SHEEMA,2025,1220,1500,2720,32
SIRONKO,2015,1210,1290,2500,32
SIRONKO,2016,1240,1310,2550,32
SIRONKO,2017,1270,1340,2610,32
SIRONKO,2018,1300,1370,2670,32
SIRONKO,2019,1330,1390,2720,32
SIRONKO,2020,1360,1420,2780,32
SIRONKO,2021,1390,1440,2830,32
SIRONKO,2022,1420,1470,2890,32
SIRONKO,2023,1440,1500,2940,32
SIRONKO,2024,1470,1520,2990,32
SIRONKO,2025,1500,1540,3040,32
SOROTI,2015,1500,1610,3110,32
SOROTI,2016,1560,1690,3250,32
SOROTI,2017,1630,1770,3400,32
SOROTI,2018,1700,1850,3550,32
SOROTI,2019,1780,1960,3740,32
SOROTI,2020,1860,2070,3930,32
SOROTI,2021,1940,2200,4140,32
SOROTI,2022,2030,2330,4360,32
SOROTI,2023,2110,2460,4570,32
SOROTI,2024,2220,2570,4790,32
SOROTI,2025,2340,2660,5000,32
SSEMBABULE,2015,1290,1570,2860,32
SSEMBABULE,2016,1330,1630,2960,32
SSEMBABULE,2017,1380,1700,3080,32
SSEMBABULE,2018,1430,1770,3200,32
SSEMBABULE,2019,1490,1850,3340,32
SSEMBABULE,2020,1550,1940,3490,32
SSEMBABULE,2021,1600,2040,3640,32
SSEMBABULE,2022,1650,2150,3800,32
SSEMBABULE,2023,1720,2260,3980,32
SSEMBABULE,2024,1790,2330,4120,32
SSEMBABULE,2025,1880,2400,4280,32
TORORO,2015,2400,2970,5370,32
TORORO,2016,2460,3040,5500,32
TORORO,2017,2530,3120,5650,32
TORORO,2018,2590,3200,5790,32
TORORO,2019,2660,3270,5930,32
TORORO,2020,2730,3350,6080,32
TORORO,2021,2790,3430,6220,32
TORORO,2022,2860,3500,6360,32
TORORO,2023,2920,3580,6500,32
TORORO,2024,2990,3650,6640,32
TORORO,2025,3050,3730,6780,32
WAKISO,2015,17930,17830,35760,32
WAKISO,2016,19130,19040,38170,32
WAKISO,2017,20410,20350,40760,32
WAKISO,2018,21770,21730,43500,32
WAKISO,2019,23210,23190,46400,32
WAKISO,2020,24720,24730,49450,32
WAKISO,2021,26310,26370,52680,32
WAKISO,2022,28000,28110,56110,32
WAKISO,2023,29780,29920,59700,32
WAKISO,2024,31630,31820,63450,32
WAKISO,2025,33580,33840,67420,32
YUMBE,2015,1910,2560,4470,32
YUMBE,2016,2030,2750,4780,32
YUMBE,2017,2150,2950,5100,32
YUMBE,2018,2280,3160,5440,32
YUMBE,2019,2420,3400,5820,32
YUMBE,2020,2570,3690,6260,32
YUMBE,2021,2710,4010,6720,32
YUMBE,2022,2860,4360,7220,32
YUMBE,2023,3030,4700,7730,32
YUMBE,2024,3240,5030,8270,32
YUMBE,2025,3470,5330,8800,32
ZOMBO,2015,1390,1640,3030,32
ZOMBO,2016,1430,1690,3120,32
ZOMBO,2017,1470,1740,3210,32
ZOMBO,2018,1520,1790,3310,32
ZOMBO,2019,1560,1830,3390,32
ZOMBO,2020,1610,1880,3490,32
ZOMBO,2021,1650,1930,3580,32
ZOMBO,2022,1700,1980,3680,32
ZOMBO,2023,1750,2030,3780,32
ZOMBO,2024,1790,2080,3870,32
ZOMBO,2025,1840,2120,3960,32
BUTALEJA,2015,1010,1350,2360,32
BUTALEJA,2016,1060,1430,2490,32
BUTALEJA,2017,1100,1500,2600,32
BUTALEJA,2018,1160,1560,2720,32
BUTALEJA,2019,1220,1650,2870,32
BUTALEJA,2020,1280,1730,3010,32
BUTALEJA,2021,1330,1840,3170,32
BUTALEJA,2022,1390,1940,3330,32
BUTALEJA,2023,1450,2060,3510,32
BUTALEJA,2024,1520,2180,3700,32
BUTALEJA,2025,1590,2270,3860,32
ABIM,2015,540,660,1200,33
ABIM,2016,580,710,1290,33
ABIM,2017,610,760,1370,33
ABIM,2018,660,810,1470,33
ABIM,2019,720,890,1610,33
ABIM,2020,770,950,1720,33
ABIM,2021,830,1030,1860,33
ABIM,2022,880,1120,2000,33
ABIM,2023,940,1220,2160,33
ABIM,2024,1010,1330,2340,33
ABIM,2025,1100,1420,2520,33
ADJUMANI,2015,640,900,1540,33
ADJUMANI,2016,650,910,1560,33
ADJUMANI,2017,650,910,1560,33
ADJUMANI,2018,660,920,1580,33
ADJUMANI,2019,660,930,1590,33
ADJUMANI,2020,660,940,1600,33
ADJUMANI,2021,670,950,1620,33
ADJUMANI,2022,670,950,1620,33
ADJUMANI,2023,670,960,1630,33
ADJUMANI,2024,680,970,1650,33
ADJUMANI,2025,680,970,1650,33
AGAGO,2015,700,1080,1780,33
AGAGO,2016,710,1100,1810,33
AGAGO,2017,720,1120,1840,33
AGAGO,2018,730,1140,1870,33
AGAGO,2019,740,1150,1890,33
AGAGO,2020,760,1170,1930,33
AGAGO,2021,770,1190,1960,33
AGAGO,2022,780,1210,1990,33
AGAGO,2023,790,1230,2020,33
AGAGO,2024,800,1240,2040,33
AGAGO,2025,810,1260,2070,33
ALEBTONG,2015,920,1120,2040,33
ALEBTONG,2016,960,1190,2150,33
ALEBTONG,2017,990,1230,2220,33
ALEBTONG,2018,1020,1280,2300,33
ALEBTONG,2019,1060,1330,2390,33
ALEBTONG,2020,1100,1390,2490,33
ALEBTONG,2021,1140,1460,2600,33
ALEBTONG,2022,1180,1530,2710,33
ALEBTONG,2023,1230,1610,2840,33
ALEBTONG,2024,1270,1680,2950,33
ALEBTONG,2025,1310,1740,3050,33
AMOLATAR,2015,660,750,1410,33
AMOLATAR,2016,680,790,1470,33
AMOLATAR,2017,700,820,1520,33
AMOLATAR,2018,730,840,1570,33
AMOLATAR,2019,750,870,1620,33
AMOLATAR,2020,790,920,1710,33
AMOLATAR,2021,810,960,1770,33
AMOLATAR,2022,830,1000,1830,33
AMOLATAR,2023,860,1050,1910,33
AMOLATAR,2024,900,1110,2010,33
AMOLATAR,2025,930,1140,2070,33
AMUDAT,2015,480,490,970,33
AMUDAT,2016,500,530,1030,33
AMUDAT,2017,520,560,1080,33
AMUDAT,2018,560,590,1150,33
AMUDAT,2019,580,630,1210,33
AMUDAT,2020,610,660,1270,33
AMUDAT,2021,640,710,1350,33
AMUDAT,2022,670,770,1440,33
AMUDAT,2023,690,820,1510,33
AMUDAT,2024,730,880,1610,33
AMUDAT,2025,760,930,1690,33
AMURIA,2015,820,990,1810,33
AMURIA,2016,850,1050,1900,33
AMURIA,2017,900,1090,1990,33
AMURIA,2018,940,1140,2080,33
AMURIA,2019,980,1200,2180,33
AMURIA,2020,1020,1260,2280,33
AMURIA,2021,1080,1340,2420,33
AMURIA,2022,1120,1410,2530,33
AMURIA,2023,1180,1500,2680,33
AMURIA,2024,1220,1590,2810,33
AMURIA,2025,1290,1650,2940,33
AMURU,2015,760,930,1690,33
AMURU,2016,780,960,1740,33
AMURU,2017,800,1000,1800,33
AMURU,2018,830,1050,1880,33
AMURU,2019,860,1080,1940,33
AMURU,2020,900,1130,2030,33
AMURU,2021,920,1190,2110,33
AMURU,2022,940,1260,2200,33
AMURU,2023,980,1310,2290,33
AMURU,2024,1010,1380,2390,33
AMURU,2025,1060,1440,2500,33
APAC,2015,610,700,1310,33
APAC,2016,630,720,1350,33
APAC,2017,660,750,1410,33
APAC,2018,680,770,1450,33
APAC,2019,700,800,1500,33
APAC,2020,730,820,1550,33
APAC,2021,750,850,1600,33
APAC,2022,780,880,1660,33
APAC,2023,810,910,1720,33
APAC,2024,830,930,1760,33
APAC,2025,860,960,1820,33
ARUA,2015,2060,2550,4610,33
ARUA,2016,2120,2620,4740,33
ARUA,2017,2180,2690,4870,33
ARUA,2018,2240,2760,5000,33
ARUA,2019,2310,2830,5140,33
ARUA,2020,2370,2900,5270,33
ARUA,2021,2430,2980,5410,33
ARUA,2022,2500,3050,5550,33
ARUA,2023,2560,3120,5680,33
ARUA,2024,2620,3200,5820,33
ARUA,2025,2680,3270,5950,33
BUDAKA,2015,800,1060,1860,33
BUDAKA,2016,840,1110,1950,33
BUDAKA,2017,870,1170,2040,33
BUDAKA,2018,930,1220,2150,33
BUDAKA,2019,970,1280,2250,33
BUDAKA,2020,1010,1340,2350,33
BUDAKA,2021,1050,1420,2470,33
BUDAKA,2022,1090,1510,2600,33
BUDAKA,2023,1150,1590,2740,33
BUDAKA,2024,1190,1680,2870,33
BUDAKA,2025,1240,1760,3000,33
BUDUDA,2015,970,880,1850,33
BUDUDA,2016,1020,940,1960,33
BUDUDA,2017,1070,1000,2070,33
BUDUDA,2018,1130,1050,2180,33
BUDUDA,2019,1190,1110,2300,33
BUDUDA,2020,1260,1180,2440,33
BUDUDA,2021,1320,1260,2580,33
BUDUDA,2022,1390,1360,2750,33
BUDUDA,2023,1470,1450,2920,33
BUDUDA,2024,1530,1540,3070,33
BUDUDA,2025,1630,1640,3270,33
BUGIRI,2015,1500,1920,3420,33
BUGIRI,2016,1570,2020,3590,33
BUGIRI,2017,1650,2130,3780,33
BUGIRI,2018,1730,2230,3960,33
BUGIRI,2019,1830,2360,4190,33
BUGIRI,2020,1910,2490,4400,33
BUGIRI,2021,2000,2650,4650,33
BUGIRI,2022,2100,2820,4920,33
BUGIRI,2023,2190,3010,5200,33
BUGIRI,2024,2300,3190,5490,33
BUGIRI,2025,2420,3340,5760,33
BUGWERI,2015,450,750,1200,33
BUGWERI,2016,470,780,1250,33
BUGWERI,2017,490,820,1310,33
BUGWERI,2018,510,840,1350,33
BUGWERI,2019,530,870,1400,33
BUGWERI,2020,550,900,1450,33
BUGWERI,2021,570,960,1530,33
BUGWERI,2022,590,1000,1590,33
BUGWERI,2023,600,1050,1650,33
BUGWERI,2024,620,1110,1730,33
BUGWERI,2025,650,1140,1790,33
BUHWEJU,2015,460,550,1010,33
BUHWEJU,2016,470,570,1040,33
BUHWEJU,2017,490,580,1070,33
BUHWEJU,2018,500,600,1100,33
BUHWEJU,2019,520,620,1140,33
BUHWEJU,2020,530,640,1170,33
BUHWEJU,2021,550,650,1200,33
BUHWEJU,2022,570,670,1240,33
BUHWEJU,2023,580,690,1270,33
BUHWEJU,2024,600,710,1310,33
BUHWEJU,2025,610,730,1340,33
BUIKWE,2015,1980,2100,4080,33
BUIKWE,2016,2040,2170,4210,33
BUIKWE,2017,2100,2240,4340,33
BUIKWE,2018,2150,2310,4460,33
BUIKWE,2019,2220,2390,4610,33
BUIKWE,2020,2280,2490,4770,33
BUIKWE,2021,2350,2600,4950,33
BUIKWE,2022,2400,2700,5100,33
BUIKWE,2023,2470,2830,5300,33
BUIKWE,2024,2530,2950,5480,33
BUIKWE,2025,2620,3030,5650,33
BUKEDEA,2015,910,1150,2060,33
BUKEDEA,2016,960,1220,2180,33
BUKEDEA,2017,990,1280,2270,33
BUKEDEA,2018,1050,1340,2390,33
BUKEDEA,2019,1110,1430,2540,33
BUKEDEA,2020,1170,1500,2670,33
BUKEDEA,2021,1240,1600,2840,33
BUKEDEA,2022,1300,1720,3020,33
BUKEDEA,2023,1360,1820,3180,33
BUKEDEA,2024,1440,1930,3370,33
BUKEDEA,2025,1510,2030,3540,33
BUKOMANSIMBI,2015,650,820,1470,33
BUKOMANSIMBI,2016,650,850,1500,33
BUKOMANSIMBI,2017,660,860,1520,33
BUKOMANSIMBI,2018,680,880,1560,33
BUKOMANSIMBI,2019,690,890,1580,33
BUKOMANSIMBI,2020,690,900,1590,33
BUKOMANSIMBI,2021,710,940,1650,33
BUKOMANSIMBI,2022,720,970,1690,33
BUKOMANSIMBI,2023,730,1000,1730,33
BUKOMANSIMBI,2024,730,1020,1750,33
BUKOMANSIMBI,2025,750,1040,1790,33
BUKWO,2015,360,380,740,33
BUKWO,2016,370,400,770,33
BUKWO,2017,400,420,820,33
BUKWO,2018,420,440,860,33
BUKWO,2019,440,460,900,33
BUKWO,2020,460,480,940,33
BUKWO,2021,480,510,990,33
BUKWO,2022,510,530,1040,33
BUKWO,2023,530,550,1080,33
BUKWO,2024,560,580,1140,33
BUKWO,2025,590,600,1190,33
BULAMBULI,2015,790,870,1660,33
BULAMBULI,2016,840,930,1770,33
BULAMBULI,2017,890,990,1880,33
BULAMBULI,2018,940,1050,1990,33
BULAMBULI,2019,1000,1110,2110,33
BULAMBULI,2020,1060,1180,2240,33
BULAMBULI,2021,1110,1270,2380,33
BULAMBULI,2022,1170,1360,2530,33
BULAMBULI,2023,1240,1470,2710,33
BULAMBULI,2024,1310,1580,2890,33
BULAMBULI,2025,1390,1670,3060,33
BULIISA,2015,400,410,810,33
BULIISA,2016,420,430,850,33
BULIISA,2017,440,450,890,33
BULIISA,2018,470,470,940,33
BULIISA,2019,490,490,980,33
BULIISA,2020,520,510,1030,33
BULIISA,2021,550,530,1080,33
BULIISA,2022,570,550,1120,33
BULIISA,2023,600,570,1170,33
BULIISA,2024,630,600,1230,33
BULIISA,2025,660,620,1280,33
BUNDIBUGYO,2015,1060,1260,2320,33
BUNDIBUGYO,2016,1090,1310,2400,33
BUNDIBUGYO,2017,1130,1360,2490,33
BUNDIBUGYO,2018,1170,1420,2590,33
BUNDIBUGYO,2019,1230,1470,2700,33
BUNDIBUGYO,2020,1280,1530,2810,33
BUNDIBUGYO,2021,1320,1620,2940,33
BUNDIBUGYO,2022,1380,1700,3080,33
BUNDIBUGYO,2023,1420,1800,3220,33
BUNDIBUGYO,2024,1470,1880,3350,33
BUNDIBUGYO,2025,1540,1940,3480,33
BUNYANGABU,2015,910,1000,1910,33
BUNYANGABU,2016,940,1050,1990,33
BUNYANGABU,2017,960,1080,2040,33
BUNYANGABU,2018,1000,1130,2130,33
BUNYANGABU,2019,1050,1160,2210,33
BUNYANGABU,2020,1070,1210,2280,33
BUNYANGABU,2021,1110,1260,2370,33
BUNYANGABU,2022,1150,1330,2480,33
BUNYANGABU,2023,1180,1380,2560,33
BUNYANGABU,2024,1220,1450,2670,33
BUNYANGABU,2025,1280,1490,2770,33
BUSHENYI,2015,860,1000,1860,33
BUSHENYI,2016,870,1010,1880,33
BUSHENYI,2017,880,1020,1900,33
BUSHENYI,2018,890,1030,1920,33
BUSHENYI,2019,900,1040,1940,33
BUSHENYI,2020,910,1040,1950,33
BUSHENYI,2021,920,1050,1970,33
BUSHENYI,2022,930,1060,1990,33
BUSHENYI,2023,940,1060,2000,33
BUSHENYI,2024,950,1070,2020,33
BUSHENYI,2025,950,1070,2020,33
BUSIA,2015,1540,1780,3320,33
BUSIA,2016,1600,1870,3470,33
BUSIA,2017,1670,1940,3610,33
BUSIA,2018,1730,2030,3760,33
BUSIA,2019,1810,2110,3920,33
BUSIA,2020,1870,2210,4080,33
BUSIA,2021,1950,2330,4280,33
BUSIA,2022,2030,2450,4480,33
BUSIA,2023,2100,2590,4690,33
BUSIA,2024,2190,2700,4890,33
BUSIA,2025,2290,2820,5110,33
BUTALEJA,2015,830,1160,1990,33
BUTALEJA,2016,880,1230,2110,33
BUTALEJA,2017,930,1310,2240,33
BUTALEJA,2018,980,1380,2360,33
BUTALEJA,2019,1030,1460,2490,33
BUTALEJA,2020,1100,1530,2630,33
BUTALEJA,2021,1150,1620,2770,33
BUTALEJA,2022,1220,1740,2960,33
BUTALEJA,2023,1280,1850,3130,33
BUTALEJA,2024,1350,1970,3320,33
BUTALEJA,2025,1410,2100,3510,33
BUTAMBALA,2015,380,420,800,33
BUTAMBALA,2016,400,430,830,33
BUTAMBALA,2017,400,450,850,33
BUTAMBALA,2018,400,450,850,33
BUTAMBALA,2019,420,460,880,33
BUTAMBALA,2020,430,470,900,33
BUTAMBALA,2021,430,500,930,33
BUTAMBALA,2022,450,510,960,33
BUTAMBALA,2023,450,520,970,33
BUTAMBALA,2024,460,540,1000,33
BUTAMBALA,2025,480,550,1030,33
BUTEBO,2015,480,610,1090,33
BUTEBO,2016,500,640,1140,33
BUTEBO,2017,520,650,1170,33
BUTEBO,2018,530,670,1200,33
BUTEBO,2019,550,680,1230,33
BUTEBO,2020,550,710,1260,33
BUTEBO,2021,570,730,1300,33
BUTEBO,2022,580,770,1350,33
BUTEBO,2023,600,790,1390,33
BUTEBO,2024,600,820,1420,33
BUTEBO,2025,610,840,1450,33
BUVUMA,2015,500,400,900,33
BUVUMA,2016,530,430,960,33
BUVUMA,2017,570,460,1030,33
BUVUMA,2018,600,490,1090,33
BUVUMA,2019,640,520,1160,33
BUVUMA,2020,680,560,1240,33
BUVUMA,2021,720,600,1320,33
BUVUMA,2022,760,630,1390,33
BUVUMA,2023,800,670,1470,33
BUVUMA,2024,850,720,1570,33
BUVUMA,2025,900,760,1660,33
BUYENDE,2015,1100,1500,2600,33
BUYENDE,2016,1160,1600,2760,33
BUYENDE,2017,1220,1680,2900,33
BUYENDE,2018,1280,1780,3060,33
BUYENDE,2019,1360,1880,3240,33
BUYENDE,2020,1430,2000,3430,33
BUYENDE,2021,1510,2130,3640,33
BUYENDE,2022,1580,2280,3860,33
BUYENDE,2023,1660,2430,4090,33
BUYENDE,2024,1750,2600,4350,33
BUYENDE,2025,1840,2730,4570,33
DOKOLO,2015,550,600,1150,33
DOKOLO,2016,570,620,1190,33
DOKOLO,2017,580,640,1220,33
DOKOLO,2018,600,650,1250,33
DOKOLO,2019,620,670,1290,33
DOKOLO,2020,640,690,1330,33
DOKOLO,2021,660,710,1370,33
DOKOLO,2022,670,720,1390,33
DOKOLO,2023,690,740,1430,33
DOKOLO,2024,710,760,1470,33
DOKOLO,2025,730,780,1510,33
GOMBA,2015,890,870,1760,33
GOMBA,2016,910,900,1810,33
GOMBA,2017,930,910,1840,33
GOMBA,2018,960,940,1900,33
GOMBA,2019,980,970,1950,33
GOMBA,2020,1010,980,1990,33
GOMBA,2021,1030,1030,2060,33
GOMBA,2022,1060,1050,2110,33
GOMBA,2023,1080,1100,2180,33
GOMBA,2024,1110,1130,2240,33
GOMBA,2025,1150,1160,2310,33
GULU,2015,980,1060,2040,33
GULU,2016,1010,1090,2100,33
GULU,2017,1040,1120,2160,33
GULU,2018,1070,1150,2220,33
GULU,2019,1100,1190,2290,33
GULU,2020,1130,1220,2350,33
GULU,2021,1160,1250,2410,33
GULU,2022,1190,1280,2470,33
GULU,2023,1230,1320,2550,33
GULU,2024,1260,1350,2610,33
GULU,2025,1290,1380,2670,33
HOIMA,2015,1330,1270,2600,33
HOIMA,2016,1380,1310,2690,33
HOIMA,2017,1430,1360,2790,33
HOIMA,2018,1490,1400,2890,33
HOIMA,2019,1540,1450,2990,33
HOIMA,2020,1600,1500,3100,33
HOIMA,2021,1650,1550,3200,33
HOIMA,2022,1710,1600,3310,33
HOIMA,2023,1770,1650,3420,33
HOIMA,2024,1830,1700,3530,33
HOIMA,2025,1890,1750,3640,33
IBANDA,2015,940,1100,2040,33
IBANDA,2016,960,1120,2080,33
IBANDA,2017,970,1140,2110,33
IBANDA,2018,990,1160,2150,33
IBANDA,2019,1010,1180,2190,33
IBANDA,2020,1030,1200,2230,33
IBANDA,2021,1050,1210,2260,33
IBANDA,2022,1070,1230,2300,33
IBANDA,2023,1080,1250,2330,33
IBANDA,2024,1100,1270,2370,33
IBANDA,2025,1110,1290,2400,33
IGANGA,2015,1180,1630,2810,33
IGANGA,2016,1220,1720,2940,33
IGANGA,2017,1270,1790,3060,33
IGANGA,2018,1330,1860,3190,33
IGANGA,2019,1370,1930,3300,33
IGANGA,2020,1430,2030,3460,33
IGANGA,2021,1490,2130,3620,33
IGANGA,2022,1540,2240,3780,33
IGANGA,2023,1600,2380,3980,33
IGANGA,2024,1660,2490,4150,33
IGANGA,2025,1740,2580,4320,33
ISINGIRO,2015,1790,2200,3990,33
ISINGIRO,2016,1860,2280,4140,33
ISINGIRO,2017,1930,2360,4290,33
ISINGIRO,2018,2000,2440,4440,33
ISINGIRO,2019,2070,2530,4600,33
ISINGIRO,2020,2150,2610,4760,33
ISINGIRO,2021,2220,2700,4920,33
ISINGIRO,2022,2300,2790,5090,33
ISINGIRO,2023,2370,2880,5250,33
ISINGIRO,2024,2450,2970,5420,33
ISINGIRO,2025,2530,3060,5590,33
JINJA,2015,1530,1590,3120,33
JINJA,2016,1550,1610,3160,33
JINJA,2017,1580,1640,3220,33
JINJA,2018,1610,1660,3270,33
JINJA,2019,1630,1690,3320,33
JINJA,2020,1660,1710,3370,33
JINJA,2021,1680,1730,3410,33
JINJA,2022,1700,1760,3460,33
JINJA,2023,1730,1780,3510,33
JINJA,2024,1750,1800,3550,33
JINJA,2025,1770,1820,3590,33
KAABONG,2015,430,570,1000,33
KAABONG,2016,440,580,1020,33
KAABONG,2017,450,600,1050,33
KAABONG,2018,460,610,1070,33
KAABONG,2019,480,620,1100,33
KAABONG,2020,490,640,1130,33
KAABONG,2021,500,650,1150,33
KAABONG,2022,510,670,1180,33
KAABONG,2023,530,680,1210,33
KAABONG,2024,540,690,1230,33
KAABONG,2025,550,710,1260,33
KABALE,2015,920,1120,2040,33
KABALE,2016,930,1140,2070,33
KABALE,2017,950,1150,2100,33
KABALE,2018,960,1160,2120,33
KABALE,2019,980,1180,2160,33
KABALE,2020,990,1190,2180,33
KABALE,2021,1000,1200,2200,33
KABALE,2022,1020,1210,2230,33
KABALE,2023,1030,1220,2250,33
KABALE,2024,1040,1230,2270,33
KABALE,2025,1050,1240,2290,33
KABAROLE,2015,1270,1260,2530,33
KABAROLE,2016,1300,1290,2590,33
KABAROLE,2017,1330,1320,2650,33
KABAROLE,2018,1350,1350,2700,33
KABAROLE,2019,1380,1370,2750,33
KABAROLE,2020,1410,1400,2810,33
KABAROLE,2021,1440,1430,2870,33
KABAROLE,2022,1470,1460,2930,33
KABAROLE,2023,1490,1480,2970,33
KABAROLE,2024,1520,1510,3030,33
KABAROLE,2025,1550,1540,3090,33
KABERAMAIDO,2015,540,600,1140,33
KABERAMAIDO,2016,580,620,1200,33
KABERAMAIDO,2017,600,660,1260,33
KABERAMAIDO,2018,630,700,1330,33
KABERAMAIDO,2019,670,740,1410,33
KABERAMAIDO,2020,710,780,1490,33
KABERAMAIDO,2021,750,830,1580,33
KABERAMAIDO,2022,780,880,1660,33
KABERAMAIDO,2023,810,940,1750,33
KABERAMAIDO,2024,870,1000,1870,33
KABERAMAIDO,2025,900,1050,1950,33
KAGADI,2015,1320,1530,2850,33
KAGADI,2016,1370,1580,2950,33
KAGADI,2017,1420,1640,3060,33
KAGADI,2018,1470,1690,3160,33
KAGADI,2019,1530,1750,3280,33
KAGADI,2020,1580,1810,3390,33
KAGADI,2021,1640,1870,3510,33
KAGADI,2022,1690,1930,3620,33
KAGADI,2023,1750,1990,3740,33
KAGADI,2024,1800,2060,3860,33
KAGADI,2025,1860,2120,3980,33
KAKUMIRO,2015,1350,1370,2720,33
KAKUMIRO,2016,1470,1480,2950,33
KAKUMIRO,2017,1600,1610,3210,33
KAKUMIRO,2018,1740,1740,3480,33
KAKUMIRO,2019,1890,1890,3780,33
KAKUMIRO,2020,2050,2040,4090,33
KAKUMIRO,2021,2230,2210,4440,33
KAKUMIRO,2022,2420,2390,4810,33
KAKUMIRO,2023,2620,2580,5200,33
KAKUMIRO,2024,2840,2790,5630,33
KAKUMIRO,2025,3080,3010,6090,33
KALAKI,2015,400,480,880,33
KALAKI,2016,420,500,920,33
KALAKI,2017,430,520,950,33
KALAKI,2018,450,540,990,33
KALAKI,2019,470,560,1030,33
KALAKI,2020,490,580,1070,33
KALAKI,2021,510,600,1110,33
KALAKI,2022,530,620,1150,33
KALAKI,2023,550,640,1190,33
KALAKI,2024,570,670,1240,33
KALAKI,2025,600,690,1290,33
KALANGALA,2015,510,320,830,33
KALANGALA,2016,530,330,860,33
KALANGALA,2017,550,350,900,33
KALANGALA,2018,570,360,930,33
KALANGALA,2019,590,370,960,33
KALANGALA,2020,610,390,1000,33
KALANGALA,2021,630,400,1030,33
KALANGALA,2022,650,420,1070,33
KALANGALA,2023,670,440,1110,33
KALANGALA,2024,690,450,1140,33
KALANGALA,2025,710,470,1180,33
KALIRO,2015,1010,1140,2150,33
KALIRO,2016,1050,1190,2240,33
KALIRO,2017,1100,1250,2350,33
KALIRO,2018,1140,1310,2450,33
KALIRO,2019,1200,1380,2580,33
KALIRO,2020,1260,1440,2700,33
KALIRO,2021,1300,1520,2820,33
KALIRO,2022,1360,1620,2980,33
KALIRO,2023,1420,1710,3130,33
KALIRO,2024,1490,1810,3300,33
KALIRO,2025,1560,1890,3450,33
KALUNGU,2015,740,1000,1740,33
KALUNGU,2016,750,1020,1770,33
KALUNGU,2017,760,1050,1810,33
KALUNGU,2018,770,1080,1850,33
KALUNGU,2019,800,1090,1890,33
KALUNGU,2020,800,1130,1930,33
KALUNGU,2021,830,1160,1990,33
KALUNGU,2022,830,1210,2040,33
KALUNGU,2023,860,1240,2100,33
KALUNGU,2024,870,1290,2160,33
KALUNGU,2025,900,1310,2210,33
KAMPALA,2015,7200,7890,15090,33
KAMPALA,2016,7350,8050,15400,33
KAMPALA,2017,7490,8200,15690,33
KAMPALA,2018,7630,8360,15990,33
KAMPALA,2019,7780,8510,16290,33
KAMPALA,2020,7920,8670,16590,33
KAMPALA,2021,8060,8820,16880,33
KAMPALA,2022,8190,8960,17150,33
KAMPALA,2023,8330,9110,17440,33
KAMPALA,2024,8450,9250,17700,33
KAMPALA,2025,8570,9380,17950,33
KAMULI,2015,1680,2250,3930,33
KAMULI,2016,1730,2330,4060,33
KAMULI,2017,1810,2410,4220,33
KAMULI,2018,1870,2500,4370,33
KAMULI,2019,1940,2580,4520,33
KAMULI,2020,2000,2700,4700,33
KAMULI,2021,2060,2810,4870,33
KAMULI,2022,2130,2960,5090,33
KAMULI,2023,2190,3100,5290,33
KAMULI,2024,2270,3220,5490,33
KAMULI,2025,2360,3320,5680,33
KAMWENGE,2015,1040,1240,2280,33
KAMWENGE,2016,1080,1290,2370,33
KAMWENGE,2017,1130,1330,2460,33
KAMWENGE,2018,1170,1380,2550,33
KAMWENGE,2019,1220,1430,2650,33
KAMWENGE,2020,1270,1480,2750,33
KAMWENGE,2021,1320,1520,2840,33
KAMWENGE,2022,1370,1570,2940,33
KAMWENGE,2023,1420,1630,3050,33
KAMWENGE,2024,1470,1680,3150,33
KAMWENGE,2025,1520,1730,3250,33
KANUNGU,2015,950,1170,2120,33
KANUNGU,2016,970,1190,2160,33
KANUNGU,2017,990,1210,2200,33
KANUNGU,2018,1000,1230,2230,33
KANUNGU,2019,1020,1250,2270,33
KANUNGU,2020,1040,1260,2300,33
KANUNGU,2021,1050,1280,2330,33
KANUNGU,2022,1070,1300,2370,33
KANUNGU,2023,1080,1320,2400,33
KANUNGU,2024,1100,1330,2430,33
KANUNGU,2025,1110,1350,2460,33
KAPCHORWA,2015,400,450,850,33
KAPCHORWA,2016,410,460,870,33
KAPCHORWA,2017,420,470,890,33
KAPCHORWA,2018,430,490,920,33
KAPCHORWA,2019,450,500,950,33
KAPCHORWA,2020,460,510,970,33
KAPCHORWA,2021,470,530,1000,33
KAPCHORWA,2022,490,540,1030,33
KAPCHORWA,2023,500,550,1050,33
KAPCHORWA,2024,510,570,1080,33
KAPCHORWA,2025,520,580,1100,33
KAPELEBYONG,2015,410,420,830,33
KAPELEBYONG,2016,430,440,870,33
KAPELEBYONG,2017,440,460,900,33
KAPELEBYONG,2018,460,470,930,33
KAPELEBYONG,2019,480,490,970,33
KAPELEBYONG,2020,500,520,1020,33
KAPELEBYONG,2021,520,550,1070,33
KAPELEBYONG,2022,540,580,1120,33
KAPELEBYONG,2023,560,590,1150,33
KAPELEBYONG,2024,590,630,1220,33
KAPELEBYONG,2025,610,650,1260,33
KASESE,2015,3550,4150,7700,33
KASESE,2016,3660,4320,7980,33
KASESE,2017,3780,4470,8250,33
KASESE,2018,3910,4630,8540,33
KASESE,2019,4040,4780,8820,33
KASESE,2020,4180,4970,9150,33
KASESE,2021,4320,5210,9530,33
KASESE,2022,4450,5460,9910,33
KASESE,2023,4580,5720,10300,33
KASESE,2024,4730,5960,10690,33
KASESE,2025,4900,6140,11040,33
KASSANDA,2015,990,1000,1990,33
KASSANDA,2016,1020,1020,2040,33
KASSANDA,2017,1040,1040,2080,33
KASSANDA,2018,1070,1060,2130,33
KASSANDA,2019,1100,1090,2190,33
KASSANDA,2020,1130,1110,2240,33
KASSANDA,2021,1160,1130,2290,33
KASSANDA,2022,1190,1150,2340,33
KASSANDA,2023,1220,1170,2390,33
KASSANDA,2024,1250,1190,2440,33
KASSANDA,2025,1280,1210,2490,33
KATAKWI,2015,860,960,1820,33
KATAKWI,2016,900,990,1890,33
KATAKWI,2017,930,1030,1960,33
KATAKWI,2018,960,1080,2040,33
KATAKWI,2019,1000,1110,2110,33
KATAKWI,2020,1040,1160,2200,33
KATAKWI,2021,1080,1220,2300,33
KATAKWI,2022,1120,1290,2410,33
KATAKWI,2023,1160,1350,2510,33
KATAKWI,2024,1210,1410,2620,33
KATAKWI,2025,1240,1450,2690,33
KAYUNGA,2015,1300,1720,3020,33
KAYUNGA,2016,1340,1780,3120,33
KAYUNGA,2017,1380,1830,3210,33
KAYUNGA,2018,1420,1890,3310,33
KAYUNGA,2019,1450,1950,3400,33
KAYUNGA,2020,1500,2000,3500,33
KAYUNGA,2021,1540,2080,3620,33
KAYUNGA,2022,1570,2180,3750,33
KAYUNGA,2023,1610,2270,3880,33
KAYUNGA,2024,1660,2350,4010,33
KAYUNGA,2025,1710,2420,4130,33
KAZO,2015,590,720,1310,33
KAZO,2016,610,750,1360,33
KAZO,2017,630,770,1400,33
KAZO,2018,650,800,1450,33
KAZO,2019,680,830,1510,33
KAZO,2020,700,860,1560,33
KAZO,2021,730,880,1610,33
KAZO,2022,750,910,1660,33
KAZO,2023,780,940,1720,33
KAZO,2024,810,970,1780,33
KAZO,2025,830,1000,1830,33
KIBAALE,2015,550,600,1150,33
KIBAALE,2016,580,630,1210,33
KIBAALE,2017,620,670,1290,33
KIBAALE,2018,660,710,1370,33
KIBAALE,2019,700,750,1450,33
KIBAALE,2020,740,790,1530,33
KIBAALE,2021,790,840,1630,33
KIBAALE,2022,830,880,1710,33
KIBAALE,2023,890,930,1820,33
KIBAALE,2024,940,980,1920,33
KIBAALE,2025,990,1030,2020,33
KIBOGA,2015,890,800,1690,33
KIBOGA,2016,920,830,1750,33
KIBOGA,2017,950,870,1820,33
KIBOGA,2018,980,900,1880,33
KIBOGA,2019,1020,940,1960,33
KIBOGA,2020,1060,970,2030,33
KIBOGA,2021,1090,1010,2100,33
KIBOGA,2022,1130,1060,2190,33
KIBOGA,2023,1170,1110,2280,33
KIBOGA,2024,1210,1170,2380,33
KIBOGA,2025,1240,1230,2470,33
KIBUKU,2015,880,1150,2030,33
KIBUKU,2016,910,1220,2130,33
KIBUKU,2017,950,1280,2230,33
KIBUKU,2018,1000,1340,2340,33
KIBUKU,2019,1050,1410,2460,33
KIBUKU,2020,1100,1490,2590,33
KIBUKU,2021,1140,1570,2710,33
KIBUKU,2022,1200,1680,2880,33
KIBUKU,2023,1260,1780,3040,33
KIBUKU,2024,1320,1880,3200,33
KIBUKU,2025,1380,1980,3360,33
KIKUUBE,2015,1210,1250,2460,33
KIKUUBE,2016,1270,1320,2590,33
KIKUUBE,2017,1340,1380,2720,33
KIKUUBE,2018,1410,1450,2860,33
KIKUUBE,2019,1480,1520,3000,33
KIKUUBE,2020,1560,1600,3160,33
KIKUUBE,2021,1640,1680,3320,33
KIKUUBE,2022,1720,1760,3480,33
KIKUUBE,2023,1810,1840,3650,33
KIKUUBE,2024,1900,1930,3830,33
KIKUUBE,2025,1990,2020,4010,33
KIRUHURA,2015,680,630,1310,33
KIRUHURA,2016,710,660,1370,33
KIRUHURA,2017,740,680,1420,33
KIRUHURA,2018,770,700,1470,33
KIRUHURA,2019,790,730,1520,33
KIRUHURA,2020,820,750,1570,33
KIRUHURA,2021,850,780,1630,33
KIRUHURA,2022,880,800,1680,33
KIRUHURA,2023,910,830,1740,33
KIRUHURA,2024,940,850,1790,33
KIRUHURA,2025,970,880,1850,33
KIRYANDONGO,2015,1270,1450,2720,33
KIRYANDONGO,2016,1310,1520,2830,33
KIRYANDONGO,2017,1360,1590,2950,33
KIRYANDONGO,2018,1420,1660,3080,33
KIRYANDONGO,2019,1480,1710,3190,33
KIRYANDONGO,2020,1530,1790,3320,33
KIRYANDONGO,2021,1590,1890,3480,33
KIRYANDONGO,2022,1650,1990,3640,33
KIRYANDONGO,2023,1710,2100,3810,33
KIRYANDONGO,2024,1780,2180,3960,33
KIRYANDONGO,2025,1860,2270,4130,33
KISORO,2015,1220,2290,3510,33
KISORO,2016,1260,2370,3630,33
KISORO,2017,1300,2470,3770,33
KISORO,2018,1330,2550,3880,33
KISORO,2019,1370,2630,4000,33
KISORO,2020,1420,2730,4150,33
KISORO,2021,1450,2850,4300,33
KISORO,2022,1490,2980,4470,33
KISORO,2023,1530,3110,4640,33
KISORO,2024,1570,3220,4790,33
KISORO,2025,1630,3320,4950,33
KITAGWENDA,2015,520,650,1170,33
KITAGWENDA,2016,550,670,1220,33
KITAGWENDA,2017,570,700,1270,33
KITAGWENDA,2018,590,720,1310,33
KITAGWENDA,2019,610,750,1360,33
KITAGWENDA,2020,640,770,1410,33
KITAGWENDA,2021,660,800,1460,33
KITAGWENDA,2022,690,830,1520,33
KITAGWENDA,2023,710,850,1560,33
KITAGWENDA,2024,740,880,1620,33
KITAGWENDA,2025,770,910,1680,33
KITGUM,2015,950,1120,2070,33
KITGUM,2016,970,1170,2140,33
KITGUM,2017,990,1200,2190,33
KITGUM,2018,1020,1230,2250,33
KITGUM,2019,1050,1270,2320,33
KITGUM,2020,1070,1310,2380,33
KITGUM,2021,1100,1360,2460,33
KITGUM,2022,1120,1430,2550,33
KITGUM,2023,1150,1490,2640,33
KITGUM,2024,1180,1540,2720,33
KITGUM,2025,1210,1560,2770,33
KOBOKO,2015,830,1060,1890,33
KOBOKO,2016,870,1110,1980,33
KOBOKO,2017,920,1170,2090,33
KOBOKO,2018,960,1230,2190,33
KOBOKO,2019,1010,1300,2310,33
KOBOKO,2020,1060,1370,2430,33
KOBOKO,2021,1110,1460,2570,33
KOBOKO,2022,1150,1550,2700,33
KOBOKO,2023,1210,1660,2870,33
KOBOKO,2024,1270,1750,3020,33
KOBOKO,2025,1340,1830,3170,33
KOLE,2015,730,770,1500,33
KOLE,2016,760,800,1560,33
KOLE,2017,780,820,1600,33
KOLE,2018,810,840,1650,33
KOLE,2019,830,870,1700,33
KOLE,2020,860,890,1750,33
KOLE,2021,890,910,1800,33
KOLE,2022,910,940,1850,33
KOLE,2023,940,960,1900,33
KOLE,2024,960,980,1940,33
KOLE,2025,990,1010,2000,33
KOTIDO,2015,910,990,1900,33
KOTIDO,2016,930,1020,1950,33
KOTIDO,2017,960,1060,2020,33
KOTIDO,2018,1000,1090,2090,33
KOTIDO,2019,1030,1120,2150,33
KOTIDO,2020,1070,1180,2250,33
KOTIDO,2021,1100,1220,2320,33
KOTIDO,2022,1140,1290,2430,33
KOTIDO,2023,1160,1350,2510,33
KOTIDO,2024,1210,1410,2620,33
KOTIDO,2025,1240,1450,2690,33
KUMI,2015,1190,1500,2690,33
KUMI,2016,1230,1570,2800,33
KUMI,2017,1290,1630,2920,33
KUMI,2018,1340,1700,3040,33
KUMI,2019,1410,1770,3180,33
KUMI,2020,1450,1860,3310,33
KUMI,2021,1510,1950,3460,33
KUMI,2022,1570,2060,3630,33
KUMI,2023,1630,2170,3800,33
KUMI,2024,1700,2270,3970,33
KUMI,2025,1780,2360,4140,33
KWANIA,2015,520,570,1090,33
KWANIA,2016,540,590,1130,33
KWANIA,2017,560,610,1170,33
KWANIA,2018,570,620,1190,33
KWANIA,2019,590,640,1230,33
KWANIA,2020,610,660,1270,33
KWANIA,2021,630,680,1310,33
KWANIA,2022,640,690,1330,33
KWANIA,2023,660,710,1370,33
KWANIA,2024,680,730,1410,33
KWANIA,2025,700,750,1450,33
KWEEN,2015,340,370,710,33
KWEEN,2016,350,380,730,33
KWEEN,2017,360,390,750,33
KWEEN,2018,370,400,770,33
KWEEN,2019,390,410,800,33
KWEEN,2020,400,420,820,33
KWEEN,2021,410,430,840,33
KWEEN,2022,420,440,860,33
KWEEN,2023,430,450,880,33
KWEEN,2024,440,460,900,33
KWEEN,2025,450,470,920,33
KYANKWANZI,2015,930,840,1770,33
KYANKWANZI,2016,970,880,1850,33
KYANKWANZI,2017,1020,920,1940,33
KYANKWANZI,2018,1070,960,2030,33
KYANKWANZI,2019,1130,1000,2130,33
KYANKWANZI,2020,1180,1050,2230,33
KYANKWANZI,2021,1240,1100,2340,33
KYANKWANZI,2022,1300,1140,2440,33
KYANKWANZI,2023,1360,1190,2550,33
KYANKWANZI,2024,1430,1240,2670,33
KYANKWANZI,2025,1490,1300,2790,33
KYEGEGWA,2015,1130,1280,2410,33
KYEGEGWA,2016,1220,1380,2600,33
KYEGEGWA,2017,1320,1490,2810,33
KYEGEGWA,2018,1430,1610,3040,33
KYEGEGWA,2019,1540,1730,3270,33
KYEGEGWA,2020,1670,1870,3540,33
KYEGEGWA,2021,1800,2010,3810,33
KYEGEGWA,2022,1940,2160,4100,33
KYEGEGWA,2023,2090,2330,4420,33
KYEGEGWA,2024,2260,2500,4760,33
KYEGEGWA,2025,2430,2690,5120,33
KYENJOJO,2015,1630,1900,3530,33
KYENJOJO,2016,1690,1970,3660,33
KYENJOJO,2017,1760,2050,3810,33
KYENJOJO,2018,1840,2120,3960,33
KYENJOJO,2019,1910,2200,4110,33
KYENJOJO,2020,1980,2270,4250,33
KYENJOJO,2021,2060,2350,4410,33
KYENJOJO,2022,2140,2430,4570,33
KYENJOJO,2023,2220,2510,4730,33
KYENJOJO,2024,2300,2600,4900,33
KYENJOJO,2025,2380,2680,5060,33
KYOTERA,2015,1300,1530,2830,33
KYOTERA,2016,1320,1580,2900,33
KYOTERA,2017,1360,1620,2980,33
KYOTERA,2018,1390,1660,3050,33
KYOTERA,2019,1440,1710,3150,33
KYOTERA,2020,1470,1760,3230,33
KYOTERA,2021,1510,1820,3330,33
KYOTERA,2022,1540,1900,3440,33
KYOTERA,2023,1560,1980,3540,33
KYOTERA,2024,1600,2040,3640,33
KYOTERA,2025,1660,2090,3750,33
KARENGA,2015,250,250,500,33
KARENGA,2016,250,250,500,33
KARENGA,2017,260,260,520,33
KARENGA,2018,270,270,540,33
KARENGA,2019,270,270,540,33
KARENGA,2020,280,280,560,33
KARENGA,2021,290,280,570,33
KARENGA,2022,290,290,580,33
KARENGA,2023,300,300,600,33
KARENGA,2024,310,300,610,33
KARENGA,2025,320,310,630,33
LAMWO,2015,530,640,1170,33
LAMWO,2016,550,650,1200,33
LAMWO,2017,550,680,1230,33
LAMWO,2018,560,700,1260,33
LAMWO,2019,580,710,1290,33
LAMWO,2020,580,740,1320,33
LAMWO,2021,590,760,1350,33
LAMWO,2022,610,800,1410,33
LAMWO,2023,610,840,1450,33
LAMWO,2024,620,860,1480,33
LAMWO,2025,630,870,1500,33
LIRA,2015,1450,1550,3000,33
LIRA,2016,1490,1600,3090,33
LIRA,2017,1540,1640,3180,33
LIRA,2018,1580,1690,3270,33
LIRA,2019,1620,1730,3350,33
LIRA,2020,1660,1780,3440,33
LIRA,2021,1710,1830,3540,33
LIRA,2022,1750,1880,3630,33
LIRA,2023,1790,1920,3710,33
LIRA,2024,1830,1970,3800,33
LIRA,2025,1880,2020,3900,33
LUUKA,2015,660,970,1630,33
LUUKA,2016,680,1000,1680,33
LUUKA,2017,700,1030,1730,33
LUUKA,2018,730,1080,1810,33
LUUKA,2019,750,1110,1860,33
LUUKA,2020,770,1150,1920,33
LUUKA,2021,780,1210,1990,33
LUUKA,2022,800,1260,2060,33
LUUKA,2023,820,1310,2130,33
LUUKA,2024,850,1360,2210,33
LUUKA,2025,880,1400,2280,33
LUWERO,2015,2050,2440,4490,33
LUWERO,2016,2130,2540,4670,33
LUWERO,2017,2190,2640,4830,33
LUWERO,2018,2270,2720,4990,33
LUWERO,2019,2360,2820,5180,33
LUWERO,2020,2430,2940,5370,33
LUWERO,2021,2510,3080,5590,33
LUWERO,2022,2590,3210,5800,33
LUWERO,2023,2660,3380,6040,33
LUWERO,2024,2760,3510,6270,33
LUWERO,2025,2850,3630,6480,33
LWENGO,2015,1310,1740,3050,33
LWENGO,2016,1340,1790,3130,33
LWENGO,2017,1360,1830,3190,33
LWENGO,2018,1390,1880,3270,33
LWENGO,2019,1420,1920,3340,33
LWENGO,2020,1450,1970,3420,33
LWENGO,2021,1480,2020,3500,33
LWENGO,2022,1500,2090,3590,33
LWENGO,2023,1520,2170,3690,33
LWENGO,2024,1550,2240,3790,33
LWENGO,2025,1590,2270,3860,33
LYANTONDE,2015,530,540,1070,33
LYANTONDE,2016,550,570,1120,33
LYANTONDE,2017,570,600,1170,33
LYANTONDE,2018,590,620,1210,33
LYANTONDE,2019,610,650,1260,33
LYANTONDE,2020,640,680,1320,33
LYANTONDE,2021,670,700,1370,33
LYANTONDE,2022,690,740,1430,33
LYANTONDE,2023,720,770,1490,33
LYANTONDE,2024,740,820,1560,33
LYANTONDE,2025,770,860,1630,33
MANAFWA,2015,450,560,1010,33
MANAFWA,2016,460,570,1030,33
MANAFWA,2017,470,580,1050,33
MANAFWA,2018,480,600,1080,33
MANAFWA,2019,490,610,1100,33
MANAFWA,2020,510,620,1130,33
MANAFWA,2021,520,640,1160,33
MANAFWA,2022,530,650,1180,33
MANAFWA,2023,540,660,1200,33
MANAFWA,2024,550,670,1220,33
MANAFWA,2025,560,680,1240,33
MARACHA,2015,610,760,1370,33
MARACHA,2016,620,770,1390,33
MARACHA,2017,630,790,1420,33
MARACHA,2018,640,800,1440,33
MARACHA,2019,660,820,1480,33
MARACHA,2020,670,830,1500,33
MARACHA,2021,680,850,1530,33
MARACHA,2022,700,860,1560,33
MARACHA,2023,710,870,1580,33
MARACHA,2024,720,890,1610,33
MARACHA,2025,730,900,1630,33
MASAKA,2015,1660,2010,3670,33
MASAKA,2016,1700,2080,3780,33
MASAKA,2017,1760,2140,3900,33
MASAKA,2018,1820,2220,4040,33
MASAKA,2019,1870,2300,4170,33
MASAKA,2020,1940,2390,4330,33
MASAKA,2021,2000,2480,4480,33
MASAKA,2022,2050,2600,4650,33
MASAKA,2023,2110,2730,4840,33
MASAKA,2024,2170,2830,5000,33
MASAKA,2025,2260,2920,5180,33
MASINDI,2015,1220,1190,2410,33
MASINDI,2016,1260,1220,2480,33
MASINDI,2017,1300,1260,2560,33
MASINDI,2018,1330,1290,2620,33
MASINDI,2019,1370,1320,2690,33
MASINDI,2020,1410,1350,2760,33
MASINDI,2021,1450,1390,2840,33
MASINDI,2022,1480,1420,2900,33
MASINDI,2023,1520,1460,2980,33
MASINDI,2024,1560,1490,3050,33
MASINDI,2025,1600,1520,3120,33
MAYUGE,2015,1770,2280,4050,33
MAYUGE,2016,1840,2390,4230,33
MAYUGE,2017,1910,2480,4390,33
MAYUGE,2018,1990,2590,4580,33
MAYUGE,2019,2080,2710,4790,33
MAYUGE,2020,2160,2840,5000,33
MAYUGE,2021,2240,2990,5230,33
MAYUGE,2022,2320,3160,5480,33
MAYUGE,2023,2400,3340,5740,33
MAYUGE,2024,2500,3510,6010,33
MAYUGE,2025,2620,3650,6270,33
MBALE,2015,2360,2860,5220,33
MBALE,2016,2450,3000,5450,33
MBALE,2017,2540,3150,5690,33
MBALE,2018,2640,3300,5940,33
MBALE,2019,2750,3440,6190,33
MBALE,2020,2850,3620,6470,33
MBALE,2021,2970,3820,6790,33
MBALE,2022,3070,4050,7120,33
MBALE,2023,3180,4290,7470,33
MBALE,2024,3300,4510,7810,33
MBALE,2025,3450,4720,8170,33
MBARARA,2015,1550,1570,3120,33
MBARARA,2016,1590,1610,3200,33
MBARARA,2017,1620,1640,3260,33
MBARARA,2018,1660,1670,3330,33
MBARARA,2019,1700,1710,3410,33
MBARARA,2020,1730,1740,3470,33
MBARARA,2021,1770,1780,3550,33
MBARARA,2022,1800,1810,3610,33
MBARARA,2023,1840,1850,3690,33
MBARARA,2024,1870,1880,3750,33
MBARARA,2025,1910,1910,3820,33
MITOOMA,2015,520,750,1270,33
MITOOMA,2016,530,760,1290,33
MITOOMA,2017,530,770,1300,33
MITOOMA,2018,540,770,1310,33
MITOOMA,2019,540,780,1320,33
MITOOMA,2020,550,790,1340,33
MITOOMA,2021,560,790,1350,33
MITOOMA,2022,560,800,1360,33
MITOOMA,2023,570,800,1370,33
MITOOMA,2024,570,810,1380,33
MITOOMA,2025,570,810,1380,33
MITYANA,2015,1630,1800,3430,33
MITYANA,2016,1670,1850,3520,33
MITYANA,2017,1710,1910,3620,33
MITYANA,2018,1780,1970,3750,33
MITYANA,2019,1830,2030,3860,33
MITYANA,2020,1870,2080,3950,33
MITYANA,2021,1920,2170,4090,33
MITYANA,2022,1970,2260,4230,33
MITYANA,2023,2020,2360,4380,33
MITYANA,2024,2060,2440,4500,33
MITYANA,2025,2120,2510,4630,33
MOROTO,2015,570,640,1210,33
MOROTO,2016,590,670,1260,33
MOROTO,2017,610,690,1300,33
MOROTO,2018,630,720,1350,33
MOROTO,2019,660,740,1400,33
MOROTO,2020,680,780,1460,33
MOROTO,2021,700,810,1510,33
MOROTO,2022,720,870,1590,33
MOROTO,2023,740,910,1650,33
MOROTO,2024,770,950,1720,33
MOROTO,2025,780,980,1760,33
MOYO,2015,370,460,830,33
MOYO,2016,380,470,850,33
MOYO,2017,390,480,870,33
MOYO,2018,400,490,890,33
MOYO,2019,410,500,910,33
MOYO,2020,420,510,930,33
MOYO,2021,430,520,950,33
MOYO,2022,440,530,970,33
MOYO,2023,450,540,990,33
MOYO,2024,460,550,1010,33
MOYO,2025,460,560,1020,33
MPIGI,2015,1300,1320,2620,33
MPIGI,2016,1340,1370,2710,33
MPIGI,2017,1390,1420,2810,33
MPIGI,2018,1440,1470,2910,33
MPIGI,2019,1480,1520,3000,33
MPIGI,2020,1530,1580,3110,33
MPIGI,2021,1590,1650,3240,33
MPIGI,2022,1630,1730,3360,33
MPIGI,2023,1680,1820,3500,33
MPIGI,2024,1730,1900,3630,33
MPIGI,2025,1790,1960,3750,33
MUBENDE,2015,2480,2560,5040,33
MUBENDE,2016,2630,2740,5370,33
MUBENDE,2017,2780,2910,5690,33
MUBENDE,2018,2970,3110,6080,33
MUBENDE,2019,3150,3310,6460,33
MUBENDE,2020,3340,3540,6880,33
MUBENDE,2021,3560,3800,7360,33
MUBENDE,2022,3760,4100,7860,33
MUBENDE,2023,3980,4430,8410,33
MUBENDE,2024,4230,4750,8980,33
MUBENDE,2025,4510,5030,9540,33
MUKONO,2015,3100,3520,6620,33
MUKONO,2016,3210,3680,6890,33
MUKONO,2017,3320,3840,7160,33
MUKONO,2018,3440,4000,7440,33
MUKONO,2019,3580,4170,7750,33
MUKONO,2020,3700,4360,8060,33
MUKONO,2021,3830,4600,8430,33
MUKONO,2022,3950,4850,8800,33
MUKONO,2023,4080,5130,9210,33
MUKONO,2024,4230,5370,9600,33
MUKONO,2025,4400,5580,9980,33
MADI OKOLLO,2015,360,510,870,33
MADI OKOLLO,2016,370,520,890,33
MADI OKOLLO,2017,390,540,930,33
MADI OKOLLO,2018,400,550,950,33
MADI OKOLLO,2019,410,570,980,33
MADI OKOLLO,2020,420,580,1000,33
MADI OKOLLO,2021,430,600,1030,33
MADI OKOLLO,2022,440,610,1050,33
MADI OKOLLO,2023,450,620,1070,33
MADI OKOLLO,2024,460,640,1100,33
MADI OKOLLO,2025,470,650,1120,33
NABILATUK,2015,300,360,660,33
NABILATUK,2016,320,380,700,33
NABILATUK,2017,340,400,740,33
NABILATUK,2018,360,420,780,33
NABILATUK,2019,370,440,810,33
NABILATUK,2020,410,470,880,33
NABILATUK,2021,430,510,940,33
NABILATUK,2022,450,540,990,33
NABILATUK,2023,480,580,1060,33
NABILATUK,2024,510,630,1140,33
NABILATUK,2025,530,650,1180,33
NAKAPIRIPIRIT,2015,470,520,990,33
NAKAPIRIPIRIT,2016,500,560,1060,33
NAKAPIRIPIRIT,2017,520,600,1120,33
NAKAPIRIPIRIT,2018,560,630,1190,33
NAKAPIRIPIRIT,2019,580,670,1250,33
NAKAPIRIPIRIT,2020,610,710,1320,33
NAKAPIRIPIRIT,2021,650,740,1390,33
NAKAPIRIPIRIT,2022,670,800,1470,33
NAKAPIRIPIRIT,2023,710,860,1570,33
NAKAPIRIPIRIT,2024,750,910,1660,33
NAKAPIRIPIRIT,2025,800,960,1760,33
NAKASEKE,2015,910,660,1570,33
NAKASEKE,2016,950,670,1620,33
NAKASEKE,2017,980,690,1670,33
NAKASEKE,2018,1010,700,1710,33
NAKASEKE,2019,1050,720,1770,33
NAKASEKE,2020,1090,740,1830,33
NAKASEKE,2021,1120,750,1870,33
NAKASEKE,2022,1160,770,1930,33
NAKASEKE,2023,1200,780,1980,33
NAKASEKE,2024,1240,800,2040,33
NAKASEKE,2025,1280,820,2100,33
NAKASONGOLA,2015,1000,940,1940,33
NAKASONGOLA,2016,1030,990,2020,33
NAKASONGOLA,2017,1070,1030,2100,33
NAKASONGOLA,2018,1130,1060,2190,33
NAKASONGOLA,2019,1170,1110,2280,33
NAKASONGOLA,2020,1210,1160,2370,33
NAKASONGOLA,2021,1270,1220,2490,33
NAKASONGOLA,2022,1310,1280,2590,33
NAKASONGOLA,2023,1370,1350,2720,33
NAKASONGOLA,2024,1420,1410,2830,33
NAKASONGOLA,2025,1490,1470,2960,33
NAMAYINGO,2015,1040,1090,2130,33
NAMAYINGO,2016,1080,1130,2210,33
NAMAYINGO,2017,1100,1160,2260,33
NAMAYINGO,2018,1140,1190,2330,33
NAMAYINGO,2019,1170,1220,2390,33
NAMAYINGO,2020,1200,1260,2460,33
NAMAYINGO,2021,1240,1310,2550,33
NAMAYINGO,2022,1260,1360,2620,33
NAMAYINGO,2023,1290,1420,2710,33
NAMAYINGO,2024,1320,1470,2790,33
NAMAYINGO,2025,1360,1510,2870,33
NAMISINDWA,2015,580,690,1270,33
NAMISINDWA,2016,600,710,1310,33
NAMISINDWA,2017,620,720,1340,33
NAMISINDWA,2018,630,740,1370,33
NAMISINDWA,2019,650,760,1410,33
NAMISINDWA,2020,670,770,1440,33
NAMISINDWA,2021,680,790,1470,33
NAMISINDWA,2022,700,810,1510,33
NAMISINDWA,2023,720,820,1540,33
NAMISINDWA,2024,730,840,1570,33
NAMISINDWA,2025,750,860,1610,33
NAMUTUMBA,2015,940,1270,2210,33
NAMUTUMBA,2016,970,1340,2310,33
NAMUTUMBA,2017,1010,1400,2410,33
NAMUTUMBA,2018,1070,1470,2540,33
NAMUTUMBA,2019,1110,1540,2650,33
NAMUTUMBA,2020,1170,1610,2780,33
NAMUTUMBA,2021,1210,1700,2910,33
NAMUTUMBA,2022,1260,1800,3060,33
NAMUTUMBA,2023,1310,1910,3220,33
NAMUTUMBA,2024,1370,2010,3380,33
NAMUTUMBA,2025,1430,2090,3520,33
NAPAK,2015,500,720,1220,33
NAPAK,2016,500,740,1240,33
NAPAK,2017,520,770,1290,33
NAPAK,2018,540,800,1340,33
NAPAK,2019,550,820,1370,33
NAPAK,2020,570,860,1430,33
NAPAK,2021,570,890,1460,33
NAPAK,2022,590,940,1530,33
NAPAK,2023,600,980,1580,33
NAPAK,2024,620,1020,1640,33
NAPAK,2025,630,1050,1680,33
NEBBI,2015,690,900,1590,33
NEBBI,2016,710,930,1640,33
NEBBI,2017,730,950,1680,33
NEBBI,2018,750,980,1730,33
NEBBI,2019,780,1010,1790,33
NEBBI,2020,800,1030,1830,33
NEBBI,2021,820,1060,1880,33
NEBBI,2022,850,1090,1940,33
NEBBI,2023,870,1120,1990,33
NEBBI,2024,900,1140,2040,33
NEBBI,2025,920,1170,2090,33
NGORA,2015,570,750,1320,33
NGORA,2016,590,780,1370,33
NGORA,2017,630,820,1450,33
NGORA,2018,650,840,1490,33
NGORA,2019,670,890,1560,33
NGORA,2020,690,920,1610,33
NGORA,2021,710,960,1670,33
NGORA,2022,750,1020,1770,33
NGORA,2023,770,1070,1840,33
NGORA,2024,800,1110,1910,33
NGORA,2025,830,1160,1990,33
NTOROKO,2015,390,330,720,33
NTOROKO,2016,400,350,750,33
NTOROKO,2017,410,350,760,33
NTOROKO,2018,430,380,810,33
NTOROKO,2019,440,380,820,33
NTOROKO,2020,460,390,850,33
NTOROKO,2021,480,410,890,33
NTOROKO,2022,480,430,910,33
NTOROKO,2023,500,450,950,33
NTOROKO,2024,520,470,990,33
NTOROKO,2025,530,470,1000,33
NTUNGAMO,2015,1670,2030,3700,33
NTUNGAMO,2016,1710,2070,3780,33
NTUNGAMO,2017,1750,2110,3860,33
NTUNGAMO,2018,1780,2150,3930,33
NTUNGAMO,2019,1820,2180,4000,33
NTUNGAMO,2020,1860,2220,4080,33
NTUNGAMO,2021,1890,2260,4150,33
NTUNGAMO,2022,1930,2290,4220,33
NTUNGAMO,2023,1960,2330,4290,33
NTUNGAMO,2024,2000,2360,4360,33
NTUNGAMO,2025,2030,2390,4420,33
NWOYA,2015,430,540,970,33
NWOYA,2016,480,600,1080,33
NWOYA,2017,530,660,1190,33
NWOYA,2018,580,720,1300,33
NWOYA,2019,640,800,1440,33
NWOYA,2020,710,880,1590,33
NWOYA,2021,780,960,1740,33
NWOYA,2022,860,1060,1920,33
NWOYA,2023,950,1160,2110,33
NWOYA,2024,1040,1280,2320,33
NWOYA,2025,1150,1400,2550,33
OBONGI,2015,180,270,450,33
OBONGI,2016,200,270,470,33
OBONGI,2017,200,290,490,33
OBONGI,2018,220,300,520,33
OBONGI,2019,220,320,540,33
OBONGI,2020,220,320,540,33
OBONGI,2021,240,350,590,33
OBONGI,2022,240,360,600,33
OBONGI,2023,240,370,610,33
OBONGI,2024,240,390,630,33
OBONGI,2025,270,400,670,33
OMORO,2015,730,840,1570,33
OMORO,2016,760,880,1640,33
OMORO,2017,800,930,1730,33
OMORO,2018,820,970,1790,33
OMORO,2019,860,1010,1870,33
OMORO,2020,900,1080,1980,33
OMORO,2021,940,1140,2080,33
OMORO,2022,980,1210,2190,33
OMORO,2023,1020,1280,2300,33
OMORO,2024,1060,1340,2400,33
OMORO,2025,1110,1420,2530,33
OTUKE,2015,310,400,710,33
OTUKE,2016,320,410,730,33
OTUKE,2017,340,430,770,33
OTUKE,2018,350,450,800,33
OTUKE,2019,370,470,840,33
OTUKE,2020,380,490,870,33
OTUKE,2021,400,510,910,33
OTUKE,2022,420,530,950,33
OTUKE,2023,430,550,980,33
OTUKE,2024,450,570,1020,33
OTUKE,2025,470,590,1060,33
OYAM,2015,1190,1340,2530,33
OYAM,2016,1220,1380,2600,33
OYAM,2017,1260,1420,2680,33
OYAM,2018,1300,1460,2760,33
OYAM,2019,1340,1510,2850,33
OYAM,2020,1380,1550,2930,33
OYAM,2021,1420,1590,3010,33
OYAM,2022,1460,1630,3090,33
OYAM,2023,1500,1670,3170,33
OYAM,2024,1530,1720,3250,33
OYAM,2025,1570,1760,3330,33
PADER,2015,850,970,1820,33
PADER,2016,870,1020,1890,33
PADER,2017,890,1050,1940,33
PADER,2018,910,1080,1990,33
PADER,2019,940,1110,2050,33
PADER,2020,960,1160,2120,33
PADER,2021,980,1210,2190,33
PADER,2022,1010,1260,2270,33
PADER,2023,1030,1310,2340,33
PADER,2024,1060,1360,2420,33
PADER,2025,1080,1400,2480,33
PAKWACH,2015,490,570,1060,33
PAKWACH,2016,510,590,1100,33
PAKWACH,2017,530,610,1140,33
PAKWACH,2018,550,630,1180,33
PAKWACH,2019,570,660,1230,33
PAKWACH,2020,600,680,1280,33
PAKWACH,2021,620,700,1320,33
PAKWACH,2022,650,730,1380,33
PAKWACH,2023,670,750,1420,33
PAKWACH,2024,690,770,1460,33
PAKWACH,2025,720,800,1520,33
PALLISA,2015,1210,1330,2540,33
PALLISA,2016,1260,1410,2670,33
PALLISA,2017,1330,1500,2830,33
PALLISA,2018,1410,1580,2990,33
PALLISA,2019,1480,1660,3140,33
PALLISA,2020,1560,1780,3340,33
PALLISA,2021,1650,1890,3540,33
PALLISA,2022,1730,2020,3750,33
PALLISA,2023,1820,2170,3990,33
PALLISA,2024,1910,2290,4200,33
PALLISA,2025,2020,2420,4440,33
RAKAI,2015,1420,1710,3130,33
RAKAI,2016,1480,1780,3260,33
RAKAI,2017,1510,1830,3340,33
RAKAI,2018,1580,1910,3490,33
RAKAI,2019,1620,1980,3600,33
RAKAI,2020,1690,2050,3740,33
RAKAI,2021,1750,2150,3900,33
RAKAI,2022,1790,2240,4030,33
RAKAI,2023,1860,2360,4220,33
RAKAI,2024,1910,2470,4380,33
RAKAI,2025,1990,2540,4530,33
RUBANDA,2015,710,980,1690,33
RUBANDA,2016,720,990,1710,33
RUBANDA,2017,730,1000,1730,33
RUBANDA,2018,740,1000,1740,33
RUBANDA,2019,740,1010,1750,33
RUBANDA,2020,750,1020,1770,33
RUBANDA,2021,760,1020,1780,33
RUBANDA,2022,770,1030,1800,33
RUBANDA,2023,780,1030,1810,33
RUBANDA,2024,780,1040,1820,33
RUBANDA,2025,790,1040,1830,33
RUBIRIZI,2015,400,510,910,33
RUBIRIZI,2016,410,520,930,33
RUBIRIZI,2017,420,530,950,33
RUBIRIZI,2018,430,540,970,33
RUBIRIZI,2019,440,550,990,33
RUBIRIZI,2020,440,560,1000,33
RUBIRIZI,2021,450,570,1020,33
RUBIRIZI,2022,460,580,1040,33
RUBIRIZI,2023,470,590,1060,33
RUBIRIZI,2024,470,600,1070,33
RUBIRIZI,2025,480,610,1090,33
RUKIGA,2015,390,470,860,33
RUKIGA,2016,400,480,880,33
RUKIGA,2017,400,480,880,33
RUKIGA,2018,400,480,880,33
RUKIGA,2019,410,490,900,33
RUKIGA,2020,410,490,900,33
RUKIGA,2021,420,490,910,33
RUKIGA,2022,420,490,910,33
RUKIGA,2023,420,500,920,33
RUKIGA,2024,420,500,920,33
RUKIGA,2025,420,500,920,33
RUKUNGIRI,2015,1080,1440,2520,33
RUKUNGIRI,2016,1090,1460,2550,33
RUKUNGIRI,2017,1110,1470,2580,33
RUKUNGIRI,2018,1120,1480,2600,33
RUKUNGIRI,2019,1130,1500,2630,33
RUKUNGIRI,2020,1140,1510,2650,33
RUKUNGIRI,2021,1150,1520,2670,33
RUKUNGIRI,2022,1170,1530,2700,33
RUKUNGIRI,2023,1180,1540,2720,33
RUKUNGIRI,2024,1180,1550,2730,33
RUKUNGIRI,2025,1190,1560,2750,33
RWAMPARA,2015,460,560,1020,33
RWAMPARA,2016,470,570,1040,33
RWAMPARA,2017,480,580,1060,33
RWAMPARA,2018,490,590,1080,33
RWAMPARA,2019,500,600,1100,33
RWAMPARA,2020,510,620,1130,33
RWAMPARA,2021,520,630,1150,33
RWAMPARA,2022,530,640,1170,33
RWAMPARA,2023,540,650,1190,33
RWAMPARA,2024,550,670,1220,33
RWAMPARA,2025,560,680,1240,33
SERERE,2015,1340,1390,2730,33
SERERE,2016,1410,1470,2880,33
SERERE,2017,1480,1560,3040,33
SERERE,2018,1560,1640,3200,33
SERERE,2019,1640,1730,3370,33
SERERE,2020,1720,1820,3540,33
SERERE,2021,1790,1940,3730,33
SERERE,2022,1890,2070,3960,33
SERERE,2023,1970,2200,4170,33
SERERE,2024,2070,2350,4420,33
SERERE,2025,2190,2450,4640,33
SHEEMA,2015,660,870,1530,33
SHEEMA,2016,660,880,1540,33
SHEEMA,2017,670,890,1560,33
SHEEMA,2018,680,900,1580,33
SHEEMA,2019,690,910,1600,33
SHEEMA,2020,700,920,1620,33
SHEEMA,2021,700,920,1620,33
SHEEMA,2022,710,930,1640,33
SHEEMA,2023,710,940,1650,33
SHEEMA,2024,720,940,1660,33
SHEEMA,2025,730,950,1680,33
SIRONKO,2015,700,830,1530,33
SIRONKO,2016,710,850,1560,33
SIRONKO,2017,730,860,1590,33
SIRONKO,2018,750,880,1630,33
SIRONKO,2019,770,900,1670,33
SIRONKO,2020,780,910,1690,33
SIRONKO,2021,800,930,1730,33
SIRONKO,2022,820,950,1770,33
SIRONKO,2023,830,960,1790,33
SIRONKO,2024,850,980,1830,33
SIRONKO,2025,860,990,1850,33
SOROTI,2015,1530,1540,3070,33
SOROTI,2016,1580,1630,3210,33
SOROTI,2017,1650,1710,3360,33
SOROTI,2018,1730,1780,3510,33
SOROTI,2019,1810,1870,3680,33
SOROTI,2020,1910,1970,3880,33
SOROTI,2021,1990,2080,4070,33
SOROTI,2022,2060,2210,4270,33
SOROTI,2023,2150,2340,4490,33
SOROTI,2024,2250,2470,4720,33
SOROTI,2025,2360,2600,4960,33
SSEMBABULE,2015,1480,1560,3040,33
SSEMBABULE,2016,1540,1630,3170,33
SSEMBABULE,2017,1590,1700,3290,33
SSEMBABULE,2018,1650,1770,3420,33
SSEMBABULE,2019,1720,1840,3560,33
SSEMBABULE,2020,1780,1910,3690,33
SSEMBABULE,2021,1840,2000,3840,33
SSEMBABULE,2022,1900,2110,4010,33
SSEMBABULE,2023,1970,2220,4190,33
SSEMBABULE,2024,2040,2330,4370,33
SSEMBABULE,2025,2120,2420,4540,33
TORORO,2015,1650,2120,3770,33
TORORO,2016,1700,2170,3870,33
TORORO,2017,1740,2230,3970,33
TORORO,2018,1790,2280,4070,33
TORORO,2019,1830,2340,4170,33
TORORO,2020,1880,2390,4270,33
TORORO,2021,1920,2450,4370,33
TORORO,2022,1970,2500,4470,33
TORORO,2023,2010,2560,4570,33
TORORO,2024,2060,2610,4670,33
TORORO,2025,2100,2660,4760,33
WAKISO,2015,9340,10090,19430,33
WAKISO,2016,9960,10780,20740,33
WAKISO,2017,10630,11520,22150,33
WAKISO,2018,11340,12300,23640,33
WAKISO,2019,12090,13130,25220,33
WAKISO,2020,12880,14000,26880,33
WAKISO,2021,13710,14930,28640,33
WAKISO,2022,14580,15910,30490,33
WAKISO,2023,15510,16940,32450,33
WAKISO,2024,16470,18010,34480,33
WAKISO,2025,17490,19160,36650,33
YUMBE,2015,1810,2320,4130,33
YUMBE,2016,1920,2490,4410,33
YUMBE,2017,2030,2670,4700,33
YUMBE,2018,2160,2880,5040,33
YUMBE,2019,2290,3070,5360,33
YUMBE,2020,2440,3330,5770,33
YUMBE,2021,2570,3590,6160,33
YUMBE,2022,2720,3890,6610,33
YUMBE,2023,2890,4230,7120,33
YUMBE,2024,3050,4580,7630,33
YUMBE,2025,3250,4890,8140,33
ZOMBO,2015,750,940,1690,33
ZOMBO,2016,770,970,1740,33
ZOMBO,2017,800,1000,1800,33
ZOMBO,2018,820,1020,1840,33
ZOMBO,2019,850,1050,1900,33
ZOMBO,2020,870,1080,1950,33
ZOMBO,2021,890,1110,2000,33
ZOMBO,2022,920,1140,2060,33
ZOMBO,2023,940,1160,2100,33
ZOMBO,2024,970,1190,2160,33
ZOMBO,2025,990,1220,2210,33
ABIM,2015,520,640,1160,34
ABIM,2016,560,690,1250,34
ABIM,2017,600,740,1340,34
ABIM,2018,650,800,1450,34
ABIM,2019,690,850,1540,34
ABIM,2020,740,920,1660,34
ABIM,2021,800,990,1790,34
ABIM,2022,860,1070,1930,34
ABIM,2023,920,1160,2080,34
ABIM,2024,980,1270,2250,34
ABIM,2025,1060,1370,2430,34
ADJUMANI,2015,930,1270,2200,34
ADJUMANI,2016,940,1280,2220,34
ADJUMANI,2017,950,1290,2240,34
ADJUMANI,2018,950,1300,2250,34
ADJUMANI,2019,960,1320,2280,34
ADJUMANI,2020,970,1330,2300,34
ADJUMANI,2021,970,1340,2310,34
ADJUMANI,2022,980,1350,2330,34
ADJUMANI,2023,980,1350,2330,34
ADJUMANI,2024,980,1360,2340,34
ADJUMANI,2025,980,1370,2350,34
AGAGO,2015,1190,1460,2650,34
AGAGO,2016,1210,1490,2700,34
AGAGO,2017,1230,1510,2740,34
AGAGO,2018,1250,1540,2790,34
AGAGO,2019,1270,1570,2840,34
AGAGO,2020,1290,1590,2880,34
AGAGO,2021,1310,1620,2930,34
AGAGO,2022,1330,1640,2970,34
AGAGO,2023,1350,1660,3010,34
AGAGO,2024,1370,1690,3060,34
AGAGO,2025,1380,1710,3090,34
ALEBTONG,2015,980,1870,2850,34
ALEBTONG,2016,930,1880,2810,34
ALEBTONG,2017,1040,1300,2340,34
ALEBTONG,2018,1130,1350,2480,34
ALEBTONG,2019,1180,1400,2580,34
ALEBTONG,2020,1230,1450,2680,34
ALEBTONG,2021,1270,1520,2790,34
ALEBTONG,2022,1310,1600,2910,34
ALEBTONG,2023,1360,1680,3040,34
ALEBTONG,2024,1400,1760,3160,34
ALEBTONG,2025,1460,1860,3320,34
AMOLATAR,2015,640,690,1330,34
AMOLATAR,2016,660,720,1380,34
AMOLATAR,2017,680,750,1430,34
AMOLATAR,2018,710,790,1500,34
AMOLATAR,2019,730,810,1540,34
AMOLATAR,2020,760,840,1600,34
AMOLATAR,2021,780,880,1660,34
AMOLATAR,2022,810,910,1720,34
AMOLATAR,2023,840,960,1800,34
AMOLATAR,2024,860,1010,1870,34
AMOLATAR,2025,900,1050,1950,34
AMUDAT,2015,560,520,1080,34
AMUDAT,2016,590,550,1140,34
AMUDAT,2017,610,590,1200,34
AMUDAT,2018,650,620,1270,34
AMUDAT,2019,670,660,1330,34
AMUDAT,2020,710,690,1400,34
AMUDAT,2021,750,730,1480,34
AMUDAT,2022,780,790,1570,34
AMUDAT,2023,820,840,1660,34
AMUDAT,2024,850,910,1760,34
AMUDAT,2025,890,970,1860,34
AMURIA,2015,750,870,1620,34
AMURIA,2016,790,920,1710,34
AMURIA,2017,820,960,1780,34
AMURIA,2018,870,1010,1880,34
AMURIA,2019,910,1050,1960,34
AMURIA,2020,950,1100,2050,34
AMURIA,2021,990,1160,2150,34
AMURIA,2022,1040,1230,2270,34
AMURIA,2023,1080,1300,2380,34
AMURIA,2024,1130,1380,2510,34
AMURIA,2025,1180,1460,2640,34
AMURU,2015,680,880,1560,34
AMURU,2016,710,920,1630,34
AMURU,2017,730,960,1690,34
AMURU,2018,760,1000,1760,34
AMURU,2019,790,1030,1820,34
AMURU,2020,810,1080,1890,34
AMURU,2021,840,1120,1960,34
AMURU,2022,870,1190,2060,34
AMURU,2023,890,1240,2130,34
AMURU,2024,920,1300,2220,34
AMURU,2025,950,1370,2320,34
APAC,2015,890,860,1750,34
APAC,2016,930,900,1830,34
APAC,2017,960,930,1890,34
APAC,2018,990,960,1950,34
APAC,2019,1030,990,2020,34
APAC,2020,1070,1020,2090,34
APAC,2021,1100,1060,2160,34
APAC,2022,1140,1090,2230,34
APAC,2023,1180,1120,2300,34
APAC,2024,1220,1160,2380,34
APAC,2025,1250,1190,2440,34
ARUA,2015,2730,3240,5970,34
ARUA,2016,2810,3330,6140,34
ARUA,2017,2890,3430,6320,34
ARUA,2018,2980,3510,6490,34
ARUA,2019,3060,3610,6670,34
ARUA,2020,3140,3700,6840,34
ARUA,2021,3230,3790,7020,34
ARUA,2022,3310,3890,7200,34
ARUA,2023,3390,3980,7370,34
ARUA,2024,3480,4070,7550,34
ARUA,2025,3560,4160,7720,34
BUDAKA,2015,790,1320,2110,34
BUDAKA,2016,830,1390,2220,34
BUDAKA,2017,860,1450,2310,34
BUDAKA,2018,910,1530,2440,34
BUDAKA,2019,950,1600,2550,34
BUDAKA,2020,990,1680,2670,34
BUDAKA,2021,1030,1760,2790,34
BUDAKA,2022,1080,1860,2940,34
BUDAKA,2023,1120,1970,3090,34
BUDAKA,2024,1170,2090,3260,34
BUDAKA,2025,1220,2200,3420,34
BUDUDA,2015,1110,1070,2180,34
BUDUDA,2016,1170,1140,2310,34
BUDUDA,2017,1230,1210,2440,34
BUDUDA,2018,1300,1280,2580,34
BUDUDA,2019,1370,1350,2720,34
BUDUDA,2020,1440,1430,2870,34
BUDUDA,2021,1530,1520,3050,34
BUDUDA,2022,1610,1630,3240,34
BUDUDA,2023,1680,1750,3430,34
BUDUDA,2024,1770,1870,3640,34
BUDUDA,2025,1870,1990,3860,34
BUGIRI,2015,1590,2200,3790,34
BUGIRI,2016,1660,2320,3980,34
BUGIRI,2017,1750,2450,4200,34
BUGIRI,2018,1840,2580,4420,34
BUGIRI,2019,1930,2710,4640,34
BUGIRI,2020,2030,2860,4890,34
BUGIRI,2021,2120,3010,5130,34
BUGIRI,2022,2230,3210,5440,34
BUGIRI,2023,2340,3410,5750,34
BUGIRI,2024,2450,3630,6080,34
BUGIRI,2025,2560,3850,6410,34
BUGWERI,2015,530,810,1340,34
BUGWERI,2016,550,840,1390,34
BUGWERI,2017,570,880,1450,34
BUGWERI,2018,590,910,1500,34
BUGWERI,2019,610,960,1570,34
BUGWERI,2020,640,990,1630,34
BUGWERI,2021,660,1030,1690,34
BUGWERI,2022,680,1080,1760,34
BUGWERI,2023,700,1140,1840,34
BUGWERI,2024,730,1200,1930,34
BUGWERI,2025,760,1250,2010,34
BUHWEJU,2015,610,670,1280,34
BUHWEJU,2016,630,690,1320,34
BUHWEJU,2017,650,710,1360,34
BUHWEJU,2018,680,730,1410,34
BUHWEJU,2019,700,750,1450,34
BUHWEJU,2020,720,770,1490,34
BUHWEJU,2021,740,790,1530,34
BUHWEJU,2022,760,810,1570,34
BUHWEJU,2023,780,840,1620,34
BUHWEJU,2024,810,860,1670,34
BUHWEJU,2025,830,880,1710,34
BUIKWE,2015,1820,2130,3950,34
BUIKWE,2016,1870,2200,4070,34
BUIKWE,2017,1930,2280,4210,34
BUIKWE,2018,1980,2360,4340,34
BUIKWE,2019,2040,2440,4480,34
BUIKWE,2020,2100,2520,4620,34
BUIKWE,2021,2170,2610,4780,34
BUIKWE,2022,2230,2730,4960,34
BUIKWE,2023,2280,2850,5130,34
BUIKWE,2024,2340,2980,5320,34
BUIKWE,2025,2400,3110,5510,34
BUKEDEA,2015,950,980,1930,34
BUKEDEA,2016,1000,1030,2030,34
BUKEDEA,2017,1040,1100,2140,34
BUKEDEA,2018,1100,1160,2260,34
BUKEDEA,2019,1160,1210,2370,34
BUKEDEA,2020,1230,1290,2520,34
BUKEDEA,2021,1290,1360,2650,34
BUKEDEA,2022,1350,1450,2800,34
BUKEDEA,2023,1430,1550,2980,34
BUKEDEA,2024,1490,1640,3130,34
BUKEDEA,2025,1580,1740,3320,34
BUKOMANSIMBI,2015,620,730,1350,34
BUKOMANSIMBI,2016,640,740,1380,34
BUKOMANSIMBI,2017,640,760,1400,34
BUKOMANSIMBI,2018,660,770,1430,34
BUKOMANSIMBI,2019,660,780,1440,34
BUKOMANSIMBI,2020,680,810,1490,34
BUKOMANSIMBI,2021,690,820,1510,34
BUKOMANSIMBI,2022,700,840,1540,34
BUKOMANSIMBI,2023,710,870,1580,34
BUKOMANSIMBI,2024,720,890,1610,34
BUKOMANSIMBI,2025,720,920,1640,34
BUKWO,2015,500,550,1050,34
BUKWO,2016,530,580,1110,34
BUKWO,2017,550,610,1160,34
BUKWO,2018,580,640,1220,34
BUKWO,2019,610,670,1280,34
BUKWO,2020,640,700,1340,34
BUKWO,2021,680,730,1410,34
BUKWO,2022,710,760,1470,34
BUKWO,2023,750,800,1550,34
BUKWO,2024,780,830,1610,34
BUKWO,2025,820,870,1690,34
BULAMBULI,2015,1060,1110,2170,34
BULAMBULI,2016,1130,1170,2300,34
BULAMBULI,2017,1180,1250,2430,34
BULAMBULI,2018,1250,1340,2590,34
BULAMBULI,2019,1330,1420,2750,34
BULAMBULI,2020,1410,1510,2920,34
BULAMBULI,2021,1490,1600,3090,34
BULAMBULI,2022,1580,1720,3300,34
BULAMBULI,2023,1660,1850,3510,34
BULAMBULI,2024,1750,1990,3740,34
BULAMBULI,2025,1850,2130,3980,34
BULIISA,2015,650,520,1170,34
BULIISA,2016,680,540,1220,34
BULIISA,2017,720,570,1290,34
BULIISA,2018,760,590,1350,34
BULIISA,2019,800,620,1420,34
BULIISA,2020,840,650,1490,34
BULIISA,2021,890,670,1560,34
BULIISA,2022,930,700,1630,34
BULIISA,2023,980,730,1710,34
BULIISA,2024,1030,760,1790,34
BULIISA,2025,1080,790,1870,34
BUNDIBUGYO,2015,920,1060,1980,34
BUNDIBUGYO,2016,960,1110,2070,34
BUNDIBUGYO,2017,990,1160,2150,34
BUNDIBUGYO,2018,1030,1210,2240,34
BUNDIBUGYO,2019,1070,1260,2330,34
BUNDIBUGYO,2020,1110,1310,2420,34
BUNDIBUGYO,2021,1160,1370,2530,34
BUNDIBUGYO,2022,1200,1440,2640,34
BUNDIBUGYO,2023,1240,1510,2750,34
BUNDIBUGYO,2024,1280,1590,2870,34
BUNDIBUGYO,2025,1330,1670,3000,34
BUNYANGABU,2015,800,860,1660,34
BUNYANGABU,2016,830,900,1730,34
BUNYANGABU,2017,850,930,1780,34
BUNYANGABU,2018,880,970,1850,34
BUNYANGABU,2019,920,1000,1920,34
BUNYANGABU,2020,950,1040,1990,34
BUNYANGABU,2021,980,1080,2060,34
BUNYANGABU,2022,1010,1130,2140,34
BUNYANGABU,2023,1040,1170,2210,34
BUNYANGABU,2024,1080,1230,2310,34
BUNYANGABU,2025,1110,1290,2400,34
BUSHENYI,2015,1250,1440,2690,34
BUSHENYI,2016,1270,1450,2720,34
BUSHENYI,2017,1280,1470,2750,34
BUSHENYI,2018,1300,1480,2780,34
BUSHENYI,2019,1310,1490,2800,34
BUSHENYI,2020,1330,1500,2830,34
BUSHENYI,2021,1340,1510,2850,34
BUSHENYI,2022,1350,1520,2870,34
BUSHENYI,2023,1370,1530,2900,34
BUSHENYI,2024,1380,1540,2920,34
BUSHENYI,2025,1390,1540,2930,34
BUSIA,2015,1550,1900,3450,34
BUSIA,2016,1610,1980,3590,34
BUSIA,2017,1690,2060,3750,34
BUSIA,2018,1750,2150,3900,34
BUSIA,2019,1830,2250,4080,34
BUSIA,2020,1900,2330,4230,34
BUSIA,2021,1980,2450,4430,34
BUSIA,2022,2050,2580,4630,34
BUSIA,2023,2130,2710,4840,34
BUSIA,2024,2200,2860,5060,34
BUSIA,2025,2290,3010,5300,34
BUTALEJA,2015,860,1090,1950,34
BUTALEJA,2016,900,1140,2040,34
BUTALEJA,2017,950,1200,2150,34
BUTALEJA,2018,990,1250,2240,34
BUTALEJA,2019,1040,1330,2370,34
BUTALEJA,2020,1080,1400,2480,34
BUTALEJA,2021,1140,1490,2630,34
BUTALEJA,2022,1180,1580,2760,34
BUTALEJA,2023,1230,1670,2900,34
BUTALEJA,2024,1300,1750,3050,34
BUTALEJA,2025,1370,1800,3170,34
BUTAMBALA,2015,310,380,690,34
BUTAMBALA,2016,310,390,700,34
BUTAMBALA,2017,320,400,720,34
BUTAMBALA,2018,320,400,720,34
BUTAMBALA,2019,340,420,760,34
BUTAMBALA,2020,340,430,770,34
BUTAMBALA,2021,340,430,770,34
BUTAMBALA,2022,360,460,820,34
BUTAMBALA,2023,360,470,830,34
BUTAMBALA,2024,370,480,850,34
BUTAMBALA,2025,380,500,880,34
BUTEBO,2015,450,560,1010,34
BUTEBO,2016,460,580,1040,34
BUTEBO,2017,470,600,1070,34
BUTEBO,2018,480,600,1080,34
BUTEBO,2019,490,620,1110,34
BUTEBO,2020,510,640,1150,34
BUTEBO,2021,520,660,1180,34
BUTEBO,2022,530,680,1210,34
BUTEBO,2023,540,720,1260,34
BUTEBO,2024,560,740,1300,34
BUTEBO,2025,560,770,1330,34
BUVUMA,2015,810,560,1370,34
BUVUMA,2016,860,600,1460,34
BUVUMA,2017,920,640,1560,34
BUVUMA,2018,970,680,1650,34
BUVUMA,2019,1030,730,1760,34
BUVUMA,2020,1090,780,1870,34
BUVUMA,2021,1160,830,1990,34
BUVUMA,2022,1230,880,2110,34
BUVUMA,2023,1300,940,2240,34
BUVUMA,2024,1370,1000,2370,34
BUVUMA,2025,1450,1060,2510,34
BUYENDE,2015,1190,1430,2620,34
BUYENDE,2016,1250,1510,2760,34
BUYENDE,2017,1310,1610,2920,34
BUYENDE,2018,1380,1700,3080,34
BUYENDE,2019,1460,1800,3260,34
BUYENDE,2020,1550,1900,3450,34
BUYENDE,2021,1620,2010,3630,34
BUYENDE,2022,1710,2140,3850,34
BUYENDE,2023,1800,2300,4100,34
BUYENDE,2024,1890,2450,4340,34
BUYENDE,2025,1990,2610,4600,34
DOKOLO,2015,840,1000,1840,34
DOKOLO,2016,860,1030,1890,34
DOKOLO,2017,890,1060,1950,34
DOKOLO,2018,920,1090,2010,34
DOKOLO,2019,950,1110,2060,34
DOKOLO,2020,970,1140,2110,34
DOKOLO,2021,1000,1170,2170,34
DOKOLO,2022,1030,1200,2230,34
DOKOLO,2023,1060,1230,2290,34
DOKOLO,2024,1080,1260,2340,34
DOKOLO,2025,1110,1290,2400,34
GOMBA,2015,800,790,1590,34
GOMBA,2016,830,810,1640,34
GOMBA,2017,840,830,1670,34
GOMBA,2018,870,850,1720,34
GOMBA,2019,890,870,1760,34
GOMBA,2020,920,890,1810,34
GOMBA,2021,940,920,1860,34
GOMBA,2022,960,960,1920,34
GOMBA,2023,990,990,1980,34
GOMBA,2024,1000,1030,2030,34
GOMBA,2025,1030,1060,2090,34
GULU,2015,1510,1540,3050,34
GULU,2016,1560,1590,3150,34
GULU,2017,1600,1630,3230,34
GULU,2018,1650,1680,3330,34
GULU,2019,1700,1730,3430,34
GULU,2020,1750,1770,3520,34
GULU,2021,1800,1820,3620,34
GULU,2022,1850,1870,3720,34
GULU,2023,1890,1920,3810,34
GULU,2024,1940,1970,3910,34
GULU,2025,1990,2020,4010,34
HOIMA,2015,1750,1800,3550,34
HOIMA,2016,1810,1860,3670,34
HOIMA,2017,1880,1920,3800,34
HOIMA,2018,1950,1990,3940,34
HOIMA,2019,2020,2060,4080,34
HOIMA,2020,2100,2130,4230,34
HOIMA,2021,2170,2200,4370,34
HOIMA,2022,2250,2260,4510,34
HOIMA,2023,2320,2340,4660,34
HOIMA,2024,2400,2410,4810,34
HOIMA,2025,2480,2480,4960,34
IBANDA,2015,1400,1570,2970,34
IBANDA,2016,1430,1590,3020,34
IBANDA,2017,1460,1620,3080,34
IBANDA,2018,1490,1650,3140,34
IBANDA,2019,1510,1680,3190,34
IBANDA,2020,1540,1710,3250,34
IBANDA,2021,1570,1740,3310,34
IBANDA,2022,1590,1760,3350,34
IBANDA,2023,1620,1790,3410,34
IBANDA,2024,1640,1810,3450,34
IBANDA,2025,1670,1840,3510,34
IGANGA,2015,1380,1910,3290,34
IGANGA,2016,1420,2000,3420,34
IGANGA,2017,1480,2080,3560,34
IGANGA,2018,1550,2180,3730,34
IGANGA,2019,1600,2270,3870,34
IGANGA,2020,1670,2360,4030,34
IGANGA,2021,1740,2470,4210,34
IGANGA,2022,1810,2600,4410,34
IGANGA,2023,1870,2740,4610,34
IGANGA,2024,1940,2890,4830,34
IGANGA,2025,2020,3030,5050,34
ISINGIRO,2015,2560,3180,5740,34
ISINGIRO,2016,2660,3300,5960,34
ISINGIRO,2017,2750,3410,6160,34
ISINGIRO,2018,2860,3530,6390,34
ISINGIRO,2019,2960,3650,6610,34
ISINGIRO,2020,3070,3770,6840,34
ISINGIRO,2021,3170,3900,7070,34
ISINGIRO,2022,3280,4030,7310,34
ISINGIRO,2023,3390,4150,7540,34
ISINGIRO,2024,3510,4280,7790,34
ISINGIRO,2025,3620,4410,8030,34
JINJA,2015,2330,2370,4700,34
JINJA,2016,2370,2400,4770,34
JINJA,2017,2410,2440,4850,34
JINJA,2018,2450,2480,4930,34
JINJA,2019,2490,2510,5000,34
JINJA,2020,2530,2550,5080,34
JINJA,2021,2560,2580,5140,34
JINJA,2022,2600,2620,5220,34
JINJA,2023,2630,2650,5280,34
JINJA,2024,2670,2680,5350,34
JINJA,2025,2700,2710,5410,34
KAABONG,2015,790,890,1680,34
KAABONG,2016,810,920,1730,34
KAABONG,2017,830,940,1770,34
KAABONG,2018,850,960,1810,34
KAABONG,2019,880,980,1860,34
KAABONG,2020,900,1010,1910,34
KAABONG,2021,920,1030,1950,34
KAABONG,2022,940,1050,1990,34
KAABONG,2023,970,1070,2040,34
KAABONG,2024,990,1100,2090,34
KAABONG,2025,1010,1120,2130,34
KABALE,2015,1240,1460,2700,34
KABALE,2016,1260,1470,2730,34
KABALE,2017,1280,1490,2770,34
KABALE,2018,1300,1510,2810,34
KABALE,2019,1320,1530,2850,34
KABALE,2020,1340,1540,2880,34
KABALE,2021,1360,1560,2920,34
KABALE,2022,1370,1570,2940,34
KABALE,2023,1390,1590,2980,34
KABALE,2024,1410,1600,3010,34
KABALE,2025,1420,1610,3030,34
KABAROLE,2015,1730,1670,3400,34
KABAROLE,2016,1770,1710,3480,34
KABAROLE,2017,1810,1750,3560,34
KABAROLE,2018,1850,1780,3630,34
KABAROLE,2019,1890,1820,3710,34
KABAROLE,2020,1930,1860,3790,34
KABAROLE,2021,1960,1890,3850,34
KABAROLE,2022,2000,1930,3930,34
KABAROLE,2023,2040,1960,4000,34
KABAROLE,2024,2070,2000,4070,34
KABAROLE,2025,2110,2030,4140,34
KABERAMAIDO,2015,470,570,1040,34
KABERAMAIDO,2016,490,610,1100,34
KABERAMAIDO,2017,510,640,1150,34
KABERAMAIDO,2018,550,670,1220,34
KABERAMAIDO,2019,570,710,1280,34
KABERAMAIDO,2020,600,740,1340,34
KABERAMAIDO,2021,640,790,1430,34
KABERAMAIDO,2022,660,830,1490,34
KABERAMAIDO,2023,700,890,1590,34
KABERAMAIDO,2024,740,950,1690,34
KABERAMAIDO,2025,770,1010,1780,34
KAGADI,2015,1860,2080,3940,34
KAGADI,2016,1930,2160,4090,34
KAGADI,2017,2010,2230,4240,34
KAGADI,2018,2080,2310,4390,34
KAGADI,2019,2150,2390,4540,34
KAGADI,2020,2230,2470,4700,34
KAGADI,2021,2310,2560,4870,34
KAGADI,2022,2390,2640,5030,34
KAGADI,2023,2470,2720,5190,34
KAGADI,2024,2550,2810,5360,34
KAGADI,2025,2630,2890,5520,34
KAKUMIRO,2015,1730,1650,3380,34
KAKUMIRO,2016,1880,1790,3670,34
KAKUMIRO,2017,2050,1940,3990,34
KAKUMIRO,2018,2230,2100,4330,34
KAKUMIRO,2019,2420,2270,4690,34
KAKUMIRO,2020,2630,2460,5090,34
KAKUMIRO,2021,2860,2660,5520,34
KAKUMIRO,2022,3110,2880,5990,34
KAKUMIRO,2023,3370,3110,6480,34
KAKUMIRO,2024,3650,3360,7010,34
KAKUMIRO,2025,3950,3630,7580,34
KALAKI,2015,440,560,1000,34
KALAKI,2016,460,580,1040,34
KALAKI,2017,480,610,1090,34
KALAKI,2018,500,630,1130,34
KALAKI,2019,520,650,1170,34
KALAKI,2020,540,680,1220,34
KALAKI,2021,570,700,1270,34
KALAKI,2022,590,730,1320,34
KALAKI,2023,610,760,1370,34
KALAKI,2024,640,780,1420,34
KALAKI,2025,660,810,1470,34
KALANGALA,2015,810,480,1290,34
KALANGALA,2016,840,500,1340,34
KALANGALA,2017,870,520,1390,34
KALANGALA,2018,900,540,1440,34
KALANGALA,2019,930,560,1490,34
KALANGALA,2020,960,580,1540,34
KALANGALA,2021,990,600,1590,34
KALANGALA,2022,1030,630,1660,34
KALANGALA,2023,1060,650,1710,34
KALANGALA,2024,1090,680,1770,34
KALANGALA,2025,1120,700,1820,34
KALIRO,2015,930,1110,2040,34
KALIRO,2016,970,1160,2130,34
KALIRO,2017,1010,1220,2230,34
KALIRO,2018,1060,1280,2340,34
KALIRO,2019,1100,1340,2440,34
KALIRO,2020,1150,1410,2560,34
KALIRO,2021,1210,1490,2700,34
KALIRO,2022,1260,1570,2830,34
KALIRO,2023,1310,1670,2980,34
KALIRO,2024,1370,1780,3150,34
KALIRO,2025,1430,1870,3300,34
KALUNGU,2015,730,860,1590,34
KALUNGU,2016,740,890,1630,34
KALUNGU,2017,750,910,1660,34
KALUNGU,2018,770,920,1690,34
KALUNGU,2019,790,950,1740,34
KALUNGU,2020,800,970,1770,34
KALUNGU,2021,820,990,1810,34
KALUNGU,2022,830,1030,1860,34
KALUNGU,2023,850,1070,1920,34
KALUNGU,2024,860,1100,1960,34
KALUNGU,2025,880,1130,2010,34
KAMPALA,2015,10490,10850,21340,34
KAMPALA,2016,10700,11060,21760,34
KAMPALA,2017,10910,11280,22190,34
KAMPALA,2018,11120,11490,22610,34
KAMPALA,2019,11330,11710,23040,34
KAMPALA,2020,11530,11920,23450,34
KAMPALA,2021,11740,12120,23860,34
KAMPALA,2022,11930,12320,24250,34
KAMPALA,2023,12130,12520,24650,34
KAMPALA,2024,12310,12720,25030,34
KAMPALA,2025,12490,12900,25390,34
KAMULI,2015,1800,2350,4150,34
KAMULI,2016,1860,2450,4310,34
KAMULI,2017,1930,2540,4470,34
KAMULI,2018,1990,2630,4620,34
KAMULI,2019,2060,2730,4790,34
KAMULI,2020,2140,2820,4960,34
KAMULI,2021,2220,2940,5160,34
KAMULI,2022,2290,3080,5370,34
KAMULI,2023,2360,3230,5590,34
KAMULI,2024,2430,3380,5810,34
KAMULI,2025,2520,3530,6050,34
KAMWENGE,2015,1410,1660,3070,34
KAMWENGE,2016,1470,1720,3190,34
KAMWENGE,2017,1530,1780,3310,34
KAMWENGE,2018,1590,1840,3430,34
KAMWENGE,2019,1660,1900,3560,34
KAMWENGE,2020,1720,1970,3690,34
KAMWENGE,2021,1790,2030,3820,34
KAMWENGE,2022,1850,2100,3950,34
KAMWENGE,2023,1920,2170,4090,34
KAMWENGE,2024,1990,2240,4230,34
KAMWENGE,2025,2060,2300,4360,34
KANUNGU,2015,1200,1590,2790,34
KANUNGU,2016,1230,1610,2840,34
KANUNGU,2017,1250,1640,2890,34
KANUNGU,2018,1270,1670,2940,34
KANUNGU,2019,1290,1690,2980,34
KANUNGU,2020,1310,1720,3030,34
KANUNGU,2021,1330,1740,3070,34
KANUNGU,2022,1350,1760,3110,34
KANUNGU,2023,1370,1790,3160,34
KANUNGU,2024,1390,1810,3200,34
KANUNGU,2025,1410,1830,3240,34
KAPCHORWA,2015,610,670,1280,34
KAPCHORWA,2016,630,690,1320,34
KAPCHORWA,2017,650,710,1360,34
KAPCHORWA,2018,670,720,1390,34
KAPCHORWA,2019,690,740,1430,34
KAPCHORWA,2020,710,760,1470,34
KAPCHORWA,2021,730,780,1510,34
KAPCHORWA,2022,750,800,1550,34
KAPCHORWA,2023,770,820,1590,34
KAPCHORWA,2024,790,840,1630,34
KAPCHORWA,2025,810,860,1670,34
KAPELEBYONG,2015,360,410,770,34
KAPELEBYONG,2016,370,420,790,34
KAPELEBYONG,2017,390,440,830,34
KAPELEBYONG,2018,400,460,860,34
KAPELEBYONG,2019,420,470,890,34
KAPELEBYONG,2020,430,490,920,34
KAPELEBYONG,2021,460,510,970,34
KAPELEBYONG,2022,470,550,1020,34
KAPELEBYONG,2023,490,570,1060,34
KAPELEBYONG,2024,510,600,1110,34
KAPELEBYONG,2025,530,630,1160,34
KASESE,2015,3020,3470,6490,34
KASESE,2016,3120,3610,6730,34
KASESE,2017,3220,3730,6950,34
KASESE,2018,3320,3870,7190,34
KASESE,2019,3440,4010,7450,34
KASESE,2020,3560,4140,7700,34
KASESE,2021,3680,4310,7990,34
KASESE,2022,3790,4510,8300,34
KASESE,2023,3910,4730,8640,34
KASESE,2024,4030,4950,8980,34
KASESE,2025,4150,5160,9310,34
KASSANDA,2015,1400,1330,2730,34
KASSANDA,2016,1440,1360,2800,34
KASSANDA,2017,1480,1390,2870,34
KASSANDA,2018,1520,1420,2940,34
KASSANDA,2019,1570,1440,3010,34
KASSANDA,2020,1610,1470,3080,34
KASSANDA,2021,1650,1500,3150,34
KASSANDA,2022,1690,1530,3220,34
KASSANDA,2023,1730,1560,3290,34
KASSANDA,2024,1780,1590,3370,34
KASSANDA,2025,1820,1610,3430,34
KATAKWI,2015,750,840,1590,34
KATAKWI,2016,780,890,1670,34
KATAKWI,2017,810,920,1730,34
KATAKWI,2018,840,960,1800,34
KATAKWI,2019,880,990,1870,34
KATAKWI,2020,910,1030,1940,34
KATAKWI,2021,950,1070,2020,34
KATAKWI,2022,980,1130,2110,34
KATAKWI,2023,1020,1180,2200,34
KATAKWI,2024,1050,1240,2290,34
KATAKWI,2025,1090,1300,2390,34
KAYUNGA,2015,1430,1820,3250,34
KAYUNGA,2016,1470,1890,3360,34
KAYUNGA,2017,1510,1940,3450,34
KAYUNGA,2018,1560,2010,3570,34
KAYUNGA,2019,1600,2060,3660,34
KAYUNGA,2020,1650,2130,3780,34
KAYUNGA,2021,1690,2200,3890,34
KAYUNGA,2022,1730,2280,4010,34
KAYUNGA,2023,1780,2380,4160,34
KAYUNGA,2024,1830,2480,4310,34
KAYUNGA,2025,1870,2570,4440,34
KAZO,2015,1050,1080,2130,34
KAZO,2016,1090,1110,2200,34
KAZO,2017,1130,1150,2280,34
KAZO,2018,1170,1200,2370,34
KAZO,2019,1220,1240,2460,34
KAZO,2020,1260,1280,2540,34
KAZO,2021,1300,1320,2620,34
KAZO,2022,1350,1360,2710,34
KAZO,2023,1400,1410,2810,34
KAZO,2024,1440,1450,2890,34
KAZO,2025,1490,1500,2990,34
KIBAALE,2015,810,800,1610,34
KIBAALE,2016,860,840,1700,34
KIBAALE,2017,910,890,1800,34
KIBAALE,2018,970,940,1910,34
KIBAALE,2019,1030,1000,2030,34
KIBAALE,2020,1090,1050,2140,34
KIBAALE,2021,1160,1110,2270,34
KIBAALE,2022,1230,1170,2400,34
KIBAALE,2023,1310,1240,2550,34
KIBAALE,2024,1380,1300,2680,34
KIBAALE,2025,1460,1370,2830,34
KIBOGA,2015,720,690,1410,34
KIBOGA,2016,740,720,1460,34
KIBOGA,2017,770,750,1520,34
KIBOGA,2018,800,780,1580,34
KIBOGA,2019,820,810,1630,34
KIBOGA,2020,860,840,1700,34
KIBOGA,2021,890,870,1760,34
KIBOGA,2022,920,910,1830,34
KIBOGA,2023,950,950,1900,34
KIBOGA,2024,980,1000,1980,34
KIBOGA,2025,1010,1050,2060,34
KIBUKU,2015,860,1300,2160,34
KIBUKU,2016,910,1370,2280,34
KIBUKU,2017,950,1440,2390,34
KIBUKU,2018,990,1520,2510,34
KIBUKU,2019,1040,1590,2630,34
KIBUKU,2020,1090,1670,2760,34
KIBUKU,2021,1150,1760,2910,34
KIBUKU,2022,1200,1870,3070,34
KIBUKU,2023,1250,1980,3230,34
KIBUKU,2024,1300,2110,3410,34
KIBUKU,2025,1360,2240,3600,34
KIKUUBE,2015,1590,1530,3120,34
KIKUUBE,2016,1670,1610,3280,34
KIKUUBE,2017,1760,1690,3450,34
KIKUUBE,2018,1860,1780,3640,34
KIKUUBE,2019,1950,1860,3810,34
KIKUUBE,2020,2060,1960,4020,34
KIKUUBE,2021,2160,2050,4210,34
KIKUUBE,2022,2270,2150,4420,34
KIKUUBE,2023,2380,2250,4630,34
KIKUUBE,2024,2500,2360,4860,34
KIKUUBE,2025,2620,2470,5090,34
KIRUHURA,2015,1020,1020,2040,34
KIRUHURA,2016,1060,1050,2110,34
KIRUHURA,2017,1100,1090,2190,34
KIRUHURA,2018,1150,1130,2280,34
KIRUHURA,2019,1190,1170,2360,34
KIRUHURA,2020,1230,1210,2440,34
KIRUHURA,2021,1280,1250,2530,34
KIRUHURA,2022,1320,1290,2610,34
KIRUHURA,2023,1370,1330,2700,34
KIRUHURA,2024,1410,1370,2780,34
KIRUHURA,2025,1460,1410,2870,34
KIRYANDONGO,2015,1270,1330,2600,34
KIRYANDONGO,2016,1310,1390,2700,34
KIRYANDONGO,2017,1360,1440,2800,34
KIRYANDONGO,2018,1420,1510,2930,34
KIRYANDONGO,2019,1480,1570,3050,34
KIRYANDONGO,2020,1540,1640,3180,34
KIRYANDONGO,2021,1600,1700,3300,34
KIRYANDONGO,2022,1660,1790,3450,34
KIRYANDONGO,2023,1720,1890,3610,34
KIRYANDONGO,2024,1780,1980,3760,34
KIRYANDONGO,2025,1850,2080,3930,34
KISORO,2015,900,1580,2480,34
KISORO,2016,930,1640,2570,34
KISORO,2017,950,1700,2650,34
KISORO,2018,980,1760,2740,34
KISORO,2019,1010,1820,2830,34
KISORO,2020,1040,1880,2920,34
KISORO,2021,1070,1950,3020,34
KISORO,2022,1100,2030,3130,34
KISORO,2023,1120,2120,3240,34
KISORO,2024,1150,2220,3370,34
KISORO,2025,1190,2310,3500,34
KITAGWENDA,2015,730,890,1620,34
KITAGWENDA,2016,760,930,1690,34
KITAGWENDA,2017,790,960,1750,34
KITAGWENDA,2018,820,990,1810,34
KITAGWENDA,2019,850,1030,1880,34
KITAGWENDA,2020,890,1060,1950,34
KITAGWENDA,2021,920,1100,2020,34
KITAGWENDA,2022,950,1140,2090,34
KITAGWENDA,2023,990,1170,2160,34
KITAGWENDA,2024,1020,1210,2230,34
KITAGWENDA,2025,1060,1250,2310,34
KITGUM,2015,920,1090,2010,34
KITGUM,2016,950,1130,2080,34
KITGUM,2017,960,1170,2130,34
KITGUM,2018,990,1200,2190,34
KITGUM,2019,1010,1240,2250,34
KITGUM,2020,1040,1280,2320,34
KITGUM,2021,1060,1310,2370,34
KITGUM,2022,1090,1370,2460,34
KITGUM,2023,1110,1420,2530,34
KITGUM,2024,1140,1490,2630,34
KITGUM,2025,1170,1530,2700,34
KOBOKO,2015,790,960,1750,34
KOBOKO,2016,830,1020,1850,34
KOBOKO,2017,860,1080,1940,34
KOBOKO,2018,910,1140,2050,34
KOBOKO,2019,960,1190,2150,34
KOBOKO,2020,1000,1250,2250,34
KOBOKO,2021,1050,1320,2370,34
KOBOKO,2022,1100,1400,2500,34
KOBOKO,2023,1150,1490,2640,34
KOBOKO,2024,1210,1590,2800,34
KOBOKO,2025,1260,1680,2940,34
KOLE,2015,1050,1090,2140,34
KOLE,2016,1090,1120,2210,34
KOLE,2017,1120,1150,2270,34
KOLE,2018,1160,1190,2350,34
KOLE,2019,1190,1220,2410,34
KOLE,2020,1230,1250,2480,34
KOLE,2021,1270,1290,2560,34
KOLE,2022,1310,1320,2630,34
KOLE,2023,1340,1350,2690,34
KOLE,2024,1380,1390,2770,34
KOLE,2025,1420,1420,2840,34
KOTIDO,2015,930,1150,2080,34
KOTIDO,2016,970,1180,2150,34
KOTIDO,2017,990,1230,2220,34
KOTIDO,2018,1030,1270,2300,34
KOTIDO,2019,1060,1320,2380,34
KOTIDO,2020,1090,1360,2450,34
KOTIDO,2021,1140,1420,2560,34
KOTIDO,2022,1170,1480,2650,34
KOTIDO,2023,1210,1550,2760,34
KOTIDO,2024,1240,1630,2870,34
KOTIDO,2025,1290,1700,2990,34
KUMI,2015,1040,1150,2190,34
KUMI,2016,1090,1190,2280,34
KUMI,2017,1120,1250,2370,34
KUMI,2018,1170,1310,2480,34
KUMI,2019,1220,1370,2590,34
KUMI,2020,1280,1420,2700,34
KUMI,2021,1320,1490,2810,34
KUMI,2022,1380,1560,2940,34
KUMI,2023,1430,1650,3080,34
KUMI,2024,1480,1740,3220,34
KUMI,2025,1550,1830,3380,34
KWANIA,2015,790,900,1690,34
KWANIA,2016,810,920,1730,34
KWANIA,2017,840,950,1790,34
KWANIA,2018,860,980,1840,34
KWANIA,2019,890,1000,1890,34
KWANIA,2020,920,1030,1950,34
KWANIA,2021,940,1060,2000,34
KWANIA,2022,970,1090,2060,34
KWANIA,2023,1000,1110,2110,34
KWANIA,2024,1020,1140,2160,34
KWANIA,2025,1050,1170,2220,34
KWEEN,2015,510,490,1000,34
KWEEN,2016,520,510,1030,34
KWEEN,2017,540,520,1060,34
KWEEN,2018,560,530,1090,34
KWEEN,2019,570,540,1110,34
KWEEN,2020,590,560,1150,34
KWEEN,2021,610,570,1180,34
KWEEN,2022,620,580,1200,34
KWEEN,2023,640,590,1230,34
KWEEN,2024,660,610,1270,34
KWEEN,2025,670,620,1290,34
KYANKWANZI,2015,1330,1140,2470,34
KYANKWANZI,2016,1400,1190,2590,34
KYANKWANZI,2017,1470,1250,2720,34
KYANKWANZI,2018,1550,1300,2850,34
KYANKWANZI,2019,1620,1360,2980,34
KYANKWANZI,2020,1700,1430,3130,34
KYANKWANZI,2021,1790,1490,3280,34
KYANKWANZI,2022,1870,1560,3430,34
KYANKWANZI,2023,1960,1620,3580,34
KYANKWANZI,2024,2050,1690,3740,34
KYANKWANZI,2025,2150,1760,3910,34
KYEGEGWA,2015,1620,1620,3240,34
KYEGEGWA,2016,1750,1740,3490,34
KYEGEGWA,2017,1890,1880,3770,34
KYEGEGWA,2018,2050,2030,4080,34
KYEGEGWA,2019,2220,2190,4410,34
KYEGEGWA,2020,2390,2360,4750,34
KYEGEGWA,2021,2580,2540,5120,34
KYEGEGWA,2022,2790,2730,5520,34
KYEGEGWA,2023,3010,2940,5950,34
KYEGEGWA,2024,3240,3160,6400,34
KYEGEGWA,2025,3490,3390,6880,34
KYENJOJO,2015,2250,2400,4650,34
KYENJOJO,2016,2350,2490,4840,34
KYENJOJO,2017,2440,2580,5020,34
KYENJOJO,2018,2540,2680,5220,34
KYENJOJO,2019,2650,2770,5420,34
KYENJOJO,2020,2750,2870,5620,34
KYENJOJO,2021,2860,2970,5830,34
KYENJOJO,2022,2960,3070,6030,34
KYENJOJO,2023,3070,3170,6240,34
KYENJOJO,2024,3190,3280,6470,34
KYENJOJO,2025,3300,3380,6680,34
KYOTERA,2015,1240,1410,2650,34
KYOTERA,2016,1270,1450,2720,34
KYOTERA,2017,1300,1490,2790,34
KYOTERA,2018,1330,1540,2870,34
KYOTERA,2019,1370,1580,2950,34
KYOTERA,2020,1400,1630,3030,34
KYOTERA,2021,1440,1670,3110,34
KYOTERA,2022,1470,1730,3200,34
KYOTERA,2023,1500,1810,3310,34
KYOTERA,2024,1540,1870,3410,34
KYOTERA,2025,1580,1930,3510,34
KARENGA,2015,450,460,910,34
KARENGA,2016,460,470,930,34
KARENGA,2017,470,490,960,34
KARENGA,2018,490,500,990,34
KARENGA,2019,500,510,1010,34
KARENGA,2020,520,520,1040,34
KARENGA,2021,530,530,1060,34
KARENGA,2022,540,540,1080,34
KARENGA,2023,550,560,1110,34
KARENGA,2024,570,570,1140,34
KARENGA,2025,580,580,1160,34
LAMWO,2015,570,680,1250,34
LAMWO,2016,580,700,1280,34
LAMWO,2017,590,720,1310,34
LAMWO,2018,600,740,1340,34
LAMWO,2019,610,760,1370,34
LAMWO,2020,630,790,1420,34
LAMWO,2021,640,810,1450,34
LAMWO,2022,640,840,1480,34
LAMWO,2023,660,880,1540,34
LAMWO,2024,660,910,1570,34
LAMWO,2025,680,940,1620,34
LIRA,2015,2100,2130,4230,34
LIRA,2016,2170,2190,4360,34
LIRA,2017,2230,2250,4480,34
LIRA,2018,2290,2310,4600,34
LIRA,2019,2350,2380,4730,34
LIRA,2020,2410,2440,4850,34
LIRA,2021,2470,2510,4980,34
LIRA,2022,2540,2570,5110,34
LIRA,2023,2600,2640,5240,34
LIRA,2024,2660,2700,5360,34
LIRA,2025,2720,2770,5490,34
LUUKA,2015,890,1170,2060,34
LUUKA,2016,920,1210,2130,34
LUUKA,2017,940,1240,2180,34
LUUKA,2018,960,1280,2240,34
LUUKA,2019,1000,1330,2330,34
LUUKA,2020,1020,1370,2390,34
LUUKA,2021,1050,1420,2470,34
LUUKA,2022,1080,1480,2560,34
LUUKA,2023,1110,1560,2670,34
LUUKA,2024,1140,1630,2770,34
LUUKA,2025,1180,1700,2880,34
LUWERO,2015,2090,2450,4540,34
LUWERO,2016,2160,2550,4710,34
LUWERO,2017,2230,2650,4880,34
LUWERO,2018,2300,2750,5050,34
LUWERO,2019,2390,2850,5240,34
LUWERO,2020,2470,2940,5410,34
LUWERO,2021,2550,3070,5620,34
LUWERO,2022,2640,3210,5850,34
LUWERO,2023,2720,3370,6090,34
LUWERO,2024,2800,3530,6330,34
LUWERO,2025,2900,3680,6580,34
LWENGO,2015,1180,1620,2800,34
LWENGO,2016,1210,1670,2880,34
LWENGO,2017,1220,1700,2920,34
LWENGO,2018,1240,1750,2990,34
LWENGO,2019,1270,1780,3050,34
LWENGO,2020,1300,1820,3120,34
LWENGO,2021,1320,1870,3190,34
LWENGO,2022,1340,1940,3280,34
LWENGO,2023,1370,2010,3380,34
LWENGO,2024,1390,2070,3460,34
LWENGO,2025,1420,2130,3550,34
LYANTONDE,2015,500,510,1010,34
LYANTONDE,2016,520,530,1050,34
LYANTONDE,2017,540,550,1090,34
LYANTONDE,2018,560,570,1130,34
LYANTONDE,2019,580,610,1190,34
LYANTONDE,2020,610,630,1240,34
LYANTONDE,2021,620,650,1270,34
LYANTONDE,2022,660,670,1330,34
LYANTONDE,2023,680,710,1390,34
LYANTONDE,2024,710,750,1460,34
LYANTONDE,2025,730,780,1510,34
MANAFWA,2015,720,850,1570,34
MANAFWA,2016,740,870,1610,34
MANAFWA,2017,760,890,1650,34
MANAFWA,2018,780,900,1680,34
MANAFWA,2019,800,920,1720,34
MANAFWA,2020,820,940,1760,34
MANAFWA,2021,830,960,1790,34
MANAFWA,2022,850,980,1830,34
MANAFWA,2023,870,1000,1870,34
MANAFWA,2024,890,1020,1910,34
MANAFWA,2025,910,1040,1950,34
MARACHA,2015,690,1030,1720,34
MARACHA,2016,710,1050,1760,34
MARACHA,2017,720,1070,1790,34
MARACHA,2018,740,1100,1840,34
MARACHA,2019,750,1120,1870,34
MARACHA,2020,770,1130,1900,34
MARACHA,2021,780,1160,1940,34
MARACHA,2022,800,1170,1970,34
MARACHA,2023,810,1190,2000,34
MARACHA,2024,820,1210,2030,34
MARACHA,2025,840,1230,2070,34
MASAKA,2015,1500,1810,3310,34
MASAKA,2016,1540,1890,3430,34
MASAKA,2017,1590,1950,3540,34
MASAKA,2018,1640,2020,3660,34
MASAKA,2019,1690,2090,3780,34
MASAKA,2020,1750,2160,3910,34
MASAKA,2021,1800,2230,4030,34
MASAKA,2022,1860,2340,4200,34
MASAKA,2023,1910,2440,4350,34
MASAKA,2024,1960,2560,4520,34
MASAKA,2025,2020,2660,4680,34
MASINDI,2015,1690,1520,3210,34
MASINDI,2016,1740,1560,3300,34
MASINDI,2017,1790,1600,3390,34
MASINDI,2018,1840,1640,3480,34
MASINDI,2019,1890,1690,3580,34
MASINDI,2020,1940,1730,3670,34
MASINDI,2021,1990,1770,3760,34
MASINDI,2022,2050,1810,3860,34
MASINDI,2023,2100,1860,3960,34
MASINDI,2024,2150,1900,4050,34
MASINDI,2025,2200,1940,4140,34
MAYUGE,2015,1920,2370,4290,34
MAYUGE,2016,2000,2490,4490,34
MAYUGE,2017,2080,2600,4680,34
MAYUGE,2018,2160,2730,4890,34
MAYUGE,2019,2240,2840,5080,34
MAYUGE,2020,2340,2970,5310,34
MAYUGE,2021,2440,3110,5550,34
MAYUGE,2022,2530,3270,5800,34
MAYUGE,2023,2630,3460,6090,34
MAYUGE,2024,2720,3660,6380,34
MAYUGE,2025,2830,3850,6680,34
MBALE,2015,2560,2990,5550,34
MBALE,2016,2670,3140,5810,34
MBALE,2017,2770,3290,6060,34
MBALE,2018,2880,3450,6330,34
MBALE,2019,2990,3610,6600,34
MBALE,2020,3110,3770,6880,34
MBALE,2021,3240,3970,7210,34
MBALE,2022,3360,4200,7560,34
MBALE,2023,3480,4450,7930,34
MBALE,2024,3610,4710,8320,34
MBALE,2025,3740,4960,8700,34
MBARARA,2015,2160,2240,4400,34
MBARARA,2016,2210,2290,4500,34
MBARARA,2017,2260,2340,4600,34
MBARARA,2018,2310,2390,4700,34
MBARARA,2019,2360,2440,4800,34
MBARARA,2020,2410,2490,4900,34
MBARARA,2021,2470,2530,5000,34
MBARARA,2022,2510,2580,5090,34
MBARARA,2023,2560,2630,5190,34
MBARARA,2024,2610,2670,5280,34
MBARARA,2025,2660,2720,5380,34
MITOOMA,2015,750,1160,1910,34
MITOOMA,2016,750,1170,1920,34
MITOOMA,2017,760,1180,1940,34
MITOOMA,2018,770,1190,1960,34
MITOOMA,2019,780,1200,1980,34
MITOOMA,2020,790,1210,2000,34
MITOOMA,2021,800,1220,2020,34
MITOOMA,2022,800,1220,2020,34
MITOOMA,2023,810,1230,2040,34
MITOOMA,2024,820,1240,2060,34
MITOOMA,2025,820,1240,2060,34
MITYANA,2015,1470,1650,3120,34
MITYANA,2016,1510,1710,3220,34
MITYANA,2017,1550,1770,3320,34
MITYANA,2018,1600,1810,3410,34
MITYANA,2019,1640,1870,3510,34
MITYANA,2020,1690,1920,3610,34
MITYANA,2021,1740,1990,3730,34
MITYANA,2022,1780,2060,3840,34
MITYANA,2023,1820,2150,3970,34
MITYANA,2024,1860,2230,4090,34
MITYANA,2025,1910,2310,4220,34
MOROTO,2015,580,640,1220,34
MOROTO,2016,610,660,1270,34
MOROTO,2017,620,690,1310,34
MOROTO,2018,650,720,1370,34
MOROTO,2019,660,740,1400,34
MOROTO,2020,680,770,1450,34
MOROTO,2021,710,810,1520,34
MOROTO,2022,720,840,1560,34
MOROTO,2023,750,890,1640,34
MOROTO,2024,770,930,1700,34
MOROTO,2025,790,980,1770,34
MOYO,2015,520,600,1120,34
MOYO,2016,540,610,1150,34
MOYO,2017,550,620,1170,34
MOYO,2018,560,640,1200,34
MOYO,2019,580,650,1230,34
MOYO,2020,590,670,1260,34
MOYO,2021,600,680,1280,34
MOYO,2022,620,690,1310,34
MOYO,2023,630,700,1330,34
MOYO,2024,650,720,1370,34
MOYO,2025,660,730,1390,34
MPIGI,2015,1210,1260,2470,34
MPIGI,2016,1250,1310,2560,34
MPIGI,2017,1290,1360,2650,34
MPIGI,2018,1330,1410,2740,34
MPIGI,2019,1380,1460,2840,34
MPIGI,2020,1420,1520,2940,34
MPIGI,2021,1470,1580,3050,34
MPIGI,2022,1510,1650,3160,34
MPIGI,2023,1570,1740,3310,34
MPIGI,2024,1610,1810,3420,34
MPIGI,2025,1650,1890,3540,34
MUBENDE,2015,2310,2360,4670,34
MUBENDE,2016,2450,2520,4970,34
MUBENDE,2017,2600,2700,5300,34
MUBENDE,2018,2760,2880,5640,34
MUBENDE,2019,2930,3060,5990,34
MUBENDE,2020,3120,3260,6380,34
MUBENDE,2021,3310,3490,6800,34
MUBENDE,2022,3520,3750,7270,34
MUBENDE,2023,3720,4040,7760,34
MUBENDE,2024,3940,4360,8300,34
MUBENDE,2025,4180,4670,8850,34
MUKONO,2015,2950,3380,6330,34
MUKONO,2016,3050,3530,6580,34
MUKONO,2017,3160,3690,6850,34
MUKONO,2018,3260,3850,7110,34
MUKONO,2019,3390,4020,7410,34
MUKONO,2020,3520,4190,7710,34
MUKONO,2021,3650,4390,8040,34
MUKONO,2022,3770,4620,8390,34
MUKONO,2023,3900,4880,8780,34
MUKONO,2024,4030,5140,9170,34
MUKONO,2025,4160,5400,9560,34
MADI OKOLLO,2015,570,690,1260,34
MADI OKOLLO,2016,580,710,1290,34
MADI OKOLLO,2017,600,730,1330,34
MADI OKOLLO,2018,620,750,1370,34
MADI OKOLLO,2019,640,770,1410,34
MADI OKOLLO,2020,660,790,1450,34
MADI OKOLLO,2021,670,810,1480,34
MADI OKOLLO,2022,690,830,1520,34
MADI OKOLLO,2023,710,850,1560,34
MADI OKOLLO,2024,720,870,1590,34
MADI OKOLLO,2025,740,890,1630,34
NABILATUK,2015,360,400,760,34
NABILATUK,2016,380,410,790,34
NABILATUK,2017,400,440,840,34
NABILATUK,2018,420,470,890,34
NABILATUK,2019,450,490,940,34
NABILATUK,2020,470,520,990,34
NABILATUK,2021,500,560,1060,34
NABILATUK,2022,540,590,1130,34
NABILATUK,2023,560,630,1190,34
NABILATUK,2024,600,690,1290,34
NABILATUK,2025,630,730,1360,34
NAKAPIRIPIRIT,2015,510,680,1190,34
NAKAPIRIPIRIT,2016,550,720,1270,34
NAKAPIRIPIRIT,2017,570,760,1330,34
NAKAPIRIPIRIT,2018,610,810,1420,34
NAKAPIRIPIRIT,2019,630,850,1480,34
NAKAPIRIPIRIT,2020,670,890,1560,34
NAKAPIRIPIRIT,2021,710,960,1670,34
NAKAPIRIPIRIT,2022,750,1020,1770,34
NAKAPIRIPIRIT,2023,780,1090,1870,34
NAKAPIRIPIRIT,2024,820,1160,1980,34
NAKAPIRIPIRIT,2025,860,1240,2100,34
NAKASEKE,2015,1330,1020,2350,34
NAKASEKE,2016,1380,1040,2420,34
NAKASEKE,2017,1430,1060,2490,34
NAKASEKE,2018,1490,1090,2580,34
NAKASEKE,2019,1540,1110,2650,34
NAKASEKE,2020,1590,1140,2730,34
NAKASEKE,2021,1650,1170,2820,34
NAKASEKE,2022,1700,1190,2890,34
NAKASEKE,2023,1760,1210,2970,34
NAKASEKE,2024,1820,1240,3060,34
NAKASEKE,2025,1870,1260,3130,34
NAKASONGOLA,2015,1040,940,1980,34
NAKASONGOLA,2016,1090,980,2070,34
NAKASONGOLA,2017,1120,1020,2140,34
NAKASONGOLA,2018,1170,1060,2230,34
NAKASONGOLA,2019,1220,1110,2330,34
NAKASONGOLA,2020,1280,1150,2430,34
NAKASONGOLA,2021,1320,1200,2520,34
NAKASONGOLA,2022,1380,1270,2650,34
NAKASONGOLA,2023,1430,1330,2760,34
NAKASONGOLA,2024,1480,1400,2880,34
NAKASONGOLA,2025,1550,1460,3010,34
NAMAYINGO,2015,1110,1200,2310,34
NAMAYINGO,2016,1140,1230,2370,34
NAMAYINGO,2017,1160,1260,2420,34
NAMAYINGO,2018,1190,1310,2500,34
NAMAYINGO,2019,1220,1340,2560,34
NAMAYINGO,2020,1270,1370,2640,34
NAMAYINGO,2021,1300,1420,2720,34
NAMAYINGO,2022,1330,1470,2800,34
NAMAYINGO,2023,1370,1540,2910,34
NAMAYINGO,2024,1400,1590,2990,34
NAMAYINGO,2025,1440,1660,3100,34
NAMISINDWA,2015,1030,1090,2120,34
NAMISINDWA,2016,1060,1120,2180,34
NAMISINDWA,2017,1090,1140,2230,34
NAMISINDWA,2018,1120,1170,2290,34
NAMISINDWA,2019,1150,1200,2350,34
NAMISINDWA,2020,1180,1220,2400,34
NAMISINDWA,2021,1210,1250,2460,34
NAMISINDWA,2022,1240,1280,2520,34
NAMISINDWA,2023,1270,1300,2570,34
NAMISINDWA,2024,1300,1330,2630,34
NAMISINDWA,2025,1330,1350,2680,34
NAMUTUMBA,2015,930,1250,2180,34
NAMUTUMBA,2016,980,1310,2290,34
NAMUTUMBA,2017,1010,1370,2380,34
NAMUTUMBA,2018,1060,1430,2490,34
NAMUTUMBA,2019,1110,1490,2600,34
NAMUTUMBA,2020,1150,1560,2710,34
NAMUTUMBA,2021,1210,1650,2860,34
NAMUTUMBA,2022,1260,1730,2990,34
NAMUTUMBA,2023,1310,1840,3150,34
NAMUTUMBA,2024,1370,1940,3310,34
NAMUTUMBA,2025,1430,2050,3480,34
NAPAK,2015,610,910,1520,34
NAPAK,2016,630,950,1580,34
NAPAK,2017,640,980,1620,34
NAPAK,2018,660,1020,1680,34
NAPAK,2019,670,1040,1710,34
NAPAK,2020,690,1080,1770,34
NAPAK,2021,710,1120,1830,34
NAPAK,2022,720,1170,1890,34
NAPAK,2023,740,1230,1970,34
NAPAK,2024,760,1280,2040,34
NAPAK,2025,780,1340,2120,34
NEBBI,2015,920,1150,2070,34
NEBBI,2016,950,1190,2140,34
NEBBI,2017,990,1220,2210,34
NEBBI,2018,1020,1260,2280,34
NEBBI,2019,1050,1290,2340,34
NEBBI,2020,1080,1320,2400,34
NEBBI,2021,1110,1360,2470,34
NEBBI,2022,1140,1390,2530,34
NEBBI,2023,1170,1430,2600,34
NEBBI,2024,1210,1460,2670,34
NEBBI,2025,1240,1500,2740,34
NGORA,2015,530,530,1060,34
NGORA,2016,560,550,1110,34
NGORA,2017,570,570,1140,34
NGORA,2018,600,590,1190,34
NGORA,2019,620,610,1230,34
NGORA,2020,640,640,1280,34
NGORA,2021,670,670,1340,34
NGORA,2022,690,710,1400,34
NGORA,2023,710,740,1450,34
NGORA,2024,740,770,1510,34
NGORA,2025,770,820,1590,34
NTOROKO,2015,350,340,690,34
NTOROKO,2016,360,360,720,34
NTOROKO,2017,370,370,740,34
NTOROKO,2018,380,380,760,34
NTOROKO,2019,400,400,800,34
NTOROKO,2020,410,400,810,34
NTOROKO,2021,430,420,850,34
NTOROKO,2022,440,440,880,34
NTOROKO,2023,460,460,920,34
NTOROKO,2024,470,480,950,34
NTOROKO,2025,480,500,980,34
NTUNGAMO,2015,2430,3070,5500,34
NTUNGAMO,2016,2480,3120,5600,34
NTUNGAMO,2017,2530,3180,5710,34
NTUNGAMO,2018,2590,3240,5830,34
NTUNGAMO,2019,2640,3300,5940,34
NTUNGAMO,2020,2690,3350,6040,34
NTUNGAMO,2021,2740,3410,6150,34
NTUNGAMO,2022,2790,3460,6250,34
NTUNGAMO,2023,2840,3520,6360,34
NTUNGAMO,2024,2890,3570,6460,34
NTUNGAMO,2025,2940,3620,6560,34
NWOYA,2015,680,650,1330,34
NWOYA,2016,750,720,1470,34
NWOYA,2017,830,790,1620,34
NWOYA,2018,910,870,1780,34
NWOYA,2019,1010,960,1970,34
NWOYA,2020,1110,1050,2160,34
NWOYA,2021,1230,1160,2390,34
NWOYA,2022,1350,1270,2620,34
NWOYA,2023,1490,1400,2890,34
NWOYA,2024,1640,1530,3170,34
NWOYA,2025,1800,1680,3480,34
OBONGI,2015,170,190,360,34
OBONGI,2016,180,210,390,34
OBONGI,2017,180,210,390,34
OBONGI,2018,190,220,410,34
OBONGI,2019,190,230,420,34
OBONGI,2020,210,240,450,34
OBONGI,2021,210,240,450,34
OBONGI,2022,220,250,470,34
OBONGI,2023,220,270,490,34
OBONGI,2024,220,280,500,34
OBONGI,2025,240,300,540,34
OMORO,2015,570,750,1320,34
OMORO,2016,600,780,1380,34
OMORO,2017,630,830,1460,34
OMORO,2018,660,870,1530,34
OMORO,2019,680,900,1580,34
OMORO,2020,720,950,1670,34
OMORO,2021,750,1000,1750,34
OMORO,2022,780,1060,1840,34
OMORO,2023,820,1130,1950,34
OMORO,2024,840,1200,2040,34
OMORO,2025,890,1260,2150,34
OTUKE,2015,540,500,1040,34
OTUKE,2016,560,530,1090,34
OTUKE,2017,580,550,1130,34
OTUKE,2018,610,570,1180,34
OTUKE,2019,640,600,1240,34
OTUKE,2020,670,620,1290,34
OTUKE,2021,690,650,1340,34
OTUKE,2022,720,670,1390,34
OTUKE,2023,750,700,1450,34
OTUKE,2024,780,730,1510,34
OTUKE,2025,810,750,1560,34
OYAM,2015,1680,1940,3620,34
OYAM,2016,1740,2000,3740,34
OYAM,2017,1790,2060,3850,34
OYAM,2018,1840,2120,3960,34
OYAM,2019,1900,2180,4080,34
OYAM,2020,1950,2240,4190,34
OYAM,2021,2010,2300,4310,34
OYAM,2022,2060,2360,4420,34
OYAM,2023,2120,2420,4540,34
OYAM,2024,2170,2480,4650,34
OYAM,2025,2230,2540,4770,34
PADER,2015,710,810,1520,34
PADER,2016,730,840,1570,34
PADER,2017,740,870,1610,34
PADER,2018,770,900,1670,34
PADER,2019,790,940,1730,34
PADER,2020,800,960,1760,34
PADER,2021,830,1000,1830,34
PADER,2022,850,1040,1890,34
PADER,2023,870,1080,1950,34
PADER,2024,890,1140,2030,34
PADER,2025,910,1180,2090,34
PAKWACH,2015,690,740,1430,34
PAKWACH,2016,720,770,1490,34
PAKWACH,2017,750,790,1540,34
PAKWACH,2018,780,820,1600,34
PAKWACH,2019,810,850,1660,34
PAKWACH,2020,840,880,1720,34
PAKWACH,2021,880,910,1790,34
PAKWACH,2022,910,940,1850,34
PAKWACH,2023,940,970,1910,34
PAKWACH,2024,980,1000,1980,34
PAKWACH,2025,1010,1040,2050,34
PALLISA,2015,1060,1320,2380,34
PALLISA,2016,1120,1400,2520,34
PALLISA,2017,1170,1480,2650,34
PALLISA,2018,1230,1570,2800,34
PALLISA,2019,1310,1660,2970,34
PALLISA,2020,1370,1760,3130,34
PALLISA,2021,1450,1860,3310,34
PALLISA,2022,1520,1980,3500,34
PALLISA,2023,1600,2120,3720,34
PALLISA,2024,1690,2270,3960,34
PALLISA,2025,1770,2410,4180,34
RAKAI,2015,1340,1650,2990,34
RAKAI,2016,1380,1720,3100,34
RAKAI,2017,1420,1790,3210,34
RAKAI,2018,1470,1850,3320,34
RAKAI,2019,1530,1910,3440,34
RAKAI,2020,1590,1990,3580,34
RAKAI,2021,1640,2070,3710,34
RAKAI,2022,1690,2160,3850,34
RAKAI,2023,1750,2260,4010,34
RAKAI,2024,1790,2380,4170,34
RAKAI,2025,1860,2480,4340,34
RUBANDA,2015,860,1130,1990,34
RUBANDA,2016,870,1140,2010,34
RUBANDA,2017,880,1150,2030,34
RUBANDA,2018,890,1160,2050,34
RUBANDA,2019,900,1170,2070,34
RUBANDA,2020,910,1170,2080,34
RUBANDA,2021,920,1180,2100,34
RUBANDA,2022,930,1190,2120,34
RUBANDA,2023,940,1190,2130,34
RUBANDA,2024,950,1200,2150,34
RUBANDA,2025,960,1200,2160,34
RUBIRIZI,2015,550,760,1310,34
RUBIRIZI,2016,560,780,1340,34
RUBIRIZI,2017,570,790,1360,34
RUBIRIZI,2018,580,810,1390,34
RUBIRIZI,2019,590,820,1410,34
RUBIRIZI,2020,600,840,1440,34
RUBIRIZI,2021,610,850,1460,34
RUBIRIZI,2022,620,870,1490,34
RUBIRIZI,2023,630,880,1510,34
RUBIRIZI,2024,640,890,1530,34
RUBIRIZI,2025,650,910,1560,34
RUKIGA,2015,500,570,1070,34
RUKIGA,2016,510,580,1090,34
RUKIGA,2017,510,580,1090,34
RUKIGA,2018,520,590,1110,34
RUKIGA,2019,520,590,1110,34
RUKIGA,2020,530,590,1120,34
RUKIGA,2021,530,600,1130,34
RUKIGA,2022,540,600,1140,34
RUKIGA,2023,540,600,1140,34
RUKIGA,2024,540,600,1140,34
RUKIGA,2025,550,600,1150,34
RUKUNGIRI,2015,1470,2020,3490,34
RUKUNGIRI,2016,1490,2040,3530,34
RUKUNGIRI,2017,1510,2060,3570,34
RUKUNGIRI,2018,1530,2080,3610,34
RUKUNGIRI,2019,1540,2100,3640,34
RUKUNGIRI,2020,1560,2120,3680,34
RUKUNGIRI,2021,1580,2140,3720,34
RUKUNGIRI,2022,1590,2150,3740,34
RUKUNGIRI,2023,1600,2160,3760,34
RUKUNGIRI,2024,1620,2180,3800,34
RUKUNGIRI,2025,1630,2190,3820,34
RWAMPARA,2015,650,750,1400,34
RWAMPARA,2016,670,760,1430,34
RWAMPARA,2017,680,780,1460,34
RWAMPARA,2018,700,800,1500,34
RWAMPARA,2019,710,810,1520,34
RWAMPARA,2020,730,830,1560,34
RWAMPARA,2021,740,840,1580,34
RWAMPARA,2022,760,860,1620,34
RWAMPARA,2023,770,880,1650,34
RWAMPARA,2024,790,890,1680,34
RWAMPARA,2025,800,910,1710,34
SERERE,2015,1100,1190,2290,34
SERERE,2016,1160,1260,2420,34
SERERE,2017,1210,1330,2540,34
SERERE,2018,1270,1400,2670,34
SERERE,2019,1340,1470,2810,34
SERERE,2020,1410,1550,2960,34
SERERE,2021,1480,1630,3110,34
SERERE,2022,1550,1750,3300,34
SERERE,2023,1620,1850,3470,34
SERERE,2024,1700,1980,3680,34
SERERE,2025,1780,2100,3880,34
SHEEMA,2015,1040,1360,2400,34
SHEEMA,2016,1060,1370,2430,34
SHEEMA,2017,1070,1390,2460,34
SHEEMA,2018,1080,1400,2480,34
SHEEMA,2019,1100,1410,2510,34
SHEEMA,2020,1110,1430,2540,34
SHEEMA,2021,1120,1440,2560,34
SHEEMA,2022,1130,1450,2580,34
SHEEMA,2023,1140,1460,2600,34
SHEEMA,2024,1150,1470,2620,34
SHEEMA,2025,1150,1480,2630,34
SIRONKO,2015,1320,1380,2700,34
SIRONKO,2016,1350,1410,2760,34
SIRONKO,2017,1390,1440,2830,34
SIRONKO,2018,1420,1470,2890,34
SIRONKO,2019,1450,1490,2940,34
SIRONKO,2020,1480,1520,3000,34
SIRONKO,2021,1520,1550,3070,34
SIRONKO,2022,1550,1580,3130,34
SIRONKO,2023,1580,1610,3190,34
SIRONKO,2024,1610,1630,3240,34
SIRONKO,2025,1640,1660,3300,34
SOROTI,2015,1380,1360,2740,34
SOROTI,2016,1440,1430,2870,34
SOROTI,2017,1500,1510,3010,34
SOROTI,2018,1570,1580,3150,34
SOROTI,2019,1640,1660,3300,34
SOROTI,2020,1720,1730,3450,34
SOROTI,2021,1800,1820,3620,34
SOROTI,2022,1880,1930,3810,34
SOROTI,2023,1960,2050,4010,34
SOROTI,2024,2040,2170,4210,34
SOROTI,2025,2130,2300,4430,34
SSEMBABULE,2015,1380,1650,3030,34
SSEMBABULE,2016,1420,1720,3140,34
SSEMBABULE,2017,1480,1800,3280,34
SSEMBABULE,2018,1540,1870,3410,34
SSEMBABULE,2019,1590,1950,3540,34
SSEMBABULE,2020,1660,2020,3680,34
SSEMBABULE,2021,1720,2110,3830,34
SSEMBABULE,2022,1790,2210,4000,34
SSEMBABULE,2023,1840,2330,4170,34
SSEMBABULE,2024,1910,2450,4360,34
SSEMBABULE,2025,1980,2570,4550,34
TORORO,2015,2270,2910,5180,34
TORORO,2016,2330,2990,5320,34
TORORO,2017,2400,3060,5460,34
TORORO,2018,2460,3140,5600,34
TORORO,2019,2520,3210,5730,34
TORORO,2020,2580,3290,5870,34
TORORO,2021,2650,3360,6010,34
TORORO,2022,2710,3440,6150,34
TORORO,2023,2770,3510,6280,34
TORORO,2024,2830,3590,6420,34
TORORO,2025,2890,3660,6550,34
WAKISO,2015,13320,13920,27240,34
WAKISO,2016,14210,14860,29070,34
WAKISO,2017,15160,15890,31050,34
WAKISO,2018,16170,16960,33130,34
WAKISO,2019,17240,18100,35340,34
WAKISO,2020,18370,19300,37670,34
WAKISO,2021,19550,20580,40130,34
WAKISO,2022,20800,21940,42740,34
WAKISO,2023,22120,23350,45470,34
WAKISO,2024,23500,24840,48340,34
WAKISO,2025,24940,26420,51360,34
YUMBE,2015,1770,2110,3880,34
YUMBE,2016,1870,2280,4150,34
YUMBE,2017,1990,2450,4440,34
YUMBE,2018,2100,2620,4720,34
YUMBE,2019,2230,2820,5050,34
YUMBE,2020,2370,3020,5390,34
YUMBE,2021,2520,3260,5780,34
YUMBE,2022,2670,3520,6190,34
YUMBE,2023,2820,3820,6640,34
YUMBE,2024,2980,4150,7130,34
YUMBE,2025,3160,4490,7650,34
ZOMBO,2015,900,1190,2090,34
ZOMBO,2016,930,1220,2150,34
ZOMBO,2017,960,1260,2220,34
ZOMBO,2018,990,1290,2280,34
ZOMBO,2019,1020,1330,2350,34
ZOMBO,2020,1050,1360,2410,34
ZOMBO,2021,1080,1400,2480,34
ZOMBO,2022,1110,1430,2540,34
ZOMBO,2023,1140,1470,2610,34
ZOMBO,2024,1170,1500,2670,34
ZOMBO,2025,1200,1540,2740,34
ABIM,2015,420,570,990,35
ABIM,2016,460,620,1080,35
ABIM,2017,490,660,1150,35
ABIM,2018,520,720,1240,35
ABIM,2019,560,770,1330,35
ABIM,2020,600,820,1420,35
ABIM,2021,650,890,1540,35
ABIM,2022,700,950,1650,35
ABIM,2023,740,1040,1780,35
ABIM,2024,800,1130,1930,35
ABIM,2025,850,1230,2080,35
ADJUMANI,2015,1120,1610,2730,35
ADJUMANI,2016,1130,1630,2760,35
ADJUMANI,2017,1140,1650,2790,35
ADJUMANI,2018,1150,1660,2810,35
ADJUMANI,2019,1160,1680,2840,35
ADJUMANI,2020,1160,1690,2850,35
ADJUMANI,2021,1170,1700,2870,35
ADJUMANI,2022,1170,1720,2890,35
ADJUMANI,2023,1180,1730,2910,35
ADJUMANI,2024,1180,1740,2920,35
ADJUMANI,2025,1180,1750,2930,35
AGAGO,2015,1290,1400,2690,35
AGAGO,2016,1310,1420,2730,35
AGAGO,2017,1330,1450,2780,35
AGAGO,2018,1360,1470,2830,35
AGAGO,2019,1380,1500,2880,35
AGAGO,2020,1400,1520,2920,35
AGAGO,2021,1420,1540,2960,35
AGAGO,2022,1440,1570,3010,35
AGAGO,2023,1460,1590,3050,35
AGAGO,2024,1480,1610,3090,35
AGAGO,2025,1500,1630,3130,35
ALEBTONG,2015,990,1180,2170,35
ALEBTONG,2016,1020,1220,2240,35
ALEBTONG,2017,1060,1280,2340,35
ALEBTONG,2018,1100,1330,2430,35
ALEBTONG,2019,1140,1390,2530,35
ALEBTONG,2020,1180,1450,2630,35
ALEBTONG,2021,1230,1510,2740,35
ALEBTONG,2022,1280,1570,2850,35
ALEBTONG,2023,1320,1650,2970,35
ALEBTONG,2024,1360,1740,3100,35
ALEBTONG,2025,1410,1830,3240,35
AMOLATAR,2015,630,690,1320,35
AMOLATAR,2016,660,720,1380,35
AMOLATAR,2017,680,750,1430,35
AMOLATAR,2018,700,780,1480,35
AMOLATAR,2019,730,810,1540,35
AMOLATAR,2020,750,830,1580,35
AMOLATAR,2021,790,870,1660,35
AMOLATAR,2022,810,910,1720,35
AMOLATAR,2023,830,950,1780,35
AMOLATAR,2024,870,1000,1870,35
AMOLATAR,2025,890,1050,1940,35
AMUDAT,2015,560,560,1120,35
AMUDAT,2016,580,590,1170,35
AMUDAT,2017,610,630,1240,35
AMUDAT,2018,640,670,1310,35
AMUDAT,2019,670,710,1380,35
AMUDAT,2020,710,750,1460,35
AMUDAT,2021,740,800,1540,35
AMUDAT,2022,770,850,1620,35
AMUDAT,2023,810,910,1720,35
AMUDAT,2024,840,980,1820,35
AMUDAT,2025,880,1050,1930,35
AMURIA,2015,700,980,1680,35
AMURIA,2016,730,1030,1760,35
AMURIA,2017,760,1080,1840,35
AMURIA,2018,800,1140,1940,35
AMURIA,2019,840,1190,2030,35
AMURIA,2020,870,1260,2130,35
AMURIA,2021,920,1310,2230,35
AMURIA,2022,960,1380,2340,35
AMURIA,2023,1000,1460,2460,35
AMURIA,2024,1050,1540,2590,35
AMURIA,2025,1090,1640,2730,35
AMURU,2015,940,1030,1970,35
AMURU,2016,980,1070,2050,35
AMURU,2017,1010,1120,2130,35
AMURU,2018,1050,1170,2220,35
AMURU,2019,1080,1210,2290,35
AMURU,2020,1120,1260,2380,35
AMURU,2021,1160,1310,2470,35
AMURU,2022,1200,1370,2570,35
AMURU,2023,1240,1440,2680,35
AMURU,2024,1280,1520,2800,35
AMURU,2025,1320,1590,2910,35
APAC,2015,1130,1140,2270,35
APAC,2016,1170,1180,2350,35
APAC,2017,1210,1220,2430,35
APAC,2018,1260,1260,2520,35
APAC,2019,1300,1310,2610,35
APAC,2020,1350,1350,2700,35
APAC,2021,1400,1390,2790,35
APAC,2022,1440,1440,2880,35
APAC,2023,1490,1480,2970,35
APAC,2024,1540,1530,3070,35
APAC,2025,1590,1570,3160,35
ARUA,2015,3820,4600,8420,35
ARUA,2016,3930,4720,8650,35
ARUA,2017,4040,4860,8900,35
ARUA,2018,4160,4980,9140,35
ARUA,2019,4270,5120,9390,35
ARUA,2020,4390,5250,9640,35
ARUA,2021,4510,5380,9890,35
ARUA,2022,4620,5510,10130,35
ARUA,2023,4740,5640,10380,35
ARUA,2024,4860,5770,10630,35
ARUA,2025,4970,5900,10870,35
BUDAKA,2015,620,890,1510,35
BUDAKA,2016,640,930,1570,35
BUDAKA,2017,680,980,1660,35
BUDAKA,2018,710,1030,1740,35
BUDAKA,2019,740,1080,1820,35
BUDAKA,2020,770,1130,1900,35
BUDAKA,2021,810,1180,1990,35
BUDAKA,2022,840,1240,2080,35
BUDAKA,2023,880,1310,2190,35
BUDAKA,2024,910,1390,2300,35
BUDAKA,2025,960,1480,2440,35
BUDUDA,2015,590,650,1240,35
BUDUDA,2016,630,690,1320,35
BUDUDA,2017,660,730,1390,35
BUDUDA,2018,700,780,1480,35
BUDUDA,2019,740,820,1560,35
BUDUDA,2020,780,870,1650,35
BUDUDA,2021,830,920,1750,35
BUDUDA,2022,870,970,1840,35
BUDUDA,2023,910,1040,1950,35
BUDUDA,2024,960,1110,2070,35
BUDUDA,2025,1010,1200,2210,35
BUGIRI,2015,1360,1740,3100,35
BUGIRI,2016,1420,1840,3260,35
BUGIRI,2017,1490,1950,3440,35
BUGIRI,2018,1560,2050,3610,35
BUGIRI,2019,1650,2160,3810,35
BUGIRI,2020,1730,2270,4000,35
BUGIRI,2021,1820,2400,4220,35
BUGIRI,2022,1910,2530,4440,35
BUGIRI,2023,2000,2690,4690,35
BUGIRI,2024,2090,2870,4960,35
BUGIRI,2025,2190,3050,5240,35
BUGWERI,2015,620,930,1550,35
BUGWERI,2016,640,970,1610,35
BUGWERI,2017,670,1020,1690,35
BUGWERI,2018,690,1060,1750,35
BUGWERI,2019,720,1100,1820,35
BUGWERI,2020,750,1140,1890,35
BUGWERI,2021,780,1180,1960,35
BUGWERI,2022,800,1240,2040,35
BUGWERI,2023,830,1300,2130,35
BUGWERI,2024,860,1360,2220,35
BUGWERI,2025,880,1430,2310,35
BUHWEJU,2015,670,680,1350,35
BUHWEJU,2016,700,710,1410,35
BUHWEJU,2017,720,730,1450,35
BUHWEJU,2018,740,750,1490,35
BUHWEJU,2019,770,770,1540,35
BUHWEJU,2020,790,790,1580,35
BUHWEJU,2021,810,820,1630,35
BUHWEJU,2022,840,840,1680,35
BUHWEJU,2023,860,860,1720,35
BUHWEJU,2024,890,880,1770,35
BUHWEJU,2025,910,910,1820,35
BUIKWE,2015,2180,2400,4580,35
BUIKWE,2016,2240,2490,4730,35
BUIKWE,2017,2310,2580,4890,35
BUIKWE,2018,2370,2680,5050,35
BUIKWE,2019,2440,2770,5210,35
BUIKWE,2020,2510,2860,5370,35
BUIKWE,2021,2590,2960,5550,35
BUIKWE,2022,2660,3070,5730,35
BUIKWE,2023,2740,3210,5950,35
BUIKWE,2024,2810,3350,6160,35
BUIKWE,2025,2880,3510,6390,35
BUKEDEA,2015,760,930,1690,35
BUKEDEA,2016,800,990,1790,35
BUKEDEA,2017,850,1050,1900,35
BUKEDEA,2018,890,1110,2000,35
BUKEDEA,2019,940,1170,2110,35
BUKEDEA,2020,990,1230,2220,35
BUKEDEA,2021,1050,1300,2350,35
BUKEDEA,2022,1100,1370,2470,35
BUKEDEA,2023,1160,1460,2620,35
BUKEDEA,2024,1220,1560,2780,35
BUKEDEA,2025,1280,1670,2950,35
BUKOMANSIMBI,2015,710,790,1500,35
BUKOMANSIMBI,2016,720,820,1540,35
BUKOMANSIMBI,2017,730,830,1560,35
BUKOMANSIMBI,2018,740,840,1580,35
BUKOMANSIMBI,2019,750,870,1620,35
BUKOMANSIMBI,2020,770,880,1650,35
BUKOMANSIMBI,2021,780,890,1670,35
BUKOMANSIMBI,2022,790,910,1700,35
BUKOMANSIMBI,2023,800,940,1740,35
BUKOMANSIMBI,2024,820,970,1790,35
BUKOMANSIMBI,2025,820,1000,1820,35
BUKWO,2015,410,430,840,35
BUKWO,2016,440,450,890,35
BUKWO,2017,460,480,940,35
BUKWO,2018,480,500,980,35
BUKWO,2019,510,520,1030,35
BUKWO,2020,530,550,1080,35
BUKWO,2021,560,570,1130,35
BUKWO,2022,590,600,1190,35
BUKWO,2023,620,630,1250,35
BUKWO,2024,650,660,1310,35
BUKWO,2025,680,690,1370,35
BULAMBULI,2015,620,690,1310,35
BULAMBULI,2016,660,730,1390,35
BULAMBULI,2017,700,780,1480,35
BULAMBULI,2018,740,840,1580,35
BULAMBULI,2019,780,890,1670,35
BULAMBULI,2020,830,940,1770,35
BULAMBULI,2021,880,1000,1880,35
BULAMBULI,2022,930,1070,2000,35
BULAMBULI,2023,990,1150,2140,35
BULAMBULI,2024,1040,1230,2270,35
BULAMBULI,2025,1100,1320,2420,35
BULIISA,2015,730,660,1390,35
BULIISA,2016,760,690,1450,35
BULIISA,2017,810,720,1530,35
BULIISA,2018,850,760,1610,35
BULIISA,2019,890,790,1680,35
BULIISA,2020,940,820,1760,35
BULIISA,2021,990,860,1850,35
BULIISA,2022,1040,890,1930,35
BULIISA,2023,1090,930,2020,35
BULIISA,2024,1150,970,2120,35
BULIISA,2025,1200,1010,2210,35
BUNDIBUGYO,2015,1200,1560,2760,35
BUNDIBUGYO,2016,1240,1630,2870,35
BUNDIBUGYO,2017,1280,1690,2970,35
BUNDIBUGYO,2018,1340,1770,3110,35
BUNDIBUGYO,2019,1390,1840,3230,35
BUNDIBUGYO,2020,1440,1910,3350,35
BUNDIBUGYO,2021,1500,2000,3500,35
BUNDIBUGYO,2022,1560,2080,3640,35
BUNDIBUGYO,2023,1620,2190,3810,35
BUNDIBUGYO,2024,1670,2300,3970,35
BUNDIBUGYO,2025,1730,2430,4160,35
BUNYANGABU,2015,780,930,1710,35
BUNYANGABU,2016,800,970,1770,35
BUNYANGABU,2017,830,1010,1840,35
BUNYANGABU,2018,850,1040,1890,35
BUNYANGABU,2019,890,1080,1970,35
BUNYANGABU,2020,920,1120,2040,35
BUNYANGABU,2021,940,1160,2100,35
BUNYANGABU,2022,980,1210,2190,35
BUNYANGABU,2023,1010,1260,2270,35
BUNYANGABU,2024,1050,1320,2370,35
BUNYANGABU,2025,1070,1380,2450,35
BUSHENYI,2015,1580,1740,3320,35
BUSHENYI,2016,1600,1760,3360,35
BUSHENYI,2017,1620,1780,3400,35
BUSHENYI,2018,1640,1790,3430,35
BUSHENYI,2019,1660,1810,3470,35
BUSHENYI,2020,1680,1820,3500,35
BUSHENYI,2021,1690,1830,3520,35
BUSHENYI,2022,1710,1840,3550,35
BUSHENYI,2023,1720,1850,3570,35
BUSHENYI,2024,1740,1860,3600,35
BUSHENYI,2025,1750,1870,3620,35
BUSIA,2015,1330,1520,2850,35
BUSIA,2016,1390,1590,2980,35
BUSIA,2017,1440,1670,3110,35
BUSIA,2018,1500,1740,3240,35
BUSIA,2019,1560,1820,3380,35
BUSIA,2020,1620,1900,3520,35
BUSIA,2021,1690,1970,3660,35
BUSIA,2022,1760,2060,3820,35
BUSIA,2023,1830,2170,4000,35
BUSIA,2024,1890,2290,4180,35
BUSIA,2025,1970,2410,4380,35
BUTALEJA,2015,690,890,1580,35
BUTALEJA,2016,730,940,1670,35
BUTALEJA,2017,760,990,1750,35
BUTALEJA,2018,790,1040,1830,35
BUTALEJA,2019,830,1100,1930,35
BUTALEJA,2020,870,1150,2020,35
BUTALEJA,2021,910,1200,2110,35
BUTALEJA,2022,950,1260,2210,35
BUTALEJA,2023,1000,1340,2340,35
BUTALEJA,2024,1050,1420,2470,35
BUTALEJA,2025,1090,1510,2600,35
BUTAMBALA,2015,500,570,1070,35
BUTAMBALA,2016,510,590,1100,35
BUTAMBALA,2017,520,600,1120,35
BUTAMBALA,2018,530,610,1140,35
BUTAMBALA,2019,540,630,1170,35
BUTAMBALA,2020,560,650,1210,35
BUTAMBALA,2021,570,660,1230,35
BUTAMBALA,2022,590,680,1270,35
BUTAMBALA,2023,590,700,1290,35
BUTAMBALA,2024,600,730,1330,35
BUTAMBALA,2025,620,750,1370,35
BUTEBO,2015,320,450,770,35
BUTEBO,2016,330,460,790,35
BUTEBO,2017,340,480,820,35
BUTEBO,2018,350,490,840,35
BUTEBO,2019,360,500,860,35
BUTEBO,2020,360,520,880,35
BUTEBO,2021,370,530,900,35
BUTEBO,2022,380,550,930,35
BUTEBO,2023,390,570,960,35
BUTEBO,2024,400,590,990,35
BUTEBO,2025,400,610,1010,35
BUVUMA,2015,1000,680,1680,35
BUVUMA,2016,1070,730,1800,35
BUVUMA,2017,1130,770,1900,35
BUVUMA,2018,1200,830,2030,35
BUVUMA,2019,1270,880,2150,35
BUVUMA,2020,1350,940,2290,35
BUVUMA,2021,1430,1000,2430,35
BUVUMA,2022,1510,1070,2580,35
BUVUMA,2023,1600,1130,2730,35
BUVUMA,2024,1690,1210,2900,35
BUVUMA,2025,1790,1280,3070,35
BUYENDE,2015,1120,1430,2550,35
BUYENDE,2016,1180,1510,2690,35
BUYENDE,2017,1250,1600,2850,35
BUYENDE,2018,1320,1700,3020,35
BUYENDE,2019,1380,1800,3180,35
BUYENDE,2020,1460,1900,3360,35
BUYENDE,2021,1540,2000,3540,35
BUYENDE,2022,1620,2130,3750,35
BUYENDE,2023,1710,2270,3980,35
BUYENDE,2024,1800,2430,4230,35
BUYENDE,2025,1880,2600,4480,35
DOKOLO,2015,920,1050,1970,35
DOKOLO,2016,950,1080,2030,35
DOKOLO,2017,980,1110,2090,35
DOKOLO,2018,1010,1140,2150,35
DOKOLO,2019,1040,1170,2210,35
DOKOLO,2020,1070,1200,2270,35
DOKOLO,2021,1100,1230,2330,35
DOKOLO,2022,1130,1260,2390,35
DOKOLO,2023,1160,1290,2450,35
DOKOLO,2024,1190,1320,2510,35
DOKOLO,2025,1220,1350,2570,35
GOMBA,2015,800,760,1560,35
GOMBA,2016,820,780,1600,35
GOMBA,2017,840,810,1650,35
GOMBA,2018,860,830,1690,35
GOMBA,2019,890,850,1740,35
GOMBA,2020,900,870,1770,35
GOMBA,2021,930,890,1820,35
GOMBA,2022,950,920,1870,35
GOMBA,2023,980,950,1930,35
GOMBA,2024,1000,990,1990,35
GOMBA,2025,1020,1020,2040,35
GULU,2015,2130,1870,4000,35
GULU,2016,2190,1920,4110,35
GULU,2017,2260,1980,4240,35
GULU,2018,2330,2040,4370,35
GULU,2019,2390,2090,4480,35
GULU,2020,2460,2150,4610,35
GULU,2021,2530,2210,4740,35
GULU,2022,2600,2270,4870,35
GULU,2023,2670,2330,5000,35
GULU,2024,2740,2390,5130,35
GULU,2025,2810,2440,5250,35
HOIMA,2015,1950,1960,3910,35
HOIMA,2016,2020,2030,4050,35
HOIMA,2017,2100,2100,4200,35
HOIMA,2018,2180,2170,4350,35
HOIMA,2019,2260,2240,4500,35
HOIMA,2020,2340,2320,4660,35
HOIMA,2021,2420,2390,4810,35
HOIMA,2022,2500,2470,4970,35
HOIMA,2023,2590,2550,5140,35
HOIMA,2024,2670,2630,5300,35
HOIMA,2025,2760,2700,5460,35
IBANDA,2015,1470,1690,3160,35
IBANDA,2016,1500,1720,3220,35
IBANDA,2017,1530,1750,3280,35
IBANDA,2018,1560,1780,3340,35
IBANDA,2019,1590,1810,3400,35
IBANDA,2020,1620,1840,3460,35
IBANDA,2021,1650,1870,3520,35
IBANDA,2022,1680,1900,3580,35
IBANDA,2023,1710,1930,3640,35
IBANDA,2024,1730,1960,3690,35
IBANDA,2025,1760,1980,3740,35
IGANGA,2015,1690,1990,3680,35
IGANGA,2016,1760,2080,3840,35
IGANGA,2017,1830,2170,4000,35
IGANGA,2018,1900,2280,4180,35
IGANGA,2019,1980,2370,4350,35
IGANGA,2020,2060,2470,4530,35
IGANGA,2021,2150,2570,4720,35
IGANGA,2022,2240,2690,4930,35
IGANGA,2023,2320,2830,5150,35
IGANGA,2024,2400,2990,5390,35
IGANGA,2025,2490,3150,5640,35
ISINGIRO,2015,2900,3510,6410,35
ISINGIRO,2016,3010,3630,6640,35
ISINGIRO,2017,3120,3760,6880,35
ISINGIRO,2018,3240,3890,7130,35
ISINGIRO,2019,3350,4030,7380,35
ISINGIRO,2020,3470,4160,7630,35
ISINGIRO,2021,3590,4300,7890,35
ISINGIRO,2022,3720,4440,8160,35
ISINGIRO,2023,3840,4580,8420,35
ISINGIRO,2024,3970,4720,8690,35
ISINGIRO,2025,4100,4870,8970,35
JINJA,2015,3320,3220,6540,35
JINJA,2016,3380,3270,6650,35
JINJA,2017,3430,3320,6750,35
JINJA,2018,3490,3370,6860,35
JINJA,2019,3550,3420,6970,35
JINJA,2020,3600,3470,7070,35
JINJA,2021,3650,3510,7160,35
JINJA,2022,3700,3560,7260,35
JINJA,2023,3750,3600,7350,35
JINJA,2024,3800,3640,7440,35
JINJA,2025,3840,3680,7520,35
KAABONG,2015,660,650,1310,35
KAABONG,2016,680,670,1350,35
KAABONG,2017,700,690,1390,35
KAABONG,2018,710,700,1410,35
KAABONG,2019,730,720,1450,35
KAABONG,2020,750,740,1490,35
KAABONG,2021,770,750,1520,35
KAABONG,2022,790,770,1560,35
KAABONG,2023,810,780,1590,35
KAABONG,2024,830,800,1630,35
KAABONG,2025,850,820,1670,35
KABALE,2015,1360,1510,2870,35
KABALE,2016,1380,1530,2910,35
KABALE,2017,1400,1550,2950,35
KABALE,2018,1420,1570,2990,35
KABALE,2019,1440,1590,3030,35
KABALE,2020,1460,1600,3060,35
KABALE,2021,1480,1620,3100,35
KABALE,2022,1500,1640,3140,35
KABALE,2023,1520,1650,3170,35
KABALE,2024,1530,1660,3190,35
KABALE,2025,1550,1670,3220,35
KABAROLE,2015,2120,2010,4130,35
KABAROLE,2016,2170,2060,4230,35
KABAROLE,2017,2220,2100,4320,35
KABAROLE,2018,2260,2150,4410,35
KABAROLE,2019,2310,2190,4500,35
KABAROLE,2020,2360,2240,4600,35
KABAROLE,2021,2410,2280,4690,35
KABAROLE,2022,2450,2320,4770,35
KABAROLE,2023,2500,2370,4870,35
KABAROLE,2024,2540,2410,4950,35
KABAROLE,2025,2580,2450,5030,35
KABERAMAIDO,2015,410,450,860,35
KABERAMAIDO,2016,420,480,900,35
KABERAMAIDO,2017,440,500,940,35
KABERAMAIDO,2018,470,540,1010,35
KABERAMAIDO,2019,500,560,1060,35
KABERAMAIDO,2020,520,590,1110,35
KABERAMAIDO,2021,550,620,1170,35
KABERAMAIDO,2022,580,650,1230,35
KABERAMAIDO,2023,610,700,1310,35
KABERAMAIDO,2024,640,750,1390,35
KABERAMAIDO,2025,670,790,1460,35
KAGADI,2015,1880,1970,3850,35
KAGADI,2016,1950,2040,3990,35
KAGADI,2017,2030,2110,4140,35
KAGADI,2018,2100,2190,4290,35
KAGADI,2019,2180,2260,4440,35
KAGADI,2020,2250,2340,4590,35
KAGADI,2021,2330,2420,4750,35
KAGADI,2022,2410,2490,4900,35
KAGADI,2023,2490,2570,5060,35
KAGADI,2024,2570,2650,5220,35
KAGADI,2025,2660,2740,5400,35
KAKUMIRO,2015,1850,1600,3450,35
KAKUMIRO,2016,2010,1730,3740,35
KAKUMIRO,2017,2190,1880,4070,35
KAKUMIRO,2018,2380,2030,4410,35
KAKUMIRO,2019,2590,2200,4790,35
KAKUMIRO,2020,2810,2390,5200,35
KAKUMIRO,2021,3060,2580,5640,35
KAKUMIRO,2022,3320,2790,6110,35
KAKUMIRO,2023,3600,3020,6620,35
KAKUMIRO,2024,3900,3260,7160,35
KAKUMIRO,2025,4220,3520,7740,35
KALAKI,2015,530,620,1150,35
KALAKI,2016,560,650,1210,35
KALAKI,2017,580,670,1250,35
KALAKI,2018,610,700,1310,35
KALAKI,2019,630,720,1350,35
KALAKI,2020,660,750,1410,35
KALAKI,2021,680,780,1460,35
KALAKI,2022,710,810,1520,35
KALAKI,2023,740,840,1580,35
KALAKI,2024,770,870,1640,35
KALAKI,2025,800,900,1700,35
KALANGALA,2015,890,510,1400,35
KALANGALA,2016,920,530,1450,35
KALANGALA,2017,960,550,1510,35
KALANGALA,2018,990,580,1570,35
KALANGALA,2019,1020,600,1620,35
KALANGALA,2020,1060,620,1680,35
KALANGALA,2021,1090,650,1740,35
KALANGALA,2022,1130,670,1800,35
KALANGALA,2023,1170,700,1870,35
KALANGALA,2024,1200,720,1920,35
KALANGALA,2025,1240,750,1990,35
KALIRO,2015,810,1070,1880,35
KALIRO,2016,850,1130,1980,35
KALIRO,2017,890,1190,2080,35
KALIRO,2018,920,1240,2160,35
KALIRO,2019,960,1310,2270,35
KALIRO,2020,1010,1370,2380,35
KALIRO,2021,1060,1430,2490,35
KALIRO,2022,1110,1520,2630,35
KALIRO,2023,1150,1600,2750,35
KALIRO,2024,1200,1700,2900,35
KALIRO,2025,1240,1800,3040,35
KALUNGU,2015,870,1020,1890,35
KALUNGU,2016,890,1050,1940,35
KALUNGU,2017,910,1070,1980,35
KALUNGU,2018,920,1100,2020,35
KALUNGU,2019,940,1130,2070,35
KALUNGU,2020,960,1150,2110,35
KALUNGU,2021,980,1180,2160,35
KALUNGU,2022,1000,1210,2210,35
KALUNGU,2023,1020,1250,2270,35
KALUNGU,2024,1040,1300,2340,35
KALUNGU,2025,1060,1330,2390,35
KAMPALA,2015,14120,13240,27360,35
KAMPALA,2016,14400,13500,27900,35
KAMPALA,2017,14690,13760,28450,35
KAMPALA,2018,14970,14020,28990,35
KAMPALA,2019,15250,14280,29530,35
KAMPALA,2020,15530,14530,30060,35
KAMPALA,2021,15800,14790,30590,35
KAMPALA,2022,16070,15030,31100,35
KAMPALA,2023,16330,15280,31610,35
KAMPALA,2024,16580,15510,32090,35
KAMPALA,2025,16820,15740,32560,35
KAMULI,2015,1830,2460,4290,35
KAMULI,2016,1890,2560,4450,35
KAMULI,2017,1960,2660,4620,35
KAMULI,2018,2030,2760,4790,35
KAMULI,2019,2100,2870,4970,35
KAMULI,2020,2170,2970,5140,35
KAMULI,2021,2250,3070,5320,35
KAMULI,2022,2330,3200,5530,35
KAMULI,2023,2400,3340,5740,35
KAMULI,2024,2480,3500,5980,35
KAMULI,2025,2560,3680,6240,35
KAMWENGE,2015,1560,1690,3250,35
KAMWENGE,2016,1630,1750,3380,35
KAMWENGE,2017,1690,1810,3500,35
KAMWENGE,2018,1760,1870,3630,35
KAMWENGE,2019,1830,1940,3770,35
KAMWENGE,2020,1900,2000,3900,35
KAMWENGE,2021,1980,2070,4050,35
KAMWENGE,2022,2050,2140,4190,35
KAMWENGE,2023,2130,2210,4340,35
KAMWENGE,2024,2200,2280,4480,35
KAMWENGE,2025,2280,2350,4630,35
KANUNGU,2015,1420,1660,3080,35
KANUNGU,2016,1450,1680,3130,35
KANUNGU,2017,1470,1710,3180,35
KANUNGU,2018,1500,1740,3240,35
KANUNGU,2019,1520,1760,3280,35
KANUNGU,2020,1550,1790,3340,35
KANUNGU,2021,1570,1820,3390,35
KANUNGU,2022,1600,1840,3440,35
KANUNGU,2023,1620,1860,3480,35
KANUNGU,2024,1640,1890,3530,35
KANUNGU,2025,1670,1910,3580,35
KAPCHORWA,2015,510,570,1080,35
KAPCHORWA,2016,520,580,1100,35
KAPCHORWA,2017,540,600,1140,35
KAPCHORWA,2018,550,610,1160,35
KAPCHORWA,2019,570,630,1200,35
KAPCHORWA,2020,590,650,1240,35
KAPCHORWA,2021,600,660,1260,35
KAPCHORWA,2022,620,680,1300,35
KAPCHORWA,2023,640,700,1340,35
KAPCHORWA,2024,650,710,1360,35
KAPCHORWA,2025,670,730,1400,35
KAPELEBYONG,2015,350,450,800,35
KAPELEBYONG,2016,360,480,840,35
KAPELEBYONG,2017,370,500,870,35
KAPELEBYONG,2018,390,520,910,35
KAPELEBYONG,2019,400,540,940,35
KAPELEBYONG,2020,420,560,980,35
KAPELEBYONG,2021,440,590,1030,35
KAPELEBYONG,2022,460,610,1070,35
KAPELEBYONG,2023,480,640,1120,35
KAPELEBYONG,2024,490,680,1170,35
KAPELEBYONG,2025,510,710,1220,35
KASESE,2015,3340,4110,7450,35
KASESE,2016,3460,4280,7740,35
KASESE,2017,3570,4450,8020,35
KASESE,2018,3690,4610,8300,35
KASESE,2019,3810,4790,8600,35
KASESE,2020,3940,4950,8890,35
KASESE,2021,4080,5120,9200,35
KASESE,2022,4210,5320,9530,35
KASESE,2023,4350,5570,9920,35
KASESE,2024,4470,5830,10300,35
KASESE,2025,4610,6110,10720,35
KASSANDA,2015,1770,1640,3410,35
KASSANDA,2016,1820,1680,3500,35
KASSANDA,2017,1870,1720,3590,35
KASSANDA,2018,1930,1750,3680,35
KASSANDA,2019,1980,1790,3770,35
KASSANDA,2020,2030,1830,3860,35
KASSANDA,2021,2090,1860,3950,35
KASSANDA,2022,2140,1890,4030,35
KASSANDA,2023,2190,1930,4120,35
KASSANDA,2024,2250,1960,4210,35
KASSANDA,2025,2300,2000,4300,35
KATAKWI,2015,620,780,1400,35
KATAKWI,2016,640,810,1450,35
KATAKWI,2017,660,850,1510,35
KATAKWI,2018,690,880,1570,35
KATAKWI,2019,720,920,1640,35
KATAKWI,2020,750,950,1700,35
KATAKWI,2021,780,990,1770,35
KATAKWI,2022,810,1030,1840,35
KATAKWI,2023,840,1080,1920,35
KATAKWI,2024,870,1130,2000,35
KATAKWI,2025,900,1200,2100,35
KAYUNGA,2015,1600,1910,3510,35
KAYUNGA,2016,1650,1970,3620,35
KAYUNGA,2017,1700,2040,3740,35
KAYUNGA,2018,1740,2110,3850,35
KAYUNGA,2019,1790,2170,3960,35
KAYUNGA,2020,1840,2230,4070,35
KAYUNGA,2021,1900,2300,4200,35
KAYUNGA,2022,1950,2380,4330,35
KAYUNGA,2023,2000,2470,4470,35
KAYUNGA,2024,2050,2570,4620,35
KAYUNGA,2025,2100,2680,4780,35
KAZO,2015,1090,1170,2260,35
KAZO,2016,1130,1210,2340,35
KAZO,2017,1170,1250,2420,35
KAZO,2018,1220,1290,2510,35
KAZO,2019,1260,1340,2600,35
KAZO,2020,1310,1380,2690,35
KAZO,2021,1350,1430,2780,35
KAZO,2022,1400,1480,2880,35
KAZO,2023,1450,1520,2970,35
KAZO,2024,1500,1570,3070,35
KAZO,2025,1550,1620,3170,35
KIBAALE,2015,710,740,1450,35
KIBAALE,2016,760,790,1550,35
KIBAALE,2017,800,830,1630,35
KIBAALE,2018,860,880,1740,35
KIBAALE,2019,910,930,1840,35
KIBAALE,2020,960,980,1940,35
KIBAALE,2021,1020,1040,2060,35
KIBAALE,2022,1090,1090,2180,35
KIBAALE,2023,1150,1150,2300,35
KIBAALE,2024,1220,1220,2440,35
KIBAALE,2025,1290,1280,2570,35
KIBOGA,2015,710,730,1440,35
KIBOGA,2016,740,750,1490,35
KIBOGA,2017,760,780,1540,35
KIBOGA,2018,790,820,1610,35
KIBOGA,2019,820,850,1670,35
KIBOGA,2020,850,880,1730,35
KIBOGA,2021,870,920,1790,35
KIBOGA,2022,910,950,1860,35
KIBOGA,2023,940,990,1930,35
KIBOGA,2024,960,1030,1990,35
KIBOGA,2025,1000,1090,2090,35
KIBUKU,2015,570,850,1420,35
KIBUKU,2016,600,900,1500,35
KIBUKU,2017,630,950,1580,35
KIBUKU,2018,650,1000,1650,35
KIBUKU,2019,680,1050,1730,35
KIBUKU,2020,720,1110,1830,35
KIBUKU,2021,750,1160,1910,35
KIBUKU,2022,790,1230,2020,35
KIBUKU,2023,830,1300,2130,35
KIBUKU,2024,870,1380,2250,35
KIBUKU,2025,900,1460,2360,35
KIKUUBE,2015,1790,1540,3330,35
KIKUUBE,2016,1890,1620,3510,35
KIKUUBE,2017,1990,1700,3690,35
KIKUUBE,2018,2090,1790,3880,35
KIKUUBE,2019,2200,1880,4080,35
KIKUUBE,2020,2320,1970,4290,35
KIKUUBE,2021,2440,2070,4510,35
KIKUUBE,2022,2560,2170,4730,35
KIKUUBE,2023,2690,2270,4960,35
KIKUUBE,2024,2820,2380,5200,35
KIKUUBE,2025,2950,2490,5440,35
KIRUHURA,2015,1330,1150,2480,35
KIRUHURA,2016,1380,1190,2570,35
KIRUHURA,2017,1430,1230,2660,35
KIRUHURA,2018,1490,1270,2760,35
KIRUHURA,2019,1540,1320,2860,35
KIRUHURA,2020,1600,1360,2960,35
KIRUHURA,2021,1660,1410,3070,35
KIRUHURA,2022,1720,1450,3170,35
KIRUHURA,2023,1780,1500,3280,35
KIRUHURA,2024,1830,1550,3380,35
KIRUHURA,2025,1890,1590,3480,35
KIRYANDONGO,2015,1210,1390,2600,35
KIRYANDONGO,2016,1260,1450,2710,35
KIRYANDONGO,2017,1310,1520,2830,35
KIRYANDONGO,2018,1360,1590,2950,35
KIRYANDONGO,2019,1410,1650,3060,35
KIRYANDONGO,2020,1470,1720,3190,35
KIRYANDONGO,2021,1530,1790,3320,35
KIRYANDONGO,2022,1590,1860,3450,35
KIRYANDONGO,2023,1640,1960,3600,35
KIRYANDONGO,2024,1710,2060,3770,35
KIRYANDONGO,2025,1760,2170,3930,35
KISORO,2015,990,1700,2690,35
KISORO,2016,1020,1780,2800,35
KISORO,2017,1050,1840,2890,35
KISORO,2018,1080,1900,2980,35
KISORO,2019,1110,1970,3080,35
KISORO,2020,1150,2040,3190,35
KISORO,2021,1170,2100,3270,35
KISORO,2022,1210,2180,3390,35
KISORO,2023,1240,2280,3520,35
KISORO,2024,1270,2380,3650,35
KISORO,2025,1300,2480,3780,35
KITAGWENDA,2015,820,1010,1830,35
KITAGWENDA,2016,860,1040,1900,35
KITAGWENDA,2017,890,1080,1970,35
KITAGWENDA,2018,930,1120,2050,35
KITAGWENDA,2019,960,1160,2120,35
KITAGWENDA,2020,1000,1200,2200,35
KITAGWENDA,2021,1040,1240,2280,35
KITAGWENDA,2022,1080,1280,2360,35
KITAGWENDA,2023,1120,1320,2440,35
KITAGWENDA,2024,1160,1360,2520,35
KITAGWENDA,2025,1200,1400,2600,35
KITGUM,2015,940,1110,2050,35
KITGUM,2016,960,1150,2110,35
KITGUM,2017,990,1180,2170,35
KITGUM,2018,1020,1220,2240,35
KITGUM,2019,1040,1260,2300,35
KITGUM,2020,1070,1290,2360,35
KITGUM,2021,1100,1330,2430,35
KITGUM,2022,1120,1370,2490,35
KITGUM,2023,1150,1430,2580,35
KITGUM,2024,1180,1490,2670,35
KITGUM,2025,1200,1550,2750,35
KOBOKO,2015,990,1450,2440,35
KOBOKO,2016,1040,1530,2570,35
KOBOKO,2017,1090,1620,2710,35
KOBOKO,2018,1150,1710,2860,35
KOBOKO,2019,1200,1790,2990,35
KOBOKO,2020,1260,1890,3150,35
KOBOKO,2021,1330,1990,3320,35
KOBOKO,2022,1390,2090,3480,35
KOBOKO,2023,1460,2220,3680,35
KOBOKO,2024,1520,2370,3890,35
KOBOKO,2025,1590,2520,4110,35
KOLE,2015,1250,1350,2600,35
KOLE,2016,1300,1390,2690,35
KOLE,2017,1340,1430,2770,35
KOLE,2018,1380,1470,2850,35
KOLE,2019,1420,1510,2930,35
KOLE,2020,1470,1550,3020,35
KOLE,2021,1510,1590,3100,35
KOLE,2022,1560,1630,3190,35
KOLE,2023,1600,1680,3280,35
KOLE,2024,1650,1720,3370,35
KOLE,2025,1690,1760,3450,35
KOTIDO,2015,750,940,1690,35
KOTIDO,2016,770,980,1750,35
KOTIDO,2017,800,1020,1820,35
KOTIDO,2018,820,1060,1880,35
KOTIDO,2019,850,1100,1950,35
KOTIDO,2020,880,1130,2010,35
KOTIDO,2021,910,1180,2090,35
KOTIDO,2022,950,1220,2170,35
KOTIDO,2023,970,1280,2250,35
KOTIDO,2024,1000,1330,2330,35
KOTIDO,2025,1030,1400,2430,35
KUMI,2015,870,1140,2010,35
KUMI,2016,910,1190,2100,35
KUMI,2017,950,1240,2190,35
KUMI,2018,990,1300,2290,35
KUMI,2019,1030,1350,2380,35
KUMI,2020,1070,1410,2480,35
KUMI,2021,1110,1470,2580,35
KUMI,2022,1160,1540,2700,35
KUMI,2023,1210,1620,2830,35
KUMI,2024,1250,1710,2960,35
KUMI,2025,1290,1800,3090,35
KWANIA,2015,970,1070,2040,35
KWANIA,2016,1000,1100,2100,35
KWANIA,2017,1030,1130,2160,35
KWANIA,2018,1060,1170,2230,35
KWANIA,2019,1090,1200,2290,35
KWANIA,2020,1120,1230,2350,35
KWANIA,2021,1150,1260,2410,35
KWANIA,2022,1190,1300,2490,35
KWANIA,2023,1220,1330,2550,35
KWANIA,2024,1250,1360,2610,35
KWANIA,2025,1280,1390,2670,35
KWEEN,2015,430,520,950,35
KWEEN,2016,440,530,970,35
KWEEN,2017,450,540,990,35
KWEEN,2018,470,560,1030,35
KWEEN,2019,480,570,1050,35
KWEEN,2020,500,580,1080,35
KWEEN,2021,510,600,1110,35
KWEEN,2022,530,610,1140,35
KWEEN,2023,540,620,1160,35
KWEEN,2024,550,640,1190,35
KWEEN,2025,570,650,1220,35
KYANKWANZI,2015,1460,1250,2710,35
KYANKWANZI,2016,1540,1310,2850,35
KYANKWANZI,2017,1620,1370,2990,35
KYANKWANZI,2018,1700,1440,3140,35
KYANKWANZI,2019,1780,1500,3280,35
KYANKWANZI,2020,1870,1570,3440,35
KYANKWANZI,2021,1960,1640,3600,35
KYANKWANZI,2022,2060,1710,3770,35
KYANKWANZI,2023,2160,1790,3950,35
KYANKWANZI,2024,2260,1860,4120,35
KYANKWANZI,2025,2360,1940,4300,35
KYEGEGWA,2015,1750,1680,3430,35
KYEGEGWA,2016,1890,1810,3700,35
KYEGEGWA,2017,2050,1950,4000,35
KYEGEGWA,2018,2220,2110,4330,35
KYEGEGWA,2019,2400,2270,4670,35
KYEGEGWA,2020,2590,2450,5040,35
KYEGEGWA,2021,2800,2640,5440,35
KYEGEGWA,2022,3020,2840,5860,35
KYEGEGWA,2023,3260,3050,6310,35
KYEGEGWA,2024,3510,3280,6790,35
KYEGEGWA,2025,3780,3520,7300,35
KYENJOJO,2015,2340,2390,4730,35
KYENJOJO,2016,2430,2480,4910,35
KYENJOJO,2017,2530,2570,5100,35
KYENJOJO,2018,2640,2660,5300,35
KYENJOJO,2019,2740,2760,5500,35
KYENJOJO,2020,2850,2860,5710,35
KYENJOJO,2021,2960,2960,5920,35
KYENJOJO,2022,3070,3060,6130,35
KYENJOJO,2023,3190,3160,6350,35
KYENJOJO,2024,3300,3260,6560,35
KYENJOJO,2025,3420,3370,6790,35
KYOTERA,2015,1330,1500,2830,35
KYOTERA,2016,1360,1550,2910,35
KYOTERA,2017,1390,1590,2980,35
KYOTERA,2018,1420,1650,3070,35
KYOTERA,2019,1460,1690,3150,35
KYOTERA,2020,1500,1740,3240,35
KYOTERA,2021,1540,1780,3320,35
KYOTERA,2022,1580,1830,3410,35
KYOTERA,2023,1610,1900,3510,35
KYOTERA,2024,1650,1980,3630,35
KYOTERA,2025,1680,2060,3740,35
KARENGA,2015,290,320,610,35
KARENGA,2016,300,330,630,35
KARENGA,2017,300,340,640,35
KARENGA,2018,320,350,670,35
KARENGA,2019,320,360,680,35
KARENGA,2020,330,360,690,35
KARENGA,2021,340,370,710,35
KARENGA,2022,350,380,730,35
KARENGA,2023,360,390,750,35
KARENGA,2024,360,400,760,35
KARENGA,2025,370,400,770,35
LAMWO,2015,620,710,1330,35
LAMWO,2016,630,730,1360,35
LAMWO,2017,640,750,1390,35
LAMWO,2018,650,780,1430,35
LAMWO,2019,660,800,1460,35
LAMWO,2020,670,820,1490,35
LAMWO,2021,690,840,1530,35
LAMWO,2022,700,860,1560,35
LAMWO,2023,710,900,1610,35
LAMWO,2024,730,930,1660,35
LAMWO,2025,730,970,1700,35
LIRA,2015,2900,2850,5750,35
LIRA,2016,2990,2940,5930,35
LIRA,2017,3070,3020,6090,35
LIRA,2018,3160,3110,6270,35
LIRA,2019,3240,3190,6430,35
LIRA,2020,3330,3280,6610,35
LIRA,2021,3410,3370,6780,35
LIRA,2022,3500,3450,6950,35
LIRA,2023,3580,3540,7120,35
LIRA,2024,3670,3630,7300,35
LIRA,2025,3750,3710,7460,35
LUUKA,2015,800,1190,1990,35
LUUKA,2016,820,1240,2060,35
LUUKA,2017,840,1280,2120,35
LUUKA,2018,870,1330,2200,35
LUUKA,2019,890,1380,2270,35
LUUKA,2020,920,1420,2340,35
LUUKA,2021,950,1470,2420,35
LUUKA,2022,980,1530,2510,35
LUUKA,2023,1000,1590,2590,35
LUUKA,2024,1030,1660,2690,35
LUUKA,2025,1060,1740,2800,35
LUWERO,2015,2310,2490,4800,35
LUWERO,2016,2390,2590,4980,35
LUWERO,2017,2470,2690,5160,35
LUWERO,2018,2550,2800,5350,35
LUWERO,2019,2640,2900,5540,35
LUWERO,2020,2730,3000,5730,35
LUWERO,2021,2830,3110,5940,35
LUWERO,2022,2930,3230,6160,35
LUWERO,2023,3020,3380,6400,35
LUWERO,2024,3110,3540,6650,35
LUWERO,2025,3210,3720,6930,35
LWENGO,2015,1250,1480,2730,35
LWENGO,2016,1270,1520,2790,35
LWENGO,2017,1300,1560,2860,35
LWENGO,2018,1320,1600,2920,35
LWENGO,2019,1340,1640,2980,35
LWENGO,2020,1370,1680,3050,35
LWENGO,2021,1410,1710,3120,35
LWENGO,2022,1430,1750,3180,35
LWENGO,2023,1450,1810,3260,35
LWENGO,2024,1480,1870,3350,35
LWENGO,2025,1500,1940,3440,35
LYANTONDE,2015,490,530,1020,35
LYANTONDE,2016,510,560,1070,35
LYANTONDE,2017,520,580,1100,35
LYANTONDE,2018,550,600,1150,35
LYANTONDE,2019,570,640,1210,35
LYANTONDE,2020,590,660,1250,35
LYANTONDE,2021,620,690,1310,35
LYANTONDE,2022,640,730,1370,35
LYANTONDE,2023,670,750,1420,35
LYANTONDE,2024,690,780,1470,35
LYANTONDE,2025,710,820,1530,35
MANAFWA,2015,580,610,1190,35
MANAFWA,2016,600,630,1230,35
MANAFWA,2017,610,640,1250,35
MANAFWA,2018,630,660,1290,35
MANAFWA,2019,640,670,1310,35
MANAFWA,2020,660,680,1340,35
MANAFWA,2021,670,700,1370,35
MANAFWA,2022,690,710,1400,35
MANAFWA,2023,700,720,1420,35
MANAFWA,2024,720,740,1460,35
MANAFWA,2025,730,750,1480,35
MARACHA,2015,870,1360,2230,35
MARACHA,2016,890,1380,2270,35
MARACHA,2017,910,1410,2320,35
MARACHA,2018,930,1440,2370,35
MARACHA,2019,940,1470,2410,35
MARACHA,2020,960,1490,2450,35
MARACHA,2021,980,1520,2500,35
MARACHA,2022,1000,1540,2540,35
MARACHA,2023,1020,1570,2590,35
MARACHA,2024,1030,1590,2620,35
MARACHA,2025,1050,1620,2670,35
MASAKA,2015,1870,1790,3660,35
MASAKA,2016,1930,1870,3800,35
MASAKA,2017,1990,1930,3920,35
MASAKA,2018,2050,2000,4050,35
MASAKA,2019,2110,2080,4190,35
MASAKA,2020,2180,2140,4320,35
MASAKA,2021,2250,2220,4470,35
MASAKA,2022,2320,2300,4620,35
MASAKA,2023,2390,2400,4790,35
MASAKA,2024,2460,2510,4970,35
MASAKA,2025,2520,2630,5150,35
MASINDI,2015,2040,1850,3890,35
MASINDI,2016,2090,1900,3990,35
MASINDI,2017,2160,1950,4110,35
MASINDI,2018,2220,2000,4220,35
MASINDI,2019,2280,2060,4340,35
MASINDI,2020,2340,2110,4450,35
MASINDI,2021,2410,2160,4570,35
MASINDI,2022,2470,2210,4680,35
MASINDI,2023,2530,2260,4790,35
MASINDI,2024,2600,2310,4910,35
MASINDI,2025,2660,2360,5020,35
MAYUGE,2015,1990,2430,4420,35
MAYUGE,2016,2060,2560,4620,35
MAYUGE,2017,2150,2680,4830,35
MAYUGE,2018,2230,2800,5030,35
MAYUGE,2019,2320,2930,5250,35
MAYUGE,2020,2420,3050,5470,35
MAYUGE,2021,2520,3190,5710,35
MAYUGE,2022,2630,3340,5970,35
MAYUGE,2023,2730,3520,6250,35
MAYUGE,2024,2830,3720,6550,35
MAYUGE,2025,2930,3930,6860,35
MBALE,2015,2000,2290,4290,35
MBALE,2016,2070,2400,4470,35
MBALE,2017,2150,2530,4680,35
MBALE,2018,2230,2650,4880,35
MBALE,2019,2320,2780,5100,35
MBALE,2020,2420,2900,5320,35
MBALE,2021,2520,3040,5560,35
MBALE,2022,2610,3190,5800,35
MBALE,2023,2710,3380,6090,35
MBALE,2024,2810,3570,6380,35
MBALE,2025,2910,3780,6690,35
MBARARA,2015,2830,2700,5530,35
MBARARA,2016,2890,2760,5650,35
MBARARA,2017,2960,2820,5780,35
MBARARA,2018,3030,2880,5910,35
MBARARA,2019,3090,2940,6030,35
MBARARA,2020,3160,3000,6160,35
MBARARA,2021,3230,3060,6290,35
MBARARA,2022,3290,3120,6410,35
MBARARA,2023,3350,3170,6520,35
MBARARA,2024,3410,3230,6640,35
MBARARA,2025,3480,3280,6760,35
MITOOMA,2015,890,1250,2140,35
MITOOMA,2016,900,1260,2160,35
MITOOMA,2017,910,1280,2190,35
MITOOMA,2018,920,1290,2210,35
MITOOMA,2019,930,1300,2230,35
MITOOMA,2020,940,1310,2250,35
MITOOMA,2021,950,1320,2270,35
MITOOMA,2022,960,1330,2290,35
MITOOMA,2023,960,1330,2290,35
MITOOMA,2024,970,1340,2310,35
MITOOMA,2025,980,1350,2330,35
MITYANA,2015,1670,1630,3300,35
MITYANA,2016,1720,1680,3400,35
MITYANA,2017,1760,1750,3510,35
MITYANA,2018,1820,1800,3620,35
MITYANA,2019,1860,1850,3710,35
MITYANA,2020,1910,1900,3810,35
MITYANA,2021,1970,1960,3930,35
MITYANA,2022,2020,2030,4050,35
MITYANA,2023,2070,2100,4170,35
MITYANA,2024,2120,2190,4310,35
MITYANA,2025,2180,2280,4460,35
MOROTO,2015,570,560,1130,35
MOROTO,2016,580,590,1170,35
MOROTO,2017,600,610,1210,35
MOROTO,2018,620,630,1250,35
MOROTO,2019,640,660,1300,35
MOROTO,2020,670,680,1350,35
MOROTO,2021,680,710,1390,35
MOROTO,2022,710,740,1450,35
MOROTO,2023,730,770,1500,35
MOROTO,2024,750,820,1570,35
MOROTO,2025,770,860,1630,35
MOYO,2015,610,650,1260,35
MOYO,2016,620,660,1280,35
MOYO,2017,640,680,1320,35
MOYO,2018,650,690,1340,35
MOYO,2019,670,700,1370,35
MOYO,2020,690,720,1410,35
MOYO,2021,700,730,1430,35
MOYO,2022,720,750,1470,35
MOYO,2023,740,760,1500,35
MOYO,2024,750,770,1520,35
MOYO,2025,760,790,1550,35
MPIGI,2015,1330,1280,2610,35
MPIGI,2016,1380,1340,2720,35
MPIGI,2017,1420,1390,2810,35
MPIGI,2018,1470,1440,2910,35
MPIGI,2019,1520,1500,3020,35
MPIGI,2020,1570,1550,3120,35
MPIGI,2021,1630,1600,3230,35
MPIGI,2022,1680,1670,3350,35
MPIGI,2023,1730,1750,3480,35
MPIGI,2024,1780,1830,3610,35
MPIGI,2025,1840,1930,3770,35
MUBENDE,2015,2060,2120,4180,35
MUBENDE,2016,2190,2260,4450,35
MUBENDE,2017,2330,2420,4750,35
MUBENDE,2018,2470,2580,5050,35
MUBENDE,2019,2630,2750,5380,35
MUBENDE,2020,2790,2930,5720,35
MUBENDE,2021,2970,3120,6090,35
MUBENDE,2022,3150,3330,6480,35
MUBENDE,2023,3340,3590,6930,35
MUBENDE,2024,3540,3870,7410,35
MUBENDE,2025,3750,4170,7920,35
MUKONO,2015,3390,3690,7080,35
MUKONO,2016,3510,3870,7380,35
MUKONO,2017,3640,4050,7690,35
MUKONO,2018,3770,4230,8000,35
MUKONO,2019,3900,4410,8310,35
MUKONO,2020,4050,4610,8660,35
MUKONO,2021,4200,4800,9000,35
MUKONO,2022,4350,5020,9370,35
MUKONO,2023,4500,5300,9800,35
MUKONO,2024,4650,5580,10230,35
MUKONO,2025,4800,5890,10690,35
MADI OKOLLO,2015,790,1000,1790,35
MADI OKOLLO,2016,810,1030,1840,35
MADI OKOLLO,2017,840,1060,1900,35
MADI OKOLLO,2018,860,1090,1950,35
MADI OKOLLO,2019,890,1110,2000,35
MADI OKOLLO,2020,910,1140,2050,35
MADI OKOLLO,2021,940,1170,2110,35
MADI OKOLLO,2022,960,1200,2160,35
MADI OKOLLO,2023,990,1230,2220,35
MADI OKOLLO,2024,1010,1260,2270,35
MADI OKOLLO,2025,1030,1290,2320,35
NABILATUK,2015,260,330,590,35
NABILATUK,2016,270,350,620,35
NABILATUK,2017,290,370,660,35
NABILATUK,2018,310,390,700,35
NABILATUK,2019,330,420,750,35
NABILATUK,2020,350,440,790,35
NABILATUK,2021,370,460,830,35
NABILATUK,2022,380,500,880,35
NABILATUK,2023,410,530,940,35
NABILATUK,2024,430,570,1000,35
NABILATUK,2025,450,610,1060,35
NAKAPIRIPIRIT,2015,410,470,880,35
NAKAPIRIPIRIT,2016,440,500,940,35
NAKAPIRIPIRIT,2017,470,530,1000,35
NAKAPIRIPIRIT,2018,490,560,1050,35
NAKAPIRIPIRIT,2019,510,590,1100,35
NAKAPIRIPIRIT,2020,540,620,1160,35
NAKAPIRIPIRIT,2021,570,660,1230,35
NAKAPIRIPIRIT,2022,600,700,1300,35
NAKAPIRIPIRIT,2023,630,750,1380,35
NAKAPIRIPIRIT,2024,660,810,1470,35
NAKAPIRIPIRIT,2025,700,860,1560,35
NAKASEKE,2015,1790,1300,3090,35
NAKASEKE,2016,1850,1330,3180,35
NAKASEKE,2017,1920,1360,3280,35
NAKASEKE,2018,1990,1400,3390,35
NAKASEKE,2019,2060,1430,3490,35
NAKASEKE,2020,2130,1460,3590,35
NAKASEKE,2021,2210,1490,3700,35
NAKASEKE,2022,2280,1530,3810,35
NAKASEKE,2023,2360,1560,3920,35
NAKASEKE,2024,2430,1590,4020,35
NAKASEKE,2025,2510,1620,4130,35
NAKASONGOLA,2015,1000,890,1890,35
NAKASONGOLA,2016,1040,930,1970,35
NAKASONGOLA,2017,1080,970,2050,35
NAKASONGOLA,2018,1130,1010,2140,35
NAKASONGOLA,2019,1170,1060,2230,35
NAKASONGOLA,2020,1220,1100,2320,35
NAKASONGOLA,2021,1280,1140,2420,35
NAKASONGOLA,2022,1330,1190,2520,35
NAKASONGOLA,2023,1380,1250,2630,35
NAKASONGOLA,2024,1440,1310,2750,35
NAKASONGOLA,2025,1480,1380,2860,35
NAMAYINGO,2015,880,1010,1890,35
NAMAYINGO,2016,900,1040,1940,35
NAMAYINGO,2017,920,1070,1990,35
NAMAYINGO,2018,950,1110,2060,35
NAMAYINGO,2019,980,1130,2110,35
NAMAYINGO,2020,1000,1170,2170,35
NAMAYINGO,2021,1040,1200,2240,35
NAMAYINGO,2022,1070,1240,2310,35
NAMAYINGO,2023,1090,1290,2380,35
NAMAYINGO,2024,1120,1340,2460,35
NAMAYINGO,2025,1150,1390,2540,35
NAMISINDWA,2015,730,860,1590,35
NAMISINDWA,2016,750,880,1630,35
NAMISINDWA,2017,770,900,1670,35
NAMISINDWA,2018,790,930,1720,35
NAMISINDWA,2019,810,950,1760,35
NAMISINDWA,2020,830,970,1800,35
NAMISINDWA,2021,850,990,1840,35
NAMISINDWA,2022,880,1010,1890,35
NAMISINDWA,2023,900,1030,1930,35
NAMISINDWA,2024,920,1050,1970,35
NAMISINDWA,2025,940,1070,2010,35
NAMUTUMBA,2015,800,1100,1900,35
NAMUTUMBA,2016,830,1160,1990,35
NAMUTUMBA,2017,870,1220,2090,35
NAMUTUMBA,2018,910,1280,2190,35
NAMUTUMBA,2019,950,1340,2290,35
NAMUTUMBA,2020,990,1400,2390,35
NAMUTUMBA,2021,1040,1470,2510,35
NAMUTUMBA,2022,1080,1540,2620,35
NAMUTUMBA,2023,1120,1620,2740,35
NAMUTUMBA,2024,1180,1720,2900,35
NAMUTUMBA,2025,1220,1820,3040,35
NAPAK,2015,530,780,1310,35
NAPAK,2016,540,810,1350,35
NAPAK,2017,550,840,1390,35
NAPAK,2018,560,870,1430,35
NAPAK,2019,570,900,1470,35
NAPAK,2020,600,930,1530,35
NAPAK,2021,610,960,1570,35
NAPAK,2022,630,1000,1630,35
NAPAK,2023,640,1040,1680,35
NAPAK,2024,650,1080,1730,35
NAPAK,2025,670,1140,1810,35
NEBBI,2015,1050,1300,2350,35
NEBBI,2016,1080,1340,2420,35
NEBBI,2017,1110,1380,2490,35
NEBBI,2018,1150,1420,2570,35
NEBBI,2019,1180,1460,2640,35
NEBBI,2020,1220,1490,2710,35
NEBBI,2021,1260,1530,2790,35
NEBBI,2022,1290,1570,2860,35
NEBBI,2023,1330,1610,2940,35
NEBBI,2024,1360,1650,3010,35
NEBBI,2025,1400,1690,3090,35
NGORA,2015,560,690,1250,35
NGORA,2016,580,730,1310,35
NGORA,2017,600,760,1360,35
NGORA,2018,630,780,1410,35
NGORA,2019,650,820,1470,35
NGORA,2020,680,850,1530,35
NGORA,2021,710,880,1590,35
NGORA,2022,730,920,1650,35
NGORA,2023,760,970,1730,35
NGORA,2024,780,1020,1800,35
NGORA,2025,810,1070,1880,35
NTOROKO,2015,380,340,720,35
NTOROKO,2016,390,360,750,35
NTOROKO,2017,400,370,770,35
NTOROKO,2018,420,380,800,35
NTOROKO,2019,430,400,830,35
NTOROKO,2020,440,400,840,35
NTOROKO,2021,460,420,880,35
NTOROKO,2022,470,440,910,35
NTOROKO,2023,490,460,950,35
NTOROKO,2024,510,470,980,35
NTOROKO,2025,520,490,1010,35
NTUNGAMO,2015,2870,3350,6220,35
NTUNGAMO,2016,2930,3410,6340,35
NTUNGAMO,2017,3000,3480,6480,35
NTUNGAMO,2018,3060,3540,6600,35
NTUNGAMO,2019,3120,3600,6720,35
NTUNGAMO,2020,3190,3660,6850,35
NTUNGAMO,2021,3250,3720,6970,35
NTUNGAMO,2022,3310,3780,7090,35
NTUNGAMO,2023,3370,3840,7210,35
NTUNGAMO,2024,3420,3900,7320,35
NTUNGAMO,2025,3480,3950,7430,35
NWOYA,2015,930,860,1790,35
NWOYA,2016,1030,940,1970,35
NWOYA,2017,1140,1040,2180,35
NWOYA,2018,1260,1150,2410,35
NWOYA,2019,1390,1260,2650,35
NWOYA,2020,1530,1390,2920,35
NWOYA,2021,1690,1530,3220,35
NWOYA,2022,1860,1680,3540,35
NWOYA,2023,2040,1840,3880,35
NWOYA,2024,2250,2020,4270,35
NWOYA,2025,2470,2220,4690,35
OBONGI,2015,210,260,470,35
OBONGI,2016,220,270,490,35
OBONGI,2017,230,290,520,35
OBONGI,2018,230,290,520,35
OBONGI,2019,240,300,540,35
OBONGI,2020,250,320,570,35
OBONGI,2021,250,330,580,35
OBONGI,2022,260,340,600,35
OBONGI,2023,280,350,630,35
OBONGI,2024,280,360,640,35
OBONGI,2025,290,390,680,35
OMORO,2015,720,810,1530,35
OMORO,2016,760,860,1620,35
OMORO,2017,790,900,1690,35
OMORO,2018,820,950,1770,35
OMORO,2019,860,1000,1860,35
OMORO,2020,900,1040,1940,35
OMORO,2021,940,1100,2040,35
OMORO,2022,990,1140,2130,35
OMORO,2023,1030,1210,2240,35
OMORO,2024,1070,1290,2360,35
OMORO,2025,1110,1360,2470,35
OTUKE,2015,580,710,1290,35
OTUKE,2016,610,740,1350,35
OTUKE,2017,640,770,1410,35
OTUKE,2018,670,810,1480,35
OTUKE,2019,700,840,1540,35
OTUKE,2020,720,880,1600,35
OTUKE,2021,760,910,1670,35
OTUKE,2022,790,950,1740,35
OTUKE,2023,820,980,1800,35
OTUKE,2024,850,1020,1870,35
OTUKE,2025,890,1060,1950,35
OYAM,2015,1950,2200,4150,35
OYAM,2016,2010,2270,4280,35
OYAM,2017,2070,2330,4400,35
OYAM,2018,2130,2400,4530,35
OYAM,2019,2190,2470,4660,35
OYAM,2020,2260,2540,4800,35
OYAM,2021,2320,2600,4920,35
OYAM,2022,2390,2670,5060,35
OYAM,2023,2450,2740,5190,35
OYAM,2024,2510,2810,5320,35
OYAM,2025,2580,2880,5460,35
PADER,2015,860,960,1820,35
PADER,2016,880,1000,1880,35
PADER,2017,900,1030,1930,35
PADER,2018,930,1070,2000,35
PADER,2019,960,1110,2070,35
PADER,2020,980,1140,2120,35
PADER,2021,1010,1180,2190,35
PADER,2022,1030,1220,2250,35
PADER,2023,1050,1270,2320,35
PADER,2024,1080,1320,2400,35
PADER,2025,1100,1380,2480,35
PAKWACH,2015,930,990,1920,35
PAKWACH,2016,970,1030,2000,35
PAKWACH,2017,1010,1070,2080,35
PAKWACH,2018,1060,1100,2160,35
PAKWACH,2019,1100,1140,2240,35
PAKWACH,2020,1140,1180,2320,35
PAKWACH,2021,1190,1220,2410,35
PAKWACH,2022,1240,1270,2510,35
PAKWACH,2023,1280,1310,2590,35
PAKWACH,2024,1330,1350,2680,35
PAKWACH,2025,1380,1390,2770,35
PALLISA,2015,910,1290,2200,35
PALLISA,2016,960,1370,2330,35
PALLISA,2017,1020,1460,2480,35
PALLISA,2018,1070,1540,2610,35
PALLISA,2019,1130,1640,2770,35
PALLISA,2020,1190,1730,2920,35
PALLISA,2021,1250,1830,3080,35
PALLISA,2022,1320,1930,3250,35
PALLISA,2023,1390,2060,3450,35
PALLISA,2024,1460,2210,3670,35
PALLISA,2025,1530,2360,3890,35
RAKAI,2015,1270,1510,2780,35
RAKAI,2016,1310,1570,2880,35
RAKAI,2017,1360,1640,3000,35
RAKAI,2018,1410,1700,3110,35
RAKAI,2019,1450,1760,3210,35
RAKAI,2020,1510,1830,3340,35
RAKAI,2021,1560,1890,3450,35
RAKAI,2022,1610,1960,3570,35
RAKAI,2023,1670,2050,3720,35
RAKAI,2024,1710,2150,3860,35
RAKAI,2025,1770,2250,4020,35
RUBANDA,2015,910,1280,2190,35
RUBANDA,2016,930,1290,2220,35
RUBANDA,2017,940,1300,2240,35
RUBANDA,2018,950,1310,2260,35
RUBANDA,2019,960,1320,2280,35
RUBANDA,2020,970,1330,2300,35
RUBANDA,2021,990,1340,2330,35
RUBANDA,2022,1000,1350,2350,35
RUBANDA,2023,1010,1350,2360,35
RUBANDA,2024,1010,1360,2370,35
RUBANDA,2025,1020,1360,2380,35
RUBIRIZI,2015,720,970,1690,35
RUBIRIZI,2016,740,990,1730,35
RUBIRIZI,2017,750,1010,1760,35
RUBIRIZI,2018,770,1030,1800,35
RUBIRIZI,2019,780,1050,1830,35
RUBIRIZI,2020,800,1070,1870,35
RUBIRIZI,2021,810,1090,1900,35
RUBIRIZI,2022,830,1110,1940,35
RUBIRIZI,2023,840,1120,1960,35
RUBIRIZI,2024,850,1140,1990,35
RUBIRIZI,2025,870,1160,2030,35
RUKIGA,2015,530,660,1190,35
RUKIGA,2016,540,670,1210,35
RUKIGA,2017,550,670,1220,35
RUKIGA,2018,550,670,1220,35
RUKIGA,2019,560,680,1240,35
RUKIGA,2020,560,680,1240,35
RUKIGA,2021,570,690,1260,35
RUKIGA,2022,570,690,1260,35
RUKIGA,2023,570,690,1260,35
RUKIGA,2024,580,690,1270,35
RUKIGA,2025,580,700,1280,35
RUKUNGIRI,2015,1680,2050,3730,35
RUKUNGIRI,2016,1700,2070,3770,35
RUKUNGIRI,2017,1720,2090,3810,35
RUKUNGIRI,2018,1740,2110,3850,35
RUKUNGIRI,2019,1760,2130,3890,35
RUKUNGIRI,2020,1780,2140,3920,35
RUKUNGIRI,2021,1800,2160,3960,35
RUKUNGIRI,2022,1820,2170,3990,35
RUKUNGIRI,2023,1830,2190,4020,35
RUKUNGIRI,2024,1850,2200,4050,35
RUKUNGIRI,2025,1860,2210,4070,35
RWAMPARA,2015,720,870,1590,35
RWAMPARA,2016,740,890,1630,35
RWAMPARA,2017,760,910,1670,35
RWAMPARA,2018,770,930,1700,35
RWAMPARA,2019,790,940,1730,35
RWAMPARA,2020,810,960,1770,35
RWAMPARA,2021,820,980,1800,35
RWAMPARA,2022,840,1000,1840,35
RWAMPARA,2023,860,1020,1880,35
RWAMPARA,2024,870,1040,1910,35
RWAMPARA,2025,890,1060,1950,35
SERERE,2015,1130,1380,2510,35
SERERE,2016,1190,1460,2650,35
SERERE,2017,1250,1540,2790,35
SERERE,2018,1310,1630,2940,35
SERERE,2019,1380,1720,3100,35
SERERE,2020,1440,1810,3250,35
SERERE,2021,1520,1910,3430,35
SERERE,2022,1600,2020,3620,35
SERERE,2023,1680,2140,3820,35
SERERE,2024,1760,2280,4040,35
SERERE,2025,1830,2430,4260,35
SHEEMA,2015,1290,1590,2880,35
SHEEMA,2016,1300,1610,2910,35
SHEEMA,2017,1320,1630,2950,35
SHEEMA,2018,1330,1640,2970,35
SHEEMA,2019,1350,1660,3010,35
SHEEMA,2020,1360,1670,3030,35
SHEEMA,2021,1380,1690,3070,35
SHEEMA,2022,1390,1700,3090,35
SHEEMA,2023,1400,1720,3120,35
SHEEMA,2024,1410,1730,3140,35
SHEEMA,2025,1420,1740,3160,35
SIRONKO,2015,1070,1230,2300,35
SIRONKO,2016,1090,1250,2340,35
SIRONKO,2017,1120,1280,2400,35
SIRONKO,2018,1150,1300,2450,35
SIRONKO,2019,1170,1330,2500,35
SIRONKO,2020,1200,1350,2550,35
SIRONKO,2021,1220,1380,2600,35
SIRONKO,2022,1250,1400,2650,35
SIRONKO,2023,1270,1430,2700,35
SIRONKO,2024,1300,1450,2750,35
SIRONKO,2025,1320,1470,2790,35
SOROTI,2015,1360,1660,3020,35
SOROTI,2016,1420,1750,3170,35
SOROTI,2017,1480,1850,3330,35
SOROTI,2018,1550,1940,3490,35
SOROTI,2019,1620,2030,3650,35
SOROTI,2020,1690,2130,3820,35
SOROTI,2021,1770,2240,4010,35
SOROTI,2022,1850,2350,4200,35
SOROTI,2023,1930,2490,4420,35
SOROTI,2024,2020,2640,4660,35
SOROTI,2025,2100,2800,4900,35
SSEMBABULE,2015,1320,1440,2760,35
SSEMBABULE,2016,1370,1510,2880,35
SSEMBABULE,2017,1420,1580,3000,35
SSEMBABULE,2018,1470,1650,3120,35
SSEMBABULE,2019,1530,1710,3240,35
SSEMBABULE,2020,1580,1780,3360,35
SSEMBABULE,2021,1650,1850,3500,35
SSEMBABULE,2022,1720,1930,3650,35
SSEMBABULE,2023,1770,2030,3800,35
SSEMBABULE,2024,1840,2140,3980,35
SSEMBABULE,2025,1900,2250,4150,35
TORORO,2015,2180,2560,4740,35
TORORO,2016,2240,2630,4870,35
TORORO,2017,2300,2700,5000,35
TORORO,2018,2360,2760,5120,35
TORORO,2019,2420,2830,5250,35
TORORO,2020,2490,2890,5380,35
TORORO,2021,2550,2960,5510,35
TORORO,2022,2610,3030,5640,35
TORORO,2023,2670,3090,5760,35
TORORO,2024,2730,3160,5890,35
TORORO,2025,2780,3220,6000,35
WAKISO,2015,19710,17320,37030,35
WAKISO,2016,21030,18500,39530,35
WAKISO,2017,22440,19770,42210,35
WAKISO,2018,23930,21110,45040,35
WAKISO,2019,25520,22530,48050,35
WAKISO,2020,27180,24020,51200,35
WAKISO,2021,28930,25620,54550,35
WAKISO,2022,30780,27310,58090,35
WAKISO,2023,32740,29060,61800,35
WAKISO,2024,34770,30910,65680,35
WAKISO,2025,36910,32880,69790,35
YUMBE,2015,1930,2770,4700,35
YUMBE,2016,2040,2980,5020,35
YUMBE,2017,2160,3210,5370,35
YUMBE,2018,2290,3450,5740,35
YUMBE,2019,2430,3710,6140,35
YUMBE,2020,2580,3980,6560,35
YUMBE,2021,2750,4270,7020,35
YUMBE,2022,2910,4600,7510,35
YUMBE,2023,3080,4980,8060,35
YUMBE,2024,3260,5410,8670,35
YUMBE,2025,3440,5870,9310,35
ZOMBO,2015,1130,1390,2520,35
ZOMBO,2016,1170,1430,2600,35
ZOMBO,2017,1200,1470,2670,35
ZOMBO,2018,1240,1510,2750,35
ZOMBO,2019,1280,1550,2830,35
ZOMBO,2020,1310,1590,2900,35
ZOMBO,2021,1350,1630,2980,35
ZOMBO,2022,1390,1670,3060,35
ZOMBO,2023,1420,1710,3130,35
ZOMBO,2024,1460,1750,3210,35
ZOMBO,2025,1500,1790,3290,35
ABIM,2015,400,450,850,36
ABIM,2016,420,480,900,36
ABIM,2017,460,530,990,36
ABIM,2018,490,560,1050,36
ABIM,2019,530,610,1140,36
ABIM,2020,570,650,1220,36
ABIM,2021,610,700,1310,36
ABIM,2022,660,750,1410,36
ABIM,2023,700,810,1510,36
ABIM,2024,750,880,1630,36
ABIM,2025,810,950,1760,36
ADJUMANI,2015,660,1010,1670,36
ADJUMANI,2016,670,1020,1690,36
ADJUMANI,2017,670,1030,1700,36
ADJUMANI,2018,680,1040,1720,36
ADJUMANI,2019,680,1050,1730,36
ADJUMANI,2020,690,1060,1750,36
ADJUMANI,2021,690,1070,1760,36
ADJUMANI,2022,690,1080,1770,36
ADJUMANI,2023,690,1080,1770,36
ADJUMANI,2024,700,1090,1790,36
ADJUMANI,2025,700,1100,1800,36
AGAGO,2015,810,920,1730,36
AGAGO,2016,820,930,1750,36
AGAGO,2017,840,950,1790,36
AGAGO,2018,850,970,1820,36
AGAGO,2019,870,980,1850,36
AGAGO,2020,880,1000,1880,36
AGAGO,2021,890,1020,1910,36
AGAGO,2022,910,1030,1940,36
AGAGO,2023,920,1050,1970,36
AGAGO,2024,930,1060,1990,36
AGAGO,2025,940,1070,2010,36
ALEBTONG,2015,800,870,1670,36
ALEBTONG,2016,840,920,1760,36
ALEBTONG,2017,870,1170,2040,36
ALEBTONG,2018,1120,1230,2350,36
ALEBTONG,2019,1170,1280,2450,36
ALEBTONG,2020,1200,1330,2530,36
ALEBTONG,2021,1250,1380,2630,36
ALEBTONG,2022,1300,1440,2740,36
ALEBTONG,2023,1340,1510,2850,36
ALEBTONG,2024,1390,1580,2970,36
ALEBTONG,2025,1430,1660,3090,36
AMOLATAR,2015,710,730,1440,36
AMOLATAR,2016,730,770,1500,36
AMOLATAR,2017,760,790,1550,36
AMOLATAR,2018,790,830,1620,36
AMOLATAR,2019,820,850,1670,36
AMOLATAR,2020,840,890,1730,36
AMOLATAR,2021,870,930,1800,36
AMOLATAR,2022,910,960,1870,36
AMOLATAR,2023,930,1010,1940,36
AMOLATAR,2024,960,1050,2010,36
AMOLATAR,2025,1000,1110,2110,36
AMUDAT,2015,430,390,820,36
AMUDAT,2016,460,410,870,36
AMUDAT,2017,470,440,910,36
AMUDAT,2018,500,480,980,36
AMUDAT,2019,520,510,1030,36
AMUDAT,2020,550,530,1080,36
AMUDAT,2021,580,560,1140,36
AMUDAT,2022,610,600,1210,36
AMUDAT,2023,630,640,1270,36
AMUDAT,2024,660,680,1340,36
AMUDAT,2025,690,730,1420,36
AMURIA,2015,690,770,1460,36
AMURIA,2016,710,810,1520,36
AMURIA,2017,740,850,1590,36
AMURIA,2018,790,900,1690,36
AMURIA,2019,820,940,1760,36
AMURIA,2020,850,990,1840,36
AMURIA,2021,890,1030,1920,36
AMURIA,2022,940,1090,2030,36
AMURIA,2023,980,1150,2130,36
AMURIA,2024,1030,1210,2240,36
AMURIA,2025,1070,1290,2360,36
AMURU,2015,790,870,1660,36
AMURU,2016,810,910,1720,36
AMURU,2017,840,950,1790,36
AMURU,2018,870,990,1860,36
AMURU,2019,900,1030,1930,36
AMURU,2020,930,1070,2000,36
AMURU,2021,970,1110,2080,36
AMURU,2022,1000,1150,2150,36
AMURU,2023,1040,1200,2240,36
AMURU,2024,1080,1260,2340,36
AMURU,2025,1100,1330,2430,36
APAC,2015,720,890,1610,36
APAC,2016,750,920,1670,36
APAC,2017,770,960,1730,36
APAC,2018,800,990,1790,36
APAC,2019,830,1020,1850,36
APAC,2020,860,1060,1920,36
APAC,2021,890,1090,1980,36
APAC,2022,920,1130,2050,36
APAC,2023,950,1160,2110,36
APAC,2024,980,1200,2180,36
APAC,2025,1010,1230,2240,36
ARUA,2015,2330,2920,5250,36
ARUA,2016,2400,3000,5400,36
ARUA,2017,2470,3090,5560,36
ARUA,2018,2540,3170,5710,36
ARUA,2019,2610,3250,5860,36
ARUA,2020,2680,3340,6020,36
ARUA,2021,2750,3420,6170,36
ARUA,2022,2820,3500,6320,36
ARUA,2023,2890,3590,6480,36
ARUA,2024,2960,3670,6630,36
ARUA,2025,3030,3750,6780,36
BUDAKA,2015,760,910,1670,36
BUDAKA,2016,780,950,1730,36
BUDAKA,2017,820,1010,1830,36
BUDAKA,2018,860,1060,1920,36
BUDAKA,2019,900,1110,2010,36
BUDAKA,2020,930,1170,2100,36
BUDAKA,2021,980,1230,2210,36
BUDAKA,2022,1030,1280,2310,36
BUDAKA,2023,1070,1350,2420,36
BUDAKA,2024,1110,1430,2540,36
BUDAKA,2025,1160,1510,2670,36
BUDUDA,2015,910,990,1900,36
BUDUDA,2016,960,1060,2020,36
BUDUDA,2017,1000,1130,2130,36
BUDUDA,2018,1060,1190,2250,36
BUDUDA,2019,1120,1260,2380,36
BUDUDA,2020,1180,1350,2530,36
BUDUDA,2021,1250,1420,2670,36
BUDUDA,2022,1310,1500,2810,36
BUDUDA,2023,1390,1600,2990,36
BUDUDA,2024,1460,1710,3170,36
BUDUDA,2025,1530,1830,3360,36
BUGIRI,2015,1440,1840,3280,36
BUGIRI,2016,1510,1940,3450,36
BUGIRI,2017,1580,2060,3640,36
BUGIRI,2018,1670,2170,3840,36
BUGIRI,2019,1750,2290,4040,36
BUGIRI,2020,1830,2420,4250,36
BUGIRI,2021,1920,2540,4460,36
BUGIRI,2022,2030,2670,4700,36
BUGIRI,2023,2130,2830,4960,36
BUGIRI,2024,2230,3000,5230,36
BUGIRI,2025,2340,3190,5530,36
BUGWERI,2015,600,760,1360,36
BUGWERI,2016,620,790,1410,36
BUGWERI,2017,640,830,1470,36
BUGWERI,2018,670,870,1540,36
BUGWERI,2019,700,890,1590,36
BUGWERI,2020,720,930,1650,36
BUGWERI,2021,750,970,1720,36
BUGWERI,2022,770,1010,1780,36
BUGWERI,2023,800,1050,1850,36
BUGWERI,2024,820,1100,1920,36
BUGWERI,2025,860,1160,2020,36
BUHWEJU,2015,480,520,1000,36
BUHWEJU,2016,490,540,1030,36
BUHWEJU,2017,510,550,1060,36
BUHWEJU,2018,520,570,1090,36
BUHWEJU,2019,540,590,1130,36
BUHWEJU,2020,560,600,1160,36
BUHWEJU,2021,570,620,1190,36
BUHWEJU,2022,590,640,1230,36
BUHWEJU,2023,610,650,1260,36
BUHWEJU,2024,620,670,1290,36
BUHWEJU,2025,640,690,1330,36
BUIKWE,2015,1750,2060,3810,36
BUIKWE,2016,1800,2130,3930,36
BUIKWE,2017,1870,2220,4090,36
BUIKWE,2018,1920,2300,4220,36
BUIKWE,2019,1970,2380,4350,36
BUIKWE,2020,2020,2470,4490,36
BUIKWE,2021,2080,2540,4620,36
BUIKWE,2022,2160,2630,4790,36
BUIKWE,2023,2220,2730,4950,36
BUIKWE,2024,2280,2850,5130,36
BUIKWE,2025,2330,2980,5310,36
BUKEDEA,2015,770,880,1650,36
BUKEDEA,2016,820,940,1760,36
BUKEDEA,2017,860,990,1850,36
BUKEDEA,2018,910,1050,1960,36
BUKEDEA,2019,950,1110,2060,36
BUKEDEA,2020,1010,1170,2180,36
BUKEDEA,2021,1050,1240,2290,36
BUKEDEA,2022,1120,1310,2430,36
BUKEDEA,2023,1180,1380,2560,36
BUKEDEA,2024,1230,1470,2700,36
BUKEDEA,2025,1290,1570,2860,36
BUKOMANSIMBI,2015,570,670,1240,36
BUKOMANSIMBI,2016,570,680,1250,36
BUKOMANSIMBI,2017,590,700,1290,36
BUKOMANSIMBI,2018,600,710,1310,36
BUKOMANSIMBI,2019,600,730,1330,36
BUKOMANSIMBI,2020,620,740,1360,36
BUKOMANSIMBI,2021,620,750,1370,36
BUKOMANSIMBI,2022,630,760,1390,36
BUKOMANSIMBI,2023,650,780,1430,36
BUKOMANSIMBI,2024,660,800,1460,36
BUKOMANSIMBI,2025,660,830,1490,36
BUKWO,2015,410,420,830,36
BUKWO,2016,440,440,880,36
BUKWO,2017,460,470,930,36
BUKWO,2018,480,490,970,36
BUKWO,2019,510,510,1020,36
BUKWO,2020,530,540,1070,36
BUKWO,2021,560,560,1120,36
BUKWO,2022,590,590,1180,36
BUKWO,2023,620,610,1230,36
BUKWO,2024,650,640,1290,36
BUKWO,2025,680,670,1350,36
BULAMBULI,2015,840,860,1700,36
BULAMBULI,2016,890,920,1810,36
BULAMBULI,2017,930,970,1900,36
BULAMBULI,2018,990,1040,2030,36
BULAMBULI,2019,1060,1100,2160,36
BULAMBULI,2020,1120,1180,2300,36
BULAMBULI,2021,1180,1250,2430,36
BULAMBULI,2022,1250,1340,2590,36
BULAMBULI,2023,1330,1420,2750,36
BULAMBULI,2024,1390,1520,2910,36
BULAMBULI,2025,1470,1640,3110,36
BULIISA,2015,510,380,890,36
BULIISA,2016,540,400,940,36
BULIISA,2017,570,420,990,36
BULIISA,2018,600,440,1040,36
BULIISA,2019,630,460,1090,36
BULIISA,2020,670,480,1150,36
BULIISA,2021,700,500,1200,36
BULIISA,2022,740,520,1260,36
BULIISA,2023,770,540,1310,36
BULIISA,2024,810,560,1370,36
BULIISA,2025,850,580,1430,36
BUNDIBUGYO,2015,880,990,1870,36
BUNDIBUGYO,2016,910,1040,1950,36
BUNDIBUGYO,2017,960,1080,2040,36
BUNDIBUGYO,2018,990,1130,2120,36
BUNDIBUGYO,2019,1030,1180,2210,36
BUNDIBUGYO,2020,1070,1230,2300,36
BUNDIBUGYO,2021,1110,1280,2390,36
BUNDIBUGYO,2022,1150,1340,2490,36
BUNDIBUGYO,2023,1200,1390,2590,36
BUNDIBUGYO,2024,1240,1450,2690,36
BUNDIBUGYO,2025,1290,1540,2830,36
BUNYANGABU,2015,730,830,1560,36
BUNYANGABU,2016,750,870,1620,36
BUNYANGABU,2017,780,900,1680,36
BUNYANGABU,2018,810,940,1750,36
BUNYANGABU,2019,830,980,1810,36
BUNYANGABU,2020,860,1010,1870,36
BUNYANGABU,2021,890,1050,1940,36
BUNYANGABU,2022,930,1090,2020,36
BUNYANGABU,2023,950,1120,2070,36
BUNYANGABU,2024,990,1180,2170,36
BUNYANGABU,2025,1020,1230,2250,36
BUSHENYI,2015,900,1090,1990,36
BUSHENYI,2016,910,1100,2010,36
BUSHENYI,2017,920,1110,2030,36
BUSHENYI,2018,930,1120,2050,36
BUSHENYI,2019,950,1130,2080,36
BUSHENYI,2020,960,1140,2100,36
BUSHENYI,2021,960,1140,2100,36
BUSHENYI,2022,970,1150,2120,36
BUSHENYI,2023,980,1160,2140,36
BUSHENYI,2024,990,1160,2150,36
BUSHENYI,2025,1000,1170,2170,36
BUSIA,2015,1390,1720,3110,36
BUSIA,2016,1450,1800,3250,36
BUSIA,2017,1510,1890,3400,36
BUSIA,2018,1570,1970,3540,36
BUSIA,2019,1630,2070,3700,36
BUSIA,2020,1700,2150,3850,36
BUSIA,2021,1760,2250,4010,36
BUSIA,2022,1850,2330,4180,36
BUSIA,2023,1920,2450,4370,36
BUSIA,2024,1990,2570,4560,36
BUSIA,2025,2060,2710,4770,36
BUTALEJA,2015,890,990,1880,36
BUTALEJA,2016,940,1050,1990,36
BUTALEJA,2017,980,1100,2080,36
BUTALEJA,2018,1020,1160,2180,36
BUTALEJA,2019,1070,1230,2300,36
BUTALEJA,2020,1130,1280,2410,36
BUTALEJA,2021,1180,1340,2520,36
BUTALEJA,2022,1230,1410,2640,36
BUTALEJA,2023,1290,1480,2770,36
BUTALEJA,2024,1340,1580,2920,36
BUTALEJA,2025,1410,1660,3070,36
BUTAMBALA,2015,360,400,760,36
BUTAMBALA,2016,360,410,770,36
BUTAMBALA,2017,380,430,810,36
BUTAMBALA,2018,380,440,820,36
BUTAMBALA,2019,380,450,830,36
BUTAMBALA,2020,400,470,870,36
BUTAMBALA,2021,400,470,870,36
BUTAMBALA,2022,420,480,900,36
BUTAMBALA,2023,430,500,930,36
BUTAMBALA,2024,430,520,950,36
BUTAMBALA,2025,450,530,980,36
BUTEBO,2015,370,550,920,36
BUTEBO,2016,370,560,930,36
BUTEBO,2017,390,590,980,36
BUTEBO,2018,390,600,990,36
BUTEBO,2019,410,620,1030,36
BUTEBO,2020,410,640,1050,36
BUTEBO,2021,430,650,1080,36
BUTEBO,2022,430,670,1100,36
BUTEBO,2023,450,690,1140,36
BUTEBO,2024,460,720,1180,36
BUTEBO,2025,470,740,1210,36
BUVUMA,2015,670,470,1140,36
BUVUMA,2016,720,510,1230,36
BUVUMA,2017,760,540,1300,36
BUVUMA,2018,810,580,1390,36
BUVUMA,2019,860,620,1480,36
BUVUMA,2020,910,660,1570,36
BUVUMA,2021,960,700,1660,36
BUVUMA,2022,1020,740,1760,36
BUVUMA,2023,1080,790,1870,36
BUVUMA,2024,1140,840,1980,36
BUVUMA,2025,1200,900,2100,36
BUYENDE,2015,1080,1310,2390,36
BUYENDE,2016,1150,1380,2530,36
BUYENDE,2017,1200,1470,2670,36
BUYENDE,2018,1270,1560,2830,36
BUYENDE,2019,1330,1650,2980,36
BUYENDE,2020,1410,1750,3160,36
BUYENDE,2021,1480,1840,3320,36
BUYENDE,2022,1580,1940,3520,36
BUYENDE,2023,1660,2060,3720,36
BUYENDE,2024,1730,2200,3930,36
BUYENDE,2025,1830,2350,4180,36
DOKOLO,2015,630,760,1390,36
DOKOLO,2016,650,780,1430,36
DOKOLO,2017,670,800,1470,36
DOKOLO,2018,690,820,1510,36
DOKOLO,2019,710,850,1560,36
DOKOLO,2020,730,870,1600,36
DOKOLO,2021,760,890,1650,36
DOKOLO,2022,780,910,1690,36
DOKOLO,2023,800,930,1730,36
DOKOLO,2024,820,960,1780,36
DOKOLO,2025,840,980,1820,36
GOMBA,2015,700,690,1390,36
GOMBA,2016,710,710,1420,36
GOMBA,2017,730,730,1460,36
GOMBA,2018,750,760,1510,36
GOMBA,2019,770,770,1540,36
GOMBA,2020,790,790,1580,36
GOMBA,2021,810,820,1630,36
GOMBA,2022,830,830,1660,36
GOMBA,2023,850,860,1710,36
GOMBA,2024,870,880,1750,36
GOMBA,2025,890,920,1810,36
GULU,2015,1150,1270,2420,36
GULU,2016,1190,1300,2490,36
GULU,2017,1220,1340,2560,36
GULU,2018,1260,1380,2640,36
GULU,2019,1300,1420,2720,36
GULU,2020,1330,1460,2790,36
GULU,2021,1370,1500,2870,36
GULU,2022,1410,1540,2950,36
GULU,2023,1440,1580,3020,36
GULU,2024,1480,1620,3100,36
GULU,2025,1520,1660,3180,36
HOIMA,2015,1420,1380,2800,36
HOIMA,2016,1480,1420,2900,36
HOIMA,2017,1530,1470,3000,36
HOIMA,2018,1590,1520,3110,36
HOIMA,2019,1650,1580,3230,36
HOIMA,2020,1710,1630,3340,36
HOIMA,2021,1770,1680,3450,36
HOIMA,2022,1830,1730,3560,36
HOIMA,2023,1890,1790,3680,36
HOIMA,2024,1950,1840,3790,36
HOIMA,2025,2010,1900,3910,36
IBANDA,2015,1100,1210,2310,36
IBANDA,2016,1130,1230,2360,36
IBANDA,2017,1150,1250,2400,36
IBANDA,2018,1170,1280,2450,36
IBANDA,2019,1190,1300,2490,36
IBANDA,2020,1210,1320,2530,36
IBANDA,2021,1240,1340,2580,36
IBANDA,2022,1260,1360,2620,36
IBANDA,2023,1280,1380,2660,36
IBANDA,2024,1300,1400,2700,36
IBANDA,2025,1320,1420,2740,36
IGANGA,2015,1320,1730,3050,36
IGANGA,2016,1380,1820,3200,36
IGANGA,2017,1440,1910,3350,36
IGANGA,2018,1490,1990,3480,36
IGANGA,2019,1550,2080,3630,36
IGANGA,2020,1610,2180,3790,36
IGANGA,2021,1680,2260,3940,36
IGANGA,2022,1760,2360,4120,36
IGANGA,2023,1830,2460,4290,36
IGANGA,2024,1900,2600,4500,36
IGANGA,2025,1970,2730,4700,36
ISINGIRO,2015,1820,2320,4140,36
ISINGIRO,2016,1890,2410,4300,36
ISINGIRO,2017,1960,2490,4450,36
ISINGIRO,2018,2030,2580,4610,36
ISINGIRO,2019,2110,2670,4780,36
ISINGIRO,2020,2180,2760,4940,36
ISINGIRO,2021,2260,2850,5110,36
ISINGIRO,2022,2330,2940,5270,36
ISINGIRO,2023,2410,3030,5440,36
ISINGIRO,2024,2490,3130,5620,36
ISINGIRO,2025,2570,3220,5790,36
JINJA,2015,1870,2080,3950,36
JINJA,2016,1900,2110,4010,36
JINJA,2017,1930,2140,4070,36
JINJA,2018,1960,2180,4140,36
JINJA,2019,1990,2210,4200,36
JINJA,2020,2020,2240,4260,36
JINJA,2021,2050,2270,4320,36
JINJA,2022,2080,2300,4380,36
JINJA,2023,2110,2320,4430,36
JINJA,2024,2130,2350,4480,36
JINJA,2025,2160,2380,4540,36
KAABONG,2015,340,340,680,36
KAABONG,2016,350,340,690,36
KAABONG,2017,360,350,710,36
KAABONG,2018,360,360,720,36
KAABONG,2019,380,370,750,36
KAABONG,2020,380,380,760,36
KAABONG,2021,400,390,790,36
KAABONG,2022,400,400,800,36
KAABONG,2023,410,400,810,36
KAABONG,2024,420,410,830,36
KAABONG,2025,430,420,850,36
KABALE,2015,940,1150,2090,36
KABALE,2016,960,1170,2130,36
KABALE,2017,980,1180,2160,36
KABALE,2018,990,1200,2190,36
KABALE,2019,1000,1210,2210,36
KABALE,2020,1020,1220,2240,36
KABALE,2021,1030,1230,2260,36
KABALE,2022,1040,1250,2290,36
KABALE,2023,1060,1260,2320,36
KABALE,2024,1070,1270,2340,36
KABALE,2025,1080,1280,2360,36
KABAROLE,2015,1370,1330,2700,36
KABAROLE,2016,1400,1360,2760,36
KABAROLE,2017,1430,1390,2820,36
KABAROLE,2018,1460,1420,2880,36
KABAROLE,2019,1490,1440,2930,36
KABAROLE,2020,1520,1470,2990,36
KABAROLE,2021,1550,1500,3050,36
KABAROLE,2022,1580,1530,3110,36
KABAROLE,2023,1610,1560,3170,36
KABAROLE,2024,1630,1590,3220,36
KABAROLE,2025,1660,1610,3270,36
KABERAMAIDO,2015,430,470,900,36
KABERAMAIDO,2016,460,510,970,36
KABERAMAIDO,2017,480,540,1020,36
KABERAMAIDO,2018,510,570,1080,36
KABERAMAIDO,2019,530,590,1120,36
KABERAMAIDO,2020,560,630,1190,36
KABERAMAIDO,2021,590,660,1250,36
KABERAMAIDO,2022,620,700,1320,36
KABERAMAIDO,2023,650,740,1390,36
KABERAMAIDO,2024,680,790,1470,36
KABERAMAIDO,2025,720,840,1560,36
KAGADI,2015,1320,1540,2860,36
KAGADI,2016,1370,1590,2960,36
KAGADI,2017,1420,1650,3070,36
KAGADI,2018,1470,1710,3180,36
KAGADI,2019,1530,1770,3300,36
KAGADI,2020,1580,1830,3410,36
KAGADI,2021,1640,1890,3530,36
KAGADI,2022,1690,1950,3640,36
KAGADI,2023,1750,2010,3760,36
KAGADI,2024,1810,2070,3880,36
KAGADI,2025,1860,2140,4000,36
KAKUMIRO,2015,1330,1260,2590,36
KAKUMIRO,2016,1440,1360,2800,36
KAKUMIRO,2017,1570,1480,3050,36
KAKUMIRO,2018,1710,1600,3310,36
KAKUMIRO,2019,1860,1730,3590,36
KAKUMIRO,2020,2020,1880,3900,36
KAKUMIRO,2021,2190,2030,4220,36
KAKUMIRO,2022,2380,2200,4580,36
KAKUMIRO,2023,2580,2370,4950,36
KAKUMIRO,2024,2800,2560,5360,36
KAKUMIRO,2025,3030,2770,5800,36
KALAKI,2015,380,450,830,36
KALAKI,2016,400,460,860,36
KALAKI,2017,420,480,900,36
KALAKI,2018,430,500,930,36
KALAKI,2019,450,520,970,36
KALAKI,2020,470,540,1010,36
KALAKI,2021,490,560,1050,36
KALAKI,2022,510,580,1090,36
KALAKI,2023,530,600,1130,36
KALAKI,2024,550,620,1170,36
KALAKI,2025,570,640,1210,36
KALANGALA,2015,570,350,920,36
KALANGALA,2016,590,360,950,36
KALANGALA,2017,610,380,990,36
KALANGALA,2018,630,390,1020,36
KALANGALA,2019,660,410,1070,36
KALANGALA,2020,680,420,1100,36
KALANGALA,2021,700,440,1140,36
KALANGALA,2022,720,460,1180,36
KALANGALA,2023,750,470,1220,36
KALANGALA,2024,770,490,1260,36
KALANGALA,2025,790,510,1300,36
KALIRO,2015,880,1060,1940,36
KALIRO,2016,930,1120,2050,36
KALIRO,2017,970,1170,2140,36
KALIRO,2018,1010,1240,2250,36
KALIRO,2019,1060,1300,2360,36
KALIRO,2020,1100,1370,2470,36
KALIRO,2021,1150,1430,2580,36
KALIRO,2022,1200,1500,2700,36
KALIRO,2023,1250,1570,2820,36
KALIRO,2024,1300,1670,2970,36
KALIRO,2025,1370,1780,3150,36
KALUNGU,2015,770,890,1660,36
KALUNGU,2016,780,920,1700,36
KALUNGU,2017,790,930,1720,36
KALUNGU,2018,810,960,1770,36
KALUNGU,2019,830,990,1820,36
KALUNGU,2020,850,1010,1860,36
KALUNGU,2021,860,1030,1890,36
KALUNGU,2022,880,1060,1940,36
KALUNGU,2023,900,1080,1980,36
KALUNGU,2024,910,1130,2040,36
KALUNGU,2025,930,1160,2090,36
KAMPALA,2015,7260,7850,15110,36
KAMPALA,2016,7400,8000,15400,36
KAMPALA,2017,7550,8160,15710,36
KAMPALA,2018,7690,8310,16000,36
KAMPALA,2019,7840,8470,16310,36
KAMPALA,2020,7980,8620,16600,36
KAMPALA,2021,8120,8770,16890,36
KAMPALA,2022,8260,8910,17170,36
KAMPALA,2023,8390,9060,17450,36
KAMPALA,2024,8520,9200,17720,36
KAMPALA,2025,8640,9330,17970,36
KAMULI,2015,1710,2210,3920,36
KAMULI,2016,1770,2310,4080,36
KAMULI,2017,1830,2400,4230,36
KAMULI,2018,1890,2490,4380,36
KAMULI,2019,1960,2590,4550,36
KAMULI,2020,2020,2680,4700,36
KAMULI,2021,2090,2780,4870,36
KAMULI,2022,2170,2880,5050,36
KAMULI,2023,2240,2990,5230,36
KAMULI,2024,2330,3140,5470,36
KAMULI,2025,2390,3290,5680,36
KAMWENGE,2015,1090,1170,2260,36
KAMWENGE,2016,1130,1220,2350,36
KAMWENGE,2017,1180,1260,2440,36
KAMWENGE,2018,1230,1300,2530,36
KAMWENGE,2019,1280,1350,2630,36
KAMWENGE,2020,1330,1390,2720,36
KAMWENGE,2021,1380,1440,2820,36
KAMWENGE,2022,1430,1490,2920,36
KAMWENGE,2023,1480,1540,3020,36
KAMWENGE,2024,1540,1590,3130,36
KAMWENGE,2025,1590,1630,3220,36
KANUNGU,2015,960,1250,2210,36
KANUNGU,2016,970,1270,2240,36
KANUNGU,2017,990,1290,2280,36
KANUNGU,2018,1010,1310,2320,36
KANUNGU,2019,1030,1330,2360,36
KANUNGU,2020,1040,1350,2390,36
KANUNGU,2021,1060,1370,2430,36
KANUNGU,2022,1080,1390,2470,36
KANUNGU,2023,1090,1410,2500,36
KANUNGU,2024,1110,1430,2540,36
KANUNGU,2025,1120,1440,2560,36
KAPCHORWA,2015,440,500,940,36
KAPCHORWA,2016,460,510,970,36
KAPCHORWA,2017,470,530,1000,36
KAPCHORWA,2018,490,540,1030,36
KAPCHORWA,2019,500,560,1060,36
KAPCHORWA,2020,510,570,1080,36
KAPCHORWA,2021,530,590,1120,36
KAPCHORWA,2022,540,600,1140,36
KAPCHORWA,2023,560,620,1180,36
KAPCHORWA,2024,570,630,1200,36
KAPCHORWA,2025,590,650,1240,36
KAPELEBYONG,2015,300,390,690,36
KAPELEBYONG,2016,320,410,730,36
KAPELEBYONG,2017,330,430,760,36
KAPELEBYONG,2018,350,450,800,36
KAPELEBYONG,2019,360,470,830,36
KAPELEBYONG,2020,380,490,870,36
KAPELEBYONG,2021,390,510,900,36
KAPELEBYONG,2022,410,530,940,36
KAPELEBYONG,2023,430,560,990,36
KAPELEBYONG,2024,440,580,1020,36
KAPELEBYONG,2025,460,620,1080,36
KASESE,2015,2870,3390,6260,36
KASESE,2016,2960,3520,6480,36
KASESE,2017,3060,3670,6730,36
KASESE,2018,3170,3820,6990,36
KASESE,2019,3270,3950,7220,36
KASESE,2020,3380,4100,7480,36
KASESE,2021,3490,4240,7730,36
KASESE,2022,3620,4390,8010,36
KASESE,2023,3740,4560,8300,36
KASESE,2024,3850,4770,8620,36
KASESE,2025,3960,4990,8950,36
KASSANDA,2015,1140,1140,2280,36
KASSANDA,2016,1170,1160,2330,36
KASSANDA,2017,1200,1190,2390,36
KASSANDA,2018,1240,1210,2450,36
KASSANDA,2019,1270,1240,2510,36
KASSANDA,2020,1310,1260,2570,36
KASSANDA,2021,1340,1290,2630,36
KASSANDA,2022,1370,1310,2680,36
KASSANDA,2023,1410,1340,2750,36
KASSANDA,2024,1440,1360,2800,36
KASSANDA,2025,1480,1380,2860,36
KATAKWI,2015,660,810,1470,36
KATAKWI,2016,690,850,1540,36
KATAKWI,2017,720,890,1610,36
KATAKWI,2018,750,930,1680,36
KATAKWI,2019,780,970,1750,36
KATAKWI,2020,810,1010,1820,36
KATAKWI,2021,830,1030,1860,36
KATAKWI,2022,870,1080,1950,36
KATAKWI,2023,900,1120,2020,36
KATAKWI,2024,940,1180,2120,36
KATAKWI,2025,970,1250,2220,36
KAYUNGA,2015,1420,1650,3070,36
KAYUNGA,2016,1460,1720,3180,36
KAYUNGA,2017,1500,1770,3270,36
KAYUNGA,2018,1550,1840,3390,36
KAYUNGA,2019,1590,1900,3490,36
KAYUNGA,2020,1640,1950,3590,36
KAYUNGA,2021,1680,2010,3690,36
KAYUNGA,2022,1740,2070,3810,36
KAYUNGA,2023,1780,2140,3920,36
KAYUNGA,2024,1820,2230,4050,36
KAYUNGA,2025,1880,2310,4190,36
KAZO,2015,690,860,1550,36
KAZO,2016,710,890,1600,36
KAZO,2017,740,920,1660,36
KAZO,2018,770,950,1720,36
KAZO,2019,800,980,1780,36
KAZO,2020,820,1020,1840,36
KAZO,2021,860,1050,1910,36
KAZO,2022,880,1080,1960,36
KAZO,2023,920,1120,2040,36
KAZO,2024,950,1150,2100,36
KAZO,2025,980,1190,2170,36
KIBAALE,2015,540,650,1190,36
KIBAALE,2016,580,690,1270,36
KIBAALE,2017,610,730,1340,36
KIBAALE,2018,650,770,1420,36
KIBAALE,2019,690,810,1500,36
KIBAALE,2020,740,860,1600,36
KIBAALE,2021,780,910,1690,36
KIBAALE,2022,830,960,1790,36
KIBAALE,2023,880,1010,1890,36
KIBAALE,2024,930,1060,1990,36
KIBAALE,2025,980,1120,2100,36
KIBOGA,2015,680,720,1400,36
KIBOGA,2016,710,740,1450,36
KIBOGA,2017,730,780,1510,36
KIBOGA,2018,760,810,1570,36
KIBOGA,2019,790,840,1630,36
KIBOGA,2020,810,880,1690,36
KIBOGA,2021,840,900,1740,36
KIBOGA,2022,880,950,1830,36
KIBOGA,2023,900,970,1870,36
KIBOGA,2024,940,1020,1960,36
KIBOGA,2025,970,1070,2040,36
KIBUKU,2015,690,880,1570,36
KIBUKU,2016,710,930,1640,36
KIBUKU,2017,760,980,1740,36
KIBUKU,2018,790,1040,1830,36
KIBUKU,2019,830,1090,1920,36
KIBUKU,2020,860,1150,2010,36
KIBUKU,2021,910,1200,2110,36
KIBUKU,2022,950,1270,2220,36
KIBUKU,2023,1000,1340,2340,36
KIBUKU,2024,1040,1410,2450,36
KIBUKU,2025,1090,1510,2600,36
KIKUUBE,2015,1190,1240,2430,36
KIKUUBE,2016,1250,1310,2560,36
KIKUUBE,2017,1320,1370,2690,36
KIKUUBE,2018,1390,1440,2830,36
KIKUUBE,2019,1460,1510,2970,36
KIKUUBE,2020,1540,1590,3130,36
KIKUUBE,2021,1620,1670,3290,36
KIKUUBE,2022,1700,1750,3450,36
KIKUUBE,2023,1780,1830,3610,36
KIKUUBE,2024,1870,1920,3790,36
KIKUUBE,2025,1960,2000,3960,36
KIRUHURA,2015,740,690,1430,36
KIRUHURA,2016,760,720,1480,36
KIRUHURA,2017,790,740,1530,36
KIRUHURA,2018,820,770,1590,36
KIRUHURA,2019,850,790,1640,36
KIRUHURA,2020,890,820,1710,36
KIRUHURA,2021,920,850,1770,36
KIRUHURA,2022,950,880,1830,36
KIRUHURA,2023,980,900,1880,36
KIRUHURA,2024,1010,930,1940,36
KIRUHURA,2025,1050,960,2010,36
KIRYANDONGO,2015,1070,1210,2280,36
KIRYANDONGO,2016,1110,1270,2380,36
KIRYANDONGO,2017,1160,1330,2490,36
KIRYANDONGO,2018,1190,1390,2580,36
KIRYANDONGO,2019,1250,1450,2700,36
KIRYANDONGO,2020,1300,1510,2810,36
KIRYANDONGO,2021,1350,1570,2920,36
KIRYANDONGO,2022,1400,1630,3030,36
KIRYANDONGO,2023,1450,1710,3160,36
KIRYANDONGO,2024,1510,1790,3300,36
KIRYANDONGO,2025,1560,1890,3450,36
KISORO,2015,810,1270,2080,36
KISORO,2016,840,1330,2170,36
KISORO,2017,860,1380,2240,36
KISORO,2018,890,1430,2320,36
KISORO,2019,910,1470,2380,36
KISORO,2020,950,1520,2470,36
KISORO,2021,970,1580,2550,36
KISORO,2022,990,1630,2620,36
KISORO,2023,1030,1690,2720,36
KISORO,2024,1050,1770,2820,36
KISORO,2025,1070,1850,2920,36
KITAGWENDA,2015,570,680,1250,36
KITAGWENDA,2016,600,710,1310,36
KITAGWENDA,2017,620,740,1360,36
KITAGWENDA,2018,650,760,1410,36
KITAGWENDA,2019,670,790,1460,36
KITAGWENDA,2020,700,820,1520,36
KITAGWENDA,2021,730,840,1570,36
KITAGWENDA,2022,750,870,1620,36
KITAGWENDA,2023,780,900,1680,36
KITAGWENDA,2024,810,930,1740,36
KITAGWENDA,2025,840,960,1800,36
KITGUM,2015,990,1010,2000,36
KITGUM,2016,1010,1040,2050,36
KITGUM,2017,1030,1080,2110,36
KITGUM,2018,1060,1110,2170,36
KITGUM,2019,1080,1140,2220,36
KITGUM,2020,1120,1180,2300,36
KITGUM,2021,1140,1210,2350,36
KITGUM,2022,1180,1240,2420,36
KITGUM,2023,1200,1280,2480,36
KITGUM,2024,1230,1350,2580,36
KITGUM,2025,1250,1400,2650,36
KOBOKO,2015,980,1160,2140,36
KOBOKO,2016,1020,1210,2230,36
KOBOKO,2017,1070,1280,2350,36
KOBOKO,2018,1130,1350,2480,36
KOBOKO,2019,1190,1420,2610,36
KOBOKO,2020,1240,1510,2750,36
KOBOKO,2021,1300,1580,2880,36
KOBOKO,2022,1360,1660,3020,36
KOBOKO,2023,1440,1760,3200,36
KOBOKO,2024,1510,1860,3370,36
KOBOKO,2025,1570,1990,3560,36
KOLE,2015,870,1020,1890,36
KOLE,2016,890,1050,1940,36
KOLE,2017,920,1080,2000,36
KOLE,2018,950,1110,2060,36
KOLE,2019,980,1140,2120,36
KOLE,2020,1010,1170,2180,36
KOLE,2021,1050,1200,2250,36
KOLE,2022,1080,1240,2320,36
KOLE,2023,1110,1270,2380,36
KOLE,2024,1140,1300,2440,36
KOLE,2025,1170,1330,2500,36
KOTIDO,2015,660,800,1460,36
KOTIDO,2016,680,820,1500,36
KOTIDO,2017,710,860,1570,36
KOTIDO,2018,730,890,1620,36
KOTIDO,2019,760,930,1690,36
KOTIDO,2020,780,960,1740,36
KOTIDO,2021,810,1000,1810,36
KOTIDO,2022,830,1020,1850,36
KOTIDO,2023,870,1070,1940,36
KOTIDO,2024,890,1110,2000,36
KOTIDO,2025,920,1180,2100,36
KUMI,2015,1010,1110,2120,36
KUMI,2016,1050,1170,2220,36
KUMI,2017,1100,1220,2320,36
KUMI,2018,1140,1280,2420,36
KUMI,2019,1190,1340,2530,36
KUMI,2020,1240,1400,2640,36
KUMI,2021,1300,1460,2760,36
KUMI,2022,1350,1520,2870,36
KUMI,2023,1400,1590,2990,36
KUMI,2024,1460,1660,3120,36
KUMI,2025,1510,1750,3260,36
KWANIA,2015,650,760,1410,36
KWANIA,2016,670,780,1450,36
KWANIA,2017,690,800,1490,36
KWANIA,2018,710,820,1530,36
KWANIA,2019,730,850,1580,36
KWANIA,2020,750,870,1620,36
KWANIA,2021,770,890,1660,36
KWANIA,2022,800,920,1720,36
KWANIA,2023,820,940,1760,36
KWANIA,2024,840,960,1800,36
KWANIA,2025,860,980,1840,36
KWEEN,2015,430,460,890,36
KWEEN,2016,450,470,920,36
KWEEN,2017,460,490,950,36
KWEEN,2018,470,500,970,36
KWEEN,2019,490,510,1000,36
KWEEN,2020,500,520,1020,36
KWEEN,2021,520,530,1050,36
KWEEN,2022,530,540,1070,36
KWEEN,2023,550,560,1110,36
KWEEN,2024,560,570,1130,36
KWEEN,2025,580,580,1160,36
KYANKWANZI,2015,950,850,1800,36
KYANKWANZI,2016,1000,890,1890,36
KYANKWANZI,2017,1050,930,1980,36
KYANKWANZI,2018,1100,970,2070,36
KYANKWANZI,2019,1160,1020,2180,36
KYANKWANZI,2020,1220,1060,2280,36
KYANKWANZI,2021,1270,1110,2380,36
KYANKWANZI,2022,1340,1160,2500,36
KYANKWANZI,2023,1400,1210,2610,36
KYANKWANZI,2024,1470,1260,2730,36
KYANKWANZI,2025,1530,1310,2840,36
KYEGEGWA,2015,1250,1300,2550,36
KYEGEGWA,2016,1350,1400,2750,36
KYEGEGWA,2017,1460,1510,2970,36
KYEGEGWA,2018,1580,1630,3210,36
KYEGEGWA,2019,1710,1760,3470,36
KYEGEGWA,2020,1850,1900,3750,36
KYEGEGWA,2021,2000,2040,4040,36
KYEGEGWA,2022,2150,2200,4350,36
KYEGEGWA,2023,2320,2360,4680,36
KYEGEGWA,2024,2500,2540,5040,36
KYEGEGWA,2025,2690,2730,5420,36
KYENJOJO,2015,1670,1690,3360,36
KYENJOJO,2016,1730,1750,3480,36
KYENJOJO,2017,1810,1810,3620,36
KYENJOJO,2018,1880,1880,3760,36
KYENJOJO,2019,1950,1950,3900,36
KYENJOJO,2020,2030,2020,4050,36
KYENJOJO,2021,2110,2090,4200,36
KYENJOJO,2022,2190,2160,4350,36
KYENJOJO,2023,2270,2230,4500,36
KYENJOJO,2024,2350,2300,4650,36
KYENJOJO,2025,2440,2380,4820,36
KYOTERA,2015,1190,1420,2610,36
KYOTERA,2016,1210,1460,2670,36
KYOTERA,2017,1240,1510,2750,36
KYOTERA,2018,1270,1560,2830,36
KYOTERA,2019,1310,1600,2910,36
KYOTERA,2020,1330,1650,2980,36
KYOTERA,2021,1370,1690,3060,36
KYOTERA,2022,1410,1740,3150,36
KYOTERA,2023,1440,1790,3230,36
KYOTERA,2024,1480,1860,3340,36
KYOTERA,2025,1510,1930,3440,36
KARENGA,2015,240,240,480,36
KARENGA,2016,250,250,500,36
KARENGA,2017,250,250,500,36
KARENGA,2018,260,260,520,36
KARENGA,2019,270,270,540,36
KARENGA,2020,280,270,550,36
KARENGA,2021,280,280,560,36
KARENGA,2022,290,280,570,36
KARENGA,2023,290,290,580,36
KARENGA,2024,300,300,600,36
KARENGA,2025,310,300,610,36
LAMWO,2015,620,660,1280,36
LAMWO,2016,620,680,1300,36
LAMWO,2017,640,700,1340,36
LAMWO,2018,640,720,1360,36
LAMWO,2019,660,740,1400,36
LAMWO,2020,670,770,1440,36
LAMWO,2021,690,780,1470,36
LAMWO,2022,690,800,1490,36
LAMWO,2023,710,830,1540,36
LAMWO,2024,720,860,1580,36
LAMWO,2025,730,900,1630,36
LIRA,2015,1650,1690,3340,36
LIRA,2016,1700,1740,3440,36
LIRA,2017,1740,1790,3530,36
LIRA,2018,1790,1840,3630,36
LIRA,2019,1840,1890,3730,36
LIRA,2020,1890,1940,3830,36
LIRA,2021,1940,2000,3940,36
LIRA,2022,1990,2050,4040,36
LIRA,2023,2040,2100,4140,36
LIRA,2024,2080,2150,4230,36
LIRA,2025,2130,2200,4330,36
LUUKA,2015,840,1110,1950,36
LUUKA,2016,870,1150,2020,36
LUUKA,2017,890,1200,2090,36
LUUKA,2018,920,1240,2160,36
LUUKA,2019,940,1290,2230,36
LUUKA,2020,970,1330,2300,36
LUUKA,2021,990,1380,2370,36
LUUKA,2022,1030,1410,2440,36
LUUKA,2023,1050,1470,2520,36
LUUKA,2024,1090,1540,2630,36
LUUKA,2025,1110,1610,2720,36
LUWERO,2015,1950,2230,4180,36
LUWERO,2016,2030,2320,4350,36
LUWERO,2017,2090,2420,4510,36
LUWERO,2018,2170,2510,4680,36
LUWERO,2019,2230,2600,4830,36
LUWERO,2020,2320,2710,5030,36
LUWERO,2021,2390,2800,5190,36
LUWERO,2022,2480,2900,5380,36
LUWERO,2023,2570,3020,5590,36
LUWERO,2024,2650,3150,5800,36
LUWERO,2025,2720,3300,6020,36
LWENGO,2015,1130,1470,2600,36
LWENGO,2016,1150,1510,2660,36
LWENGO,2017,1170,1550,2720,36
LWENGO,2018,1190,1580,2770,36
LWENGO,2019,1230,1620,2850,36
LWENGO,2020,1240,1660,2900,36
LWENGO,2021,1260,1700,2960,36
LWENGO,2022,1290,1740,3030,36
LWENGO,2023,1320,1790,3110,36
LWENGO,2024,1340,1830,3170,36
LWENGO,2025,1360,1900,3260,36
LYANTONDE,2015,460,480,940,36
LYANTONDE,2016,470,500,970,36
LYANTONDE,2017,490,520,1010,36
LYANTONDE,2018,500,550,1050,36
LYANTONDE,2019,530,570,1100,36
LYANTONDE,2020,540,600,1140,36
LYANTONDE,2021,570,630,1200,36
LYANTONDE,2022,580,650,1230,36
LYANTONDE,2023,610,680,1290,36
LYANTONDE,2024,640,700,1340,36
LYANTONDE,2025,660,740,1400,36
MANAFWA,2015,560,700,1260,36
MANAFWA,2016,570,720,1290,36
MANAFWA,2017,590,730,1320,36
MANAFWA,2018,600,750,1350,36
MANAFWA,2019,620,770,1390,36
MANAFWA,2020,630,780,1410,36
MANAFWA,2021,640,800,1440,36
MANAFWA,2022,660,810,1470,36
MANAFWA,2023,670,830,1500,36
MANAFWA,2024,690,850,1540,36
MANAFWA,2025,700,860,1560,36
MARACHA,2015,580,880,1460,36
MARACHA,2016,590,890,1480,36
MARACHA,2017,600,910,1510,36
MARACHA,2018,620,930,1550,36
MARACHA,2019,630,950,1580,36
MARACHA,2020,640,960,1600,36
MARACHA,2021,650,980,1630,36
MARACHA,2022,660,1000,1660,36
MARACHA,2023,680,1010,1690,36
MARACHA,2024,690,1030,1720,36
MARACHA,2025,700,1040,1740,36
MASAKA,2015,1510,1620,3130,36
MASAKA,2016,1560,1680,3240,36
MASAKA,2017,1610,1750,3360,36
MASAKA,2018,1660,1820,3480,36
MASAKA,2019,1710,1880,3590,36
MASAKA,2020,1760,1950,3710,36
MASAKA,2021,1810,2020,3830,36
MASAKA,2022,1870,2090,3960,36
MASAKA,2023,1930,2160,4090,36
MASAKA,2024,1990,2260,4250,36
MASAKA,2025,2050,2360,4410,36
MASINDI,2015,1370,1370,2740,36
MASINDI,2016,1410,1400,2810,36
MASINDI,2017,1450,1440,2890,36
MASINDI,2018,1490,1480,2970,36
MASINDI,2019,1530,1520,3050,36
MASINDI,2020,1570,1560,3130,36
MASINDI,2021,1620,1590,3210,36
MASINDI,2022,1660,1630,3290,36
MASINDI,2023,1700,1670,3370,36
MASINDI,2024,1740,1710,3450,36
MASINDI,2025,1780,1750,3530,36
MAYUGE,2015,1810,2500,4310,36
MAYUGE,2016,1890,2620,4510,36
MAYUGE,2017,1960,2760,4720,36
MAYUGE,2018,2040,2880,4920,36
MAYUGE,2019,2130,3020,5150,36
MAYUGE,2020,2210,3160,5370,36
MAYUGE,2021,2300,3300,5600,36
MAYUGE,2022,2390,3430,5820,36
MAYUGE,2023,2500,3600,6100,36
MAYUGE,2024,2600,3790,6390,36
MAYUGE,2025,2680,4010,6690,36
MBALE,2015,2360,2730,5090,36
MBALE,2016,2460,2870,5330,36
MBALE,2017,2560,3020,5580,36
MBALE,2018,2660,3170,5830,36
MBALE,2019,2760,3330,6090,36
MBALE,2020,2870,3490,6360,36
MBALE,2021,2990,3650,6640,36
MBALE,2022,3110,3810,6920,36
MBALE,2023,3240,4010,7250,36
MBALE,2024,3360,4240,7600,36
MBALE,2025,3480,4490,7970,36
MBARARA,2015,1560,1810,3370,36
MBARARA,2016,1590,1850,3440,36
MBARARA,2017,1630,1890,3520,36
MBARARA,2018,1670,1930,3600,36
MBARARA,2019,1700,1980,3680,36
MBARARA,2020,1740,2010,3750,36
MBARARA,2021,1780,2050,3830,36
MBARARA,2022,1810,2090,3900,36
MBARARA,2023,1850,2130,3980,36
MBARARA,2024,1880,2170,4050,36
MBARARA,2025,1920,2200,4120,36
MITOOMA,2015,540,930,1470,36
MITOOMA,2016,550,940,1490,36
MITOOMA,2017,550,950,1500,36
MITOOMA,2018,560,960,1520,36
MITOOMA,2019,570,970,1540,36
MITOOMA,2020,570,980,1550,36
MITOOMA,2021,580,980,1560,36
MITOOMA,2022,580,990,1570,36
MITOOMA,2023,590,990,1580,36
MITOOMA,2024,590,1000,1590,36
MITOOMA,2025,600,1000,1600,36
MITYANA,2015,1490,1570,3060,36
MITYANA,2016,1530,1620,3150,36
MITYANA,2017,1570,1680,3250,36
MITYANA,2018,1620,1730,3350,36
MITYANA,2019,1660,1780,3440,36
MITYANA,2020,1710,1850,3560,36
MITYANA,2021,1750,1900,3650,36
MITYANA,2022,1810,1940,3750,36
MITYANA,2023,1860,2010,3870,36
MITYANA,2024,1900,2090,3990,36
MITYANA,2025,1940,2180,4120,36
MOROTO,2015,410,430,840,36
MOROTO,2016,410,450,860,36
MOROTO,2017,430,470,900,36
MOROTO,2018,440,490,930,36
MOROTO,2019,460,510,970,36
MOROTO,2020,470,530,1000,36
MOROTO,2021,490,550,1040,36
MOROTO,2022,500,570,1070,36
MOROTO,2023,510,600,1110,36
MOROTO,2024,530,610,1140,36
MOROTO,2025,550,640,1190,36
MOYO,2015,390,460,850,36
MOYO,2016,400,480,880,36
MOYO,2017,410,490,900,36
MOYO,2018,420,500,920,36
MOYO,2019,430,510,940,36
MOYO,2020,440,520,960,36
MOYO,2021,450,530,980,36
MOYO,2022,460,540,1000,36
MOYO,2023,470,550,1020,36
MOYO,2024,490,560,1050,36
MOYO,2025,490,570,1060,36
MPIGI,2015,1080,1140,2220,36
MPIGI,2016,1120,1190,2310,36
MPIGI,2017,1160,1230,2390,36
MPIGI,2018,1200,1280,2480,36
MPIGI,2019,1240,1340,2580,36
MPIGI,2020,1270,1380,2650,36
MPIGI,2021,1320,1430,2750,36
MPIGI,2022,1360,1490,2850,36
MPIGI,2023,1420,1550,2970,36
MPIGI,2024,1460,1620,3080,36
MPIGI,2025,1500,1690,3190,36
MUBENDE,2015,1880,2050,3930,36
MUBENDE,2016,1990,2200,4190,36
MUBENDE,2017,2130,2350,4480,36
MUBENDE,2018,2250,2510,4760,36
MUBENDE,2019,2390,2680,5070,36
MUBENDE,2020,2550,2860,5410,36
MUBENDE,2021,2710,3040,5750,36
MUBENDE,2022,2880,3240,6120,36
MUBENDE,2023,3060,3470,6530,36
MUBENDE,2024,3240,3720,6960,36
MUBENDE,2025,3430,4010,7440,36
MUKONO,2015,2790,3180,5970,36
MUKONO,2016,2890,3330,6220,36
MUKONO,2017,3000,3490,6490,36
MUKONO,2018,3110,3660,6770,36
MUKONO,2019,3220,3820,7040,36
MUKONO,2020,3330,3990,7320,36
MUKONO,2021,3450,4150,7600,36
MUKONO,2022,3580,4330,7910,36
MUKONO,2023,3710,4540,8250,36
MUKONO,2024,3840,4770,8610,36
MUKONO,2025,3960,5040,9000,36
MADI OKOLLO,2015,540,700,1240,36
MADI OKOLLO,2016,550,720,1270,36
MADI OKOLLO,2017,570,730,1300,36
MADI OKOLLO,2018,580,750,1330,36
MADI OKOLLO,2019,600,770,1370,36
MADI OKOLLO,2020,620,790,1410,36
MADI OKOLLO,2021,630,810,1440,36
MADI OKOLLO,2022,650,830,1480,36
MADI OKOLLO,2023,670,850,1520,36
MADI OKOLLO,2024,680,870,1550,36
MADI OKOLLO,2025,700,890,1590,36
NABILATUK,2015,240,290,530,36
NABILATUK,2016,260,310,570,36
NABILATUK,2017,270,320,590,36
NABILATUK,2018,290,340,630,36
NABILATUK,2019,310,360,670,36
NABILATUK,2020,330,380,710,36
NABILATUK,2021,340,410,750,36
NABILATUK,2022,370,430,800,36
NABILATUK,2023,390,460,850,36
NABILATUK,2024,420,490,910,36
NABILATUK,2025,430,520,950,36
NAKAPIRIPIRIT,2015,380,430,810,36
NAKAPIRIPIRIT,2016,410,450,860,36
NAKAPIRIPIRIT,2017,430,480,910,36
NAKAPIRIPIRIT,2018,450,510,960,36
NAKAPIRIPIRIT,2019,470,550,1020,36
NAKAPIRIPIRIT,2020,500,570,1070,36
NAKAPIRIPIRIT,2021,530,600,1130,36
NAKAPIRIPIRIT,2022,560,640,1200,36
NAKAPIRIPIRIT,2023,590,670,1260,36
NAKAPIRIPIRIT,2024,610,720,1330,36
NAKAPIRIPIRIT,2025,640,770,1410,36
NAKASEKE,2015,1050,790,1840,36
NAKASEKE,2016,1090,810,1900,36
NAKASEKE,2017,1130,830,1960,36
NAKASEKE,2018,1170,850,2020,36
NAKASEKE,2019,1210,870,2080,36
NAKASEKE,2020,1260,890,2150,36
NAKASEKE,2021,1300,910,2210,36
NAKASEKE,2022,1340,930,2270,36
NAKASEKE,2023,1390,940,2330,36
NAKASEKE,2024,1430,960,2390,36
NAKASEKE,2025,1480,980,2460,36
NAKASONGOLA,2015,930,840,1770,36
NAKASONGOLA,2016,970,880,1850,36
NAKASONGOLA,2017,1020,920,1940,36
NAKASONGOLA,2018,1060,980,2040,36
NAKASONGOLA,2019,1090,1020,2110,36
NAKASONGOLA,2020,1140,1060,2200,36
NAKASONGOLA,2021,1190,1100,2290,36
NAKASONGOLA,2022,1240,1140,2380,36
NAKASONGOLA,2023,1290,1190,2480,36
NAKASONGOLA,2024,1340,1250,2590,36
NAKASONGOLA,2025,1390,1310,2700,36
NAMAYINGO,2015,900,970,1870,36
NAMAYINGO,2016,940,1010,1950,36
NAMAYINGO,2017,970,1050,2020,36
NAMAYINGO,2018,1000,1090,2090,36
NAMAYINGO,2019,1030,1130,2160,36
NAMAYINGO,2020,1060,1170,2230,36
NAMAYINGO,2021,1100,1210,2310,36
NAMAYINGO,2022,1140,1240,2380,36
NAMAYINGO,2023,1180,1300,2480,36
NAMAYINGO,2024,1210,1350,2560,36
NAMAYINGO,2025,1240,1410,2650,36
NAMISINDWA,2015,800,900,1700,36
NAMISINDWA,2016,820,920,1740,36
NAMISINDWA,2017,850,940,1790,36
NAMISINDWA,2018,870,970,1840,36
NAMISINDWA,2019,890,990,1880,36
NAMISINDWA,2020,920,1010,1930,36
NAMISINDWA,2021,940,1030,1970,36
NAMISINDWA,2022,960,1050,2010,36
NAMISINDWA,2023,990,1080,2070,36
NAMISINDWA,2024,1010,1100,2110,36
NAMISINDWA,2025,1030,1120,2150,36
NAMUTUMBA,2015,870,1130,2000,36
NAMUTUMBA,2016,910,1190,2100,36
NAMUTUMBA,2017,960,1250,2210,36
NAMUTUMBA,2018,1000,1320,2320,36
NAMUTUMBA,2019,1050,1380,2430,36
NAMUTUMBA,2020,1090,1430,2520,36
NAMUTUMBA,2021,1140,1510,2650,36
NAMUTUMBA,2022,1190,1570,2760,36
NAMUTUMBA,2023,1240,1650,2890,36
NAMUTUMBA,2024,1290,1740,3030,36
NAMUTUMBA,2025,1340,1850,3190,36
NAPAK,2015,450,660,1110,36
NAPAK,2016,470,680,1150,36
NAPAK,2017,470,710,1180,36
NAPAK,2018,490,730,1220,36
NAPAK,2019,500,760,1260,36
NAPAK,2020,510,790,1300,36
NAPAK,2021,530,820,1350,36
NAPAK,2022,550,840,1390,36
NAPAK,2023,550,870,1420,36
NAPAK,2024,570,910,1480,36
NAPAK,2025,580,950,1530,36
NEBBI,2015,820,970,1790,36
NEBBI,2016,850,1000,1850,36
NEBBI,2017,870,1030,1900,36
NEBBI,2018,900,1060,1960,36
NEBBI,2019,930,1090,2020,36
NEBBI,2020,960,1120,2080,36
NEBBI,2021,980,1150,2130,36
NEBBI,2022,1010,1180,2190,36
NEBBI,2023,1040,1210,2250,36
NEBBI,2024,1070,1240,2310,36
NEBBI,2025,1100,1260,2360,36
NGORA,2015,530,640,1170,36
NGORA,2016,550,660,1210,36
NGORA,2017,580,680,1260,36
NGORA,2018,600,720,1320,36
NGORA,2019,610,740,1350,36
NGORA,2020,640,780,1420,36
NGORA,2021,660,800,1460,36
NGORA,2022,690,840,1530,36
NGORA,2023,710,870,1580,36
NGORA,2024,750,920,1670,36
NGORA,2025,770,970,1740,36
NTOROKO,2015,310,320,630,36
NTOROKO,2016,320,330,650,36
NTOROKO,2017,330,350,680,36
NTOROKO,2018,350,350,700,36
NTOROKO,2019,360,370,730,36
NTOROKO,2020,360,380,740,36
NTOROKO,2021,380,400,780,36
NTOROKO,2022,400,400,800,36
NTOROKO,2023,400,420,820,36
NTOROKO,2024,420,430,850,36
NTOROKO,2025,430,460,890,36
NTUNGAMO,2015,1770,2240,4010,36
NTUNGAMO,2016,1810,2280,4090,36
NTUNGAMO,2017,1850,2320,4170,36
NTUNGAMO,2018,1890,2370,4260,36
NTUNGAMO,2019,1920,2410,4330,36
NTUNGAMO,2020,1960,2450,4410,36
NTUNGAMO,2021,2000,2490,4490,36
NTUNGAMO,2022,2040,2530,4570,36
NTUNGAMO,2023,2070,2570,4640,36
NTUNGAMO,2024,2110,2610,4720,36
NTUNGAMO,2025,2140,2640,4780,36
NWOYA,2015,540,510,1050,36
NWOYA,2016,600,570,1170,36
NWOYA,2017,660,620,1280,36
NWOYA,2018,730,690,1420,36
NWOYA,2019,810,760,1570,36
NWOYA,2020,890,830,1720,36
NWOYA,2021,980,910,1890,36
NWOYA,2022,1080,1010,2090,36
NWOYA,2023,1190,1100,2290,36
NWOYA,2024,1310,1210,2520,36
NWOYA,2025,1440,1330,2770,36
OBONGI,2015,170,210,380,36
OBONGI,2016,190,210,400,36
OBONGI,2017,190,230,420,36
OBONGI,2018,190,230,420,36
OBONGI,2019,200,250,450,36
OBONGI,2020,210,250,460,36
OBONGI,2021,210,270,480,36
OBONGI,2022,220,270,490,36
OBONGI,2023,230,280,510,36
OBONGI,2024,240,300,540,36
OBONGI,2025,240,310,550,36
OMORO,2015,690,860,1550,36
OMORO,2016,730,910,1640,36
OMORO,2017,760,950,1710,36
OMORO,2018,790,1000,1790,36
OMORO,2019,820,1050,1870,36
OMORO,2020,860,1110,1970,36
OMORO,2021,890,1150,2040,36
OMORO,2022,940,1210,2150,36
OMORO,2023,980,1270,2250,36
OMORO,2024,1030,1350,2380,36
OMORO,2025,1060,1430,2490,36
OTUKE,2015,380,380,760,36
OTUKE,2016,400,400,800,36
OTUKE,2017,420,420,840,36
OTUKE,2018,440,440,880,36
OTUKE,2019,460,450,910,36
OTUKE,2020,480,470,950,36
OTUKE,2021,500,490,990,36
OTUKE,2022,520,510,1030,36
OTUKE,2023,540,530,1070,36
OTUKE,2024,560,550,1110,36
OTUKE,2025,580,570,1150,36
OYAM,2015,1410,1690,3100,36
OYAM,2016,1460,1740,3200,36
OYAM,2017,1500,1790,3290,36
OYAM,2018,1550,1850,3400,36
OYAM,2019,1590,1900,3490,36
OYAM,2020,1640,1950,3590,36
OYAM,2021,1690,2000,3690,36
OYAM,2022,1730,2060,3790,36
OYAM,2023,1780,2110,3890,36
OYAM,2024,1830,2160,3990,36
OYAM,2025,1870,2220,4090,36
PADER,2015,830,920,1750,36
PADER,2016,840,950,1790,36
PADER,2017,870,990,1860,36
PADER,2018,890,1040,1930,36
PADER,2019,910,1070,1980,36
PADER,2020,950,1110,2060,36
PADER,2021,970,1140,2110,36
PADER,2022,990,1170,2160,36
PADER,2023,1020,1220,2240,36
PADER,2024,1040,1260,2300,36
PADER,2025,1060,1330,2390,36
PAKWACH,2015,510,630,1140,36
PAKWACH,2016,530,650,1180,36
PAKWACH,2017,550,670,1220,36
PAKWACH,2018,580,700,1280,36
PAKWACH,2019,600,720,1320,36
PAKWACH,2020,620,750,1370,36
PAKWACH,2021,650,770,1420,36
PAKWACH,2022,670,800,1470,36
PAKWACH,2023,700,830,1530,36
PAKWACH,2024,720,850,1570,36
PAKWACH,2025,750,880,1630,36
PALLISA,2015,980,1280,2260,36
PALLISA,2016,1030,1350,2380,36
PALLISA,2017,1090,1440,2530,36
PALLISA,2018,1140,1520,2660,36
PALLISA,2019,1210,1620,2830,36
PALLISA,2020,1270,1710,2980,36
PALLISA,2021,1350,1810,3160,36
PALLISA,2022,1410,1920,3330,36
PALLISA,2023,1490,2020,3510,36
PALLISA,2024,1570,2160,3730,36
PALLISA,2025,1650,2320,3970,36
RAKAI,2015,1210,1490,2700,36
RAKAI,2016,1250,1550,2800,36
RAKAI,2017,1300,1620,2920,36
RAKAI,2018,1350,1680,3030,36
RAKAI,2019,1390,1760,3150,36
RAKAI,2020,1440,1810,3250,36
RAKAI,2021,1490,1880,3370,36
RAKAI,2022,1550,1940,3490,36
RAKAI,2023,1590,2020,3610,36
RAKAI,2024,1650,2120,3770,36
RAKAI,2025,1700,2220,3920,36
RUBANDA,2015,730,950,1680,36
RUBANDA,2016,740,960,1700,36
RUBANDA,2017,750,970,1720,36
RUBANDA,2018,760,970,1730,36
RUBANDA,2019,770,980,1750,36
RUBANDA,2020,780,990,1770,36
RUBANDA,2021,790,990,1780,36
RUBANDA,2022,800,1000,1800,36
RUBANDA,2023,800,1000,1800,36
RUBANDA,2024,810,1010,1820,36
RUBANDA,2025,820,1010,1830,36
RUBIRIZI,2015,480,660,1140,36
RUBIRIZI,2016,490,670,1160,36
RUBIRIZI,2017,500,680,1180,36
RUBIRIZI,2018,510,700,1210,36
RUBIRIZI,2019,520,710,1230,36
RUBIRIZI,2020,530,720,1250,36
RUBIRIZI,2021,540,730,1270,36
RUBIRIZI,2022,550,750,1300,36
RUBIRIZI,2023,560,760,1320,36
RUBIRIZI,2024,570,770,1340,36
RUBIRIZI,2025,580,780,1360,36
RUKIGA,2015,410,490,900,36
RUKIGA,2016,410,500,910,36
RUKIGA,2017,410,500,910,36
RUKIGA,2018,420,500,920,36
RUKIGA,2019,420,510,930,36
RUKIGA,2020,430,510,940,36
RUKIGA,2021,430,510,940,36
RUKIGA,2022,430,520,950,36
RUKIGA,2023,430,520,950,36
RUKIGA,2024,440,520,960,36
RUKIGA,2025,440,520,960,36
RUKUNGIRI,2015,1170,1600,2770,36
RUKUNGIRI,2016,1180,1610,2790,36
RUKUNGIRI,2017,1200,1630,2830,36
RUKUNGIRI,2018,1210,1640,2850,36
RUKUNGIRI,2019,1220,1660,2880,36
RUKUNGIRI,2020,1240,1670,2910,36
RUKUNGIRI,2021,1250,1680,2930,36
RUKUNGIRI,2022,1260,1700,2960,36
RUKUNGIRI,2023,1270,1710,2980,36
RUKUNGIRI,2024,1280,1720,3000,36
RUKUNGIRI,2025,1290,1730,3020,36
RWAMPARA,2015,520,620,1140,36
RWAMPARA,2016,530,630,1160,36
RWAMPARA,2017,540,650,1190,36
RWAMPARA,2018,550,660,1210,36
RWAMPARA,2019,560,670,1230,36
RWAMPARA,2020,580,690,1270,36
RWAMPARA,2021,590,700,1290,36
RWAMPARA,2022,600,710,1310,36
RWAMPARA,2023,610,730,1340,36
RWAMPARA,2024,620,740,1360,36
RWAMPARA,2025,630,750,1380,36
SERERE,2015,1100,1320,2420,36
SERERE,2016,1160,1400,2560,36
SERERE,2017,1220,1490,2710,36
SERERE,2018,1290,1560,2850,36
SERERE,2019,1350,1650,3000,36
SERERE,2020,1420,1740,3160,36
SERERE,2021,1480,1840,3320,36
SERERE,2022,1560,1930,3490,36
SERERE,2023,1640,2040,3680,36
SERERE,2024,1720,2170,3890,36
SERERE,2025,1800,2310,4110,36
SHEEMA,2015,800,1020,1820,36
SHEEMA,2016,810,1030,1840,36
SHEEMA,2017,820,1040,1860,36
SHEEMA,2018,830,1050,1880,36
SHEEMA,2019,840,1060,1900,36
SHEEMA,2020,850,1070,1920,36
SHEEMA,2021,860,1080,1940,36
SHEEMA,2022,870,1080,1950,36
SHEEMA,2023,870,1090,1960,36
SHEEMA,2024,880,1100,1980,36
SHEEMA,2025,890,1110,2000,36
SIRONKO,2015,900,1110,2010,36
SIRONKO,2016,920,1130,2050,36
SIRONKO,2017,940,1150,2090,36
SIRONKO,2018,960,1170,2130,36
SIRONKO,2019,980,1200,2180,36
SIRONKO,2020,1010,1220,2230,36
SIRONKO,2021,1030,1240,2270,36
SIRONKO,2022,1050,1260,2310,36
SIRONKO,2023,1070,1290,2360,36
SIRONKO,2024,1090,1310,2400,36
SIRONKO,2025,1110,1330,2440,36
SOROTI,2015,1290,1360,2650,36
SOROTI,2016,1350,1440,2790,36
SOROTI,2017,1410,1510,2920,36
SOROTI,2018,1480,1580,3060,36
SOROTI,2019,1540,1670,3210,36
SOROTI,2020,1610,1750,3360,36
SOROTI,2021,1690,1840,3530,36
SOROTI,2022,1760,1920,3680,36
SOROTI,2023,1840,2020,3860,36
SOROTI,2024,1920,2150,4070,36
SOROTI,2025,2010,2270,4280,36
SSEMBABULE,2015,1170,1290,2460,36
SSEMBABULE,2016,1220,1350,2570,36
SSEMBABULE,2017,1260,1410,2670,36
SSEMBABULE,2018,1310,1480,2790,36
SSEMBABULE,2019,1360,1550,2910,36
SSEMBABULE,2020,1420,1610,3030,36
SSEMBABULE,2021,1470,1670,3140,36
SSEMBABULE,2022,1530,1740,3270,36
SSEMBABULE,2023,1580,1810,3390,36
SSEMBABULE,2024,1630,1900,3530,36
SSEMBABULE,2025,1700,2000,3700,36
TORORO,2015,1800,2200,4000,36
TORORO,2016,1850,2250,4100,36
TORORO,2017,1900,2310,4210,36
TORORO,2018,1950,2370,4320,36
TORORO,2019,2000,2430,4430,36
TORORO,2020,2050,2480,4530,36
TORORO,2021,2100,2540,4640,36
TORORO,2022,2150,2600,4750,36
TORORO,2023,2200,2650,4850,36
TORORO,2024,2250,2710,4960,36
TORORO,2025,2300,2760,5060,36
WAKISO,2015,10110,10190,20300,36
WAKISO,2016,10790,10890,21680,36
WAKISO,2017,11510,11630,23140,36
WAKISO,2018,12270,12420,24690,36
WAKISO,2019,13090,13250,26340,36
WAKISO,2020,13940,14130,28070,36
WAKISO,2021,14840,15070,29910,36
WAKISO,2022,15790,16070,31860,36
WAKISO,2023,16790,17100,33890,36
WAKISO,2024,17840,18190,36030,36
WAKISO,2025,18940,19350,38290,36
YUMBE,2015,1790,2150,3940,36
YUMBE,2016,1900,2320,4220,36
YUMBE,2017,2010,2490,4500,36
YUMBE,2018,2130,2690,4820,36
YUMBE,2019,2260,2900,5160,36
YUMBE,2020,2400,3110,5510,36
YUMBE,2021,2550,3330,5880,36
YUMBE,2022,2700,3580,6280,36
YUMBE,2023,2870,3850,6720,36
YUMBE,2024,3040,4170,7210,36
YUMBE,2025,3210,4530,7740,36
ZOMBO,2015,790,940,1730,36
ZOMBO,2016,810,960,1770,36
ZOMBO,2017,840,990,1830,36
ZOMBO,2018,870,1020,1890,36
ZOMBO,2019,890,1050,1940,36
ZOMBO,2020,920,1070,1990,36
ZOMBO,2021,940,1100,2040,36
ZOMBO,2022,970,1130,2100,36
ZOMBO,2023,1000,1160,2160,36
ZOMBO,2024,1020,1180,2200,36
ZOMBO,2025,1050,1210,2260,36
ABIM,2015,310,350,660,37
ABIM,2016,330,370,700,37
ABIM,2017,360,400,760,37
ABIM,2018,390,440,830,37
ABIM,2019,410,470,880,37
ABIM,2020,440,500,940,37
ABIM,2021,470,550,1020,37
ABIM,2022,510,590,1100,37
ABIM,2023,540,630,1170,37
ABIM,2024,590,680,1270,37
ABIM,2025,620,740,1360,37
ADJUMANI,2015,620,950,1570,37
ADJUMANI,2016,630,960,1590,37
ADJUMANI,2017,630,970,1600,37
ADJUMANI,2018,640,980,1620,37
ADJUMANI,2019,640,990,1630,37
ADJUMANI,2020,650,1000,1650,37
ADJUMANI,2021,650,1010,1660,37
ADJUMANI,2022,650,1010,1660,37
ADJUMANI,2023,660,1020,1680,37
ADJUMANI,2024,660,1030,1690,37
ADJUMANI,2025,660,1030,1690,37
AGAGO,2015,680,740,1420,37
AGAGO,2016,690,760,1450,37
AGAGO,2017,700,770,1470,37
AGAGO,2018,710,780,1490,37
AGAGO,2019,720,800,1520,37
AGAGO,2020,740,810,1550,37
AGAGO,2021,750,820,1570,37
AGAGO,2022,760,830,1590,37
AGAGO,2023,770,840,1610,37
AGAGO,2024,780,860,1640,37
AGAGO,2025,790,870,1660,37
ALEBTONG,2015,860,900,1760,37
ALEBTONG,2016,890,940,1830,37
ALEBTONG,2017,920,980,1900,37
ALEBTONG,2018,960,1030,1990,37
ALEBTONG,2019,1000,1070,2070,37
ALEBTONG,2020,1030,1120,2150,37
ALEBTONG,2021,1060,1160,2220,37
ALEBTONG,2022,1110,1210,2320,37
ALEBTONG,2023,1150,1250,2400,37
ALEBTONG,2024,1190,1310,2500,37
ALEBTONG,2025,1230,1370,2600,37
AMOLATAR,2015,610,680,1290,37
AMOLATAR,2016,630,720,1350,37
AMOLATAR,2017,640,740,1380,37
AMOLATAR,2018,670,770,1440,37
AMOLATAR,2019,690,810,1500,37
AMOLATAR,2020,720,840,1560,37
AMOLATAR,2021,740,860,1600,37
AMOLATAR,2022,780,900,1680,37
AMOLATAR,2023,800,930,1730,37
AMOLATAR,2024,830,980,1810,37
AMOLATAR,2025,850,1020,1870,37
AMUDAT,2015,360,360,720,37
AMUDAT,2016,390,380,770,37
AMUDAT,2017,410,420,830,37
AMUDAT,2018,420,440,860,37
AMUDAT,2019,450,470,920,37
AMUDAT,2020,470,490,960,37
AMUDAT,2021,490,530,1020,37
AMUDAT,2022,510,560,1070,37
AMUDAT,2023,540,580,1120,37
AMUDAT,2024,560,630,1190,37
AMUDAT,2025,600,670,1270,37
AMURIA,2015,650,850,1500,37
AMURIA,2016,670,890,1560,37
AMURIA,2017,700,940,1640,37
AMURIA,2018,750,990,1740,37
AMURIA,2019,780,1050,1830,37
AMURIA,2020,810,1100,1910,37
AMURIA,2021,850,1150,2000,37
AMURIA,2022,890,1210,2100,37
AMURIA,2023,920,1270,2190,37
AMURIA,2024,970,1320,2290,37
AMURIA,2025,1010,1400,2410,37
AMURU,2015,620,700,1320,37
AMURU,2016,650,740,1390,37
AMURU,2017,670,770,1440,37
AMURU,2018,700,810,1510,37
AMURU,2019,720,850,1570,37
AMURU,2020,750,880,1630,37
AMURU,2021,770,920,1690,37
AMURU,2022,800,950,1750,37
AMURU,2023,820,990,1810,37
AMURU,2024,860,1040,1900,37
AMURU,2025,880,1080,1960,37
APAC,2015,740,710,1450,37
APAC,2016,770,730,1500,37
APAC,2017,790,760,1550,37
APAC,2018,820,780,1600,37
APAC,2019,850,810,1660,37
APAC,2020,880,830,1710,37
APAC,2021,910,860,1770,37
APAC,2022,940,890,1830,37
APAC,2023,970,920,1890,37
APAC,2024,1010,950,1960,37
APAC,2025,1040,970,2010,37
ARUA,2015,2070,2540,4610,37
ARUA,2016,2130,2610,4740,37
ARUA,2017,2190,2680,4870,37
ARUA,2018,2250,2750,5000,37
ARUA,2019,2320,2830,5150,37
ARUA,2020,2380,2900,5280,37
ARUA,2021,2440,2970,5410,37
ARUA,2022,2500,3040,5540,37
ARUA,2023,2570,3120,5690,37
ARUA,2024,2630,3190,5820,37
ARUA,2025,2690,3260,5950,37
BUDAKA,2015,720,850,1570,37
BUDAKA,2016,740,900,1640,37
BUDAKA,2017,770,940,1710,37
BUDAKA,2018,820,1000,1820,37
BUDAKA,2019,850,1050,1900,37
BUDAKA,2020,890,1100,1990,37
BUDAKA,2021,930,1150,2080,37
BUDAKA,2022,980,1210,2190,37
BUDAKA,2023,1010,1270,2280,37
BUDAKA,2024,1060,1320,2380,37
BUDAKA,2025,1110,1400,2510,37
BUDUDA,2015,780,780,1560,37
BUDUDA,2016,810,830,1640,37
BUDUDA,2017,860,870,1730,37
BUDUDA,2018,910,940,1850,37
BUDUDA,2019,960,990,1950,37
BUDUDA,2020,1020,1050,2070,37
BUDUDA,2021,1060,1110,2170,37
BUDUDA,2022,1130,1180,2310,37
BUDUDA,2023,1190,1240,2430,37
BUDUDA,2024,1260,1320,2580,37
BUDUDA,2025,1320,1400,2720,37
BUGIRI,2015,1290,1700,2990,37
BUGIRI,2016,1360,1800,3160,37
BUGIRI,2017,1430,1900,3330,37
BUGIRI,2018,1500,2020,3520,37
BUGIRI,2019,1580,2130,3710,37
BUGIRI,2020,1650,2250,3900,37
BUGIRI,2021,1740,2380,4120,37
BUGIRI,2022,1830,2490,4320,37
BUGIRI,2023,1930,2620,4550,37
BUGIRI,2024,2010,2770,4780,37
BUGIRI,2025,2110,2930,5040,37
BUGWERI,2015,550,740,1290,37
BUGWERI,2016,570,780,1350,37
BUGWERI,2017,580,820,1400,37
BUGWERI,2018,610,850,1460,37
BUGWERI,2019,630,890,1520,37
BUGWERI,2020,660,920,1580,37
BUGWERI,2021,680,960,1640,37
BUGWERI,2022,700,1000,1700,37
BUGWERI,2023,730,1030,1760,37
BUGWERI,2024,760,1080,1840,37
BUGWERI,2025,790,1120,1910,37
BUHWEJU,2015,470,490,960,37
BUHWEJU,2016,480,500,980,37
BUHWEJU,2017,500,520,1020,37
BUHWEJU,2018,510,540,1050,37
BUHWEJU,2019,530,550,1080,37
BUHWEJU,2020,550,570,1120,37
BUHWEJU,2021,560,580,1140,37
BUHWEJU,2022,580,600,1180,37
BUHWEJU,2023,600,620,1220,37
BUHWEJU,2024,610,630,1240,37
BUHWEJU,2025,630,650,1280,37
BUIKWE,2015,1770,2000,3770,37
BUIKWE,2016,1820,2080,3900,37
BUIKWE,2017,1880,2150,4030,37
BUIKWE,2018,1940,2250,4190,37
BUIKWE,2019,1990,2330,4320,37
BUIKWE,2020,2050,2400,4450,37
BUIKWE,2021,2100,2500,4600,37
BUIKWE,2022,2160,2580,4740,37
BUIKWE,2023,2230,2660,4890,37
BUIKWE,2024,2290,2760,5050,37
BUIKWE,2025,2360,2880,5240,37
BUKEDEA,2015,820,920,1740,37
BUKEDEA,2016,860,980,1840,37
BUKEDEA,2017,910,1030,1940,37
BUKEDEA,2018,950,1090,2040,37
BUKEDEA,2019,1010,1160,2170,37
BUKEDEA,2020,1070,1220,2290,37
BUKEDEA,2021,1110,1300,2410,37
BUKEDEA,2022,1180,1370,2550,37
BUKEDEA,2023,1240,1430,2670,37
BUKEDEA,2024,1310,1520,2830,37
BUKEDEA,2025,1370,1620,2990,37
BUKOMANSIMBI,2015,630,780,1410,37
BUKOMANSIMBI,2016,640,790,1430,37
BUKOMANSIMBI,2017,660,810,1470,37
BUKOMANSIMBI,2018,660,830,1490,37
BUKOMANSIMBI,2019,680,850,1530,37
BUKOMANSIMBI,2020,690,860,1550,37
BUKOMANSIMBI,2021,700,880,1580,37
BUKOMANSIMBI,2022,710,890,1600,37
BUKOMANSIMBI,2023,720,900,1620,37
BUKOMANSIMBI,2024,730,920,1650,37
BUKOMANSIMBI,2025,750,950,1700,37
BUKWO,2015,340,360,700,37
BUKWO,2016,350,380,730,37
BUKWO,2017,370,390,760,37
BUKWO,2018,390,410,800,37
BUKWO,2019,410,430,840,37
BUKWO,2020,430,450,880,37
BUKWO,2021,460,480,940,37
BUKWO,2022,480,500,980,37
BUKWO,2023,500,520,1020,37
BUKWO,2024,530,540,1070,37
BUKWO,2025,550,570,1120,37
BULAMBULI,2015,690,740,1430,37
BULAMBULI,2016,730,790,1520,37
BULAMBULI,2017,770,840,1610,37
BULAMBULI,2018,820,910,1730,37
BULAMBULI,2019,870,970,1840,37
BULAMBULI,2020,920,1020,1940,37
BULAMBULI,2021,980,1090,2070,37
BULAMBULI,2022,1030,1160,2190,37
BULAMBULI,2023,1090,1240,2330,37
BULAMBULI,2024,1150,1320,2470,37
BULAMBULI,2025,1220,1420,2640,37
BULIISA,2015,440,430,870,37
BULIISA,2016,460,450,910,37
BULIISA,2017,490,470,960,37
BULIISA,2018,510,490,1000,37
BULIISA,2019,540,510,1050,37
BULIISA,2020,570,540,1110,37
BULIISA,2021,600,560,1160,37
BULIISA,2022,630,580,1210,37
BULIISA,2023,660,610,1270,37
BULIISA,2024,690,630,1320,37
BULIISA,2025,730,660,1390,37
BUNDIBUGYO,2015,870,890,1760,37
BUNDIBUGYO,2016,910,930,1840,37
BUNDIBUGYO,2017,940,970,1910,37
BUNDIBUGYO,2018,990,1010,2000,37
BUNDIBUGYO,2019,1020,1070,2090,37
BUNDIBUGYO,2020,1050,1120,2170,37
BUNDIBUGYO,2021,1100,1160,2260,37
BUNDIBUGYO,2022,1140,1210,2350,37
BUNDIBUGYO,2023,1190,1250,2440,37
BUNDIBUGYO,2024,1230,1310,2540,37
BUNDIBUGYO,2025,1280,1370,2650,37
BUNYANGABU,2015,780,860,1640,37
BUNYANGABU,2016,800,900,1700,37
BUNYANGABU,2017,830,930,1760,37
BUNYANGABU,2018,850,980,1830,37
BUNYANGABU,2019,890,1020,1910,37
BUNYANGABU,2020,920,1050,1970,37
BUNYANGABU,2021,950,1090,2040,37
BUNYANGABU,2022,990,1120,2110,37
BUNYANGABU,2023,1010,1170,2180,37
BUNYANGABU,2024,1050,1210,2260,37
BUNYANGABU,2025,1090,1270,2360,37
BUSHENYI,2015,910,1010,1920,37
BUSHENYI,2016,920,1020,1940,37
BUSHENYI,2017,930,1030,1960,37
BUSHENYI,2018,940,1040,1980,37
BUSHENYI,2019,960,1040,2000,37
BUSHENYI,2020,970,1050,2020,37
BUSHENYI,2021,980,1060,2040,37
BUSHENYI,2022,990,1070,2060,37
BUSHENYI,2023,990,1070,2060,37
BUSHENYI,2024,1000,1080,2080,37
BUSHENYI,2025,1010,1080,2090,37
BUSIA,2015,1340,1580,2920,37
BUSIA,2016,1390,1660,3050,37
BUSIA,2017,1450,1730,3180,37
BUSIA,2018,1520,1810,3330,37
BUSIA,2019,1580,1900,3480,37
BUSIA,2020,1640,1980,3620,37
BUSIA,2021,1710,2070,3780,37
BUSIA,2022,1780,2150,3930,37
BUSIA,2023,1850,2240,4090,37
BUSIA,2024,1920,2340,4260,37
BUSIA,2025,1990,2470,4460,37
BUTALEJA,2015,760,1030,1790,37
BUTALEJA,2016,800,1090,1890,37
BUTALEJA,2017,830,1150,1980,37
BUTALEJA,2018,880,1220,2100,37
BUTALEJA,2019,920,1280,2200,37
BUTALEJA,2020,970,1340,2310,37
BUTALEJA,2021,1000,1420,2420,37
BUTALEJA,2022,1050,1480,2530,37
BUTALEJA,2023,1100,1540,2640,37
BUTALEJA,2024,1150,1630,2780,37
BUTALEJA,2025,1200,1720,2920,37
BUTAMBALA,2015,380,400,780,37
BUTAMBALA,2016,390,420,810,37
BUTAMBALA,2017,390,430,820,37
BUTAMBALA,2018,400,440,840,37
BUTAMBALA,2019,410,460,870,37
BUTAMBALA,2020,420,470,890,37
BUTAMBALA,2021,430,470,900,37
BUTAMBALA,2022,440,490,930,37
BUTAMBALA,2023,460,500,960,37
BUTAMBALA,2024,460,510,970,37
BUTAMBALA,2025,470,530,1000,37
BUTEBO,2015,400,490,890,37
BUTEBO,2016,400,510,910,37
BUTEBO,2017,420,520,940,37
BUTEBO,2018,430,540,970,37
BUTEBO,2019,440,550,990,37
BUTEBO,2020,450,570,1020,37
BUTEBO,2021,460,580,1040,37
BUTEBO,2022,480,600,1080,37
BUTEBO,2023,480,610,1090,37
BUTEBO,2024,500,640,1140,37
BUTEBO,2025,500,660,1160,37
BUVUMA,2015,600,420,1020,37
BUVUMA,2016,640,450,1090,37
BUVUMA,2017,680,480,1160,37
BUVUMA,2018,720,510,1230,37
BUVUMA,2019,770,540,1310,37
BUVUMA,2020,810,580,1390,37
BUVUMA,2021,860,620,1480,37
BUVUMA,2022,910,650,1560,37
BUVUMA,2023,960,700,1660,37
BUVUMA,2024,1020,740,1760,37
BUVUMA,2025,1080,790,1870,37
BUYENDE,2015,1020,1230,2250,37
BUYENDE,2016,1070,1310,2380,37
BUYENDE,2017,1130,1390,2520,37
BUYENDE,2018,1200,1480,2680,37
BUYENDE,2019,1260,1570,2830,37
BUYENDE,2020,1340,1660,3000,37
BUYENDE,2021,1410,1760,3170,37
BUYENDE,2022,1490,1850,3340,37
BUYENDE,2023,1560,1950,3510,37
BUYENDE,2024,1650,2070,3720,37
BUYENDE,2025,1730,2200,3930,37
DOKOLO,2015,600,670,1270,37
DOKOLO,2016,620,690,1310,37
DOKOLO,2017,640,700,1340,37
DOKOLO,2018,660,720,1380,37
DOKOLO,2019,680,740,1420,37
DOKOLO,2020,700,760,1460,37
DOKOLO,2021,720,780,1500,37
DOKOLO,2022,740,800,1540,37
DOKOLO,2023,760,820,1580,37
DOKOLO,2024,770,840,1610,37
DOKOLO,2025,790,860,1650,37
GOMBA,2015,690,770,1460,37
GOMBA,2016,710,790,1500,37
GOMBA,2017,730,820,1550,37
GOMBA,2018,750,850,1600,37
GOMBA,2019,770,860,1630,37
GOMBA,2020,780,890,1670,37
GOMBA,2021,800,920,1720,37
GOMBA,2022,830,930,1760,37
GOMBA,2023,850,960,1810,37
GOMBA,2024,870,980,1850,37
GOMBA,2025,890,1020,1910,37
GULU,2015,1020,1040,2060,37
GULU,2016,1050,1080,2130,37
GULU,2017,1080,1110,2190,37
GULU,2018,1110,1140,2250,37
GULU,2019,1150,1170,2320,37
GULU,2020,1180,1200,2380,37
GULU,2021,1210,1240,2450,37
GULU,2022,1250,1270,2520,37
GULU,2023,1280,1300,2580,37
GULU,2024,1310,1330,2640,37
GULU,2025,1340,1370,2710,37
HOIMA,2015,1310,1280,2590,37
HOIMA,2016,1360,1320,2680,37
HOIMA,2017,1420,1370,2790,37
HOIMA,2018,1470,1410,2880,37
HOIMA,2019,1520,1460,2980,37
HOIMA,2020,1580,1510,3090,37
HOIMA,2021,1630,1560,3190,37
HOIMA,2022,1690,1610,3300,37
HOIMA,2023,1750,1660,3410,37
HOIMA,2024,1800,1710,3510,37
HOIMA,2025,1860,1760,3620,37
IBANDA,2015,1000,1220,2220,37
IBANDA,2016,1020,1240,2260,37
IBANDA,2017,1040,1270,2310,37
IBANDA,2018,1060,1290,2350,37
IBANDA,2019,1080,1310,2390,37
IBANDA,2020,1100,1330,2430,37
IBANDA,2021,1120,1350,2470,37
IBANDA,2022,1140,1380,2520,37
IBANDA,2023,1160,1400,2560,37
IBANDA,2024,1170,1420,2590,37
IBANDA,2025,1190,1440,2630,37
IGANGA,2015,1160,1580,2740,37
IGANGA,2016,1200,1640,2840,37
IGANGA,2017,1250,1730,2980,37
IGANGA,2018,1310,1810,3120,37
IGANGA,2019,1360,1900,3260,37
IGANGA,2020,1420,1980,3400,37
IGANGA,2021,1470,2070,3540,37
IGANGA,2022,1540,2150,3690,37
IGANGA,2023,1600,2240,3840,37
IGANGA,2024,1670,2340,4010,37
IGANGA,2025,1720,2450,4170,37
ISINGIRO,2015,1880,2230,4110,37
ISINGIRO,2016,1960,2310,4270,37
ISINGIRO,2017,2030,2390,4420,37
ISINGIRO,2018,2100,2480,4580,37
ISINGIRO,2019,2180,2560,4740,37
ISINGIRO,2020,2260,2650,4910,37
ISINGIRO,2021,2340,2740,5080,37
ISINGIRO,2022,2420,2830,5250,37
ISINGIRO,2023,2500,2920,5420,37
ISINGIRO,2024,2580,3010,5590,37
ISINGIRO,2025,2660,3100,5760,37
JINJA,2015,1780,1880,3660,37
JINJA,2016,1810,1900,3710,37
JINJA,2017,1840,1930,3770,37
JINJA,2018,1870,1960,3830,37
JINJA,2019,1900,1990,3890,37
JINJA,2020,1930,2020,3950,37
JINJA,2021,1950,2050,4000,37
JINJA,2022,1980,2070,4050,37
JINJA,2023,2010,2100,4110,37
JINJA,2024,2030,2120,4150,37
JINJA,2025,2060,2140,4200,37
KAABONG,2015,240,360,600,37
KAABONG,2016,250,370,620,37
KAABONG,2017,260,380,640,37
KAABONG,2018,260,390,650,37
KAABONG,2019,270,390,660,37
KAABONG,2020,280,400,680,37
KAABONG,2021,290,410,700,37
KAABONG,2022,290,420,710,37
KAABONG,2023,300,430,730,37
KAABONG,2024,310,440,750,37
KAABONG,2025,310,450,760,37
KABALE,2015,880,980,1860,37
KABALE,2016,900,990,1890,37
KABALE,2017,910,1000,1910,37
KABALE,2018,930,1020,1950,37
KABALE,2019,940,1030,1970,37
KABALE,2020,950,1040,1990,37
KABALE,2021,960,1050,2010,37
KABALE,2022,980,1060,2040,37
KABALE,2023,990,1070,2060,37
KABALE,2024,1000,1080,2080,37
KABALE,2025,1010,1080,2090,37
KABAROLE,2015,1290,1210,2500,37
KABAROLE,2016,1320,1230,2550,37
KABAROLE,2017,1350,1260,2610,37
KABAROLE,2018,1380,1290,2670,37
KABAROLE,2019,1410,1310,2720,37
KABAROLE,2020,1440,1340,2780,37
KABAROLE,2021,1470,1370,2840,37
KABAROLE,2022,1500,1390,2890,37
KABAROLE,2023,1520,1420,2940,37
KABAROLE,2024,1550,1440,2990,37
KABAROLE,2025,1580,1470,3050,37
KABERAMAIDO,2015,470,490,960,37
KABERAMAIDO,2016,500,510,1010,37
KABERAMAIDO,2017,510,540,1050,37
KABERAMAIDO,2018,540,580,1120,37
KABERAMAIDO,2019,570,610,1180,37
KABERAMAIDO,2020,600,640,1240,37
KABERAMAIDO,2021,630,680,1310,37
KABERAMAIDO,2022,660,710,1370,37
KABERAMAIDO,2023,700,750,1450,37
KABERAMAIDO,2024,740,800,1540,37
KABERAMAIDO,2025,780,850,1630,37
KAGADI,2015,1280,1420,2700,37
KAGADI,2016,1330,1470,2800,37
KAGADI,2017,1380,1520,2900,37
KAGADI,2018,1430,1570,3000,37
KAGADI,2019,1480,1630,3110,37
KAGADI,2020,1540,1680,3220,37
KAGADI,2021,1590,1740,3330,37
KAGADI,2022,1650,1790,3440,37
KAGADI,2023,1700,1850,3550,37
KAGADI,2024,1750,1910,3660,37
KAGADI,2025,1810,1970,3780,37
KAKUMIRO,2015,1320,1240,2560,37
KAKUMIRO,2016,1440,1340,2780,37
KAKUMIRO,2017,1570,1460,3030,37
KAKUMIRO,2018,1700,1580,3280,37
KAKUMIRO,2019,1850,1710,3560,37
KAKUMIRO,2020,2010,1850,3860,37
KAKUMIRO,2021,2190,2000,4190,37
KAKUMIRO,2022,2370,2160,4530,37
KAKUMIRO,2023,2570,2340,4910,37
KAKUMIRO,2024,2790,2530,5320,37
KAKUMIRO,2025,3020,2730,5750,37
KALAKI,2015,350,460,810,37
KALAKI,2016,360,470,830,37
KALAKI,2017,380,490,870,37
KALAKI,2018,390,510,900,37
KALAKI,2019,410,530,940,37
KALAKI,2020,430,550,980,37
KALAKI,2021,440,570,1010,37
KALAKI,2022,460,590,1050,37
KALAKI,2023,480,620,1100,37
KALAKI,2024,500,640,1140,37
KALAKI,2025,520,660,1180,37
KALANGALA,2015,600,330,930,37
KALANGALA,2016,630,340,970,37
KALANGALA,2017,650,350,1000,37
KALANGALA,2018,670,370,1040,37
KALANGALA,2019,690,380,1070,37
KALANGALA,2020,720,400,1120,37
KALANGALA,2021,740,410,1150,37
KALANGALA,2022,770,430,1200,37
KALANGALA,2023,790,450,1240,37
KALANGALA,2024,810,460,1270,37
KALANGALA,2025,840,480,1320,37
KALIRO,2015,830,910,1740,37
KALIRO,2016,860,960,1820,37
KALIRO,2017,910,1020,1930,37
KALIRO,2018,950,1080,2030,37
KALIRO,2019,980,1120,2100,37
KALIRO,2020,1030,1180,2210,37
KALIRO,2021,1080,1240,2320,37
KALIRO,2022,1130,1300,2430,37
KALIRO,2023,1180,1360,2540,37
KALIRO,2024,1230,1440,2670,37
KALIRO,2025,1280,1520,2800,37
KALUNGU,2015,750,970,1720,37
KALUNGU,2016,770,1000,1770,37
KALUNGU,2017,770,1020,1790,37
KALUNGU,2018,790,1050,1840,37
KALUNGU,2019,810,1080,1890,37
KALUNGU,2020,820,1100,1920,37
KALUNGU,2021,840,1130,1970,37
KALUNGU,2022,860,1160,2020,37
KALUNGU,2023,870,1180,2050,37
KALUNGU,2024,900,1220,2120,37
KALUNGU,2025,910,1260,2170,37
KAMPALA,2015,6900,7160,14060,37
KAMPALA,2016,7040,7300,14340,37
KAMPALA,2017,7180,7450,14630,37
KAMPALA,2018,7320,7590,14910,37
KAMPALA,2019,7450,7730,15180,37
KAMPALA,2020,7590,7870,15460,37
KAMPALA,2021,7720,8000,15720,37
KAMPALA,2022,7850,8140,15990,37
KAMPALA,2023,7980,8270,16250,37
KAMPALA,2024,8100,8390,16490,37
KAMPALA,2025,8220,8520,16740,37
KAMULI,2015,1540,2080,3620,37
KAMULI,2016,1580,2160,3740,37
KAMULI,2017,1650,2260,3910,37
KAMULI,2018,1700,2350,4050,37
KAMULI,2019,1760,2440,4200,37
KAMULI,2020,1830,2540,4370,37
KAMULI,2021,1880,2630,4510,37
KAMULI,2022,1950,2730,4680,37
KAMULI,2023,2030,2820,4850,37
KAMULI,2024,2090,2940,5030,37
KAMULI,2025,2160,3070,5230,37
KAMWENGE,2015,1100,1130,2230,37
KAMWENGE,2016,1150,1170,2320,37
KAMWENGE,2017,1190,1210,2400,37
KAMWENGE,2018,1240,1250,2490,37
KAMWENGE,2019,1290,1290,2580,37
KAMWENGE,2020,1340,1340,2680,37
KAMWENGE,2021,1390,1380,2770,37
KAMWENGE,2022,1450,1430,2880,37
KAMWENGE,2023,1500,1470,2970,37
KAMWENGE,2024,1550,1520,3070,37
KAMWENGE,2025,1610,1570,3180,37
KANUNGU,2015,960,1180,2140,37
KANUNGU,2016,980,1200,2180,37
KANUNGU,2017,1000,1220,2220,37
KANUNGU,2018,1010,1240,2250,37
KANUNGU,2019,1030,1250,2280,37
KANUNGU,2020,1050,1270,2320,37
KANUNGU,2021,1060,1290,2350,37
KANUNGU,2022,1080,1310,2390,37
KANUNGU,2023,1100,1330,2430,37
KANUNGU,2024,1110,1340,2450,37
KANUNGU,2025,1130,1360,2490,37
KAPCHORWA,2015,390,530,920,37
KAPCHORWA,2016,400,540,940,37
KAPCHORWA,2017,410,560,970,37
KAPCHORWA,2018,430,570,1000,37
KAPCHORWA,2019,440,590,1030,37
KAPCHORWA,2020,450,600,1050,37
KAPCHORWA,2021,460,620,1080,37
KAPCHORWA,2022,480,630,1110,37
KAPCHORWA,2023,490,650,1140,37
KAPCHORWA,2024,500,670,1170,37
KAPCHORWA,2025,510,680,1190,37
KAPELEBYONG,2015,320,380,700,37
KAPELEBYONG,2016,330,400,730,37
KAPELEBYONG,2017,350,420,770,37
KAPELEBYONG,2018,360,440,800,37
KAPELEBYONG,2019,380,460,840,37
KAPELEBYONG,2020,390,480,870,37
KAPELEBYONG,2021,410,500,910,37
KAPELEBYONG,2022,430,520,950,37
KAPELEBYONG,2023,440,540,980,37
KAPELEBYONG,2024,460,550,1010,37
KAPELEBYONG,2025,480,580,1060,37
KASESE,2015,2770,3180,5950,37
KASESE,2016,2860,3300,6160,37
KASESE,2017,2960,3440,6400,37
KASESE,2018,3070,3580,6650,37
KASESE,2019,3170,3730,6900,37
KASESE,2020,3270,3870,7140,37
KASESE,2021,3380,4010,7390,37
KASESE,2022,3490,4140,7630,37
KASESE,2023,3610,4290,7900,37
KASESE,2024,3730,4460,8190,37
KASESE,2025,3840,4660,8500,37
KASSANDA,2015,1060,1060,2120,37
KASSANDA,2016,1100,1090,2190,37
KASSANDA,2017,1130,1110,2240,37
KASSANDA,2018,1160,1130,2290,37
KASSANDA,2019,1190,1160,2350,37
KASSANDA,2020,1220,1180,2400,37
KASSANDA,2021,1260,1200,2460,37
KASSANDA,2022,1290,1230,2520,37
KASSANDA,2023,1320,1250,2570,37
KASSANDA,2024,1350,1270,2620,37
KASSANDA,2025,1380,1290,2670,37
KATAKWI,2015,630,720,1350,37
KATAKWI,2016,660,750,1410,37
KATAKWI,2017,680,780,1460,37
KATAKWI,2018,710,820,1530,37
KATAKWI,2019,740,860,1600,37
KATAKWI,2020,770,890,1660,37
KATAKWI,2021,790,930,1720,37
KATAKWI,2022,830,960,1790,37
KATAKWI,2023,860,1000,1860,37
KATAKWI,2024,900,1040,1940,37
KATAKWI,2025,920,1100,2020,37
KAYUNGA,2015,1280,1600,2880,37
KAYUNGA,2016,1310,1670,2980,37
KAYUNGA,2017,1350,1730,3080,37
KAYUNGA,2018,1380,1780,3160,37
KAYUNGA,2019,1420,1840,3260,37
KAYUNGA,2020,1470,1900,3370,37
KAYUNGA,2021,1510,1960,3470,37
KAYUNGA,2022,1550,2010,3560,37
KAYUNGA,2023,1600,2070,3670,37
KAYUNGA,2024,1640,2150,3790,37
KAYUNGA,2025,1680,2230,3910,37
KAZO,2015,710,770,1480,37
KAZO,2016,740,790,1530,37
KAZO,2017,770,820,1590,37
KAZO,2018,800,850,1650,37
KAZO,2019,830,880,1710,37
KAZO,2020,850,910,1760,37
KAZO,2021,890,940,1830,37
KAZO,2022,920,970,1890,37
KAZO,2023,950,1000,1950,37
KAZO,2024,980,1030,2010,37
KAZO,2025,1010,1060,2070,37
KIBAALE,2015,580,540,1120,37
KIBAALE,2016,620,570,1190,37
KIBAALE,2017,660,600,1260,37
KIBAALE,2018,700,640,1340,37
KIBAALE,2019,750,670,1420,37
KIBAALE,2020,790,710,1500,37
KIBAALE,2021,840,750,1590,37
KIBAALE,2022,890,790,1680,37
KIBAALE,2023,950,840,1790,37
KIBAALE,2024,1000,880,1880,37
KIBAALE,2025,1060,930,1990,37
KIBOGA,2015,680,610,1290,37
KIBOGA,2016,700,640,1340,37
KIBOGA,2017,730,670,1400,37
KIBOGA,2018,750,690,1440,37
KIBOGA,2019,780,730,1510,37
KIBOGA,2020,820,760,1580,37
KIBOGA,2021,850,780,1630,37
KIBOGA,2022,870,820,1690,37
KIBOGA,2023,910,840,1750,37
KIBOGA,2024,940,870,1810,37
KIBOGA,2025,970,910,1880,37
KIBUKU,2015,660,840,1500,37
KIBUKU,2016,690,880,1570,37
KIBUKU,2017,730,930,1660,37
KIBUKU,2018,760,980,1740,37
KIBUKU,2019,790,1030,1820,37
KIBUKU,2020,830,1090,1920,37
KIBUKU,2021,870,1150,2020,37
KIBUKU,2022,910,1210,2120,37
KIBUKU,2023,960,1270,2230,37
KIBUKU,2024,1000,1340,2340,37
KIBUKU,2025,1050,1420,2470,37
KIKUUBE,2015,1180,1120,2300,37
KIKUUBE,2016,1240,1180,2420,37
KIKUUBE,2017,1310,1230,2540,37
KIKUUBE,2018,1380,1300,2680,37
KIKUUBE,2019,1450,1360,2810,37
KIKUUBE,2020,1520,1430,2950,37
KIKUUBE,2021,1600,1500,3100,37
KIKUUBE,2022,1680,1570,3250,37
KIKUUBE,2023,1770,1650,3420,37
KIKUUBE,2024,1850,1720,3570,37
KIKUUBE,2025,1940,1800,3740,37
KIRUHURA,2015,690,590,1280,37
KIRUHURA,2016,720,610,1330,37
KIRUHURA,2017,750,640,1390,37
KIRUHURA,2018,770,660,1430,37
KIRUHURA,2019,800,680,1480,37
KIRUHURA,2020,830,700,1530,37
KIRUHURA,2021,860,730,1590,37
KIRUHURA,2022,890,750,1640,37
KIRUHURA,2023,920,780,1700,37
KIRUHURA,2024,950,800,1750,37
KIRUHURA,2025,980,820,1800,37
KIRYANDONGO,2015,1050,1060,2110,37
KIRYANDONGO,2016,1090,1110,2200,37
KIRYANDONGO,2017,1130,1160,2290,37
KIRYANDONGO,2018,1170,1220,2390,37
KIRYANDONGO,2019,1210,1270,2480,37
KIRYANDONGO,2020,1260,1330,2590,37
KIRYANDONGO,2021,1310,1380,2690,37
KIRYANDONGO,2022,1360,1440,2800,37
KIRYANDONGO,2023,1420,1490,2910,37
KIRYANDONGO,2024,1490,1560,3050,37
KIRYANDONGO,2025,1530,1640,3170,37
KISORO,2015,810,1210,2020,37
KISORO,2016,840,1260,2100,37
KISORO,2017,860,1310,2170,37
KISORO,2018,880,1360,2240,37
KISORO,2019,910,1410,2320,37
KISORO,2020,930,1460,2390,37
KISORO,2021,960,1510,2470,37
KISORO,2022,990,1560,2550,37
KISORO,2023,1030,1610,2640,37
KISORO,2024,1050,1660,2710,37
KISORO,2025,1070,1740,2810,37
KITAGWENDA,2015,570,660,1230,37
KITAGWENDA,2016,600,680,1280,37
KITAGWENDA,2017,620,700,1320,37
KITAGWENDA,2018,650,730,1380,37
KITAGWENDA,2019,670,750,1420,37
KITAGWENDA,2020,700,780,1480,37
KITAGWENDA,2021,720,810,1530,37
KITAGWENDA,2022,750,830,1580,37
KITAGWENDA,2023,780,860,1640,37
KITAGWENDA,2024,810,890,1700,37
KITAGWENDA,2025,840,910,1750,37
KITGUM,2015,810,870,1680,37
KITGUM,2016,830,900,1730,37
KITGUM,2017,850,930,1780,37
KITGUM,2018,880,960,1840,37
KITGUM,2019,900,990,1890,37
KITGUM,2020,920,1020,1940,37
KITGUM,2021,940,1050,1990,37
KITGUM,2022,960,1080,2040,37
KITGUM,2023,990,1110,2100,37
KITGUM,2024,1010,1150,2160,37
KITGUM,2025,1040,1200,2240,37
KOBOKO,2015,760,870,1630,37
KOBOKO,2016,790,930,1720,37
KOBOKO,2017,830,980,1810,37
KOBOKO,2018,880,1040,1920,37
KOBOKO,2019,920,1100,2020,37
KOBOKO,2020,970,1160,2130,37
KOBOKO,2021,1010,1220,2230,37
KOBOKO,2022,1060,1270,2330,37
KOBOKO,2023,1110,1340,2450,37
KOBOKO,2024,1180,1420,2600,37
KOBOKO,2025,1230,1500,2730,37
KOLE,2015,780,870,1650,37
KOLE,2016,800,900,1700,37
KOLE,2017,830,920,1750,37
KOLE,2018,850,950,1800,37
KOLE,2019,880,970,1850,37
KOLE,2020,910,1000,1910,37
KOLE,2021,940,1030,1970,37
KOLE,2022,960,1050,2010,37
KOLE,2023,990,1080,2070,37
KOLE,2024,1020,1110,2130,37
KOLE,2025,1050,1130,2180,37
KOTIDO,2015,540,740,1280,37
KOTIDO,2016,560,770,1330,37
KOTIDO,2017,570,810,1380,37
KOTIDO,2018,590,830,1420,37
KOTIDO,2019,620,880,1500,37
KOTIDO,2020,640,900,1540,37
KOTIDO,2021,660,930,1590,37
KOTIDO,2022,680,970,1650,37
KOTIDO,2023,700,1000,1700,37
KOTIDO,2024,730,1040,1770,37
KOTIDO,2025,750,1080,1830,37
KUMI,2015,940,1170,2110,37
KUMI,2016,980,1220,2200,37
KUMI,2017,1030,1280,2310,37
KUMI,2018,1060,1350,2410,37
KUMI,2019,1110,1410,2520,37
KUMI,2020,1150,1470,2620,37
KUMI,2021,1200,1540,2740,37
KUMI,2022,1250,1600,2850,37
KUMI,2023,1300,1670,2970,37
KUMI,2024,1360,1750,3110,37
KUMI,2025,1410,1840,3250,37
KWANIA,2015,650,650,1300,37
KWANIA,2016,670,670,1340,37
KWANIA,2017,690,690,1380,37
KWANIA,2018,710,710,1420,37
KWANIA,2019,740,720,1460,37
KWANIA,2020,760,740,1500,37
KWANIA,2021,780,760,1540,37
KWANIA,2022,800,780,1580,37
KWANIA,2023,820,800,1620,37
KWANIA,2024,840,820,1660,37
KWANIA,2025,870,840,1710,37
KWEEN,2015,380,410,790,37
KWEEN,2016,390,420,810,37
KWEEN,2017,400,430,830,37
KWEEN,2018,410,440,850,37
KWEEN,2019,420,450,870,37
KWEEN,2020,440,460,900,37
KWEEN,2021,450,470,920,37
KWEEN,2022,460,480,940,37
KWEEN,2023,470,490,960,37
KWEEN,2024,490,500,990,37
KWEEN,2025,500,510,1010,37
KYANKWANZI,2015,950,820,1770,37
KYANKWANZI,2016,1000,850,1850,37
KYANKWANZI,2017,1050,890,1940,37
KYANKWANZI,2018,1100,940,2040,37
KYANKWANZI,2019,1160,980,2140,37
KYANKWANZI,2020,1210,1020,2230,37
KYANKWANZI,2021,1270,1070,2340,37
KYANKWANZI,2022,1330,1110,2440,37
KYANKWANZI,2023,1400,1160,2560,37
KYANKWANZI,2024,1460,1210,2670,37
KYANKWANZI,2025,1530,1260,2790,37
KYEGEGWA,2015,1150,1120,2270,37
KYEGEGWA,2016,1250,1210,2460,37
KYEGEGWA,2017,1350,1310,2660,37
KYEGEGWA,2018,1460,1410,2870,37
KYEGEGWA,2019,1580,1520,3100,37
KYEGEGWA,2020,1710,1640,3350,37
KYEGEGWA,2021,1850,1760,3610,37
KYEGEGWA,2022,1990,1900,3890,37
KYEGEGWA,2023,2150,2040,4190,37
KYEGEGWA,2024,2310,2200,4510,37
KYEGEGWA,2025,2490,2360,4850,37
KYENJOJO,2015,1660,1720,3380,37
KYENJOJO,2016,1730,1780,3510,37
KYENJOJO,2017,1800,1850,3650,37
KYENJOJO,2018,1870,1910,3780,37
KYENJOJO,2019,1940,1980,3920,37
KYENJOJO,2020,2020,2050,4070,37
KYENJOJO,2021,2100,2120,4220,37
KYENJOJO,2022,2180,2200,4380,37
KYENJOJO,2023,2260,2270,4530,37
KYENJOJO,2024,2340,2340,4680,37
KYENJOJO,2025,2420,2420,4840,37
KYOTERA,2015,1220,1410,2630,37
KYOTERA,2016,1250,1450,2700,37
KYOTERA,2017,1290,1500,2790,37
KYOTERA,2018,1320,1540,2860,37
KYOTERA,2019,1350,1590,2940,37
KYOTERA,2020,1380,1630,3010,37
KYOTERA,2021,1420,1690,3110,37
KYOTERA,2022,1460,1730,3190,37
KYOTERA,2023,1490,1780,3270,37
KYOTERA,2024,1540,1830,3370,37
KYOTERA,2025,1570,1900,3470,37
KARENGA,2015,140,150,290,37
KARENGA,2016,150,150,300,37
KARENGA,2017,150,160,310,37
KARENGA,2018,150,160,310,37
KARENGA,2019,160,170,330,37
KARENGA,2020,160,170,330,37
KARENGA,2021,170,170,340,37
KARENGA,2022,170,180,350,37
KARENGA,2023,170,180,350,37
KARENGA,2024,180,190,370,37
KARENGA,2025,180,190,370,37
LAMWO,2015,480,550,1030,37
LAMWO,2016,480,570,1050,37
LAMWO,2017,500,590,1090,37
LAMWO,2018,510,600,1110,37
LAMWO,2019,520,630,1150,37
LAMWO,2020,530,640,1170,37
LAMWO,2021,530,660,1190,37
LAMWO,2022,550,680,1230,37
LAMWO,2023,560,700,1260,37
LAMWO,2024,560,720,1280,37
LAMWO,2025,570,740,1310,37
LIRA,2015,1550,1510,3060,37
LIRA,2016,1600,1550,3150,37
LIRA,2017,1640,1600,3240,37
LIRA,2018,1690,1640,3330,37
LIRA,2019,1740,1690,3430,37
LIRA,2020,1780,1740,3520,37
LIRA,2021,1830,1780,3610,37
LIRA,2022,1870,1830,3700,37
LIRA,2023,1920,1870,3790,37
LIRA,2024,1960,1920,3880,37
LIRA,2025,2010,1970,3980,37
LUUKA,2015,690,980,1670,37
LUUKA,2016,710,1010,1720,37
LUUKA,2017,740,1060,1800,37
LUUKA,2018,760,1100,1860,37
LUUKA,2019,780,1140,1920,37
LUUKA,2020,810,1180,1990,37
LUUKA,2021,830,1220,2050,37
LUUKA,2022,850,1260,2110,37
LUUKA,2023,870,1310,2180,37
LUUKA,2024,900,1350,2250,37
LUUKA,2025,930,1400,2330,37
LUWERO,2015,2000,2200,4200,37
LUWERO,2016,2070,2290,4360,37
LUWERO,2017,2130,2380,4510,37
LUWERO,2018,2210,2480,4690,37
LUWERO,2019,2280,2570,4850,37
LUWERO,2020,2370,2680,5050,37
LUWERO,2021,2450,2780,5230,37
LUWERO,2022,2530,2880,5410,37
LUWERO,2023,2620,2980,5600,37
LUWERO,2024,2700,3100,5800,37
LUWERO,2025,2800,3240,6040,37
LWENGO,2015,1220,1490,2710,37
LWENGO,2016,1240,1530,2770,37
LWENGO,2017,1260,1570,2830,37
LWENGO,2018,1300,1620,2920,37
LWENGO,2019,1320,1660,2980,37
LWENGO,2020,1350,1700,3050,37
LWENGO,2021,1370,1740,3110,37
LWENGO,2022,1400,1780,3180,37
LWENGO,2023,1430,1820,3250,37
LWENGO,2024,1450,1860,3310,37
LWENGO,2025,1480,1930,3410,37
LYANTONDE,2015,390,390,780,37
LYANTONDE,2016,400,410,810,37
LYANTONDE,2017,410,420,830,37
LYANTONDE,2018,430,440,870,37
LYANTONDE,2019,440,460,900,37
LYANTONDE,2020,460,480,940,37
LYANTONDE,2021,480,510,990,37
LYANTONDE,2022,500,530,1030,37
LYANTONDE,2023,520,550,1070,37
LYANTONDE,2024,540,570,1110,37
LYANTONDE,2025,560,590,1150,37
MANAFWA,2015,570,620,1190,37
MANAFWA,2016,590,640,1230,37
MANAFWA,2017,600,650,1250,37
MANAFWA,2018,620,660,1280,37
MANAFWA,2019,630,680,1310,37
MANAFWA,2020,640,690,1330,37
MANAFWA,2021,660,710,1370,37
MANAFWA,2022,670,720,1390,37
MANAFWA,2023,690,730,1420,37
MANAFWA,2024,700,750,1450,37
MANAFWA,2025,720,760,1480,37
MARACHA,2015,510,770,1280,37
MARACHA,2016,520,790,1310,37
MARACHA,2017,530,800,1330,37
MARACHA,2018,540,820,1360,37
MARACHA,2019,550,830,1380,37
MARACHA,2020,560,850,1410,37
MARACHA,2021,570,860,1430,37
MARACHA,2022,580,880,1460,37
MARACHA,2023,590,890,1480,37
MARACHA,2024,600,900,1500,37
MARACHA,2025,610,920,1530,37
MASAKA,2015,1560,1650,3210,37
MASAKA,2016,1610,1720,3330,37
MASAKA,2017,1670,1790,3460,37
MASAKA,2018,1720,1860,3580,37
MASAKA,2019,1770,1930,3700,37
MASAKA,2020,1830,2010,3840,37
MASAKA,2021,1880,2070,3950,37
MASAKA,2022,1940,2140,4080,37
MASAKA,2023,2010,2210,4220,37
MASAKA,2024,2060,2290,4350,37
MASAKA,2025,2120,2390,4510,37
MASINDI,2015,1280,1150,2430,37
MASINDI,2016,1320,1180,2500,37
MASINDI,2017,1360,1220,2580,37
MASINDI,2018,1400,1250,2650,37
MASINDI,2019,1440,1280,2720,37
MASINDI,2020,1480,1310,2790,37
MASINDI,2021,1520,1350,2870,37
MASINDI,2022,1560,1380,2940,37
MASINDI,2023,1600,1410,3010,37
MASINDI,2024,1640,1440,3080,37
MASINDI,2025,1680,1470,3150,37
MAYUGE,2015,1570,2060,3630,37
MAYUGE,2016,1630,2180,3810,37
MAYUGE,2017,1700,2280,3980,37
MAYUGE,2018,1770,2390,4160,37
MAYUGE,2019,1850,2510,4360,37
MAYUGE,2020,1920,2630,4550,37
MAYUGE,2021,2000,2740,4740,37
MAYUGE,2022,2080,2860,4940,37
MAYUGE,2023,2170,2990,5160,37
MAYUGE,2024,2260,3130,5390,37
MAYUGE,2025,2340,3300,5640,37
MBALE,2015,2000,2430,4430,37
MBALE,2016,2080,2560,4640,37
MBALE,2017,2160,2680,4840,37
MBALE,2018,2250,2820,5070,37
MBALE,2019,2330,2980,5310,37
MBALE,2020,2430,3120,5550,37
MBALE,2021,2520,3270,5790,37
MBALE,2022,2630,3410,6040,37
MBALE,2023,2740,3580,6320,37
MBALE,2024,2850,3750,6600,37
MBALE,2025,2940,3970,6910,37
MBARARA,2015,1450,1520,2970,37
MBARARA,2016,1480,1550,3030,37
MBARARA,2017,1510,1580,3090,37
MBARARA,2018,1550,1620,3170,37
MBARARA,2019,1580,1650,3230,37
MBARARA,2020,1620,1680,3300,37
MBARARA,2021,1650,1720,3370,37
MBARARA,2022,1680,1750,3430,37
MBARARA,2023,1720,1780,3500,37
MBARARA,2024,1750,1810,3560,37
MBARARA,2025,1780,1840,3620,37
MITOOMA,2015,540,830,1370,37
MITOOMA,2016,540,840,1380,37
MITOOMA,2017,550,840,1390,37
MITOOMA,2018,550,850,1400,37
MITOOMA,2019,560,860,1420,37
MITOOMA,2020,570,870,1440,37
MITOOMA,2021,570,870,1440,37
MITOOMA,2022,580,880,1460,37
MITOOMA,2023,580,880,1460,37
MITOOMA,2024,590,890,1480,37
MITOOMA,2025,590,890,1480,37
MITYANA,2015,1540,1580,3120,37
MITYANA,2016,1580,1630,3210,37
MITYANA,2017,1620,1690,3310,37
MITYANA,2018,1670,1750,3420,37
MITYANA,2019,1710,1800,3510,37
MITYANA,2020,1760,1860,3620,37
MITYANA,2021,1810,1920,3730,37
MITYANA,2022,1860,1970,3830,37
MITYANA,2023,1910,2030,3940,37
MITYANA,2024,1960,2100,4060,37
MITYANA,2025,2020,2180,4200,37
MOROTO,2015,350,350,700,37
MOROTO,2016,350,370,720,37
MOROTO,2017,370,390,760,37
MOROTO,2018,390,400,790,37
MOROTO,2019,390,420,810,37
MOROTO,2020,400,440,840,37
MOROTO,2021,420,460,880,37
MOROTO,2022,440,470,910,37
MOROTO,2023,440,490,930,37
MOROTO,2024,460,510,970,37
MOROTO,2025,480,540,1020,37
MOYO,2015,340,400,740,37
MOYO,2016,340,410,750,37
MOYO,2017,350,420,770,37
MOYO,2018,360,430,790,37
MOYO,2019,370,440,810,37
MOYO,2020,380,450,830,37
MOYO,2021,390,450,840,37
MOYO,2022,400,460,860,37
MOYO,2023,400,470,870,37
MOYO,2024,410,480,890,37
MOYO,2025,420,490,910,37
MPIGI,2015,1140,1200,2340,37
MPIGI,2016,1170,1250,2420,37
MPIGI,2017,1220,1310,2530,37
MPIGI,2018,1250,1360,2610,37
MPIGI,2019,1300,1410,2710,37
MPIGI,2020,1340,1470,2810,37
MPIGI,2021,1390,1530,2920,37
MPIGI,2022,1430,1580,3010,37
MPIGI,2023,1480,1630,3110,37
MPIGI,2024,1530,1710,3240,37
MPIGI,2025,1570,1780,3350,37
MUBENDE,2015,2040,1960,4000,37
MUBENDE,2016,2160,2100,4260,37
MUBENDE,2017,2300,2240,4540,37
MUBENDE,2018,2460,2400,4860,37
MUBENDE,2019,2600,2570,5170,37
MUBENDE,2020,2770,2750,5520,37
MUBENDE,2021,2930,2930,5860,37
MUBENDE,2022,3110,3110,6220,37
MUBENDE,2023,3320,3310,6630,37
MUBENDE,2024,3520,3540,7060,37
MUBENDE,2025,3730,3810,7540,37
MUKONO,2015,2810,3050,5860,37
MUKONO,2016,2910,3200,6110,37
MUKONO,2017,3000,3350,6350,37
MUKONO,2018,3120,3520,6640,37
MUKONO,2019,3240,3690,6930,37
MUKONO,2020,3360,3850,7210,37
MUKONO,2021,3480,4010,7490,37
MUKONO,2022,3600,4180,7780,37
MUKONO,2023,3740,4360,8100,37
MUKONO,2024,3870,4560,8430,37
MUKONO,2025,4000,4800,8800,37
MADI OKOLLO,2015,400,530,930,37
MADI OKOLLO,2016,410,550,960,37
MADI OKOLLO,2017,430,560,990,37
MADI OKOLLO,2018,440,580,1020,37
MADI OKOLLO,2019,450,590,1040,37
MADI OKOLLO,2020,460,610,1070,37
MADI OKOLLO,2021,470,620,1090,37
MADI OKOLLO,2022,490,640,1130,37
MADI OKOLLO,2023,500,650,1150,37
MADI OKOLLO,2024,510,670,1180,37
MADI OKOLLO,2025,520,680,1200,37
NABILATUK,2015,130,180,310,37
NABILATUK,2016,140,200,340,37
NABILATUK,2017,140,200,340,37
NABILATUK,2018,160,220,380,37
NABILATUK,2019,170,240,410,37
NABILATUK,2020,170,250,420,37
NABILATUK,2021,190,260,450,37
NABILATUK,2022,200,270,470,37
NABILATUK,2023,220,290,510,37
NABILATUK,2024,230,310,540,37
NABILATUK,2025,230,340,570,37
NAKAPIRIPIRIT,2015,220,280,500,37
NAKAPIRIPIRIT,2016,220,300,520,37
NAKAPIRIPIRIT,2017,240,310,550,37
NAKAPIRIPIRIT,2018,250,330,580,37
NAKAPIRIPIRIT,2019,270,350,620,37
NAKAPIRIPIRIT,2020,280,370,650,37
NAKAPIRIPIRIT,2021,300,410,710,37
NAKAPIRIPIRIT,2022,310,420,730,37
NAKAPIRIPIRIT,2023,330,450,780,37
NAKAPIRIPIRIT,2024,350,470,820,37
NAKAPIRIPIRIT,2025,360,510,870,37
NAKASEKE,2015,980,680,1660,37
NAKASEKE,2016,1020,700,1720,37
NAKASEKE,2017,1060,720,1780,37
NAKASEKE,2018,1090,730,1820,37
NAKASEKE,2019,1130,750,1880,37
NAKASEKE,2020,1170,770,1940,37
NAKASEKE,2021,1210,790,2000,37
NAKASEKE,2022,1250,800,2050,37
NAKASEKE,2023,1290,820,2110,37
NAKASEKE,2024,1340,830,2170,37
NAKASEKE,2025,1380,850,2230,37
NAKASONGOLA,2015,920,780,1700,37
NAKASONGOLA,2016,960,800,1760,37
NAKASONGOLA,2017,1000,840,1840,37
NAKASONGOLA,2018,1030,890,1920,37
NAKASONGOLA,2019,1080,930,2010,37
NAKASONGOLA,2020,1130,970,2100,37
NAKASONGOLA,2021,1170,1000,2170,37
NAKASONGOLA,2022,1230,1040,2270,37
NAKASONGOLA,2023,1280,1090,2370,37
NAKASONGOLA,2024,1320,1140,2460,37
NAKASONGOLA,2025,1370,1200,2570,37
NAMAYINGO,2015,920,980,1900,37
NAMAYINGO,2016,940,1010,1950,37
NAMAYINGO,2017,970,1050,2020,37
NAMAYINGO,2018,1000,1080,2080,37
NAMAYINGO,2019,1020,1110,2130,37
NAMAYINGO,2020,1050,1140,2190,37
NAMAYINGO,2021,1080,1190,2270,37
NAMAYINGO,2022,1110,1220,2330,37
NAMAYINGO,2023,1140,1250,2390,37
NAMAYINGO,2024,1180,1290,2470,37
NAMAYINGO,2025,1200,1340,2540,37
NAMISINDWA,2015,700,810,1510,37
NAMISINDWA,2016,720,830,1550,37
NAMISINDWA,2017,740,850,1590,37
NAMISINDWA,2018,760,870,1630,37
NAMISINDWA,2019,790,890,1680,37
NAMISINDWA,2020,810,910,1720,37
NAMISINDWA,2021,830,920,1750,37
NAMISINDWA,2022,850,940,1790,37
NAMISINDWA,2023,870,960,1830,37
NAMISINDWA,2024,890,980,1870,37
NAMISINDWA,2025,910,1000,1910,37
NAMUTUMBA,2015,820,1070,1890,37
NAMUTUMBA,2016,850,1120,1970,37
NAMUTUMBA,2017,890,1180,2070,37
NAMUTUMBA,2018,940,1250,2190,37
NAMUTUMBA,2019,970,1310,2280,37
NAMUTUMBA,2020,1020,1370,2390,37
NAMUTUMBA,2021,1060,1430,2490,37
NAMUTUMBA,2022,1110,1490,2600,37
NAMUTUMBA,2023,1170,1560,2730,37
NAMUTUMBA,2024,1220,1650,2870,37
NAMUTUMBA,2025,1270,1740,3010,37
NAPAK,2015,340,460,800,37
NAPAK,2016,350,480,830,37
NAPAK,2017,360,490,850,37
NAPAK,2018,370,510,880,37
NAPAK,2019,380,540,920,37
NAPAK,2020,390,560,950,37
NAPAK,2021,400,580,980,37
NAPAK,2022,410,590,1000,37
NAPAK,2023,420,610,1030,37
NAPAK,2024,440,640,1080,37
NAPAK,2025,440,670,1110,37
NEBBI,2015,700,900,1600,37
NEBBI,2016,720,920,1640,37
NEBBI,2017,750,950,1700,37
NEBBI,2018,770,980,1750,37
NEBBI,2019,790,1000,1790,37
NEBBI,2020,820,1030,1850,37
NEBBI,2021,840,1060,1900,37
NEBBI,2022,860,1090,1950,37
NEBBI,2023,890,1110,2000,37
NEBBI,2024,910,1140,2050,37
NEBBI,2025,940,1170,2110,37
NGORA,2015,490,640,1130,37
NGORA,2016,520,680,1200,37
NGORA,2017,540,710,1250,37
NGORA,2018,550,730,1280,37
NGORA,2019,580,770,1350,37
NGORA,2020,600,800,1400,37
NGORA,2021,620,840,1460,37
NGORA,2022,650,860,1510,37
NGORA,2023,670,900,1570,37
NGORA,2024,690,940,1630,37
NGORA,2025,720,980,1700,37
NTOROKO,2015,330,290,620,37
NTOROKO,2016,340,300,640,37
NTOROKO,2017,360,310,670,37
NTOROKO,2018,370,320,690,37
NTOROKO,2019,380,340,720,37
NTOROKO,2020,390,350,740,37
NTOROKO,2021,410,360,770,37
NTOROKO,2022,430,370,800,37
NTOROKO,2023,430,390,820,37
NTOROKO,2024,450,400,850,37
NTOROKO,2025,470,410,880,37
NTUNGAMO,2015,1720,2150,3870,37
NTUNGAMO,2016,1760,2190,3950,37
NTUNGAMO,2017,1800,2230,4030,37
NTUNGAMO,2018,1840,2270,4110,37
NTUNGAMO,2019,1870,2310,4180,37
NTUNGAMO,2020,1910,2350,4260,37
NTUNGAMO,2021,1950,2390,4340,37
NTUNGAMO,2022,1980,2420,4400,37
NTUNGAMO,2023,2020,2460,4480,37
NTUNGAMO,2024,2050,2500,4550,37
NTUNGAMO,2025,2090,2530,4620,37
NWOYA,2015,480,490,970,37
NWOYA,2016,530,540,1070,37
NWOYA,2017,590,590,1180,37
NWOYA,2018,650,650,1300,37
NWOYA,2019,720,720,1440,37
NWOYA,2020,790,790,1580,37
NWOYA,2021,870,870,1740,37
NWOYA,2022,960,960,1920,37
NWOYA,2023,1060,1050,2110,37
NWOYA,2024,1160,1150,2310,37
NWOYA,2025,1280,1260,2540,37
OBONGI,2015,150,210,360,37
OBONGI,2016,150,210,360,37
OBONGI,2017,170,230,400,37
OBONGI,2018,170,230,400,37
OBONGI,2019,170,240,410,37
OBONGI,2020,180,250,430,37
OBONGI,2021,190,260,450,37
OBONGI,2022,190,260,450,37
OBONGI,2023,200,280,480,37
OBONGI,2024,210,280,490,37
OBONGI,2025,210,290,500,37
OMORO,2015,620,730,1350,37
OMORO,2016,650,770,1420,37
OMORO,2017,680,810,1490,37
OMORO,2018,720,860,1580,37
OMORO,2019,750,900,1650,37
OMORO,2020,780,940,1720,37
OMORO,2021,820,990,1810,37
OMORO,2022,850,1040,1890,37
OMORO,2023,900,1090,1990,37
OMORO,2024,940,1140,2080,37
OMORO,2025,970,1210,2180,37
OTUKE,2015,350,320,670,37
OTUKE,2016,370,330,700,37
OTUKE,2017,390,340,730,37
OTUKE,2018,400,360,760,37
OTUKE,2019,420,370,790,37
OTUKE,2020,440,390,830,37
OTUKE,2021,460,400,860,37
OTUKE,2022,480,420,900,37
OTUKE,2023,500,440,940,37
OTUKE,2024,520,450,970,37
OTUKE,2025,540,470,1010,37
OYAM,2015,1290,1480,2770,37
OYAM,2016,1330,1530,2860,37
OYAM,2017,1380,1570,2950,37
OYAM,2018,1420,1620,3040,37
OYAM,2019,1460,1660,3120,37
OYAM,2020,1500,1710,3210,37
OYAM,2021,1540,1760,3300,37
OYAM,2022,1590,1800,3390,37
OYAM,2023,1630,1850,3480,37
OYAM,2024,1670,1900,3570,37
OYAM,2025,1710,1940,3650,37
PADER,2015,620,720,1340,37
PADER,2016,640,750,1390,37
PADER,2017,660,780,1440,37
PADER,2018,670,810,1480,37
PADER,2019,690,840,1530,37
PADER,2020,710,860,1570,37
PADER,2021,730,890,1620,37
PADER,2022,750,920,1670,37
PADER,2023,760,950,1710,37
PADER,2024,780,980,1760,37
PADER,2025,800,1020,1820,37
PAKWACH,2015,500,550,1050,37
PAKWACH,2016,520,570,1090,37
PAKWACH,2017,540,590,1130,37
PAKWACH,2018,560,620,1180,37
PAKWACH,2019,590,640,1230,37
PAKWACH,2020,610,660,1270,37
PAKWACH,2021,640,680,1320,37
PAKWACH,2022,660,710,1370,37
PAKWACH,2023,680,730,1410,37
PAKWACH,2024,710,750,1460,37
PAKWACH,2025,740,780,1520,37
PALLISA,2015,1010,1230,2240,37
PALLISA,2016,1060,1300,2360,37
PALLISA,2017,1130,1390,2520,37
PALLISA,2018,1190,1460,2650,37
PALLISA,2019,1250,1560,2810,37
PALLISA,2020,1320,1650,2970,37
PALLISA,2021,1400,1740,3140,37
PALLISA,2022,1480,1850,3330,37
PALLISA,2023,1550,1950,3500,37
PALLISA,2024,1640,2060,3700,37
PALLISA,2025,1720,2200,3920,37
RAKAI,2015,1280,1480,2760,37
RAKAI,2016,1320,1550,2870,37
RAKAI,2017,1360,1610,2970,37
RAKAI,2018,1420,1680,3100,37
RAKAI,2019,1470,1750,3220,37
RAKAI,2020,1520,1820,3340,37
RAKAI,2021,1570,1880,3450,37
RAKAI,2022,1630,1950,3580,37
RAKAI,2023,1670,2020,3690,37
RAKAI,2024,1730,2100,3830,37
RAKAI,2025,1790,2190,3980,37
RUBANDA,2015,670,850,1520,37
RUBANDA,2016,680,860,1540,37
RUBANDA,2017,690,870,1560,37
RUBANDA,2018,690,870,1560,37
RUBANDA,2019,700,880,1580,37
RUBANDA,2020,710,890,1600,37
RUBANDA,2021,720,890,1610,37
RUBANDA,2022,730,900,1630,37
RUBANDA,2023,730,900,1630,37
RUBANDA,2024,740,910,1650,37
RUBANDA,2025,750,910,1660,37
RUBIRIZI,2015,470,580,1050,37
RUBIRIZI,2016,480,590,1070,37
RUBIRIZI,2017,490,600,1090,37
RUBIRIZI,2018,500,610,1110,37
RUBIRIZI,2019,510,620,1130,37
RUBIRIZI,2020,520,630,1150,37
RUBIRIZI,2021,520,640,1160,37
RUBIRIZI,2022,530,650,1180,37
RUBIRIZI,2023,540,660,1200,37
RUBIRIZI,2024,550,670,1220,37
RUBIRIZI,2025,560,680,1240,37
RUKIGA,2015,410,460,870,37
RUKIGA,2016,420,470,890,37
RUKIGA,2017,420,470,890,37
RUKIGA,2018,420,470,890,37
RUKIGA,2019,430,480,910,37
RUKIGA,2020,430,480,910,37
RUKIGA,2021,440,480,920,37
RUKIGA,2022,440,480,920,37
RUKIGA,2023,440,490,930,37
RUKIGA,2024,440,490,930,37
RUKIGA,2025,450,490,940,37
RUKUNGIRI,2015,1140,1440,2580,37
RUKUNGIRI,2016,1160,1450,2610,37
RUKUNGIRI,2017,1170,1460,2630,37
RUKUNGIRI,2018,1180,1480,2660,37
RUKUNGIRI,2019,1200,1490,2690,37
RUKUNGIRI,2020,1210,1500,2710,37
RUKUNGIRI,2021,1220,1510,2730,37
RUKUNGIRI,2022,1230,1530,2760,37
RUKUNGIRI,2023,1240,1540,2780,37
RUKUNGIRI,2024,1250,1540,2790,37
RUKUNGIRI,2025,1260,1550,2810,37
RWAMPARA,2015,500,560,1060,37
RWAMPARA,2016,510,580,1090,37
RWAMPARA,2017,520,590,1110,37
RWAMPARA,2018,530,600,1130,37
RWAMPARA,2019,540,610,1150,37
RWAMPARA,2020,550,630,1180,37
RWAMPARA,2021,560,640,1200,37
RWAMPARA,2022,580,650,1230,37
RWAMPARA,2023,590,660,1250,37
RWAMPARA,2024,600,680,1280,37
RWAMPARA,2025,610,690,1300,37
SERERE,2015,1140,1250,2390,37
SERERE,2016,1190,1320,2510,37
SERERE,2017,1250,1400,2650,37
SERERE,2018,1310,1480,2790,37
SERERE,2019,1380,1570,2950,37
SERERE,2020,1450,1650,3100,37
SERERE,2021,1520,1740,3260,37
SERERE,2022,1600,1840,3440,37
SERERE,2023,1680,1920,3600,37
SERERE,2024,1770,2030,3800,37
SERERE,2025,1850,2160,4010,37
SHEEMA,2015,720,980,1700,37
SHEEMA,2016,730,990,1720,37
SHEEMA,2017,740,1000,1740,37
SHEEMA,2018,750,1010,1760,37
SHEEMA,2019,760,1020,1780,37
SHEEMA,2020,760,1030,1790,37
SHEEMA,2021,770,1040,1810,37
SHEEMA,2022,780,1050,1830,37
SHEEMA,2023,790,1050,1840,37
SHEEMA,2024,790,1060,1850,37
SHEEMA,2025,800,1070,1870,37
SIRONKO,2015,870,990,1860,37
SIRONKO,2016,890,1010,1900,37
SIRONKO,2017,910,1030,1940,37
SIRONKO,2018,930,1050,1980,37
SIRONKO,2019,950,1070,2020,37
SIRONKO,2020,980,1090,2070,37
SIRONKO,2021,1000,1120,2120,37
SIRONKO,2022,1020,1140,2160,37
SIRONKO,2023,1040,1150,2190,37
SIRONKO,2024,1060,1170,2230,37
SIRONKO,2025,1080,1190,2270,37
SOROTI,2015,1260,1380,2640,37
SOROTI,2016,1310,1460,2770,37
SOROTI,2017,1370,1540,2910,37
SOROTI,2018,1440,1620,3060,37
SOROTI,2019,1510,1700,3210,37
SOROTI,2020,1570,1790,3360,37
SOROTI,2021,1640,1880,3520,37
SOROTI,2022,1730,1970,3700,37
SOROTI,2023,1800,2060,3860,37
SOROTI,2024,1880,2170,4050,37
SOROTI,2025,1970,2290,4260,37
SSEMBABULE,2015,1280,1290,2570,37
SSEMBABULE,2016,1330,1350,2680,37
SSEMBABULE,2017,1380,1410,2790,37
SSEMBABULE,2018,1440,1480,2920,37
SSEMBABULE,2019,1490,1530,3020,37
SSEMBABULE,2020,1540,1590,3130,37
SSEMBABULE,2021,1610,1660,3270,37
SSEMBABULE,2022,1680,1730,3410,37
SSEMBABULE,2023,1740,1800,3540,37
SSEMBABULE,2024,1810,1880,3690,37
SSEMBABULE,2025,1860,1970,3830,37
TORORO,2015,1770,2190,3960,37
TORORO,2016,1820,2240,4060,37
TORORO,2017,1870,2300,4170,37
TORORO,2018,1920,2350,4270,37
TORORO,2019,1970,2410,4380,37
TORORO,2020,2010,2470,4480,37
TORORO,2021,2060,2520,4580,37
TORORO,2022,2110,2580,4690,37
TORORO,2023,2160,2640,4800,37
TORORO,2024,2210,2690,4900,37
TORORO,2025,2260,2750,5010,37
WAKISO,2015,9830,9300,19130,37
WAKISO,2016,10490,9930,20420,37
WAKISO,2017,11190,10610,21800,37
WAKISO,2018,11930,11330,23260,37
WAKISO,2019,12730,12090,24820,37
WAKISO,2020,13560,12890,26450,37
WAKISO,2021,14430,13750,28180,37
WAKISO,2022,15350,14660,30010,37
WAKISO,2023,16330,15600,31930,37
WAKISO,2024,17340,16590,33930,37
WAKISO,2025,18410,17650,36060,37
YUMBE,2015,1600,1970,3570,37
YUMBE,2016,1700,2130,3830,37
YUMBE,2017,1800,2290,4090,37
YUMBE,2018,1910,2480,4390,37
YUMBE,2019,2030,2670,4700,37
YUMBE,2020,2160,2870,5030,37
YUMBE,2021,2290,3080,5370,37
YUMBE,2022,2430,3300,5730,37
YUMBE,2023,2570,3530,6100,37
YUMBE,2024,2730,3810,6540,37
YUMBE,2025,2890,4130,7020,37
ZOMBO,2015,660,800,1460,37
ZOMBO,2016,680,830,1510,37
ZOMBO,2017,710,850,1560,37
ZOMBO,2018,730,870,1600,37
ZOMBO,2019,750,900,1650,37
ZOMBO,2020,770,920,1690,37
ZOMBO,2021,790,940,1730,37
ZOMBO,2022,820,970,1790,37
ZOMBO,2023,840,990,1830,37
ZOMBO,2024,860,1010,1870,37
ZOMBO,2025,880,1040,1920,37
ABIM,2015,360,440,800,38
ABIM,2016,380,470,850,38
ABIM,2017,410,510,920,38
ABIM,2018,440,560,1000,38
ABIM,2019,480,600,1080,38
ABIM,2020,510,650,1160,38
ABIM,2021,550,700,1250,38
ABIM,2022,580,750,1330,38
ABIM,2023,630,810,1440,38
ABIM,2024,680,860,1540,38
ABIM,2025,730,940,1670,38
ADJUMANI,2015,810,1190,2000,38
ADJUMANI,2016,820,1200,2020,38
ADJUMANI,2017,820,1210,2030,38
ADJUMANI,2018,830,1220,2050,38
ADJUMANI,2019,840,1240,2080,38
ADJUMANI,2020,840,1250,2090,38
ADJUMANI,2021,840,1260,2100,38
ADJUMANI,2022,850,1260,2110,38
ADJUMANI,2023,850,1270,2120,38
ADJUMANI,2024,850,1280,2130,38
ADJUMANI,2025,860,1290,2150,38
AGAGO,2015,870,1100,1970,38
AGAGO,2016,890,1120,2010,38
AGAGO,2017,910,1140,2050,38
AGAGO,2018,920,1160,2080,38
AGAGO,2019,940,1180,2120,38
AGAGO,2020,950,1200,2150,38
AGAGO,2021,970,1220,2190,38
AGAGO,2022,980,1240,2220,38
AGAGO,2023,990,1250,2240,38
AGAGO,2024,1010,1270,2280,38
AGAGO,2025,1020,1290,2310,38
ALEBTONG,2015,750,960,1710,38
ALEBTONG,2016,780,1000,1780,38
ALEBTONG,2017,800,1050,1850,38
ALEBTONG,2018,830,1100,1930,38
ALEBTONG,2019,870,1150,2020,38
ALEBTONG,2020,900,1200,2100,38
ALEBTONG,2021,940,1240,2180,38
ALEBTONG,2022,960,1290,2250,38
ALEBTONG,2023,1000,1340,2340,38
ALEBTONG,2024,1040,1400,2440,38
ALEBTONG,2025,1080,1460,2540,38
AMOLATAR,2015,540,640,1180,38
AMOLATAR,2016,560,670,1230,38
AMOLATAR,2017,570,690,1260,38
AMOLATAR,2018,600,720,1320,38
AMOLATAR,2019,610,760,1370,38
AMOLATAR,2020,640,790,1430,38
AMOLATAR,2021,670,810,1480,38
AMOLATAR,2022,680,850,1530,38
AMOLATAR,2023,710,880,1590,38
AMOLATAR,2024,730,910,1640,38
AMOLATAR,2025,760,950,1710,38
AMUDAT,2015,390,370,760,38
AMUDAT,2016,410,390,800,38
AMUDAT,2017,430,420,850,38
AMUDAT,2018,450,440,890,38
AMUDAT,2019,470,470,940,38
AMUDAT,2020,490,500,990,38
AMUDAT,2021,520,530,1050,38
AMUDAT,2022,540,570,1110,38
AMUDAT,2023,570,600,1170,38
AMUDAT,2024,600,630,1230,38
AMUDAT,2025,630,680,1310,38
AMURIA,2015,640,740,1380,38
AMURIA,2016,660,780,1440,38
AMURIA,2017,700,820,1520,38
AMURIA,2018,720,870,1590,38
AMURIA,2019,760,910,1670,38
AMURIA,2020,800,960,1760,38
AMURIA,2021,840,1010,1850,38
AMURIA,2022,870,1050,1920,38
AMURIA,2023,920,1100,2020,38
AMURIA,2024,960,1160,2120,38
AMURIA,2025,1000,1220,2220,38
AMURU,2015,680,930,1610,38
AMURU,2016,700,970,1670,38
AMURU,2017,730,1000,1730,38
AMURU,2018,750,1050,1800,38
AMURU,2019,780,1100,1880,38
AMURU,2020,810,1150,1960,38
AMURU,2021,840,1190,2030,38
AMURU,2022,860,1240,2100,38
AMURU,2023,900,1290,2190,38
AMURU,2024,930,1330,2260,38
AMURU,2025,960,1390,2350,38
APAC,2015,740,880,1620,38
APAC,2016,770,920,1690,38
APAC,2017,800,950,1750,38
APAC,2018,830,980,1810,38
APAC,2019,860,1010,1870,38
APAC,2020,890,1050,1940,38
APAC,2021,920,1080,2000,38
APAC,2022,950,1120,2070,38
APAC,2023,980,1150,2130,38
APAC,2024,1010,1190,2200,38
APAC,2025,1040,1220,2260,38
ARUA,2015,2720,3860,6580,38
ARUA,2016,2800,3960,6760,38
ARUA,2017,2870,4070,6940,38
ARUA,2018,2960,4180,7140,38
ARUA,2019,3040,4290,7330,38
ARUA,2020,3120,4400,7520,38
ARUA,2021,3210,4510,7720,38
ARUA,2022,3290,4620,7910,38
ARUA,2023,3370,4730,8100,38
ARUA,2024,3460,4840,8300,38
ARUA,2025,3540,4950,8490,38
BUDAKA,2015,650,870,1520,38
BUDAKA,2016,670,910,1580,38
BUDAKA,2017,710,950,1660,38
BUDAKA,2018,730,1010,1740,38
BUDAKA,2019,770,1060,1830,38
BUDAKA,2020,810,1120,1930,38
BUDAKA,2021,850,1170,2020,38
BUDAKA,2022,880,1230,2110,38
BUDAKA,2023,930,1280,2210,38
BUDAKA,2024,970,1340,2310,38
BUDAKA,2025,1000,1420,2420,38
BUDUDA,2015,720,780,1500,38
BUDUDA,2016,760,830,1590,38
BUDUDA,2017,790,880,1670,38
BUDUDA,2018,840,930,1770,38
BUDUDA,2019,890,1000,1890,38
BUDUDA,2020,940,1060,2000,38
BUDUDA,2021,990,1120,2110,38
BUDUDA,2022,1040,1190,2230,38
BUDUDA,2023,1100,1260,2360,38
BUDUDA,2024,1150,1330,2480,38
BUDUDA,2025,1220,1420,2640,38
BUGIRI,2015,1260,1750,3010,38
BUGIRI,2016,1310,1840,3150,38
BUGIRI,2017,1380,1950,3330,38
BUGIRI,2018,1450,2060,3510,38
BUGIRI,2019,1520,2180,3700,38
BUGIRI,2020,1610,2300,3910,38
BUGIRI,2021,1680,2420,4100,38
BUGIRI,2022,1770,2550,4320,38
BUGIRI,2023,1850,2690,4540,38
BUGIRI,2024,1950,2830,4780,38
BUGIRI,2025,2050,2970,5020,38
BUGWERI,2015,560,810,1370,38
BUGWERI,2016,570,840,1410,38
BUGWERI,2017,590,880,1470,38
BUGWERI,2018,620,920,1540,38
BUGWERI,2019,640,950,1590,38
BUGWERI,2020,660,1000,1660,38
BUGWERI,2021,690,1040,1730,38
BUGWERI,2022,710,1080,1790,38
BUGWERI,2023,730,1120,1850,38
BUGWERI,2024,760,1160,1920,38
BUGWERI,2025,790,1210,2000,38
BUHWEJU,2015,530,530,1060,38
BUHWEJU,2016,550,540,1090,38
BUHWEJU,2017,570,560,1130,38
BUHWEJU,2018,590,580,1170,38
BUHWEJU,2019,610,590,1200,38
BUHWEJU,2020,630,610,1240,38
BUHWEJU,2021,640,630,1270,38
BUHWEJU,2022,660,650,1310,38
BUHWEJU,2023,680,660,1340,38
BUHWEJU,2024,700,680,1380,38
BUHWEJU,2025,720,700,1420,38
BUIKWE,2015,1770,1830,3600,38
BUIKWE,2016,1800,1900,3700,38
BUIKWE,2017,1860,1970,3830,38
BUIKWE,2018,1910,2050,3960,38
BUIKWE,2019,1970,2130,4100,38
BUIKWE,2020,2030,2210,4240,38
BUIKWE,2021,2090,2290,4380,38
BUIKWE,2022,2150,2370,4520,38
BUIKWE,2023,2220,2440,4660,38
BUIKWE,2024,2280,2520,4800,38
BUIKWE,2025,2350,2610,4960,38
BUKEDEA,2015,650,830,1480,38
BUKEDEA,2016,670,870,1540,38
BUKEDEA,2017,710,930,1640,38
BUKEDEA,2018,750,980,1730,38
BUKEDEA,2019,790,1040,1830,38
BUKEDEA,2020,830,1100,1930,38
BUKEDEA,2021,880,1170,2050,38
BUKEDEA,2022,920,1230,2150,38
BUKEDEA,2023,980,1290,2270,38
BUKEDEA,2024,1030,1360,2390,38
BUKEDEA,2025,1090,1450,2540,38
BUKOMANSIMBI,2015,620,630,1250,38
BUKOMANSIMBI,2016,620,640,1260,38
BUKOMANSIMBI,2017,630,660,1290,38
BUKOMANSIMBI,2018,640,670,1310,38
BUKOMANSIMBI,2019,650,690,1340,38
BUKOMANSIMBI,2020,660,700,1360,38
BUKOMANSIMBI,2021,680,720,1400,38
BUKOMANSIMBI,2022,680,730,1410,38
BUKOMANSIMBI,2023,700,740,1440,38
BUKOMANSIMBI,2024,710,760,1470,38
BUKOMANSIMBI,2025,720,770,1490,38
BUKWO,2015,410,390,800,38
BUKWO,2016,430,400,830,38
BUKWO,2017,450,420,870,38
BUKWO,2018,480,440,920,38
BUKWO,2019,500,470,970,38
BUKWO,2020,530,490,1020,38
BUKWO,2021,560,510,1070,38
BUKWO,2022,580,530,1110,38
BUKWO,2023,610,560,1170,38
BUKWO,2024,640,580,1220,38
BUKWO,2025,670,610,1280,38
BULAMBULI,2015,700,710,1410,38
BULAMBULI,2016,730,760,1490,38
BULAMBULI,2017,780,810,1590,38
BULAMBULI,2018,820,870,1690,38
BULAMBULI,2019,880,920,1800,38
BULAMBULI,2020,930,990,1920,38
BULAMBULI,2021,990,1050,2040,38
BULAMBULI,2022,1040,1120,2160,38
BULAMBULI,2023,1100,1190,2290,38
BULAMBULI,2024,1160,1260,2420,38
BULAMBULI,2025,1230,1340,2570,38
BULIISA,2015,450,510,960,38
BULIISA,2016,480,540,1020,38
BULIISA,2017,500,560,1060,38
BULIISA,2018,530,580,1110,38
BULIISA,2019,560,610,1170,38
BULIISA,2020,590,630,1220,38
BULIISA,2021,620,660,1280,38
BULIISA,2022,650,690,1340,38
BULIISA,2023,680,720,1400,38
BULIISA,2024,720,750,1470,38
BULIISA,2025,750,780,1530,38
BUNDIBUGYO,2015,830,970,1800,38
BUNDIBUGYO,2016,850,1010,1860,38
BUNDIBUGYO,2017,890,1060,1950,38
BUNDIBUGYO,2018,930,1110,2040,38
BUNDIBUGYO,2019,970,1160,2130,38
BUNDIBUGYO,2020,1010,1210,2220,38
BUNDIBUGYO,2021,1040,1260,2300,38
BUNDIBUGYO,2022,1080,1310,2390,38
BUNDIBUGYO,2023,1120,1360,2480,38
BUNDIBUGYO,2024,1160,1420,2580,38
BUNDIBUGYO,2025,1210,1480,2690,38
BUNYANGABU,2015,600,720,1320,38
BUNYANGABU,2016,620,750,1370,38
BUNYANGABU,2017,640,780,1420,38
BUNYANGABU,2018,670,820,1490,38
BUNYANGABU,2019,680,840,1520,38
BUNYANGABU,2020,710,880,1590,38
BUNYANGABU,2021,740,920,1660,38
BUNYANGABU,2022,760,950,1710,38
BUNYANGABU,2023,780,990,1770,38
BUNYANGABU,2024,810,1010,1820,38
BUNYANGABU,2025,850,1060,1910,38
BUSHENYI,2015,1060,1320,2380,38
BUSHENYI,2016,1070,1340,2410,38
BUSHENYI,2017,1080,1350,2430,38
BUSHENYI,2018,1100,1360,2460,38
BUSHENYI,2019,1110,1370,2480,38
BUSHENYI,2020,1120,1380,2500,38
BUSHENYI,2021,1130,1390,2520,38
BUSHENYI,2022,1140,1400,2540,38
BUSHENYI,2023,1150,1410,2560,38
BUSHENYI,2024,1160,1420,2580,38
BUSHENYI,2025,1170,1420,2590,38
BUSIA,2015,1220,1440,2660,38
BUSIA,2016,1260,1500,2760,38
BUSIA,2017,1310,1570,2880,38
BUSIA,2018,1370,1650,3020,38
BUSIA,2019,1420,1730,3150,38
BUSIA,2020,1490,1810,3300,38
BUSIA,2021,1540,1880,3420,38
BUSIA,2022,1610,1960,3570,38
BUSIA,2023,1680,2050,3730,38
BUSIA,2024,1740,2130,3870,38
BUSIA,2025,1820,2230,4050,38
BUTALEJA,2015,780,980,1760,38
BUTALEJA,2016,810,1030,1840,38
BUTALEJA,2017,840,1080,1920,38
BUTALEJA,2018,890,1140,2030,38
BUTALEJA,2019,930,1200,2130,38
BUTALEJA,2020,980,1270,2250,38
BUTALEJA,2021,1020,1330,2350,38
BUTALEJA,2022,1070,1400,2470,38
BUTALEJA,2023,1110,1460,2570,38
BUTALEJA,2024,1160,1540,2700,38
BUTALEJA,2025,1220,1610,2830,38
BUTAMBALA,2015,420,440,860,38
BUTAMBALA,2016,430,450,880,38
BUTAMBALA,2017,440,460,900,38
BUTAMBALA,2018,440,470,910,38
BUTAMBALA,2019,460,490,950,38
BUTAMBALA,2020,460,500,960,38
BUTAMBALA,2021,480,510,990,38
BUTAMBALA,2022,490,530,1020,38
BUTAMBALA,2023,500,540,1040,38
BUTAMBALA,2024,520,540,1060,38
BUTAMBALA,2025,520,570,1090,38
BUTEBO,2015,330,420,750,38
BUTEBO,2016,340,440,780,38
BUTEBO,2017,340,440,780,38
BUTEBO,2018,360,460,820,38
BUTEBO,2019,360,470,830,38
BUTEBO,2020,370,490,860,38
BUTEBO,2021,380,500,880,38
BUTEBO,2022,390,520,910,38
BUTEBO,2023,410,520,930,38
BUTEBO,2024,410,540,950,38
BUTEBO,2025,420,560,980,38
BUVUMA,2015,710,540,1250,38
BUVUMA,2016,760,570,1330,38
BUVUMA,2017,800,610,1410,38
BUVUMA,2018,850,650,1500,38
BUVUMA,2019,910,700,1610,38
BUVUMA,2020,960,740,1700,38
BUVUMA,2021,1020,790,1810,38
BUVUMA,2022,1080,840,1920,38
BUVUMA,2023,1140,890,2030,38
BUVUMA,2024,1210,950,2160,38
BUVUMA,2025,1270,1010,2280,38
BUYENDE,2015,1050,1310,2360,38
BUYENDE,2016,1100,1380,2480,38
BUYENDE,2017,1160,1460,2620,38
BUYENDE,2018,1230,1560,2790,38
BUYENDE,2019,1290,1660,2950,38
BUYENDE,2020,1360,1760,3120,38
BUYENDE,2021,1430,1860,3290,38
BUYENDE,2022,1510,1970,3480,38
BUYENDE,2023,1600,2080,3680,38
BUYENDE,2024,1680,2200,3880,38
BUYENDE,2025,1770,2330,4100,38
DOKOLO,2015,690,830,1520,38
DOKOLO,2016,720,850,1570,38
DOKOLO,2017,740,870,1610,38
DOKOLO,2018,760,900,1660,38
DOKOLO,2019,780,920,1700,38
DOKOLO,2020,800,950,1750,38
DOKOLO,2021,830,970,1800,38
DOKOLO,2022,850,990,1840,38
DOKOLO,2023,870,1020,1890,38
DOKOLO,2024,900,1040,1940,38
DOKOLO,2025,920,1070,1990,38
GOMBA,2015,710,690,1400,38
GOMBA,2016,720,710,1430,38
GOMBA,2017,740,730,1470,38
GOMBA,2018,760,740,1500,38
GOMBA,2019,780,770,1550,38
GOMBA,2020,800,790,1590,38
GOMBA,2021,830,810,1640,38
GOMBA,2022,840,840,1680,38
GOMBA,2023,860,850,1710,38
GOMBA,2024,890,870,1760,38
GOMBA,2025,910,890,1800,38
GULU,2015,1260,1350,2610,38
GULU,2016,1300,1390,2690,38
GULU,2017,1340,1430,2770,38
GULU,2018,1380,1470,2850,38
GULU,2019,1420,1510,2930,38
GULU,2020,1460,1560,3020,38
GULU,2021,1500,1600,3100,38
GULU,2022,1540,1640,3180,38
GULU,2023,1580,1680,3260,38
GULU,2024,1620,1730,3350,38
GULU,2025,1660,1770,3430,38
HOIMA,2015,1430,1520,2950,38
HOIMA,2016,1490,1570,3060,38
HOIMA,2017,1540,1630,3170,38
HOIMA,2018,1600,1680,3280,38
HOIMA,2019,1660,1740,3400,38
HOIMA,2020,1720,1800,3520,38
HOIMA,2021,1780,1860,3640,38
HOIMA,2022,1840,1910,3750,38
HOIMA,2023,1900,1980,3880,38
HOIMA,2024,1970,2040,4010,38
HOIMA,2025,2030,2100,4130,38
IBANDA,2015,1110,1350,2460,38
IBANDA,2016,1130,1370,2500,38
IBANDA,2017,1160,1390,2550,38
IBANDA,2018,1180,1420,2600,38
IBANDA,2019,1200,1440,2640,38
IBANDA,2020,1220,1470,2690,38
IBANDA,2021,1240,1490,2730,38
IBANDA,2022,1270,1510,2780,38
IBANDA,2023,1290,1540,2830,38
IBANDA,2024,1300,1560,2860,38
IBANDA,2025,1320,1580,2900,38
IGANGA,2015,1260,1510,2770,38
IGANGA,2016,1300,1580,2880,38
IGANGA,2017,1350,1650,3000,38
IGANGA,2018,1410,1730,3140,38
IGANGA,2019,1470,1820,3290,38
IGANGA,2020,1530,1900,3430,38
IGANGA,2021,1590,1980,3570,38
IGANGA,2022,1660,2070,3730,38
IGANGA,2023,1720,2150,3870,38
IGANGA,2024,1790,2240,4030,38
IGANGA,2025,1870,2340,4210,38
ISINGIRO,2015,2090,2570,4660,38
ISINGIRO,2016,2170,2670,4840,38
ISINGIRO,2017,2250,2760,5010,38
ISINGIRO,2018,2340,2860,5200,38
ISINGIRO,2019,2420,2950,5370,38
ISINGIRO,2020,2510,3050,5560,38
ISINGIRO,2021,2600,3150,5750,38
ISINGIRO,2022,2690,3260,5950,38
ISINGIRO,2023,2780,3360,6140,38
ISINGIRO,2024,2870,3460,6330,38
ISINGIRO,2025,2960,3570,6530,38
JINJA,2015,2130,2380,4510,38
JINJA,2016,2170,2410,4580,38
JINJA,2017,2200,2450,4650,38
JINJA,2018,2240,2490,4730,38
JINJA,2019,2270,2530,4800,38
JINJA,2020,2310,2560,4870,38
JINJA,2021,2340,2590,4930,38
JINJA,2022,2370,2630,5000,38
JINJA,2023,2410,2660,5070,38
JINJA,2024,2440,2690,5130,38
JINJA,2025,2460,2720,5180,38
KAABONG,2015,450,410,860,38
KAABONG,2016,460,420,880,38
KAABONG,2017,470,430,900,38
KAABONG,2018,480,440,920,38
KAABONG,2019,500,450,950,38
KAABONG,2020,510,460,970,38
KAABONG,2021,520,470,990,38
KAABONG,2022,530,480,1010,38
KAABONG,2023,550,490,1040,38
KAABONG,2024,560,500,1060,38
KAABONG,2025,570,510,1080,38
KABALE,2015,970,1330,2300,38
KABALE,2016,990,1350,2340,38
KABALE,2017,1000,1370,2370,38
KABALE,2018,1020,1380,2400,38
KABALE,2019,1030,1400,2430,38
KABALE,2020,1050,1410,2460,38
KABALE,2021,1060,1430,2490,38
KABALE,2022,1080,1440,2520,38
KABALE,2023,1090,1450,2540,38
KABALE,2024,1100,1460,2560,38
KABALE,2025,1110,1470,2580,38
KABAROLE,2015,1550,1380,2930,38
KABAROLE,2016,1580,1410,2990,38
KABAROLE,2017,1620,1440,3060,38
KABAROLE,2018,1650,1470,3120,38
KABAROLE,2019,1690,1500,3190,38
KABAROLE,2020,1720,1530,3250,38
KABAROLE,2021,1760,1560,3320,38
KABAROLE,2022,1790,1590,3380,38
KABAROLE,2023,1820,1620,3440,38
KABAROLE,2024,1850,1650,3500,38
KABAROLE,2025,1890,1670,3560,38
KABERAMAIDO,2015,370,420,790,38
KABERAMAIDO,2016,390,440,830,38
KABERAMAIDO,2017,400,460,860,38
KABERAMAIDO,2018,430,490,920,38
KABERAMAIDO,2019,450,520,970,38
KABERAMAIDO,2020,470,550,1020,38
KABERAMAIDO,2021,500,580,1080,38
KABERAMAIDO,2022,520,620,1140,38
KABERAMAIDO,2023,550,650,1200,38
KABERAMAIDO,2024,580,680,1260,38
KABERAMAIDO,2025,620,720,1340,38
KAGADI,2015,1410,1620,3030,38
KAGADI,2016,1460,1680,3140,38
KAGADI,2017,1520,1740,3260,38
KAGADI,2018,1570,1800,3370,38
KAGADI,2019,1630,1860,3490,38
KAGADI,2020,1690,1930,3620,38
KAGADI,2021,1750,1990,3740,38
KAGADI,2022,1810,2060,3870,38
KAGADI,2023,1870,2120,3990,38
KAGADI,2024,1930,2190,4120,38
KAGADI,2025,1990,2260,4250,38
KAKUMIRO,2015,1400,1410,2810,38
KAKUMIRO,2016,1530,1530,3060,38
KAKUMIRO,2017,1660,1660,3320,38
KAKUMIRO,2018,1810,1800,3610,38
KAKUMIRO,2019,1970,1950,3920,38
KAKUMIRO,2020,2140,2110,4250,38
KAKUMIRO,2021,2330,2280,4610,38
KAKUMIRO,2022,2520,2460,4980,38
KAKUMIRO,2023,2740,2660,5400,38
KAKUMIRO,2024,2970,2880,5850,38
KAKUMIRO,2025,3210,3100,6310,38
KALAKI,2015,360,460,820,38
KALAKI,2016,380,480,860,38
KALAKI,2017,390,500,890,38
KALAKI,2018,410,510,920,38
KALAKI,2019,430,530,960,38
KALAKI,2020,450,560,1010,38
KALAKI,2021,460,580,1040,38
KALAKI,2022,480,600,1080,38
KALAKI,2023,500,620,1120,38
KALAKI,2024,520,640,1160,38
KALAKI,2025,540,660,1200,38
KALANGALA,2015,620,310,930,38
KALANGALA,2016,650,320,970,38
KALANGALA,2017,670,330,1000,38
KALANGALA,2018,690,350,1040,38
KALANGALA,2019,720,360,1080,38
KALANGALA,2020,740,380,1120,38
KALANGALA,2021,760,390,1150,38
KALANGALA,2022,790,410,1200,38
KALANGALA,2023,820,420,1240,38
KALANGALA,2024,840,440,1280,38
KALANGALA,2025,870,450,1320,38
KALIRO,2015,770,1050,1820,38
KALIRO,2016,800,1100,1900,38
KALIRO,2017,830,1160,1990,38
KALIRO,2018,880,1220,2100,38
KALIRO,2019,920,1290,2210,38
KALIRO,2020,960,1360,2320,38
KALIRO,2021,1000,1420,2420,38
KALIRO,2022,1050,1490,2540,38
KALIRO,2023,1090,1560,2650,38
KALIRO,2024,1140,1640,2780,38
KALIRO,2025,1190,1720,2910,38
KALUNGU,2015,710,890,1600,38
KALUNGU,2016,720,910,1630,38
KALUNGU,2017,740,940,1680,38
KALUNGU,2018,750,960,1710,38
KALUNGU,2019,770,990,1760,38
KALUNGU,2020,780,1020,1800,38
KALUNGU,2021,800,1040,1840,38
KALUNGU,2022,810,1060,1870,38
KALUNGU,2023,830,1090,1920,38
KALUNGU,2024,850,1110,1960,38
KALUNGU,2025,870,1140,2010,38
KAMPALA,2015,8450,8730,17180,38
KAMPALA,2016,8620,8900,17520,38
KAMPALA,2017,8790,9070,17860,38
KAMPALA,2018,8960,9240,18200,38
KAMPALA,2019,9130,9420,18550,38
KAMPALA,2020,9300,9580,18880,38
KAMPALA,2021,9460,9750,19210,38
KAMPALA,2022,9620,9910,19530,38
KAMPALA,2023,9770,10070,19840,38
KAMPALA,2024,9920,10230,20150,38
KAMPALA,2025,10070,10380,20450,38
KAMULI,2015,1740,2020,3760,38
KAMULI,2016,1780,2100,3880,38
KAMULI,2017,1850,2180,4030,38
KAMULI,2018,1920,2270,4190,38
KAMULI,2019,1990,2380,4370,38
KAMULI,2020,2060,2470,4530,38
KAMULI,2021,2130,2560,4690,38
KAMULI,2022,2200,2660,4860,38
KAMULI,2023,2280,2750,5030,38
KAMULI,2024,2360,2850,5210,38
KAMULI,2025,2440,2950,5390,38
KAMWENGE,2015,1130,1320,2450,38
KAMWENGE,2016,1180,1370,2550,38
KAMWENGE,2017,1220,1420,2640,38
KAMWENGE,2018,1270,1470,2740,38
KAMWENGE,2019,1320,1520,2840,38
KAMWENGE,2020,1370,1570,2940,38
KAMWENGE,2021,1430,1620,3050,38
KAMWENGE,2022,1480,1670,3150,38
KAMWENGE,2023,1540,1730,3270,38
KAMWENGE,2024,1590,1780,3370,38
KAMWENGE,2025,1650,1840,3490,38
KANUNGU,2015,1060,1350,2410,38
KANUNGU,2016,1080,1370,2450,38
KANUNGU,2017,1100,1400,2500,38
KANUNGU,2018,1120,1420,2540,38
KANUNGU,2019,1140,1440,2580,38
KANUNGU,2020,1160,1460,2620,38
KANUNGU,2021,1170,1480,2650,38
KANUNGU,2022,1190,1500,2690,38
KANUNGU,2023,1210,1520,2730,38
KANUNGU,2024,1230,1540,2770,38
KANUNGU,2025,1240,1560,2800,38
KAPCHORWA,2015,460,500,960,38
KAPCHORWA,2016,480,520,1000,38
KAPCHORWA,2017,490,530,1020,38
KAPCHORWA,2018,510,540,1050,38
KAPCHORWA,2019,520,560,1080,38
KAPCHORWA,2020,540,570,1110,38
KAPCHORWA,2021,550,590,1140,38
KAPCHORWA,2022,570,600,1170,38
KAPCHORWA,2023,580,620,1200,38
KAPCHORWA,2024,600,630,1230,38
KAPCHORWA,2025,620,650,1270,38
KAPELEBYONG,2015,310,380,690,38
KAPELEBYONG,2016,320,400,720,38
KAPELEBYONG,2017,330,420,750,38
KAPELEBYONG,2018,350,430,780,38
KAPELEBYONG,2019,370,450,820,38
KAPELEBYONG,2020,380,470,850,38
KAPELEBYONG,2021,400,500,900,38
KAPELEBYONG,2022,410,520,930,38
KAPELEBYONG,2023,430,540,970,38
KAPELEBYONG,2024,450,550,1000,38
KAPELEBYONG,2025,470,580,1050,38
KASESE,2015,2780,3270,6050,38
KASESE,2016,2850,3380,6230,38
KASESE,2017,2950,3510,6460,38
KASESE,2018,3040,3670,6710,38
KASESE,2019,3150,3810,6960,38
KASESE,2020,3260,3960,7220,38
KASESE,2021,3370,4110,7480,38
KASESE,2022,3480,4260,7740,38
KASESE,2023,3600,4410,8010,38
KASESE,2024,3720,4550,8270,38
KASESE,2025,3840,4740,8580,38
KASSANDA,2015,1330,1290,2620,38
KASSANDA,2016,1370,1320,2690,38
KASSANDA,2017,1410,1350,2760,38
KASSANDA,2018,1450,1370,2820,38
KASSANDA,2019,1490,1400,2890,38
KASSANDA,2020,1530,1430,2960,38
KASSANDA,2021,1570,1460,3030,38
KASSANDA,2022,1610,1490,3100,38
KASSANDA,2023,1650,1510,3160,38
KASSANDA,2024,1690,1540,3230,38
KASSANDA,2025,1730,1560,3290,38
KATAKWI,2015,580,680,1260,38
KATAKWI,2016,590,700,1290,38
KATAKWI,2017,610,730,1340,38
KATAKWI,2018,640,760,1400,38
KATAKWI,2019,660,800,1460,38
KATAKWI,2020,690,830,1520,38
KATAKWI,2021,720,860,1580,38
KATAKWI,2022,740,900,1640,38
KATAKWI,2023,770,930,1700,38
KATAKWI,2024,800,970,1770,38
KATAKWI,2025,830,1010,1840,38
KAYUNGA,2015,1390,1620,3010,38
KAYUNGA,2016,1410,1670,3080,38
KAYUNGA,2017,1450,1730,3180,38
KAYUNGA,2018,1500,1790,3290,38
KAYUNGA,2019,1540,1860,3400,38
KAYUNGA,2020,1590,1910,3500,38
KAYUNGA,2021,1630,1970,3600,38
KAYUNGA,2022,1680,2040,3720,38
KAYUNGA,2023,1720,2090,3810,38
KAYUNGA,2024,1770,2150,3920,38
KAYUNGA,2025,1830,2220,4050,38
KAZO,2015,750,980,1730,38
KAZO,2016,770,1010,1780,38
KAZO,2017,800,1050,1850,38
KAZO,2018,830,1090,1920,38
KAZO,2019,870,1130,2000,38
KAZO,2020,900,1160,2060,38
KAZO,2021,930,1200,2130,38
KAZO,2022,960,1240,2200,38
KAZO,2023,990,1280,2270,38
KAZO,2024,1030,1320,2350,38
KAZO,2025,1060,1360,2420,38
KIBAALE,2015,620,640,1260,38
KIBAALE,2016,670,680,1350,38
KIBAALE,2017,710,720,1430,38
KIBAALE,2018,750,760,1510,38
KIBAALE,2019,800,800,1600,38
KIBAALE,2020,850,850,1700,38
KIBAALE,2021,900,900,1800,38
KIBAALE,2022,960,940,1900,38
KIBAALE,2023,1010,1000,2010,38
KIBAALE,2024,1070,1050,2120,38
KIBAALE,2025,1130,1110,2240,38
KIBOGA,2015,720,630,1350,38
KIBOGA,2016,730,640,1370,38
KIBOGA,2017,760,660,1420,38
KIBOGA,2018,780,700,1480,38
KIBOGA,2019,810,720,1530,38
KIBOGA,2020,840,750,1590,38
KIBOGA,2021,870,790,1660,38
KIBOGA,2022,910,820,1730,38
KIBOGA,2023,930,850,1780,38
KIBOGA,2024,960,880,1840,38
KIBOGA,2025,1000,910,1910,38
KIBUKU,2015,620,810,1430,38
KIBUKU,2016,640,840,1480,38
KIBUKU,2017,670,890,1560,38
KIBUKU,2018,710,940,1650,38
KIBUKU,2019,740,990,1730,38
KIBUKU,2020,780,1050,1830,38
KIBUKU,2021,810,1100,1910,38
KIBUKU,2022,850,1160,2010,38
KIBUKU,2023,900,1220,2120,38
KIBUKU,2024,940,1280,2220,38
KIBUKU,2025,980,1350,2330,38
KIKUUBE,2015,1310,1320,2630,38
KIKUUBE,2016,1380,1390,2770,38
KIKUUBE,2017,1450,1460,2910,38
KIKUUBE,2018,1530,1530,3060,38
KIKUUBE,2019,1610,1610,3220,38
KIKUUBE,2020,1690,1690,3380,38
KIKUUBE,2021,1780,1770,3550,38
KIKUUBE,2022,1870,1860,3730,38
KIKUUBE,2023,1960,1940,3900,38
KIKUUBE,2024,2050,2040,4090,38
KIKUUBE,2025,2150,2130,4280,38
KIRUHURA,2015,860,810,1670,38
KIRUHURA,2016,890,840,1730,38
KIRUHURA,2017,930,870,1800,38
KIRUHURA,2018,960,900,1860,38
KIRUHURA,2019,1000,930,1930,38
KIRUHURA,2020,1040,970,2010,38
KIRUHURA,2021,1070,1000,2070,38
KIRUHURA,2022,1110,1030,2140,38
KIRUHURA,2023,1150,1060,2210,38
KIRUHURA,2024,1190,1100,2290,38
KIRUHURA,2025,1220,1130,2350,38
KIRYANDONGO,2015,1010,1140,2150,38
KIRYANDONGO,2016,1030,1180,2210,38
KIRYANDONGO,2017,1070,1240,2310,38
KIRYANDONGO,2018,1120,1290,2410,38
KIRYANDONGO,2019,1160,1350,2510,38
KIRYANDONGO,2020,1210,1410,2620,38
KIRYANDONGO,2021,1260,1470,2730,38
KIRYANDONGO,2022,1310,1530,2840,38
KIRYANDONGO,2023,1360,1590,2950,38
KIRYANDONGO,2024,1410,1650,3060,38
KIRYANDONGO,2025,1470,1730,3200,38
KISORO,2015,820,1330,2150,38
KISORO,2016,840,1370,2210,38
KISORO,2017,850,1430,2280,38
KISORO,2018,880,1480,2360,38
KISORO,2019,910,1540,2450,38
KISORO,2020,940,1600,2540,38
KISORO,2021,970,1660,2630,38
KISORO,2022,980,1710,2690,38
KISORO,2023,1020,1760,2780,38
KISORO,2024,1050,1820,2870,38
KISORO,2025,1080,1880,2960,38
KITAGWENDA,2015,620,790,1410,38
KITAGWENDA,2016,650,820,1470,38
KITAGWENDA,2017,680,850,1530,38
KITAGWENDA,2018,700,880,1580,38
KITAGWENDA,2019,730,910,1640,38
KITAGWENDA,2020,760,940,1700,38
KITAGWENDA,2021,790,970,1760,38
KITAGWENDA,2022,820,1010,1830,38
KITAGWENDA,2023,850,1040,1890,38
KITAGWENDA,2024,880,1070,1950,38
KITAGWENDA,2025,910,1100,2010,38
KITGUM,2015,730,900,1630,38
KITGUM,2016,750,920,1670,38
KITGUM,2017,770,950,1720,38
KITGUM,2018,790,980,1770,38
KITGUM,2019,810,1020,1830,38
KITGUM,2020,830,1050,1880,38
KITGUM,2021,850,1090,1940,38
KITGUM,2022,870,1120,1990,38
KITGUM,2023,900,1140,2040,38
KITGUM,2024,920,1180,2100,38
KITGUM,2025,940,1220,2160,38
KOBOKO,2015,830,1000,1830,38
KOBOKO,2016,860,1050,1910,38
KOBOKO,2017,900,1110,2010,38
KOBOKO,2018,950,1180,2130,38
KOBOKO,2019,1000,1240,2240,38
KOBOKO,2020,1040,1310,2350,38
KOBOKO,2021,1100,1380,2480,38
KOBOKO,2022,1160,1460,2620,38
KOBOKO,2023,1210,1530,2740,38
KOBOKO,2024,1270,1610,2880,38
KOBOKO,2025,1330,1700,3030,38
KOLE,2015,890,1030,1920,38
KOLE,2016,920,1060,1980,38
KOLE,2017,950,1090,2040,38
KOLE,2018,990,1120,2110,38
KOLE,2019,1020,1160,2180,38
KOLE,2020,1050,1190,2240,38
KOLE,2021,1080,1220,2300,38
KOLE,2022,1110,1250,2360,38
KOLE,2023,1140,1280,2420,38
KOLE,2024,1180,1320,2500,38
KOLE,2025,1210,1350,2560,38
KOTIDO,2015,630,830,1460,38
KOTIDO,2016,640,860,1500,38
KOTIDO,2017,660,900,1560,38
KOTIDO,2018,690,930,1620,38
KOTIDO,2019,700,970,1670,38
KOTIDO,2020,730,1010,1740,38
KOTIDO,2021,760,1050,1810,38
KOTIDO,2022,780,1090,1870,38
KOTIDO,2023,800,1120,1920,38
KOTIDO,2024,840,1160,2000,38
KOTIDO,2025,870,1210,2080,38
KUMI,2015,820,1010,1830,38
KUMI,2016,840,1050,1890,38
KUMI,2017,880,1110,1990,38
KUMI,2018,920,1160,2080,38
KUMI,2019,960,1210,2170,38
KUMI,2020,1000,1270,2270,38
KUMI,2021,1040,1320,2360,38
KUMI,2022,1080,1390,2470,38
KUMI,2023,1120,1440,2560,38
KUMI,2024,1180,1490,2670,38
KUMI,2025,1220,1570,2790,38
KWANIA,2015,720,790,1510,38
KWANIA,2016,740,820,1560,38
KWANIA,2017,760,840,1600,38
KWANIA,2018,790,870,1660,38
KWANIA,2019,810,890,1700,38
KWANIA,2020,830,910,1740,38
KWANIA,2021,860,940,1800,38
KWANIA,2022,880,960,1840,38
KWANIA,2023,910,990,1900,38
KWANIA,2024,930,1010,1940,38
KWANIA,2025,950,1030,1980,38
KWEEN,2015,390,430,820,38
KWEEN,2016,400,440,840,38
KWEEN,2017,410,460,870,38
KWEEN,2018,420,470,890,38
KWEEN,2019,440,480,920,38
KWEEN,2020,450,490,940,38
KWEEN,2021,460,500,960,38
KWEEN,2022,480,510,990,38
KWEEN,2023,490,520,1010,38
KWEEN,2024,500,530,1030,38
KWEEN,2025,510,540,1050,38
KYANKWANZI,2015,1050,950,2000,38
KYANKWANZI,2016,1100,990,2090,38
KYANKWANZI,2017,1160,1040,2200,38
KYANKWANZI,2018,1220,1090,2310,38
KYANKWANZI,2019,1280,1140,2420,38
KYANKWANZI,2020,1340,1190,2530,38
KYANKWANZI,2021,1410,1240,2650,38
KYANKWANZI,2022,1470,1290,2760,38
KYANKWANZI,2023,1540,1350,2890,38
KYANKWANZI,2024,1620,1410,3030,38
KYANKWANZI,2025,1690,1470,3160,38
KYEGEGWA,2015,1310,1310,2620,38
KYEGEGWA,2016,1420,1410,2830,38
KYEGEGWA,2017,1540,1530,3070,38
KYEGEGWA,2018,1670,1640,3310,38
KYEGEGWA,2019,1800,1770,3570,38
KYEGEGWA,2020,1940,1910,3850,38
KYEGEGWA,2021,2100,2060,4160,38
KYEGEGWA,2022,2270,2210,4480,38
KYEGEGWA,2023,2440,2380,4820,38
KYEGEGWA,2024,2630,2560,5190,38
KYEGEGWA,2025,2830,2750,5580,38
KYENJOJO,2015,1730,1950,3680,38
KYENJOJO,2016,1800,2030,3830,38
KYENJOJO,2017,1870,2100,3970,38
KYENJOJO,2018,1950,2180,4130,38
KYENJOJO,2019,2030,2260,4290,38
KYENJOJO,2020,2110,2340,4450,38
KYENJOJO,2021,2190,2420,4610,38
KYENJOJO,2022,2270,2500,4770,38
KYENJOJO,2023,2360,2580,4940,38
KYENJOJO,2024,2440,2670,5110,38
KYENJOJO,2025,2530,2750,5280,38
KYOTERA,2015,1210,1200,2410,38
KYOTERA,2016,1230,1230,2460,38
KYOTERA,2017,1260,1280,2540,38
KYOTERA,2018,1300,1320,2620,38
KYOTERA,2019,1340,1360,2700,38
KYOTERA,2020,1370,1400,2770,38
KYOTERA,2021,1400,1440,2840,38
KYOTERA,2022,1440,1480,2920,38
KYOTERA,2023,1470,1520,2990,38
KYOTERA,2024,1520,1560,3080,38
KYOTERA,2025,1560,1610,3170,38
KARENGA,2015,230,250,480,38
KARENGA,2016,240,260,500,38
KARENGA,2017,240,270,510,38
KARENGA,2018,250,270,520,38
KARENGA,2019,260,280,540,38
KARENGA,2020,260,290,550,38
KARENGA,2021,270,290,560,38
KARENGA,2022,280,300,580,38
KARENGA,2023,280,300,580,38
KARENGA,2024,290,310,600,38
KARENGA,2025,300,320,620,38
LAMWO,2015,480,600,1080,38
LAMWO,2016,490,620,1110,38
LAMWO,2017,500,640,1140,38
LAMWO,2018,510,660,1170,38
LAMWO,2019,530,690,1220,38
LAMWO,2020,530,710,1240,38
LAMWO,2021,540,730,1270,38
LAMWO,2022,550,750,1300,38
LAMWO,2023,560,770,1330,38
LAMWO,2024,580,790,1370,38
LAMWO,2025,580,820,1400,38
LIRA,2015,1750,2020,3770,38
LIRA,2016,1810,2070,3880,38
LIRA,2017,1860,2130,3990,38
LIRA,2018,1910,2190,4100,38
LIRA,2019,1960,2250,4210,38
LIRA,2020,2010,2320,4330,38
LIRA,2021,2060,2380,4440,38
LIRA,2022,2120,2440,4560,38
LIRA,2023,2170,2500,4670,38
LIRA,2024,2220,2560,4780,38
LIRA,2025,2270,2620,4890,38
LUUKA,2015,820,1070,1890,38
LUUKA,2016,840,1110,1950,38
LUUKA,2017,860,1150,2010,38
LUUKA,2018,890,1190,2080,38
LUUKA,2019,920,1250,2170,38
LUUKA,2020,940,1290,2230,38
LUUKA,2021,970,1330,2300,38
LUUKA,2022,1000,1380,2380,38
LUUKA,2023,1030,1430,2460,38
LUUKA,2024,1060,1470,2530,38
LUUKA,2025,1090,1520,2610,38
LUWERO,2015,2070,2120,4190,38
LUWERO,2016,2130,2190,4320,38
LUWERO,2017,2190,2280,4470,38
LUWERO,2018,2270,2380,4650,38
LUWERO,2019,2350,2470,4820,38
LUWERO,2020,2430,2570,5000,38
LUWERO,2021,2520,2670,5190,38
LUWERO,2022,2600,2770,5370,38
LUWERO,2023,2700,2860,5560,38
LUWERO,2024,2790,2960,5750,38
LUWERO,2025,2880,3080,5960,38
LWENGO,2015,1130,1370,2500,38
LWENGO,2016,1140,1410,2550,38
LWENGO,2017,1170,1450,2620,38
LWENGO,2018,1190,1490,2680,38
LWENGO,2019,1210,1530,2740,38
LWENGO,2020,1240,1570,2810,38
LWENGO,2021,1260,1610,2870,38
LWENGO,2022,1290,1640,2930,38
LWENGO,2023,1310,1680,2990,38
LWENGO,2024,1340,1720,3060,38
LWENGO,2025,1360,1760,3120,38
LYANTONDE,2015,410,420,830,38
LYANTONDE,2016,420,430,850,38
LYANTONDE,2017,430,450,880,38
LYANTONDE,2018,450,470,920,38
LYANTONDE,2019,460,490,950,38
LYANTONDE,2020,480,520,1000,38
LYANTONDE,2021,500,540,1040,38
LYANTONDE,2022,520,570,1090,38
LYANTONDE,2023,540,590,1130,38
LYANTONDE,2024,560,610,1170,38
LYANTONDE,2025,580,630,1210,38
MANAFWA,2015,650,740,1390,38
MANAFWA,2016,670,750,1420,38
MANAFWA,2017,690,770,1460,38
MANAFWA,2018,700,790,1490,38
MANAFWA,2019,720,800,1520,38
MANAFWA,2020,740,820,1560,38
MANAFWA,2021,750,840,1590,38
MANAFWA,2022,770,850,1620,38
MANAFWA,2023,790,870,1660,38
MANAFWA,2024,800,890,1690,38
MANAFWA,2025,820,900,1720,38
MARACHA,2015,640,1150,1790,38
MARACHA,2016,660,1170,1830,38
MARACHA,2017,670,1190,1860,38
MARACHA,2018,680,1220,1900,38
MARACHA,2019,700,1240,1940,38
MARACHA,2020,710,1260,1970,38
MARACHA,2021,720,1280,2000,38
MARACHA,2022,740,1300,2040,38
MARACHA,2023,750,1330,2080,38
MARACHA,2024,760,1350,2110,38
MARACHA,2025,780,1370,2150,38
MASAKA,2015,1550,1520,3070,38
MASAKA,2016,1590,1580,3170,38
MASAKA,2017,1640,1630,3270,38
MASAKA,2018,1690,1710,3400,38
MASAKA,2019,1750,1770,3520,38
MASAKA,2020,1800,1840,3640,38
MASAKA,2021,1860,1900,3760,38
MASAKA,2022,1910,1960,3870,38
MASAKA,2023,1970,2030,4000,38
MASAKA,2024,2040,2100,4140,38
MASAKA,2025,2100,2180,4280,38
MASINDI,2015,1400,1510,2910,38
MASINDI,2016,1440,1550,2990,38
MASINDI,2017,1480,1590,3070,38
MASINDI,2018,1520,1640,3160,38
MASINDI,2019,1560,1680,3240,38
MASINDI,2020,1610,1720,3330,38
MASINDI,2021,1650,1760,3410,38
MASINDI,2022,1690,1800,3490,38
MASINDI,2023,1740,1850,3590,38
MASINDI,2024,1780,1890,3670,38
MASINDI,2025,1820,1930,3750,38
MAYUGE,2015,1620,2130,3750,38
MAYUGE,2016,1670,2230,3900,38
MAYUGE,2017,1740,2340,4080,38
MAYUGE,2018,1820,2460,4280,38
MAYUGE,2019,1890,2580,4470,38
MAYUGE,2020,1970,2700,4670,38
MAYUGE,2021,2050,2830,4880,38
MAYUGE,2022,2130,2960,5090,38
MAYUGE,2023,2220,3080,5300,38
MAYUGE,2024,2310,3210,5520,38
MAYUGE,2025,2400,3360,5760,38
MBALE,2015,2020,2200,4220,38
MBALE,2016,2090,2300,4390,38
MBALE,2017,2160,2420,4580,38
MBALE,2018,2250,2550,4800,38
MBALE,2019,2350,2680,5030,38
MBALE,2020,2440,2820,5260,38
MBALE,2021,2540,2960,5500,38
MBALE,2022,2630,3090,5720,38
MBALE,2023,2750,3230,5980,38
MBALE,2024,2860,3380,6240,38
MBALE,2025,2960,3550,6510,38
MBARARA,2015,1730,1900,3630,38
MBARARA,2016,1780,1950,3730,38
MBARARA,2017,1820,1990,3810,38
MBARARA,2018,1860,2030,3890,38
MBARARA,2019,1900,2070,3970,38
MBARARA,2020,1940,2110,4050,38
MBARARA,2021,1980,2150,4130,38
MBARARA,2022,2020,2200,4220,38
MBARARA,2023,2060,2240,4300,38
MBARARA,2024,2100,2270,4370,38
MBARARA,2025,2130,2310,4440,38
MITOOMA,2015,660,990,1650,38
MITOOMA,2016,670,1000,1670,38
MITOOMA,2017,680,1010,1690,38
MITOOMA,2018,680,1020,1700,38
MITOOMA,2019,690,1030,1720,38
MITOOMA,2020,700,1040,1740,38
MITOOMA,2021,700,1040,1740,38
MITOOMA,2022,710,1050,1760,38
MITOOMA,2023,720,1060,1780,38
MITOOMA,2024,720,1060,1780,38
MITOOMA,2025,730,1070,1800,38
MITYANA,2015,1470,1520,2990,38
MITYANA,2016,1500,1570,3070,38
MITYANA,2017,1540,1620,3160,38
MITYANA,2018,1580,1680,3260,38
MITYANA,2019,1630,1730,3360,38
MITYANA,2020,1680,1790,3470,38
MITYANA,2021,1720,1840,3560,38
MITYANA,2022,1760,1900,3660,38
MITYANA,2023,1810,1950,3760,38
MITYANA,2024,1870,2000,3870,38
MITYANA,2025,1910,2070,3980,38
MOROTO,2015,360,380,740,38
MOROTO,2016,360,400,760,38
MOROTO,2017,370,430,800,38
MOROTO,2018,390,440,830,38
MOROTO,2019,400,460,860,38
MOROTO,2020,410,480,890,38
MOROTO,2021,430,500,930,38
MOROTO,2022,440,520,960,38
MOROTO,2023,460,540,1000,38
MOROTO,2024,460,550,1010,38
MOROTO,2025,480,580,1060,38
MOYO,2015,420,530,950,38
MOYO,2016,430,540,970,38
MOYO,2017,450,550,1000,38
MOYO,2018,460,570,1030,38
MOYO,2019,470,580,1050,38
MOYO,2020,480,590,1070,38
MOYO,2021,490,600,1090,38
MOYO,2022,500,610,1110,38
MOYO,2023,510,620,1130,38
MOYO,2024,520,640,1160,38
MOYO,2025,530,650,1180,38
MPIGI,2015,1180,1150,2330,38
MPIGI,2016,1210,1190,2400,38
MPIGI,2017,1240,1230,2470,38
MPIGI,2018,1290,1280,2570,38
MPIGI,2019,1340,1340,2680,38
MPIGI,2020,1380,1390,2770,38
MPIGI,2021,1420,1440,2860,38
MPIGI,2022,1470,1500,2970,38
MPIGI,2023,1530,1550,3080,38
MPIGI,2024,1580,1610,3190,38
MPIGI,2025,1630,1670,3300,38
MUBENDE,2015,1770,1790,3560,38
MUBENDE,2016,1880,1900,3780,38
MUBENDE,2017,1990,2030,4020,38
MUBENDE,2018,2130,2180,4310,38
MUBENDE,2019,2250,2340,4590,38
MUBENDE,2020,2400,2500,4900,38
MUBENDE,2021,2550,2660,5210,38
MUBENDE,2022,2700,2840,5540,38
MUBENDE,2023,2880,3020,5900,38
MUBENDE,2024,3060,3210,6270,38
MUBENDE,2025,3250,3430,6680,38
MUKONO,2015,2690,2840,5530,38
MUKONO,2016,2770,2960,5730,38
MUKONO,2017,2870,3110,5980,38
MUKONO,2018,2990,3260,6250,38
MUKONO,2019,3090,3420,6510,38
MUKONO,2020,3210,3570,6780,38
MUKONO,2021,3330,3730,7060,38
MUKONO,2022,3450,3900,7350,38
MUKONO,2023,3570,4050,7620,38
MUKONO,2024,3700,4220,7920,38
MUKONO,2025,3830,4420,8250,38
MADI OKOLLO,2015,590,940,1530,38
MADI OKOLLO,2016,600,970,1570,38
MADI OKOLLO,2017,620,990,1610,38
MADI OKOLLO,2018,640,1020,1660,38
MADI OKOLLO,2019,660,1050,1710,38
MADI OKOLLO,2020,680,1070,1750,38
MADI OKOLLO,2021,690,1100,1790,38
MADI OKOLLO,2022,710,1130,1840,38
MADI OKOLLO,2023,730,1150,1880,38
MADI OKOLLO,2024,750,1180,1930,38
MADI OKOLLO,2025,770,1210,1980,38
NABILATUK,2015,220,220,440,38
NABILATUK,2016,230,230,460,38
NABILATUK,2017,240,250,490,38
NABILATUK,2018,250,260,510,38
NABILATUK,2019,270,270,540,38
NABILATUK,2020,290,300,590,38
NABILATUK,2021,310,320,630,38
NABILATUK,2022,320,330,650,38
NABILATUK,2023,350,360,710,38
NABILATUK,2024,360,370,730,38
NABILATUK,2025,390,390,780,38
NAKAPIRIPIRIT,2015,280,280,560,38
NAKAPIRIPIRIT,2016,280,300,580,38
NAKAPIRIPIRIT,2017,300,320,620,38
NAKAPIRIPIRIT,2018,320,340,660,38
NAKAPIRIPIRIT,2019,330,360,690,38
NAKAPIRIPIRIT,2020,350,380,730,38
NAKAPIRIPIRIT,2021,370,410,780,38
NAKAPIRIPIRIT,2022,390,430,820,38
NAKAPIRIPIRIT,2023,410,450,860,38
NAKAPIRIPIRIT,2024,430,480,910,38
NAKAPIRIPIRIT,2025,460,510,970,38
NAKASEKE,2015,1250,990,2240,38
NAKASEKE,2016,1300,1010,2310,38
NAKASEKE,2017,1340,1040,2380,38
NAKASEKE,2018,1390,1060,2450,38
NAKASEKE,2019,1440,1080,2520,38
NAKASEKE,2020,1490,1110,2600,38
NAKASEKE,2021,1540,1130,2670,38
NAKASEKE,2022,1590,1160,2750,38
NAKASEKE,2023,1650,1180,2830,38
NAKASEKE,2024,1700,1200,2900,38
NAKASEKE,2025,1750,1230,2980,38
NAKASONGOLA,2015,800,770,1570,38
NAKASONGOLA,2016,830,800,1630,38
NAKASONGOLA,2017,860,830,1690,38
NAKASONGOLA,2018,900,880,1780,38
NAKASONGOLA,2019,940,910,1850,38
NAKASONGOLA,2020,980,950,1930,38
NAKASONGOLA,2021,1020,1000,2020,38
NAKASONGOLA,2022,1060,1030,2090,38
NAKASONGOLA,2023,1100,1080,2180,38
NAKASONGOLA,2024,1140,1120,2260,38
NAKASONGOLA,2025,1200,1170,2370,38
NAMAYINGO,2015,910,940,1850,38
NAMAYINGO,2016,930,970,1900,38
NAMAYINGO,2017,960,1000,1960,38
NAMAYINGO,2018,980,1030,2010,38
NAMAYINGO,2019,1000,1070,2070,38
NAMAYINGO,2020,1030,1100,2130,38
NAMAYINGO,2021,1070,1140,2210,38
NAMAYINGO,2022,1100,1170,2270,38
NAMAYINGO,2023,1130,1200,2330,38
NAMAYINGO,2024,1150,1230,2380,38
NAMAYINGO,2025,1190,1270,2460,38
NAMISINDWA,2015,820,870,1690,38
NAMISINDWA,2016,840,890,1730,38
NAMISINDWA,2017,870,910,1780,38
NAMISINDWA,2018,890,930,1820,38
NAMISINDWA,2019,910,960,1870,38
NAMISINDWA,2020,940,980,1920,38
NAMISINDWA,2021,960,1000,1960,38
NAMISINDWA,2022,990,1020,2010,38
NAMISINDWA,2023,1010,1040,2050,38
NAMISINDWA,2024,1030,1060,2090,38
NAMISINDWA,2025,1060,1080,2140,38
NAMUTUMBA,2015,810,1070,1880,38
NAMUTUMBA,2016,840,1120,1960,38
NAMUTUMBA,2017,870,1180,2050,38
NAMUTUMBA,2018,910,1240,2150,38
NAMUTUMBA,2019,960,1310,2270,38
NAMUTUMBA,2020,1000,1370,2370,38
NAMUTUMBA,2021,1040,1440,2480,38
NAMUTUMBA,2022,1090,1510,2600,38
NAMUTUMBA,2023,1130,1570,2700,38
NAMUTUMBA,2024,1190,1640,2830,38
NAMUTUMBA,2025,1230,1730,2960,38
NAPAK,2015,360,520,880,38
NAPAK,2016,370,540,910,38
NAPAK,2017,370,560,930,38
NAPAK,2018,390,590,980,38
NAPAK,2019,400,610,1010,38
NAPAK,2020,400,630,1030,38
NAPAK,2021,420,650,1070,38
NAPAK,2022,430,670,1100,38
NAPAK,2023,440,700,1140,38
NAPAK,2024,450,720,1170,38
NAPAK,2025,460,750,1210,38
NEBBI,2015,810,1130,1940,38
NEBBI,2016,830,1170,2000,38
NEBBI,2017,860,1200,2060,38
NEBBI,2018,890,1230,2120,38
NEBBI,2019,910,1270,2180,38
NEBBI,2020,940,1300,2240,38
NEBBI,2021,970,1340,2310,38
NEBBI,2022,1000,1370,2370,38
NEBBI,2023,1030,1400,2430,38
NEBBI,2024,1050,1440,2490,38
NEBBI,2025,1080,1470,2550,38
NGORA,2015,500,590,1090,38
NGORA,2016,510,610,1120,38
NGORA,2017,540,630,1170,38
NGORA,2018,560,660,1220,38
NGORA,2019,580,700,1280,38
NGORA,2020,600,730,1330,38
NGORA,2021,630,750,1380,38
NGORA,2022,640,790,1430,38
NGORA,2023,670,820,1490,38
NGORA,2024,700,840,1540,38
NGORA,2025,720,880,1600,38
NTOROKO,2015,320,300,620,38
NTOROKO,2016,330,320,650,38
NTOROKO,2017,330,320,650,38
NTOROKO,2018,350,340,690,38
NTOROKO,2019,360,340,700,38
NTOROKO,2020,370,360,730,38
NTOROKO,2021,390,380,770,38
NTOROKO,2022,400,380,780,38
NTOROKO,2023,420,400,820,38
NTOROKO,2024,430,410,840,38
NTOROKO,2025,450,420,870,38
NTUNGAMO,2015,2000,2580,4580,38
NTUNGAMO,2016,2040,2620,4660,38
NTUNGAMO,2017,2090,2670,4760,38
NTUNGAMO,2018,2130,2720,4850,38
NTUNGAMO,2019,2180,2770,4950,38
NTUNGAMO,2020,2220,2820,5040,38
NTUNGAMO,2021,2260,2860,5120,38
NTUNGAMO,2022,2300,2910,5210,38
NTUNGAMO,2023,2350,2950,5300,38
NTUNGAMO,2024,2390,3000,5390,38
NTUNGAMO,2025,2420,3040,5460,38
NWOYA,2015,650,680,1330,38
NWOYA,2016,720,750,1470,38
NWOYA,2017,790,820,1610,38
NWOYA,2018,880,910,1790,38
NWOYA,2019,970,1000,1970,38
NWOYA,2020,1070,1100,2170,38
NWOYA,2021,1180,1210,2390,38
NWOYA,2022,1300,1330,2630,38
NWOYA,2023,1430,1460,2890,38
NWOYA,2024,1570,1600,3170,38
NWOYA,2025,1730,1760,3490,38
OBONGI,2015,160,210,370,38
OBONGI,2016,170,210,380,38
OBONGI,2017,170,230,400,38
OBONGI,2018,180,230,410,38
OBONGI,2019,190,250,440,38
OBONGI,2020,200,250,450,38
OBONGI,2021,200,260,460,38
OBONGI,2022,210,270,480,38
OBONGI,2023,210,280,490,38
OBONGI,2024,220,290,510,38
OBONGI,2025,230,290,520,38
OMORO,2015,550,730,1280,38
OMORO,2016,570,770,1340,38
OMORO,2017,590,810,1400,38
OMORO,2018,620,860,1480,38
OMORO,2019,650,900,1550,38
OMORO,2020,680,950,1630,38
OMORO,2021,720,1000,1720,38
OMORO,2022,740,1040,1780,38
OMORO,2023,770,1090,1860,38
OMORO,2024,810,1140,1950,38
OMORO,2025,850,1200,2050,38
OTUKE,2015,400,460,860,38
OTUKE,2016,420,480,900,38
OTUKE,2017,440,500,940,38
OTUKE,2018,460,520,980,38
OTUKE,2019,480,540,1020,38
OTUKE,2020,500,560,1060,38
OTUKE,2021,520,580,1100,38
OTUKE,2022,550,610,1160,38
OTUKE,2023,570,630,1200,38
OTUKE,2024,590,660,1250,38
OTUKE,2025,620,680,1300,38
OYAM,2015,1430,1690,3120,38
OYAM,2016,1480,1740,3220,38
OYAM,2017,1520,1790,3310,38
OYAM,2018,1570,1850,3420,38
OYAM,2019,1620,1900,3520,38
OYAM,2020,1660,1950,3610,38
OYAM,2021,1710,2000,3710,38
OYAM,2022,1760,2060,3820,38
OYAM,2023,1800,2110,3910,38
OYAM,2024,1850,2160,4010,38
OYAM,2025,1900,2220,4120,38
PADER,2015,620,800,1420,38
PADER,2016,630,820,1450,38
PADER,2017,640,850,1490,38
PADER,2018,660,890,1550,38
PADER,2019,670,910,1580,38
PADER,2020,700,950,1650,38
PADER,2021,720,990,1710,38
PADER,2022,730,1010,1740,38
PADER,2023,750,1050,1800,38
PADER,2024,770,1080,1850,38
PADER,2025,790,1120,1910,38
PAKWACH,2015,600,760,1360,38
PAKWACH,2016,630,790,1420,38
PAKWACH,2017,650,820,1470,38
PAKWACH,2018,680,850,1530,38
PAKWACH,2019,710,880,1590,38
PAKWACH,2020,740,910,1650,38
PAKWACH,2021,770,940,1710,38
PAKWACH,2022,800,970,1770,38
PAKWACH,2023,830,1000,1830,38
PAKWACH,2024,860,1030,1890,38
PAKWACH,2025,890,1070,1960,38
PALLISA,2015,870,1120,1990,38
PALLISA,2016,910,1190,2100,38
PALLISA,2017,970,1260,2230,38
PALLISA,2018,1010,1340,2350,38
PALLISA,2019,1070,1420,2490,38
PALLISA,2020,1130,1510,2640,38
PALLISA,2021,1190,1600,2790,38
PALLISA,2022,1260,1690,2950,38
PALLISA,2023,1320,1780,3100,38
PALLISA,2024,1400,1880,3280,38
PALLISA,2025,1470,1990,3460,38
RAKAI,2015,1230,1400,2630,38
RAKAI,2016,1260,1460,2720,38
RAKAI,2017,1310,1510,2820,38
RAKAI,2018,1360,1580,2940,38
RAKAI,2019,1400,1650,3050,38
RAKAI,2020,1460,1710,3170,38
RAKAI,2021,1500,1780,3280,38
RAKAI,2022,1560,1840,3400,38
RAKAI,2023,1620,1910,3530,38
RAKAI,2024,1670,1970,3640,38
RAKAI,2025,1720,2050,3770,38
RUBANDA,2015,750,1020,1770,38
RUBANDA,2016,760,1030,1790,38
RUBANDA,2017,770,1040,1810,38
RUBANDA,2018,780,1040,1820,38
RUBANDA,2019,790,1050,1840,38
RUBANDA,2020,800,1060,1860,38
RUBANDA,2021,810,1070,1880,38
RUBANDA,2022,820,1070,1890,38
RUBANDA,2023,830,1080,1910,38
RUBANDA,2024,840,1080,1920,38
RUBANDA,2025,840,1080,1920,38
RUBIRIZI,2015,520,710,1230,38
RUBIRIZI,2016,530,720,1250,38
RUBIRIZI,2017,540,740,1280,38
RUBIRIZI,2018,550,750,1300,38
RUBIRIZI,2019,560,760,1320,38
RUBIRIZI,2020,570,780,1350,38
RUBIRIZI,2021,580,790,1370,38
RUBIRIZI,2022,590,800,1390,38
RUBIRIZI,2023,600,820,1420,38
RUBIRIZI,2024,610,830,1440,38
RUBIRIZI,2025,620,840,1460,38
RUKIGA,2015,410,540,950,38
RUKIGA,2016,410,550,960,38
RUKIGA,2017,420,550,970,38
RUKIGA,2018,420,560,980,38
RUKIGA,2019,430,560,990,38
RUKIGA,2020,430,560,990,38
RUKIGA,2021,430,560,990,38
RUKIGA,2022,440,570,1010,38
RUKIGA,2023,440,570,1010,38
RUKIGA,2024,440,570,1010,38
RUKIGA,2025,440,570,1010,38
RUKUNGIRI,2015,1170,1650,2820,38
RUKUNGIRI,2016,1190,1660,2850,38
RUKUNGIRI,2017,1200,1680,2880,38
RUKUNGIRI,2018,1220,1690,2910,38
RUKUNGIRI,2019,1230,1710,2940,38
RUKUNGIRI,2020,1240,1720,2960,38
RUKUNGIRI,2021,1260,1740,3000,38
RUKUNGIRI,2022,1270,1750,3020,38
RUKUNGIRI,2023,1280,1760,3040,38
RUKUNGIRI,2024,1290,1770,3060,38
RUKUNGIRI,2025,1300,1780,3080,38
RWAMPARA,2015,510,630,1140,38
RWAMPARA,2016,520,650,1170,38
RWAMPARA,2017,530,660,1190,38
RWAMPARA,2018,540,680,1220,38
RWAMPARA,2019,550,690,1240,38
RWAMPARA,2020,570,700,1270,38
RWAMPARA,2021,580,720,1300,38
RWAMPARA,2022,590,730,1320,38
RWAMPARA,2023,600,750,1350,38
RWAMPARA,2024,610,760,1370,38
RWAMPARA,2025,620,770,1390,38
SERERE,2015,940,1110,2050,38
SERERE,2016,980,1170,2150,38
SERERE,2017,1020,1240,2260,38
SERERE,2018,1080,1310,2390,38
SERERE,2019,1130,1390,2520,38
SERERE,2020,1190,1470,2660,38
SERERE,2021,1250,1550,2800,38
SERERE,2022,1320,1630,2950,38
SERERE,2023,1380,1720,3100,38
SERERE,2024,1450,1810,3260,38
SERERE,2025,1520,1910,3430,38
SHEEMA,2015,880,1250,2130,38
SHEEMA,2016,890,1260,2150,38
SHEEMA,2017,900,1270,2170,38
SHEEMA,2018,910,1280,2190,38
SHEEMA,2019,920,1300,2220,38
SHEEMA,2020,930,1310,2240,38
SHEEMA,2021,940,1320,2260,38
SHEEMA,2022,950,1330,2280,38
SHEEMA,2023,960,1340,2300,38
SHEEMA,2024,960,1350,2310,38
SHEEMA,2025,970,1360,2330,38
SIRONKO,2015,1040,1220,2260,38
SIRONKO,2016,1060,1250,2310,38
SIRONKO,2017,1090,1270,2360,38
SIRONKO,2018,1110,1300,2410,38
SIRONKO,2019,1140,1320,2460,38
SIRONKO,2020,1170,1350,2520,38
SIRONKO,2021,1190,1370,2560,38
SIRONKO,2022,1210,1400,2610,38
SIRONKO,2023,1240,1420,2660,38
SIRONKO,2024,1260,1440,2700,38
SIRONKO,2025,1290,1470,2760,38
SOROTI,2015,1170,1250,2420,38
SOROTI,2016,1210,1310,2520,38
SOROTI,2017,1260,1370,2630,38
SOROTI,2018,1320,1450,2770,38
SOROTI,2019,1390,1520,2910,38
SOROTI,2020,1450,1610,3060,38
SOROTI,2021,1510,1690,3200,38
SOROTI,2022,1580,1770,3350,38
SOROTI,2023,1660,1860,3520,38
SOROTI,2024,1730,1940,3670,38
SOROTI,2025,1810,2050,3860,38
SSEMBABULE,2015,1160,1150,2310,38
SSEMBABULE,2016,1190,1200,2390,38
SSEMBABULE,2017,1230,1260,2490,38
SSEMBABULE,2018,1290,1310,2600,38
SSEMBABULE,2019,1340,1370,2710,38
SSEMBABULE,2020,1390,1430,2820,38
SSEMBABULE,2021,1440,1500,2940,38
SSEMBABULE,2022,1500,1550,3050,38
SSEMBABULE,2023,1560,1620,3180,38
SSEMBABULE,2024,1610,1670,3280,38
SSEMBABULE,2025,1670,1750,3420,38
TORORO,2015,2000,2450,4450,38
TORORO,2016,2050,2520,4570,38
TORORO,2017,2110,2580,4690,38
TORORO,2018,2160,2640,4800,38
TORORO,2019,2220,2710,4930,38
TORORO,2020,2270,2770,5040,38
TORORO,2021,2330,2830,5160,38
TORORO,2022,2380,2900,5280,38
TORORO,2023,2440,2960,5400,38
TORORO,2024,2490,3020,5510,38
TORORO,2025,2550,3080,5630,38
WAKISO,2015,11800,11550,23350,38
WAKISO,2016,12590,12340,24930,38
WAKISO,2017,13430,13190,26620,38
WAKISO,2018,14320,14080,28400,38
WAKISO,2019,15270,15030,30300,38
WAKISO,2020,16270,16030,32300,38
WAKISO,2021,17310,17090,34400,38
WAKISO,2022,18420,18220,36640,38
WAKISO,2023,19590,19390,38980,38
WAKISO,2024,20810,20620,41430,38
WAKISO,2025,22090,21940,44030,38
YUMBE,2015,1840,2460,4300,38
YUMBE,2016,1940,2650,4590,38
YUMBE,2017,2060,2850,4910,38
YUMBE,2018,2180,3080,5260,38
YUMBE,2019,2310,3320,5630,38
YUMBE,2020,2450,3580,6030,38
YUMBE,2021,2610,3840,6450,38
YUMBE,2022,2760,4130,6890,38
YUMBE,2023,2930,4430,7360,38
YUMBE,2024,3110,4740,7850,38
YUMBE,2025,3300,5110,8410,38
ZOMBO,2015,990,1180,2170,38
ZOMBO,2016,1020,1220,2240,38
ZOMBO,2017,1050,1250,2300,38
ZOMBO,2018,1080,1290,2370,38
ZOMBO,2019,1110,1320,2430,38
ZOMBO,2020,1150,1360,2510,38
ZOMBO,2021,1180,1390,2570,38
ZOMBO,2022,1210,1430,2640,38
ZOMBO,2023,1240,1460,2700,38
ZOMBO,2024,1280,1500,2780,38
ZOMBO,2025,1310,1530,2840,38
ABIM,2015,320,460,780,39
ABIM,2016,340,480,820,39
ABIM,2017,370,530,900,39
ABIM,2018,390,570,960,39
ABIM,2019,430,610,1040,39
ABIM,2020,460,670,1130,39
ABIM,2021,490,710,1200,39
ABIM,2022,530,760,1290,39
ABIM,2023,570,830,1400,39
ABIM,2024,610,880,1490,39
ABIM,2025,650,950,1600,39
ADJUMANI,2015,670,990,1660,39
ADJUMANI,2016,680,1000,1680,39
ADJUMANI,2017,680,1010,1690,39
ADJUMANI,2018,690,1020,1710,39
ADJUMANI,2019,690,1030,1720,39
ADJUMANI,2020,700,1040,1740,39
ADJUMANI,2021,700,1050,1750,39
ADJUMANI,2022,700,1050,1750,39
ADJUMANI,2023,710,1060,1770,39
ADJUMANI,2024,710,1070,1780,39
ADJUMANI,2025,710,1070,1780,39
AGAGO,2015,700,810,1510,39
AGAGO,2016,710,830,1540,39
AGAGO,2017,730,840,1570,39
AGAGO,2018,740,860,1600,39
AGAGO,2019,750,870,1620,39
AGAGO,2020,760,890,1650,39
AGAGO,2021,770,900,1670,39
AGAGO,2022,780,910,1690,39
AGAGO,2023,800,930,1730,39
AGAGO,2024,810,940,1750,39
AGAGO,2025,820,950,1770,39
ALEBTONG,2015,910,860,1770,39
ALEBTONG,2016,940,890,1830,39
ALEBTONG,2017,960,920,1880,39
ALEBTONG,2018,1000,980,1980,39
ALEBTONG,2019,1040,1020,2060,39
ALEBTONG,2020,1080,1060,2140,39
ALEBTONG,2021,1120,1110,2230,39
ALEBTONG,2022,1160,1150,2310,39
ALEBTONG,2023,1200,1200,2400,39
ALEBTONG,2024,1250,1260,2510,39
ALEBTONG,2025,1290,1300,2590,39
AMOLATAR,2015,610,660,1270,39
AMOLATAR,2016,630,690,1320,39
AMOLATAR,2017,640,710,1350,39
AMOLATAR,2018,670,740,1410,39
AMOLATAR,2019,690,770,1460,39
AMOLATAR,2020,720,810,1530,39
AMOLATAR,2021,740,840,1580,39
AMOLATAR,2022,770,880,1650,39
AMOLATAR,2023,790,910,1700,39
AMOLATAR,2024,830,950,1780,39
AMOLATAR,2025,850,980,1830,39
AMUDAT,2015,320,350,670,39
AMUDAT,2016,330,360,690,39
AMUDAT,2017,340,390,730,39
AMUDAT,2018,360,410,770,39
AMUDAT,2019,390,440,830,39
AMUDAT,2020,400,470,870,39
AMUDAT,2021,420,490,910,39
AMUDAT,2022,430,530,960,39
AMUDAT,2023,460,560,1020,39
AMUDAT,2024,480,600,1080,39
AMUDAT,2025,510,620,1130,39
AMURIA,2015,600,690,1290,39
AMURIA,2016,620,720,1340,39
AMURIA,2017,640,750,1390,39
AMURIA,2018,670,790,1460,39
AMURIA,2019,700,840,1540,39
AMURIA,2020,730,880,1610,39
AMURIA,2021,770,920,1690,39
AMURIA,2022,810,980,1790,39
AMURIA,2023,840,1020,1860,39
AMURIA,2024,880,1060,1940,39
AMURIA,2025,930,1120,2050,39
AMURU,2015,620,760,1380,39
AMURU,2016,630,790,1420,39
AMURU,2017,650,820,1470,39
AMURU,2018,670,860,1530,39
AMURU,2019,700,900,1600,39
AMURU,2020,720,930,1650,39
AMURU,2021,750,970,1720,39
AMURU,2022,770,1020,1790,39
AMURU,2023,810,1060,1870,39
AMURU,2024,830,1100,1930,39
AMURU,2025,860,1150,2010,39
APAC,2015,670,700,1370,39
APAC,2016,700,730,1430,39
APAC,2017,720,750,1470,39
APAC,2018,750,780,1530,39
APAC,2019,780,800,1580,39
APAC,2020,810,830,1640,39
APAC,2021,830,860,1690,39
APAC,2022,860,880,1740,39
APAC,2023,890,910,1800,39
APAC,2024,920,940,1860,39
APAC,2025,950,970,1920,39
ARUA,2015,2080,2560,4640,39
ARUA,2016,2140,2630,4770,39
ARUA,2017,2200,2700,4900,39
ARUA,2018,2260,2770,5030,39
ARUA,2019,2330,2850,5180,39
ARUA,2020,2390,2920,5310,39
ARUA,2021,2450,2990,5440,39
ARUA,2022,2520,3060,5580,39
ARUA,2023,2580,3140,5720,39
ARUA,2024,2640,3210,5850,39
ARUA,2025,2710,3280,5990,39
BUDAKA,2015,720,940,1660,39
BUDAKA,2016,740,980,1720,39
BUDAKA,2017,770,1030,1800,39
BUDAKA,2018,800,1080,1880,39
BUDAKA,2019,840,1140,1980,39
BUDAKA,2020,880,1200,2080,39
BUDAKA,2021,920,1260,2180,39
BUDAKA,2022,970,1330,2300,39
BUDAKA,2023,1000,1390,2390,39
BUDAKA,2024,1050,1450,2500,39
BUDAKA,2025,1100,1520,2620,39
BUDUDA,2015,730,770,1500,39
BUDUDA,2016,760,810,1570,39
BUDUDA,2017,790,870,1660,39
BUDUDA,2018,830,920,1750,39
BUDUDA,2019,880,970,1850,39
BUDUDA,2020,930,1040,1970,39
BUDUDA,2021,980,1110,2090,39
BUDUDA,2022,1040,1170,2210,39
BUDUDA,2023,1090,1240,2330,39
BUDUDA,2024,1150,1310,2460,39
BUDUDA,2025,1220,1380,2600,39
BUGIRI,2015,1310,1800,3110,39
BUGIRI,2016,1350,1880,3230,39
BUGIRI,2017,1410,1990,3400,39
BUGIRI,2018,1480,2090,3570,39
BUGIRI,2019,1560,2220,3780,39
BUGIRI,2020,1640,2350,3990,39
BUGIRI,2021,1720,2480,4200,39
BUGIRI,2022,1810,2610,4420,39
BUGIRI,2023,1890,2760,4650,39
BUGIRI,2024,1990,2890,4880,39
BUGIRI,2025,2090,3040,5130,39
BUGWERI,2015,530,750,1280,39
BUGWERI,2016,540,780,1320,39
BUGWERI,2017,550,810,1360,39
BUGWERI,2018,580,840,1420,39
BUGWERI,2019,600,880,1480,39
BUGWERI,2020,620,920,1540,39
BUGWERI,2021,650,960,1610,39
BUGWERI,2022,660,990,1650,39
BUGWERI,2023,680,1030,1710,39
BUGWERI,2024,720,1080,1800,39
BUGWERI,2025,740,1120,1860,39
BUHWEJU,2015,380,480,860,39
BUHWEJU,2016,400,500,900,39
BUHWEJU,2017,410,510,920,39
BUHWEJU,2018,420,530,950,39
BUHWEJU,2019,440,540,980,39
BUHWEJU,2020,450,560,1010,39
BUHWEJU,2021,460,570,1030,39
BUHWEJU,2022,480,590,1070,39
BUHWEJU,2023,490,610,1100,39
BUHWEJU,2024,500,620,1120,39
BUHWEJU,2025,520,640,1160,39
BUIKWE,2015,1570,1850,3420,39
BUIKWE,2016,1590,1900,3490,39
BUIKWE,2017,1630,1960,3590,39
BUIKWE,2018,1670,2050,3720,39
BUIKWE,2019,1720,2120,3840,39
BUIKWE,2020,1770,2200,3970,39
BUIKWE,2021,1830,2290,4120,39
BUIKWE,2022,1880,2370,4250,39
BUIKWE,2023,1940,2450,4390,39
BUIKWE,2024,1990,2530,4520,39
BUIKWE,2025,2050,2610,4660,39
BUKEDEA,2015,770,820,1590,39
BUKEDEA,2016,800,860,1660,39
BUKEDEA,2017,850,900,1750,39
BUKEDEA,2018,890,950,1840,39
BUKEDEA,2019,940,1020,1960,39
BUKEDEA,2020,990,1080,2070,39
BUKEDEA,2021,1040,1150,2190,39
BUKEDEA,2022,1100,1200,2300,39
BUKEDEA,2023,1160,1280,2440,39
BUKEDEA,2024,1220,1330,2550,39
BUKEDEA,2025,1290,1410,2700,39
BUKOMANSIMBI,2015,520,620,1140,39
BUKOMANSIMBI,2016,530,620,1150,39
BUKOMANSIMBI,2017,530,630,1160,39
BUKOMANSIMBI,2018,530,650,1180,39
BUKOMANSIMBI,2019,550,660,1210,39
BUKOMANSIMBI,2020,560,680,1240,39
BUKOMANSIMBI,2021,560,690,1250,39
BUKOMANSIMBI,2022,580,700,1280,39
BUKOMANSIMBI,2023,590,710,1300,39
BUKOMANSIMBI,2024,590,730,1320,39
BUKOMANSIMBI,2025,600,740,1340,39
BUKWO,2015,350,330,680,39
BUKWO,2016,370,350,720,39
BUKWO,2017,390,360,750,39
BUKWO,2018,410,380,790,39
BUKWO,2019,430,400,830,39
BUKWO,2020,460,420,880,39
BUKWO,2021,480,440,920,39
BUKWO,2022,510,460,970,39
BUKWO,2023,530,480,1010,39
BUKWO,2024,560,500,1060,39
BUKWO,2025,580,520,1100,39
BULAMBULI,2015,720,830,1550,39
BULAMBULI,2016,760,880,1640,39
BULAMBULI,2017,790,920,1710,39
BULAMBULI,2018,830,990,1820,39
BULAMBULI,2019,890,1060,1950,39
BULAMBULI,2020,950,1140,2090,39
BULAMBULI,2021,990,1210,2200,39
BULAMBULI,2022,1050,1290,2340,39
BULAMBULI,2023,1110,1370,2480,39
BULAMBULI,2024,1190,1450,2640,39
BULAMBULI,2025,1250,1540,2790,39
BULIISA,2015,440,430,870,39
BULIISA,2016,470,450,920,39
BULIISA,2017,490,470,960,39
BULIISA,2018,520,490,1010,39
BULIISA,2019,540,510,1050,39
BULIISA,2020,570,530,1100,39
BULIISA,2021,600,560,1160,39
BULIISA,2022,630,580,1210,39
BULIISA,2023,670,600,1270,39
BULIISA,2024,700,630,1330,39
BULIISA,2025,730,650,1380,39
BUNDIBUGYO,2015,820,780,1600,39
BUNDIBUGYO,2016,840,810,1650,39
BUNDIBUGYO,2017,860,840,1700,39
BUNDIBUGYO,2018,900,880,1780,39
BUNDIBUGYO,2019,940,930,1870,39
BUNDIBUGYO,2020,970,970,1940,39
BUNDIBUGYO,2021,1020,1010,2030,39
BUNDIBUGYO,2022,1050,1050,2100,39
BUNDIBUGYO,2023,1090,1100,2190,39
BUNDIBUGYO,2024,1140,1140,2280,39
BUNDIBUGYO,2025,1180,1190,2370,39
BUNYANGABU,2015,660,690,1350,39
BUNYANGABU,2016,680,720,1400,39
BUNYANGABU,2017,690,740,1430,39
BUNYANGABU,2018,720,770,1490,39
BUNYANGABU,2019,740,810,1550,39
BUNYANGABU,2020,770,830,1600,39
BUNYANGABU,2021,790,870,1660,39
BUNYANGABU,2022,820,900,1720,39
BUNYANGABU,2023,840,930,1770,39
BUNYANGABU,2024,880,970,1850,39
BUNYANGABU,2025,900,1000,1900,39
BUSHENYI,2015,810,1050,1860,39
BUSHENYI,2016,820,1060,1880,39
BUSHENYI,2017,830,1070,1900,39
BUSHENYI,2018,840,1080,1920,39
BUSHENYI,2019,850,1080,1930,39
BUSHENYI,2020,860,1090,1950,39
BUSHENYI,2021,870,1100,1970,39
BUSHENYI,2022,880,1110,1990,39
BUSHENYI,2023,880,1110,1990,39
BUSHENYI,2024,890,1120,2010,39
BUSHENYI,2025,900,1120,2020,39
BUSIA,2015,1360,1540,2900,39
BUSIA,2016,1400,1600,3000,39
BUSIA,2017,1450,1680,3130,39
BUSIA,2018,1510,1750,3260,39
BUSIA,2019,1570,1840,3410,39
BUSIA,2020,1640,1920,3560,39
BUSIA,2021,1710,2010,3720,39
BUSIA,2022,1770,2090,3860,39
BUSIA,2023,1840,2190,4030,39
BUSIA,2024,1920,2280,4200,39
BUSIA,2025,2000,2370,4370,39
BUTALEJA,2015,890,1110,2000,39
BUTALEJA,2016,920,1160,2080,39
BUTALEJA,2017,950,1210,2160,39
BUTALEJA,2018,1000,1280,2280,39
BUTALEJA,2019,1040,1350,2390,39
BUTALEJA,2020,1100,1430,2530,39
BUTALEJA,2021,1150,1490,2640,39
BUTALEJA,2022,1210,1570,2780,39
BUTALEJA,2023,1260,1650,2910,39
BUTALEJA,2024,1320,1720,3040,39
BUTALEJA,2025,1380,1810,3190,39
BUTAMBALA,2015,280,370,650,39
BUTAMBALA,2016,270,370,640,39
BUTAMBALA,2017,280,380,660,39
BUTAMBALA,2018,290,400,690,39
BUTAMBALA,2019,290,400,690,39
BUTAMBALA,2020,300,410,710,39
BUTAMBALA,2021,310,430,740,39
BUTAMBALA,2022,310,440,750,39
BUTAMBALA,2023,320,450,770,39
BUTAMBALA,2024,320,450,770,39
BUTAMBALA,2025,340,460,800,39
BUTEBO,2015,390,480,870,39
BUTEBO,2016,390,500,890,39
BUTEBO,2017,400,500,900,39
BUTEBO,2018,410,520,930,39
BUTEBO,2019,420,530,950,39
BUTEBO,2020,430,560,990,39
BUTEBO,2021,440,570,1010,39
BUTEBO,2022,450,590,1040,39
BUTEBO,2023,460,600,1060,39
BUTEBO,2024,470,620,1090,39
BUTEBO,2025,490,630,1120,39
BUVUMA,2015,540,450,990,39
BUVUMA,2016,570,490,1060,39
BUVUMA,2017,610,520,1130,39
BUVUMA,2018,640,550,1190,39
BUVUMA,2019,680,590,1270,39
BUVUMA,2020,720,630,1350,39
BUVUMA,2021,770,670,1440,39
BUVUMA,2022,810,710,1520,39
BUVUMA,2023,860,760,1620,39
BUVUMA,2024,910,810,1720,39
BUVUMA,2025,960,860,1820,39
BUYENDE,2015,1010,1190,2200,39
BUYENDE,2016,1040,1250,2290,39
BUYENDE,2017,1090,1320,2410,39
BUYENDE,2018,1160,1410,2570,39
BUYENDE,2019,1220,1490,2710,39
BUYENDE,2020,1290,1580,2870,39
BUYENDE,2021,1360,1680,3040,39
BUYENDE,2022,1420,1780,3200,39
BUYENDE,2023,1500,1880,3380,39
BUYENDE,2024,1580,1980,3560,39
BUYENDE,2025,1680,2100,3780,39
DOKOLO,2015,650,730,1380,39
DOKOLO,2016,670,750,1420,39
DOKOLO,2017,690,770,1460,39
DOKOLO,2018,710,790,1500,39
DOKOLO,2019,730,810,1540,39
DOKOLO,2020,750,830,1580,39
DOKOLO,2021,770,860,1630,39
DOKOLO,2022,790,880,1670,39
DOKOLO,2023,810,900,1710,39
DOKOLO,2024,840,920,1760,39
DOKOLO,2025,860,940,1800,39
GOMBA,2015,660,550,1210,39
GOMBA,2016,680,560,1240,39
GOMBA,2017,690,570,1260,39
GOMBA,2018,710,590,1300,39
GOMBA,2019,730,610,1340,39
GOMBA,2020,750,630,1380,39
GOMBA,2021,770,640,1410,39
GOMBA,2022,780,660,1440,39
GOMBA,2023,810,680,1490,39
GOMBA,2024,830,700,1530,39
GOMBA,2025,840,710,1550,39
GULU,2015,970,1010,1980,39
GULU,2016,1000,1030,2030,39
GULU,2017,1030,1060,2090,39
GULU,2018,1070,1100,2170,39
GULU,2019,1100,1130,2230,39
GULU,2020,1130,1160,2290,39
GULU,2021,1160,1190,2350,39
GULU,2022,1190,1220,2410,39
GULU,2023,1220,1250,2470,39
GULU,2024,1250,1280,2530,39
GULU,2025,1290,1310,2600,39
HOIMA,2015,1250,1210,2460,39
HOIMA,2016,1300,1250,2550,39
HOIMA,2017,1350,1290,2640,39
HOIMA,2018,1400,1340,2740,39
HOIMA,2019,1450,1380,2830,39
HOIMA,2020,1500,1430,2930,39
HOIMA,2021,1560,1480,3040,39
HOIMA,2022,1610,1520,3130,39
HOIMA,2023,1670,1570,3240,39
HOIMA,2024,1720,1620,3340,39
HOIMA,2025,1780,1670,3450,39
IBANDA,2015,840,1110,1950,39
IBANDA,2016,850,1130,1980,39
IBANDA,2017,870,1150,2020,39
IBANDA,2018,890,1170,2060,39
IBANDA,2019,900,1190,2090,39
IBANDA,2020,920,1210,2130,39
IBANDA,2021,940,1230,2170,39
IBANDA,2022,950,1240,2190,39
IBANDA,2023,970,1260,2230,39
IBANDA,2024,980,1280,2260,39
IBANDA,2025,1000,1300,2300,39
IGANGA,2015,1220,1560,2780,39
IGANGA,2016,1250,1610,2860,39
IGANGA,2017,1300,1680,2980,39
IGANGA,2018,1340,1770,3110,39
IGANGA,2019,1400,1850,3250,39
IGANGA,2020,1470,1940,3410,39
IGANGA,2021,1530,2020,3550,39
IGANGA,2022,1580,2120,3700,39
IGANGA,2023,1650,2210,3860,39
IGANGA,2024,1720,2290,4010,39
IGANGA,2025,1790,2390,4180,39
ISINGIRO,2015,1740,2130,3870,39
ISINGIRO,2016,1800,2210,4010,39
ISINGIRO,2017,1870,2280,4150,39
ISINGIRO,2018,1940,2360,4300,39
ISINGIRO,2019,2010,2440,4450,39
ISINGIRO,2020,2080,2530,4610,39
ISINGIRO,2021,2160,2610,4770,39
ISINGIRO,2022,2230,2700,4930,39
ISINGIRO,2023,2300,2780,5080,39
ISINGIRO,2024,2380,2870,5250,39
ISINGIRO,2025,2460,2950,5410,39
JINJA,2015,1680,2030,3710,39
JINJA,2016,1710,2070,3780,39
JINJA,2017,1740,2100,3840,39
JINJA,2018,1760,2130,3890,39
JINJA,2019,1790,2160,3950,39
JINJA,2020,1820,2190,4010,39
JINJA,2021,1850,2220,4070,39
JINJA,2022,1870,2250,4120,39
JINJA,2023,1900,2270,4170,39
JINJA,2024,1920,2300,4220,39
JINJA,2025,1940,2320,4260,39
KAABONG,2015,320,340,660,39
KAABONG,2016,330,350,680,39
KAABONG,2017,340,360,700,39
KAABONG,2018,350,370,720,39
KAABONG,2019,360,370,730,39
KAABONG,2020,360,380,740,39
KAABONG,2021,370,390,760,39
KAABONG,2022,380,400,780,39
KAABONG,2023,390,410,800,39
KAABONG,2024,400,420,820,39
KAABONG,2025,410,430,840,39
KABALE,2015,860,1050,1910,39
KABALE,2016,870,1070,1940,39
KABALE,2017,890,1080,1970,39
KABALE,2018,900,1090,1990,39
KABALE,2019,910,1100,2010,39
KABALE,2020,920,1110,2030,39
KABALE,2021,940,1130,2070,39
KABALE,2022,950,1140,2090,39
KABALE,2023,960,1150,2110,39
KABALE,2024,970,1160,2130,39
KABALE,2025,980,1160,2140,39
KABAROLE,2015,1270,1130,2400,39
KABAROLE,2016,1300,1150,2450,39
KABAROLE,2017,1330,1180,2510,39
KABAROLE,2018,1360,1200,2560,39
KABAROLE,2019,1390,1230,2620,39
KABAROLE,2020,1410,1250,2660,39
KABAROLE,2021,1440,1280,2720,39
KABAROLE,2022,1470,1300,2770,39
KABAROLE,2023,1500,1320,2820,39
KABAROLE,2024,1520,1350,2870,39
KABAROLE,2025,1550,1370,2920,39
KABERAMAIDO,2015,450,470,920,39
KABERAMAIDO,2016,460,500,960,39
KABERAMAIDO,2017,480,510,990,39
KABERAMAIDO,2018,510,550,1060,39
KABERAMAIDO,2019,540,580,1120,39
KABERAMAIDO,2020,560,620,1180,39
KABERAMAIDO,2021,590,650,1240,39
KABERAMAIDO,2022,630,690,1320,39
KABERAMAIDO,2023,660,710,1370,39
KABERAMAIDO,2024,690,760,1450,39
KABERAMAIDO,2025,730,790,1520,39
KAGADI,2015,1170,1330,2500,39
KAGADI,2016,1210,1380,2590,39
KAGADI,2017,1260,1430,2690,39
KAGADI,2018,1300,1480,2780,39
KAGADI,2019,1350,1530,2880,39
KAGADI,2020,1400,1580,2980,39
KAGADI,2021,1450,1640,3090,39
KAGADI,2022,1490,1690,3180,39
KAGADI,2023,1540,1740,3280,39
KAGADI,2024,1590,1800,3390,39
KAGADI,2025,1650,1850,3500,39
KAKUMIRO,2015,1130,1200,2330,39
KAKUMIRO,2016,1230,1300,2530,39
KAKUMIRO,2017,1340,1410,2750,39
KAKUMIRO,2018,1450,1530,2980,39
KAKUMIRO,2019,1580,1650,3230,39
KAKUMIRO,2020,1720,1790,3510,39
KAKUMIRO,2021,1870,1940,3810,39
KAKUMIRO,2022,2030,2090,4120,39
KAKUMIRO,2023,2200,2260,4460,39
KAKUMIRO,2024,2380,2440,4820,39
KAKUMIRO,2025,2580,2640,5220,39
KALAKI,2015,360,410,770,39
KALAKI,2016,370,420,790,39
KALAKI,2017,390,440,830,39
KALAKI,2018,410,460,870,39
KALAKI,2019,420,470,890,39
KALAKI,2020,440,490,930,39
KALAKI,2021,460,510,970,39
KALAKI,2022,480,530,1010,39
KALAKI,2023,490,550,1040,39
KALAKI,2024,510,570,1080,39
KALAKI,2025,530,590,1120,39
KALANGALA,2015,500,290,790,39
KALANGALA,2016,520,300,820,39
KALANGALA,2017,540,310,850,39
KALANGALA,2018,550,320,870,39
KALANGALA,2019,570,340,910,39
KALANGALA,2020,590,350,940,39
KALANGALA,2021,610,360,970,39
KALANGALA,2022,630,380,1010,39
KALANGALA,2023,650,390,1040,39
KALANGALA,2024,670,410,1080,39
KALANGALA,2025,690,420,1110,39
KALIRO,2015,770,940,1710,39
KALIRO,2016,800,980,1780,39
KALIRO,2017,830,1030,1860,39
KALIRO,2018,870,1080,1950,39
KALIRO,2019,910,1140,2050,39
KALIRO,2020,950,1200,2150,39
KALIRO,2021,990,1260,2250,39
KALIRO,2022,1040,1330,2370,39
KALIRO,2023,1090,1390,2480,39
KALIRO,2024,1140,1450,2590,39
KALIRO,2025,1180,1530,2710,39
KALUNGU,2015,590,730,1320,39
KALUNGU,2016,580,740,1320,39
KALUNGU,2017,600,750,1350,39
KALUNGU,2018,610,780,1390,39
KALUNGU,2019,620,790,1410,39
KALUNGU,2020,640,820,1460,39
KALUNGU,2021,650,850,1500,39
KALUNGU,2022,660,870,1530,39
KALUNGU,2023,670,880,1550,39
KALUNGU,2024,690,910,1600,39
KALUNGU,2025,700,920,1620,39
KAMPALA,2015,6170,6720,12890,39
KAMPALA,2016,6290,6850,13140,39
KAMPALA,2017,6410,6980,13390,39
KAMPALA,2018,6540,7110,13650,39
KAMPALA,2019,6660,7250,13910,39
KAMPALA,2020,6780,7380,14160,39
KAMPALA,2021,6900,7500,14400,39
KAMPALA,2022,7020,7630,14650,39
KAMPALA,2023,7130,7750,14880,39
KAMPALA,2024,7240,7870,15110,39
KAMPALA,2025,7340,7990,15330,39
KAMULI,2015,1630,2160,3790,39
KAMULI,2016,1650,2230,3880,39
KAMULI,2017,1700,2310,4010,39
KAMULI,2018,1760,2410,4170,39
KAMULI,2019,1830,2500,4330,39
KAMULI,2020,1890,2610,4500,39
KAMULI,2021,1960,2710,4670,39
KAMULI,2022,2030,2810,4840,39
KAMULI,2023,2100,2920,5020,39
KAMULI,2024,2170,3020,5190,39
KAMULI,2025,2250,3120,5370,39
KAMWENGE,2015,990,1130,2120,39
KAMWENGE,2016,1030,1170,2200,39
KAMWENGE,2017,1070,1210,2280,39
KAMWENGE,2018,1110,1250,2360,39
KAMWENGE,2019,1160,1290,2450,39
KAMWENGE,2020,1200,1340,2540,39
KAMWENGE,2021,1250,1380,2630,39
KAMWENGE,2022,1300,1430,2730,39
KAMWENGE,2023,1340,1480,2820,39
KAMWENGE,2024,1390,1520,2910,39
KAMWENGE,2025,1440,1570,3010,39
KANUNGU,2015,880,1110,1990,39
KANUNGU,2016,890,1130,2020,39
KANUNGU,2017,910,1140,2050,39
KANUNGU,2018,920,1160,2080,39
KANUNGU,2019,940,1180,2120,39
KANUNGU,2020,950,1200,2150,39
KANUNGU,2021,970,1210,2180,39
KANUNGU,2022,980,1230,2210,39
KANUNGU,2023,1000,1250,2250,39
KANUNGU,2024,1010,1260,2270,39
KANUNGU,2025,1020,1280,2300,39
KAPCHORWA,2015,420,450,870,39
KAPCHORWA,2016,440,470,910,39
KAPCHORWA,2017,450,480,930,39
KAPCHORWA,2018,470,490,960,39
KAPCHORWA,2019,480,500,980,39
KAPCHORWA,2020,490,520,1010,39
KAPCHORWA,2021,510,530,1040,39
KAPCHORWA,2022,520,540,1060,39
KAPCHORWA,2023,530,560,1090,39
KAPCHORWA,2024,550,570,1120,39
KAPCHORWA,2025,560,580,1140,39
KAPELEBYONG,2015,310,300,610,39
KAPELEBYONG,2016,320,320,640,39
KAPELEBYONG,2017,330,330,660,39
KAPELEBYONG,2018,350,340,690,39
KAPELEBYONG,2019,360,360,720,39
KAPELEBYONG,2020,380,370,750,39
KAPELEBYONG,2021,380,390,770,39
KAPELEBYONG,2022,400,410,810,39
KAPELEBYONG,2023,410,420,830,39
KAPELEBYONG,2024,430,440,870,39
KAPELEBYONG,2025,450,460,910,39
KASESE,2015,2350,2700,5050,39
KASESE,2016,2380,2780,5160,39
KASESE,2017,2460,2880,5340,39
KASESE,2018,2540,2990,5530,39
KASESE,2019,2620,3120,5740,39
KASESE,2020,2720,3240,5960,39
KASESE,2021,2810,3380,6190,39
KASESE,2022,2900,3500,6400,39
KASESE,2023,2990,3620,6610,39
KASESE,2024,3100,3750,6850,39
KASESE,2025,3210,3880,7090,39
KASSANDA,2015,990,960,1950,39
KASSANDA,2016,1010,980,1990,39
KASSANDA,2017,1040,1000,2040,39
KASSANDA,2018,1070,1020,2090,39
KASSANDA,2019,1100,1040,2140,39
KASSANDA,2020,1130,1060,2190,39
KASSANDA,2021,1160,1080,2240,39
KASSANDA,2022,1190,1100,2290,39
KASSANDA,2023,1220,1120,2340,39
KASSANDA,2024,1250,1140,2390,39
KASSANDA,2025,1280,1160,2440,39
KATAKWI,2015,600,640,1240,39
KATAKWI,2016,620,660,1280,39
KATAKWI,2017,640,690,1330,39
KATAKWI,2018,660,720,1380,39
KATAKWI,2019,690,750,1440,39
KATAKWI,2020,720,790,1510,39
KATAKWI,2021,740,810,1550,39
KATAKWI,2022,770,850,1620,39
KATAKWI,2023,810,880,1690,39
KATAKWI,2024,840,920,1760,39
KATAKWI,2025,860,950,1810,39
KAYUNGA,2015,1280,1480,2760,39
KAYUNGA,2016,1310,1510,2820,39
KAYUNGA,2017,1330,1550,2880,39
KAYUNGA,2018,1370,1600,2970,39
KAYUNGA,2019,1400,1670,3070,39
KAYUNGA,2020,1450,1730,3180,39
KAYUNGA,2021,1490,1790,3280,39
KAYUNGA,2022,1530,1840,3370,39
KAYUNGA,2023,1570,1900,3470,39
KAYUNGA,2024,1620,1940,3560,39
KAYUNGA,2025,1670,2000,3670,39
KAZO,2015,640,760,1400,39
KAZO,2016,670,790,1460,39
KAZO,2017,690,810,1500,39
KAZO,2018,720,840,1560,39
KAZO,2019,740,870,1610,39
KAZO,2020,770,900,1670,39
KAZO,2021,800,930,1730,39
KAZO,2022,830,960,1790,39
KAZO,2023,850,990,1840,39
KAZO,2024,880,1020,1900,39
KAZO,2025,910,1050,1960,39
KIBAALE,2015,580,540,1120,39
KIBAALE,2016,610,570,1180,39
KIBAALE,2017,650,600,1250,39
KIBAALE,2018,700,640,1340,39
KIBAALE,2019,740,680,1420,39
KIBAALE,2020,780,710,1490,39
KIBAALE,2021,830,750,1580,39
KIBAALE,2022,880,800,1680,39
KIBAALE,2023,940,840,1780,39
KIBAALE,2024,990,880,1870,39
KIBAALE,2025,1050,930,1980,39
KIBOGA,2015,600,560,1160,39
KIBOGA,2016,610,580,1190,39
KIBOGA,2017,620,600,1220,39
KIBOGA,2018,640,620,1260,39
KIBOGA,2019,660,650,1310,39
KIBOGA,2020,690,670,1360,39
KIBOGA,2021,710,700,1410,39
KIBOGA,2022,740,730,1470,39
KIBOGA,2023,760,760,1520,39
KIBOGA,2024,790,790,1580,39
KIBOGA,2025,820,820,1640,39
KIBUKU,2015,670,790,1460,39
KIBUKU,2016,690,830,1520,39
KIBUKU,2017,710,880,1590,39
KIBUKU,2018,750,930,1680,39
KIBUKU,2019,780,970,1750,39
KIBUKU,2020,830,1030,1860,39
KIBUKU,2021,860,1080,1940,39
KIBUKU,2022,910,1140,2050,39
KIBUKU,2023,950,1200,2150,39
KIBUKU,2024,1000,1270,2270,39
KIBUKU,2025,1040,1330,2370,39
KIKUUBE,2015,1100,1010,2110,39
KIKUUBE,2016,1160,1060,2220,39
KIKUUBE,2017,1220,1120,2340,39
KIKUUBE,2018,1290,1170,2460,39
KIKUUBE,2019,1350,1230,2580,39
KIKUUBE,2020,1420,1290,2710,39
KIKUUBE,2021,1500,1360,2860,39
KIKUUBE,2022,1570,1420,2990,39
KIKUUBE,2023,1650,1490,3140,39
KIKUUBE,2024,1730,1560,3290,39
KIKUUBE,2025,1810,1630,3440,39
KIRUHURA,2015,680,640,1320,39
KIRUHURA,2016,710,670,1380,39
KIRUHURA,2017,740,690,1430,39
KIRUHURA,2018,760,710,1470,39
KIRUHURA,2019,790,740,1530,39
KIRUHURA,2020,820,760,1580,39
KIRUHURA,2021,850,790,1640,39
KIRUHURA,2022,880,810,1690,39
KIRUHURA,2023,910,840,1750,39
KIRUHURA,2024,940,870,1810,39
KIRUHURA,2025,970,890,1860,39
KIRYANDONGO,2015,1060,1050,2110,39
KIRYANDONGO,2016,1090,1090,2180,39
KIRYANDONGO,2017,1120,1130,2250,39
KIRYANDONGO,2018,1170,1190,2360,39
KIRYANDONGO,2019,1220,1230,2450,39
KIRYANDONGO,2020,1270,1290,2560,39
KIRYANDONGO,2021,1330,1360,2690,39
KIRYANDONGO,2022,1380,1420,2800,39
KIRYANDONGO,2023,1430,1470,2900,39
KIRYANDONGO,2024,1480,1530,3010,39
KIRYANDONGO,2025,1540,1580,3120,39
KISORO,2015,600,1060,1660,39
KISORO,2016,610,1080,1690,39
KISORO,2017,620,1120,1740,39
KISORO,2018,640,1160,1800,39
KISORO,2019,660,1210,1870,39
KISORO,2020,670,1260,1930,39
KISORO,2021,690,1310,2000,39
KISORO,2022,720,1350,2070,39
KISORO,2023,740,1400,2140,39
KISORO,2024,750,1440,2190,39
KISORO,2025,780,1490,2270,39
KITAGWENDA,2015,510,650,1160,39
KITAGWENDA,2016,530,670,1200,39
KITAGWENDA,2017,550,700,1250,39
KITAGWENDA,2018,580,720,1300,39
KITAGWENDA,2019,600,750,1350,39
KITAGWENDA,2020,620,770,1390,39
KITAGWENDA,2021,640,800,1440,39
KITAGWENDA,2022,670,830,1500,39
KITAGWENDA,2023,690,850,1540,39
KITAGWENDA,2024,720,880,1600,39
KITAGWENDA,2025,740,900,1640,39
KITGUM,2015,770,810,1580,39
KITGUM,2016,780,830,1610,39
KITGUM,2017,790,860,1650,39
KITGUM,2018,810,880,1690,39
KITGUM,2019,830,910,1740,39
KITGUM,2020,860,940,1800,39
KITGUM,2021,880,970,1850,39
KITGUM,2022,910,1000,1910,39
KITGUM,2023,930,1030,1960,39
KITGUM,2024,950,1060,2010,39
KITGUM,2025,980,1090,2070,39
KOBOKO,2015,820,840,1660,39
KOBOKO,2016,850,880,1730,39
KOBOKO,2017,880,920,1800,39
KOBOKO,2018,930,980,1910,39
KOBOKO,2019,970,1030,2000,39
KOBOKO,2020,1030,1090,2120,39
KOBOKO,2021,1080,1150,2230,39
KOBOKO,2022,1130,1220,2350,39
KOBOKO,2023,1180,1280,2460,39
KOBOKO,2024,1250,1330,2580,39
KOBOKO,2025,1300,1410,2710,39
KOLE,2015,870,890,1760,39
KOLE,2016,900,920,1820,39
KOLE,2017,930,940,1870,39
KOLE,2018,960,970,1930,39
KOLE,2019,990,1000,1990,39
KOLE,2020,1020,1030,2050,39
KOLE,2021,1050,1050,2100,39
KOLE,2022,1090,1080,2170,39
KOLE,2023,1120,1110,2230,39
KOLE,2024,1150,1140,2290,39
KOLE,2025,1180,1160,2340,39
KOTIDO,2015,550,780,1330,39
KOTIDO,2016,570,810,1380,39
KOTIDO,2017,590,830,1420,39
KOTIDO,2018,600,870,1470,39
KOTIDO,2019,620,900,1520,39
KOTIDO,2020,650,940,1590,39
KOTIDO,2021,670,990,1660,39
KOTIDO,2022,690,1020,1710,39
KOTIDO,2023,710,1060,1770,39
KOTIDO,2024,740,1090,1830,39
KOTIDO,2025,760,1120,1880,39
KUMI,2015,890,960,1850,39
KUMI,2016,920,1000,1920,39
KUMI,2017,940,1040,1980,39
KUMI,2018,980,1090,2070,39
KUMI,2019,1030,1140,2170,39
KUMI,2020,1080,1200,2280,39
KUMI,2021,1110,1260,2370,39
KUMI,2022,1160,1300,2460,39
KUMI,2023,1210,1370,2580,39
KUMI,2024,1260,1430,2690,39
KUMI,2025,1320,1480,2800,39
KWANIA,2015,640,730,1370,39
KWANIA,2016,660,750,1410,39
KWANIA,2017,680,770,1450,39
KWANIA,2018,700,790,1490,39
KWANIA,2019,720,810,1530,39
KWANIA,2020,740,830,1570,39
KWANIA,2021,760,860,1620,39
KWANIA,2022,790,880,1670,39
KWANIA,2023,810,900,1710,39
KWANIA,2024,830,920,1750,39
KWANIA,2025,850,950,1800,39
KWEEN,2015,340,370,710,39
KWEEN,2016,350,380,730,39
KWEEN,2017,360,390,750,39
KWEEN,2018,370,400,770,39
KWEEN,2019,380,410,790,39
KWEEN,2020,390,420,810,39
KWEEN,2021,400,430,830,39
KWEEN,2022,410,440,850,39
KWEEN,2023,420,440,860,39
KWEEN,2024,430,450,880,39
KWEEN,2025,440,460,900,39
KYANKWANZI,2015,870,740,1610,39
KYANKWANZI,2016,910,780,1690,39
KYANKWANZI,2017,960,810,1770,39
KYANKWANZI,2018,1010,850,1860,39
KYANKWANZI,2019,1060,890,1950,39
KYANKWANZI,2020,1110,930,2040,39
KYANKWANZI,2021,1170,970,2140,39
KYANKWANZI,2022,1220,1010,2230,39
KYANKWANZI,2023,1280,1060,2340,39
KYANKWANZI,2024,1340,1100,2440,39
KYANKWANZI,2025,1400,1150,2550,39
KYEGEGWA,2015,1060,1110,2170,39
KYEGEGWA,2016,1150,1190,2340,39
KYEGEGWA,2017,1240,1290,2530,39
KYEGEGWA,2018,1340,1390,2730,39
KYEGEGWA,2019,1450,1500,2950,39
KYEGEGWA,2020,1570,1610,3180,39
KYEGEGWA,2021,1690,1740,3430,39
KYEGEGWA,2022,1830,1870,3700,39
KYEGEGWA,2023,1970,2010,3980,39
KYEGEGWA,2024,2120,2160,4280,39
KYEGEGWA,2025,2280,2320,4600,39
KYENJOJO,2015,1550,1630,3180,39
KYENJOJO,2016,1610,1690,3300,39
KYENJOJO,2017,1680,1750,3430,39
KYENJOJO,2018,1740,1820,3560,39
KYENJOJO,2019,1810,1880,3690,39
KYENJOJO,2020,1890,1950,3840,39
KYENJOJO,2021,1960,2020,3980,39
KYENJOJO,2022,2030,2090,4120,39
KYENJOJO,2023,2110,2160,4270,39
KYENJOJO,2024,2190,2230,4420,39
KYENJOJO,2025,2260,2300,4560,39
KYOTERA,2015,1010,1130,2140,39
KYOTERA,2016,1020,1150,2170,39
KYOTERA,2017,1030,1190,2220,39
KYOTERA,2018,1070,1220,2290,39
KYOTERA,2019,1090,1260,2350,39
KYOTERA,2020,1120,1310,2430,39
KYOTERA,2021,1150,1340,2490,39
KYOTERA,2022,1180,1380,2560,39
KYOTERA,2023,1210,1420,2630,39
KYOTERA,2024,1240,1450,2690,39
KYOTERA,2025,1280,1490,2770,39
KARENGA,2015,190,200,390,39
KARENGA,2016,200,210,410,39
KARENGA,2017,200,210,410,39
KARENGA,2018,210,220,430,39
KARENGA,2019,210,220,430,39
KARENGA,2020,220,230,450,39
KARENGA,2021,220,230,450,39
KARENGA,2022,230,240,470,39
KARENGA,2023,230,240,470,39
KARENGA,2024,240,250,490,39
KARENGA,2025,240,250,490,39
LAMWO,2015,470,540,1010,39
LAMWO,2016,470,550,1020,39
LAMWO,2017,480,560,1040,39
LAMWO,2018,490,580,1070,39
LAMWO,2019,490,610,1100,39
LAMWO,2020,510,620,1130,39
LAMWO,2021,510,640,1150,39
LAMWO,2022,530,660,1190,39
LAMWO,2023,540,680,1220,39
LAMWO,2024,540,700,1240,39
LAMWO,2025,550,710,1260,39
LIRA,2015,1370,1490,2860,39
LIRA,2016,1410,1530,2940,39
LIRA,2017,1450,1580,3030,39
LIRA,2018,1490,1620,3110,39
LIRA,2019,1530,1670,3200,39
LIRA,2020,1570,1710,3280,39
LIRA,2021,1610,1760,3370,39
LIRA,2022,1650,1800,3450,39
LIRA,2023,1690,1850,3540,39
LIRA,2024,1730,1890,3620,39
LIRA,2025,1770,1940,3710,39
LUUKA,2015,750,1120,1870,39
LUUKA,2016,760,1150,1910,39
LUUKA,2017,780,1190,1970,39
LUUKA,2018,800,1230,2030,39
LUUKA,2019,820,1280,2100,39
LUUKA,2020,850,1330,2180,39
LUUKA,2021,870,1380,2250,39
LUUKA,2022,910,1430,2340,39
LUUKA,2023,930,1470,2400,39
LUUKA,2024,950,1520,2470,39
LUUKA,2025,980,1570,2550,39
LUWERO,2015,1870,2070,3940,39
LUWERO,2016,1900,2130,4030,39
LUWERO,2017,1950,2200,4150,39
LUWERO,2018,2030,2290,4320,39
LUWERO,2019,2100,2400,4500,39
LUWERO,2020,2180,2490,4670,39
LUWERO,2021,2250,2590,4840,39
LUWERO,2022,2330,2680,5010,39
LUWERO,2023,2400,2780,5180,39
LUWERO,2024,2480,2880,5360,39
LUWERO,2025,2570,2980,5550,39
LWENGO,2015,1050,1230,2280,39
LWENGO,2016,1050,1250,2300,39
LWENGO,2017,1070,1280,2350,39
LWENGO,2018,1090,1310,2400,39
LWENGO,2019,1110,1340,2450,39
LWENGO,2020,1140,1380,2520,39
LWENGO,2021,1160,1420,2580,39
LWENGO,2022,1180,1450,2630,39
LWENGO,2023,1210,1490,2700,39
LWENGO,2024,1220,1520,2740,39
LWENGO,2025,1250,1560,2810,39
LYANTONDE,2015,350,370,720,39
LYANTONDE,2016,360,380,740,39
LYANTONDE,2017,370,400,770,39
LYANTONDE,2018,380,400,780,39
LYANTONDE,2019,390,420,810,39
LYANTONDE,2020,410,440,850,39
LYANTONDE,2021,410,470,880,39
LYANTONDE,2022,430,490,920,39
LYANTONDE,2023,450,500,950,39
LYANTONDE,2024,470,530,1000,39
LYANTONDE,2025,490,550,1040,39
MANAFWA,2015,580,640,1220,39
MANAFWA,2016,600,660,1260,39
MANAFWA,2017,610,670,1280,39
MANAFWA,2018,630,680,1310,39
MANAFWA,2019,640,700,1340,39
MANAFWA,2020,660,710,1370,39
MANAFWA,2021,670,730,1400,39
MANAFWA,2022,690,740,1430,39
MANAFWA,2023,700,760,1460,39
MANAFWA,2024,720,770,1490,39
MANAFWA,2025,730,780,1510,39
MARACHA,2015,560,770,1330,39
MARACHA,2016,570,780,1350,39
MARACHA,2017,580,800,1380,39
MARACHA,2018,590,810,1400,39
MARACHA,2019,600,830,1430,39
MARACHA,2020,620,840,1460,39
MARACHA,2021,630,860,1490,39
MARACHA,2022,640,870,1510,39
MARACHA,2023,650,890,1540,39
MARACHA,2024,660,900,1560,39
MARACHA,2025,670,910,1580,39
MASAKA,2015,1320,1340,2660,39
MASAKA,2016,1330,1380,2710,39
MASAKA,2017,1370,1430,2800,39
MASAKA,2018,1410,1490,2900,39
MASAKA,2019,1450,1540,2990,39
MASAKA,2020,1500,1610,3110,39
MASAKA,2021,1550,1660,3210,39
MASAKA,2022,1610,1720,3330,39
MASAKA,2023,1650,1790,3440,39
MASAKA,2024,1710,1840,3550,39
MASAKA,2025,1750,1900,3650,39
MASINDI,2015,1240,1120,2360,39
MASINDI,2016,1280,1150,2430,39
MASINDI,2017,1320,1180,2500,39
MASINDI,2018,1360,1210,2570,39
MASINDI,2019,1390,1240,2630,39
MASINDI,2020,1430,1270,2700,39
MASINDI,2021,1470,1300,2770,39
MASINDI,2022,1510,1340,2850,39
MASINDI,2023,1550,1370,2920,39
MASINDI,2024,1590,1400,2990,39
MASINDI,2025,1620,1430,3050,39
MAYUGE,2015,1620,2070,3690,39
MAYUGE,2016,1650,2150,3800,39
MAYUGE,2017,1710,2250,3960,39
MAYUGE,2018,1780,2360,4140,39
MAYUGE,2019,1860,2480,4340,39
MAYUGE,2020,1940,2600,4540,39
MAYUGE,2021,2020,2720,4740,39
MAYUGE,2022,2100,2850,4950,39
MAYUGE,2023,2180,2970,5150,39
MAYUGE,2024,2270,3100,5370,39
MAYUGE,2025,2370,3230,5600,39
MBALE,2015,1990,2180,4170,39
MBALE,2016,2030,2260,4290,39
MBALE,2017,2100,2370,4470,39
MBALE,2018,2190,2500,4690,39
MBALE,2019,2270,2630,4900,39
MBALE,2020,2370,2770,5140,39
MBALE,2021,2460,2910,5370,39
MBALE,2022,2560,3050,5610,39
MBALE,2023,2660,3190,5850,39
MBALE,2024,2770,3340,6110,39
MBALE,2025,2880,3490,6370,39
MBARARA,2015,1330,1560,2890,39
MBARARA,2016,1360,1590,2950,39
MBARARA,2017,1390,1630,3020,39
MBARARA,2018,1420,1660,3080,39
MBARARA,2019,1450,1700,3150,39
MBARARA,2020,1480,1730,3210,39
MBARARA,2021,1520,1760,3280,39
MBARARA,2022,1540,1800,3340,39
MBARARA,2023,1580,1830,3410,39
MBARARA,2024,1600,1860,3460,39
MBARARA,2025,1630,1890,3520,39
MITOOMA,2015,520,820,1340,39
MITOOMA,2016,520,820,1340,39
MITOOMA,2017,530,830,1360,39
MITOOMA,2018,540,840,1380,39
MITOOMA,2019,540,850,1390,39
MITOOMA,2020,550,850,1400,39
MITOOMA,2021,550,860,1410,39
MITOOMA,2022,560,860,1420,39
MITOOMA,2023,560,870,1430,39
MITOOMA,2024,570,870,1440,39
MITOOMA,2025,570,880,1450,39
MITYANA,2015,1310,1310,2620,39
MITYANA,2016,1320,1340,2660,39
MITYANA,2017,1350,1380,2730,39
MITYANA,2018,1390,1430,2820,39
MITYANA,2019,1430,1470,2900,39
MITYANA,2020,1470,1520,2990,39
MITYANA,2021,1510,1580,3090,39
MITYANA,2022,1550,1630,3180,39
MITYANA,2023,1590,1670,3260,39
MITYANA,2024,1630,1720,3350,39
MITYANA,2025,1680,1770,3450,39
MOROTO,2015,320,370,690,39
MOROTO,2016,330,370,700,39
MOROTO,2017,340,390,730,39
MOROTO,2018,350,410,760,39
MOROTO,2019,360,430,790,39
MOROTO,2020,380,450,830,39
MOROTO,2021,380,470,850,39
MOROTO,2022,400,490,890,39
MOROTO,2023,410,500,910,39
MOROTO,2024,420,520,940,39
MOROTO,2025,440,540,980,39
MOYO,2015,340,470,810,39
MOYO,2016,350,480,830,39
MOYO,2017,360,490,850,39
MOYO,2018,370,500,870,39
MOYO,2019,380,510,890,39
MOYO,2020,390,520,910,39
MOYO,2021,400,530,930,39
MOYO,2022,410,540,950,39
MOYO,2023,420,550,970,39
MOYO,2024,430,560,990,39
MOYO,2025,430,570,1000,39
MPIGI,2015,970,1040,2010,39
MPIGI,2016,990,1070,2060,39
MPIGI,2017,1010,1110,2120,39
MPIGI,2018,1040,1150,2190,39
MPIGI,2019,1080,1200,2280,39
MPIGI,2020,1120,1260,2380,39
MPIGI,2021,1160,1310,2470,39
MPIGI,2022,1200,1350,2550,39
MPIGI,2023,1230,1400,2630,39
MPIGI,2024,1270,1450,2720,39
MPIGI,2025,1320,1500,2820,39
MUBENDE,2015,1640,1700,3340,39
MUBENDE,2016,1720,1800,3520,39
MUBENDE,2017,1810,1920,3730,39
MUBENDE,2018,1930,2060,3990,39
MUBENDE,2019,2060,2210,4270,39
MUBENDE,2020,2190,2360,4550,39
MUBENDE,2021,2330,2510,4840,39
MUBENDE,2022,2460,2680,5140,39
MUBENDE,2023,2620,2860,5480,39
MUBENDE,2024,2780,3050,5830,39
MUBENDE,2025,2960,3240,6200,39
MUKONO,2015,2540,2630,5170,39
MUKONO,2016,2600,2720,5320,39
MUKONO,2017,2670,2840,5510,39
MUKONO,2018,2770,2980,5750,39
MUKONO,2019,2880,3120,6000,39
MUKONO,2020,2980,3270,6250,39
MUKONO,2021,3100,3420,6520,39
MUKONO,2022,3210,3570,6780,39
MUKONO,2023,3320,3740,7060,39
MUKONO,2024,3450,3890,7340,39
MUKONO,2025,3570,4050,7620,39
MADI OKOLLO,2015,470,560,1030,39
MADI OKOLLO,2016,480,570,1050,39
MADI OKOLLO,2017,500,580,1080,39
MADI OKOLLO,2018,510,600,1110,39
MADI OKOLLO,2019,530,620,1150,39
MADI OKOLLO,2020,540,630,1170,39
MADI OKOLLO,2021,550,650,1200,39
MADI OKOLLO,2022,570,670,1240,39
MADI OKOLLO,2023,580,680,1260,39
MADI OKOLLO,2024,600,700,1300,39
MADI OKOLLO,2025,610,710,1320,39
NABILATUK,2015,170,170,340,39
NABILATUK,2016,180,180,360,39
NABILATUK,2017,200,190,390,39
NABILATUK,2018,210,200,410,39
NABILATUK,2019,220,210,430,39
NABILATUK,2020,240,230,470,39
NABILATUK,2021,250,250,500,39
NABILATUK,2022,270,260,530,39
NABILATUK,2023,280,280,560,39
NABILATUK,2024,300,290,590,39
NABILATUK,2025,310,300,610,39
NAKAPIRIPIRIT,2015,230,280,510,39
NAKAPIRIPIRIT,2016,240,290,530,39
NAKAPIRIPIRIT,2017,250,310,560,39
NAKAPIRIPIRIT,2018,270,340,610,39
NAKAPIRIPIRIT,2019,280,360,640,39
NAKAPIRIPIRIT,2020,300,370,670,39
NAKAPIRIPIRIT,2021,310,390,700,39
NAKAPIRIPIRIT,2022,330,430,760,39
NAKAPIRIPIRIT,2023,340,450,790,39
NAKAPIRIPIRIT,2024,370,470,840,39
NAKAPIRIPIRIT,2025,390,500,890,39
NAKASEKE,2015,900,690,1590,39
NAKASEKE,2016,930,700,1630,39
NAKASEKE,2017,970,720,1690,39
NAKASEKE,2018,1000,740,1740,39
NAKASEKE,2019,1040,750,1790,39
NAKASEKE,2020,1070,770,1840,39
NAKASEKE,2021,1110,790,1900,39
NAKASEKE,2022,1150,800,1950,39
NAKASEKE,2023,1190,820,2010,39
NAKASEKE,2024,1220,840,2060,39
NAKASEKE,2025,1260,850,2110,39
NAKASONGOLA,2015,790,760,1550,39
NAKASONGOLA,2016,810,790,1600,39
NAKASONGOLA,2017,840,820,1660,39
NAKASONGOLA,2018,870,860,1730,39
NAKASONGOLA,2019,910,900,1810,39
NAKASONGOLA,2020,950,940,1890,39
NAKASONGOLA,2021,990,990,1980,39
NAKASONGOLA,2022,1030,1030,2060,39
NAKASONGOLA,2023,1070,1070,2140,39
NAKASONGOLA,2024,1110,1100,2210,39
NAKASONGOLA,2025,1170,1150,2320,39
NAMAYINGO,2015,870,1050,1920,39
NAMAYINGO,2016,870,1070,1940,39
NAMAYINGO,2017,890,1100,1990,39
NAMAYINGO,2018,910,1140,2050,39
NAMAYINGO,2019,950,1170,2120,39
NAMAYINGO,2020,970,1210,2180,39
NAMAYINGO,2021,990,1260,2250,39
NAMAYINGO,2022,1030,1290,2320,39
NAMAYINGO,2023,1050,1330,2380,39
NAMAYINGO,2024,1090,1360,2450,39
NAMAYINGO,2025,1110,1400,2510,39
NAMISINDWA,2015,710,800,1510,39
NAMISINDWA,2016,730,820,1550,39
NAMISINDWA,2017,750,840,1590,39
NAMISINDWA,2018,770,860,1630,39
NAMISINDWA,2019,800,880,1680,39
NAMISINDWA,2020,820,900,1720,39
NAMISINDWA,2021,840,920,1760,39
NAMISINDWA,2022,860,940,1800,39
NAMISINDWA,2023,880,960,1840,39
NAMISINDWA,2024,900,980,1880,39
NAMISINDWA,2025,920,1000,1920,39
NAMUTUMBA,2015,820,1060,1880,39
NAMUTUMBA,2016,850,1100,1950,39
NAMUTUMBA,2017,870,1150,2020,39
NAMUTUMBA,2018,910,1220,2130,39
NAMUTUMBA,2019,960,1280,2240,39
NAMUTUMBA,2020,1010,1340,2350,39
NAMUTUMBA,2021,1040,1420,2460,39
NAMUTUMBA,2022,1090,1480,2570,39
NAMUTUMBA,2023,1130,1540,2670,39
NAMUTUMBA,2024,1190,1620,2810,39
NAMUTUMBA,2025,1240,1690,2930,39
NAPAK,2015,370,560,930,39
NAPAK,2016,380,570,950,39
NAPAK,2017,390,590,980,39
NAPAK,2018,390,620,1010,39
NAPAK,2019,410,640,1050,39
NAPAK,2020,410,670,1080,39
NAPAK,2021,430,690,1120,39
NAPAK,2022,430,710,1140,39
NAPAK,2023,450,740,1190,39
NAPAK,2024,460,760,1220,39
NAPAK,2025,480,790,1270,39
NEBBI,2015,710,970,1680,39
NEBBI,2016,730,1000,1730,39
NEBBI,2017,750,1030,1780,39
NEBBI,2018,780,1060,1840,39
NEBBI,2019,800,1090,1890,39
NEBBI,2020,830,1110,1940,39
NEBBI,2021,850,1140,1990,39
NEBBI,2022,880,1170,2050,39
NEBBI,2023,900,1200,2100,39
NEBBI,2024,920,1230,2150,39
NEBBI,2025,950,1260,2210,39
NGORA,2015,490,510,1000,39
NGORA,2016,500,530,1030,39
NGORA,2017,520,550,1070,39
NGORA,2018,530,570,1100,39
NGORA,2019,550,610,1160,39
NGORA,2020,580,630,1210,39
NGORA,2021,600,650,1250,39
NGORA,2022,620,680,1300,39
NGORA,2023,650,710,1360,39
NGORA,2024,670,740,1410,39
NGORA,2025,690,760,1450,39
NTOROKO,2015,290,230,520,39
NTOROKO,2016,300,250,550,39
NTOROKO,2017,300,250,550,39
NTOROKO,2018,310,260,570,39
NTOROKO,2019,330,270,600,39
NTOROKO,2020,330,280,610,39
NTOROKO,2021,350,300,650,39
NTOROKO,2022,360,300,660,39
NTOROKO,2023,370,310,680,39
NTOROKO,2024,380,320,700,39
NTOROKO,2025,400,330,730,39
NTUNGAMO,2015,1490,2090,3580,39
NTUNGAMO,2016,1530,2130,3660,39
NTUNGAMO,2017,1560,2170,3730,39
NTUNGAMO,2018,1590,2210,3800,39
NTUNGAMO,2019,1620,2250,3870,39
NTUNGAMO,2020,1660,2290,3950,39
NTUNGAMO,2021,1690,2330,4020,39
NTUNGAMO,2022,1720,2360,4080,39
NTUNGAMO,2023,1750,2400,4150,39
NTUNGAMO,2024,1780,2430,4210,39
NTUNGAMO,2025,1810,2470,4280,39
NWOYA,2015,530,570,1100,39
NWOYA,2016,590,630,1220,39
NWOYA,2017,650,700,1350,39
NWOYA,2018,720,770,1490,39
NWOYA,2019,790,850,1640,39
NWOYA,2020,870,930,1800,39
NWOYA,2021,960,1020,1980,39
NWOYA,2022,1060,1130,2190,39
NWOYA,2023,1170,1240,2410,39
NWOYA,2024,1280,1360,2640,39
NWOYA,2025,1410,1490,2900,39
OBONGI,2015,140,180,320,39
OBONGI,2016,140,180,320,39
OBONGI,2017,150,190,340,39
OBONGI,2018,150,200,350,39
OBONGI,2019,150,200,350,39
OBONGI,2020,170,220,390,39
OBONGI,2021,170,220,390,39
OBONGI,2022,170,230,400,39
OBONGI,2023,180,240,420,39
OBONGI,2024,190,250,440,39
OBONGI,2025,190,250,440,39
OMORO,2015,610,680,1290,39
OMORO,2016,620,710,1330,39
OMORO,2017,640,740,1380,39
OMORO,2018,670,780,1450,39
OMORO,2019,710,820,1530,39
OMORO,2020,750,870,1620,39
OMORO,2021,780,910,1690,39
OMORO,2022,810,950,1760,39
OMORO,2023,840,1010,1850,39
OMORO,2024,890,1050,1940,39
OMORO,2025,930,1090,2020,39
OTUKE,2015,350,340,690,39
OTUKE,2016,360,350,710,39
OTUKE,2017,380,370,750,39
OTUKE,2018,390,390,780,39
OTUKE,2019,410,400,810,39
OTUKE,2020,430,420,850,39
OTUKE,2021,450,440,890,39
OTUKE,2022,470,450,920,39
OTUKE,2023,490,470,960,39
OTUKE,2024,510,490,1000,39
OTUKE,2025,530,510,1040,39
OYAM,2015,1460,1590,3050,39
OYAM,2016,1510,1640,3150,39
OYAM,2017,1550,1690,3240,39
OYAM,2018,1600,1740,3340,39
OYAM,2019,1650,1790,3440,39
OYAM,2020,1700,1840,3540,39
OYAM,2021,1740,1890,3630,39
OYAM,2022,1790,1940,3730,39
OYAM,2023,1840,1990,3830,39
OYAM,2024,1890,2040,3930,39
OYAM,2025,1940,2090,4030,39
PADER,2015,600,650,1250,39
PADER,2016,610,680,1290,39
PADER,2017,620,700,1320,39
PADER,2018,640,720,1360,39
PADER,2019,640,750,1390,39
PADER,2020,660,770,1430,39
PADER,2021,680,800,1480,39
PADER,2022,700,830,1530,39
PADER,2023,720,850,1570,39
PADER,2024,740,880,1620,39
PADER,2025,760,910,1670,39
PAKWACH,2015,510,660,1170,39
PAKWACH,2016,540,680,1220,39
PAKWACH,2017,560,710,1270,39
PAKWACH,2018,580,730,1310,39
PAKWACH,2019,600,760,1360,39
PAKWACH,2020,630,790,1420,39
PAKWACH,2021,650,810,1460,39
PAKWACH,2022,680,840,1520,39
PAKWACH,2023,700,870,1570,39
PAKWACH,2024,730,890,1620,39
PAKWACH,2025,760,920,1680,39
PALLISA,2015,910,1140,2050,39
PALLISA,2016,950,1200,2150,39
PALLISA,2017,1000,1270,2270,39
PALLISA,2018,1050,1350,2400,39
PALLISA,2019,1110,1440,2550,39
PALLISA,2020,1170,1520,2690,39
PALLISA,2021,1240,1610,2850,39
PALLISA,2022,1300,1710,3010,39
PALLISA,2023,1380,1810,3190,39
PALLISA,2024,1450,1900,3350,39
PALLISA,2025,1530,2020,3550,39
RAKAI,2015,1050,1200,2250,39
RAKAI,2016,1070,1240,2310,39
RAKAI,2017,1100,1280,2380,39
RAKAI,2018,1150,1340,2490,39
RAKAI,2019,1180,1390,2570,39
RAKAI,2020,1230,1450,2680,39
RAKAI,2021,1270,1500,2770,39
RAKAI,2022,1320,1570,2890,39
RAKAI,2023,1350,1620,2970,39
RAKAI,2024,1400,1680,3080,39
RAKAI,2025,1450,1740,3190,39
RUBANDA,2015,630,900,1530,39
RUBANDA,2016,640,910,1550,39
RUBANDA,2017,650,910,1560,39
RUBANDA,2018,660,920,1580,39
RUBANDA,2019,670,930,1600,39
RUBANDA,2020,680,930,1610,39
RUBANDA,2021,680,940,1620,39
RUBANDA,2022,690,940,1630,39
RUBANDA,2023,700,950,1650,39
RUBANDA,2024,700,950,1650,39
RUBANDA,2025,710,950,1660,39
RUBIRIZI,2015,410,580,990,39
RUBIRIZI,2016,420,590,1010,39
RUBIRIZI,2017,430,600,1030,39
RUBIRIZI,2018,440,610,1050,39
RUBIRIZI,2019,450,620,1070,39
RUBIRIZI,2020,450,630,1080,39
RUBIRIZI,2021,460,640,1100,39
RUBIRIZI,2022,470,650,1120,39
RUBIRIZI,2023,480,660,1140,39
RUBIRIZI,2024,490,670,1160,39
RUBIRIZI,2025,490,680,1170,39
RUKIGA,2015,330,430,760,39
RUKIGA,2016,330,430,760,39
RUKIGA,2017,340,430,770,39
RUKIGA,2018,340,440,780,39
RUKIGA,2019,340,440,780,39
RUKIGA,2020,350,440,790,39
RUKIGA,2021,350,440,790,39
RUKIGA,2022,350,450,800,39
RUKIGA,2023,350,450,800,39
RUKIGA,2024,360,450,810,39
RUKIGA,2025,360,450,810,39
RUKUNGIRI,2015,1080,1450,2530,39
RUKUNGIRI,2016,1090,1460,2550,39
RUKUNGIRI,2017,1100,1480,2580,39
RUKUNGIRI,2018,1120,1490,2610,39
RUKUNGIRI,2019,1130,1500,2630,39
RUKUNGIRI,2020,1140,1520,2660,39
RUKUNGIRI,2021,1150,1530,2680,39
RUKUNGIRI,2022,1160,1540,2700,39
RUKUNGIRI,2023,1170,1550,2720,39
RUKUNGIRI,2024,1180,1560,2740,39
RUKUNGIRI,2025,1190,1570,2760,39
RWAMPARA,2015,390,480,870,39
RWAMPARA,2016,400,490,890,39
RWAMPARA,2017,410,500,910,39
RWAMPARA,2018,420,510,930,39
RWAMPARA,2019,430,520,950,39
RWAMPARA,2020,440,530,970,39
RWAMPARA,2021,450,540,990,39
RWAMPARA,2022,460,550,1010,39
RWAMPARA,2023,460,560,1020,39
RWAMPARA,2024,470,570,1040,39
RWAMPARA,2025,480,580,1060,39
SERERE,2015,1010,1120,2130,39
SERERE,2016,1040,1170,2210,39
SERERE,2017,1080,1240,2320,39
SERERE,2018,1130,1310,2440,39
SERERE,2019,1190,1390,2580,39
SERERE,2020,1270,1480,2750,39
SERERE,2021,1330,1550,2880,39
SERERE,2022,1390,1640,3030,39
SERERE,2023,1460,1720,3180,39
SERERE,2024,1530,1810,3340,39
SERERE,2025,1620,1910,3530,39
SHEEMA,2015,700,1000,1700,39
SHEEMA,2016,710,1010,1720,39
SHEEMA,2017,710,1020,1730,39
SHEEMA,2018,720,1030,1750,39
SHEEMA,2019,730,1040,1770,39
SHEEMA,2020,740,1050,1790,39
SHEEMA,2021,750,1060,1810,39
SHEEMA,2022,750,1070,1820,39
SHEEMA,2023,760,1080,1840,39
SHEEMA,2024,770,1080,1850,39
SHEEMA,2025,770,1090,1860,39
SIRONKO,2015,850,990,1840,39
SIRONKO,2016,870,1010,1880,39
SIRONKO,2017,890,1030,1920,39
SIRONKO,2018,910,1050,1960,39
SIRONKO,2019,930,1070,2000,39
SIRONKO,2020,950,1090,2040,39
SIRONKO,2021,970,1110,2080,39
SIRONKO,2022,990,1130,2120,39
SIRONKO,2023,1010,1150,2160,39
SIRONKO,2024,1030,1170,2200,39
SIRONKO,2025,1050,1190,2240,39
SOROTI,2015,1090,1210,2300,39
SOROTI,2016,1110,1260,2370,39
SOROTI,2017,1160,1320,2480,39
SOROTI,2018,1200,1390,2590,39
SOROTI,2019,1260,1470,2730,39
SOROTI,2020,1320,1550,2870,39
SOROTI,2021,1390,1630,3020,39
SOROTI,2022,1450,1710,3160,39
SOROTI,2023,1510,1800,3310,39
SOROTI,2024,1580,1880,3460,39
SOROTI,2025,1650,1960,3610,39
SSEMBABULE,2015,1030,1020,2050,39
SSEMBABULE,2016,1050,1060,2110,39
SSEMBABULE,2017,1090,1100,2190,39
SSEMBABULE,2018,1130,1150,2280,39
SSEMBABULE,2019,1180,1200,2380,39
SSEMBABULE,2020,1220,1260,2480,39
SSEMBABULE,2021,1270,1320,2590,39
SSEMBABULE,2022,1320,1370,2690,39
SSEMBABULE,2023,1370,1430,2800,39
SSEMBABULE,2024,1420,1480,2900,39
SSEMBABULE,2025,1480,1540,3020,39
TORORO,2015,1790,2290,4080,39
TORORO,2016,1840,2350,4190,39
TORORO,2017,1890,2410,4300,39
TORORO,2018,1940,2460,4400,39
TORORO,2019,1990,2520,4510,39
TORORO,2020,2040,2580,4620,39
TORORO,2021,2090,2640,4730,39
TORORO,2022,2140,2700,4840,39
TORORO,2023,2190,2760,4950,39
TORORO,2024,2240,2820,5060,39
TORORO,2025,2280,2870,5150,39
WAKISO,2015,8430,8540,16970,39
WAKISO,2016,9000,9120,18120,39
WAKISO,2017,9600,9750,19350,39
WAKISO,2018,10240,10400,20640,39
WAKISO,2019,10920,11100,22020,39
WAKISO,2020,11630,11840,23470,39
WAKISO,2021,12380,12630,25010,39
WAKISO,2022,13170,13460,26630,39
WAKISO,2023,14010,14320,28330,39
WAKISO,2024,14880,15240,30120,39
WAKISO,2025,15800,16210,32010,39
YUMBE,2015,1510,1620,3130,39
YUMBE,2016,1580,1720,3300,39
YUMBE,2017,1660,1850,3510,39
YUMBE,2018,1760,2000,3760,39
YUMBE,2019,1870,2160,4030,39
YUMBE,2020,1990,2320,4310,39
YUMBE,2021,2120,2500,4620,39
YUMBE,2022,2250,2700,4950,39
YUMBE,2023,2380,2900,5280,39
YUMBE,2024,2520,3100,5620,39
YUMBE,2025,2680,3320,6000,39
ZOMBO,2015,770,880,1650,39
ZOMBO,2016,790,910,1700,39
ZOMBO,2017,810,930,1740,39
ZOMBO,2018,840,960,1800,39
ZOMBO,2019,860,980,1840,39
ZOMBO,2020,890,1010,1900,39
ZOMBO,2021,920,1040,1960,39
ZOMBO,2022,940,1060,2000,39
ZOMBO,2023,970,1090,2060,39
ZOMBO,2024,990,1110,2100,39
ZOMBO,2025,1020,1140,2160,39
ABIM,2015,2250,2150,4400,4
ABIM,2016,2350,2230,4580,4
ABIM,2017,2470,2350,4820,4
ABIM,2018,2690,2530,5220,4
ABIM,2019,2810,2770,5580,4
ABIM,2020,2950,2920,5870,4
ABIM,2021,3110,3060,6170,4
ABIM,2022,3270,3210,6480,4
ABIM,2023,3430,3350,6780,4
ABIM,2024,3590,3520,7110,4
ABIM,2025,3760,3680,7440,4
ADJUMANI,2015,4570,4130,8700,4
ADJUMANI,2016,4610,4170,8780,4
ADJUMANI,2017,4640,4210,8850,4
ADJUMANI,2018,4670,4250,8920,4
ADJUMANI,2019,4710,4290,9000,4
ADJUMANI,2020,4730,4320,9050,4
ADJUMANI,2021,4760,4360,9120,4
ADJUMANI,2022,4780,4390,9170,4
ADJUMANI,2023,4800,4420,9220,4
ADJUMANI,2024,4810,4440,9250,4
ADJUMANI,2025,4820,4460,9280,4
AGAGO,2015,4490,4230,8720,4
AGAGO,2016,4570,4310,8880,4
AGAGO,2017,4650,4380,9030,4
AGAGO,2018,4730,4460,9190,4
AGAGO,2019,4810,4540,9350,4
AGAGO,2020,4890,4610,9500,4
AGAGO,2021,4960,4680,9640,4
AGAGO,2022,5030,4750,9780,4
AGAGO,2023,5100,4820,9920,4
AGAGO,2024,5170,4880,10050,4
AGAGO,2025,5230,4950,10180,4
ALEBTONG,2015,3790,3630,7420,4
ALEBTONG,2016,3830,3650,7480,4
ALEBTONG,2017,3910,3720,7630,4
ALEBTONG,2018,4100,3870,7970,4
ALEBTONG,2019,4130,4110,8240,4
ALEBTONG,2020,4200,4180,8380,4
ALEBTONG,2021,4260,4240,8500,4
ALEBTONG,2022,4330,4300,8630,4
ALEBTONG,2023,4380,4360,8740,4
ALEBTONG,2024,4440,4420,8860,4
ALEBTONG,2025,4500,4480,8980,4
AMOLATAR,2015,2530,2430,4960,4
AMOLATAR,2016,2540,2430,4970,4
AMOLATAR,2017,2590,2480,5070,4
AMOLATAR,2018,2710,2570,5280,4
AMOLATAR,2019,2730,2730,5460,4
AMOLATAR,2020,2770,2770,5540,4
AMOLATAR,2021,2810,2800,5610,4
AMOLATAR,2022,2840,2830,5670,4
AMOLATAR,2023,2880,2870,5750,4
AMOLATAR,2024,2920,2890,5810,4
AMOLATAR,2025,2940,2920,5860,4
AMUDAT,2015,2560,2450,5010,4
AMUDAT,2016,2600,2520,5120,4
AMUDAT,2017,2680,2610,5290,4
AMUDAT,2018,2860,2770,5630,4
AMUDAT,2019,2900,2990,5890,4
AMUDAT,2020,2990,3100,6090,4
AMUDAT,2021,3070,3210,6280,4
AMUDAT,2022,3140,3320,6460,4
AMUDAT,2023,3230,3430,6660,4
AMUDAT,2024,3300,3540,6840,4
AMUDAT,2025,3390,3650,7040,4
AMURIA,2015,3450,3180,6630,4
AMURIA,2016,3510,3230,6740,4
AMURIA,2017,3610,3310,6920,4
AMURIA,2018,3820,3480,7300,4
AMURIA,2019,3890,3720,7610,4
AMURIA,2020,3990,3810,7800,4
AMURIA,2021,4090,3900,7990,4
AMURIA,2022,4190,3990,8180,4
AMURIA,2023,4290,4070,8360,4
AMURIA,2024,4370,4150,8520,4
AMURIA,2025,4470,4240,8710,4
AMURU,2015,3330,3240,6570,4
AMURU,2016,3350,3250,6600,4
AMURU,2017,3420,3310,6730,4
AMURU,2018,3580,3440,7020,4
AMURU,2019,3600,3660,7260,4
AMURU,2020,3650,3720,7370,4
AMURU,2021,3700,3770,7470,4
AMURU,2022,3750,3830,7580,4
AMURU,2023,3790,3880,7670,4
AMURU,2024,3830,3920,7750,4
AMURU,2025,3880,3960,7840,4
APAC,2015,3420,3120,6540,4
APAC,2016,3550,3230,6780,4
APAC,2017,3680,3350,7030,4
APAC,2018,3820,3460,7280,4
APAC,2019,3950,3580,7530,4
APAC,2020,4090,3700,7790,4
APAC,2021,4230,3820,8050,4
APAC,2022,4380,3940,8320,4
APAC,2023,4520,4060,8580,4
APAC,2024,4670,4190,8860,4
APAC,2025,4810,4310,9120,4
ARUA,2015,11220,10480,21700,4
ARUA,2016,11560,10760,22320,4
ARUA,2017,11880,11060,22940,4
ARUA,2018,12220,11350,23570,4
ARUA,2019,12570,11650,24220,4
ARUA,2020,12900,11950,24850,4
ARUA,2021,13260,12240,25500,4
ARUA,2022,13590,12540,26130,4
ARUA,2023,13940,12850,26790,4
ARUA,2024,14280,13150,27430,4
ARUA,2025,14620,13440,28060,4
BUDAKA,2015,3970,3790,7760,4
BUDAKA,2016,4030,3850,7880,4
BUDAKA,2017,4140,3940,8080,4
BUDAKA,2018,4380,4130,8510,4
BUDAKA,2019,4450,4420,8870,4
BUDAKA,2020,4560,4520,9080,4
BUDAKA,2021,4670,4620,9290,4
BUDAKA,2022,4770,4730,9500,4
BUDAKA,2023,4880,4830,9710,4
BUDAKA,2024,4970,4920,9890,4
BUDAKA,2025,5070,5010,10080,4
BUDUDA,2015,3920,3790,7710,4
BUDUDA,2016,4010,3890,7900,4
BUDUDA,2017,4160,4030,8190,4
BUDUDA,2018,4440,4270,8710,4
BUDUDA,2019,4550,4610,9160,4
BUDUDA,2020,4700,4760,9460,4
BUDUDA,2021,4860,4930,9790,4
BUDUDA,2022,5010,5090,10100,4
BUDUDA,2023,5170,5240,10410,4
BUDUDA,2024,5320,5400,10720,4
BUDUDA,2025,5480,5560,11040,4
BUGIRI,2015,7640,7170,14810,4
BUGIRI,2016,7780,7300,15080,4
BUGIRI,2017,8050,7520,15570,4
BUGIRI,2018,8560,7930,16490,4
BUGIRI,2019,8730,8520,17250,4
BUGIRI,2020,8990,8750,17740,4
BUGIRI,2021,9250,9000,18250,4
BUGIRI,2022,9510,9240,18750,4
BUGIRI,2023,9750,9470,19220,4
BUGIRI,2024,10000,9700,19700,4
BUGIRI,2025,10260,9950,20210,4
BUGWERI,2015,3210,2930,6140,4
BUGWERI,2016,3230,2940,6170,4
BUGWERI,2017,3300,2990,6290,4
BUGWERI,2018,3460,3120,6580,4
BUGWERI,2019,3480,3300,6780,4
BUGWERI,2020,3540,3350,6890,4
BUGWERI,2021,3590,3400,6990,4
BUGWERI,2022,3640,3440,7080,4
BUGWERI,2023,3690,3490,7180,4
BUGWERI,2024,3730,3530,7260,4
BUGWERI,2025,3780,3570,7350,4
BUHWEJU,2015,2320,2160,4480,4
BUHWEJU,2016,2390,2220,4610,4
BUHWEJU,2017,2470,2290,4760,4
BUHWEJU,2018,2550,2360,4910,4
BUHWEJU,2019,2630,2430,5060,4
BUHWEJU,2020,2710,2500,5210,4
BUHWEJU,2021,2790,2570,5360,4
BUHWEJU,2022,2880,2640,5520,4
BUHWEJU,2023,2960,2720,5680,4
BUHWEJU,2024,3040,2790,5830,4
BUHWEJU,2025,3130,2860,5990,4
BUIKWE,2015,7340,6800,14140,4
BUIKWE,2016,7340,6800,14140,4
BUIKWE,2017,7430,6880,14310,4
BUIKWE,2018,7740,7120,14860,4
BUIKWE,2019,7740,7500,15240,4
BUIKWE,2020,7800,7580,15380,4
BUIKWE,2021,7870,7650,15520,4
BUIKWE,2022,7930,7710,15640,4
BUIKWE,2023,7970,7770,15740,4
BUIKWE,2024,8010,7820,15830,4
BUIKWE,2025,8050,7860,15910,4
BUKEDEA,2015,3870,3580,7450,4
BUKEDEA,2016,3960,3650,7610,4
BUKEDEA,2017,4110,3770,7880,4
BUKEDEA,2018,4380,3980,8360,4
BUKEDEA,2019,4480,4290,8770,4
BUKEDEA,2020,4620,4410,9030,4
BUKEDEA,2021,4770,4540,9310,4
BUKEDEA,2022,4920,4680,9600,4
BUKEDEA,2023,5070,4810,9880,4
BUKEDEA,2024,5210,4930,10140,4
BUKEDEA,2025,5360,5070,10430,4
BUKOMANSIMBI,2015,2760,2430,5190,4
BUKOMANSIMBI,2016,2720,2390,5110,4
BUKOMANSIMBI,2017,2720,2390,5110,4
BUKOMANSIMBI,2018,2800,2430,5230,4
BUKOMANSIMBI,2019,2760,2530,5290,4
BUKOMANSIMBI,2020,2750,2500,5250,4
BUKOMANSIMBI,2021,2740,2490,5230,4
BUKOMANSIMBI,2022,2730,2470,5200,4
BUKOMANSIMBI,2023,2720,2460,5180,4
BUKOMANSIMBI,2024,2690,2430,5120,4
BUKOMANSIMBI,2025,2670,2410,5080,4
BUKWO,2015,1830,1670,3500,4
BUKWO,2016,1930,1750,3680,4
BUKWO,2017,2030,1840,3870,4
BUKWO,2018,2140,1930,4070,4
BUKWO,2019,2250,2020,4270,4
BUKWO,2020,2370,2120,4490,4
BUKWO,2021,2490,2210,4700,4
BUKWO,2022,2620,2320,4940,4
BUKWO,2023,2750,2420,5170,4
BUKWO,2024,2880,2530,5410,4
BUKWO,2025,3020,2640,5660,4
BULAMBULI,2015,3260,3030,6290,4
BULAMBULI,2016,3350,3120,6470,4
BULAMBULI,2017,3500,3250,6750,4
BULAMBULI,2018,3750,3450,7200,4
BULAMBULI,2019,3850,3740,7590,4
BULAMBULI,2020,4000,3890,7890,4
BULAMBULI,2021,4140,4030,8170,4
BULAMBULI,2022,4290,4180,8470,4
BULAMBULI,2023,4440,4330,8770,4
BULAMBULI,2024,4590,4480,9070,4
BULAMBULI,2025,4750,4640,9390,4
BULIISA,2015,2220,2030,4250,4
BULIISA,2016,2340,2120,4460,4
BULIISA,2017,2470,2210,4680,4
BULIISA,2018,2610,2310,4920,4
BULIISA,2019,2740,2410,5150,4
BULIISA,2020,2890,2510,5400,4
BULIISA,2021,3040,2620,5660,4
BULIISA,2022,3190,2730,5920,4
BULIISA,2023,3350,2840,6190,4
BULIISA,2024,3520,2950,6470,4
BULIISA,2025,3690,3070,6760,4
BUNDIBUGYO,2015,4320,4090,8410,4
BUNDIBUGYO,2016,4360,4120,8480,4
BUNDIBUGYO,2017,4460,4200,8660,4
BUNDIBUGYO,2018,4690,4380,9070,4
BUNDIBUGYO,2019,4730,4640,9370,4
BUNDIBUGYO,2020,4820,4730,9550,4
BUNDIBUGYO,2021,4900,4800,9700,4
BUNDIBUGYO,2022,4990,4870,9860,4
BUNDIBUGYO,2023,5060,4940,10000,4
BUNDIBUGYO,2024,5130,5010,10140,4
BUNDIBUGYO,2025,5200,5070,10270,4
BUNYANGABU,2015,3110,2860,5970,4
BUNYANGABU,2016,3120,2870,5990,4
BUNYANGABU,2017,3180,2910,6090,4
BUNYANGABU,2018,3330,3020,6350,4
BUNYANGABU,2019,3350,3190,6540,4
BUNYANGABU,2020,3390,3230,6620,4
BUNYANGABU,2021,3440,3270,6710,4
BUNYANGABU,2022,3480,3300,6780,4
BUNYANGABU,2023,3520,3330,6850,4
BUNYANGABU,2024,3550,3360,6910,4
BUNYANGABU,2025,3590,3380,6970,4
BUSHENYI,2015,3710,3400,7110,4
BUSHENYI,2016,3760,3430,7190,4
BUSHENYI,2017,3800,3460,7260,4
BUSHENYI,2018,3850,3500,7350,4
BUSHENYI,2019,3890,3520,7410,4
BUSHENYI,2020,3930,3550,7480,4
BUSHENYI,2021,3970,3570,7540,4
BUSHENYI,2022,4010,3600,7610,4
BUSHENYI,2023,4040,3620,7660,4
BUSHENYI,2024,4070,3640,7710,4
BUSHENYI,2025,4100,3650,7750,4
BUSIA,2015,5530,5280,10810,4
BUSIA,2016,5580,5330,10910,4
BUSIA,2017,5720,5430,11150,4
BUSIA,2018,6020,5670,11690,4
BUSIA,2019,6080,6040,12120,4
BUSIA,2020,6210,6150,12360,4
BUSIA,2021,6330,6250,12580,4
BUSIA,2022,6440,6360,12800,4
BUSIA,2023,6550,6460,13010,4
BUSIA,2024,6660,6550,13210,4
BUSIA,2025,6760,6640,13400,4
BUTALEJA,2015,4860,4590,9450,4
BUTALEJA,2016,4930,4670,9600,4
BUTALEJA,2017,5090,4790,9880,4
BUTALEJA,2018,5390,5030,10420,4
BUTALEJA,2019,5480,5380,10860,4
BUTALEJA,2020,5620,5530,11150,4
BUTALEJA,2021,5770,5660,11430,4
BUTALEJA,2022,5910,5790,11700,4
BUTALEJA,2023,6040,5920,11960,4
BUTALEJA,2024,6180,6040,12220,4
BUTALEJA,2025,6310,6170,12480,4
BUTAMBALA,2015,1970,1770,3740,4
BUTAMBALA,2016,1950,1750,3700,4
BUTAMBALA,2017,1970,1750,3720,4
BUTAMBALA,2018,2040,1800,3840,4
BUTAMBALA,2019,2020,1880,3900,4
BUTAMBALA,2020,2030,1870,3900,4
BUTAMBALA,2021,2030,1880,3910,4
BUTAMBALA,2022,2030,1880,3910,4
BUTAMBALA,2023,2030,1870,3900,4
BUTAMBALA,2024,2030,1860,3890,4
BUTAMBALA,2025,2030,1860,3890,4
BUTEBO,2015,2160,1980,4140,4
BUTEBO,2016,2150,1970,4120,4
BUTEBO,2017,2160,1980,4140,4
BUTEBO,2018,2240,2040,4280,4
BUTEBO,2019,2230,2130,4360,4
BUTEBO,2020,2240,2140,4380,4
BUTEBO,2021,2250,2140,4390,4
BUTEBO,2022,2260,2150,4410,4
BUTEBO,2023,2260,2140,4400,4
BUTEBO,2024,2260,2140,4400,4
BUTEBO,2025,2260,2140,4400,4
BUVUMA,2015,1770,1580,3350,4
BUVUMA,2016,1880,1690,3570,4
BUVUMA,2017,1990,1810,3800,4
BUVUMA,2018,2110,1930,4040,4
BUVUMA,2019,2240,2060,4300,4
BUVUMA,2020,2380,2190,4570,4
BUVUMA,2021,2520,2340,4860,4
BUVUMA,2022,2670,2480,5150,4
BUVUMA,2023,2820,2640,5460,4
BUVUMA,2024,2980,2810,5790,4
BUVUMA,2025,3150,2990,6140,4
BUYENDE,2015,6840,6580,13420,4
BUYENDE,2016,7000,6730,13730,4
BUYENDE,2017,7250,6960,14210,4
BUYENDE,2018,7740,7370,15110,4
BUYENDE,2019,7920,7950,15870,4
BUYENDE,2020,8190,8210,16400,4
BUYENDE,2021,8450,8470,16920,4
BUYENDE,2022,8720,8730,17450,4
BUYENDE,2023,8980,9000,17980,4
BUYENDE,2024,9240,9240,18480,4
BUYENDE,2025,9510,9520,19030,4
DOKOLO,2015,3300,3190,6490,4
DOKOLO,2016,3410,3280,6690,4
DOKOLO,2017,3510,3370,6880,4
DOKOLO,2018,3610,3460,7070,4
DOKOLO,2019,3720,3560,7280,4
DOKOLO,2020,3830,3650,7480,4
DOKOLO,2021,3940,3740,7680,4
DOKOLO,2022,4050,3830,7880,4
DOKOLO,2023,4150,3930,8080,4
DOKOLO,2024,4260,4020,8280,4
DOKOLO,2025,4370,4110,8480,4
GOMBA,2015,2890,2500,5390,4
GOMBA,2016,2870,2490,5360,4
GOMBA,2017,2900,2490,5390,4
GOMBA,2018,3020,2560,5580,4
GOMBA,2019,3000,2680,5680,4
GOMBA,2020,3020,2680,5700,4
GOMBA,2021,3030,2690,5720,4
GOMBA,2022,3050,2680,5730,4
GOMBA,2023,3050,2680,5730,4
GOMBA,2024,3060,2680,5740,4
GOMBA,2025,3070,2670,5740,4
GULU,2015,4580,4380,8960,4
GULU,2016,4720,4510,9230,4
GULU,2017,4860,4640,9500,4
GULU,2018,5000,4770,9770,4
GULU,2019,5150,4910,10060,4
GULU,2020,5300,5050,10350,4
GULU,2021,5450,5180,10630,4
GULU,2022,5600,5320,10920,4
GULU,2023,5740,5460,11200,4
GULU,2024,5890,5590,11480,4
GULU,2025,6040,5730,11770,4
HOIMA,2015,5570,5110,10680,4
HOIMA,2016,5780,5290,11070,4
HOIMA,2017,6000,5480,11480,4
HOIMA,2018,6220,5660,11880,4
HOIMA,2019,6450,5850,12300,4
HOIMA,2020,6690,6050,12740,4
HOIMA,2021,6920,6250,13170,4
HOIMA,2022,7160,6450,13610,4
HOIMA,2023,7400,6650,14050,4
HOIMA,2024,7650,6850,14500,4
HOIMA,2025,7900,7060,14960,4
IBANDA,2015,4230,4090,8320,4
IBANDA,2016,4320,4160,8480,4
IBANDA,2017,4400,4230,8630,4
IBANDA,2018,4490,4310,8800,4
IBANDA,2019,4570,4390,8960,4
IBANDA,2020,4660,4460,9120,4
IBANDA,2021,4740,4530,9270,4
IBANDA,2022,4820,4600,9420,4
IBANDA,2023,4900,4670,9570,4
IBANDA,2024,4970,4730,9700,4
IBANDA,2025,5040,4790,9830,4
IGANGA,2015,6000,5600,11600,4
IGANGA,2016,6060,5650,11710,4
IGANGA,2017,6200,5760,11960,4
IGANGA,2018,6530,6010,12540,4
IGANGA,2019,6610,6400,13010,4
IGANGA,2020,6740,6510,13250,4
IGANGA,2021,6870,6630,13500,4
IGANGA,2022,6990,6740,13730,4
IGANGA,2023,7110,6840,13950,4
IGANGA,2024,7220,6950,14170,4
IGANGA,2025,7340,7050,14390,4
ISINGIRO,2015,9490,8970,18460,4
ISINGIRO,2016,9850,9290,19140,4
ISINGIRO,2017,10220,9610,19830,4
ISINGIRO,2018,10600,9950,20550,4
ISINGIRO,2019,10980,10290,21270,4
ISINGIRO,2020,11370,10640,22010,4
ISINGIRO,2021,11770,10990,22760,4
ISINGIRO,2022,12180,11350,23530,4
ISINGIRO,2023,12590,11700,24290,4
ISINGIRO,2024,13000,12070,25070,4
ISINGIRO,2025,13420,12440,25860,4
JINJA,2015,8160,7480,15640,4
JINJA,2016,8310,7600,15910,4
JINJA,2017,8450,7720,16170,4
JINJA,2018,8580,7830,16410,4
JINJA,2019,8720,7950,16670,4
JINJA,2020,8850,8060,16910,4
JINJA,2021,8980,8170,17150,4
JINJA,2022,9100,8270,17370,4
JINJA,2023,9220,8370,17590,4
JINJA,2024,9340,8460,17800,4
JINJA,2025,9440,8550,17990,4
KAABONG,2015,2220,1920,4140,4
KAABONG,2016,2280,1970,4250,4
KAABONG,2017,2350,2020,4370,4
KAABONG,2018,2400,2070,4470,4
KAABONG,2019,2470,2110,4580,4
KAABONG,2020,2520,2170,4690,4
KAABONG,2021,2600,2210,4810,4
KAABONG,2022,2660,2270,4930,4
KAABONG,2023,2720,2310,5030,4
KAABONG,2024,2780,2350,5130,4
KAABONG,2025,2840,2400,5240,4
KABALE,2015,3590,3400,6990,4
KABALE,2016,3650,3440,7090,4
KABALE,2017,3710,3490,7200,4
KABALE,2018,3760,3530,7290,4
KABALE,2019,3820,3560,7380,4
KABALE,2020,3870,3600,7470,4
KABALE,2021,3930,3640,7570,4
KABALE,2022,3970,3670,7640,4
KABALE,2023,4020,3700,7720,4
KABALE,2024,4070,3740,7810,4
KABALE,2025,4110,3760,7870,4
KABAROLE,2015,5320,4890,10210,4
KABAROLE,2016,5440,5000,10440,4
KABAROLE,2017,5560,5110,10670,4
KABAROLE,2018,5680,5220,10900,4
KABAROLE,2019,5800,5330,11130,4
KABAROLE,2020,5920,5430,11350,4
KABAROLE,2021,6040,5540,11580,4
KABAROLE,2022,6150,5640,11790,4
KABAROLE,2023,6270,5750,12020,4
KABAROLE,2024,6370,5850,12220,4
KABAROLE,2025,6480,5950,12430,4
KABERAMAIDO,2015,1830,1780,3610,4
KABERAMAIDO,2016,1870,1800,3670,4
KABERAMAIDO,2017,1930,1860,3790,4
KABERAMAIDO,2018,2050,1960,4010,4
KABERAMAIDO,2019,2100,2110,4210,4
KABERAMAIDO,2020,2170,2160,4330,4
KABERAMAIDO,2021,2240,2230,4470,4
KABERAMAIDO,2022,2300,2290,4590,4
KABERAMAIDO,2023,2360,2350,4710,4
KABERAMAIDO,2024,2440,2410,4850,4
KABERAMAIDO,2025,2490,2470,4960,4
KAGADI,2015,7120,6880,14000,4
KAGADI,2016,7380,7120,14500,4
KAGADI,2017,7660,7380,15040,4
KAGADI,2018,7940,7640,15580,4
KAGADI,2019,8220,7900,16120,4
KAGADI,2020,8510,8170,16680,4
KAGADI,2021,8810,8440,17250,4
KAGADI,2022,9110,8710,17820,4
KAGADI,2023,9420,8990,18410,4
KAGADI,2024,9720,9270,18990,4
KAGADI,2025,10030,9560,19590,4
KAKUMIRO,2015,6240,5730,11970,4
KAKUMIRO,2016,6790,6210,13000,4
KAKUMIRO,2017,7390,6730,14120,4
KAKUMIRO,2018,8050,7290,15340,4
KAKUMIRO,2019,8750,7900,16650,4
KAKUMIRO,2020,9510,8550,18060,4
KAKUMIRO,2021,10330,9260,19590,4
KAKUMIRO,2022,11210,10010,21220,4
KAKUMIRO,2023,12160,10820,22980,4
KAKUMIRO,2024,13180,11680,24860,4
KAKUMIRO,2025,14270,12610,26880,4
KALAKI,2015,2080,2060,4140,4
KALAKI,2016,2180,2140,4320,4
KALAKI,2017,2270,2230,4500,4
KALAKI,2018,2370,2310,4680,4
KALAKI,2019,2460,2400,4860,4
KALAKI,2020,2570,2500,5070,4
KALAKI,2021,2680,2590,5270,4
KALAKI,2022,2780,2680,5460,4
KALAKI,2023,2890,2780,5670,4
KALAKI,2024,3000,2880,5880,4
KALAKI,2025,3120,2980,6100,4
KALANGALA,2015,750,710,1460,4
KALANGALA,2016,770,740,1510,4
KALANGALA,2017,800,770,1570,4
KALANGALA,2018,830,800,1630,4
KALANGALA,2019,860,840,1700,4
KALANGALA,2020,890,870,1760,4
KALANGALA,2021,920,900,1820,4
KALANGALA,2022,950,940,1890,4
KALANGALA,2023,980,970,1950,4
KALANGALA,2024,1010,1010,2020,4
KALANGALA,2025,1040,1050,2090,4
KALIRO,2015,4730,4440,9170,4
KALIRO,2016,4790,4490,9280,4
KALIRO,2017,4920,4610,9530,4
KALIRO,2018,5210,4840,10050,4
KALIRO,2019,5290,5180,10470,4
KALIRO,2020,5420,5310,10730,4
KALIRO,2021,5540,5430,10970,4
KALIRO,2022,5670,5560,11230,4
KALIRO,2023,5790,5680,11470,4
KALIRO,2024,5900,5800,11700,4
KALIRO,2025,6020,5910,11930,4
KALUNGU,2015,3230,3010,6240,4
KALUNGU,2016,3200,2990,6190,4
KALUNGU,2017,3220,2990,6210,4
KALUNGU,2018,3310,3060,6370,4
KALUNGU,2019,3290,3200,6490,4
KALUNGU,2020,3280,3190,6470,4
KALUNGU,2021,3280,3190,6470,4
KALUNGU,2022,3270,3180,6450,4
KALUNGU,2023,3260,3170,6430,4
KALUNGU,2024,3250,3160,6410,4
KALUNGU,2025,3240,3150,6390,4
KAMPALA,2015,20630,19160,39790,4
KAMPALA,2016,21040,19540,40580,4
KAMPALA,2017,21450,19920,41370,4
KAMPALA,2018,21870,20290,42160,4
KAMPALA,2019,22280,20670,42950,4
KAMPALA,2020,22680,21040,43720,4
KAMPALA,2021,23080,21410,44490,4
KAMPALA,2022,23470,21760,45230,4
KAMPALA,2023,23850,22110,45960,4
KAMPALA,2024,24210,22450,46660,4
KAMPALA,2025,24560,22780,47340,4
KAMULI,2015,9260,8530,17790,4
KAMULI,2016,9300,8550,17850,4
KAMULI,2017,9480,8670,18150,4
KAMULI,2018,9930,8990,18920,4
KAMULI,2019,9990,9510,19500,4
KAMULI,2020,10130,9630,19760,4
KAMULI,2021,10270,9740,20010,4
KAMULI,2022,10400,9840,20240,4
KAMULI,2023,10530,9940,20470,4
KAMULI,2024,10640,10020,20660,4
KAMULI,2025,10750,10110,20860,4
KAMWENGE,2015,5540,5210,10750,4
KAMWENGE,2016,5770,5400,11170,4
KAMWENGE,2017,6000,5590,11590,4
KAMWENGE,2018,6250,5780,12030,4
KAMWENGE,2019,6500,5990,12490,4
KAMWENGE,2020,6740,6190,12930,4
KAMWENGE,2021,7010,6390,13400,4
KAMWENGE,2022,7270,6600,13870,4
KAMWENGE,2023,7530,6820,14350,4
KAMWENGE,2024,7810,7040,14850,4
KAMWENGE,2025,8090,7250,15340,4
KANUNGU,2015,4400,4320,8720,4
KANUNGU,2016,4480,4390,8870,4
KANUNGU,2017,4560,4460,9020,4
KANUNGU,2018,4640,4530,9170,4
KANUNGU,2019,4720,4600,9320,4
KANUNGU,2020,4800,4670,9470,4
KANUNGU,2021,4870,4730,9600,4
KANUNGU,2022,4950,4800,9750,4
KANUNGU,2023,5020,4860,9880,4
KANUNGU,2024,5090,4920,10010,4
KANUNGU,2025,5150,4980,10130,4
KAPCHORWA,2015,1840,1650,3490,4
KAPCHORWA,2016,1890,1690,3580,4
KAPCHORWA,2017,1950,1740,3690,4
KAPCHORWA,2018,2010,1790,3800,4
KAPCHORWA,2019,2070,1830,3900,4
KAPCHORWA,2020,2130,1880,4010,4
KAPCHORWA,2021,2190,1930,4120,4
KAPCHORWA,2022,2250,1980,4230,4
KAPCHORWA,2023,2310,2030,4340,4
KAPCHORWA,2024,2370,2080,4450,4
KAPCHORWA,2025,2430,2120,4550,4
KAPELEBYONG,2015,1620,1570,3190,4
KAPELEBYONG,2016,1640,1590,3230,4
KAPELEBYONG,2017,1680,1620,3300,4
KAPELEBYONG,2018,1760,1680,3440,4
KAPELEBYONG,2019,1790,1790,3580,4
KAPELEBYONG,2020,1820,1820,3640,4
KAPELEBYONG,2021,1850,1850,3700,4
KAPELEBYONG,2022,1890,1880,3770,4
KAPELEBYONG,2023,1920,1910,3830,4
KAPELEBYONG,2024,1960,1930,3890,4
KAPELEBYONG,2025,1990,1960,3950,4
KASESE,2015,12710,11930,24640,4
KASESE,2016,12750,11950,24700,4
KASESE,2017,12970,12110,25080,4
KASESE,2018,13570,12560,26130,4
KASESE,2019,13630,13280,26910,4
KASESE,2020,13800,13420,27220,4
KASESE,2021,13970,13580,27550,4
KASESE,2022,14130,13710,27840,4
KASESE,2023,14270,13840,28110,4
KASESE,2024,14400,13950,28350,4
KASESE,2025,14540,14060,28600,4
KASSANDA,2015,5130,4720,9850,4
KASSANDA,2016,5280,4820,10100,4
KASSANDA,2017,5430,4920,10350,4
KASSANDA,2018,5580,5030,10610,4
KASSANDA,2019,5730,5130,10860,4
KASSANDA,2020,5890,5240,11130,4
KASSANDA,2021,6050,5340,11390,4
KASSANDA,2022,6200,5440,11640,4
KASSANDA,2023,6350,5540,11890,4
KASSANDA,2024,6510,5630,12140,4
KASSANDA,2025,6660,5730,12390,4
KATAKWI,2015,2840,2610,5450,4
KATAKWI,2016,2860,2630,5490,4
KATAKWI,2017,2930,2680,5610,4
KATAKWI,2018,3080,2780,5860,4
KATAKWI,2019,3100,2950,6050,4
KATAKWI,2020,3170,2990,6160,4
KATAKWI,2021,3210,3030,6240,4
KATAKWI,2022,3270,3080,6350,4
KATAKWI,2023,3320,3110,6430,4
KATAKWI,2024,3370,3160,6530,4
KATAKWI,2025,3410,3190,6600,4
KAYUNGA,2015,6860,6160,13020,4
KAYUNGA,2016,6850,6130,12980,4
KAYUNGA,2017,6930,6180,13110,4
KAYUNGA,2018,7220,6380,13600,4
KAYUNGA,2019,7210,6700,13910,4
KAYUNGA,2020,7260,6740,14000,4
KAYUNGA,2021,7320,6770,14090,4
KAYUNGA,2022,7370,6820,14190,4
KAYUNGA,2023,7410,6830,14240,4
KAYUNGA,2024,7440,6850,14290,4
KAYUNGA,2025,7470,6870,14340,4
KAZO,2015,3240,3040,6280,4
KAZO,2016,3370,3140,6510,4
KAZO,2017,3500,3260,6760,4
KAZO,2018,3620,3370,6990,4
KAZO,2019,3760,3490,7250,4
KAZO,2020,3890,3610,7500,4
KAZO,2021,4030,3720,7750,4
KAZO,2022,4170,3840,8010,4
KAZO,2023,4320,3970,8290,4
KAZO,2024,4470,4100,8570,4
KAZO,2025,4610,4220,8830,4
KIBAALE,2015,2950,2830,5780,4
KIBAALE,2016,3140,3000,6140,4
KIBAALE,2017,3340,3170,6510,4
KIBAALE,2018,3550,3350,6900,4
KIBAALE,2019,3780,3540,7320,4
KIBAALE,2020,4010,3740,7750,4
KIBAALE,2021,4260,3950,8210,4
KIBAALE,2022,4510,4170,8680,4
KIBAALE,2023,4790,4400,9190,4
KIBAALE,2024,5070,4630,9700,4
KIBAALE,2025,5360,4880,10240,4
KIBOGA,2015,2490,2330,4820,4
KIBOGA,2016,2500,2340,4840,4
KIBOGA,2017,2560,2380,4940,4
KIBOGA,2018,2670,2470,5140,4
KIBOGA,2019,2690,2610,5300,4
KIBOGA,2020,2740,2640,5380,4
KIBOGA,2021,2770,2680,5450,4
KIBOGA,2022,2810,2710,5520,4
KIBOGA,2023,2850,2750,5600,4
KIBOGA,2024,2870,2770,5640,4
KIBOGA,2025,2910,2790,5700,4
KIBUKU,2015,4040,3810,7850,4
KIBUKU,2016,4110,3870,7980,4
KIBUKU,2017,4250,3990,8240,4
KIBUKU,2018,4500,4190,8690,4
KIBUKU,2019,4590,4490,9080,4
KIBUKU,2020,4710,4610,9320,4
KIBUKU,2021,4840,4730,9570,4
KIBUKU,2022,4960,4850,9810,4
KIBUKU,2023,5080,4970,10050,4
KIBUKU,2024,5200,5080,10280,4
KIBUKU,2025,5320,5190,10510,4
KIKUUBE,2015,5410,5060,10470,4
KIKUUBE,2016,5700,5320,11020,4
KIKUUBE,2017,6000,5590,11590,4
KIKUUBE,2018,6320,5870,12190,4
KIKUUBE,2019,6650,6160,12810,4
KIKUUBE,2020,7000,6470,13470,4
KIKUUBE,2021,7360,6790,14150,4
KIKUUBE,2022,7730,7110,14840,4
KIKUUBE,2023,8110,7450,15560,4
KIKUUBE,2024,8510,7800,16310,4
KIKUUBE,2025,8920,8160,17080,4
KIRUHURA,2015,2600,2350,4950,4
KIRUHURA,2016,2700,2430,5130,4
KIRUHURA,2017,2800,2520,5320,4
KIRUHURA,2018,2910,2600,5510,4
KIRUHURA,2019,3010,2690,5700,4
KIRUHURA,2020,3130,2780,5910,4
KIRUHURA,2021,3240,2880,6120,4
KIRUHURA,2022,3350,2980,6330,4
KIRUHURA,2023,3470,3070,6540,4
KIRUHURA,2024,3580,3160,6740,4
KIRUHURA,2025,3690,3260,6950,4
KIRYANDONGO,2015,5000,4460,9460,4
KIRYANDONGO,2016,5040,4490,9530,4
KIRYANDONGO,2017,5170,4570,9740,4
KIRYANDONGO,2018,5430,4770,10200,4
KIRYANDONGO,2019,5480,5060,10540,4
KIRYANDONGO,2020,5590,5150,10740,4
KIRYANDONGO,2021,5690,5240,10930,4
KIRYANDONGO,2022,5790,5320,11110,4
KIRYANDONGO,2023,5880,5390,11270,4
KIRYANDONGO,2024,5970,5460,11430,4
KIRYANDONGO,2025,6060,5530,11590,4
KISORO,2015,5000,4710,9710,4
KISORO,2016,4990,4720,9710,4
KISORO,2017,5050,4770,9820,4
KISORO,2018,5250,4940,10190,4
KISORO,2019,5260,5210,10470,4
KISORO,2020,5300,5260,10560,4
KISORO,2021,5340,5300,10640,4
KISORO,2022,5380,5340,10720,4
KISORO,2023,5410,5390,10800,4
KISORO,2024,5430,5410,10840,4
KISORO,2025,5460,5450,10910,4
KITAGWENDA,2015,2790,2690,5480,4
KITAGWENDA,2016,2910,2780,5690,4
KITAGWENDA,2017,3030,2880,5910,4
KITAGWENDA,2018,3150,2990,6140,4
KITAGWENDA,2019,3270,3090,6360,4
KITAGWENDA,2020,3400,3200,6600,4
KITAGWENDA,2021,3530,3310,6840,4
KITAGWENDA,2022,3660,3410,7070,4
KITAGWENDA,2023,3800,3520,7320,4
KITAGWENDA,2024,3930,3630,7560,4
KITAGWENDA,2025,4070,3740,7810,4
KITGUM,2015,3460,3190,6650,4
KITGUM,2016,3440,3170,6610,4
KITGUM,2017,3470,3190,6660,4
KITGUM,2018,3610,3290,6900,4
KITGUM,2019,3590,3460,7050,4
KITGUM,2020,3610,3480,7090,4
KITGUM,2021,3620,3490,7110,4
KITGUM,2022,3630,3500,7130,4
KITGUM,2023,3640,3520,7160,4
KITGUM,2024,3650,3530,7180,4
KITGUM,2025,3650,3530,7180,4
KOBOKO,2015,4020,3590,7610,4
KOBOKO,2016,4090,3650,7740,4
KOBOKO,2017,4220,3760,7980,4
KOBOKO,2018,4490,3950,8440,4
KOBOKO,2019,4580,4240,8820,4
KOBOKO,2020,4710,4370,9080,4
KOBOKO,2021,4840,4490,9330,4
KOBOKO,2022,4970,4610,9580,4
KOBOKO,2023,5090,4720,9810,4
KOBOKO,2024,5210,4820,10030,4
KOBOKO,2025,5350,4940,10290,4
KOLE,2015,4350,4120,8470,4
KOLE,2016,4500,4240,8740,4
KOLE,2017,4640,4360,9000,4
KOLE,2018,4800,4480,9280,4
KOLE,2019,4950,4610,9560,4
KOLE,2020,5100,4730,9830,4
KOLE,2021,5260,4860,10120,4
KOLE,2022,5410,4990,10400,4
KOLE,2023,5570,5120,10690,4
KOLE,2024,5730,5240,10970,4
KOLE,2025,5880,5370,11250,4
KOTIDO,2015,3910,3920,7830,4
KOTIDO,2016,3930,3930,7860,4
KOTIDO,2017,4000,3980,7980,4
KOTIDO,2018,4180,4130,8310,4
KOTIDO,2019,4200,4360,8560,4
KOTIDO,2020,4250,4410,8660,4
KOTIDO,2021,4300,4460,8760,4
KOTIDO,2022,4350,4500,8850,4
KOTIDO,2023,4400,4540,8940,4
KOTIDO,2024,4430,4580,9010,4
KOTIDO,2025,4470,4610,9080,4
KUMI,2015,4340,3960,8300,4
KUMI,2016,4380,4000,8380,4
KUMI,2017,4500,4090,8590,4
KUMI,2018,4750,4260,9010,4
KUMI,2019,4800,4530,9330,4
KUMI,2020,4900,4620,9520,4
KUMI,2021,5000,4700,9700,4
KUMI,2022,5090,4780,9870,4
KUMI,2023,5180,4860,10040,4
KUMI,2024,5270,4920,10190,4
KUMI,2025,5350,5000,10350,4
KWANIA,2015,3310,3230,6540,4
KWANIA,2016,3410,3320,6730,4
KWANIA,2017,3510,3420,6930,4
KWANIA,2018,3620,3510,7130,4
KWANIA,2019,3730,3610,7340,4
KWANIA,2020,3840,3710,7550,4
KWANIA,2021,3950,3810,7760,4
KWANIA,2022,4060,3910,7970,4
KWANIA,2023,4170,4000,8170,4
KWANIA,2024,4280,4100,8380,4
KWANIA,2025,4390,4200,8590,4
KWEEN,2015,1880,1680,3560,4
KWEEN,2016,1940,1730,3670,4
KWEEN,2017,2000,1770,3770,4
KWEEN,2018,2060,1810,3870,4
KWEEN,2019,2120,1850,3970,4
KWEEN,2020,2180,1900,4080,4
KWEEN,2021,2250,1940,4190,4
KWEEN,2022,2310,1980,4290,4
KWEEN,2023,2370,2030,4400,4
KWEEN,2024,2440,2070,4510,4
KWEEN,2025,2500,2110,4610,4
KYANKWANZI,2015,4160,3920,8080,4
KYANKWANZI,2016,4370,4110,8480,4
KYANKWANZI,2017,4590,4300,8890,4
KYANKWANZI,2018,4830,4490,9320,4
KYANKWANZI,2019,5070,4700,9770,4
KYANKWANZI,2020,5320,4910,10230,4
KYANKWANZI,2021,5580,5130,10710,4
KYANKWANZI,2022,5850,5360,11210,4
KYANKWANZI,2023,6130,5590,11720,4
KYANKWANZI,2024,6420,5820,12240,4
KYANKWANZI,2025,6710,6070,12780,4
KYEGEGWA,2015,5950,5590,11540,4
KYEGEGWA,2016,6430,6030,12460,4
KYEGEGWA,2017,6960,6510,13470,4
KYEGEGWA,2018,7540,7020,14560,4
KYEGEGWA,2019,8150,7570,15720,4
KYEGEGWA,2020,8800,8160,16960,4
KYEGEGWA,2021,9500,8780,18280,4
KYEGEGWA,2022,10250,9450,19700,4
KYEGEGWA,2023,11060,10160,21220,4
KYEGEGWA,2024,11910,10920,22830,4
KYEGEGWA,2025,12820,11730,24550,4
KYENJOJO,2015,8640,7970,16610,4
KYENJOJO,2016,9000,8270,17270,4
KYENJOJO,2017,9370,8570,17940,4
KYENJOJO,2018,9750,8890,18640,4
KYENJOJO,2019,10140,9200,19340,4
KYENJOJO,2020,10540,9530,20070,4
KYENJOJO,2021,10940,9860,20800,4
KYENJOJO,2022,11360,10200,21560,4
KYENJOJO,2023,11780,10540,22320,4
KYENJOJO,2024,12210,10880,23090,4
KYENJOJO,2025,12640,11230,23870,4
KYOTERA,2015,4150,3740,7890,4
KYOTERA,2016,4120,3720,7840,4
KYOTERA,2017,4160,3740,7900,4
KYOTERA,2018,4320,3840,8160,4
KYOTERA,2019,4310,4030,8340,4
KYOTERA,2020,4320,4040,8360,4
KYOTERA,2021,4350,4050,8400,4
KYOTERA,2022,4360,4060,8420,4
KYOTERA,2023,4360,4070,8430,4
KYOTERA,2024,4370,4060,8430,4
KYOTERA,2025,4380,4060,8440,4
KARENGA,2015,1300,1400,2700,4
KARENGA,2016,1340,1430,2770,4
KARENGA,2017,1370,1460,2830,4
KARENGA,2018,1420,1500,2920,4
KARENGA,2019,1450,1540,2990,4
KARENGA,2020,1500,1570,3070,4
KARENGA,2021,1520,1610,3130,4
KARENGA,2022,1560,1630,3190,4
KARENGA,2023,1600,1670,3270,4
KARENGA,2024,1640,1710,3350,4
KARENGA,2025,1670,1740,3410,4
LAMWO,2015,2340,2220,4560,4
LAMWO,2016,2310,2210,4520,4
LAMWO,2017,2320,2220,4540,4
LAMWO,2018,2400,2280,4680,4
LAMWO,2019,2370,2400,4770,4
LAMWO,2020,2360,2410,4770,4
LAMWO,2021,2350,2420,4770,4
LAMWO,2022,2340,2420,4760,4
LAMWO,2023,2330,2430,4760,4
LAMWO,2024,2320,2430,4750,4
LAMWO,2025,2310,2430,4740,4
LIRA,2015,6690,6420,13110,4
LIRA,2016,6880,6610,13490,4
LIRA,2017,7070,6800,13870,4
LIRA,2018,7270,6990,14260,4
LIRA,2019,7460,7180,14640,4
LIRA,2020,7660,7380,15040,4
LIRA,2021,7860,7570,15430,4
LIRA,2022,8060,7770,15830,4
LIRA,2023,8260,7960,16220,4
LIRA,2024,8450,8160,16610,4
LIRA,2025,8640,8350,16990,4
LUUKA,2015,4320,4270,8590,4
LUUKA,2016,4320,4260,8580,4
LUUKA,2017,4390,4310,8700,4
LUUKA,2018,4570,4470,9040,4
LUUKA,2019,4570,4710,9280,4
LUUKA,2020,4610,4750,9360,4
LUUKA,2021,4650,4800,9450,4
LUUKA,2022,4690,4830,9520,4
LUUKA,2023,4710,4860,9570,4
LUUKA,2024,4740,4890,9630,4
LUUKA,2025,4760,4920,9680,4
LUWERO,2015,7850,6990,14840,4
LUWERO,2016,7870,7010,14880,4
LUWERO,2017,8010,7100,15110,4
LUWERO,2018,8390,7380,15770,4
LUWERO,2019,8430,7800,16230,4
LUWERO,2020,8550,7890,16440,4
LUWERO,2021,8660,7980,16640,4
LUWERO,2022,8760,8060,16820,4
LUWERO,2023,8860,8140,17000,4
LUWERO,2024,8950,8210,17160,4
LUWERO,2025,9030,8280,17310,4
LWENGO,2015,5110,4670,9780,4
LWENGO,2016,5060,4610,9670,4
LWENGO,2017,5080,4620,9700,4
LWENGO,2018,5240,4730,9970,4
LWENGO,2019,5190,4940,10130,4
LWENGO,2020,5180,4930,10110,4
LWENGO,2021,5170,4930,10100,4
LWENGO,2022,5160,4910,10070,4
LWENGO,2023,5140,4890,10030,4
LWENGO,2024,5110,4870,9980,4
LWENGO,2025,5090,4840,9930,4
LYANTONDE,2015,1640,1530,3170,4
LYANTONDE,2016,1650,1550,3200,4
LYANTONDE,2017,1700,1570,3270,4
LYANTONDE,2018,1780,1640,3420,4
LYANTONDE,2019,1790,1750,3540,4
LYANTONDE,2020,1830,1770,3600,4
LYANTONDE,2021,1860,1800,3660,4
LYANTONDE,2022,1890,1830,3720,4
LYANTONDE,2023,1930,1860,3790,4
LYANTONDE,2024,1960,1890,3850,4
LYANTONDE,2025,1980,1910,3890,4
MANAFWA,2015,2820,2640,5460,4
MANAFWA,2016,2890,2700,5590,4
MANAFWA,2017,2970,2760,5730,4
MANAFWA,2018,3040,2820,5860,4
MANAFWA,2019,3110,2880,5990,4
MANAFWA,2020,3190,2940,6130,4
MANAFWA,2021,3260,3000,6260,4
MANAFWA,2022,3330,3060,6390,4
MANAFWA,2023,3400,3120,6520,4
MANAFWA,2024,3470,3180,6650,4
MANAFWA,2025,3540,3230,6770,4
MARACHA,2015,3510,3310,6820,4
MARACHA,2016,3590,3370,6960,4
MARACHA,2017,3660,3440,7100,4
MARACHA,2018,3740,3510,7250,4
MARACHA,2019,3810,3570,7380,4
MARACHA,2020,3890,3630,7520,4
MARACHA,2021,3960,3700,7660,4
MARACHA,2022,4030,3760,7790,4
MARACHA,2023,4100,3820,7920,4
MARACHA,2024,4170,3880,8050,4
MARACHA,2025,4240,3940,8180,4
MASAKA,2015,5030,4490,9520,4
MASAKA,2016,5020,4490,9510,4
MASAKA,2017,5100,4550,9650,4
MASAKA,2018,5340,4710,10050,4
MASAKA,2019,5340,4970,10310,4
MASAKA,2020,5400,5020,10420,4
MASAKA,2021,5460,5070,10530,4
MASAKA,2022,5510,5100,10610,4
MASAKA,2023,5550,5150,10700,4
MASAKA,2024,5590,5180,10770,4
MASAKA,2025,5630,5210,10840,4
MASINDI,2015,5330,4900,10230,4
MASINDI,2016,5490,5030,10520,4
MASINDI,2017,5650,5160,10810,4
MASINDI,2018,5810,5300,11110,4
MASINDI,2019,5970,5440,11410,4
MASINDI,2020,6140,5570,11710,4
MASINDI,2021,6310,5710,12020,4
MASINDI,2022,6470,5850,12320,4
MASINDI,2023,6640,5980,12620,4
MASINDI,2024,6800,6120,12920,4
MASINDI,2025,6960,6250,13210,4
MAYUGE,2015,9240,8650,17890,4
MAYUGE,2016,9340,8740,18080,4
MAYUGE,2017,9560,8930,18490,4
MAYUGE,2018,10070,9340,19410,4
MAYUGE,2019,10180,9950,20130,4
MAYUGE,2020,10390,10160,20550,4
MAYUGE,2021,10590,10350,20940,4
MAYUGE,2022,10790,10540,21330,4
MAYUGE,2023,10970,10730,21700,4
MAYUGE,2024,11150,10900,22050,4
MAYUGE,2025,11330,11080,22410,4
MBALE,2015,7870,7600,15470,4
MBALE,2016,7940,7700,15640,4
MBALE,2017,8130,7900,16030,4
MBALE,2018,8560,8290,16850,4
MBALE,2019,8650,8870,17520,4
MBALE,2020,8810,9070,17880,4
MBALE,2021,8980,9280,18260,4
MBALE,2022,9140,9480,18620,4
MBALE,2023,9290,9680,18970,4
MBALE,2024,9430,9860,19290,4
MBALE,2025,9580,10050,19630,4
MBARARA,2015,5320,4970,10290,4
MBARARA,2016,5450,5080,10530,4
MBARARA,2017,5570,5190,10760,4
MBARARA,2018,5700,5300,11000,4
MBARARA,2019,5830,5410,11240,4
MBARARA,2020,5950,5520,11470,4
MBARARA,2021,6080,5620,11700,4
MBARARA,2022,6190,5730,11920,4
MBARARA,2023,6320,5830,12150,4
MBARARA,2024,6430,5930,12360,4
MBARARA,2025,6550,6030,12580,4
MITOOMA,2015,3420,3140,6560,4
MITOOMA,2016,3460,3170,6630,4
MITOOMA,2017,3500,3200,6700,4
MITOOMA,2018,3540,3230,6770,4
MITOOMA,2019,3580,3250,6830,4
MITOOMA,2020,3620,3280,6900,4
MITOOMA,2021,3650,3300,6950,4
MITOOMA,2022,3690,3330,7020,4
MITOOMA,2023,3720,3340,7060,4
MITOOMA,2024,3740,3360,7100,4
MITOOMA,2025,3770,3380,7150,4
MITYANA,2015,5580,5090,10670,4
MITYANA,2016,5550,5060,10610,4
MITYANA,2017,5620,5100,10720,4
MITYANA,2018,5850,5260,11110,4
MITYANA,2019,5830,5520,11350,4
MITYANA,2020,5870,5540,11410,4
MITYANA,2021,5910,5580,11490,4
MITYANA,2022,5940,5590,11530,4
MITYANA,2023,5960,5620,11580,4
MITYANA,2024,5980,5620,11600,4
MITYANA,2025,6000,5630,11630,4
MOROTO,2015,2290,2340,4630,4
MOROTO,2016,2290,2360,4650,4
MOROTO,2017,2320,2400,4720,4
MOROTO,2018,2420,2500,4920,4
MOROTO,2019,2430,2640,5070,4
MOROTO,2020,2460,2670,5130,4
MOROTO,2021,2480,2720,5200,4
MOROTO,2022,2510,2760,5270,4
MOROTO,2023,2530,2780,5310,4
MOROTO,2024,2550,2810,5360,4
MOROTO,2025,2560,2850,5410,4
MOYO,2015,1510,1420,2930,4
MOYO,2016,1540,1450,2990,4
MOYO,2017,1580,1480,3060,4
MOYO,2018,1620,1520,3140,4
MOYO,2019,1660,1540,3200,4
MOYO,2020,1700,1580,3280,4
MOYO,2021,1740,1610,3350,4
MOYO,2022,1780,1640,3420,4
MOYO,2023,1820,1670,3490,4
MOYO,2024,1860,1700,3560,4
MOYO,2025,1890,1730,3620,4
MPIGI,2015,4450,4010,8460,4
MPIGI,2016,4460,4020,8480,4
MPIGI,2017,4530,4080,8610,4
MPIGI,2018,4740,4230,8970,4
MPIGI,2019,4760,4470,9230,4
MPIGI,2020,4820,4540,9360,4
MPIGI,2021,4870,4590,9460,4
MPIGI,2022,4920,4640,9560,4
MPIGI,2023,4980,4690,9670,4
MPIGI,2024,5020,4730,9750,4
MPIGI,2025,5070,4770,9840,4
MUBENDE,2015,7720,7180,14900,4
MUBENDE,2016,7970,7400,15370,4
MUBENDE,2017,8330,7720,16050,4
MUBENDE,2018,8960,8230,17190,4
MUBENDE,2019,9250,8950,18200,4
MUBENDE,2020,9620,9310,18930,4
MUBENDE,2021,10020,9690,19710,4
MUBENDE,2022,10420,10060,20480,4
MUBENDE,2023,10810,10440,21250,4
MUBENDE,2024,11220,10830,22050,4
MUBENDE,2025,11640,11220,22860,4
MUKONO,2015,9950,9220,19170,4
MUKONO,2016,10000,9300,19300,4
MUKONO,2017,10210,9500,19710,4
MUKONO,2018,10710,9920,20630,4
MUKONO,2019,10780,10560,21340,4
MUKONO,2020,10950,10760,21710,4
MUKONO,2021,11120,10960,22080,4
MUKONO,2022,11270,11140,22410,4
MUKONO,2023,11420,11320,22740,4
MUKONO,2024,11550,11490,23040,4
MUKONO,2025,11690,11670,23360,4
MADI OKOLLO,2015,2430,2290,4720,4
MADI OKOLLO,2016,2500,2360,4860,4
MADI OKOLLO,2017,2580,2410,4990,4
MADI OKOLLO,2018,2650,2480,5130,4
MADI OKOLLO,2019,2720,2540,5260,4
MADI OKOLLO,2020,2800,2610,5410,4
MADI OKOLLO,2021,2870,2680,5550,4
MADI OKOLLO,2022,2950,2740,5690,4
MADI OKOLLO,2023,3030,2800,5830,4
MADI OKOLLO,2024,3100,2870,5970,4
MADI OKOLLO,2025,3170,2930,6100,4
NABILATUK,2015,1500,1630,3130,4
NABILATUK,2016,1550,1670,3220,4
NABILATUK,2017,1610,1730,3340,4
NABILATUK,2018,1740,1830,3570,4
NABILATUK,2019,1790,1980,3770,4
NABILATUK,2020,1860,2040,3900,4
NABILATUK,2021,1930,2120,4050,4
NABILATUK,2022,2000,2180,4180,4
NABILATUK,2023,2070,2250,4320,4
NABILATUK,2024,2150,2320,4470,4
NABILATUK,2025,2220,2400,4620,4
NAKAPIRIPIRIT,2015,1830,1930,3760,4
NAKAPIRIPIRIT,2016,1870,1980,3850,4
NAKAPIRIPIRIT,2017,1940,2050,3990,4
NAKAPIRIPIRIT,2018,2070,2170,4240,4
NAKAPIRIPIRIT,2019,2120,2350,4470,4
NAKAPIRIPIRIT,2020,2190,2420,4610,4
NAKAPIRIPIRIT,2021,2250,2490,4740,4
NAKAPIRIPIRIT,2022,2330,2570,4900,4
NAKAPIRIPIRIT,2023,2400,2660,5060,4
NAKAPIRIPIRIT,2024,2460,2730,5190,4
NAKAPIRIPIRIT,2025,2540,2810,5350,4
NAKASEKE,2015,3490,3130,6620,4
NAKASEKE,2016,3620,3200,6820,4
NAKASEKE,2017,3750,3280,7030,4
NAKASEKE,2018,3890,3360,7250,4
NAKASEKE,2019,4030,3440,7470,4
NAKASEKE,2020,4170,3510,7680,4
NAKASEKE,2021,4310,3590,7900,4
NAKASEKE,2022,4460,3670,8130,4
NAKASEKE,2023,4600,3740,8340,4
NAKASEKE,2024,4750,3820,8570,4
NAKASEKE,2025,4900,3890,8790,4
NAKASONGOLA,2015,3150,2930,6080,4
NAKASONGOLA,2016,3190,2940,6130,4
NAKASONGOLA,2017,3260,3000,6260,4
NAKASONGOLA,2018,3440,3130,6570,4
NAKASONGOLA,2019,3480,3320,6800,4
NAKASONGOLA,2020,3550,3370,6920,4
NAKASONGOLA,2021,3620,3420,7040,4
NAKASONGOLA,2022,3700,3480,7180,4
NAKASONGOLA,2023,3760,3530,7290,4
NAKASONGOLA,2024,3820,3570,7390,4
NAKASONGOLA,2025,3890,3610,7500,4
NAMAYINGO,2015,4080,3900,7980,4
NAMAYINGO,2016,4070,3870,7940,4
NAMAYINGO,2017,4120,3900,8020,4
NAMAYINGO,2018,4290,4020,8310,4
NAMAYINGO,2019,4280,4220,8500,4
NAMAYINGO,2020,4310,4240,8550,4
NAMAYINGO,2021,4340,4260,8600,4
NAMAYINGO,2022,4360,4260,8620,4
NAMAYINGO,2023,4380,4280,8660,4
NAMAYINGO,2024,4400,4280,8680,4
NAMAYINGO,2025,4410,4280,8690,4
NAMISINDWA,2015,4150,3810,7960,4
NAMISINDWA,2016,4260,3900,8160,4
NAMISINDWA,2017,4380,4000,8380,4
NAMISINDWA,2018,4500,4090,8590,4
NAMISINDWA,2019,4630,4180,8810,4
NAMISINDWA,2020,4750,4280,9030,4
NAMISINDWA,2021,4870,4370,9240,4
NAMISINDWA,2022,4990,4460,9450,4
NAMISINDWA,2023,5110,4550,9660,4
NAMISINDWA,2024,5230,4640,9870,4
NAMISINDWA,2025,5350,4730,10080,4
NAMUTUMBA,2015,5120,4800,9920,4
NAMUTUMBA,2016,5190,4860,10050,4
NAMUTUMBA,2017,5340,4970,10310,4
NAMUTUMBA,2018,5640,5210,10850,4
NAMUTUMBA,2019,5730,5560,11290,4
NAMUTUMBA,2020,5870,5690,11560,4
NAMUTUMBA,2021,6000,5810,11810,4
NAMUTUMBA,2022,6130,5930,12060,4
NAMUTUMBA,2023,6260,6050,12310,4
NAMUTUMBA,2024,6380,6160,12540,4
NAMUTUMBA,2025,6510,6260,12770,4
NAPAK,2015,3030,3000,6030,4
NAPAK,2016,3010,3010,6020,4
NAPAK,2017,3050,3050,6100,4
NAPAK,2018,3150,3160,6310,4
NAPAK,2019,3150,3320,6470,4
NAPAK,2020,3160,3360,6520,4
NAPAK,2021,3180,3400,6580,4
NAPAK,2022,3190,3420,6610,4
NAPAK,2023,3190,3450,6640,4
NAPAK,2024,3200,3470,6670,4
NAPAK,2025,3200,3500,6700,4
NEBBI,2015,4100,3900,8000,4
NEBBI,2016,4230,4010,8240,4
NEBBI,2017,4370,4130,8500,4
NEBBI,2018,4500,4240,8740,4
NEBBI,2019,4640,4360,9000,4
NEBBI,2020,4780,4480,9260,4
NEBBI,2021,4920,4590,9510,4
NEBBI,2022,5070,4710,9780,4
NEBBI,2023,5210,4830,10040,4
NEBBI,2024,5350,4950,10300,4
NEBBI,2025,5490,5060,10550,4
NGORA,2015,2530,2400,4930,4
NGORA,2016,2550,2410,4960,4
NGORA,2017,2610,2450,5060,4
NGORA,2018,2740,2550,5290,4
NGORA,2019,2760,2720,5480,4
NGORA,2020,2810,2750,5560,4
NGORA,2021,2860,2790,5650,4
NGORA,2022,2900,2840,5740,4
NGORA,2023,2930,2870,5800,4
NGORA,2024,2980,2900,5880,4
NGORA,2025,3010,2940,5950,4
NTOROKO,2015,1250,1060,2310,4
NTOROKO,2016,1260,1070,2330,4
NTOROKO,2017,1280,1080,2360,4
NTOROKO,2018,1340,1110,2450,4
NTOROKO,2019,1350,1170,2520,4
NTOROKO,2020,1360,1180,2540,4
NTOROKO,2021,1380,1190,2570,4
NTOROKO,2022,1400,1200,2600,4
NTOROKO,2023,1410,1210,2620,4
NTOROKO,2024,1420,1220,2640,4
NTOROKO,2025,1440,1220,2660,4
NTUNGAMO,2015,8760,8290,17050,4
NTUNGAMO,2016,8950,8440,17390,4
NTUNGAMO,2017,9140,8600,17740,4
NTUNGAMO,2018,9340,8750,18090,4
NTUNGAMO,2019,9530,8910,18440,4
NTUNGAMO,2020,9720,9060,18780,4
NTUNGAMO,2021,9910,9210,19120,4
NTUNGAMO,2022,10090,9360,19450,4
NTUNGAMO,2023,10270,9500,19770,4
NTUNGAMO,2024,10440,9640,20080,4
NTUNGAMO,2025,10610,9770,20380,4
NWOYA,2015,2630,2540,5170,4
NWOYA,2016,2910,2800,5710,4
NWOYA,2017,3220,3090,6310,4
NWOYA,2018,3550,3400,6950,4
NWOYA,2019,3920,3740,7660,4
NWOYA,2020,4320,4120,8440,4
NWOYA,2021,4760,4530,9290,4
NWOYA,2022,5250,4980,10230,4
NWOYA,2023,5780,5470,11250,4
NWOYA,2024,6350,6000,12350,4
NWOYA,2025,6980,6580,13560,4
OBONGI,2015,810,740,1550,4
OBONGI,2016,820,740,1560,4
OBONGI,2017,830,750,1580,4
OBONGI,2018,870,780,1650,4
OBONGI,2019,870,830,1700,4
OBONGI,2020,890,830,1720,4
OBONGI,2021,900,840,1740,4
OBONGI,2022,900,850,1750,4
OBONGI,2023,910,860,1770,4
OBONGI,2024,920,860,1780,4
OBONGI,2025,930,870,1800,4
OMORO,2015,2820,2610,5430,4
OMORO,2016,2860,2640,5500,4
OMORO,2017,2940,2710,5650,4
OMORO,2018,3110,2850,5960,4
OMORO,2019,3150,3050,6200,4
OMORO,2020,3230,3120,6350,4
OMORO,2021,3310,3200,6510,4
OMORO,2022,3380,3260,6640,4
OMORO,2023,3450,3330,6780,4
OMORO,2024,3530,3410,6940,4
OMORO,2025,3600,3480,7080,4
OTUKE,2015,1960,1800,3760,4
OTUKE,2016,2050,1880,3930,4
OTUKE,2017,2140,1960,4100,4
OTUKE,2018,2230,2040,4270,4
OTUKE,2019,2330,2130,4460,4
OTUKE,2020,2430,2220,4650,4
OTUKE,2021,2540,2310,4850,4
OTUKE,2022,2640,2400,5040,4
OTUKE,2023,2750,2490,5240,4
OTUKE,2024,2870,2590,5460,4
OTUKE,2025,2980,2690,5670,4
OYAM,2015,6880,6510,13390,4
OYAM,2016,7090,6700,13790,4
OYAM,2017,7310,6900,14210,4
OYAM,2018,7530,7090,14620,4
OYAM,2019,7750,7300,15050,4
OYAM,2020,7980,7500,15480,4
OYAM,2021,8200,7700,15900,4
OYAM,2022,8430,7910,16340,4
OYAM,2023,8660,8110,16770,4
OYAM,2024,8880,8310,17190,4
OYAM,2025,9110,8520,17630,4
PADER,2015,3050,2900,5950,4
PADER,2016,3030,2900,5930,4
PADER,2017,3060,2930,5990,4
PADER,2018,3180,3030,6210,4
PADER,2019,3170,3190,6360,4
PADER,2020,3190,3220,6410,4
PADER,2021,3200,3250,6450,4
PADER,2022,3220,3260,6480,4
PADER,2023,3230,3290,6520,4
PADER,2024,3230,3300,6530,4
PADER,2025,3230,3320,6550,4
PAKWACH,2015,2940,2790,5730,4
PAKWACH,2016,3070,2900,5970,4
PAKWACH,2017,3190,3000,6190,4
PAKWACH,2018,3330,3110,6440,4
PAKWACH,2019,3460,3220,6680,4
PAKWACH,2020,3600,3330,6930,4
PAKWACH,2021,3750,3450,7200,4
PAKWACH,2022,3890,3560,7450,4
PAKWACH,2023,4040,3680,7720,4
PAKWACH,2024,4190,3800,7990,4
PAKWACH,2025,4340,3920,8260,4
PALLISA,2015,5330,5070,10400,4
PALLISA,2016,5450,5190,10640,4
PALLISA,2017,5670,5360,11030,4
PALLISA,2018,6040,5680,11720,4
PALLISA,2019,6190,6120,12310,4
PALLISA,2020,6390,6330,12720,4
PALLISA,2021,6600,6530,13130,4
PALLISA,2022,6810,6730,13540,4
PALLISA,2023,7020,6930,13950,4
PALLISA,2024,7220,7130,14350,4
PALLISA,2025,7440,7330,14770,4
RAKAI,2015,5310,4970,10280,4
RAKAI,2016,5330,4980,10310,4
RAKAI,2017,5430,5040,10470,4
RAKAI,2018,5690,5240,10930,4
RAKAI,2019,5710,5540,11250,4
RAKAI,2020,5790,5610,11400,4
RAKAI,2021,5870,5670,11540,4
RAKAI,2022,5940,5730,11670,4
RAKAI,2023,6010,5790,11800,4
RAKAI,2024,6070,5840,11910,4
RAKAI,2025,6140,5890,12030,4
RUBANDA,2015,3440,3220,6660,4
RUBANDA,2016,3480,3250,6730,4
RUBANDA,2017,3530,3270,6800,4
RUBANDA,2018,3580,3290,6870,4
RUBANDA,2019,3620,3320,6940,4
RUBANDA,2020,3670,3340,7010,4
RUBANDA,2021,3710,3360,7070,4
RUBANDA,2022,3740,3380,7120,4
RUBANDA,2023,3780,3390,7170,4
RUBANDA,2024,3810,3410,7220,4
RUBANDA,2025,3850,3420,7270,4
RUBIRIZI,2015,2420,2280,4700,4
RUBIRIZI,2016,2470,2330,4800,4
RUBIRIZI,2017,2520,2370,4890,4
RUBIRIZI,2018,2570,2420,4990,4
RUBIRIZI,2019,2630,2460,5090,4
RUBIRIZI,2020,2680,2500,5180,4
RUBIRIZI,2021,2720,2550,5270,4
RUBIRIZI,2022,2770,2590,5360,4
RUBIRIZI,2023,2810,2630,5440,4
RUBIRIZI,2024,2860,2670,5530,4
RUBIRIZI,2025,2900,2710,5610,4
RUKIGA,2015,1590,1510,3100,4
RUKIGA,2016,1610,1520,3130,4
RUKIGA,2017,1630,1530,3160,4
RUKIGA,2018,1640,1540,3180,4
RUKIGA,2019,1660,1550,3210,4
RUKIGA,2020,1670,1560,3230,4
RUKIGA,2021,1690,1570,3260,4
RUKIGA,2022,1700,1580,3280,4
RUKIGA,2023,1710,1580,3290,4
RUKIGA,2024,1720,1590,3310,4
RUKIGA,2025,1730,1590,3320,4
RUKUNGIRI,2015,5480,4880,10360,4
RUKUNGIRI,2016,5540,4920,10460,4
RUKUNGIRI,2017,5610,4970,10580,4
RUKUNGIRI,2018,5670,5020,10690,4
RUKUNGIRI,2019,5740,5060,10800,4
RUKUNGIRI,2020,5800,5110,10910,4
RUKUNGIRI,2021,5850,5140,10990,4
RUKUNGIRI,2022,5910,5180,11090,4
RUKUNGIRI,2023,5960,5220,11180,4
RUKUNGIRI,2024,6000,5240,11240,4
RUKUNGIRI,2025,6050,5270,11320,4
RWAMPARA,2015,2300,2150,4450,4
RWAMPARA,2016,2350,2200,4550,4
RWAMPARA,2017,2410,2250,4660,4
RWAMPARA,2018,2460,2300,4760,4
RWAMPARA,2019,2510,2340,4850,4
RWAMPARA,2020,2570,2390,4960,4
RWAMPARA,2021,2620,2440,5060,4
RWAMPARA,2022,2670,2480,5150,4
RWAMPARA,2023,2720,2530,5250,4
RWAMPARA,2024,2770,2580,5350,4
RWAMPARA,2025,2820,2620,5440,4
SERERE,2015,5590,5330,10920,4
SERERE,2016,5700,5430,11130,4
SERERE,2017,5890,5600,11490,4
SERERE,2018,6260,5900,12160,4
SERERE,2019,6390,6340,12730,4
SERERE,2020,6580,6520,13100,4
SERERE,2021,6770,6710,13480,4
SERERE,2022,6960,6900,13860,4
SERERE,2023,7140,7070,14210,4
SERERE,2024,7320,7260,14580,4
SERERE,2025,7510,7430,14940,4
SHEEMA,2015,3270,3080,6350,4
SHEEMA,2016,3310,3110,6420,4
SHEEMA,2017,3350,3140,6490,4
SHEEMA,2018,3390,3170,6560,4
SHEEMA,2019,3430,3200,6630,4
SHEEMA,2020,3460,3230,6690,4
SHEEMA,2021,3500,3260,6760,4
SHEEMA,2022,3530,3290,6820,4
SHEEMA,2023,3560,3310,6870,4
SHEEMA,2024,3590,3330,6920,4
SHEEMA,2025,3610,3350,6960,4
SIRONKO,2015,4330,3990,8320,4
SIRONKO,2016,4440,4070,8510,4
SIRONKO,2017,4540,4150,8690,4
SIRONKO,2018,4650,4240,8890,4
SIRONKO,2019,4760,4320,9080,4
SIRONKO,2020,4860,4400,9260,4
SIRONKO,2021,4970,4480,9450,4
SIRONKO,2022,5070,4560,9630,4
SIRONKO,2023,5170,4640,9810,4
SIRONKO,2024,5270,4710,9980,4
SIRONKO,2025,5370,4780,10150,4
SOROTI,2015,5210,4630,9840,4
SOROTI,2016,5290,4690,9980,4
SOROTI,2017,5450,4820,10270,4
SOROTI,2018,5760,5060,10820,4
SOROTI,2019,5860,5410,11270,4
SOROTI,2020,6000,5540,11540,4
SOROTI,2021,6150,5670,11820,4
SOROTI,2022,6290,5810,12100,4
SOROTI,2023,6430,5930,12360,4
SOROTI,2024,6560,6050,12610,4
SOROTI,2025,6700,6170,12870,4
SSEMBABULE,2015,4570,4380,8950,4
SSEMBABULE,2016,4600,4410,9010,4
SSEMBABULE,2017,4700,4490,9190,4
SSEMBABULE,2018,4940,4680,9620,4
SSEMBABULE,2019,4990,4970,9960,4
SSEMBABULE,2020,5070,5050,10120,4
SSEMBABULE,2021,5160,5120,10280,4
SSEMBABULE,2022,5240,5200,10440,4
SSEMBABULE,2023,5320,5270,10590,4
SSEMBABULE,2024,5390,5330,10720,4
SSEMBABULE,2025,5460,5400,10860,4
TORORO,2015,9100,8700,17800,4
TORORO,2016,9340,8920,18260,4
TORORO,2017,9590,9140,18730,4
TORORO,2018,9840,9360,19200,4
TORORO,2019,10100,9590,19690,4
TORORO,2020,10350,9820,20170,4
TORORO,2021,10600,10040,20640,4
TORORO,2022,10850,10260,21110,4
TORORO,2023,11100,10490,21590,4
TORORO,2024,11350,10710,22060,4
TORORO,2025,11590,10920,22510,4
WAKISO,2015,34800,32100,66900,4
WAKISO,2016,37130,34290,71420,4
WAKISO,2017,39620,36640,76260,4
WAKISO,2018,42240,39120,81360,4
WAKISO,2019,45050,41750,86800,4
WAKISO,2020,47990,44520,92510,4
WAKISO,2021,51070,47480,98550,4
WAKISO,2022,54350,50610,104960,4
WAKISO,2023,57790,53860,111650,4
WAKISO,2024,61390,57290,118680,4
WAKISO,2025,65170,60940,126110,4
YUMBE,2015,9160,9310,18470,4
YUMBE,2016,9440,9660,19100,4
YUMBE,2017,9850,10150,20000,4
YUMBE,2018,10570,10910,21480,4
YUMBE,2019,10900,11950,22850,4
YUMBE,2020,11330,12530,23860,4
YUMBE,2021,11770,13120,24890,4
YUMBE,2022,12220,13740,25960,4
YUMBE,2023,12670,14360,27030,4
YUMBE,2024,13120,15010,28130,4
YUMBE,2025,13590,15670,29260,4
ZOMBO,2015,4480,4340,8820,4
ZOMBO,2016,4620,4460,9080,4
ZOMBO,2017,4760,4580,9340,4
ZOMBO,2018,4900,4710,9610,4
ZOMBO,2019,5050,4840,9890,4
ZOMBO,2020,5200,4970,10170,4
ZOMBO,2021,5350,5090,10440,4
ZOMBO,2022,5500,5220,10720,4
ZOMBO,2023,5640,5350,10990,4
ZOMBO,2024,5800,5480,11280,4
ZOMBO,2025,5940,5610,11550,4
ABIM,2015,380,430,810,40
ABIM,2016,400,460,860,40
ABIM,2017,420,490,910,40
ABIM,2018,450,520,970,40
ABIM,2019,490,570,1060,40
ABIM,2020,530,610,1140,40
ABIM,2021,570,660,1230,40
ABIM,2022,610,720,1330,40
ABIM,2023,650,770,1420,40
ABIM,2024,700,820,1520,40
ABIM,2025,750,890,1640,40
ADJUMANI,2015,940,1560,2500,40
ADJUMANI,2016,950,1570,2520,40
ADJUMANI,2017,950,1590,2540,40
ADJUMANI,2018,960,1600,2560,40
ADJUMANI,2019,970,1620,2590,40
ADJUMANI,2020,970,1630,2600,40
ADJUMANI,2021,980,1640,2620,40
ADJUMANI,2022,980,1650,2630,40
ADJUMANI,2023,990,1660,2650,40
ADJUMANI,2024,990,1670,2660,40
ADJUMANI,2025,990,1680,2670,40
AGAGO,2015,990,1430,2420,40
AGAGO,2016,1000,1460,2460,40
AGAGO,2017,1020,1480,2500,40
AGAGO,2018,1040,1510,2550,40
AGAGO,2019,1050,1530,2580,40
AGAGO,2020,1070,1560,2630,40
AGAGO,2021,1090,1580,2670,40
AGAGO,2022,1100,1610,2710,40
AGAGO,2023,1120,1630,2750,40
AGAGO,2024,1130,1650,2780,40
AGAGO,2025,1150,1670,2820,40
ALEBTONG,2015,710,920,1630,40
ALEBTONG,2016,720,950,1670,40
ALEBTONG,2017,730,980,1710,40
ALEBTONG,2018,750,1020,1770,40
ALEBTONG,2019,790,1070,1860,40
ALEBTONG,2020,820,1120,1940,40
ALEBTONG,2021,850,1170,2020,40
ALEBTONG,2022,880,1220,2100,40
ALEBTONG,2023,910,1270,2180,40
ALEBTONG,2024,950,1320,2270,40
ALEBTONG,2025,980,1380,2360,40
AMOLATAR,2015,520,590,1110,40
AMOLATAR,2016,530,600,1130,40
AMOLATAR,2017,540,620,1160,40
AMOLATAR,2018,560,640,1200,40
AMOLATAR,2019,580,670,1250,40
AMOLATAR,2020,600,700,1300,40
AMOLATAR,2021,620,730,1350,40
AMOLATAR,2022,640,760,1400,40
AMOLATAR,2023,660,800,1460,40
AMOLATAR,2024,690,820,1510,40
AMOLATAR,2025,710,850,1560,40
AMUDAT,2015,490,410,900,40
AMUDAT,2016,510,430,940,40
AMUDAT,2017,520,450,970,40
AMUDAT,2018,540,480,1020,40
AMUDAT,2019,570,510,1080,40
AMUDAT,2020,600,540,1140,40
AMUDAT,2021,630,580,1210,40
AMUDAT,2022,660,610,1270,40
AMUDAT,2023,690,650,1340,40
AMUDAT,2024,720,690,1410,40
AMUDAT,2025,760,730,1490,40
AMURIA,2015,570,810,1380,40
AMURIA,2016,580,850,1430,40
AMURIA,2017,590,880,1470,40
AMURIA,2018,620,930,1550,40
AMURIA,2019,650,970,1620,40
AMURIA,2020,680,1030,1710,40
AMURIA,2021,720,1080,1800,40
AMURIA,2022,750,1140,1890,40
AMURIA,2023,780,1200,1980,40
AMURIA,2024,820,1260,2080,40
AMURIA,2025,860,1320,2180,40
AMURU,2015,590,800,1390,40
AMURU,2016,590,820,1410,40
AMURU,2017,610,850,1460,40
AMURU,2018,620,890,1510,40
AMURU,2019,640,920,1560,40
AMURU,2020,670,970,1640,40
AMURU,2021,690,1010,1700,40
AMURU,2022,720,1050,1770,40
AMURU,2023,740,1100,1840,40
AMURU,2024,770,1140,1910,40
AMURU,2025,790,1190,1980,40
APAC,2015,910,1100,2010,40
APAC,2016,940,1140,2080,40
APAC,2017,980,1180,2160,40
APAC,2018,1010,1220,2230,40
APAC,2019,1050,1260,2310,40
APAC,2020,1090,1310,2400,40
APAC,2021,1120,1350,2470,40
APAC,2022,1160,1390,2550,40
APAC,2023,1200,1430,2630,40
APAC,2024,1240,1480,2720,40
APAC,2025,1280,1520,2800,40
ARUA,2015,3060,4500,7560,40
ARUA,2016,3150,4620,7770,40
ARUA,2017,3240,4750,7990,40
ARUA,2018,3330,4880,8210,40
ARUA,2019,3420,5010,8430,40
ARUA,2020,3520,5130,8650,40
ARUA,2021,3610,5260,8870,40
ARUA,2022,3700,5390,9090,40
ARUA,2023,3800,5520,9320,40
ARUA,2024,3890,5650,9540,40
ARUA,2025,3980,5770,9750,40
BUDAKA,2015,610,820,1430,40
BUDAKA,2016,630,850,1480,40
BUDAKA,2017,640,890,1530,40
BUDAKA,2018,670,930,1600,40
BUDAKA,2019,690,980,1670,40
BUDAKA,2020,730,1030,1760,40
BUDAKA,2021,760,1080,1840,40
BUDAKA,2022,800,1140,1940,40
BUDAKA,2023,840,1200,2040,40
BUDAKA,2024,870,1260,2130,40
BUDAKA,2025,910,1320,2230,40
BUDUDA,2015,710,680,1390,40
BUDUDA,2016,730,710,1440,40
BUDUDA,2017,760,740,1500,40
BUDUDA,2018,800,790,1590,40
BUDUDA,2019,840,840,1680,40
BUDUDA,2020,890,900,1790,40
BUDUDA,2021,940,950,1890,40
BUDUDA,2022,990,1010,2000,40
BUDUDA,2023,1050,1070,2120,40
BUDUDA,2024,1100,1130,2230,40
BUDUDA,2025,1160,1190,2350,40
BUGIRI,2015,1330,1730,3060,40
BUGIRI,2016,1370,1810,3180,40
BUGIRI,2017,1410,1890,3300,40
BUGIRI,2018,1470,1990,3460,40
BUGIRI,2019,1550,2110,3660,40
BUGIRI,2020,1630,2230,3860,40
BUGIRI,2021,1720,2360,4080,40
BUGIRI,2022,1810,2500,4310,40
BUGIRI,2023,1900,2630,4530,40
BUGIRI,2024,1990,2760,4750,40
BUGIRI,2025,2090,2910,5000,40
BUGWERI,2015,760,960,1720,40
BUGWERI,2016,780,980,1760,40
BUGWERI,2017,790,1020,1810,40
BUGWERI,2018,810,1060,1870,40
BUGWERI,2019,850,1110,1960,40
BUGWERI,2020,880,1150,2030,40
BUGWERI,2021,910,1200,2110,40
BUGWERI,2022,950,1250,2200,40
BUGWERI,2023,980,1310,2290,40
BUGWERI,2024,1020,1360,2380,40
BUGWERI,2025,1050,1410,2460,40
BUHWEJU,2015,580,680,1260,40
BUHWEJU,2016,590,700,1290,40
BUHWEJU,2017,610,720,1330,40
BUHWEJU,2018,630,740,1370,40
BUHWEJU,2019,650,770,1420,40
BUHWEJU,2020,670,790,1460,40
BUHWEJU,2021,690,810,1500,40
BUHWEJU,2022,720,830,1550,40
BUHWEJU,2023,740,860,1600,40
BUHWEJU,2024,760,880,1640,40
BUHWEJU,2025,780,900,1680,40
BUIKWE,2015,1940,2060,4000,40
BUIKWE,2016,1950,2110,4060,40
BUIKWE,2017,1980,2170,4150,40
BUIKWE,2018,2020,2240,4260,40
BUIKWE,2019,2080,2330,4410,40
BUIKWE,2020,2160,2420,4580,40
BUIKWE,2021,2220,2520,4740,40
BUIKWE,2022,2290,2610,4900,40
BUIKWE,2023,2350,2710,5060,40
BUIKWE,2024,2420,2800,5220,40
BUIKWE,2025,2490,2890,5380,40
BUKEDEA,2015,650,810,1460,40
BUKEDEA,2016,680,850,1530,40
BUKEDEA,2017,710,890,1600,40
BUKEDEA,2018,730,940,1670,40
BUKEDEA,2019,770,1000,1770,40
BUKEDEA,2020,820,1060,1880,40
BUKEDEA,2021,870,1130,2000,40
BUKEDEA,2022,910,1190,2100,40
BUKEDEA,2023,960,1260,2220,40
BUKEDEA,2024,1010,1330,2340,40
BUKEDEA,2025,1060,1400,2460,40
BUKOMANSIMBI,2015,610,700,1310,40
BUKOMANSIMBI,2016,600,700,1300,40
BUKOMANSIMBI,2017,600,710,1310,40
BUKOMANSIMBI,2018,610,720,1330,40
BUKOMANSIMBI,2019,620,740,1360,40
BUKOMANSIMBI,2020,630,760,1390,40
BUKOMANSIMBI,2021,640,770,1410,40
BUKOMANSIMBI,2022,660,790,1450,40
BUKOMANSIMBI,2023,660,800,1460,40
BUKOMANSIMBI,2024,670,820,1490,40
BUKOMANSIMBI,2025,690,830,1520,40
BUKWO,2015,410,420,830,40
BUKWO,2016,430,440,870,40
BUKWO,2017,460,460,920,40
BUKWO,2018,480,480,960,40
BUKWO,2019,500,500,1000,40
BUKWO,2020,530,530,1060,40
BUKWO,2021,560,550,1110,40
BUKWO,2022,590,580,1170,40
BUKWO,2023,610,600,1210,40
BUKWO,2024,640,630,1270,40
BUKWO,2025,680,660,1340,40
BULAMBULI,2015,630,600,1230,40
BULAMBULI,2016,660,630,1290,40
BULAMBULI,2017,690,670,1360,40
BULAMBULI,2018,720,710,1430,40
BULAMBULI,2019,760,760,1520,40
BULAMBULI,2020,810,810,1620,40
BULAMBULI,2021,860,860,1720,40
BULAMBULI,2022,910,930,1840,40
BULAMBULI,2023,960,990,1950,40
BULAMBULI,2024,1020,1050,2070,40
BULAMBULI,2025,1080,1110,2190,40
BULIISA,2015,610,780,1390,40
BULIISA,2016,640,810,1450,40
BULIISA,2017,670,850,1520,40
BULIISA,2018,710,880,1590,40
BULIISA,2019,750,920,1670,40
BULIISA,2020,790,960,1750,40
BULIISA,2021,830,1000,1830,40
BULIISA,2022,870,1040,1910,40
BULIISA,2023,910,1090,2000,40
BULIISA,2024,960,1130,2090,40
BULIISA,2025,1000,1170,2170,40
BUNDIBUGYO,2015,880,1130,2010,40
BUNDIBUGYO,2016,890,1170,2060,40
BUNDIBUGYO,2017,910,1210,2120,40
BUNDIBUGYO,2018,940,1260,2200,40
BUNDIBUGYO,2019,980,1320,2300,40
BUNDIBUGYO,2020,1020,1380,2400,40
BUNDIBUGYO,2021,1060,1440,2500,40
BUNDIBUGYO,2022,1100,1510,2610,40
BUNDIBUGYO,2023,1150,1570,2720,40
BUNDIBUGYO,2024,1190,1630,2820,40
BUNDIBUGYO,2025,1230,1690,2920,40
BUNYANGABU,2015,680,700,1380,40
BUNYANGABU,2016,690,710,1400,40
BUNYANGABU,2017,700,740,1440,40
BUNYANGABU,2018,720,760,1480,40
BUNYANGABU,2019,750,800,1550,40
BUNYANGABU,2020,780,830,1610,40
BUNYANGABU,2021,810,860,1670,40
BUNYANGABU,2022,830,900,1730,40
BUNYANGABU,2023,860,930,1790,40
BUNYANGABU,2024,890,970,1860,40
BUNYANGABU,2025,920,1000,1920,40
BUSHENYI,2015,1310,1600,2910,40
BUSHENYI,2016,1330,1620,2950,40
BUSHENYI,2017,1350,1630,2980,40
BUSHENYI,2018,1360,1650,3010,40
BUSHENYI,2019,1380,1660,3040,40
BUSHENYI,2020,1390,1670,3060,40
BUSHENYI,2021,1410,1690,3100,40
BUSHENYI,2022,1420,1700,3120,40
BUSHENYI,2023,1430,1710,3140,40
BUSHENYI,2024,1440,1710,3150,40
BUSHENYI,2025,1450,1720,3170,40
BUSIA,2015,1100,1160,2260,40
BUSIA,2016,1120,1200,2320,40
BUSIA,2017,1150,1240,2390,40
BUSIA,2018,1190,1290,2480,40
BUSIA,2019,1240,1360,2600,40
BUSIA,2020,1290,1420,2710,40
BUSIA,2021,1350,1490,2840,40
BUSIA,2022,1400,1560,2960,40
BUSIA,2023,1450,1630,3080,40
BUSIA,2024,1510,1690,3200,40
BUSIA,2025,1580,1760,3340,40
BUTALEJA,2015,760,920,1680,40
BUTALEJA,2016,780,970,1750,40
BUTALEJA,2017,800,1000,1800,40
BUTALEJA,2018,830,1050,1880,40
BUTALEJA,2019,870,1110,1980,40
BUTALEJA,2020,910,1170,2080,40
BUTALEJA,2021,950,1240,2190,40
BUTALEJA,2022,1000,1300,2300,40
BUTALEJA,2023,1050,1370,2420,40
BUTALEJA,2024,1100,1430,2530,40
BUTALEJA,2025,1150,1500,2650,40
BUTAMBALA,2015,500,530,1030,40
BUTAMBALA,2016,510,540,1050,40
BUTAMBALA,2017,510,550,1060,40
BUTAMBALA,2018,520,560,1080,40
BUTAMBALA,2019,530,580,1110,40
BUTAMBALA,2020,540,590,1130,40
BUTAMBALA,2021,560,610,1170,40
BUTAMBALA,2022,570,630,1200,40
BUTAMBALA,2023,580,640,1220,40
BUTAMBALA,2024,590,660,1250,40
BUTAMBALA,2025,600,670,1270,40
BUTEBO,2015,330,450,780,40
BUTEBO,2016,330,450,780,40
BUTEBO,2017,330,460,790,40
BUTEBO,2018,340,480,820,40
BUTEBO,2019,340,490,830,40
BUTEBO,2020,350,510,860,40
BUTEBO,2021,370,520,890,40
BUTEBO,2022,380,540,920,40
BUTEBO,2023,390,550,940,40
BUTEBO,2024,390,570,960,40
BUTEBO,2025,400,580,980,40
BUVUMA,2015,930,790,1720,40
BUVUMA,2016,990,850,1840,40
BUVUMA,2017,1050,910,1960,40
BUVUMA,2018,1110,970,2080,40
BUVUMA,2019,1180,1030,2210,40
BUVUMA,2020,1250,1100,2350,40
BUVUMA,2021,1330,1170,2500,40
BUVUMA,2022,1410,1250,2660,40
BUVUMA,2023,1490,1330,2820,40
BUVUMA,2024,1570,1410,2980,40
BUVUMA,2025,1660,1500,3160,40
BUYENDE,2015,1260,1570,2830,40
BUYENDE,2016,1300,1640,2940,40
BUYENDE,2017,1350,1720,3070,40
BUYENDE,2018,1420,1820,3240,40
BUYENDE,2019,1500,1940,3440,40
BUYENDE,2020,1580,2060,3640,40
BUYENDE,2021,1670,2190,3860,40
BUYENDE,2022,1750,2320,4070,40
BUYENDE,2023,1850,2450,4300,40
BUYENDE,2024,1950,2590,4540,40
BUYENDE,2025,2050,2740,4790,40
DOKOLO,2015,830,1110,1940,40
DOKOLO,2016,850,1140,1990,40
DOKOLO,2017,880,1170,2050,40
DOKOLO,2018,910,1200,2110,40
DOKOLO,2019,930,1240,2170,40
DOKOLO,2020,960,1270,2230,40
DOKOLO,2021,990,1300,2290,40
DOKOLO,2022,1020,1330,2350,40
DOKOLO,2023,1040,1370,2410,40
DOKOLO,2024,1070,1400,2470,40
DOKOLO,2025,1100,1430,2530,40
GOMBA,2015,720,710,1430,40
GOMBA,2016,720,720,1440,40
GOMBA,2017,730,730,1460,40
GOMBA,2018,750,750,1500,40
GOMBA,2019,770,780,1550,40
GOMBA,2020,790,800,1590,40
GOMBA,2021,810,820,1630,40
GOMBA,2022,830,850,1680,40
GOMBA,2023,850,870,1720,40
GOMBA,2024,880,890,1770,40
GOMBA,2025,900,910,1810,40
HOIMA,2015,1880,1820,3700,40
HOIMA,2016,1950,1880,3830,40
HOIMA,2017,2020,1950,3970,40
HOIMA,2018,2100,2010,4110,40
HOIMA,2019,2170,2080,4250,40
HOIMA,2020,2250,2150,4400,40
HOIMA,2021,2330,2220,4550,40
HOIMA,2022,2410,2290,4700,40
HOIMA,2023,2490,2370,4860,40
HOIMA,2024,2580,2440,5020,40
HOIMA,2025,2660,2510,5170,40
IBANDA,2015,1400,1600,3000,40
IBANDA,2016,1430,1630,3060,40
IBANDA,2017,1450,1660,3110,40
IBANDA,2018,1480,1690,3170,40
IBANDA,2019,1510,1720,3230,40
IBANDA,2020,1540,1750,3290,40
IBANDA,2021,1560,1770,3330,40
IBANDA,2022,1590,1800,3390,40
IBANDA,2023,1620,1830,3450,40
IBANDA,2024,1640,1850,3490,40
IBANDA,2025,1660,1880,3540,40
IGANGA,2015,1600,1860,3460,40
IGANGA,2016,1630,1920,3550,40
IGANGA,2017,1670,1990,3660,40
IGANGA,2018,1730,2080,3810,40
IGANGA,2019,1800,2170,3970,40
IGANGA,2020,1880,2280,4160,40
IGANGA,2021,1960,2390,4350,40
IGANGA,2022,2040,2500,4540,40
IGANGA,2023,2120,2610,4730,40
IGANGA,2024,2210,2720,4930,40
IGANGA,2025,2290,2830,5120,40
ISINGIRO,2015,2670,3250,5920,40
ISINGIRO,2016,2770,3370,6140,40
ISINGIRO,2017,2870,3490,6360,40
ISINGIRO,2018,2980,3610,6590,40
ISINGIRO,2019,3080,3730,6810,40
ISINGIRO,2020,3200,3860,7060,40
ISINGIRO,2021,3310,3990,7300,40
ISINGIRO,2022,3420,4120,7540,40
ISINGIRO,2023,3540,4250,7790,40
ISINGIRO,2024,3650,4380,8030,40
ISINGIRO,2025,3770,4510,8280,40
JINJA,2015,3260,3290,6550,40
JINJA,2016,3320,3340,6660,40
JINJA,2017,3370,3390,6760,40
JINJA,2018,3430,3440,6870,40
JINJA,2019,3480,3490,6970,40
JINJA,2020,3540,3540,7080,40
JINJA,2021,3590,3590,7180,40
JINJA,2022,3640,3630,7270,40
JINJA,2023,3680,3680,7360,40
JINJA,2024,3730,3720,7450,40
JINJA,2025,3770,3760,7530,40
KAABONG,2015,550,750,1300,40
KAABONG,2016,570,770,1340,40
KAABONG,2017,580,790,1370,40
KAABONG,2018,600,800,1400,40
KAABONG,2019,610,820,1430,40
KAABONG,2020,630,840,1470,40
KAABONG,2021,640,860,1500,40
KAABONG,2022,660,880,1540,40
KAABONG,2023,680,900,1580,40
KAABONG,2024,690,920,1610,40
KAABONG,2025,710,930,1640,40
KABALE,2015,1200,1530,2730,40
KABALE,2016,1210,1550,2760,40
KABALE,2017,1230,1570,2800,40
KABALE,2018,1250,1590,2840,40
KABALE,2019,1270,1610,2880,40
KABALE,2020,1290,1620,2910,40
KABALE,2021,1310,1640,2950,40
KABALE,2022,1320,1660,2980,40
KABALE,2023,1340,1670,3010,40
KABALE,2024,1350,1680,3030,40
KABALE,2025,1370,1690,3060,40
KABAROLE,2015,1960,1810,3770,40
KABAROLE,2016,2000,1850,3850,40
KABAROLE,2017,2040,1890,3930,40
KABAROLE,2018,2090,1930,4020,40
KABAROLE,2019,2130,1970,4100,40
KABAROLE,2020,2170,2010,4180,40
KABAROLE,2021,2220,2050,4270,40
KABAROLE,2022,2260,2090,4350,40
KABAROLE,2023,2300,2130,4430,40
KABAROLE,2024,2340,2170,4510,40
KABAROLE,2025,2380,2200,4580,40
KABERAMAIDO,2015,310,350,660,40
KABERAMAIDO,2016,320,370,690,40
KABERAMAIDO,2017,320,380,700,40
KABERAMAIDO,2018,340,400,740,40
KABERAMAIDO,2019,360,430,790,40
KABERAMAIDO,2020,370,450,820,40
KABERAMAIDO,2021,390,480,870,40
KABERAMAIDO,2022,420,510,930,40
KABERAMAIDO,2023,440,530,970,40
KABERAMAIDO,2024,460,560,1020,40
KABERAMAIDO,2025,480,600,1080,40
KAGADI,2015,1700,2000,3700,40
KAGADI,2016,1760,2070,3830,40
KAGADI,2017,1830,2140,3970,40
KAGADI,2018,1890,2210,4100,40
KAGADI,2019,1960,2290,4250,40
KAGADI,2020,2030,2370,4400,40
KAGADI,2021,2100,2450,4550,40
KAGADI,2022,2170,2530,4700,40
KAGADI,2023,2250,2610,4860,40
KAGADI,2024,2320,2690,5010,40
KAGADI,2025,2390,2770,5160,40
KAKUMIRO,2015,1620,1600,3220,40
KAKUMIRO,2016,1770,1730,3500,40
KAKUMIRO,2017,1920,1880,3800,40
KAKUMIRO,2018,2090,2040,4130,40
KAKUMIRO,2019,2280,2210,4490,40
KAKUMIRO,2020,2470,2390,4860,40
KAKUMIRO,2021,2690,2580,5270,40
KAKUMIRO,2022,2920,2790,5710,40
KAKUMIRO,2023,3160,3020,6180,40
KAKUMIRO,2024,3430,3260,6690,40
KAKUMIRO,2025,3710,3520,7230,40
KALAKI,2015,460,600,1060,40
KALAKI,2016,480,630,1110,40
KALAKI,2017,500,650,1150,40
KALAKI,2018,520,680,1200,40
KALAKI,2019,550,710,1260,40
KALAKI,2020,570,730,1300,40
KALAKI,2021,590,760,1350,40
KALAKI,2022,620,790,1410,40
KALAKI,2023,640,820,1460,40
KALAKI,2024,660,850,1510,40
KALAKI,2025,690,870,1560,40
KALANGALA,2015,690,340,1030,40
KALANGALA,2016,710,350,1060,40
KALANGALA,2017,740,370,1110,40
KALANGALA,2018,760,380,1140,40
KALANGALA,2019,790,390,1180,40
KALANGALA,2020,810,410,1220,40
KALANGALA,2021,840,430,1270,40
KALANGALA,2022,870,440,1310,40
KALANGALA,2023,900,460,1360,40
KALANGALA,2024,920,480,1400,40
KALANGALA,2025,950,490,1440,40
KALIRO,2015,890,1110,2000,40
KALIRO,2016,900,1150,2050,40
KALIRO,2017,930,1190,2120,40
KALIRO,2018,970,1250,2220,40
KALIRO,2019,1010,1320,2330,40
KALIRO,2020,1060,1390,2450,40
KALIRO,2021,1110,1460,2570,40
KALIRO,2022,1160,1540,2700,40
KALIRO,2023,1210,1620,2830,40
KALIRO,2024,1260,1700,2960,40
KALIRO,2025,1320,1780,3100,40
KALUNGU,2015,720,740,1460,40
KALUNGU,2016,720,750,1470,40
KALUNGU,2017,720,760,1480,40
KALUNGU,2018,730,780,1510,40
KALUNGU,2019,740,800,1540,40
KALUNGU,2020,760,830,1590,40
KALUNGU,2021,780,850,1630,40
KALUNGU,2022,790,870,1660,40
KALUNGU,2023,810,890,1700,40
KALUNGU,2024,830,910,1740,40
KALUNGU,2025,840,930,1770,40
KAMPALA,2015,10910,9720,20630,40
KAMPALA,2016,11130,9910,21040,40
KAMPALA,2017,11350,10100,21450,40
KAMPALA,2018,11570,10290,21860,40
KAMPALA,2019,11790,10480,22270,40
KAMPALA,2020,12000,10670,22670,40
KAMPALA,2021,12220,10850,23070,40
KAMPALA,2022,12420,11040,23460,40
KAMPALA,2023,12620,11210,23830,40
KAMPALA,2024,12810,11390,24200,40
KAMPALA,2025,13000,11550,24550,40
KAMULI,2015,1960,2480,4440,40
KAMULI,2016,1980,2550,4530,40
KAMULI,2017,2020,2620,4640,40
KAMULI,2018,2080,2720,4800,40
KAMULI,2019,2160,2830,4990,40
KAMULI,2020,2240,2950,5190,40
KAMULI,2021,2310,3070,5380,40
KAMULI,2022,2400,3200,5600,40
KAMULI,2023,2490,3310,5800,40
KAMULI,2024,2570,3440,6010,40
KAMULI,2025,2660,3560,6220,40
KAMWENGE,2015,1450,1640,3090,40
KAMWENGE,2016,1510,1710,3220,40
KAMWENGE,2017,1570,1760,3330,40
KAMWENGE,2018,1640,1830,3470,40
KAMWENGE,2019,1700,1890,3590,40
KAMWENGE,2020,1770,1950,3720,40
KAMWENGE,2021,1840,2020,3860,40
KAMWENGE,2022,1910,2080,3990,40
KAMWENGE,2023,1970,2150,4120,40
KAMWENGE,2024,2050,2220,4270,40
KAMWENGE,2025,2120,2290,4410,40
KANUNGU,2015,1350,1600,2950,40
KANUNGU,2016,1380,1630,3010,40
KANUNGU,2017,1400,1650,3050,40
KANUNGU,2018,1430,1680,3110,40
KANUNGU,2019,1450,1710,3160,40
KANUNGU,2020,1470,1730,3200,40
KANUNGU,2021,1500,1760,3260,40
KANUNGU,2022,1520,1780,3300,40
KANUNGU,2023,1540,1800,3340,40
KANUNGU,2024,1560,1830,3390,40
KANUNGU,2025,1580,1850,3430,40
KAPCHORWA,2015,530,610,1140,40
KAPCHORWA,2016,550,620,1170,40
KAPCHORWA,2017,560,640,1200,40
KAPCHORWA,2018,580,660,1240,40
KAPCHORWA,2019,600,680,1280,40
KAPCHORWA,2020,610,690,1300,40
KAPCHORWA,2021,630,710,1340,40
KAPCHORWA,2022,650,730,1380,40
KAPCHORWA,2023,670,750,1420,40
KAPCHORWA,2024,680,770,1450,40
KAPCHORWA,2025,700,780,1480,40
KAPELEBYONG,2015,280,410,690,40
KAPELEBYONG,2016,280,430,710,40
KAPELEBYONG,2017,290,440,730,40
KAPELEBYONG,2018,300,460,760,40
KAPELEBYONG,2019,310,480,790,40
KAPELEBYONG,2020,330,500,830,40
KAPELEBYONG,2021,340,530,870,40
KAPELEBYONG,2022,360,550,910,40
KAPELEBYONG,2023,370,580,950,40
KAPELEBYONG,2024,390,600,990,40
KAPELEBYONG,2025,400,630,1030,40
KASESE,2015,3090,3760,6850,40
KASESE,2016,3120,3850,6970,40
KASESE,2017,3180,3960,7140,40
KASESE,2018,3270,4100,7370,40
KASESE,2019,3380,4270,7650,40
KASESE,2020,3500,4450,7950,40
KASESE,2021,3620,4630,8250,40
KASESE,2022,3750,4810,8560,40
KASESE,2023,3870,4990,8860,40
KASESE,2024,4000,5170,9170,40
KASESE,2025,4130,5350,9480,40
KASSANDA,2015,1670,1760,3430,40
KASSANDA,2016,1710,1800,3510,40
KASSANDA,2017,1760,1840,3600,40
KASSANDA,2018,1810,1870,3680,40
KASSANDA,2019,1860,1910,3770,40
KASSANDA,2020,1910,1950,3860,40
KASSANDA,2021,1960,1990,3950,40
KASSANDA,2022,2010,2030,4040,40
KASSANDA,2023,2060,2060,4120,40
KASSANDA,2024,2110,2100,4210,40
KASSANDA,2025,2160,2130,4290,40
KATAKWI,2015,510,730,1240,40
KATAKWI,2016,520,750,1270,40
KATAKWI,2017,530,780,1310,40
KATAKWI,2018,550,810,1360,40
KATAKWI,2019,570,840,1410,40
KATAKWI,2020,600,880,1480,40
KATAKWI,2021,620,920,1540,40
KATAKWI,2022,640,960,1600,40
KATAKWI,2023,660,1000,1660,40
KATAKWI,2024,690,1040,1730,40
KATAKWI,2025,720,1080,1800,40
KAYUNGA,2015,1640,1890,3530,40
KAYUNGA,2016,1650,1920,3570,40
KAYUNGA,2017,1670,1970,3640,40
KAYUNGA,2018,1710,2030,3740,40
KAYUNGA,2019,1760,2100,3860,40
KAYUNGA,2020,1810,2180,3990,40
KAYUNGA,2021,1870,2250,4120,40
KAYUNGA,2022,1920,2330,4250,40
KAYUNGA,2023,1980,2400,4380,40
KAYUNGA,2024,2030,2470,4500,40
KAYUNGA,2025,2090,2550,4640,40
KAZO,2015,1000,1150,2150,40
KAZO,2016,1040,1190,2230,40
KAZO,2017,1080,1230,2310,40
KAZO,2018,1120,1280,2400,40
KAZO,2019,1160,1320,2480,40
KAZO,2020,1200,1370,2570,40
KAZO,2021,1240,1410,2650,40
KAZO,2022,1290,1450,2740,40
KAZO,2023,1330,1500,2830,40
KAZO,2024,1380,1550,2930,40
KAZO,2025,1420,1600,3020,40
KIBAALE,2015,690,740,1430,40
KIBAALE,2016,740,780,1520,40
KIBAALE,2017,790,830,1620,40
KIBAALE,2018,840,870,1710,40
KIBAALE,2019,890,930,1820,40
KIBAALE,2020,940,980,1920,40
KIBAALE,2021,1000,1030,2030,40
KIBAALE,2022,1060,1090,2150,40
KIBAALE,2023,1130,1150,2280,40
KIBAALE,2024,1190,1210,2400,40
KIBAALE,2025,1260,1270,2530,40
KIBOGA,2015,640,650,1290,40
KIBOGA,2016,640,660,1300,40
KIBOGA,2017,640,690,1330,40
KIBOGA,2018,660,700,1360,40
KIBOGA,2019,680,730,1410,40
KIBOGA,2020,710,760,1470,40
KIBOGA,2021,730,790,1520,40
KIBOGA,2022,750,820,1570,40
KIBOGA,2023,790,870,1660,40
KIBOGA,2024,810,900,1710,40
KIBOGA,2025,840,930,1770,40
KIBUKU,2015,590,780,1370,40
KIBUKU,2016,610,810,1420,40
KIBUKU,2017,620,850,1470,40
KIBUKU,2018,650,890,1540,40
KIBUKU,2019,680,940,1620,40
KIBUKU,2020,720,1000,1720,40
KIBUKU,2021,750,1050,1800,40
KIBUKU,2022,790,1110,1900,40
KIBUKU,2023,820,1170,1990,40
KIBUKU,2024,860,1230,2090,40
KIBUKU,2025,900,1290,2190,40
KIKUUBE,2015,1700,1580,3280,40
KIKUUBE,2016,1800,1660,3460,40
KIKUUBE,2017,1890,1740,3630,40
KIKUUBE,2018,1990,1830,3820,40
KIKUUBE,2019,2100,1920,4020,40
KIKUUBE,2020,2210,2020,4230,40
KIKUUBE,2021,2320,2120,4440,40
KIKUUBE,2022,2440,2220,4660,40
KIKUUBE,2023,2560,2320,4880,40
KIKUUBE,2024,2680,2430,5110,40
KIKUUBE,2025,2810,2540,5350,40
KIRUHURA,2015,1180,1080,2260,40
KIRUHURA,2016,1220,1120,2340,40
KIRUHURA,2017,1270,1160,2430,40
KIRUHURA,2018,1320,1190,2510,40
KIRUHURA,2019,1370,1240,2610,40
KIRUHURA,2020,1420,1280,2700,40
KIRUHURA,2021,1470,1320,2790,40
KIRUHURA,2022,1520,1370,2890,40
KIRUHURA,2023,1570,1410,2980,40
KIRUHURA,2024,1620,1450,3070,40
KIRUHURA,2025,1670,1490,3160,40
KIRYANDONGO,2015,940,1090,2030,40
KIRYANDONGO,2016,950,1120,2070,40
KIRYANDONGO,2017,970,1150,2120,40
KIRYANDONGO,2018,1010,1200,2210,40
KIRYANDONGO,2019,1050,1260,2310,40
KIRYANDONGO,2020,1090,1320,2410,40
KIRYANDONGO,2021,1140,1380,2520,40
KIRYANDONGO,2022,1180,1440,2620,40
KIRYANDONGO,2023,1230,1500,2730,40
KIRYANDONGO,2024,1270,1570,2840,40
KIRYANDONGO,2025,1330,1630,2960,40
KISORO,2015,760,1400,2160,40
KISORO,2016,760,1440,2200,40
KISORO,2017,770,1470,2240,40
KISORO,2018,790,1530,2320,40
KISORO,2019,810,1590,2400,40
KISORO,2020,840,1650,2490,40
KISORO,2021,870,1720,2590,40
KISORO,2022,890,1780,2670,40
KISORO,2023,910,1840,2750,40
KISORO,2024,940,1900,2840,40
KISORO,2025,960,1970,2930,40
KITAGWENDA,2015,770,880,1650,40
KITAGWENDA,2016,800,920,1720,40
KITAGWENDA,2017,840,950,1790,40
KITAGWENDA,2018,870,980,1850,40
KITAGWENDA,2019,900,1020,1920,40
KITAGWENDA,2020,940,1050,1990,40
KITAGWENDA,2021,970,1090,2060,40
KITAGWENDA,2022,1010,1120,2130,40
KITAGWENDA,2023,1050,1160,2210,40
KITAGWENDA,2024,1090,1200,2290,40
KITAGWENDA,2025,1130,1230,2360,40
KITGUM,2015,640,910,1550,40
KITGUM,2016,640,920,1560,40
KITGUM,2017,650,940,1590,40
KITGUM,2018,660,970,1630,40
KITGUM,2019,680,1000,1680,40
KITGUM,2020,700,1040,1740,40
KITGUM,2021,720,1070,1790,40
KITGUM,2022,740,1100,1840,40
KITGUM,2023,750,1140,1890,40
KITGUM,2024,780,1170,1950,40
KITGUM,2025,790,1210,2000,40
KOBOKO,2015,720,920,1640,40
KOBOKO,2016,740,960,1700,40
KOBOKO,2017,760,1000,1760,40
KOBOKO,2018,790,1050,1840,40
KOBOKO,2019,830,1110,1940,40
KOBOKO,2020,880,1180,2060,40
KOBOKO,2021,920,1250,2170,40
KOBOKO,2022,970,1320,2290,40
KOBOKO,2023,1010,1390,2400,40
KOBOKO,2024,1060,1460,2520,40
KOBOKO,2025,1110,1530,2640,40
KOLE,2015,1060,1350,2410,40
KOLE,2016,1100,1390,2490,40
KOLE,2017,1140,1430,2570,40
KOLE,2018,1170,1470,2640,40
KOLE,2019,1210,1510,2720,40
KOLE,2020,1250,1550,2800,40
KOLE,2021,1290,1590,2880,40
KOLE,2022,1320,1630,2950,40
KOLE,2023,1360,1670,3030,40
KOLE,2024,1400,1710,3110,40
KOLE,2025,1440,1760,3200,40
KOTIDO,2015,700,780,1480,40
KOTIDO,2016,710,800,1510,40
KOTIDO,2017,730,820,1550,40
KOTIDO,2018,740,850,1590,40
KOTIDO,2019,770,880,1650,40
KOTIDO,2020,800,920,1720,40
KOTIDO,2021,830,960,1790,40
KOTIDO,2022,850,1000,1850,40
KOTIDO,2023,880,1040,1920,40
KOTIDO,2024,910,1070,1980,40
KOTIDO,2025,940,1110,2050,40
KUMI,2015,800,1000,1800,40
KUMI,2016,810,1030,1840,40
KUMI,2017,830,1060,1890,40
KUMI,2018,860,1110,1970,40
KUMI,2019,890,1170,2060,40
KUMI,2020,930,1230,2160,40
KUMI,2021,970,1280,2250,40
KUMI,2022,1010,1340,2350,40
KUMI,2023,1050,1400,2450,40
KUMI,2024,1100,1460,2560,40
KUMI,2025,1140,1520,2660,40
KWANIA,2015,810,1040,1850,40
KWANIA,2016,830,1070,1900,40
KWANIA,2017,860,1100,1960,40
KWANIA,2018,880,1140,2020,40
KWANIA,2019,910,1170,2080,40
KWANIA,2020,940,1200,2140,40
KWANIA,2021,960,1230,2190,40
KWANIA,2022,990,1260,2250,40
KWANIA,2023,1020,1290,2310,40
KWANIA,2024,1040,1330,2370,40
KWANIA,2025,1070,1360,2430,40
KWEEN,2015,430,480,910,40
KWEEN,2016,440,490,930,40
KWEEN,2017,460,510,970,40
KWEEN,2018,470,520,990,40
KWEEN,2019,490,530,1020,40
KWEEN,2020,500,540,1040,40
KWEEN,2021,510,560,1070,40
KWEEN,2022,530,570,1100,40
KWEEN,2023,540,580,1120,40
KWEEN,2024,560,590,1150,40
KWEEN,2025,570,600,1170,40
KYANKWANZI,2015,1480,1190,2670,40
KYANKWANZI,2016,1560,1240,2800,40
KYANKWANZI,2017,1640,1300,2940,40
KYANKWANZI,2018,1720,1360,3080,40
KYANKWANZI,2019,1810,1420,3230,40
KYANKWANZI,2020,1900,1490,3390,40
KYANKWANZI,2021,1990,1560,3550,40
KYANKWANZI,2022,2090,1620,3710,40
KYANKWANZI,2023,2190,1690,3880,40
KYANKWANZI,2024,2290,1770,4060,40
KYANKWANZI,2025,2390,1840,4230,40
KYEGEGWA,2015,1480,1530,3010,40
KYEGEGWA,2016,1600,1650,3250,40
KYEGEGWA,2017,1740,1780,3520,40
KYEGEGWA,2018,1880,1920,3800,40
KYEGEGWA,2019,2030,2070,4100,40
KYEGEGWA,2020,2190,2230,4420,40
KYEGEGWA,2021,2370,2400,4770,40
KYEGEGWA,2022,2560,2590,5150,40
KYEGEGWA,2023,2760,2780,5540,40
KYEGEGWA,2024,2970,2990,5960,40
KYEGEGWA,2025,3200,3210,6410,40
KYENJOJO,2015,2240,2330,4570,40
KYENJOJO,2016,2330,2410,4740,40
KYENJOJO,2017,2430,2500,4930,40
KYENJOJO,2018,2530,2590,5120,40
KYENJOJO,2019,2630,2690,5320,40
KYENJOJO,2020,2730,2780,5510,40
KYENJOJO,2021,2840,2880,5720,40
KYENJOJO,2022,2940,2980,5920,40
KYENJOJO,2023,3050,3080,6130,40
KYENJOJO,2024,3160,3180,6340,40
KYENJOJO,2025,3280,3280,6560,40
KYOTERA,2015,1030,960,1990,40
KYOTERA,2016,1030,980,2010,40
KYOTERA,2017,1050,1000,2050,40
KYOTERA,2018,1070,1030,2100,40
KYOTERA,2019,1090,1060,2150,40
KYOTERA,2020,1120,1100,2220,40
KYOTERA,2021,1150,1130,2280,40
KYOTERA,2022,1180,1160,2340,40
KYOTERA,2023,1210,1200,2410,40
KYOTERA,2024,1250,1230,2480,40
KYOTERA,2025,1280,1260,2540,40
KARENGA,2015,280,290,570,40
KARENGA,2016,290,300,590,40
KARENGA,2017,300,310,610,40
KARENGA,2018,310,310,620,40
KARENGA,2019,320,320,640,40
KARENGA,2020,320,330,650,40
KARENGA,2021,330,340,670,40
KARENGA,2022,340,340,680,40
KARENGA,2023,350,350,700,40
KARENGA,2024,360,360,720,40
KARENGA,2025,360,370,730,40
LAMWO,2015,470,600,1070,40
LAMWO,2016,460,610,1070,40
LAMWO,2017,460,620,1080,40
LAMWO,2018,470,640,1110,40
LAMWO,2019,480,660,1140,40
LAMWO,2020,490,680,1170,40
LAMWO,2021,500,700,1200,40
LAMWO,2022,510,720,1230,40
LAMWO,2023,520,740,1260,40
LAMWO,2024,530,770,1300,40
LAMWO,2025,540,790,1330,40
LIRA,2015,2030,2650,4680,40
LIRA,2016,2090,2720,4810,40
LIRA,2017,2150,2800,4950,40
LIRA,2018,2210,2880,5090,40
LIRA,2019,2270,2960,5230,40
LIRA,2020,2330,3040,5370,40
LIRA,2021,2390,3120,5510,40
LIRA,2022,2450,3200,5650,40
LIRA,2023,2510,3280,5790,40
LIRA,2024,2570,3360,5930,40
LIRA,2025,2630,3440,6070,40
LUUKA,2015,940,1220,2160,40
LUUKA,2016,950,1240,2190,40
LUUKA,2017,970,1270,2240,40
LUUKA,2018,990,1320,2310,40
LUUKA,2019,1020,1370,2390,40
LUUKA,2020,1050,1420,2470,40
LUUKA,2021,1080,1480,2560,40
LUUKA,2022,1120,1530,2650,40
LUUKA,2023,1150,1580,2730,40
LUUKA,2024,1180,1640,2820,40
LUUKA,2025,1210,1690,2900,40
LUWERO,2015,2020,2020,4040,40
LUWERO,2016,2040,2070,4110,40
LUWERO,2017,2080,2130,4210,40
LUWERO,2018,2140,2200,4340,40
LUWERO,2019,2220,2290,4510,40
LUWERO,2020,2300,2390,4690,40
LUWERO,2021,2380,2490,4870,40
LUWERO,2022,2470,2590,5060,40
LUWERO,2023,2550,2690,5240,40
LUWERO,2024,2630,2790,5420,40
LUWERO,2025,2720,2890,5610,40
LWENGO,2015,1020,1130,2150,40
LWENGO,2016,1010,1140,2150,40
LWENGO,2017,1010,1160,2170,40
LWENGO,2018,1030,1180,2210,40
LWENGO,2019,1050,1220,2270,40
LWENGO,2020,1070,1250,2320,40
LWENGO,2021,1100,1290,2390,40
LWENGO,2022,1120,1330,2450,40
LWENGO,2023,1140,1360,2500,40
LWENGO,2024,1160,1390,2550,40
LWENGO,2025,1180,1410,2590,40
LYANTONDE,2015,350,350,700,40
LYANTONDE,2016,360,360,720,40
LYANTONDE,2017,370,370,740,40
LYANTONDE,2018,370,380,750,40
LYANTONDE,2019,380,390,770,40
LYANTONDE,2020,390,410,800,40
LYANTONDE,2021,410,420,830,40
LYANTONDE,2022,420,440,860,40
LYANTONDE,2023,440,460,900,40
LYANTONDE,2024,450,490,940,40
LYANTONDE,2025,480,510,990,40
MANAFWA,2015,700,780,1480,40
MANAFWA,2016,710,800,1510,40
MANAFWA,2017,730,820,1550,40
MANAFWA,2018,750,830,1580,40
MANAFWA,2019,770,850,1620,40
MANAFWA,2020,790,870,1660,40
MANAFWA,2021,800,890,1690,40
MANAFWA,2022,820,910,1730,40
MANAFWA,2023,840,920,1760,40
MANAFWA,2024,860,940,1800,40
MANAFWA,2025,870,960,1830,40
MARACHA,2015,770,1320,2090,40
MARACHA,2016,790,1340,2130,40
MARACHA,2017,800,1370,2170,40
MARACHA,2018,820,1400,2220,40
MARACHA,2019,830,1420,2250,40
MARACHA,2020,850,1450,2300,40
MARACHA,2021,870,1470,2340,40
MARACHA,2022,880,1500,2380,40
MARACHA,2023,900,1520,2420,40
MARACHA,2024,910,1550,2460,40
MARACHA,2025,930,1570,2500,40
MASAKA,2015,1360,1190,2550,40
MASAKA,2016,1370,1220,2590,40
MASAKA,2017,1390,1250,2640,40
MASAKA,2018,1430,1290,2720,40
MASAKA,2019,1480,1340,2820,40
MASAKA,2020,1530,1400,2930,40
MASAKA,2021,1580,1460,3040,40
MASAKA,2022,1620,1510,3130,40
MASAKA,2023,1680,1560,3240,40
MASAKA,2024,1730,1620,3350,40
MASAKA,2025,1780,1670,3450,40
MASINDI,2015,1840,1830,3670,40
MASINDI,2016,1890,1880,3770,40
MASINDI,2017,1950,1930,3880,40
MASINDI,2018,2010,1980,3990,40
MASINDI,2019,2060,2040,4100,40
MASINDI,2020,2120,2090,4210,40
MASINDI,2021,2180,2140,4320,40
MASINDI,2022,2230,2190,4420,40
MASINDI,2023,2290,2240,4530,40
MASINDI,2024,2350,2290,4640,40
MASINDI,2025,2400,2340,4740,40
MAYUGE,2015,1870,2510,4380,40
MAYUGE,2016,1900,2590,4490,40
MAYUGE,2017,1950,2690,4640,40
MAYUGE,2018,2020,2810,4830,40
MAYUGE,2019,2100,2950,5050,40
MAYUGE,2020,2190,3100,5290,40
MAYUGE,2021,2280,3250,5530,40
MAYUGE,2022,2380,3410,5790,40
MAYUGE,2023,2470,3560,6030,40
MAYUGE,2024,2570,3720,6290,40
MAYUGE,2025,2670,3890,6560,40
MBALE,2015,1900,2010,3910,40
MBALE,2016,1930,2080,4010,40
MBALE,2017,1970,2170,4140,40
MBALE,2018,2040,2260,4300,40
MBALE,2019,2120,2380,4500,40
MBALE,2020,2220,2510,4730,40
MBALE,2021,2300,2640,4940,40
MBALE,2022,2400,2780,5180,40
MBALE,2023,2490,2910,5400,40
MBALE,2024,2590,3050,5640,40
MBALE,2025,2690,3190,5880,40
MBARARA,2015,2180,2250,4430,40
MBARARA,2016,2230,2300,4530,40
MBARARA,2017,2280,2350,4630,40
MBARARA,2018,2330,2390,4720,40
MBARARA,2019,2380,2450,4830,40
MBARARA,2020,2440,2490,4930,40
MBARARA,2021,2490,2540,5030,40
MBARARA,2022,2530,2590,5120,40
MBARARA,2023,2590,2640,5230,40
MBARARA,2024,2630,2680,5310,40
MBARARA,2025,2680,2730,5410,40
MITOOMA,2015,920,1260,2180,40
MITOOMA,2016,930,1270,2200,40
MITOOMA,2017,940,1280,2220,40
MITOOMA,2018,950,1290,2240,40
MITOOMA,2019,960,1300,2260,40
MITOOMA,2020,970,1310,2280,40
MITOOMA,2021,980,1320,2300,40
MITOOMA,2022,990,1330,2320,40
MITOOMA,2023,1000,1340,2340,40
MITOOMA,2024,1010,1350,2360,40
MITOOMA,2025,1020,1350,2370,40
MITYANA,2015,1380,1360,2740,40
MITYANA,2016,1380,1390,2770,40
MITYANA,2017,1400,1420,2820,40
MITYANA,2018,1430,1460,2890,40
MITYANA,2019,1470,1510,2980,40
MITYANA,2020,1510,1560,3070,40
MITYANA,2021,1560,1620,3180,40
MITYANA,2022,1600,1670,3270,40
MITYANA,2023,1640,1720,3360,40
MITYANA,2024,1690,1780,3470,40
MITYANA,2025,1730,1820,3550,40
MOROTO,2015,490,410,900,40
MOROTO,2016,490,410,900,40
MOROTO,2017,500,430,930,40
MOROTO,2018,510,450,960,40
MOROTO,2019,530,470,1000,40
MOROTO,2020,540,490,1030,40
MOROTO,2021,560,510,1070,40
MOROTO,2022,580,530,1110,40
MOROTO,2023,600,550,1150,40
MOROTO,2024,620,570,1190,40
MOROTO,2025,640,600,1240,40
MOYO,2015,470,570,1040,40
MOYO,2016,480,590,1070,40
MOYO,2017,500,600,1100,40
MOYO,2018,510,610,1120,40
MOYO,2019,520,620,1140,40
MOYO,2020,530,640,1170,40
MOYO,2021,550,650,1200,40
MOYO,2022,560,660,1220,40
MOYO,2023,570,670,1240,40
MOYO,2024,580,680,1260,40
MOYO,2025,590,700,1290,40
MPIGI,2015,1140,1090,2230,40
MPIGI,2016,1150,1110,2260,40
MPIGI,2017,1180,1150,2330,40
MPIGI,2018,1210,1190,2400,40
MPIGI,2019,1250,1240,2490,40
MPIGI,2020,1290,1290,2580,40
MPIGI,2021,1340,1350,2690,40
MPIGI,2022,1380,1410,2790,40
MPIGI,2023,1430,1460,2890,40
MPIGI,2024,1470,1510,2980,40
MPIGI,2025,1530,1560,3090,40
MUBENDE,2015,1560,1550,3110,40
MUBENDE,2016,1630,1630,3260,40
MUBENDE,2017,1700,1720,3420,40
MUBENDE,2018,1800,1830,3630,40
MUBENDE,2019,1910,1960,3870,40
MUBENDE,2020,2030,2110,4140,40
MUBENDE,2021,2170,2260,4430,40
MUBENDE,2022,2300,2410,4710,40
MUBENDE,2023,2440,2570,5010,40
MUBENDE,2024,2590,2740,5330,40
MUBENDE,2025,2750,2920,5670,40
MUKONO,2015,2840,2830,5670,40
MUKONO,2016,2880,2920,5800,40
MUKONO,2017,2940,3030,5970,40
MUKONO,2018,3030,3160,6190,40
MUKONO,2019,3140,3310,6450,40
MUKONO,2020,3270,3480,6750,40
MUKONO,2021,3380,3640,7020,40
MUKONO,2022,3510,3810,7320,40
MUKONO,2023,3640,3990,7630,40
MUKONO,2024,3770,4160,7930,40
MUKONO,2025,3900,4330,8230,40
NABILATUK,2015,210,250,460,40
NABILATUK,2016,220,270,490,40
NABILATUK,2017,240,280,520,40
NABILATUK,2018,240,300,540,40
NABILATUK,2019,260,320,580,40
NABILATUK,2020,270,340,610,40
NABILATUK,2021,290,360,650,40
NABILATUK,2022,320,380,700,40
NABILATUK,2023,330,400,730,40
NABILATUK,2024,350,420,770,40
NABILATUK,2025,370,450,820,40
NAKAPIRIPIRIT,2015,330,320,650,40
NAKAPIRIPIRIT,2016,350,340,690,40
NAKAPIRIPIRIT,2017,360,350,710,40
NAKAPIRIPIRIT,2018,380,380,760,40
NAKAPIRIPIRIT,2019,400,400,800,40
NAKAPIRIPIRIT,2020,420,420,840,40
NAKAPIRIPIRIT,2021,450,450,900,40
NAKAPIRIPIRIT,2022,470,480,950,40
NAKAPIRIPIRIT,2023,490,500,990,40
NAKAPIRIPIRIT,2024,520,540,1060,40
NAKAPIRIPIRIT,2025,550,570,1120,40
NAKASEKE,2015,1660,1410,3070,40
NAKASEKE,2016,1720,1450,3170,40
NAKASEKE,2017,1780,1480,3260,40
NAKASEKE,2018,1840,1520,3360,40
NAKASEKE,2019,1910,1550,3460,40
NAKASEKE,2020,1980,1590,3570,40
NAKASEKE,2021,2040,1620,3660,40
NAKASEKE,2022,2110,1660,3770,40
NAKASEKE,2023,2180,1690,3870,40
NAKASEKE,2024,2250,1730,3980,40
NAKASEKE,2025,2320,1760,4080,40
NAKASONGOLA,2015,780,700,1480,40
NAKASONGOLA,2016,790,720,1510,40
NAKASONGOLA,2017,810,740,1550,40
NAKASONGOLA,2018,840,780,1620,40
NAKASONGOLA,2019,870,820,1690,40
NAKASONGOLA,2020,920,850,1770,40
NAKASONGOLA,2021,950,890,1840,40
NAKASONGOLA,2022,990,930,1920,40
NAKASONGOLA,2023,1030,970,2000,40
NAKASONGOLA,2024,1080,1010,2090,40
NAKASONGOLA,2025,1120,1050,2170,40
NAMAYINGO,2015,810,850,1660,40
NAMAYINGO,2016,820,870,1690,40
NAMAYINGO,2017,820,890,1710,40
NAMAYINGO,2018,850,910,1760,40
NAMAYINGO,2019,870,940,1810,40
NAMAYINGO,2020,890,980,1870,40
NAMAYINGO,2021,920,1010,1930,40
NAMAYINGO,2022,950,1040,1990,40
NAMAYINGO,2023,970,1070,2040,40
NAMAYINGO,2024,990,1100,2090,40
NAMAYINGO,2025,1020,1130,2150,40
NAMISINDWA,2015,850,930,1780,40
NAMISINDWA,2016,870,950,1820,40
NAMISINDWA,2017,890,970,1860,40
NAMISINDWA,2018,920,1000,1920,40
NAMISINDWA,2019,940,1020,1960,40
NAMISINDWA,2020,970,1040,2010,40
NAMISINDWA,2021,990,1060,2050,40
NAMISINDWA,2022,1020,1090,2110,40
NAMISINDWA,2023,1040,1110,2150,40
NAMISINDWA,2024,1070,1130,2200,40
NAMISINDWA,2025,1090,1150,2240,40
NAMUTUMBA,2015,950,1180,2130,40
NAMUTUMBA,2016,970,1220,2190,40
NAMUTUMBA,2017,1000,1280,2280,40
NAMUTUMBA,2018,1040,1340,2380,40
NAMUTUMBA,2019,1090,1400,2490,40
NAMUTUMBA,2020,1140,1480,2620,40
NAMUTUMBA,2021,1180,1550,2730,40
NAMUTUMBA,2022,1240,1630,2870,40
NAMUTUMBA,2023,1290,1710,3000,40
NAMUTUMBA,2024,1350,1790,3140,40
NAMUTUMBA,2025,1410,1870,3280,40
NAPAK,2015,480,590,1070,40
NAPAK,2016,490,600,1090,40
NAPAK,2017,490,620,1110,40
NAPAK,2018,500,640,1140,40
NAPAK,2019,510,670,1180,40
NAPAK,2020,530,700,1230,40
NAPAK,2021,540,720,1260,40
NAPAK,2022,550,750,1300,40
NAPAK,2023,570,770,1340,40
NAPAK,2024,580,800,1380,40
NAPAK,2025,600,830,1430,40
NEBBI,2015,1000,1370,2370,40
NEBBI,2016,1030,1410,2440,40
NEBBI,2017,1060,1450,2510,40
NEBBI,2018,1090,1490,2580,40
NEBBI,2019,1130,1530,2660,40
NEBBI,2020,1160,1570,2730,40
NEBBI,2021,1200,1610,2810,40
NEBBI,2022,1230,1650,2880,40
NEBBI,2023,1260,1690,2950,40
NEBBI,2024,1300,1730,3030,40
NEBBI,2025,1330,1770,3100,40
NGORA,2015,510,580,1090,40
NGORA,2016,520,600,1120,40
NGORA,2017,530,610,1140,40
NGORA,2018,550,640,1190,40
NGORA,2019,570,670,1240,40
NGORA,2020,590,700,1290,40
NGORA,2021,620,730,1350,40
NGORA,2022,640,760,1400,40
NGORA,2023,660,800,1460,40
NGORA,2024,690,820,1510,40
NGORA,2025,710,860,1570,40
NTOROKO,2015,310,340,650,40
NTOROKO,2016,320,350,670,40
NTOROKO,2017,330,360,690,40
NTOROKO,2018,330,370,700,40
NTOROKO,2019,340,380,720,40
NTOROKO,2020,360,400,760,40
NTOROKO,2021,370,410,780,40
NTOROKO,2022,380,430,810,40
NTOROKO,2023,400,450,850,40
NTOROKO,2024,410,460,870,40
NTOROKO,2025,430,470,900,40
NTUNGAMO,2015,2520,3180,5700,40
NTUNGAMO,2016,2570,3240,5810,40
NTUNGAMO,2017,2630,3300,5930,40
NTUNGAMO,2018,2680,3360,6040,40
NTUNGAMO,2019,2740,3420,6160,40
NTUNGAMO,2020,2790,3480,6270,40
NTUNGAMO,2021,2840,3540,6380,40
NTUNGAMO,2022,2900,3590,6490,40
NTUNGAMO,2023,2950,3650,6600,40
NTUNGAMO,2024,3000,3700,6700,40
NTUNGAMO,2025,3050,3750,6800,40
NWOYA,2015,720,900,1620,40
NWOYA,2016,790,990,1780,40
NWOYA,2017,880,1090,1970,40
NWOYA,2018,970,1200,2170,40
NWOYA,2019,1070,1320,2390,40
NWOYA,2020,1180,1450,2630,40
NWOYA,2021,1300,1600,2900,40
NWOYA,2022,1430,1750,3180,40
NWOYA,2023,1580,1930,3510,40
NWOYA,2024,1730,2110,3840,40
NWOYA,2025,1900,2320,4220,40
OBONGI,2015,190,230,420,40
OBONGI,2016,190,230,420,40
OBONGI,2017,190,240,430,40
OBONGI,2018,200,240,440,40
OBONGI,2019,210,260,470,40
OBONGI,2020,210,270,480,40
OBONGI,2021,220,280,500,40
OBONGI,2022,230,290,520,40
OBONGI,2023,240,300,540,40
OBONGI,2024,240,310,550,40
OBONGI,2025,250,320,570,40
OMORO,2015,560,700,1260,40
OMORO,2016,570,720,1290,40
OMORO,2017,590,750,1340,40
OMORO,2018,620,790,1410,40
OMORO,2019,640,830,1470,40
OMORO,2020,680,870,1550,40
OMORO,2021,700,930,1630,40
OMORO,2022,740,980,1720,40
OMORO,2023,770,1020,1790,40
OMORO,2024,810,1070,1880,40
OMORO,2025,840,1120,1960,40
OTUKE,2015,500,700,1200,40
OTUKE,2016,520,730,1250,40
OTUKE,2017,550,760,1310,40
OTUKE,2018,570,790,1360,40
OTUKE,2019,600,820,1420,40
OTUKE,2020,620,860,1480,40
OTUKE,2021,650,890,1540,40
OTUKE,2022,680,930,1610,40
OTUKE,2023,710,960,1670,40
OTUKE,2024,730,1000,1730,40
OTUKE,2025,760,1040,1800,40
OYAM,2015,1680,2050,3730,40
OYAM,2016,1740,2110,3850,40
OYAM,2017,1790,2170,3960,40
OYAM,2018,1840,2240,4080,40
OYAM,2019,1900,2300,4200,40
OYAM,2020,1950,2360,4310,40
OYAM,2021,2010,2430,4440,40
OYAM,2022,2060,2490,4550,40
OYAM,2023,2120,2560,4680,40
OYAM,2024,2170,2620,4790,40
OYAM,2025,2230,2690,4920,40
PADER,2015,570,820,1390,40
PADER,2016,570,840,1410,40
PADER,2017,570,860,1430,40
PADER,2018,590,890,1480,40
PADER,2019,600,920,1520,40
PADER,2020,620,960,1580,40
PADER,2021,640,1000,1640,40
PADER,2022,660,1030,1690,40
PADER,2023,670,1070,1740,40
PADER,2024,690,1100,1790,40
PADER,2025,700,1130,1830,40
PAKWACH,2015,710,1000,1710,40
PAKWACH,2016,740,1040,1780,40
PAKWACH,2017,770,1070,1840,40
PAKWACH,2018,800,1110,1910,40
PAKWACH,2019,840,1150,1990,40
PAKWACH,2020,870,1190,2060,40
PAKWACH,2021,900,1230,2130,40
PAKWACH,2022,940,1280,2220,40
PAKWACH,2023,970,1320,2290,40
PAKWACH,2024,1010,1360,2370,40
PAKWACH,2025,1050,1400,2450,40
PALLISA,2015,920,1190,2110,40
PALLISA,2016,950,1240,2190,40
PALLISA,2017,980,1300,2280,40
PALLISA,2018,1030,1380,2410,40
PALLISA,2019,1090,1460,2550,40
PALLISA,2020,1150,1560,2710,40
PALLISA,2021,1210,1660,2870,40
PALLISA,2022,1280,1760,3040,40
PALLISA,2023,1350,1860,3210,40
PALLISA,2024,1420,1970,3390,40
PALLISA,2025,1500,2080,3580,40
RAKAI,2015,1040,1240,2280,40
RAKAI,2016,1050,1260,2310,40
RAKAI,2017,1070,1300,2370,40
RAKAI,2018,1100,1350,2450,40
RAKAI,2019,1140,1410,2550,40
RAKAI,2020,1180,1470,2650,40
RAKAI,2021,1230,1530,2760,40
RAKAI,2022,1270,1590,2860,40
RAKAI,2023,1320,1650,2970,40
RAKAI,2024,1360,1710,3070,40
RAKAI,2025,1400,1780,3180,40
RUBANDA,2015,810,1230,2040,40
RUBANDA,2016,820,1240,2060,40
RUBANDA,2017,840,1250,2090,40
RUBANDA,2018,850,1260,2110,40
RUBANDA,2019,860,1270,2130,40
RUBANDA,2020,870,1280,2150,40
RUBANDA,2021,880,1290,2170,40
RUBANDA,2022,890,1290,2180,40
RUBANDA,2023,890,1300,2190,40
RUBANDA,2024,900,1310,2210,40
RUBANDA,2025,910,1310,2220,40
RUBIRIZI,2015,660,900,1560,40
RUBIRIZI,2016,670,920,1590,40
RUBIRIZI,2017,690,940,1630,40
RUBIRIZI,2018,700,950,1650,40
RUBIRIZI,2019,710,970,1680,40
RUBIRIZI,2020,730,990,1720,40
RUBIRIZI,2021,740,1010,1750,40
RUBIRIZI,2022,750,1020,1770,40
RUBIRIZI,2023,760,1040,1800,40
RUBIRIZI,2024,780,1060,1840,40
RUBIRIZI,2025,790,1070,1860,40
RUKIGA,2015,490,630,1120,40
RUKIGA,2016,490,640,1130,40
RUKIGA,2017,500,640,1140,40
RUKIGA,2018,500,640,1140,40
RUKIGA,2019,510,650,1160,40
RUKIGA,2020,510,650,1160,40
RUKIGA,2021,520,650,1170,40
RUKIGA,2022,520,660,1180,40
RUKIGA,2023,520,660,1180,40
RUKIGA,2024,530,660,1190,40
RUKIGA,2025,530,660,1190,40
RUKUNGIRI,2015,1520,1910,3430,40
RUKUNGIRI,2016,1540,1930,3470,40
RUKUNGIRI,2017,1560,1950,3510,40
RUKUNGIRI,2018,1570,1960,3530,40
RUKUNGIRI,2019,1590,1980,3570,40
RUKUNGIRI,2020,1610,2000,3610,40
RUKUNGIRI,2021,1620,2010,3630,40
RUKUNGIRI,2022,1640,2030,3670,40
RUKUNGIRI,2023,1650,2040,3690,40
RUKUNGIRI,2024,1670,2050,3720,40
RUKUNGIRI,2025,1680,2060,3740,40
RWAMPARA,2015,700,830,1530,40
RWAMPARA,2016,720,840,1560,40
RWAMPARA,2017,730,860,1590,40
RWAMPARA,2018,750,880,1630,40
RWAMPARA,2019,770,900,1670,40
RWAMPARA,2020,780,920,1700,40
RWAMPARA,2021,800,930,1730,40
RWAMPARA,2022,810,950,1760,40
RWAMPARA,2023,830,970,1800,40
RWAMPARA,2024,840,990,1830,40
RWAMPARA,2025,860,1010,1870,40
SERERE,2015,1000,1240,2240,40
SERERE,2016,1030,1290,2320,40
SERERE,2017,1060,1350,2410,40
SERERE,2018,1110,1420,2530,40
SERERE,2019,1170,1510,2680,40
SERERE,2020,1230,1600,2830,40
SERERE,2021,1290,1690,2980,40
SERERE,2022,1360,1790,3150,40
SERERE,2023,1430,1890,3320,40
SERERE,2024,1500,1990,3490,40
SERERE,2025,1580,2090,3670,40
SHEEMA,2015,1170,1360,2530,40
SHEEMA,2016,1180,1380,2560,40
SHEEMA,2017,1200,1390,2590,40
SHEEMA,2018,1210,1410,2620,40
SHEEMA,2019,1230,1420,2650,40
SHEEMA,2020,1240,1430,2670,40
SHEEMA,2021,1250,1440,2690,40
SHEEMA,2022,1260,1460,2720,40
SHEEMA,2023,1270,1470,2740,40
SHEEMA,2024,1280,1480,2760,40
SHEEMA,2025,1290,1480,2770,40
SIRONKO,2015,1340,1420,2760,40
SIRONKO,2016,1380,1450,2830,40
SIRONKO,2017,1410,1480,2890,40
SIRONKO,2018,1440,1510,2950,40
SIRONKO,2019,1480,1540,3020,40
SIRONKO,2020,1510,1570,3080,40
SIRONKO,2021,1540,1600,3140,40
SIRONKO,2022,1570,1630,3200,40
SIRONKO,2023,1610,1650,3260,40
SIRONKO,2024,1640,1680,3320,40
SIRONKO,2025,1670,1710,3380,40
SOROTI,2015,1090,1320,2410,40
SOROTI,2016,1110,1370,2480,40
SOROTI,2017,1150,1420,2570,40
SOROTI,2018,1190,1500,2690,40
SOROTI,2019,1250,1570,2820,40
SOROTI,2020,1310,1660,2970,40
SOROTI,2021,1370,1750,3120,40
SOROTI,2022,1430,1840,3270,40
SOROTI,2023,1500,1930,3430,40
SOROTI,2024,1570,2030,3600,40
SOROTI,2025,1640,2130,3770,40
SSEMBABULE,2015,1020,1090,2110,40
SSEMBABULE,2016,1030,1110,2140,40
SSEMBABULE,2017,1050,1150,2200,40
SSEMBABULE,2018,1090,1200,2290,40
SSEMBABULE,2019,1130,1260,2390,40
SSEMBABULE,2020,1170,1320,2490,40
SSEMBABULE,2021,1220,1370,2590,40
SSEMBABULE,2022,1270,1430,2700,40
SSEMBABULE,2023,1320,1500,2820,40
SSEMBABULE,2024,1370,1550,2920,40
SSEMBABULE,2025,1420,1620,3040,40
TORORO,2015,2460,3090,5550,40
TORORO,2016,2530,3160,5690,40
TORORO,2017,2600,3240,5840,40
TORORO,2018,2670,3320,5990,40
TORORO,2019,2740,3400,6140,40
TORORO,2020,2800,3480,6280,40
TORORO,2021,2870,3560,6430,40
TORORO,2022,2940,3640,6580,40
TORORO,2023,3010,3720,6730,40
TORORO,2024,3070,3800,6870,40
TORORO,2025,3140,3880,7020,40
WAKISO,2015,15780,12850,28630,40
WAKISO,2016,16830,13730,30560,40
WAKISO,2017,17960,14670,32630,40
WAKISO,2018,19150,15670,34820,40
WAKISO,2019,20430,16720,37150,40
WAKISO,2020,21760,17830,39590,40
WAKISO,2021,23160,19010,42170,40
WAKISO,2022,24640,20270,44910,40
WAKISO,2023,26210,21570,47780,40
WAKISO,2024,27840,22940,50780,40
WAKISO,2025,29550,24400,53950,40
YUMBE,2015,1770,1950,3720,40
YUMBE,2016,1840,2070,3910,40
YUMBE,2017,1920,2200,4120,40
YUMBE,2018,2020,2370,4390,40
YUMBE,2019,2150,2560,4710,40
YUMBE,2020,2280,2760,5040,40
YUMBE,2021,2420,2970,5390,40
YUMBE,2022,2570,3210,5780,40
YUMBE,2023,2730,3450,6180,40
YUMBE,2024,2890,3700,6590,40
YUMBE,2025,3070,3970,7040,40
ZOMBO,2015,1090,1430,2520,40
ZOMBO,2016,1130,1470,2600,40
ZOMBO,2017,1160,1510,2670,40
ZOMBO,2018,1200,1550,2750,40
ZOMBO,2019,1230,1590,2820,40
ZOMBO,2020,1270,1640,2910,40
ZOMBO,2021,1310,1680,2990,40
ZOMBO,2022,1340,1720,3060,40
ZOMBO,2023,1380,1760,3140,40
ZOMBO,2024,1420,1810,3230,40
ZOMBO,2025,1450,1850,3300,40
MADI OKOLLO,2015,680,1110,1790,40
MADI OKOLLO,2016,700,1140,1840,40
MADI OKOLLO,2017,720,1170,1890,40
MADI OKOLLO,2018,740,1200,1940,40
MADI OKOLLO,2019,760,1230,1990,40
MADI OKOLLO,2020,790,1260,2050,40
MADI OKOLLO,2021,800,1300,2100,40
MADI OKOLLO,2022,830,1330,2160,40
MADI OKOLLO,2023,850,1360,2210,40
MADI OKOLLO,2024,870,1390,2260,40
MADI OKOLLO,2025,890,1420,2310,40
GULU,2015,1450,1710,3160,40
GULU,2016,1500,1760,3260,40
GULU,2017,1540,1810,3350,40
GULU,2018,1590,1870,3460,40
GULU,2019,1640,1920,3560,40
GULU,2020,1680,1970,3650,40
GULU,2021,1730,2030,3760,40
GULU,2022,1780,2080,3860,40
GULU,2023,1820,2130,3950,40
GULU,2024,1870,2190,4060,40
GULU,2025,1920,2240,4160,40
ABIM,2015,350,300,650,41
ABIM,2016,360,330,690,41
ABIM,2017,380,340,720,41
ABIM,2018,400,370,770,41
ABIM,2019,430,390,820,41
ABIM,2020,460,430,890,41
ABIM,2021,490,470,960,41
ABIM,2022,540,490,1030,41
ABIM,2023,570,530,1100,41
ABIM,2024,610,570,1180,41
ABIM,2025,660,630,1290,41
ADJUMANI,2015,530,670,1200,41
ADJUMANI,2016,530,680,1210,41
ADJUMANI,2017,540,690,1230,41
ADJUMANI,2018,540,690,1230,41
ADJUMANI,2019,550,700,1250,41
ADJUMANI,2020,550,710,1260,41
ADJUMANI,2021,550,710,1260,41
ADJUMANI,2022,550,720,1270,41
ADJUMANI,2023,560,720,1280,41
ADJUMANI,2024,560,720,1280,41
ADJUMANI,2025,560,730,1290,41
AGAGO,2015,620,650,1270,41
AGAGO,2016,640,660,1300,41
AGAGO,2017,650,670,1320,41
AGAGO,2018,660,680,1340,41
AGAGO,2019,670,690,1360,41
AGAGO,2020,680,700,1380,41
AGAGO,2021,690,720,1410,41
AGAGO,2022,700,730,1430,41
AGAGO,2023,710,740,1450,41
AGAGO,2024,720,750,1470,41
AGAGO,2025,730,760,1490,41
ALEBTONG,2015,810,800,1610,41
ALEBTONG,2016,820,820,1640,41
ALEBTONG,2017,830,850,1680,41
ALEBTONG,2018,860,870,1730,41
ALEBTONG,2019,870,910,1780,41
ALEBTONG,2020,910,960,1870,41
ALEBTONG,2021,950,990,1940,41
ALEBTONG,2022,980,1040,2020,41
ALEBTONG,2023,1020,1080,2100,41
ALEBTONG,2024,1060,1130,2190,41
ALEBTONG,2025,1090,1180,2270,41
AMOLATAR,2015,640,670,1310,41
AMOLATAR,2016,640,700,1340,41
AMOLATAR,2017,640,710,1350,41
AMOLATAR,2018,650,730,1380,41
AMOLATAR,2019,680,760,1440,41
AMOLATAR,2020,700,800,1500,41
AMOLATAR,2021,720,830,1550,41
AMOLATAR,2022,750,860,1610,41
AMOLATAR,2023,780,900,1680,41
AMOLATAR,2024,800,950,1750,41
AMOLATAR,2025,840,980,1820,41
AMUDAT,2015,310,290,600,41
AMUDAT,2016,320,300,620,41
AMUDAT,2017,330,320,650,41
AMUDAT,2018,340,330,670,41
AMUDAT,2019,350,350,700,41
AMUDAT,2020,370,370,740,41
AMUDAT,2021,390,390,780,41
AMUDAT,2022,400,430,830,41
AMUDAT,2023,420,460,880,41
AMUDAT,2024,440,480,920,41
AMUDAT,2025,470,510,980,41
AMURIA,2015,620,590,1210,41
AMURIA,2016,640,600,1240,41
AMURIA,2017,650,630,1280,41
AMURIA,2018,670,650,1320,41
AMURIA,2019,700,690,1390,41
AMURIA,2020,740,730,1470,41
AMURIA,2021,770,760,1530,41
AMURIA,2022,810,800,1610,41
AMURIA,2023,850,850,1700,41
AMURIA,2024,880,880,1760,41
AMURIA,2025,920,930,1850,41
AMURU,2015,620,650,1270,41
AMURU,2016,640,660,1300,41
AMURU,2017,640,670,1310,41
AMURU,2018,650,700,1350,41
AMURU,2019,660,730,1390,41
AMURU,2020,700,760,1460,41
AMURU,2021,720,790,1510,41
AMURU,2022,740,830,1570,41
AMURU,2023,780,870,1650,41
AMURU,2024,800,900,1700,41
AMURU,2025,820,930,1750,41
APAC,2015,530,590,1120,41
APAC,2016,550,610,1160,41
APAC,2017,570,630,1200,41
APAC,2018,590,660,1250,41
APAC,2019,610,680,1290,41
APAC,2020,630,700,1330,41
APAC,2021,650,720,1370,41
APAC,2022,680,750,1430,41
APAC,2023,700,770,1470,41
APAC,2024,720,790,1510,41
APAC,2025,740,820,1560,41
ARUA,2015,1690,1750,3440,41
ARUA,2016,1740,1800,3540,41
ARUA,2017,1790,1850,3640,41
ARUA,2018,1840,1900,3740,41
ARUA,2019,1890,1950,3840,41
ARUA,2020,1940,2000,3940,41
ARUA,2021,2000,2050,4050,41
ARUA,2022,2050,2100,4150,41
ARUA,2023,2100,2150,4250,41
ARUA,2024,2150,2200,4350,41
ARUA,2025,2200,2240,4440,41
BUDAKA,2015,770,980,1750,41
BUDAKA,2016,780,1000,1780,41
BUDAKA,2017,800,1030,1830,41
BUDAKA,2018,820,1080,1900,41
BUDAKA,2019,850,1140,1990,41
BUDAKA,2020,890,1190,2080,41
BUDAKA,2021,930,1260,2190,41
BUDAKA,2022,970,1310,2280,41
BUDAKA,2023,1020,1380,2400,41
BUDAKA,2024,1060,1460,2520,41
BUDAKA,2025,1120,1530,2650,41
BUDUDA,2015,760,770,1530,41
BUDUDA,2016,770,790,1560,41
BUDUDA,2017,800,840,1640,41
BUDUDA,2018,830,870,1700,41
BUDUDA,2019,870,930,1800,41
BUDUDA,2020,920,990,1910,41
BUDUDA,2021,970,1050,2020,41
BUDUDA,2022,1020,1120,2140,41
BUDUDA,2023,1080,1190,2270,41
BUDUDA,2024,1140,1260,2400,41
BUDUDA,2025,1200,1330,2530,41
BUGIRI,2015,1310,1620,2930,41
BUGIRI,2016,1340,1680,3020,41
BUGIRI,2017,1370,1750,3120,41
BUGIRI,2018,1430,1840,3270,41
BUGIRI,2019,1480,1940,3420,41
BUGIRI,2020,1560,2040,3600,41
BUGIRI,2021,1640,2160,3800,41
BUGIRI,2022,1720,2280,4000,41
BUGIRI,2023,1810,2420,4230,41
BUGIRI,2024,1900,2540,4440,41
BUGIRI,2025,1990,2680,4670,41
BUGWERI,2015,470,560,1030,41
BUGWERI,2016,480,590,1070,41
BUGWERI,2017,480,600,1080,41
BUGWERI,2018,510,620,1130,41
BUGWERI,2019,520,650,1170,41
BUGWERI,2020,540,670,1210,41
BUGWERI,2021,560,700,1260,41
BUGWERI,2022,580,730,1310,41
BUGWERI,2023,600,760,1360,41
BUGWERI,2024,620,790,1410,41
BUGWERI,2025,640,820,1460,41
BUHWEJU,2015,350,450,800,41
BUHWEJU,2016,360,460,820,41
BUHWEJU,2017,370,470,840,41
BUHWEJU,2018,380,490,870,41
BUHWEJU,2019,390,500,890,41
BUHWEJU,2020,410,520,930,41
BUHWEJU,2021,420,530,950,41
BUHWEJU,2022,430,550,980,41
BUHWEJU,2023,440,560,1000,41
BUHWEJU,2024,450,570,1020,41
BUHWEJU,2025,470,590,1060,41
BUIKWE,2015,1350,1490,2840,41
BUIKWE,2016,1350,1510,2860,41
BUIKWE,2017,1360,1540,2900,41
BUIKWE,2018,1370,1580,2950,41
BUIKWE,2019,1420,1640,3060,41
BUIKWE,2020,1460,1700,3160,41
BUIKWE,2021,1500,1770,3270,41
BUIKWE,2022,1550,1830,3380,41
BUIKWE,2023,1600,1900,3500,41
BUIKWE,2024,1640,1970,3610,41
BUIKWE,2025,1690,2040,3730,41
BUKEDEA,2015,810,730,1540,41
BUKEDEA,2016,830,750,1580,41
BUKEDEA,2017,850,800,1650,41
BUKEDEA,2018,880,830,1710,41
BUKEDEA,2019,920,870,1790,41
BUKEDEA,2020,970,930,1900,41
BUKEDEA,2021,1040,980,2020,41
BUKEDEA,2022,1090,1040,2130,41
BUKEDEA,2023,1150,1100,2250,41
BUKEDEA,2024,1210,1160,2370,41
BUKEDEA,2025,1270,1230,2500,41
BUKOMANSIMBI,2015,510,620,1130,41
BUKOMANSIMBI,2016,500,620,1120,41
BUKOMANSIMBI,2017,500,630,1130,41
BUKOMANSIMBI,2018,510,640,1150,41
BUKOMANSIMBI,2019,510,650,1160,41
BUKOMANSIMBI,2020,510,660,1170,41
BUKOMANSIMBI,2021,530,670,1200,41
BUKOMANSIMBI,2022,540,690,1230,41
BUKOMANSIMBI,2023,550,700,1250,41
BUKOMANSIMBI,2024,550,710,1260,41
BUKOMANSIMBI,2025,560,730,1290,41
BUKWO,2015,270,290,560,41
BUKWO,2016,290,310,600,41
BUKWO,2017,300,320,620,41
BUKWO,2018,320,340,660,41
BUKWO,2019,340,350,690,41
BUKWO,2020,350,370,720,41
BUKWO,2021,370,390,760,41
BUKWO,2022,390,410,800,41
BUKWO,2023,410,420,830,41
BUKWO,2024,430,440,870,41
BUKWO,2025,450,460,910,41
BULAMBULI,2015,700,810,1510,41
BULAMBULI,2016,730,850,1580,41
BULAMBULI,2017,760,890,1650,41
BULAMBULI,2018,790,940,1730,41
BULAMBULI,2019,830,1000,1830,41
BULAMBULI,2020,880,1070,1950,41
BULAMBULI,2021,930,1140,2070,41
BULAMBULI,2022,980,1220,2200,41
BULAMBULI,2023,1050,1290,2340,41
BULAMBULI,2024,1100,1380,2480,41
BULAMBULI,2025,1170,1470,2640,41
BULIISA,2015,340,330,670,41
BULIISA,2016,360,350,710,41
BULIISA,2017,380,360,740,41
BULIISA,2018,400,380,780,41
BULIISA,2019,420,400,820,41
BULIISA,2020,450,410,860,41
BULIISA,2021,470,430,900,41
BULIISA,2022,490,450,940,41
BULIISA,2023,520,470,990,41
BULIISA,2024,550,490,1040,41
BULIISA,2025,570,510,1080,41
BUNDIBUGYO,2015,660,650,1310,41
BUNDIBUGYO,2016,660,660,1320,41
BUNDIBUGYO,2017,680,670,1350,41
BUNDIBUGYO,2018,690,690,1380,41
BUNDIBUGYO,2019,720,730,1450,41
BUNDIBUGYO,2020,740,760,1500,41
BUNDIBUGYO,2021,770,790,1560,41
BUNDIBUGYO,2022,810,830,1640,41
BUNDIBUGYO,2023,830,870,1700,41
BUNDIBUGYO,2024,870,900,1770,41
BUNDIBUGYO,2025,890,950,1840,41
BUNYANGABU,2015,620,630,1250,41
BUNYANGABU,2016,620,640,1260,41
BUNYANGABU,2017,640,660,1300,41
BUNYANGABU,2018,650,680,1330,41
BUNYANGABU,2019,660,700,1360,41
BUNYANGABU,2020,700,740,1440,41
BUNYANGABU,2021,720,770,1490,41
BUNYANGABU,2022,740,800,1540,41
BUNYANGABU,2023,760,840,1600,41
BUNYANGABU,2024,800,870,1670,41
BUNYANGABU,2025,820,900,1720,41
BUSHENYI,2015,720,810,1530,41
BUSHENYI,2016,730,820,1550,41
BUSHENYI,2017,740,820,1560,41
BUSHENYI,2018,740,830,1570,41
BUSHENYI,2019,750,840,1590,41
BUSHENYI,2020,760,840,1600,41
BUSHENYI,2021,770,850,1620,41
BUSHENYI,2022,780,850,1630,41
BUSHENYI,2023,780,860,1640,41
BUSHENYI,2024,790,860,1650,41
BUSHENYI,2025,790,870,1660,41
BUSIA,2015,1310,1440,2750,41
BUSIA,2016,1320,1480,2800,41
BUSIA,2017,1340,1540,2880,41
BUSIA,2018,1390,1590,2980,41
BUSIA,2019,1430,1650,3080,41
BUSIA,2020,1490,1730,3220,41
BUSIA,2021,1560,1810,3370,41
BUSIA,2022,1620,1910,3530,41
BUSIA,2023,1690,1990,3680,41
BUSIA,2024,1750,2080,3830,41
BUSIA,2025,1830,2160,3990,41
BUTALEJA,2015,710,870,1580,41
BUTALEJA,2016,730,900,1630,41
BUTALEJA,2017,760,950,1710,41
BUTALEJA,2018,790,1000,1790,41
BUTALEJA,2019,830,1060,1890,41
BUTALEJA,2020,900,1140,2040,41
BUTALEJA,2021,950,1220,2170,41
BUTALEJA,2022,1010,1310,2320,41
BUTALEJA,2023,1080,1390,2470,41
BUTALEJA,2024,1130,1470,2600,41
BUTALEJA,2025,1210,1560,2770,41
BUTAMBALA,2015,270,280,550,41
BUTAMBALA,2016,280,270,550,41
BUTAMBALA,2017,270,270,540,41
BUTAMBALA,2018,270,280,550,41
BUTAMBALA,2019,270,280,550,41
BUTAMBALA,2020,290,300,590,41
BUTAMBALA,2021,290,310,600,41
BUTAMBALA,2022,300,310,610,41
BUTAMBALA,2023,300,320,620,41
BUTAMBALA,2024,320,330,650,41
BUTAMBALA,2025,320,330,650,41
BUTEBO,2015,380,470,850,41
BUTEBO,2016,380,470,850,41
BUTEBO,2017,380,480,860,41
BUTEBO,2018,390,480,870,41
BUTEBO,2019,390,500,890,41
BUTEBO,2020,410,510,920,41
BUTEBO,2021,410,530,940,41
BUTEBO,2022,420,550,970,41
BUTEBO,2023,440,560,1000,41
BUTEBO,2024,440,590,1030,41
BUTEBO,2025,460,600,1060,41
BUVUMA,2015,490,310,800,41
BUVUMA,2016,520,330,850,41
BUVUMA,2017,550,350,900,41
BUVUMA,2018,590,380,970,41
BUVUMA,2019,620,400,1020,41
BUVUMA,2020,660,430,1090,41
BUVUMA,2021,700,460,1160,41
BUVUMA,2022,740,490,1230,41
BUVUMA,2023,780,520,1300,41
BUVUMA,2024,830,550,1380,41
BUVUMA,2025,870,590,1460,41
BUYENDE,2015,1010,1130,2140,41
BUYENDE,2016,1030,1180,2210,41
BUYENDE,2017,1070,1230,2300,41
BUYENDE,2018,1110,1280,2390,41
BUYENDE,2019,1160,1360,2520,41
BUYENDE,2020,1220,1440,2660,41
BUYENDE,2021,1290,1550,2840,41
BUYENDE,2022,1370,1640,3010,41
BUYENDE,2023,1450,1730,3180,41
BUYENDE,2024,1520,1840,3360,41
BUYENDE,2025,1600,1940,3540,41
DOKOLO,2015,570,580,1150,41
DOKOLO,2016,590,600,1190,41
DOKOLO,2017,610,610,1220,41
DOKOLO,2018,630,630,1260,41
DOKOLO,2019,650,650,1300,41
DOKOLO,2020,670,660,1330,41
DOKOLO,2021,690,680,1370,41
DOKOLO,2022,700,700,1400,41
DOKOLO,2023,720,710,1430,41
DOKOLO,2024,740,730,1470,41
DOKOLO,2025,760,750,1510,41
GOMBA,2015,620,650,1270,41
GOMBA,2016,620,660,1280,41
GOMBA,2017,630,660,1290,41
GOMBA,2018,630,680,1310,41
GOMBA,2019,640,690,1330,41
GOMBA,2020,660,720,1380,41
GOMBA,2021,680,730,1410,41
GOMBA,2022,700,760,1460,41
GOMBA,2023,720,780,1500,41
GOMBA,2024,730,790,1520,41
GOMBA,2025,750,820,1570,41
GULU,2015,770,790,1560,41
GULU,2016,790,820,1610,41
GULU,2017,810,840,1650,41
GULU,2018,840,870,1710,41
GULU,2019,860,890,1750,41
GULU,2020,890,920,1810,41
GULU,2021,910,940,1850,41
GULU,2022,940,960,1900,41
GULU,2023,960,990,1950,41
GULU,2024,990,1010,2000,41
GULU,2025,1010,1040,2050,41
HOIMA,2015,1060,1000,2060,41
HOIMA,2016,1100,1030,2130,41
HOIMA,2017,1140,1070,2210,41
HOIMA,2018,1190,1100,2290,41
HOIMA,2019,1230,1140,2370,41
HOIMA,2020,1270,1180,2450,41
HOIMA,2021,1320,1220,2540,41
HOIMA,2022,1360,1260,2620,41
HOIMA,2023,1410,1300,2710,41
HOIMA,2024,1460,1340,2800,41
HOIMA,2025,1510,1380,2890,41
IBANDA,2015,850,900,1750,41
IBANDA,2016,860,910,1770,41
IBANDA,2017,880,930,1810,41
IBANDA,2018,900,950,1850,41
IBANDA,2019,920,960,1880,41
IBANDA,2020,930,980,1910,41
IBANDA,2021,950,990,1940,41
IBANDA,2022,960,1010,1970,41
IBANDA,2023,980,1020,2000,41
IBANDA,2024,990,1040,2030,41
IBANDA,2025,1010,1050,2060,41
IGANGA,2015,960,1420,2380,41
IGANGA,2016,970,1450,2420,41
IGANGA,2017,990,1490,2480,41
IGANGA,2018,1010,1550,2560,41
IGANGA,2019,1050,1610,2660,41
IGANGA,2020,1090,1690,2780,41
IGANGA,2021,1150,1770,2920,41
IGANGA,2022,1190,1850,3040,41
IGANGA,2023,1240,1930,3170,41
IGANGA,2024,1280,2010,3290,41
IGANGA,2025,1340,2110,3450,41
ISINGIRO,2015,1480,1780,3260,41
ISINGIRO,2016,1540,1840,3380,41
ISINGIRO,2017,1600,1910,3510,41
ISINGIRO,2018,1660,1970,3630,41
ISINGIRO,2019,1720,2040,3760,41
ISINGIRO,2020,1780,2110,3890,41
ISINGIRO,2021,1840,2180,4020,41
ISINGIRO,2022,1900,2250,4150,41
ISINGIRO,2023,1970,2320,4290,41
ISINGIRO,2024,2030,2390,4420,41
ISINGIRO,2025,2100,2470,4570,41
JINJA,2015,1200,1360,2560,41
JINJA,2016,1220,1380,2600,41
JINJA,2017,1240,1400,2640,41
JINJA,2018,1260,1420,2680,41
JINJA,2019,1280,1450,2730,41
JINJA,2020,1300,1470,2770,41
JINJA,2021,1320,1480,2800,41
JINJA,2022,1340,1500,2840,41
JINJA,2023,1360,1520,2880,41
JINJA,2024,1370,1540,2910,41
JINJA,2025,1390,1560,2950,41
KAABONG,2015,330,300,630,41
KAABONG,2016,330,310,640,41
KAABONG,2017,340,320,660,41
KAABONG,2018,350,330,680,41
KAABONG,2019,360,330,690,41
KAABONG,2020,370,340,710,41
KAABONG,2021,380,350,730,41
KAABONG,2022,390,360,750,41
KAABONG,2023,400,360,760,41
KAABONG,2024,410,370,780,41
KAABONG,2025,420,380,800,41
KABALE,2015,680,850,1530,41
KABALE,2016,690,860,1550,41
KABALE,2017,700,870,1570,41
KABALE,2018,710,880,1590,41
KABALE,2019,720,890,1610,41
KABALE,2020,730,900,1630,41
KABALE,2021,740,910,1650,41
KABALE,2022,750,920,1670,41
KABALE,2023,760,920,1680,41
KABALE,2024,770,930,1700,41
KABALE,2025,780,940,1720,41
KABAROLE,2015,930,830,1760,41
KABAROLE,2016,950,850,1800,41
KABAROLE,2017,970,870,1840,41
KABAROLE,2018,1000,890,1890,41
KABAROLE,2019,1020,910,1930,41
KABAROLE,2020,1040,920,1960,41
KABAROLE,2021,1060,940,2000,41
KABAROLE,2022,1080,960,2040,41
KABAROLE,2023,1100,980,2080,41
KABAROLE,2024,1120,1000,2120,41
KABAROLE,2025,1140,1010,2150,41
KABERAMAIDO,2015,450,480,930,41
KABERAMAIDO,2016,460,510,970,41
KABERAMAIDO,2017,470,520,990,41
KABERAMAIDO,2018,490,550,1040,41
KABERAMAIDO,2019,510,570,1080,41
KABERAMAIDO,2020,540,610,1150,41
KABERAMAIDO,2021,570,640,1210,41
KABERAMAIDO,2022,590,690,1280,41
KABERAMAIDO,2023,630,730,1360,41
KABERAMAIDO,2024,660,760,1420,41
KABERAMAIDO,2025,700,800,1500,41
KAGADI,2015,1010,1050,2060,41
KAGADI,2016,1050,1090,2140,41
KAGADI,2017,1090,1130,2220,41
KAGADI,2018,1130,1170,2300,41
KAGADI,2019,1170,1210,2380,41
KAGADI,2020,1210,1250,2460,41
KAGADI,2021,1260,1290,2550,41
KAGADI,2022,1300,1330,2630,41
KAGADI,2023,1340,1370,2710,41
KAGADI,2024,1390,1420,2810,41
KAGADI,2025,1430,1460,2890,41
KAKUMIRO,2015,930,990,1920,41
KAKUMIRO,2016,1010,1080,2090,41
KAKUMIRO,2017,1100,1170,2270,41
KAKUMIRO,2018,1200,1260,2460,41
KAKUMIRO,2019,1300,1370,2670,41
KAKUMIRO,2020,1410,1480,2890,41
KAKUMIRO,2021,1540,1600,3140,41
KAKUMIRO,2022,1670,1730,3400,41
KAKUMIRO,2023,1810,1870,3680,41
KAKUMIRO,2024,1960,2020,3980,41
KAKUMIRO,2025,2120,2180,4300,41
KALAKI,2015,310,330,640,41
KALAKI,2016,330,340,670,41
KALAKI,2017,340,360,700,41
KALAKI,2018,360,370,730,41
KALAKI,2019,370,380,750,41
KALAKI,2020,390,400,790,41
KALAKI,2021,400,410,810,41
KALAKI,2022,420,430,850,41
KALAKI,2023,430,450,880,41
KALAKI,2024,450,460,910,41
KALAKI,2025,470,480,950,41
KALANGALA,2015,390,210,600,41
KALANGALA,2016,400,220,620,41
KALANGALA,2017,410,230,640,41
KALANGALA,2018,430,240,670,41
KALANGALA,2019,440,250,690,41
KALANGALA,2020,460,260,720,41
KALANGALA,2021,470,270,740,41
KALANGALA,2022,490,280,770,41
KALANGALA,2023,500,290,790,41
KALANGALA,2024,520,300,820,41
KALANGALA,2025,540,310,850,41
KALIRO,2015,820,840,1660,41
KALIRO,2016,830,860,1690,41
KALIRO,2017,850,890,1740,41
KALIRO,2018,880,930,1810,41
KALIRO,2019,910,970,1880,41
KALIRO,2020,960,1030,1990,41
KALIRO,2021,1000,1080,2080,41
KALIRO,2022,1050,1130,2180,41
KALIRO,2023,1090,1200,2290,41
KALIRO,2024,1140,1260,2400,41
KALIRO,2025,1200,1330,2530,41
KALUNGU,2015,610,700,1310,41
KALUNGU,2016,600,710,1310,41
KALUNGU,2017,600,710,1310,41
KALUNGU,2018,600,730,1330,41
KALUNGU,2019,610,740,1350,41
KALUNGU,2020,620,770,1390,41
KALUNGU,2021,640,790,1430,41
KALUNGU,2022,650,820,1470,41
KALUNGU,2023,650,840,1490,41
KALUNGU,2024,680,850,1530,41
KALUNGU,2025,680,870,1550,41
KAMPALA,2015,4230,4330,8560,41
KAMPALA,2016,4310,4410,8720,41
KAMPALA,2017,4400,4500,8900,41
KAMPALA,2018,4480,4580,9060,41
KAMPALA,2019,4570,4670,9240,41
KAMPALA,2020,4650,4750,9400,41
KAMPALA,2021,4730,4830,9560,41
KAMPALA,2022,4810,4910,9720,41
KAMPALA,2023,4890,4990,9880,41
KAMPALA,2024,4960,5070,10030,41
KAMPALA,2025,5030,5140,10170,41
KAMULI,2015,1570,1980,3550,41
KAMULI,2016,1570,2010,3580,41
KAMULI,2017,1590,2060,3650,41
KAMULI,2018,1620,2110,3730,41
KAMULI,2019,1680,2200,3880,41
KAMULI,2020,1740,2290,4030,41
KAMULI,2021,1800,2380,4180,41
KAMULI,2022,1860,2490,4350,41
KAMULI,2023,1940,2590,4530,41
KAMULI,2024,2000,2680,4680,41
KAMULI,2025,2060,2780,4840,41
KAMWENGE,2015,780,850,1630,41
KAMWENGE,2016,810,880,1690,41
KAMWENGE,2017,840,910,1750,41
KAMWENGE,2018,880,940,1820,41
KAMWENGE,2019,910,970,1880,41
KAMWENGE,2020,950,1010,1960,41
KAMWENGE,2021,980,1040,2020,41
KAMWENGE,2022,1020,1080,2100,41
KAMWENGE,2023,1060,1110,2170,41
KAMWENGE,2024,1100,1150,2250,41
KAMWENGE,2025,1130,1180,2310,41
KANUNGU,2015,770,880,1650,41
KANUNGU,2016,790,890,1680,41
KANUNGU,2017,800,910,1710,41
KANUNGU,2018,820,920,1740,41
KANUNGU,2019,830,940,1770,41
KANUNGU,2020,840,950,1790,41
KANUNGU,2021,860,970,1830,41
KANUNGU,2022,870,980,1850,41
KANUNGU,2023,880,990,1870,41
KANUNGU,2024,890,1000,1890,41
KANUNGU,2025,910,1010,1920,41
KAPCHORWA,2015,300,370,670,41
KAPCHORWA,2016,310,380,690,41
KAPCHORWA,2017,320,400,720,41
KAPCHORWA,2018,330,410,740,41
KAPCHORWA,2019,340,420,760,41
KAPCHORWA,2020,350,430,780,41
KAPCHORWA,2021,360,440,800,41
KAPCHORWA,2022,370,450,820,41
KAPCHORWA,2023,380,460,840,41
KAPCHORWA,2024,390,470,860,41
KAPCHORWA,2025,400,480,880,41
KAPELEBYONG,2015,320,260,580,41
KAPELEBYONG,2016,330,270,600,41
KAPELEBYONG,2017,340,270,610,41
KAPELEBYONG,2018,340,290,630,41
KAPELEBYONG,2019,350,310,660,41
KAPELEBYONG,2020,370,310,680,41
KAPELEBYONG,2021,390,340,730,41
KAPELEBYONG,2022,400,340,740,41
KAPELEBYONG,2023,420,370,790,41
KAPELEBYONG,2024,440,370,810,41
KAPELEBYONG,2025,450,390,840,41
KASESE,2015,2110,2130,4240,41
KASESE,2016,2120,2160,4280,41
KASESE,2017,2140,2210,4350,41
KASESE,2018,2180,2280,4460,41
KASESE,2019,2240,2360,4600,41
KASESE,2020,2310,2460,4770,41
KASESE,2021,2400,2560,4960,41
KASESE,2022,2480,2670,5150,41
KASESE,2023,2560,2770,5330,41
KASESE,2024,2650,2870,5520,41
KASESE,2025,2730,2970,5700,41
KASSANDA,2015,780,740,1520,41
KASSANDA,2016,800,760,1560,41
KASSANDA,2017,830,780,1610,41
KASSANDA,2018,850,790,1640,41
KASSANDA,2019,870,810,1680,41
KASSANDA,2020,900,830,1730,41
KASSANDA,2021,920,840,1760,41
KASSANDA,2022,940,860,1800,41
KASSANDA,2023,970,870,1840,41
KASSANDA,2024,990,890,1880,41
KASSANDA,2025,1010,900,1910,41
KATAKWI,2015,580,620,1200,41
KATAKWI,2016,600,630,1230,41
KATAKWI,2017,600,640,1240,41
KATAKWI,2018,610,680,1290,41
KATAKWI,2019,640,700,1340,41
KATAKWI,2020,660,730,1390,41
KATAKWI,2021,690,760,1450,41
KATAKWI,2022,710,790,1500,41
KATAKWI,2023,740,840,1580,41
KATAKWI,2024,770,870,1640,41
KATAKWI,2025,800,900,1700,41
KAYUNGA,2015,1090,1360,2450,41
KAYUNGA,2016,1100,1370,2470,41
KAYUNGA,2017,1110,1400,2510,41
KAYUNGA,2018,1130,1440,2570,41
KAYUNGA,2019,1150,1470,2620,41
KAYUNGA,2020,1180,1530,2710,41
KAYUNGA,2021,1220,1580,2800,41
KAYUNGA,2022,1250,1640,2890,41
KAYUNGA,2023,1300,1690,2990,41
KAYUNGA,2024,1320,1750,3070,41
KAYUNGA,2025,1370,1800,3170,41
KAZO,2015,560,710,1270,41
KAZO,2016,590,730,1320,41
KAZO,2017,610,760,1370,41
KAZO,2018,630,790,1420,41
KAZO,2019,650,810,1460,41
KAZO,2020,680,840,1520,41
KAZO,2021,700,870,1570,41
KAZO,2022,730,900,1630,41
KAZO,2023,750,930,1680,41
KAZO,2024,780,960,1740,41
KAZO,2025,800,980,1780,41
KIBAALE,2015,460,490,950,41
KIBAALE,2016,490,520,1010,41
KIBAALE,2017,520,550,1070,41
KIBAALE,2018,560,580,1140,41
KIBAALE,2019,590,620,1210,41
KIBAALE,2020,630,650,1280,41
KIBAALE,2021,670,690,1360,41
KIBAALE,2022,710,730,1440,41
KIBAALE,2023,750,770,1520,41
KIBAALE,2024,800,810,1610,41
KIBAALE,2025,840,850,1690,41
KIBOGA,2015,600,570,1170,41
KIBOGA,2016,600,580,1180,41
KIBOGA,2017,610,580,1190,41
KIBOGA,2018,620,600,1220,41
KIBOGA,2019,630,620,1250,41
KIBOGA,2020,650,650,1300,41
KIBOGA,2021,680,670,1350,41
KIBOGA,2022,700,700,1400,41
KIBOGA,2023,720,730,1450,41
KIBOGA,2024,750,760,1510,41
KIBOGA,2025,780,790,1570,41
KIBUKU,2015,730,810,1540,41
KIBUKU,2016,750,850,1600,41
KIBUKU,2017,770,880,1650,41
KIBUKU,2018,790,910,1700,41
KIBUKU,2019,830,970,1800,41
KIBUKU,2020,870,1020,1890,41
KIBUKU,2021,910,1070,1980,41
KIBUKU,2022,960,1130,2090,41
KIBUKU,2023,1000,1200,2200,41
KIBUKU,2024,1050,1260,2310,41
KIBUKU,2025,1100,1330,2430,41
KIKUUBE,2015,950,820,1770,41
KIKUUBE,2016,1000,860,1860,41
KIKUUBE,2017,1050,910,1960,41
KIKUUBE,2018,1110,950,2060,41
KIKUUBE,2019,1170,1000,2170,41
KIKUUBE,2020,1230,1050,2280,41
KIKUUBE,2021,1290,1100,2390,41
KIKUUBE,2022,1360,1160,2520,41
KIKUUBE,2023,1420,1210,2630,41
KIKUUBE,2024,1490,1270,2760,41
KIKUUBE,2025,1560,1330,2890,41
KIRUHURA,2015,580,530,1110,41
KIRUHURA,2016,600,550,1150,41
KIRUHURA,2017,630,570,1200,41
KIRUHURA,2018,650,590,1240,41
KIRUHURA,2019,670,610,1280,41
KIRUHURA,2020,700,630,1330,41
KIRUHURA,2021,720,660,1380,41
KIRUHURA,2022,750,680,1430,41
KIRUHURA,2023,770,700,1470,41
KIRUHURA,2024,800,720,1520,41
KIRUHURA,2025,830,740,1570,41
KIRYANDONGO,2015,990,1030,2020,41
KIRYANDONGO,2016,990,1050,2040,41
KIRYANDONGO,2017,1010,1070,2080,41
KIRYANDONGO,2018,1030,1100,2130,41
KIRYANDONGO,2019,1050,1140,2190,41
KIRYANDONGO,2020,1090,1190,2280,41
KIRYANDONGO,2021,1130,1240,2370,41
KIRYANDONGO,2022,1180,1300,2480,41
KIRYANDONGO,2023,1230,1360,2590,41
KIRYANDONGO,2024,1280,1420,2700,41
KIRYANDONGO,2025,1320,1480,2800,41
KISORO,2015,650,1050,1700,41
KISORO,2016,650,1050,1700,41
KISORO,2017,650,1080,1730,41
KISORO,2018,660,1110,1770,41
KISORO,2019,680,1150,1830,41
KISORO,2020,700,1190,1890,41
KISORO,2021,720,1240,1960,41
KISORO,2022,740,1280,2020,41
KISORO,2023,760,1340,2100,41
KISORO,2024,790,1380,2170,41
KISORO,2025,810,1420,2230,41
KITAGWENDA,2015,450,500,950,41
KITAGWENDA,2016,470,520,990,41
KITAGWENDA,2017,490,540,1030,41
KITAGWENDA,2018,510,560,1070,41
KITAGWENDA,2019,530,580,1110,41
KITAGWENDA,2020,550,600,1150,41
KITAGWENDA,2021,570,620,1190,41
KITAGWENDA,2022,590,640,1230,41
KITAGWENDA,2023,610,660,1270,41
KITAGWENDA,2024,630,680,1310,41
KITAGWENDA,2025,660,700,1360,41
KITGUM,2015,770,780,1550,41
KITGUM,2016,770,790,1560,41
KITGUM,2017,770,810,1580,41
KITGUM,2018,780,830,1610,41
KITGUM,2019,790,860,1650,41
KITGUM,2020,820,890,1710,41
KITGUM,2021,830,910,1740,41
KITGUM,2022,850,940,1790,41
KITGUM,2023,870,970,1840,41
KITGUM,2024,900,1010,1910,41
KITGUM,2025,920,1040,1960,41
KOBOKO,2015,620,560,1180,41
KOBOKO,2016,640,570,1210,41
KOBOKO,2017,650,600,1250,41
KOBOKO,2018,670,640,1310,41
KOBOKO,2019,700,660,1360,41
KOBOKO,2020,740,700,1440,41
KOBOKO,2021,770,750,1520,41
KOBOKO,2022,820,790,1610,41
KOBOKO,2023,860,820,1680,41
KOBOKO,2024,900,870,1770,41
KOBOKO,2025,950,920,1870,41
KOLE,2015,680,820,1500,41
KOLE,2016,700,850,1550,41
KOLE,2017,720,870,1590,41
KOLE,2018,740,900,1640,41
KOLE,2019,770,920,1690,41
KOLE,2020,790,950,1740,41
KOLE,2021,810,970,1780,41
KOLE,2022,840,1000,1840,41
KOLE,2023,860,1020,1880,41
KOLE,2024,890,1050,1940,41
KOLE,2025,910,1070,1980,41
KOTIDO,2015,410,550,960,41
KOTIDO,2016,410,550,960,41
KOTIDO,2017,420,560,980,41
KOTIDO,2018,410,580,990,41
KOTIDO,2019,430,600,1030,41
KOTIDO,2020,450,630,1080,41
KOTIDO,2021,470,660,1130,41
KOTIDO,2022,480,690,1170,41
KOTIDO,2023,490,710,1200,41
KOTIDO,2024,510,730,1240,41
KOTIDO,2025,530,760,1290,41
KUMI,2015,950,990,1940,41
KUMI,2016,970,1010,1980,41
KUMI,2017,980,1060,2040,41
KUMI,2018,1010,1090,2100,41
KUMI,2019,1040,1140,2180,41
KUMI,2020,1090,1190,2280,41
KUMI,2021,1130,1240,2370,41
KUMI,2022,1190,1310,2500,41
KUMI,2023,1230,1370,2600,41
KUMI,2024,1280,1430,2710,41
KUMI,2025,1330,1480,2810,41
KWANIA,2015,570,600,1170,41
KWANIA,2016,590,620,1210,41
KWANIA,2017,610,640,1250,41
KWANIA,2018,630,660,1290,41
KWANIA,2019,650,680,1330,41
KWANIA,2020,670,690,1360,41
KWANIA,2021,680,710,1390,41
KWANIA,2022,700,730,1430,41
KWANIA,2023,720,750,1470,41
KWANIA,2024,740,770,1510,41
KWANIA,2025,760,790,1550,41
KWEEN,2015,300,320,620,41
KWEEN,2016,310,330,640,41
KWEEN,2017,320,340,660,41
KWEEN,2018,330,350,680,41
KWEEN,2019,340,360,700,41
KWEEN,2020,350,360,710,41
KWEEN,2021,360,370,730,41
KWEEN,2022,370,380,750,41
KWEEN,2023,380,390,770,41
KWEEN,2024,390,400,790,41
KWEEN,2025,400,410,810,41
KYANKWANZI,2015,710,580,1290,41
KYANKWANZI,2016,740,610,1350,41
KYANKWANZI,2017,780,640,1420,41
KYANKWANZI,2018,820,670,1490,41
KYANKWANZI,2019,860,700,1560,41
KYANKWANZI,2020,910,730,1640,41
KYANKWANZI,2021,950,760,1710,41
KYANKWANZI,2022,1000,800,1800,41
KYANKWANZI,2023,1040,830,1870,41
KYANKWANZI,2024,1090,870,1960,41
KYANKWANZI,2025,1140,900,2040,41
KYEGEGWA,2015,950,890,1840,41
KYEGEGWA,2016,1020,970,1990,41
KYEGEGWA,2017,1110,1040,2150,41
KYEGEGWA,2018,1200,1120,2320,41
KYEGEGWA,2019,1300,1210,2510,41
KYEGEGWA,2020,1400,1310,2710,41
KYEGEGWA,2021,1510,1410,2920,41
KYEGEGWA,2022,1630,1510,3140,41
KYEGEGWA,2023,1760,1630,3390,41
KYEGEGWA,2024,1900,1750,3650,41
KYEGEGWA,2025,2040,1880,3920,41
KYENJOJO,2015,1230,1240,2470,41
KYENJOJO,2016,1280,1290,2570,41
KYENJOJO,2017,1330,1340,2670,41
KYENJOJO,2018,1380,1390,2770,41
KYENJOJO,2019,1440,1440,2880,41
KYENJOJO,2020,1500,1490,2990,41
KYENJOJO,2021,1550,1540,3090,41
KYENJOJO,2022,1610,1590,3200,41
KYENJOJO,2023,1670,1640,3310,41
KYENJOJO,2024,1730,1700,3430,41
KYENJOJO,2025,1800,1750,3550,41
KYOTERA,2015,930,1000,1930,41
KYOTERA,2016,930,1010,1940,41
KYOTERA,2017,940,1030,1970,41
KYOTERA,2018,950,1050,2000,41
KYOTERA,2019,960,1080,2040,41
KYOTERA,2020,990,1120,2110,41
KYOTERA,2021,1010,1160,2170,41
KYOTERA,2022,1050,1190,2240,41
KYOTERA,2023,1080,1230,2310,41
KYOTERA,2024,1100,1260,2360,41
KYOTERA,2025,1130,1290,2420,41
KARENGA,2015,130,150,280,41
KARENGA,2016,130,160,290,41
KARENGA,2017,140,160,300,41
KARENGA,2018,140,160,300,41
KARENGA,2019,140,170,310,41
KARENGA,2020,150,170,320,41
KARENGA,2021,150,180,330,41
KARENGA,2022,160,180,340,41
KARENGA,2023,160,180,340,41
KARENGA,2024,160,190,350,41
KARENGA,2025,170,190,360,41
LAMWO,2015,450,500,950,41
LAMWO,2016,440,490,930,41
LAMWO,2017,440,510,950,41
LAMWO,2018,440,530,970,41
LAMWO,2019,440,530,970,41
LAMWO,2020,450,540,990,41
LAMWO,2021,470,570,1040,41
LAMWO,2022,470,580,1050,41
LAMWO,2023,480,610,1090,41
LAMWO,2024,500,620,1120,41
LAMWO,2025,500,650,1150,41
LIRA,2015,1150,1190,2340,41
LIRA,2016,1180,1230,2410,41
LIRA,2017,1210,1260,2470,41
LIRA,2018,1250,1300,2550,41
LIRA,2019,1280,1340,2620,41
LIRA,2020,1320,1370,2690,41
LIRA,2021,1350,1410,2760,41
LIRA,2022,1380,1450,2830,41
LIRA,2023,1420,1480,2900,41
LIRA,2024,1450,1520,2970,41
LIRA,2025,1480,1550,3030,41
LUUKA,2015,730,990,1720,41
LUUKA,2016,730,1000,1730,41
LUUKA,2017,730,1010,1740,41
LUUKA,2018,740,1050,1790,41
LUUKA,2019,760,1080,1840,41
LUUKA,2020,790,1130,1920,41
LUUKA,2021,810,1170,1980,41
LUUKA,2022,840,1210,2050,41
LUUKA,2023,860,1260,2120,41
LUUKA,2024,880,1300,2180,41
LUUKA,2025,910,1340,2250,41
LUWERO,2015,1660,1770,3430,41
LUWERO,2016,1670,1810,3480,41
LUWERO,2017,1680,1850,3530,41
LUWERO,2018,1720,1910,3630,41
LUWERO,2019,1770,1980,3750,41
LUWERO,2020,1830,2060,3890,41
LUWERO,2021,1900,2150,4050,41
LUWERO,2022,1970,2240,4210,41
LUWERO,2023,2030,2330,4360,41
LUWERO,2024,2110,2420,4530,41
LUWERO,2025,2180,2510,4690,41
LWENGO,2015,1000,1220,2220,41
LWENGO,2016,990,1230,2220,41
LWENGO,2017,990,1230,2220,41
LWENGO,2018,1000,1260,2260,41
LWENGO,2019,1020,1290,2310,41
LWENGO,2020,1030,1330,2360,41
LWENGO,2021,1050,1360,2410,41
LWENGO,2022,1080,1400,2480,41
LWENGO,2023,1090,1450,2540,41
LWENGO,2024,1120,1470,2590,41
LWENGO,2025,1130,1500,2630,41
LYANTONDE,2015,350,370,720,41
LYANTONDE,2016,340,370,710,41
LYANTONDE,2017,350,380,730,41
LYANTONDE,2018,360,400,760,41
LYANTONDE,2019,370,410,780,41
LYANTONDE,2020,380,410,790,41
LYANTONDE,2021,390,430,820,41
LYANTONDE,2022,410,460,870,41
LYANTONDE,2023,420,480,900,41
LYANTONDE,2024,430,490,920,41
LYANTONDE,2025,450,520,970,41
MANAFWA,2015,500,620,1120,41
MANAFWA,2016,510,640,1150,41
MANAFWA,2017,530,650,1180,41
MANAFWA,2018,540,670,1210,41
MANAFWA,2019,550,680,1230,41
MANAFWA,2020,570,700,1270,41
MANAFWA,2021,580,710,1290,41
MANAFWA,2022,590,720,1310,41
MANAFWA,2023,600,740,1340,41
MANAFWA,2024,620,750,1370,41
MANAFWA,2025,630,760,1390,41
MARACHA,2015,470,520,990,41
MARACHA,2016,480,530,1010,41
MARACHA,2017,490,540,1030,41
MARACHA,2018,500,550,1050,41
MARACHA,2019,510,560,1070,41
MARACHA,2020,520,570,1090,41
MARACHA,2021,530,580,1110,41
MARACHA,2022,540,590,1130,41
MARACHA,2023,550,600,1150,41
MARACHA,2024,560,610,1170,41
MARACHA,2025,570,620,1190,41
MASAKA,2015,1150,1110,2260,41
MASAKA,2016,1150,1140,2290,41
MASAKA,2017,1170,1170,2340,41
MASAKA,2018,1190,1190,2380,41
MASAKA,2019,1220,1230,2450,41
MASAKA,2020,1260,1290,2550,41
MASAKA,2021,1300,1330,2630,41
MASAKA,2022,1350,1390,2740,41
MASAKA,2023,1390,1450,2840,41
MASAKA,2024,1430,1490,2920,41
MASAKA,2025,1460,1550,3010,41
MASINDI,2015,1050,860,1910,41
MASINDI,2016,1080,880,1960,41
MASINDI,2017,1120,910,2030,41
MASINDI,2018,1150,930,2080,41
MASINDI,2019,1180,960,2140,41
MASINDI,2020,1210,980,2190,41
MASINDI,2021,1240,1000,2240,41
MASINDI,2022,1280,1030,2310,41
MASINDI,2023,1310,1050,2360,41
MASINDI,2024,1340,1080,2420,41
MASINDI,2025,1370,1100,2470,41
MAYUGE,2015,1540,1950,3490,41
MAYUGE,2016,1560,2000,3560,41
MAYUGE,2017,1590,2070,3660,41
MAYUGE,2018,1620,2140,3760,41
MAYUGE,2019,1680,2240,3920,41
MAYUGE,2020,1750,2360,4110,41
MAYUGE,2021,1840,2470,4310,41
MAYUGE,2022,1910,2590,4500,41
MAYUGE,2023,1990,2720,4710,41
MAYUGE,2024,2070,2840,4910,41
MAYUGE,2025,2150,2970,5120,41
MBALE,2015,1960,2150,4110,41
MBALE,2016,1970,2200,4170,41
MBALE,2017,2010,2290,4300,41
MBALE,2018,2060,2380,4440,41
MBALE,2019,2120,2500,4620,41
MBALE,2020,2210,2620,4830,41
MBALE,2021,2300,2760,5060,41
MBALE,2022,2400,2910,5310,41
MBALE,2023,2500,3040,5540,41
MBALE,2024,2590,3190,5780,41
MBALE,2025,2690,3350,6040,41
MBARARA,2015,1140,1120,2260,41
MBARARA,2016,1170,1140,2310,41
MBARARA,2017,1190,1160,2350,41
MBARARA,2018,1220,1190,2410,41
MBARARA,2019,1250,1210,2460,41
MBARARA,2020,1270,1240,2510,41
MBARARA,2021,1300,1260,2560,41
MBARARA,2022,1320,1290,2610,41
MBARARA,2023,1350,1310,2660,41
MBARARA,2024,1380,1330,2710,41
MBARARA,2025,1400,1350,2750,41
MITOOMA,2015,500,690,1190,41
MITOOMA,2016,500,690,1190,41
MITOOMA,2017,510,700,1210,41
MITOOMA,2018,510,710,1220,41
MITOOMA,2019,520,710,1230,41
MITOOMA,2020,530,720,1250,41
MITOOMA,2021,530,720,1250,41
MITOOMA,2022,540,730,1270,41
MITOOMA,2023,540,730,1270,41
MITOOMA,2024,540,740,1280,41
MITOOMA,2025,550,740,1290,41
MITYANA,2015,1280,1270,2550,41
MITYANA,2016,1280,1290,2570,41
MITYANA,2017,1290,1300,2590,41
MITYANA,2018,1310,1340,2650,41
MITYANA,2019,1340,1370,2710,41
MITYANA,2020,1380,1420,2800,41
MITYANA,2021,1410,1480,2890,41
MITYANA,2022,1450,1520,2970,41
MITYANA,2023,1500,1570,3070,41
MITYANA,2024,1540,1630,3170,41
MITYANA,2025,1580,1670,3250,41
MOROTO,2015,280,250,530,41
MOROTO,2016,280,250,530,41
MOROTO,2017,290,260,550,41
MOROTO,2018,290,260,550,41
MOROTO,2019,300,270,570,41
MOROTO,2020,300,290,590,41
MOROTO,2021,320,290,610,41
MOROTO,2022,320,310,630,41
MOROTO,2023,340,320,660,41
MOROTO,2024,340,340,680,41
MOROTO,2025,360,350,710,41
MOYO,2015,370,350,720,41
MOYO,2016,380,360,740,41
MOYO,2017,390,370,760,41
MOYO,2018,400,380,780,41
MOYO,2019,410,380,790,41
MOYO,2020,420,390,810,41
MOYO,2021,430,400,830,41
MOYO,2022,440,410,850,41
MOYO,2023,450,420,870,41
MOYO,2024,460,420,880,41
MOYO,2025,470,430,900,41
MPIGI,2015,950,920,1870,41
MPIGI,2016,950,940,1890,41
MPIGI,2017,960,960,1920,41
MPIGI,2018,970,990,1960,41
MPIGI,2019,1000,1020,2020,41
MPIGI,2020,1040,1070,2110,41
MPIGI,2021,1080,1110,2190,41
MPIGI,2022,1120,1160,2280,41
MPIGI,2023,1150,1220,2370,41
MPIGI,2024,1190,1260,2450,41
MPIGI,2025,1230,1310,2540,41
MUBENDE,2015,1500,1490,2990,41
MUBENDE,2016,1550,1560,3110,41
MUBENDE,2017,1620,1650,3270,41
MUBENDE,2018,1680,1740,3420,41
MUBENDE,2019,1780,1850,3630,41
MUBENDE,2020,1890,1990,3880,41
MUBENDE,2021,2020,2120,4140,41
MUBENDE,2022,2160,2270,4430,41
MUBENDE,2023,2290,2430,4720,41
MUBENDE,2024,2430,2590,5020,41
MUBENDE,2025,2580,2760,5340,41
MUKONO,2015,2110,2270,4380,41
MUKONO,2016,2130,2330,4460,41
MUKONO,2017,2150,2400,4550,41
MUKONO,2018,2200,2490,4690,41
MUKONO,2019,2280,2590,4870,41
MUKONO,2020,2350,2720,5070,41
MUKONO,2021,2450,2850,5300,41
MUKONO,2022,2550,3000,5550,41
MUKONO,2023,2630,3130,5760,41
MUKONO,2024,2730,3270,6000,41
MUKONO,2025,2820,3410,6230,41
NABILATUK,2015,120,170,290,41
NABILATUK,2016,130,180,310,41
NABILATUK,2017,130,180,310,41
NABILATUK,2018,140,190,330,41
NABILATUK,2019,140,210,350,41
NABILATUK,2020,160,210,370,41
NABILATUK,2021,160,230,390,41
NABILATUK,2022,180,250,430,41
NABILATUK,2023,180,260,440,41
NABILATUK,2024,190,280,470,41
NABILATUK,2025,210,300,510,41
NAKAPIRIPIRIT,2015,200,280,480,41
NAKAPIRIPIRIT,2016,210,290,500,41
NAKAPIRIPIRIT,2017,220,300,520,41
NAKAPIRIPIRIT,2018,230,320,550,41
NAKAPIRIPIRIT,2019,230,340,570,41
NAKAPIRIPIRIT,2020,250,360,610,41
NAKAPIRIPIRIT,2021,270,380,650,41
NAKAPIRIPIRIT,2022,280,400,680,41
NAKAPIRIPIRIT,2023,300,430,730,41
NAKAPIRIPIRIT,2024,320,450,770,41
NAKAPIRIPIRIT,2025,330,470,800,41
NAKASEKE,2015,720,560,1280,41
NAKASEKE,2016,750,570,1320,41
NAKASEKE,2017,770,590,1360,41
NAKASEKE,2018,800,600,1400,41
NAKASEKE,2019,830,620,1450,41
NAKASEKE,2020,860,630,1490,41
NAKASEKE,2021,890,640,1530,41
NAKASEKE,2022,920,660,1580,41
NAKASEKE,2023,950,670,1620,41
NAKASEKE,2024,980,680,1660,41
NAKASEKE,2025,1010,700,1710,41
NAKASONGOLA,2015,770,700,1470,41
NAKASONGOLA,2016,780,710,1490,41
NAKASONGOLA,2017,800,740,1540,41
NAKASONGOLA,2018,820,760,1580,41
NAKASONGOLA,2019,850,800,1650,41
NAKASONGOLA,2020,880,830,1710,41
NAKASONGOLA,2021,920,880,1800,41
NAKASONGOLA,2022,960,910,1870,41
NAKASONGOLA,2023,1000,960,1960,41
NAKASONGOLA,2024,1050,990,2040,41
NAKASONGOLA,2025,1090,1030,2120,41
NAMAYINGO,2015,820,960,1780,41
NAMAYINGO,2016,820,970,1790,41
NAMAYINGO,2017,830,990,1820,41
NAMAYINGO,2018,840,1010,1850,41
NAMAYINGO,2019,860,1040,1900,41
NAMAYINGO,2020,880,1090,1970,41
NAMAYINGO,2021,910,1110,2020,41
NAMAYINGO,2022,930,1150,2080,41
NAMAYINGO,2023,970,1190,2160,41
NAMAYINGO,2024,990,1220,2210,41
NAMAYINGO,2025,1020,1260,2280,41
NAMISINDWA,2015,640,780,1420,41
NAMISINDWA,2016,650,800,1450,41
NAMISINDWA,2017,670,820,1490,41
NAMISINDWA,2018,690,840,1530,41
NAMISINDWA,2019,710,860,1570,41
NAMISINDWA,2020,730,870,1600,41
NAMISINDWA,2021,750,890,1640,41
NAMISINDWA,2022,770,910,1680,41
NAMISINDWA,2023,780,930,1710,41
NAMISINDWA,2024,800,950,1750,41
NAMISINDWA,2025,820,970,1790,41
NAMUTUMBA,2015,870,920,1790,41
NAMUTUMBA,2016,870,960,1830,41
NAMUTUMBA,2017,900,990,1890,41
NAMUTUMBA,2018,920,1020,1940,41
NAMUTUMBA,2019,960,1080,2040,41
NAMUTUMBA,2020,1000,1130,2130,41
NAMUTUMBA,2021,1050,1180,2230,41
NAMUTUMBA,2022,1100,1250,2350,41
NAMUTUMBA,2023,1150,1310,2460,41
NAMUTUMBA,2024,1200,1380,2580,41
NAMUTUMBA,2025,1260,1440,2700,41
NAPAK,2015,240,430,670,41
NAPAK,2016,240,440,680,41
NAPAK,2017,230,450,680,41
NAPAK,2018,250,460,710,41
NAPAK,2019,250,480,730,41
NAPAK,2020,250,500,750,41
NAPAK,2021,270,510,780,41
NAPAK,2022,270,540,810,41
NAPAK,2023,270,560,830,41
NAPAK,2024,290,570,860,41
NAPAK,2025,290,600,890,41
NEBBI,2015,700,870,1570,41
NEBBI,2016,720,890,1610,41
NEBBI,2017,740,920,1660,41
NEBBI,2018,770,940,1710,41
NEBBI,2019,790,970,1760,41
NEBBI,2020,820,990,1810,41
NEBBI,2021,840,1020,1860,41
NEBBI,2022,860,1040,1900,41
NEBBI,2023,890,1070,1960,41
NEBBI,2024,910,1100,2010,41
NEBBI,2025,940,1120,2060,41
NGORA,2015,530,500,1030,41
NGORA,2016,530,510,1040,41
NGORA,2017,530,520,1050,41
NGORA,2018,540,540,1080,41
NGORA,2019,560,560,1120,41
NGORA,2020,590,590,1180,41
NGORA,2021,610,610,1220,41
NGORA,2022,630,640,1270,41
NGORA,2023,650,670,1320,41
NGORA,2024,680,700,1380,41
NGORA,2025,710,730,1440,41
NTOROKO,2015,230,220,450,41
NTOROKO,2016,240,220,460,41
NTOROKO,2017,230,220,450,41
NTOROKO,2018,250,230,480,41
NTOROKO,2019,250,240,490,41
NTOROKO,2020,260,240,500,41
NTOROKO,2021,270,260,530,41
NTOROKO,2022,280,270,550,41
NTOROKO,2023,290,270,560,41
NTOROKO,2024,300,280,580,41
NTOROKO,2025,310,300,610,41
NTUNGAMO,2015,1390,1700,3090,41
NTUNGAMO,2016,1420,1730,3150,41
NTUNGAMO,2017,1450,1760,3210,41
NTUNGAMO,2018,1480,1790,3270,41
NTUNGAMO,2019,1510,1830,3340,41
NTUNGAMO,2020,1540,1860,3400,41
NTUNGAMO,2021,1570,1890,3460,41
NTUNGAMO,2022,1600,1920,3520,41
NTUNGAMO,2023,1630,1950,3580,41
NTUNGAMO,2024,1660,1980,3640,41
NTUNGAMO,2025,1680,2000,3680,41
NWOYA,2015,420,460,880,41
NWOYA,2016,460,510,970,41
NWOYA,2017,510,560,1070,41
NWOYA,2018,560,610,1170,41
NWOYA,2019,620,680,1300,41
NWOYA,2020,680,740,1420,41
NWOYA,2021,750,820,1570,41
NWOYA,2022,830,900,1730,41
NWOYA,2023,910,990,1900,41
NWOYA,2024,1000,1080,2080,41
NWOYA,2025,1100,1190,2290,41
OBONGI,2015,180,170,350,41
OBONGI,2016,190,160,350,41
OBONGI,2017,180,180,360,41
OBONGI,2018,190,180,370,41
OBONGI,2019,200,180,380,41
OBONGI,2020,200,190,390,41
OBONGI,2021,210,200,410,41
OBONGI,2022,220,210,430,41
OBONGI,2023,220,210,430,41
OBONGI,2024,230,220,450,41
OBONGI,2025,240,240,480,41
OMORO,2015,590,700,1290,41
OMORO,2016,610,710,1320,41
OMORO,2017,630,740,1370,41
OMORO,2018,630,770,1400,41
OMORO,2019,660,810,1470,41
OMORO,2020,700,860,1560,41
OMORO,2021,730,910,1640,41
OMORO,2022,770,950,1720,41
OMORO,2023,800,1000,1800,41
OMORO,2024,830,1050,1880,41
OMORO,2025,860,1100,1960,41
OTUKE,2015,350,290,640,41
OTUKE,2016,370,300,670,41
OTUKE,2017,380,320,700,41
OTUKE,2018,400,330,730,41
OTUKE,2019,420,340,760,41
OTUKE,2020,440,360,800,41
OTUKE,2021,450,370,820,41
OTUKE,2022,470,390,860,41
OTUKE,2023,490,400,890,41
OTUKE,2024,510,420,930,41
OTUKE,2025,530,440,970,41
OYAM,2015,1210,1330,2540,41
OYAM,2016,1240,1370,2610,41
OYAM,2017,1280,1410,2690,41
OYAM,2018,1320,1450,2770,41
OYAM,2019,1360,1490,2850,41
OYAM,2020,1400,1530,2930,41
OYAM,2021,1440,1570,3010,41
OYAM,2022,1480,1610,3090,41
OYAM,2023,1520,1650,3170,41
OYAM,2024,1560,1700,3260,41
OYAM,2025,1600,1740,3340,41
PADER,2015,610,620,1230,41
PADER,2016,610,630,1240,41
PADER,2017,610,640,1250,41
PADER,2018,620,660,1280,41
PADER,2019,640,690,1330,41
PADER,2020,660,700,1360,41
PADER,2021,670,730,1400,41
PADER,2022,690,760,1450,41
PADER,2023,710,790,1500,41
PADER,2024,720,820,1540,41
PADER,2025,740,840,1580,41
PAKWACH,2015,500,550,1050,41
PAKWACH,2016,530,570,1100,41
PAKWACH,2017,550,590,1140,41
PAKWACH,2018,570,620,1190,41
PAKWACH,2019,590,640,1230,41
PAKWACH,2020,620,660,1280,41
PAKWACH,2021,640,680,1320,41
PAKWACH,2022,670,710,1380,41
PAKWACH,2023,690,730,1420,41
PAKWACH,2024,720,750,1470,41
PAKWACH,2025,740,780,1520,41
PALLISA,2015,960,1130,2090,41
PALLISA,2016,980,1180,2160,41
PALLISA,2017,1020,1230,2250,41
PALLISA,2018,1050,1300,2350,41
PALLISA,2019,1110,1370,2480,41
PALLISA,2020,1170,1460,2630,41
PALLISA,2021,1240,1550,2790,41
PALLISA,2022,1310,1640,2950,41
PALLISA,2023,1380,1730,3110,41
PALLISA,2024,1450,1840,3290,41
PALLISA,2025,1520,1940,3460,41
RAKAI,2015,970,1060,2030,41
RAKAI,2016,980,1080,2060,41
RAKAI,2017,990,1110,2100,41
RAKAI,2018,1010,1150,2160,41
RAKAI,2019,1040,1180,2220,41
RAKAI,2020,1080,1230,2310,41
RAKAI,2021,1120,1290,2410,41
RAKAI,2022,1160,1340,2500,41
RAKAI,2023,1200,1400,2600,41
RAKAI,2024,1240,1440,2680,41
RAKAI,2025,1280,1500,2780,41
RUBANDA,2015,510,720,1230,41
RUBANDA,2016,510,730,1240,41
RUBANDA,2017,520,730,1250,41
RUBANDA,2018,530,740,1270,41
RUBANDA,2019,530,750,1280,41
RUBANDA,2020,540,750,1290,41
RUBANDA,2021,550,750,1300,41
RUBANDA,2022,550,760,1310,41
RUBANDA,2023,560,760,1320,41
RUBANDA,2024,560,770,1330,41
RUBANDA,2025,570,770,1340,41
RUBIRIZI,2015,390,480,870,41
RUBIRIZI,2016,400,490,890,41
RUBIRIZI,2017,400,500,900,41
RUBIRIZI,2018,410,510,920,41
RUBIRIZI,2019,420,520,940,41
RUBIRIZI,2020,430,520,950,41
RUBIRIZI,2021,440,530,970,41
RUBIRIZI,2022,440,540,980,41
RUBIRIZI,2023,450,550,1000,41
RUBIRIZI,2024,460,560,1020,41
RUBIRIZI,2025,470,570,1040,41
RUKIGA,2015,290,400,690,41
RUKIGA,2016,300,400,700,41
RUKIGA,2017,300,400,700,41
RUKIGA,2018,300,400,700,41
RUKIGA,2019,310,410,720,41
RUKIGA,2020,310,410,720,41
RUKIGA,2021,310,410,720,41
RUKIGA,2022,310,410,720,41
RUKIGA,2023,320,410,730,41
RUKIGA,2024,320,420,740,41
RUKIGA,2025,320,420,740,41
RUKUNGIRI,2015,940,1300,2240,41
RUKUNGIRI,2016,950,1320,2270,41
RUKUNGIRI,2017,960,1330,2290,41
RUKUNGIRI,2018,970,1340,2310,41
RUKUNGIRI,2019,980,1350,2330,41
RUKUNGIRI,2020,990,1370,2360,41
RUKUNGIRI,2021,1000,1380,2380,41
RUKUNGIRI,2022,1010,1390,2400,41
RUKUNGIRI,2023,1020,1390,2410,41
RUKUNGIRI,2024,1030,1400,2430,41
RUKUNGIRI,2025,1040,1410,2450,41
RWAMPARA,2015,330,460,790,41
RWAMPARA,2016,340,470,810,41
RWAMPARA,2017,350,480,830,41
RWAMPARA,2018,350,490,840,41
RWAMPARA,2019,360,500,860,41
RWAMPARA,2020,370,510,880,41
RWAMPARA,2021,380,520,900,41
RWAMPARA,2022,380,530,910,41
RWAMPARA,2023,390,540,930,41
RWAMPARA,2024,400,550,950,41
RWAMPARA,2025,410,560,970,41
SERERE,2015,960,990,1950,41
SERERE,2016,980,1030,2010,41
SERERE,2017,1000,1070,2070,41
SERERE,2018,1050,1120,2170,41
SERERE,2019,1090,1180,2270,41
SERERE,2020,1140,1240,2380,41
SERERE,2021,1210,1320,2530,41
SERERE,2022,1270,1390,2660,41
SERERE,2023,1340,1480,2820,41
SERERE,2024,1410,1550,2960,41
SERERE,2025,1460,1640,3100,41
SHEEMA,2015,670,820,1490,41
SHEEMA,2016,670,830,1500,41
SHEEMA,2017,680,840,1520,41
SHEEMA,2018,690,850,1540,41
SHEEMA,2019,700,860,1560,41
SHEEMA,2020,710,860,1570,41
SHEEMA,2021,710,870,1580,41
SHEEMA,2022,720,880,1600,41
SHEEMA,2023,730,890,1620,41
SHEEMA,2024,730,890,1620,41
SHEEMA,2025,740,900,1640,41
SIRONKO,2015,740,880,1620,41
SIRONKO,2016,760,900,1660,41
SIRONKO,2017,780,920,1700,41
SIRONKO,2018,800,940,1740,41
SIRONKO,2019,820,960,1780,41
SIRONKO,2020,830,980,1810,41
SIRONKO,2021,850,990,1840,41
SIRONKO,2022,870,1010,1880,41
SIRONKO,2023,890,1030,1920,41
SIRONKO,2024,900,1040,1940,41
SIRONKO,2025,920,1060,1980,41
SOROTI,2015,1080,1030,2110,41
SOROTI,2016,1100,1070,2170,41
SOROTI,2017,1130,1110,2240,41
SOROTI,2018,1170,1160,2330,41
SOROTI,2019,1210,1210,2420,41
SOROTI,2020,1260,1270,2530,41
SOROTI,2021,1330,1350,2680,41
SOROTI,2022,1390,1420,2810,41
SOROTI,2023,1460,1490,2950,41
SOROTI,2024,1520,1570,3090,41
SOROTI,2025,1590,1640,3230,41
SSEMBABULE,2015,1010,1110,2120,41
SSEMBABULE,2016,1020,1140,2160,41
SSEMBABULE,2017,1030,1170,2200,41
SSEMBABULE,2018,1050,1220,2270,41
SSEMBABULE,2019,1090,1260,2350,41
SSEMBABULE,2020,1130,1320,2450,41
SSEMBABULE,2021,1190,1370,2560,41
SSEMBABULE,2022,1230,1450,2680,41
SSEMBABULE,2023,1270,1510,2780,41
SSEMBABULE,2024,1320,1570,2890,41
SSEMBABULE,2025,1370,1630,3000,41
TORORO,2015,1880,2210,4090,41
TORORO,2016,1930,2270,4200,41
TORORO,2017,1980,2320,4300,41
TORORO,2018,2030,2380,4410,41
TORORO,2019,2080,2440,4520,41
TORORO,2020,2130,2500,4630,41
TORORO,2021,2190,2550,4740,41
TORORO,2022,2240,2610,4850,41
TORORO,2023,2290,2670,4960,41
TORORO,2024,2340,2720,5060,41
TORORO,2025,2390,2780,5170,41
WAKISO,2015,5890,5490,11380,41
WAKISO,2016,6290,5860,12150,41
WAKISO,2017,6710,6260,12970,41
WAKISO,2018,7150,6690,13840,41
WAKISO,2019,7630,7140,14770,41
WAKISO,2020,8130,7610,15740,41
WAKISO,2021,8650,8110,16760,41
WAKISO,2022,9200,8650,17850,41
WAKISO,2023,9790,9210,19000,41
WAKISO,2024,10400,9790,20190,41
WAKISO,2025,11030,10420,21450,41
YUMBE,2015,1270,1100,2370,41
YUMBE,2016,1310,1160,2470,41
YUMBE,2017,1370,1230,2600,41
YUMBE,2018,1430,1330,2760,41
YUMBE,2019,1510,1420,2930,41
YUMBE,2020,1590,1530,3120,41
YUMBE,2021,1700,1650,3350,41
YUMBE,2022,1800,1770,3570,41
YUMBE,2023,1910,1920,3830,41
YUMBE,2024,2030,2060,4090,41
YUMBE,2025,2150,2210,4360,41
ZOMBO,2015,740,820,1560,41
ZOMBO,2016,760,840,1600,41
ZOMBO,2017,780,860,1640,41
ZOMBO,2018,810,890,1700,41
ZOMBO,2019,830,910,1740,41
ZOMBO,2020,860,940,1800,41
ZOMBO,2021,880,960,1840,41
ZOMBO,2022,900,980,1880,41
ZOMBO,2023,930,1010,1940,41
ZOMBO,2024,950,1030,1980,41
ZOMBO,2025,980,1060,2040,41
MADI OKOLLO,2015,360,370,730,41
MADI OKOLLO,2016,370,380,750,41
MADI OKOLLO,2017,390,390,780,41
MADI OKOLLO,2018,400,400,800,41
MADI OKOLLO,2019,410,410,820,41
MADI OKOLLO,2020,420,420,840,41
MADI OKOLLO,2021,430,440,870,41
MADI OKOLLO,2022,440,450,890,41
MADI OKOLLO,2023,450,460,910,41
MADI OKOLLO,2024,460,470,930,41
MADI OKOLLO,2025,470,480,950,41
ABIM,2015,360,330,690,42
ABIM,2016,380,350,730,42
ABIM,2017,400,370,770,42
ABIM,2018,420,390,810,42
ABIM,2019,440,420,860,42
ABIM,2020,480,450,930,42
ABIM,2021,510,490,1000,42
ABIM,2022,550,520,1070,42
ABIM,2023,590,560,1150,42
ABIM,2024,630,610,1240,42
ABIM,2025,680,650,1330,42
ADJUMANI,2015,730,900,1630,42
ADJUMANI,2016,730,910,1640,42
ADJUMANI,2017,740,910,1650,42
ADJUMANI,2018,740,920,1660,42
ADJUMANI,2019,750,930,1680,42
ADJUMANI,2020,750,940,1690,42
ADJUMANI,2021,750,950,1700,42
ADJUMANI,2022,760,950,1710,42
ADJUMANI,2023,760,960,1720,42
ADJUMANI,2024,760,970,1730,42
ADJUMANI,2025,760,970,1730,42
AGAGO,2015,820,870,1690,42
AGAGO,2016,840,880,1720,42
AGAGO,2017,850,900,1750,42
AGAGO,2018,870,910,1780,42
AGAGO,2019,880,930,1810,42
AGAGO,2020,890,940,1830,42
AGAGO,2021,910,960,1870,42
AGAGO,2022,920,970,1890,42
AGAGO,2023,930,990,1920,42
AGAGO,2024,950,1000,1950,42
AGAGO,2025,960,1010,1970,42
ALEBTONG,2015,850,950,1800,42
ALEBTONG,2016,860,970,1830,42
ALEBTONG,2017,860,990,1850,42
ALEBTONG,2018,870,1020,1890,42
ALEBTONG,2019,900,1050,1950,42
ALEBTONG,2020,930,1100,2030,42
ALEBTONG,2021,960,1150,2110,42
ALEBTONG,2022,990,1200,2190,42
ALEBTONG,2023,1030,1250,2280,42
ALEBTONG,2024,1070,1310,2380,42
ALEBTONG,2025,1120,1360,2480,42
AMOLATAR,2015,590,620,1210,42
AMOLATAR,2016,580,630,1210,42
AMOLATAR,2017,590,640,1230,42
AMOLATAR,2018,600,650,1250,42
AMOLATAR,2019,620,680,1300,42
AMOLATAR,2020,640,700,1340,42
AMOLATAR,2021,650,740,1390,42
AMOLATAR,2022,680,760,1440,42
AMOLATAR,2023,700,800,1500,42
AMOLATAR,2024,730,830,1560,42
AMOLATAR,2025,750,870,1620,42
AMUDAT,2015,280,240,520,42
AMUDAT,2016,280,250,530,42
AMUDAT,2017,290,270,560,42
AMUDAT,2018,300,280,580,42
AMUDAT,2019,310,290,600,42
AMUDAT,2020,320,300,620,42
AMUDAT,2021,340,330,670,42
AMUDAT,2022,350,350,700,42
AMUDAT,2023,370,370,740,42
AMUDAT,2024,390,400,790,42
AMUDAT,2025,400,420,820,42
AMURIA,2015,610,580,1190,42
AMURIA,2016,630,600,1230,42
AMURIA,2017,640,610,1250,42
AMURIA,2018,650,630,1280,42
AMURIA,2019,680,670,1350,42
AMURIA,2020,710,700,1410,42
AMURIA,2021,740,740,1480,42
AMURIA,2022,780,770,1550,42
AMURIA,2023,810,820,1630,42
AMURIA,2024,850,860,1710,42
AMURIA,2025,890,900,1790,42
AMURU,2015,630,790,1420,42
AMURU,2016,640,800,1440,42
AMURU,2017,640,820,1460,42
AMURU,2018,650,840,1490,42
AMURU,2019,660,880,1540,42
AMURU,2020,680,910,1590,42
AMURU,2021,710,950,1660,42
AMURU,2022,730,990,1720,42
AMURU,2023,760,1040,1800,42
AMURU,2024,790,1080,1870,42
AMURU,2025,820,1140,1960,42
APAC,2015,780,830,1610,42
APAC,2016,810,860,1670,42
APAC,2017,840,890,1730,42
APAC,2018,870,920,1790,42
APAC,2019,900,950,1850,42
APAC,2020,940,980,1920,42
APAC,2021,970,1010,1980,42
APAC,2022,1000,1040,2040,42
APAC,2023,1030,1080,2110,42
APAC,2024,1070,1110,2180,42
APAC,2025,1100,1140,2240,42
ARUA,2015,2650,3090,5740,42
ARUA,2016,2730,3170,5900,42
ARUA,2017,2810,3260,6070,42
ARUA,2018,2890,3340,6230,42
ARUA,2019,2970,3430,6400,42
ARUA,2020,3050,3520,6570,42
ARUA,2021,3130,3610,6740,42
ARUA,2022,3210,3690,6900,42
ARUA,2023,3290,3780,7070,42
ARUA,2024,3370,3870,7240,42
ARUA,2025,3450,3960,7410,42
BUDAKA,2015,680,860,1540,42
BUDAKA,2016,690,870,1560,42
BUDAKA,2017,710,900,1610,42
BUDAKA,2018,720,930,1650,42
BUDAKA,2019,740,980,1720,42
BUDAKA,2020,770,1030,1800,42
BUDAKA,2021,800,1080,1880,42
BUDAKA,2022,840,1130,1970,42
BUDAKA,2023,890,1190,2080,42
BUDAKA,2024,930,1260,2190,42
BUDAKA,2025,970,1320,2290,42
BUDUDA,2015,810,800,1610,42
BUDUDA,2016,830,820,1650,42
BUDUDA,2017,850,860,1710,42
BUDUDA,2018,880,900,1780,42
BUDUDA,2019,910,950,1860,42
BUDUDA,2020,960,1000,1960,42
BUDUDA,2021,1020,1070,2090,42
BUDUDA,2022,1070,1130,2200,42
BUDUDA,2023,1140,1210,2350,42
BUDUDA,2024,1200,1280,2480,42
BUDUDA,2025,1260,1360,2620,42
BUGIRI,2015,1290,1530,2820,42
BUGIRI,2016,1320,1590,2910,42
BUGIRI,2017,1350,1640,2990,42
BUGIRI,2018,1390,1710,3100,42
BUGIRI,2019,1430,1790,3220,42
BUGIRI,2020,1500,1890,3390,42
BUGIRI,2021,1580,2000,3580,42
BUGIRI,2022,1660,2120,3780,42
BUGIRI,2023,1750,2240,3990,42
BUGIRI,2024,1830,2360,4190,42
BUGIRI,2025,1920,2480,4400,42
BUGWERI,2015,520,670,1190,42
BUGWERI,2016,530,680,1210,42
BUGWERI,2017,530,700,1230,42
BUGWERI,2018,540,710,1250,42
BUGWERI,2019,550,740,1290,42
BUGWERI,2020,570,770,1340,42
BUGWERI,2021,590,810,1400,42
BUGWERI,2022,610,840,1450,42
BUGWERI,2023,630,870,1500,42
BUGWERI,2024,660,920,1580,42
BUGWERI,2025,680,960,1640,42
BUHWEJU,2015,430,470,900,42
BUHWEJU,2016,440,480,920,42
BUHWEJU,2017,450,500,950,42
BUHWEJU,2018,470,510,980,42
BUHWEJU,2019,480,530,1010,42
BUHWEJU,2020,500,550,1050,42
BUHWEJU,2021,510,560,1070,42
BUHWEJU,2022,530,580,1110,42
BUHWEJU,2023,540,590,1130,42
BUHWEJU,2024,560,610,1170,42
BUHWEJU,2025,570,620,1190,42
BUIKWE,2015,1520,1590,3110,42
BUIKWE,2016,1520,1620,3140,42
BUIKWE,2017,1520,1650,3170,42
BUIKWE,2018,1540,1680,3220,42
BUIKWE,2019,1560,1730,3290,42
BUIKWE,2020,1600,1790,3390,42
BUIKWE,2021,1640,1850,3490,42
BUIKWE,2022,1700,1940,3640,42
BUIKWE,2023,1750,2010,3760,42
BUIKWE,2024,1800,2080,3880,42
BUIKWE,2025,1850,2150,4000,42
BUKEDEA,2015,710,750,1460,42
BUKEDEA,2016,730,770,1500,42
BUKEDEA,2017,740,800,1540,42
BUKEDEA,2018,770,830,1600,42
BUKEDEA,2019,800,880,1680,42
BUKEDEA,2020,840,920,1760,42
BUKEDEA,2021,880,980,1860,42
BUKEDEA,2022,930,1040,1970,42
BUKEDEA,2023,990,1100,2090,42
BUKEDEA,2024,1040,1170,2210,42
BUKEDEA,2025,1090,1240,2330,42
BUKOMANSIMBI,2015,530,590,1120,42
BUKOMANSIMBI,2016,520,590,1110,42
BUKOMANSIMBI,2017,520,590,1110,42
BUKOMANSIMBI,2018,510,590,1100,42
BUKOMANSIMBI,2019,510,600,1110,42
BUKOMANSIMBI,2020,520,610,1130,42
BUKOMANSIMBI,2021,530,620,1150,42
BUKOMANSIMBI,2022,540,650,1190,42
BUKOMANSIMBI,2023,550,660,1210,42
BUKOMANSIMBI,2024,560,670,1230,42
BUKOMANSIMBI,2025,560,690,1250,42
BUKWO,2015,360,350,710,42
BUKWO,2016,380,370,750,42
BUKWO,2017,400,390,790,42
BUKWO,2018,420,410,830,42
BUKWO,2019,440,430,870,42
BUKWO,2020,460,450,910,42
BUKWO,2021,490,470,960,42
BUKWO,2022,510,490,1000,42
BUKWO,2023,540,510,1050,42
BUKWO,2024,560,530,1090,42
BUKWO,2025,590,560,1150,42
BULAMBULI,2015,740,730,1470,42
BULAMBULI,2016,770,750,1520,42
BULAMBULI,2017,790,790,1580,42
BULAMBULI,2018,820,830,1650,42
BULAMBULI,2019,850,880,1730,42
BULAMBULI,2020,900,930,1830,42
BULAMBULI,2021,960,1000,1960,42
BULAMBULI,2022,1010,1070,2080,42
BULAMBULI,2023,1070,1140,2210,42
BULAMBULI,2024,1130,1210,2340,42
BULAMBULI,2025,1200,1290,2490,42
BULIISA,2015,480,490,970,42
BULIISA,2016,510,510,1020,42
BULIISA,2017,540,540,1080,42
BULIISA,2018,570,560,1130,42
BULIISA,2019,590,580,1170,42
BULIISA,2020,630,610,1240,42
BULIISA,2021,660,630,1290,42
BULIISA,2022,690,660,1350,42
BULIISA,2023,730,690,1420,42
BULIISA,2024,760,710,1470,42
BULIISA,2025,800,740,1540,42
BUNDIBUGYO,2015,780,710,1490,42
BUNDIBUGYO,2016,790,720,1510,42
BUNDIBUGYO,2017,810,740,1550,42
BUNDIBUGYO,2018,810,760,1570,42
BUNDIBUGYO,2019,830,790,1620,42
BUNDIBUGYO,2020,870,820,1690,42
BUNDIBUGYO,2021,900,860,1760,42
BUNDIBUGYO,2022,930,900,1830,42
BUNDIBUGYO,2023,970,940,1910,42
BUNDIBUGYO,2024,1010,980,1990,42
BUNDIBUGYO,2025,1050,1020,2070,42
BUNYANGABU,2015,600,600,1200,42
BUNYANGABU,2016,610,610,1220,42
BUNYANGABU,2017,620,620,1240,42
BUNYANGABU,2018,620,630,1250,42
BUNYANGABU,2019,630,650,1280,42
BUNYANGABU,2020,650,680,1330,42
BUNYANGABU,2021,680,700,1380,42
BUNYANGABU,2022,700,740,1440,42
BUNYANGABU,2023,720,770,1490,42
BUNYANGABU,2024,750,790,1540,42
BUNYANGABU,2025,780,820,1600,42
BUSHENYI,2015,970,960,1930,42
BUSHENYI,2016,990,970,1960,42
BUSHENYI,2017,1000,980,1980,42
BUSHENYI,2018,1010,990,2000,42
BUSHENYI,2019,1020,1000,2020,42
BUSHENYI,2020,1030,1000,2030,42
BUSHENYI,2021,1040,1010,2050,42
BUSHENYI,2022,1050,1020,2070,42
BUSHENYI,2023,1060,1020,2080,42
BUSHENYI,2024,1070,1030,2100,42
BUSHENYI,2025,1080,1030,2110,42
BUSIA,2015,1150,1210,2360,42
BUSIA,2016,1170,1240,2410,42
BUSIA,2017,1180,1270,2450,42
BUSIA,2018,1200,1320,2520,42
BUSIA,2019,1230,1360,2590,42
BUSIA,2020,1280,1420,2700,42
BUSIA,2021,1330,1490,2820,42
BUSIA,2022,1390,1550,2940,42
BUSIA,2023,1450,1630,3080,42
BUSIA,2024,1500,1710,3210,42
BUSIA,2025,1570,1780,3350,42
BUTALEJA,2015,820,960,1780,42
BUTALEJA,2016,830,990,1820,42
BUTALEJA,2017,850,1020,1870,42
BUTALEJA,2018,870,1060,1930,42
BUTALEJA,2019,900,1100,2000,42
BUTALEJA,2020,940,1160,2100,42
BUTALEJA,2021,980,1220,2200,42
BUTALEJA,2022,1030,1290,2320,42
BUTALEJA,2023,1080,1360,2440,42
BUTALEJA,2024,1130,1430,2560,42
BUTALEJA,2025,1180,1510,2690,42
BUTAMBALA,2015,300,340,640,42
BUTAMBALA,2016,290,340,630,42
BUTAMBALA,2017,300,350,650,42
BUTAMBALA,2018,290,350,640,42
BUTAMBALA,2019,300,360,660,42
BUTAMBALA,2020,300,370,670,42
BUTAMBALA,2021,310,370,680,42
BUTAMBALA,2022,320,380,700,42
BUTAMBALA,2023,320,400,720,42
BUTAMBALA,2024,330,410,740,42
BUTAMBALA,2025,340,420,760,42
BUTEBO,2015,360,420,780,42
BUTEBO,2016,360,420,780,42
BUTEBO,2017,360,420,780,42
BUTEBO,2018,360,430,790,42
BUTEBO,2019,360,440,800,42
BUTEBO,2020,370,450,820,42
BUTEBO,2021,370,470,840,42
BUTEBO,2022,390,480,870,42
BUTEBO,2023,400,500,900,42
BUTEBO,2024,410,510,920,42
BUTEBO,2025,420,530,950,42
BUVUMA,2015,670,370,1040,42
BUVUMA,2016,720,400,1120,42
BUVUMA,2017,760,420,1180,42
BUVUMA,2018,810,450,1260,42
BUVUMA,2019,860,480,1340,42
BUVUMA,2020,910,510,1420,42
BUVUMA,2021,960,550,1510,42
BUVUMA,2022,1020,580,1600,42
BUVUMA,2023,1080,620,1700,42
BUVUMA,2024,1140,660,1800,42
BUVUMA,2025,1200,700,1900,42
BUYENDE,2015,920,1050,1970,42
BUYENDE,2016,950,1090,2040,42
BUYENDE,2017,980,1130,2110,42
BUYENDE,2018,1010,1180,2190,42
BUYENDE,2019,1050,1240,2290,42
BUYENDE,2020,1090,1310,2400,42
BUYENDE,2021,1150,1400,2550,42
BUYENDE,2022,1220,1480,2700,42
BUYENDE,2023,1290,1580,2870,42
BUYENDE,2024,1350,1660,3010,42
BUYENDE,2025,1430,1770,3200,42
DOKOLO,2015,740,750,1490,42
DOKOLO,2016,770,770,1540,42
DOKOLO,2017,790,790,1580,42
DOKOLO,2018,810,820,1630,42
DOKOLO,2019,840,840,1680,42
DOKOLO,2020,860,860,1720,42
DOKOLO,2021,890,880,1770,42
DOKOLO,2022,910,900,1810,42
DOKOLO,2023,940,920,1860,42
DOKOLO,2024,960,950,1910,42
DOKOLO,2025,980,970,1950,42
GOMBA,2015,640,550,1190,42
GOMBA,2016,640,560,1200,42
GOMBA,2017,640,560,1200,42
GOMBA,2018,640,560,1200,42
GOMBA,2019,650,580,1230,42
GOMBA,2020,660,590,1250,42
GOMBA,2021,680,610,1290,42
GOMBA,2022,700,620,1320,42
GOMBA,2023,710,650,1360,42
GOMBA,2024,730,660,1390,42
GOMBA,2025,750,690,1440,42
GULU,2015,1100,1120,2220,42
GULU,2016,1140,1150,2290,42
GULU,2017,1170,1180,2350,42
GULU,2018,1210,1220,2430,42
GULU,2019,1240,1250,2490,42
GULU,2020,1280,1280,2560,42
GULU,2021,1310,1320,2630,42
GULU,2022,1350,1350,2700,42
GULU,2023,1380,1390,2770,42
GULU,2024,1420,1420,2840,42
GULU,2025,1450,1460,2910,42
HOIMA,2015,1380,1270,2650,42
HOIMA,2016,1430,1320,2750,42
HOIMA,2017,1480,1360,2840,42
HOIMA,2018,1540,1410,2950,42
HOIMA,2019,1590,1460,3050,42
HOIMA,2020,1650,1500,3150,42
HOIMA,2021,1710,1550,3260,42
HOIMA,2022,1770,1600,3370,42
HOIMA,2023,1830,1650,3480,42
HOIMA,2024,1890,1700,3590,42
HOIMA,2025,1950,1750,3700,42
IBANDA,2015,1050,1160,2210,42
IBANDA,2016,1070,1180,2250,42
IBANDA,2017,1090,1210,2300,42
IBANDA,2018,1110,1230,2340,42
IBANDA,2019,1130,1250,2380,42
IBANDA,2020,1150,1270,2420,42
IBANDA,2021,1170,1290,2460,42
IBANDA,2022,1190,1310,2500,42
IBANDA,2023,1210,1330,2540,42
IBANDA,2024,1230,1350,2580,42
IBANDA,2025,1250,1360,2610,42
IGANGA,2015,1120,1430,2550,42
IGANGA,2016,1130,1470,2600,42
IGANGA,2017,1150,1510,2660,42
IGANGA,2018,1170,1560,2730,42
IGANGA,2019,1200,1610,2810,42
IGANGA,2020,1240,1680,2920,42
IGANGA,2021,1290,1760,3050,42
IGANGA,2022,1350,1840,3190,42
IGANGA,2023,1400,1930,3330,42
IGANGA,2024,1460,2020,3480,42
IGANGA,2025,1520,2110,3630,42
ISINGIRO,2015,2150,2350,4500,42
ISINGIRO,2016,2230,2440,4670,42
ISINGIRO,2017,2310,2520,4830,42
ISINGIRO,2018,2400,2610,5010,42
ISINGIRO,2019,2490,2700,5190,42
ISINGIRO,2020,2580,2790,5370,42
ISINGIRO,2021,2670,2890,5560,42
ISINGIRO,2022,2760,2980,5740,42
ISINGIRO,2023,2850,3070,5920,42
ISINGIRO,2024,2950,3170,6120,42
ISINGIRO,2025,3040,3270,6310,42
JINJA,2015,1900,1920,3820,42
JINJA,2016,1940,1950,3890,42
JINJA,2017,1970,1980,3950,42
JINJA,2018,2000,2010,4010,42
JINJA,2019,2030,2040,4070,42
JINJA,2020,2060,2070,4130,42
JINJA,2021,2090,2100,4190,42
JINJA,2022,2120,2130,4250,42
JINJA,2023,2150,2150,4300,42
JINJA,2024,2180,2180,4360,42
JINJA,2025,2200,2200,4400,42
KAABONG,2015,380,270,650,42
KAABONG,2016,390,270,660,42
KAABONG,2017,400,280,680,42
KAABONG,2018,410,290,700,42
KAABONG,2019,430,290,720,42
KAABONG,2020,430,300,730,42
KAABONG,2021,450,310,760,42
KAABONG,2022,460,320,780,42
KAABONG,2023,470,320,790,42
KAABONG,2024,480,330,810,42
KAABONG,2025,490,330,820,42
KABALE,2015,940,1000,1940,42
KABALE,2016,960,1010,1970,42
KABALE,2017,970,1020,1990,42
KABALE,2018,990,1030,2020,42
KABALE,2019,1000,1050,2050,42
KABALE,2020,1020,1060,2080,42
KABALE,2021,1030,1070,2100,42
KABALE,2022,1040,1080,2120,42
KABALE,2023,1060,1090,2150,42
KABALE,2024,1070,1100,2170,42
KABALE,2025,1080,1100,2180,42
KABAROLE,2015,1340,1120,2460,42
KABAROLE,2016,1370,1140,2510,42
KABAROLE,2017,1400,1170,2570,42
KABAROLE,2018,1430,1190,2620,42
KABAROLE,2019,1460,1210,2670,42
KABAROLE,2020,1490,1240,2730,42
KABAROLE,2021,1520,1260,2780,42
KABAROLE,2022,1550,1290,2840,42
KABAROLE,2023,1580,1310,2890,42
KABAROLE,2024,1610,1330,2940,42
KABAROLE,2025,1630,1360,2990,42
KABERAMAIDO,2015,340,380,720,42
KABERAMAIDO,2016,350,400,750,42
KABERAMAIDO,2017,360,410,770,42
KABERAMAIDO,2018,370,430,800,42
KABERAMAIDO,2019,390,450,840,42
KABERAMAIDO,2020,400,470,870,42
KABERAMAIDO,2021,420,500,920,42
KABERAMAIDO,2022,440,530,970,42
KABERAMAIDO,2023,470,550,1020,42
KABERAMAIDO,2024,490,580,1070,42
KABERAMAIDO,2025,520,620,1140,42
KAGADI,2015,1320,1360,2680,42
KAGADI,2016,1370,1410,2780,42
KAGADI,2017,1420,1460,2880,42
KAGADI,2018,1470,1510,2980,42
KAGADI,2019,1520,1560,3080,42
KAGADI,2020,1580,1620,3200,42
KAGADI,2021,1630,1670,3300,42
KAGADI,2022,1690,1720,3410,42
KAGADI,2023,1740,1780,3520,42
KAGADI,2024,1800,1830,3630,42
KAGADI,2025,1860,1890,3750,42
KAKUMIRO,2015,1210,1120,2330,42
KAKUMIRO,2016,1320,1210,2530,42
KAKUMIRO,2017,1440,1310,2750,42
KAKUMIRO,2018,1560,1420,2980,42
KAKUMIRO,2019,1700,1540,3240,42
KAKUMIRO,2020,1850,1670,3520,42
KAKUMIRO,2021,2010,1810,3820,42
KAKUMIRO,2022,2180,1950,4130,42
KAKUMIRO,2023,2360,2110,4470,42
KAKUMIRO,2024,2560,2280,4840,42
KAKUMIRO,2025,2770,2460,5230,42
KALAKI,2015,410,380,790,42
KALAKI,2016,430,400,830,42
KALAKI,2017,450,410,860,42
KALAKI,2018,470,430,900,42
KALAKI,2019,490,440,930,42
KALAKI,2020,510,460,970,42
KALAKI,2021,530,480,1010,42
KALAKI,2022,550,490,1040,42
KALAKI,2023,570,510,1080,42
KALAKI,2024,590,530,1120,42
KALAKI,2025,620,550,1170,42
KALANGALA,2015,530,220,750,42
KALANGALA,2016,550,230,780,42
KALANGALA,2017,570,240,810,42
KALANGALA,2018,590,250,840,42
KALANGALA,2019,610,260,870,42
KALANGALA,2020,640,270,910,42
KALANGALA,2021,660,280,940,42
KALANGALA,2022,680,300,980,42
KALANGALA,2023,700,310,1010,42
KALANGALA,2024,720,320,1040,42
KALANGALA,2025,740,330,1070,42
KALIRO,2015,800,730,1530,42
KALIRO,2016,810,750,1560,42
KALIRO,2017,820,780,1600,42
KALIRO,2018,850,800,1650,42
KALIRO,2019,870,840,1710,42
KALIRO,2020,900,880,1780,42
KALIRO,2021,950,930,1880,42
KALIRO,2022,990,980,1970,42
KALIRO,2023,1030,1030,2060,42
KALIRO,2024,1080,1080,2160,42
KALIRO,2025,1130,1140,2270,42
KALUNGU,2015,600,730,1330,42
KALUNGU,2016,590,730,1320,42
KALUNGU,2017,590,730,1320,42
KALUNGU,2018,590,740,1330,42
KALUNGU,2019,590,760,1350,42
KALUNGU,2020,600,770,1370,42
KALUNGU,2021,620,800,1420,42
KALUNGU,2022,620,810,1430,42
KALUNGU,2023,640,840,1480,42
KALUNGU,2024,660,860,1520,42
KALUNGU,2025,670,890,1560,42
KAMPALA,2015,6420,5620,12040,42
KAMPALA,2016,6550,5730,12280,42
KAMPALA,2017,6680,5840,12520,42
KAMPALA,2018,6810,5950,12760,42
KAMPALA,2019,6940,6060,13000,42
KAMPALA,2020,7060,6170,13230,42
KAMPALA,2021,7190,6270,13460,42
KAMPALA,2022,7310,6380,13690,42
KAMPALA,2023,7430,6480,13910,42
KAMPALA,2024,7540,6580,14120,42
KAMPALA,2025,7650,6680,14330,42
KAMULI,2015,1530,1940,3470,42
KAMULI,2016,1540,1970,3510,42
KAMULI,2017,1560,2020,3580,42
KAMULI,2018,1570,2060,3630,42
KAMULI,2019,1610,2130,3740,42
KAMULI,2020,1660,2200,3860,42
KAMULI,2021,1710,2300,4010,42
KAMULI,2022,1780,2390,4170,42
KAMULI,2023,1850,2480,4330,42
KAMULI,2024,1910,2590,4500,42
KAMULI,2025,1980,2690,4670,42
KAMWENGE,2015,1050,1110,2160,42
KAMWENGE,2016,1100,1150,2250,42
KAMWENGE,2017,1140,1190,2330,42
KAMWENGE,2018,1190,1230,2420,42
KAMWENGE,2019,1230,1270,2500,42
KAMWENGE,2020,1280,1320,2600,42
KAMWENGE,2021,1330,1360,2690,42
KAMWENGE,2022,1380,1400,2780,42
KAMWENGE,2023,1430,1450,2880,42
KAMWENGE,2024,1480,1500,2980,42
KAMWENGE,2025,1540,1540,3080,42
KANUNGU,2015,990,1150,2140,42
KANUNGU,2016,1010,1170,2180,42
KANUNGU,2017,1030,1190,2220,42
KANUNGU,2018,1050,1210,2260,42
KANUNGU,2019,1070,1230,2300,42
KANUNGU,2020,1080,1250,2330,42
KANUNGU,2021,1100,1260,2360,42
KANUNGU,2022,1120,1280,2400,42
KANUNGU,2023,1140,1300,2440,42
KANUNGU,2024,1150,1320,2470,42
KANUNGU,2025,1170,1330,2500,42
KAPCHORWA,2015,400,460,860,42
KAPCHORWA,2016,410,470,880,42
KAPCHORWA,2017,430,480,910,42
KAPCHORWA,2018,440,500,940,42
KAPCHORWA,2019,450,510,960,42
KAPCHORWA,2020,460,520,980,42
KAPCHORWA,2021,480,540,1020,42
KAPCHORWA,2022,490,550,1040,42
KAPCHORWA,2023,500,570,1070,42
KAPCHORWA,2024,520,580,1100,42
KAPCHORWA,2025,530,590,1120,42
KAPELEBYONG,2015,320,280,600,42
KAPELEBYONG,2016,320,290,610,42
KAPELEBYONG,2017,320,300,620,42
KAPELEBYONG,2018,330,310,640,42
KAPELEBYONG,2019,340,320,660,42
KAPELEBYONG,2020,350,330,680,42
KAPELEBYONG,2021,370,340,710,42
KAPELEBYONG,2022,380,360,740,42
KAPELEBYONG,2023,390,380,770,42
KAPELEBYONG,2024,420,400,820,42
KAPELEBYONG,2025,430,420,850,42
KASESE,2015,2330,2580,4910,42
KASESE,2016,2340,2620,4960,42
KASESE,2017,2340,2670,5010,42
KASESE,2018,2380,2740,5120,42
KASESE,2019,2430,2820,5250,42
KASESE,2020,2490,2920,5410,42
KASESE,2021,2580,3030,5610,42
KASESE,2022,2670,3160,5830,42
KASESE,2023,2760,3290,6050,42
KASESE,2024,2850,3420,6270,42
KASESE,2025,2950,3540,6490,42
KASSANDA,2015,1100,1050,2150,42
KASSANDA,2016,1130,1080,2210,42
KASSANDA,2017,1170,1100,2270,42
KASSANDA,2018,1200,1120,2320,42
KASSANDA,2019,1230,1140,2370,42
KASSANDA,2020,1270,1170,2440,42
KASSANDA,2021,1300,1190,2490,42
KASSANDA,2022,1330,1210,2540,42
KASSANDA,2023,1360,1240,2600,42
KASSANDA,2024,1400,1260,2660,42
KASSANDA,2025,1430,1280,2710,42
KATAKWI,2015,520,570,1090,42
KATAKWI,2016,530,590,1120,42
KATAKWI,2017,540,590,1130,42
KATAKWI,2018,550,610,1160,42
KATAKWI,2019,560,630,1190,42
KATAKWI,2020,570,660,1230,42
KATAKWI,2021,600,680,1280,42
KATAKWI,2022,620,720,1340,42
KATAKWI,2023,650,750,1400,42
KATAKWI,2024,680,780,1460,42
KATAKWI,2025,700,810,1510,42
KAYUNGA,2015,1210,1400,2610,42
KAYUNGA,2016,1210,1420,2630,42
KAYUNGA,2017,1210,1440,2650,42
KAYUNGA,2018,1220,1470,2690,42
KAYUNGA,2019,1240,1500,2740,42
KAYUNGA,2020,1260,1540,2800,42
KAYUNGA,2021,1300,1600,2900,42
KAYUNGA,2022,1350,1660,3010,42
KAYUNGA,2023,1380,1720,3100,42
KAYUNGA,2024,1420,1770,3190,42
KAYUNGA,2025,1460,1830,3290,42
KAZO,2015,760,850,1610,42
KAZO,2016,790,880,1670,42
KAZO,2017,820,910,1730,42
KAZO,2018,850,940,1790,42
KAZO,2019,880,970,1850,42
KAZO,2020,910,1010,1920,42
KAZO,2021,940,1040,1980,42
KAZO,2022,970,1070,2040,42
KAZO,2023,1010,1110,2120,42
KAZO,2024,1040,1140,2180,42
KAZO,2025,1080,1180,2260,42
KIBAALE,2015,580,500,1080,42
KIBAALE,2016,620,530,1150,42
KIBAALE,2017,650,560,1210,42
KIBAALE,2018,700,590,1290,42
KIBAALE,2019,740,630,1370,42
KIBAALE,2020,790,660,1450,42
KIBAALE,2021,830,700,1530,42
KIBAALE,2022,880,740,1620,42
KIBAALE,2023,940,780,1720,42
KIBAALE,2024,990,820,1810,42
KIBAALE,2025,1050,860,1910,42
KIBOGA,2015,550,570,1120,42
KIBOGA,2016,560,590,1150,42
KIBOGA,2017,560,600,1160,42
KIBOGA,2018,580,610,1190,42
KIBOGA,2019,580,630,1210,42
KIBOGA,2020,590,650,1240,42
KIBOGA,2021,610,670,1280,42
KIBOGA,2022,640,700,1340,42
KIBOGA,2023,660,730,1390,42
KIBOGA,2024,680,760,1440,42
KIBOGA,2025,710,790,1500,42
KIBUKU,2015,620,780,1400,42
KIBUKU,2016,640,800,1440,42
KIBUKU,2017,650,830,1480,42
KIBUKU,2018,670,860,1530,42
KIBUKU,2019,690,900,1590,42
KIBUKU,2020,720,940,1660,42
KIBUKU,2021,760,990,1750,42
KIBUKU,2022,800,1060,1860,42
KIBUKU,2023,830,1110,1940,42
KIBUKU,2024,870,1170,2040,42
KIBUKU,2025,920,1240,2160,42
KIKUUBE,2015,1310,1010,2320,42
KIKUUBE,2016,1380,1070,2450,42
KIKUUBE,2017,1460,1120,2580,42
KIKUUBE,2018,1530,1180,2710,42
KIKUUBE,2019,1620,1240,2860,42
KIKUUBE,2020,1700,1300,3000,42
KIKUUBE,2021,1790,1360,3150,42
KIKUUBE,2022,1880,1430,3310,42
KIKUUBE,2023,1970,1490,3460,42
KIKUUBE,2024,2070,1570,3640,42
KIKUUBE,2025,2160,1640,3800,42
KIRUHURA,2015,790,600,1390,42
KIRUHURA,2016,820,620,1440,42
KIRUHURA,2017,850,640,1490,42
KIRUHURA,2018,880,660,1540,42
KIRUHURA,2019,910,690,1600,42
KIRUHURA,2020,950,710,1660,42
KIRUHURA,2021,980,730,1710,42
KIRUHURA,2022,1010,760,1770,42
KIRUHURA,2023,1050,780,1830,42
KIRUHURA,2024,1080,810,1890,42
KIRUHURA,2025,1120,830,1950,42
KIRYANDONGO,2015,940,950,1890,42
KIRYANDONGO,2016,960,990,1950,42
KIRYANDONGO,2017,980,1010,1990,42
KIRYANDONGO,2018,980,1040,2020,42
KIRYANDONGO,2019,1000,1070,2070,42
KIRYANDONGO,2020,1030,1100,2130,42
KIRYANDONGO,2021,1060,1150,2210,42
KIRYANDONGO,2022,1110,1200,2310,42
KIRYANDONGO,2023,1150,1260,2410,42
KIRYANDONGO,2024,1200,1310,2510,42
KIRYANDONGO,2025,1250,1370,2620,42
KISORO,2015,710,1110,1820,42
KISORO,2016,710,1130,1840,42
KISORO,2017,710,1150,1860,42
KISORO,2018,720,1170,1890,42
KISORO,2019,730,1210,1940,42
KISORO,2020,740,1250,1990,42
KISORO,2021,770,1290,2060,42
KISORO,2022,790,1340,2130,42
KISORO,2023,810,1390,2200,42
KISORO,2024,830,1440,2270,42
KISORO,2025,860,1500,2360,42
KITAGWENDA,2015,590,660,1250,42
KITAGWENDA,2016,620,680,1300,42
KITAGWENDA,2017,640,710,1350,42
KITAGWENDA,2018,670,730,1400,42
KITAGWENDA,2019,700,760,1460,42
KITAGWENDA,2020,730,780,1510,42
KITAGWENDA,2021,750,810,1560,42
KITAGWENDA,2022,780,840,1620,42
KITAGWENDA,2023,810,860,1670,42
KITAGWENDA,2024,840,890,1730,42
KITAGWENDA,2025,870,920,1790,42
KITGUM,2015,770,810,1580,42
KITGUM,2016,770,810,1580,42
KITGUM,2017,760,830,1590,42
KITGUM,2018,770,840,1610,42
KITGUM,2019,770,860,1630,42
KITGUM,2020,790,880,1670,42
KITGUM,2021,810,920,1730,42
KITGUM,2022,830,950,1780,42
KITGUM,2023,860,980,1840,42
KITGUM,2024,880,1010,1890,42
KITGUM,2025,900,1050,1950,42
KOBOKO,2015,740,720,1460,42
KOBOKO,2016,760,740,1500,42
KOBOKO,2017,770,770,1540,42
KOBOKO,2018,800,800,1600,42
KOBOKO,2019,830,840,1670,42
KOBOKO,2020,860,880,1740,42
KOBOKO,2021,900,930,1830,42
KOBOKO,2022,950,980,1930,42
KOBOKO,2023,1000,1040,2040,42
KOBOKO,2024,1050,1090,2140,42
KOBOKO,2025,1100,1160,2260,42
KOLE,2015,980,1020,2000,42
KOLE,2016,1020,1050,2070,42
KOLE,2017,1050,1080,2130,42
KOLE,2018,1080,1110,2190,42
KOLE,2019,1120,1140,2260,42
KOLE,2020,1150,1170,2320,42
KOLE,2021,1190,1210,2400,42
KOLE,2022,1220,1240,2460,42
KOLE,2023,1260,1270,2530,42
KOLE,2024,1290,1300,2590,42
KOLE,2025,1330,1330,2660,42
KOTIDO,2015,450,550,1000,42
KOTIDO,2016,450,570,1020,42
KOTIDO,2017,450,570,1020,42
KOTIDO,2018,450,580,1030,42
KOTIDO,2019,470,600,1070,42
KOTIDO,2020,480,630,1110,42
KOTIDO,2021,490,650,1140,42
KOTIDO,2022,510,680,1190,42
KOTIDO,2023,530,700,1230,42
KOTIDO,2024,550,730,1280,42
KOTIDO,2025,560,750,1310,42
KUMI,2015,880,970,1850,42
KUMI,2016,890,990,1880,42
KUMI,2017,900,1010,1910,42
KUMI,2018,930,1040,1970,42
KUMI,2019,950,1080,2030,42
KUMI,2020,980,1130,2110,42
KUMI,2021,1030,1180,2210,42
KUMI,2022,1070,1240,2310,42
KUMI,2023,1120,1300,2420,42
KUMI,2024,1160,1360,2520,42
KUMI,2025,1210,1420,2630,42
KWANIA,2015,710,820,1530,42
KWANIA,2016,730,840,1570,42
KWANIA,2017,760,870,1630,42
KWANIA,2018,780,890,1670,42
KWANIA,2019,800,920,1720,42
KWANIA,2020,830,940,1770,42
KWANIA,2021,850,970,1820,42
KWANIA,2022,870,990,1860,42
KWANIA,2023,900,1020,1920,42
KWANIA,2024,920,1040,1960,42
KWANIA,2025,940,1070,2010,42
KWEEN,2015,380,380,760,42
KWEEN,2016,390,390,780,42
KWEEN,2017,410,400,810,42
KWEEN,2018,420,410,830,42
KWEEN,2019,430,420,850,42
KWEEN,2020,440,430,870,42
KWEEN,2021,460,440,900,42
KWEEN,2022,470,450,920,42
KWEEN,2023,480,460,940,42
KWEEN,2024,490,470,960,42
KWEEN,2025,510,480,990,42
KYANKWANZI,2015,1030,820,1850,42
KYANKWANZI,2016,1080,860,1940,42
KYANKWANZI,2017,1140,900,2040,42
KYANKWANZI,2018,1200,940,2140,42
KYANKWANZI,2019,1260,990,2250,42
KYANKWANZI,2020,1320,1030,2350,42
KYANKWANZI,2021,1390,1080,2470,42
KYANKWANZI,2022,1450,1130,2580,42
KYANKWANZI,2023,1520,1180,2700,42
KYANKWANZI,2024,1590,1220,2810,42
KYANKWANZI,2025,1670,1280,2950,42
KYEGEGWA,2015,1210,1060,2270,42
KYEGEGWA,2016,1310,1150,2460,42
KYEGEGWA,2017,1420,1240,2660,42
KYEGEGWA,2018,1540,1330,2870,42
KYEGEGWA,2019,1660,1440,3100,42
KYEGEGWA,2020,1790,1550,3340,42
KYEGEGWA,2021,1940,1670,3610,42
KYEGEGWA,2022,2090,1800,3890,42
KYEGEGWA,2023,2250,1930,4180,42
KYEGEGWA,2024,2430,2080,4510,42
KYEGEGWA,2025,2620,2230,4850,42
KYENJOJO,2015,1660,1580,3240,42
KYENJOJO,2016,1730,1640,3370,42
KYENJOJO,2017,1800,1700,3500,42
KYENJOJO,2018,1870,1760,3630,42
KYENJOJO,2019,1950,1820,3770,42
KYENJOJO,2020,2020,1890,3910,42
KYENJOJO,2021,2100,1950,4050,42
KYENJOJO,2022,2180,2020,4200,42
KYENJOJO,2023,2260,2090,4350,42
KYENJOJO,2024,2340,2160,4500,42
KYENJOJO,2025,2430,2220,4650,42
KYOTERA,2015,1120,970,2090,42
KYOTERA,2016,1110,980,2090,42
KYOTERA,2017,1110,990,2100,42
KYOTERA,2018,1110,1000,2110,42
KYOTERA,2019,1120,1030,2150,42
KYOTERA,2020,1150,1060,2210,42
KYOTERA,2021,1180,1090,2270,42
KYOTERA,2022,1210,1120,2330,42
KYOTERA,2023,1250,1160,2410,42
KYOTERA,2024,1280,1190,2470,42
KYOTERA,2025,1300,1230,2530,42
KARENGA,2015,120,180,300,42
KARENGA,2016,130,180,310,42
KARENGA,2017,130,180,310,42
KARENGA,2018,140,190,330,42
KARENGA,2019,140,190,330,42
KARENGA,2020,140,200,340,42
KARENGA,2021,150,200,350,42
KARENGA,2022,150,210,360,42
KARENGA,2023,150,210,360,42
KARENGA,2024,160,220,380,42
KARENGA,2025,160,220,380,42
LAMWO,2015,500,560,1060,42
LAMWO,2016,490,570,1060,42
LAMWO,2017,490,570,1060,42
LAMWO,2018,490,580,1070,42
LAMWO,2019,490,600,1090,42
LAMWO,2020,490,610,1100,42
LAMWO,2021,510,630,1140,42
LAMWO,2022,520,660,1180,42
LAMWO,2023,530,680,1210,42
LAMWO,2024,540,690,1230,42
LAMWO,2025,540,720,1260,42
LIRA,2015,1710,1650,3360,42
LIRA,2016,1760,1700,3460,42
LIRA,2017,1810,1750,3560,42
LIRA,2018,1860,1800,3660,42
LIRA,2019,1910,1850,3760,42
LIRA,2020,1960,1900,3860,42
LIRA,2021,2010,1950,3960,42
LIRA,2022,2060,2000,4060,42
LIRA,2023,2110,2050,4160,42
LIRA,2024,2160,2100,4260,42
LIRA,2025,2210,2150,4360,42
LUUKA,2015,700,950,1650,42
LUUKA,2016,700,960,1660,42
LUUKA,2017,710,980,1690,42
LUUKA,2018,710,1000,1710,42
LUUKA,2019,720,1030,1750,42
LUUKA,2020,740,1070,1810,42
LUUKA,2021,760,1100,1860,42
LUUKA,2022,790,1140,1930,42
LUUKA,2023,810,1190,2000,42
LUUKA,2024,830,1230,2060,42
LUUKA,2025,850,1270,2120,42
LUWERO,2015,1700,1700,3400,42
LUWERO,2016,1710,1730,3440,42
LUWERO,2017,1720,1760,3480,42
LUWERO,2018,1740,1800,3540,42
LUWERO,2019,1770,1860,3630,42
LUWERO,2020,1830,1930,3760,42
LUWERO,2021,1890,2010,3900,42
LUWERO,2022,1960,2090,4050,42
LUWERO,2023,2030,2180,4210,42
LUWERO,2024,2100,2260,4360,42
LUWERO,2025,2170,2350,4520,42
LWENGO,2015,940,1110,2050,42
LWENGO,2016,930,1120,2050,42
LWENGO,2017,920,1130,2050,42
LWENGO,2018,920,1140,2060,42
LWENGO,2019,930,1160,2090,42
LWENGO,2020,940,1190,2130,42
LWENGO,2021,960,1220,2180,42
LWENGO,2022,990,1260,2250,42
LWENGO,2023,1000,1300,2300,42
LWENGO,2024,1020,1320,2340,42
LWENGO,2025,1040,1360,2400,42
LYANTONDE,2015,400,320,720,42
LYANTONDE,2016,410,330,740,42
LYANTONDE,2017,420,350,770,42
LYANTONDE,2018,430,360,790,42
LYANTONDE,2019,430,370,800,42
LYANTONDE,2020,440,380,820,42
LYANTONDE,2021,450,390,840,42
LYANTONDE,2022,460,410,870,42
LYANTONDE,2023,490,430,920,42
LYANTONDE,2024,510,450,960,42
LYANTONDE,2025,520,470,990,42
MANAFWA,2015,700,700,1400,42
MANAFWA,2016,720,720,1440,42
MANAFWA,2017,730,730,1460,42
MANAFWA,2018,750,750,1500,42
MANAFWA,2019,770,760,1530,42
MANAFWA,2020,790,780,1570,42
MANAFWA,2021,810,800,1610,42
MANAFWA,2022,820,810,1630,42
MANAFWA,2023,840,830,1670,42
MANAFWA,2024,860,840,1700,42
MANAFWA,2025,880,860,1740,42
MARACHA,2015,670,930,1600,42
MARACHA,2016,680,950,1630,42
MARACHA,2017,700,970,1670,42
MARACHA,2018,710,990,1700,42
MARACHA,2019,730,1000,1730,42
MARACHA,2020,740,1020,1760,42
MARACHA,2021,760,1040,1800,42
MARACHA,2022,770,1060,1830,42
MARACHA,2023,780,1070,1850,42
MARACHA,2024,800,1090,1890,42
MARACHA,2025,810,1110,1920,42
MASAKA,2015,1260,1130,2390,42
MASAKA,2016,1260,1150,2410,42
MASAKA,2017,1260,1180,2440,42
MASAKA,2018,1270,1200,2470,42
MASAKA,2019,1290,1230,2520,42
MASAKA,2020,1330,1280,2610,42
MASAKA,2021,1370,1330,2700,42
MASAKA,2022,1420,1380,2800,42
MASAKA,2023,1460,1440,2900,42
MASAKA,2024,1510,1490,3000,42
MASAKA,2025,1560,1540,3100,42
MASINDI,2015,1400,1130,2530,42
MASINDI,2016,1440,1160,2600,42
MASINDI,2017,1490,1190,2680,42
MASINDI,2018,1530,1220,2750,42
MASINDI,2019,1570,1250,2820,42
MASINDI,2020,1610,1280,2890,42
MASINDI,2021,1660,1320,2980,42
MASINDI,2022,1700,1350,3050,42
MASINDI,2023,1740,1380,3120,42
MASINDI,2024,1790,1410,3200,42
MASINDI,2025,1830,1440,3270,42
MAYUGE,2015,1520,1890,3410,42
MAYUGE,2016,1540,1940,3480,42
MAYUGE,2017,1560,2000,3560,42
MAYUGE,2018,1590,2060,3650,42
MAYUGE,2019,1630,2140,3770,42
MAYUGE,2020,1690,2230,3920,42
MAYUGE,2021,1760,2350,4110,42
MAYUGE,2022,1840,2460,4300,42
MAYUGE,2023,1900,2580,4480,42
MAYUGE,2024,1980,2710,4690,42
MAYUGE,2025,2060,2830,4890,42
MBALE,2015,2040,2330,4370,42
MBALE,2016,2060,2390,4450,42
MBALE,2017,2080,2460,4540,42
MBALE,2018,2120,2560,4680,42
MBALE,2019,2180,2660,4840,42
MBALE,2020,2250,2780,5030,42
MBALE,2021,2350,2930,5280,42
MBALE,2022,2440,3080,5520,42
MBALE,2023,2550,3240,5790,42
MBALE,2024,2640,3410,6050,42
MBALE,2025,2750,3580,6330,42
MBARARA,2015,1540,1650,3190,42
MBARARA,2016,1580,1690,3270,42
MBARARA,2017,1620,1720,3340,42
MBARARA,2018,1650,1760,3410,42
MBARARA,2019,1690,1800,3490,42
MBARARA,2020,1730,1830,3560,42
MBARARA,2021,1760,1870,3630,42
MBARARA,2022,1800,1900,3700,42
MBARARA,2023,1830,1940,3770,42
MBARARA,2024,1870,1970,3840,42
MBARARA,2025,1900,2000,3900,42
MITOOMA,2015,610,760,1370,42
MITOOMA,2016,620,770,1390,42
MITOOMA,2017,630,780,1410,42
MITOOMA,2018,640,780,1420,42
MITOOMA,2019,640,790,1430,42
MITOOMA,2020,650,800,1450,42
MITOOMA,2021,650,800,1450,42
MITOOMA,2022,660,810,1470,42
MITOOMA,2023,670,810,1480,42
MITOOMA,2024,670,820,1490,42
MITOOMA,2025,680,820,1500,42
MITYANA,2015,1300,1240,2540,42
MITYANA,2016,1300,1260,2560,42
MITYANA,2017,1310,1270,2580,42
MITYANA,2018,1320,1300,2620,42
MITYANA,2019,1330,1330,2660,42
MITYANA,2020,1360,1370,2730,42
MITYANA,2021,1400,1420,2820,42
MITYANA,2022,1440,1470,2910,42
MITYANA,2023,1480,1510,2990,42
MITYANA,2024,1520,1570,3090,42
MITYANA,2025,1560,1620,3180,42
MOROTO,2015,270,290,560,42
MOROTO,2016,270,300,570,42
MOROTO,2017,270,300,570,42
MOROTO,2018,270,310,580,42
MOROTO,2019,280,320,600,42
MOROTO,2020,280,330,610,42
MOROTO,2021,290,340,630,42
MOROTO,2022,310,360,670,42
MOROTO,2023,310,380,690,42
MOROTO,2024,320,400,720,42
MOROTO,2025,340,400,740,42
MOYO,2015,380,400,780,42
MOYO,2016,390,410,800,42
MOYO,2017,400,410,810,42
MOYO,2018,410,420,830,42
MOYO,2019,420,430,850,42
MOYO,2020,430,440,870,42
MOYO,2021,440,450,890,42
MOYO,2022,450,460,910,42
MOYO,2023,460,470,930,42
MOYO,2024,470,480,950,42
MOYO,2025,480,480,960,42
MPIGI,2015,930,970,1900,42
MPIGI,2016,940,990,1930,42
MPIGI,2017,940,1010,1950,42
MPIGI,2018,950,1030,1980,42
MPIGI,2019,980,1060,2040,42
MPIGI,2020,1000,1110,2110,42
MPIGI,2021,1040,1150,2190,42
MPIGI,2022,1070,1200,2270,42
MPIGI,2023,1110,1240,2350,42
MPIGI,2024,1140,1300,2440,42
MPIGI,2025,1180,1350,2530,42
MUBENDE,2015,1610,1580,3190,42
MUBENDE,2016,1660,1660,3320,42
MUBENDE,2017,1720,1740,3460,42
MUBENDE,2018,1790,1820,3610,42
MUBENDE,2019,1870,1940,3810,42
MUBENDE,2020,1980,2060,4040,42
MUBENDE,2021,2110,2210,4320,42
MUBENDE,2022,2240,2370,4610,42
MUBENDE,2023,2390,2530,4920,42
MUBENDE,2024,2530,2700,5230,42
MUBENDE,2025,2690,2890,5580,42
MUKONO,2015,2290,2480,4770,42
MUKONO,2016,2310,2550,4860,42
MUKONO,2017,2330,2610,4940,42
MUKONO,2018,2360,2700,5060,42
MUKONO,2019,2420,2790,5210,42
MUKONO,2020,2490,2910,5400,42
MUKONO,2021,2580,3050,5630,42
MUKONO,2022,2680,3200,5880,42
MUKONO,2023,2780,3360,6140,42
MUKONO,2024,2880,3510,6390,42
MUKONO,2025,2980,3660,6640,42
MADI OKOLLO,2015,590,700,1290,42
MADI OKOLLO,2016,600,720,1320,42
MADI OKOLLO,2017,620,730,1350,42
MADI OKOLLO,2018,640,750,1390,42
MADI OKOLLO,2019,660,770,1430,42
MADI OKOLLO,2020,680,790,1470,42
MADI OKOLLO,2021,690,810,1500,42
MADI OKOLLO,2022,710,830,1540,42
MADI OKOLLO,2023,730,850,1580,42
MADI OKOLLO,2024,750,870,1620,42
MADI OKOLLO,2025,760,890,1650,42
NABILATUK,2015,140,160,300,42
NABILATUK,2016,140,160,300,42
NABILATUK,2017,140,170,310,42
NABILATUK,2018,150,180,330,42
NABILATUK,2019,160,190,350,42
NABILATUK,2020,170,190,360,42
NABILATUK,2021,180,210,390,42
NABILATUK,2022,190,220,410,42
NABILATUK,2023,200,240,440,42
NABILATUK,2024,210,250,460,42
NABILATUK,2025,230,270,500,42
NAKAPIRIPIRIT,2015,230,270,500,42
NAKAPIRIPIRIT,2016,240,280,520,42
NAKAPIRIPIRIT,2017,240,290,530,42
NAKAPIRIPIRIT,2018,250,300,550,42
NAKAPIRIPIRIT,2019,260,320,580,42
NAKAPIRIPIRIT,2020,270,330,600,42
NAKAPIRIPIRIT,2021,290,350,640,42
NAKAPIRIPIRIT,2022,310,380,690,42
NAKAPIRIPIRIT,2023,320,400,720,42
NAKAPIRIPIRIT,2024,330,430,760,42
NAKAPIRIPIRIT,2025,360,450,810,42
NAKASEKE,2015,1100,720,1820,42
NAKASEKE,2016,1140,740,1880,42
NAKASEKE,2017,1180,760,1940,42
NAKASEKE,2018,1220,780,2000,42
NAKASEKE,2019,1270,790,2060,42
NAKASEKE,2020,1310,810,2120,42
NAKASEKE,2021,1360,830,2190,42
NAKASEKE,2022,1400,850,2250,42
NAKASEKE,2023,1450,860,2310,42
NAKASEKE,2024,1490,880,2370,42
NAKASEKE,2025,1540,900,2440,42
NAKASONGOLA,2015,760,720,1480,42
NAKASONGOLA,2016,770,720,1490,42
NAKASONGOLA,2017,780,740,1520,42
NAKASONGOLA,2018,800,760,1560,42
NAKASONGOLA,2019,820,790,1610,42
NAKASONGOLA,2020,850,820,1670,42
NAKASONGOLA,2021,880,870,1750,42
NAKASONGOLA,2022,920,900,1820,42
NAKASONGOLA,2023,960,950,1910,42
NAKASONGOLA,2024,1000,990,1990,42
NAKASONGOLA,2025,1040,1030,2070,42
NAMAYINGO,2015,850,900,1750,42
NAMAYINGO,2016,850,900,1750,42
NAMAYINGO,2017,850,920,1770,42
NAMAYINGO,2018,860,930,1790,42
NAMAYINGO,2019,870,950,1820,42
NAMAYINGO,2020,890,970,1860,42
NAMAYINGO,2021,910,1010,1920,42
NAMAYINGO,2022,940,1050,1990,42
NAMAYINGO,2023,970,1080,2050,42
NAMAYINGO,2024,990,1110,2100,42
NAMAYINGO,2025,1020,1150,2170,42
NAMISINDWA,2015,830,890,1720,42
NAMISINDWA,2016,850,910,1760,42
NAMISINDWA,2017,880,940,1820,42
NAMISINDWA,2018,900,960,1860,42
NAMISINDWA,2019,920,980,1900,42
NAMISINDWA,2020,950,1000,1950,42
NAMISINDWA,2021,970,1020,1990,42
NAMISINDWA,2022,1000,1040,2040,42
NAMISINDWA,2023,1020,1070,2090,42
NAMISINDWA,2024,1040,1090,2130,42
NAMISINDWA,2025,1070,1110,2180,42
NAMUTUMBA,2015,800,960,1760,42
NAMUTUMBA,2016,810,980,1790,42
NAMUTUMBA,2017,820,1010,1830,42
NAMUTUMBA,2018,840,1040,1880,42
NAMUTUMBA,2019,870,1080,1950,42
NAMUTUMBA,2020,900,1140,2040,42
NAMUTUMBA,2021,950,1190,2140,42
NAMUTUMBA,2022,990,1260,2250,42
NAMUTUMBA,2023,1030,1320,2350,42
NAMUTUMBA,2024,1070,1390,2460,42
NAMUTUMBA,2025,1130,1450,2580,42
NAPAK,2015,300,450,750,42
NAPAK,2016,300,450,750,42
NAPAK,2017,300,450,750,42
NAPAK,2018,300,470,770,42
NAPAK,2019,300,480,780,42
NAPAK,2020,310,500,810,42
NAPAK,2021,310,520,830,42
NAPAK,2022,330,540,870,42
NAPAK,2023,330,560,890,42
NAPAK,2024,340,580,920,42
NAPAK,2025,350,610,960,42
NEBBI,2015,910,1100,2010,42
NEBBI,2016,940,1130,2070,42
NEBBI,2017,970,1170,2140,42
NEBBI,2018,1000,1200,2200,42
NEBBI,2019,1030,1230,2260,42
NEBBI,2020,1060,1270,2330,42
NEBBI,2021,1090,1300,2390,42
NEBBI,2022,1120,1330,2450,42
NEBBI,2023,1150,1370,2520,42
NEBBI,2024,1180,1400,2580,42
NEBBI,2025,1210,1430,2640,42
NGORA,2015,470,540,1010,42
NGORA,2016,470,560,1030,42
NGORA,2017,470,560,1030,42
NGORA,2018,480,570,1050,42
NGORA,2019,490,600,1090,42
NGORA,2020,500,620,1120,42
NGORA,2021,530,650,1180,42
NGORA,2022,540,680,1220,42
NGORA,2023,570,710,1280,42
NGORA,2024,580,740,1320,42
NGORA,2025,610,780,1390,42
NTOROKO,2015,270,220,490,42
NTOROKO,2016,270,230,500,42
NTOROKO,2017,280,230,510,42
NTOROKO,2018,270,240,510,42
NTOROKO,2019,280,240,520,42
NTOROKO,2020,290,240,530,42
NTOROKO,2021,300,260,560,42
NTOROKO,2022,310,260,570,42
NTOROKO,2023,320,280,600,42
NTOROKO,2024,330,290,620,42
NTOROKO,2025,350,290,640,42
NTUNGAMO,2015,1830,2170,4000,42
NTUNGAMO,2016,1870,2210,4080,42
NTUNGAMO,2017,1910,2250,4160,42
NTUNGAMO,2018,1950,2290,4240,42
NTUNGAMO,2019,1990,2330,4320,42
NTUNGAMO,2020,2030,2370,4400,42
NTUNGAMO,2021,2070,2410,4480,42
NTUNGAMO,2022,2100,2450,4550,42
NTUNGAMO,2023,2140,2490,4630,42
NTUNGAMO,2024,2180,2520,4700,42
NTUNGAMO,2025,2210,2560,4770,42
NWOYA,2015,600,590,1190,42
NWOYA,2016,670,650,1320,42
NWOYA,2017,740,720,1460,42
NWOYA,2018,810,790,1600,42
NWOYA,2019,900,870,1770,42
NWOYA,2020,990,960,1950,42
NWOYA,2021,1090,1050,2140,42
NWOYA,2022,1200,1160,2360,42
NWOYA,2023,1320,1270,2590,42
NWOYA,2024,1450,1400,2850,42
NWOYA,2025,1600,1530,3130,42
OBONGI,2015,150,160,310,42
OBONGI,2016,150,160,310,42
OBONGI,2017,150,170,320,42
OBONGI,2018,150,170,320,42
OBONGI,2019,150,170,320,42
OBONGI,2020,160,170,330,42
OBONGI,2021,160,190,350,42
OBONGI,2022,170,190,360,42
OBONGI,2023,170,210,380,42
OBONGI,2024,180,210,390,42
OBONGI,2025,190,210,400,42
OMORO,2015,600,710,1310,42
OMORO,2016,610,730,1340,42
OMORO,2017,630,750,1380,42
OMORO,2018,640,780,1420,42
OMORO,2019,660,820,1480,42
OMORO,2020,680,850,1530,42
OMORO,2021,710,900,1610,42
OMORO,2022,750,950,1700,42
OMORO,2023,780,1000,1780,42
OMORO,2024,820,1060,1880,42
OMORO,2025,850,1100,1950,42
OTUKE,2015,400,410,810,42
OTUKE,2016,420,430,850,42
OTUKE,2017,440,450,890,42
OTUKE,2018,460,470,930,42
OTUKE,2019,480,490,970,42
OTUKE,2020,500,510,1010,42
OTUKE,2021,520,530,1050,42
OTUKE,2022,540,550,1090,42
OTUKE,2023,560,570,1130,42
OTUKE,2024,590,590,1180,42
OTUKE,2025,610,610,1220,42
OYAM,2015,1380,1700,3080,42
OYAM,2016,1430,1750,3180,42
OYAM,2017,1470,1800,3270,42
OYAM,2018,1510,1860,3370,42
OYAM,2019,1560,1910,3470,42
OYAM,2020,1600,1960,3560,42
OYAM,2021,1650,2020,3670,42
OYAM,2022,1700,2070,3770,42
OYAM,2023,1740,2120,3860,42
OYAM,2024,1790,2180,3970,42
OYAM,2025,1830,2230,4060,42
PADER,2015,650,750,1400,42
PADER,2016,650,750,1400,42
PADER,2017,640,770,1410,42
PADER,2018,650,780,1430,42
PADER,2019,660,810,1470,42
PADER,2020,670,830,1500,42
PADER,2021,690,860,1550,42
PADER,2022,710,900,1610,42
PADER,2023,730,930,1660,42
PADER,2024,750,960,1710,42
PADER,2025,770,1000,1770,42
PAKWACH,2015,690,700,1390,42
PAKWACH,2016,720,730,1450,42
PAKWACH,2017,750,750,1500,42
PAKWACH,2018,780,780,1560,42
PAKWACH,2019,810,810,1620,42
PAKWACH,2020,840,840,1680,42
PAKWACH,2021,880,870,1750,42
PAKWACH,2022,910,900,1810,42
PAKWACH,2023,940,930,1870,42
PAKWACH,2024,980,960,1940,42
PAKWACH,2025,1010,990,2000,42
PALLISA,2015,860,1010,1870,42
PALLISA,2016,880,1040,1920,42
PALLISA,2017,900,1090,1990,42
PALLISA,2018,940,1130,2070,42
PALLISA,2019,970,1190,2160,42
PALLISA,2020,1020,1260,2280,42
PALLISA,2021,1070,1340,2410,42
PALLISA,2022,1130,1420,2550,42
PALLISA,2023,1200,1510,2710,42
PALLISA,2024,1260,1600,2860,42
PALLISA,2025,1330,1700,3030,42
RAKAI,2015,1120,1230,2350,42
RAKAI,2016,1120,1250,2370,42
RAKAI,2017,1140,1270,2410,42
RAKAI,2018,1150,1310,2460,42
RAKAI,2019,1170,1350,2520,42
RAKAI,2020,1210,1400,2610,42
RAKAI,2021,1250,1460,2710,42
RAKAI,2022,1290,1520,2810,42
RAKAI,2023,1350,1580,2930,42
RAKAI,2024,1390,1640,3030,42
RAKAI,2025,1440,1710,3150,42
RUBANDA,2015,670,880,1550,42
RUBANDA,2016,680,880,1560,42
RUBANDA,2017,690,890,1580,42
RUBANDA,2018,700,900,1600,42
RUBANDA,2019,710,900,1610,42
RUBANDA,2020,720,910,1630,42
RUBANDA,2021,720,910,1630,42
RUBANDA,2022,730,920,1650,42
RUBANDA,2023,740,920,1660,42
RUBANDA,2024,750,930,1680,42
RUBANDA,2025,750,930,1680,42
RUBIRIZI,2015,520,600,1120,42
RUBIRIZI,2016,530,610,1140,42
RUBIRIZI,2017,540,620,1160,42
RUBIRIZI,2018,550,630,1180,42
RUBIRIZI,2019,560,640,1200,42
RUBIRIZI,2020,570,650,1220,42
RUBIRIZI,2021,580,660,1240,42
RUBIRIZI,2022,590,680,1270,42
RUBIRIZI,2023,600,690,1290,42
RUBIRIZI,2024,610,700,1310,42
RUBIRIZI,2025,620,710,1330,42
RUKIGA,2015,410,460,870,42
RUKIGA,2016,410,460,870,42
RUKIGA,2017,420,470,890,42
RUKIGA,2018,420,470,890,42
RUKIGA,2019,420,470,890,42
RUKIGA,2020,430,480,910,42
RUKIGA,2021,430,480,910,42
RUKIGA,2022,430,480,910,42
RUKIGA,2023,440,480,920,42
RUKIGA,2024,440,480,920,42
RUKIGA,2025,440,480,920,42
RUKUNGIRI,2015,1190,1540,2730,42
RUKUNGIRI,2016,1210,1560,2770,42
RUKUNGIRI,2017,1220,1570,2790,42
RUKUNGIRI,2018,1240,1590,2830,42
RUKUNGIRI,2019,1250,1600,2850,42
RUKUNGIRI,2020,1260,1620,2880,42
RUKUNGIRI,2021,1280,1630,2910,42
RUKUNGIRI,2022,1290,1640,2930,42
RUKUNGIRI,2023,1300,1650,2950,42
RUKUNGIRI,2024,1310,1660,2970,42
RUKUNGIRI,2025,1320,1670,2990,42
RWAMPARA,2015,520,590,1110,42
RWAMPARA,2016,530,600,1130,42
RWAMPARA,2017,550,610,1160,42
RWAMPARA,2018,560,620,1180,42
RWAMPARA,2019,570,640,1210,42
RWAMPARA,2020,580,650,1230,42
RWAMPARA,2021,590,660,1250,42
RWAMPARA,2022,610,680,1290,42
RWAMPARA,2023,620,690,1310,42
RWAMPARA,2024,630,700,1330,42
RWAMPARA,2025,640,710,1350,42
SERERE,2015,950,1030,1980,42
SERERE,2016,970,1060,2030,42
SERERE,2017,980,1100,2080,42
SERERE,2018,1020,1140,2160,42
SERERE,2019,1050,1200,2250,42
SERERE,2020,1090,1260,2350,42
SERERE,2021,1150,1340,2490,42
SERERE,2022,1210,1420,2630,42
SERERE,2023,1280,1490,2770,42
SERERE,2024,1340,1580,2920,42
SERERE,2025,1410,1660,3070,42
SHEEMA,2015,860,920,1780,42
SHEEMA,2016,870,930,1800,42
SHEEMA,2017,880,940,1820,42
SHEEMA,2018,890,950,1840,42
SHEEMA,2019,900,950,1850,42
SHEEMA,2020,910,960,1870,42
SHEEMA,2021,920,970,1890,42
SHEEMA,2022,930,980,1910,42
SHEEMA,2023,940,990,1930,42
SHEEMA,2024,950,990,1940,42
SHEEMA,2025,950,1000,1950,42
SIRONKO,2015,1080,1060,2140,42
SIRONKO,2016,1110,1080,2190,42
SIRONKO,2017,1140,1110,2250,42
SIRONKO,2018,1160,1130,2290,42
SIRONKO,2019,1190,1150,2340,42
SIRONKO,2020,1220,1170,2390,42
SIRONKO,2021,1240,1190,2430,42
SIRONKO,2022,1270,1210,2480,42
SIRONKO,2023,1290,1230,2520,42
SIRONKO,2024,1320,1250,2570,42
SIRONKO,2025,1340,1270,2610,42
SOROTI,2015,950,1030,1980,42
SOROTI,2016,970,1060,2030,42
SOROTI,2017,980,1090,2070,42
SOROTI,2018,1010,1130,2140,42
SOROTI,2019,1040,1180,2220,42
SOROTI,2020,1080,1240,2320,42
SOROTI,2021,1130,1300,2430,42
SOROTI,2022,1180,1380,2560,42
SOROTI,2023,1240,1450,2690,42
SOROTI,2024,1300,1520,2820,42
SOROTI,2025,1350,1600,2950,42
SSEMBABULE,2015,950,950,1900,42
SSEMBABULE,2016,960,970,1930,42
SSEMBABULE,2017,980,1000,1980,42
SSEMBABULE,2018,990,1020,2010,42
SSEMBABULE,2019,1010,1060,2070,42
SSEMBABULE,2020,1040,1100,2140,42
SSEMBABULE,2021,1090,1150,2240,42
SSEMBABULE,2022,1130,1210,2340,42
SSEMBABULE,2023,1170,1250,2420,42
SSEMBABULE,2024,1210,1310,2520,42
SSEMBABULE,2025,1270,1370,2640,42
TORORO,2015,2090,2350,4440,42
TORORO,2016,2150,2410,4560,42
TORORO,2017,2210,2460,4670,42
TORORO,2018,2260,2530,4790,42
TORORO,2019,2320,2590,4910,42
TORORO,2020,2380,2650,5030,42
TORORO,2021,2440,2710,5150,42
TORORO,2022,2500,2770,5270,42
TORORO,2023,2550,2830,5380,42
TORORO,2024,2610,2890,5500,42
TORORO,2025,2660,2950,5610,42
WAKISO,2015,8930,7400,16330,42
WAKISO,2016,9530,7900,17430,42
WAKISO,2017,10170,8440,18610,42
WAKISO,2018,10840,9010,19850,42
WAKISO,2019,11560,9620,21180,42
WAKISO,2020,12320,10260,22580,42
WAKISO,2021,13110,10940,24050,42
WAKISO,2022,13950,11660,25610,42
WAKISO,2023,14830,12410,27240,42
WAKISO,2024,15760,13200,28960,42
WAKISO,2025,16730,14040,30770,42
YUMBE,2015,1380,1350,2730,42
YUMBE,2016,1420,1430,2850,42
YUMBE,2017,1470,1510,2980,42
YUMBE,2018,1520,1610,3130,42
YUMBE,2019,1590,1710,3300,42
YUMBE,2020,1680,1840,3520,42
YUMBE,2021,1790,1980,3770,42
YUMBE,2022,1900,2140,4040,42
YUMBE,2023,2010,2310,4320,42
YUMBE,2024,2130,2480,4610,42
YUMBE,2025,2260,2660,4920,42
ZOMBO,2015,990,1190,2180,42
ZOMBO,2016,1020,1230,2250,42
ZOMBO,2017,1050,1260,2310,42
ZOMBO,2018,1090,1300,2390,42
ZOMBO,2019,1120,1330,2450,42
ZOMBO,2020,1150,1370,2520,42
ZOMBO,2021,1190,1400,2590,42
ZOMBO,2022,1220,1440,2660,42
ZOMBO,2023,1250,1470,2720,42
ZOMBO,2024,1290,1510,2800,42
ZOMBO,2025,1320,1540,2860,42
ABIM,2015,350,350,700,43
ABIM,2016,360,380,740,43
ABIM,2017,380,410,790,43
ABIM,2018,390,420,810,43
ABIM,2019,410,450,860,43
ABIM,2020,440,480,920,43
ABIM,2021,480,520,1000,43
ABIM,2022,510,560,1070,43
ABIM,2023,550,610,1160,43
ABIM,2024,580,660,1240,43
ABIM,2025,630,720,1350,43
ADJUMANI,2015,480,500,980,43
ADJUMANI,2016,480,500,980,43
ADJUMANI,2017,480,510,990,43
ADJUMANI,2018,490,510,1000,43
ADJUMANI,2019,490,520,1010,43
ADJUMANI,2020,490,520,1010,43
ADJUMANI,2021,500,520,1020,43
ADJUMANI,2022,500,530,1030,43
ADJUMANI,2023,500,530,1030,43
ADJUMANI,2024,500,540,1040,43
ADJUMANI,2025,500,540,1040,43
AGAGO,2015,650,720,1370,43
AGAGO,2016,660,730,1390,43
AGAGO,2017,670,740,1410,43
AGAGO,2018,680,750,1430,43
AGAGO,2019,690,770,1460,43
AGAGO,2020,700,780,1480,43
AGAGO,2021,710,790,1500,43
AGAGO,2022,720,800,1520,43
AGAGO,2023,740,810,1550,43
AGAGO,2024,740,830,1570,43
AGAGO,2025,750,840,1590,43
ALEBTONG,2015,780,880,1660,43
ALEBTONG,2016,790,920,1710,43
ALEBTONG,2017,800,940,1740,43
ALEBTONG,2018,810,970,1780,43
ALEBTONG,2019,830,1000,1830,43
ALEBTONG,2020,850,1030,1880,43
ALEBTONG,2021,880,1070,1950,43
ALEBTONG,2022,900,1120,2020,43
ALEBTONG,2023,940,1170,2110,43
ALEBTONG,2024,970,1230,2200,43
ALEBTONG,2025,1010,1280,2290,43
AMOLATAR,2015,600,650,1250,43
AMOLATAR,2016,630,670,1300,43
AMOLATAR,2017,630,680,1310,43
AMOLATAR,2018,630,700,1330,43
AMOLATAR,2019,640,720,1360,43
AMOLATAR,2020,650,740,1390,43
AMOLATAR,2021,670,770,1440,43
AMOLATAR,2022,700,800,1500,43
AMOLATAR,2023,720,830,1550,43
AMOLATAR,2024,750,870,1620,43
AMOLATAR,2025,780,920,1700,43
AMUDAT,2015,270,200,470,43
AMUDAT,2016,280,210,490,43
AMUDAT,2017,290,220,510,43
AMUDAT,2018,300,230,530,43
AMUDAT,2019,300,230,530,43
AMUDAT,2020,320,250,570,43
AMUDAT,2021,330,270,600,43
AMUDAT,2022,350,290,640,43
AMUDAT,2023,360,310,670,43
AMUDAT,2024,380,330,710,43
AMUDAT,2025,400,350,750,43
AMURIA,2015,620,650,1270,43
AMURIA,2016,630,670,1300,43
AMURIA,2017,640,700,1340,43
AMURIA,2018,650,720,1370,43
AMURIA,2019,670,750,1420,43
AMURIA,2020,690,770,1460,43
AMURIA,2021,720,810,1530,43
AMURIA,2022,750,860,1610,43
AMURIA,2023,800,910,1710,43
AMURIA,2024,840,960,1800,43
AMURIA,2025,870,1010,1880,43
AMURU,2015,690,770,1460,43
AMURU,2016,700,790,1490,43
AMURU,2017,710,820,1530,43
AMURU,2018,710,830,1540,43
AMURU,2019,730,860,1590,43
AMURU,2020,740,900,1640,43
AMURU,2021,770,930,1700,43
AMURU,2022,790,970,1760,43
AMURU,2023,820,1010,1830,43
AMURU,2024,860,1060,1920,43
AMURU,2025,890,1100,1990,43
APAC,2015,600,530,1130,43
APAC,2016,620,550,1170,43
APAC,2017,650,570,1220,43
APAC,2018,670,590,1260,43
APAC,2019,690,610,1300,43
APAC,2020,720,630,1350,43
APAC,2021,740,650,1390,43
APAC,2022,770,670,1440,43
APAC,2023,790,690,1480,43
APAC,2024,820,710,1530,43
APAC,2025,840,730,1570,43
ARUA,2015,1560,1730,3290,43
ARUA,2016,1600,1780,3380,43
ARUA,2017,1650,1830,3480,43
ARUA,2018,1700,1870,3570,43
ARUA,2019,1740,1920,3660,43
ARUA,2020,1790,1970,3760,43
ARUA,2021,1840,2020,3860,43
ARUA,2022,1890,2070,3960,43
ARUA,2023,1940,2120,4060,43
ARUA,2024,1980,2170,4150,43
ARUA,2025,2030,2220,4250,43
BUDAKA,2015,660,830,1490,43
BUDAKA,2016,680,860,1540,43
BUDAKA,2017,690,890,1580,43
BUDAKA,2018,700,910,1610,43
BUDAKA,2019,720,960,1680,43
BUDAKA,2020,740,990,1730,43
BUDAKA,2021,770,1040,1810,43
BUDAKA,2022,800,1090,1890,43
BUDAKA,2023,840,1150,1990,43
BUDAKA,2024,890,1210,2100,43
BUDAKA,2025,920,1270,2190,43
BUDUDA,2015,630,630,1260,43
BUDUDA,2016,660,670,1330,43
BUDUDA,2017,680,700,1380,43
BUDUDA,2018,690,720,1410,43
BUDUDA,2019,720,750,1470,43
BUDUDA,2020,750,800,1550,43
BUDUDA,2021,780,840,1620,43
BUDUDA,2022,830,900,1730,43
BUDUDA,2023,870,950,1820,43
BUDUDA,2024,920,1020,1940,43
BUDUDA,2025,980,1070,2050,43
BUGIRI,2015,1090,1370,2460,43
BUGIRI,2016,1140,1440,2580,43
BUGIRI,2017,1150,1490,2640,43
BUGIRI,2018,1180,1540,2720,43
BUGIRI,2019,1220,1600,2820,43
BUGIRI,2020,1260,1680,2940,43
BUGIRI,2021,1320,1770,3090,43
BUGIRI,2022,1380,1870,3250,43
BUGIRI,2023,1460,1970,3430,43
BUGIRI,2024,1530,2090,3620,43
BUGIRI,2025,1620,2210,3830,43
BUGWERI,2015,460,610,1070,43
BUGWERI,2016,470,630,1100,43
BUGWERI,2017,480,660,1140,43
BUGWERI,2018,480,670,1150,43
BUGWERI,2019,490,680,1170,43
BUGWERI,2020,500,700,1200,43
BUGWERI,2021,510,730,1240,43
BUGWERI,2022,530,770,1300,43
BUGWERI,2023,550,800,1350,43
BUGWERI,2024,570,840,1410,43
BUGWERI,2025,590,870,1460,43
BUHWEJU,2015,330,390,720,43
BUHWEJU,2016,340,400,740,43
BUHWEJU,2017,350,420,770,43
BUHWEJU,2018,360,430,790,43
BUHWEJU,2019,370,440,810,43
BUHWEJU,2020,390,450,840,43
BUHWEJU,2021,400,470,870,43
BUHWEJU,2022,410,480,890,43
BUHWEJU,2023,420,490,910,43
BUHWEJU,2024,430,510,940,43
BUHWEJU,2025,440,520,960,43
BUIKWE,2015,1340,1370,2710,43
BUIKWE,2016,1370,1410,2780,43
BUIKWE,2017,1370,1430,2800,43
BUIKWE,2018,1370,1460,2830,43
BUIKWE,2019,1380,1490,2870,43
BUIKWE,2020,1410,1530,2940,43
BUIKWE,2021,1440,1580,3020,43
BUIKWE,2022,1480,1650,3130,43
BUIKWE,2023,1520,1710,3230,43
BUIKWE,2024,1570,1780,3350,43
BUIKWE,2025,1620,1830,3450,43
BUKEDEA,2015,690,760,1450,43
BUKEDEA,2016,710,790,1500,43
BUKEDEA,2017,740,820,1560,43
BUKEDEA,2018,750,860,1610,43
BUKEDEA,2019,780,890,1670,43
BUKEDEA,2020,810,940,1750,43
BUKEDEA,2021,850,1000,1850,43
BUKEDEA,2022,900,1040,1940,43
BUKEDEA,2023,950,1110,2060,43
BUKEDEA,2024,1000,1180,2180,43
BUKEDEA,2025,1050,1250,2300,43
BUKOMANSIMBI,2015,580,600,1180,43
BUKOMANSIMBI,2016,590,600,1190,43
BUKOMANSIMBI,2017,580,600,1180,43
BUKOMANSIMBI,2018,570,600,1170,43
BUKOMANSIMBI,2019,570,600,1170,43
BUKOMANSIMBI,2020,570,620,1190,43
BUKOMANSIMBI,2021,570,630,1200,43
BUKOMANSIMBI,2022,590,640,1230,43
BUKOMANSIMBI,2023,600,660,1260,43
BUKOMANSIMBI,2024,610,670,1280,43
BUKOMANSIMBI,2025,620,690,1310,43
BUKWO,2015,210,210,420,43
BUKWO,2016,220,220,440,43
BUKWO,2017,230,230,460,43
BUKWO,2018,240,240,480,43
BUKWO,2019,260,250,510,43
BUKWO,2020,270,260,530,43
BUKWO,2021,280,280,560,43
BUKWO,2022,300,290,590,43
BUKWO,2023,310,300,610,43
BUKWO,2024,330,320,650,43
BUKWO,2025,340,330,670,43
BULAMBULI,2015,640,580,1220,43
BULAMBULI,2016,680,620,1300,43
BULAMBULI,2017,690,660,1350,43
BULAMBULI,2018,710,680,1390,43
BULAMBULI,2019,740,710,1450,43
BULAMBULI,2020,780,760,1540,43
BULAMBULI,2021,820,800,1620,43
BULAMBULI,2022,860,860,1720,43
BULAMBULI,2023,910,920,1830,43
BULAMBULI,2024,970,990,1960,43
BULAMBULI,2025,1030,1040,2070,43
BULIISA,2015,320,260,580,43
BULIISA,2016,330,270,600,43
BULIISA,2017,350,290,640,43
BULIISA,2018,370,300,670,43
BULIISA,2019,390,310,700,43
BULIISA,2020,410,320,730,43
BULIISA,2021,430,340,770,43
BULIISA,2022,450,350,800,43
BULIISA,2023,480,370,850,43
BULIISA,2024,500,380,880,43
BULIISA,2025,520,400,920,43
BUNDIBUGYO,2015,680,690,1370,43
BUNDIBUGYO,2016,690,730,1420,43
BUNDIBUGYO,2017,700,740,1440,43
BUNDIBUGYO,2018,710,760,1470,43
BUNDIBUGYO,2019,730,780,1510,43
BUNDIBUGYO,2020,740,800,1540,43
BUNDIBUGYO,2021,770,840,1610,43
BUNDIBUGYO,2022,800,870,1670,43
BUNDIBUGYO,2023,820,920,1740,43
BUNDIBUGYO,2024,860,960,1820,43
BUNDIBUGYO,2025,900,1010,1910,43
BUNYANGABU,2015,590,630,1220,43
BUNYANGABU,2016,610,640,1250,43
BUNYANGABU,2017,610,660,1270,43
BUNYANGABU,2018,620,670,1290,43
BUNYANGABU,2019,620,680,1300,43
BUNYANGABU,2020,640,700,1340,43
BUNYANGABU,2021,660,730,1390,43
BUNYANGABU,2022,680,760,1440,43
BUNYANGABU,2023,700,790,1490,43
BUNYANGABU,2024,730,820,1550,43
BUNYANGABU,2025,760,850,1610,43
BUSHENYI,2015,700,710,1410,43
BUSHENYI,2016,710,720,1430,43
BUSHENYI,2017,720,720,1440,43
BUSHENYI,2018,730,730,1460,43
BUSHENYI,2019,740,730,1470,43
BUSHENYI,2020,740,740,1480,43
BUSHENYI,2021,750,740,1490,43
BUSHENYI,2022,760,750,1510,43
BUSHENYI,2023,770,750,1520,43
BUSHENYI,2024,770,760,1530,43
BUSHENYI,2025,780,760,1540,43
BUSIA,2015,1000,990,1990,43
BUSIA,2016,1030,1030,2060,43
BUSIA,2017,1040,1050,2090,43
BUSIA,2018,1060,1080,2140,43
BUSIA,2019,1080,1110,2190,43
BUSIA,2020,1100,1160,2260,43
BUSIA,2021,1150,1210,2360,43
BUSIA,2022,1200,1260,2460,43
BUSIA,2023,1250,1320,2570,43
BUSIA,2024,1300,1370,2670,43
BUSIA,2025,1350,1450,2800,43
BUTALEJA,2015,820,920,1740,43
BUTALEJA,2016,860,960,1820,43
BUTALEJA,2017,870,1000,1870,43
BUTALEJA,2018,890,1020,1910,43
BUTALEJA,2019,910,1070,1980,43
BUTALEJA,2020,930,1120,2050,43
BUTALEJA,2021,970,1160,2130,43
BUTALEJA,2022,1020,1230,2250,43
BUTALEJA,2023,1070,1300,2370,43
BUTALEJA,2024,1130,1370,2500,43
BUTALEJA,2025,1180,1430,2610,43
BUTAMBALA,2015,310,370,680,43
BUTAMBALA,2016,310,380,690,43
BUTAMBALA,2017,300,380,680,43
BUTAMBALA,2018,310,380,690,43
BUTAMBALA,2019,300,380,680,43
BUTAMBALA,2020,300,400,700,43
BUTAMBALA,2021,320,410,730,43
BUTAMBALA,2022,320,410,730,43
BUTAMBALA,2023,320,420,740,43
BUTAMBALA,2024,340,430,770,43
BUTAMBALA,2025,350,460,810,43
BUTEBO,2015,350,450,800,43
BUTEBO,2016,340,450,790,43
BUTEBO,2017,350,460,810,43
BUTEBO,2018,340,460,800,43
BUTEBO,2019,340,480,820,43
BUTEBO,2020,350,480,830,43
BUTEBO,2021,350,490,840,43
BUTEBO,2022,370,520,890,43
BUTEBO,2023,370,530,900,43
BUTEBO,2024,380,550,930,43
BUTEBO,2025,400,560,960,43
BUVUMA,2015,390,260,650,43
BUVUMA,2016,410,280,690,43
BUVUMA,2017,440,300,740,43
BUVUMA,2018,470,320,790,43
BUVUMA,2019,490,340,830,43
BUVUMA,2020,520,360,880,43
BUVUMA,2021,560,390,950,43
BUVUMA,2022,590,410,1000,43
BUVUMA,2023,620,440,1060,43
BUVUMA,2024,660,470,1130,43
BUVUMA,2025,690,500,1190,43
BUYENDE,2015,850,1020,1870,43
BUYENDE,2016,890,1070,1960,43
BUYENDE,2017,920,1110,2030,43
BUYENDE,2018,940,1160,2100,43
BUYENDE,2019,960,1200,2160,43
BUYENDE,2020,1010,1270,2280,43
BUYENDE,2021,1060,1350,2410,43
BUYENDE,2022,1110,1420,2530,43
BUYENDE,2023,1170,1510,2680,43
BUYENDE,2024,1240,1600,2840,43
BUYENDE,2025,1310,1690,3000,43
DOKOLO,2015,490,480,970,43
DOKOLO,2016,510,490,1000,43
DOKOLO,2017,520,510,1030,43
DOKOLO,2018,540,520,1060,43
DOKOLO,2019,560,530,1090,43
DOKOLO,2020,570,550,1120,43
DOKOLO,2021,590,560,1150,43
DOKOLO,2022,600,580,1180,43
DOKOLO,2023,620,590,1210,43
DOKOLO,2024,640,600,1240,43
DOKOLO,2025,650,620,1270,43
GOMBA,2015,660,670,1330,43
GOMBA,2016,660,680,1340,43
GOMBA,2017,660,680,1340,43
GOMBA,2018,660,700,1360,43
GOMBA,2019,670,700,1370,43
GOMBA,2020,680,720,1400,43
GOMBA,2021,690,730,1420,43
GOMBA,2022,720,760,1480,43
GOMBA,2023,720,770,1490,43
GOMBA,2024,750,810,1560,43
GOMBA,2025,770,820,1590,43
GULU,2015,840,790,1630,43
GULU,2016,870,810,1680,43
GULU,2017,890,830,1720,43
GULU,2018,920,860,1780,43
GULU,2019,950,880,1830,43
GULU,2020,970,900,1870,43
GULU,2021,1000,930,1930,43
GULU,2022,1030,950,1980,43
GULU,2023,1060,980,2040,43
GULU,2024,1080,1000,2080,43
GULU,2025,1110,1030,2140,43
HOIMA,2015,990,870,1860,43
HOIMA,2016,1030,900,1930,43
HOIMA,2017,1070,930,2000,43
HOIMA,2018,1110,960,2070,43
HOIMA,2019,1150,990,2140,43
HOIMA,2020,1190,1030,2220,43
HOIMA,2021,1230,1060,2290,43
HOIMA,2022,1280,1090,2370,43
HOIMA,2023,1320,1130,2450,43
HOIMA,2024,1360,1160,2520,43
HOIMA,2025,1410,1200,2610,43
IBANDA,2015,710,790,1500,43
IBANDA,2016,730,800,1530,43
IBANDA,2017,740,820,1560,43
IBANDA,2018,750,830,1580,43
IBANDA,2019,770,850,1620,43
IBANDA,2020,780,860,1640,43
IBANDA,2021,800,880,1680,43
IBANDA,2022,810,890,1700,43
IBANDA,2023,820,900,1720,43
IBANDA,2024,840,920,1760,43
IBANDA,2025,850,930,1780,43
IGANGA,2015,1040,1260,2300,43
IGANGA,2016,1060,1320,2380,43
IGANGA,2017,1080,1340,2420,43
IGANGA,2018,1100,1380,2480,43
IGANGA,2019,1120,1420,2540,43
IGANGA,2020,1140,1480,2620,43
IGANGA,2021,1180,1540,2720,43
IGANGA,2022,1230,1600,2830,43
IGANGA,2023,1290,1680,2970,43
IGANGA,2024,1340,1760,3100,43
IGANGA,2025,1400,1850,3250,43
ISINGIRO,2015,1470,1570,3040,43
ISINGIRO,2016,1520,1630,3150,43
ISINGIRO,2017,1580,1690,3270,43
ISINGIRO,2018,1640,1750,3390,43
ISINGIRO,2019,1700,1810,3510,43
ISINGIRO,2020,1760,1870,3630,43
ISINGIRO,2021,1820,1930,3750,43
ISINGIRO,2022,1880,1990,3870,43
ISINGIRO,2023,1940,2060,4000,43
ISINGIRO,2024,2010,2120,4130,43
ISINGIRO,2025,2070,2190,4260,43
JINJA,2015,1240,1190,2430,43
JINJA,2016,1260,1200,2460,43
JINJA,2017,1280,1220,2500,43
JINJA,2018,1300,1240,2540,43
JINJA,2019,1320,1260,2580,43
JINJA,2020,1340,1280,2620,43
JINJA,2021,1360,1290,2650,43
JINJA,2022,1380,1310,2690,43
JINJA,2023,1400,1330,2730,43
JINJA,2024,1420,1340,2760,43
JINJA,2025,1430,1360,2790,43
KAABONG,2015,260,240,500,43
KAABONG,2016,270,250,520,43
KAABONG,2017,280,260,540,43
KAABONG,2018,290,260,550,43
KAABONG,2019,290,270,560,43
KAABONG,2020,300,270,570,43
KAABONG,2021,310,280,590,43
KAABONG,2022,320,290,610,43
KAABONG,2023,320,290,610,43
KAABONG,2024,330,300,630,43
KAABONG,2025,340,300,640,43
KABALE,2015,730,880,1610,43
KABALE,2016,740,890,1630,43
KABALE,2017,750,900,1650,43
KABALE,2018,770,910,1680,43
KABALE,2019,780,920,1700,43
KABALE,2020,790,930,1720,43
KABALE,2021,800,940,1740,43
KABALE,2022,810,950,1760,43
KABALE,2023,820,960,1780,43
KABALE,2024,830,970,1800,43
KABALE,2025,840,970,1810,43
KABAROLE,2015,890,780,1670,43
KABAROLE,2016,900,800,1700,43
KABAROLE,2017,920,820,1740,43
KABAROLE,2018,940,830,1770,43
KABAROLE,2019,960,850,1810,43
KABAROLE,2020,980,870,1850,43
KABAROLE,2021,1000,880,1880,43
KABAROLE,2022,1020,900,1920,43
KABAROLE,2023,1040,920,1960,43
KABAROLE,2024,1060,930,1990,43
KABAROLE,2025,1080,950,2030,43
KABERAMAIDO,2015,370,420,790,43
KABERAMAIDO,2016,380,440,820,43
KABERAMAIDO,2017,390,450,840,43
KABERAMAIDO,2018,410,480,890,43
KABERAMAIDO,2019,410,490,900,43
KABERAMAIDO,2020,440,510,950,43
KABERAMAIDO,2021,450,550,1000,43
KABERAMAIDO,2022,480,570,1050,43
KABERAMAIDO,2023,500,610,1110,43
KABERAMAIDO,2024,530,640,1170,43
KABERAMAIDO,2025,550,690,1240,43
KAGADI,2015,910,1080,1990,43
KAGADI,2016,950,1110,2060,43
KAGADI,2017,980,1150,2130,43
KAGADI,2018,1020,1190,2210,43
KAGADI,2019,1050,1230,2280,43
KAGADI,2020,1090,1280,2370,43
KAGADI,2021,1130,1320,2450,43
KAGADI,2022,1170,1360,2530,43
KAGADI,2023,1210,1400,2610,43
KAGADI,2024,1240,1450,2690,43
KAGADI,2025,1280,1490,2770,43
KAKUMIRO,2015,920,870,1790,43
KAKUMIRO,2016,1010,940,1950,43
KAKUMIRO,2017,1090,1020,2110,43
KAKUMIRO,2018,1190,1110,2300,43
KAKUMIRO,2019,1290,1200,2490,43
KAKUMIRO,2020,1410,1300,2710,43
KAKUMIRO,2021,1530,1410,2940,43
KAKUMIRO,2022,1660,1520,3180,43
KAKUMIRO,2023,1800,1640,3440,43
KAKUMIRO,2024,1950,1780,3730,43
KAKUMIRO,2025,2110,1920,4030,43
KALAKI,2015,340,360,700,43
KALAKI,2016,350,370,720,43
KALAKI,2017,370,390,760,43
KALAKI,2018,380,400,780,43
KALAKI,2019,400,420,820,43
KALAKI,2020,420,430,850,43
KALAKI,2021,430,450,880,43
KALAKI,2022,450,460,910,43
KALAKI,2023,470,480,950,43
KALAKI,2024,480,500,980,43
KALAKI,2025,500,520,1020,43
KALANGALA,2015,410,150,560,43
KALANGALA,2016,420,150,570,43
KALANGALA,2017,440,160,600,43
KALANGALA,2018,450,160,610,43
KALANGALA,2019,470,170,640,43
KALANGALA,2020,480,180,660,43
KALANGALA,2021,500,180,680,43
KALANGALA,2022,520,190,710,43
KALANGALA,2023,530,200,730,43
KALANGALA,2024,550,210,760,43
KALANGALA,2025,560,210,770,43
KALIRO,2015,760,870,1630,43
KALIRO,2016,790,900,1690,43
KALIRO,2017,800,930,1730,43
KALIRO,2018,810,950,1760,43
KALIRO,2019,840,1000,1840,43
KALIRO,2020,860,1030,1890,43
KALIRO,2021,890,1090,1980,43
KALIRO,2022,940,1140,2080,43
KALIRO,2023,970,1210,2180,43
KALIRO,2024,1030,1270,2300,43
KALIRO,2025,1070,1340,2410,43
KALUNGU,2015,660,710,1370,43
KALUNGU,2016,660,710,1370,43
KALUNGU,2017,660,720,1380,43
KALUNGU,2018,650,720,1370,43
KALUNGU,2019,660,740,1400,43
KALUNGU,2020,650,740,1390,43
KALUNGU,2021,670,760,1430,43
KALUNGU,2022,680,790,1470,43
KALUNGU,2023,700,800,1500,43
KALUNGU,2024,710,820,1530,43
KALUNGU,2025,730,850,1580,43
KAMPALA,2015,4550,4130,8680,43
KAMPALA,2016,4650,4210,8860,43
KAMPALA,2017,4740,4290,9030,43
KAMPALA,2018,4830,4370,9200,43
KAMPALA,2019,4920,4450,9370,43
KAMPALA,2020,5010,4530,9540,43
KAMPALA,2021,5100,4610,9710,43
KAMPALA,2022,5180,4690,9870,43
KAMPALA,2023,5270,4760,10030,43
KAMPALA,2024,5350,4840,10190,43
KAMPALA,2025,5420,4910,10330,43
KAMULI,2015,1480,1690,3170,43
KAMULI,2016,1510,1740,3250,43
KAMULI,2017,1530,1780,3310,43
KAMULI,2018,1540,1810,3350,43
KAMULI,2019,1560,1860,3420,43
KAMULI,2020,1590,1920,3510,43
KAMULI,2021,1650,1990,3640,43
KAMULI,2022,1700,2060,3760,43
KAMULI,2023,1760,2150,3910,43
KAMULI,2024,1820,2240,4060,43
KAMULI,2025,1890,2330,4220,43
KAMWENGE,2015,740,850,1590,43
KAMWENGE,2016,770,880,1650,43
KAMWENGE,2017,810,920,1730,43
KAMWENGE,2018,840,950,1790,43
KAMWENGE,2019,870,980,1850,43
KAMWENGE,2020,900,1010,1910,43
KAMWENGE,2021,940,1050,1990,43
KAMWENGE,2022,980,1080,2060,43
KAMWENGE,2023,1010,1120,2130,43
KAMWENGE,2024,1050,1150,2200,43
KAMWENGE,2025,1080,1190,2270,43
KANUNGU,2015,750,880,1630,43
KANUNGU,2016,760,900,1660,43
KANUNGU,2017,770,910,1680,43
KANUNGU,2018,790,930,1720,43
KANUNGU,2019,800,940,1740,43
KANUNGU,2020,820,950,1770,43
KANUNGU,2021,830,970,1800,43
KANUNGU,2022,840,980,1820,43
KANUNGU,2023,850,990,1840,43
KANUNGU,2024,860,1000,1860,43
KANUNGU,2025,880,1020,1900,43
KAPCHORWA,2015,330,330,660,43
KAPCHORWA,2016,340,340,680,43
KAPCHORWA,2017,350,350,700,43
KAPCHORWA,2018,360,360,720,43
KAPCHORWA,2019,370,370,740,43
KAPCHORWA,2020,390,380,770,43
KAPCHORWA,2021,400,390,790,43
KAPCHORWA,2022,410,400,810,43
KAPCHORWA,2023,420,410,830,43
KAPCHORWA,2024,430,420,850,43
KAPCHORWA,2025,440,430,870,43
KAPELEBYONG,2015,310,310,620,43
KAPELEBYONG,2016,310,330,640,43
KAPELEBYONG,2017,310,330,640,43
KAPELEBYONG,2018,320,340,660,43
KAPELEBYONG,2019,330,360,690,43
KAPELEBYONG,2020,340,360,700,43
KAPELEBYONG,2021,350,380,730,43
KAPELEBYONG,2022,360,400,760,43
KAPELEBYONG,2023,370,410,780,43
KAPELEBYONG,2024,390,430,820,43
KAPELEBYONG,2025,410,460,870,43
KASESE,2015,2200,2460,4660,43
KASESE,2016,2230,2530,4760,43
KASESE,2017,2260,2580,4840,43
KASESE,2018,2270,2630,4900,43
KASESE,2019,2300,2690,4990,43
KASESE,2020,2340,2770,5110,43
KASESE,2021,2410,2870,5280,43
KASESE,2022,2490,2990,5480,43
KASESE,2023,2570,3110,5680,43
KASESE,2024,2670,3240,5910,43
KASESE,2025,2760,3370,6130,43
KASSANDA,2015,810,740,1550,43
KASSANDA,2016,830,760,1590,43
KASSANDA,2017,860,770,1630,43
KASSANDA,2018,880,790,1670,43
KASSANDA,2019,910,800,1710,43
KASSANDA,2020,930,820,1750,43
KASSANDA,2021,950,840,1790,43
KASSANDA,2022,980,850,1830,43
KASSANDA,2023,1000,870,1870,43
KASSANDA,2024,1030,880,1910,43
KASSANDA,2025,1050,900,1950,43
KATAKWI,2015,550,630,1180,43
KATAKWI,2016,570,640,1210,43
KATAKWI,2017,580,660,1240,43
KATAKWI,2018,590,670,1260,43
KATAKWI,2019,600,700,1300,43
KATAKWI,2020,610,720,1330,43
KATAKWI,2021,630,740,1370,43
KATAKWI,2022,650,770,1420,43
KATAKWI,2023,690,820,1510,43
KATAKWI,2024,710,850,1560,43
KATAKWI,2025,740,880,1620,43
KAYUNGA,2015,1070,1200,2270,43
KAYUNGA,2016,1080,1220,2300,43
KAYUNGA,2017,1090,1240,2330,43
KAYUNGA,2018,1100,1250,2350,43
KAYUNGA,2019,1100,1270,2370,43
KAYUNGA,2020,1120,1310,2430,43
KAYUNGA,2021,1150,1350,2500,43
KAYUNGA,2022,1170,1390,2560,43
KAYUNGA,2023,1210,1450,2660,43
KAYUNGA,2024,1240,1490,2730,43
KAYUNGA,2025,1280,1540,2820,43
KAZO,2015,540,600,1140,43
KAZO,2016,560,620,1180,43
KAZO,2017,580,640,1220,43
KAZO,2018,600,660,1260,43
KAZO,2019,630,690,1320,43
KAZO,2020,650,710,1360,43
KAZO,2021,670,730,1400,43
KAZO,2022,700,760,1460,43
KAZO,2023,720,780,1500,43
KAZO,2024,740,810,1550,43
KAZO,2025,770,830,1600,43
KIBAALE,2015,450,360,810,43
KIBAALE,2016,480,380,860,43
KIBAALE,2017,510,410,920,43
KIBAALE,2018,540,430,970,43
KIBAALE,2019,570,450,1020,43
KIBAALE,2020,610,480,1090,43
KIBAALE,2021,650,510,1160,43
KIBAALE,2022,690,530,1220,43
KIBAALE,2023,730,560,1290,43
KIBAALE,2024,770,590,1360,43
KIBAALE,2025,810,620,1430,43
KIBOGA,2015,590,570,1160,43
KIBOGA,2016,620,600,1220,43
KIBOGA,2017,630,620,1250,43
KIBOGA,2018,640,640,1280,43
KIBOGA,2019,640,650,1290,43
KIBOGA,2020,660,660,1320,43
KIBOGA,2021,660,680,1340,43
KIBOGA,2022,690,710,1400,43
KIBOGA,2023,710,740,1450,43
KIBOGA,2024,740,770,1510,43
KIBOGA,2025,760,800,1560,43
KIBUKU,2015,640,730,1370,43
KIBUKU,2016,660,770,1430,43
KIBUKU,2017,680,790,1470,43
KIBUKU,2018,690,820,1510,43
KIBUKU,2019,710,850,1560,43
KIBUKU,2020,730,900,1630,43
KIBUKU,2021,770,940,1710,43
KIBUKU,2022,800,990,1790,43
KIBUKU,2023,840,1050,1890,43
KIBUKU,2024,890,1110,2000,43
KIBUKU,2025,920,1160,2080,43
KIKUUBE,2015,950,690,1640,43
KIKUUBE,2016,1010,720,1730,43
KIKUUBE,2017,1060,760,1820,43
KIKUUBE,2018,1120,800,1920,43
KIKUUBE,2019,1170,840,2010,43
KIKUUBE,2020,1230,880,2110,43
KIKUUBE,2021,1300,920,2220,43
KIKUUBE,2022,1360,970,2330,43
KIKUUBE,2023,1430,1010,2440,43
KIKUUBE,2024,1500,1060,2560,43
KIKUUBE,2025,1570,1110,2680,43
KIRUHURA,2015,600,430,1030,43
KIRUHURA,2016,620,440,1060,43
KIRUHURA,2017,640,460,1100,43
KIRUHURA,2018,670,470,1140,43
KIRUHURA,2019,690,490,1180,43
KIRUHURA,2020,720,500,1220,43
KIRUHURA,2021,750,520,1270,43
KIRUHURA,2022,770,540,1310,43
KIRUHURA,2023,800,560,1360,43
KIRUHURA,2024,820,570,1390,43
KIRUHURA,2025,850,590,1440,43
KIRYANDONGO,2015,890,850,1740,43
KIRYANDONGO,2016,930,910,1840,43
KIRYANDONGO,2017,950,940,1890,43
KIRYANDONGO,2018,970,960,1930,43
KIRYANDONGO,2019,970,980,1950,43
KIRYANDONGO,2020,990,1010,2000,43
KIRYANDONGO,2021,1020,1040,2060,43
KIRYANDONGO,2022,1050,1080,2130,43
KIRYANDONGO,2023,1100,1130,2230,43
KIRYANDONGO,2024,1150,1180,2330,43
KIRYANDONGO,2025,1190,1240,2430,43
KISORO,2015,800,1510,2310,43
KISORO,2016,820,1550,2370,43
KISORO,2017,820,1580,2400,43
KISORO,2018,810,1610,2420,43
KISORO,2019,830,1640,2470,43
KISORO,2020,840,1680,2520,43
KISORO,2021,850,1740,2590,43
KISORO,2022,890,1820,2710,43
KISORO,2023,910,1890,2800,43
KISORO,2024,940,1960,2900,43
KISORO,2025,960,2030,2990,43
KITAGWENDA,2015,470,480,950,43
KITAGWENDA,2016,480,500,980,43
KITAGWENDA,2017,500,510,1010,43
KITAGWENDA,2018,530,530,1060,43
KITAGWENDA,2019,550,550,1100,43
KITAGWENDA,2020,570,570,1140,43
KITAGWENDA,2021,590,590,1180,43
KITAGWENDA,2022,610,610,1220,43
KITAGWENDA,2023,630,630,1260,43
KITAGWENDA,2024,660,650,1310,43
KITAGWENDA,2025,680,670,1350,43
KITGUM,2015,750,840,1590,43
KITGUM,2016,750,860,1610,43
KITGUM,2017,760,870,1630,43
KITGUM,2018,760,890,1650,43
KITGUM,2019,770,900,1670,43
KITGUM,2020,780,920,1700,43
KITGUM,2021,780,950,1730,43
KITGUM,2022,800,990,1790,43
KITGUM,2023,820,1020,1840,43
KITGUM,2024,850,1050,1900,43
KITGUM,2025,870,1080,1950,43
KOBOKO,2015,630,540,1170,43
KOBOKO,2016,650,560,1210,43
KOBOKO,2017,660,590,1250,43
KOBOKO,2018,680,600,1280,43
KOBOKO,2019,710,630,1340,43
KOBOKO,2020,730,660,1390,43
KOBOKO,2021,760,700,1460,43
KOBOKO,2022,800,730,1530,43
KOBOKO,2023,840,770,1610,43
KOBOKO,2024,870,820,1690,43
KOBOKO,2025,920,870,1790,43
KOLE,2015,680,750,1430,43
KOLE,2016,700,770,1470,43
KOLE,2017,720,790,1510,43
KOLE,2018,750,810,1560,43
KOLE,2019,770,830,1600,43
KOLE,2020,790,860,1650,43
KOLE,2021,820,880,1700,43
KOLE,2022,840,900,1740,43
KOLE,2023,870,930,1800,43
KOLE,2024,890,950,1840,43
KOLE,2025,920,970,1890,43
KOTIDO,2015,530,680,1210,43
KOTIDO,2016,540,700,1240,43
KOTIDO,2017,540,710,1250,43
KOTIDO,2018,540,740,1280,43
KOTIDO,2019,550,750,1300,43
KOTIDO,2020,560,770,1330,43
KOTIDO,2021,570,800,1370,43
KOTIDO,2022,590,830,1420,43
KOTIDO,2023,610,860,1470,43
KOTIDO,2024,630,900,1530,43
KOTIDO,2025,650,930,1580,43
KUMI,2015,890,940,1830,43
KUMI,2016,910,970,1880,43
KUMI,2017,930,1000,1930,43
KUMI,2018,940,1020,1960,43
KUMI,2019,960,1050,2010,43
KUMI,2020,980,1090,2070,43
KUMI,2021,1020,1140,2160,43
KUMI,2022,1060,1200,2260,43
KUMI,2023,1110,1260,2370,43
KUMI,2024,1150,1310,2460,43
KUMI,2025,1210,1370,2580,43
KWANIA,2015,490,540,1030,43
KWANIA,2016,500,560,1060,43
KWANIA,2017,520,580,1100,43
KWANIA,2018,530,590,1120,43
KWANIA,2019,550,610,1160,43
KWANIA,2020,570,620,1190,43
KWANIA,2021,580,640,1220,43
KWANIA,2022,600,660,1260,43
KWANIA,2023,620,670,1290,43
KWANIA,2024,630,690,1320,43
KWANIA,2025,650,710,1360,43
KWEEN,2015,260,270,530,43
KWEEN,2016,270,280,550,43
KWEEN,2017,280,280,560,43
KWEEN,2018,290,290,580,43
KWEEN,2019,290,300,590,43
KWEEN,2020,300,300,600,43
KWEEN,2021,310,310,620,43
KWEEN,2022,320,320,640,43
KWEEN,2023,330,320,650,43
KWEEN,2024,340,330,670,43
KWEEN,2025,350,340,690,43
KYANKWANZI,2015,670,510,1180,43
KYANKWANZI,2016,700,530,1230,43
KYANKWANZI,2017,740,550,1290,43
KYANKWANZI,2018,780,580,1360,43
KYANKWANZI,2019,820,610,1430,43
KYANKWANZI,2020,860,630,1490,43
KYANKWANZI,2021,900,660,1560,43
KYANKWANZI,2022,940,690,1630,43
KYANKWANZI,2023,990,720,1710,43
KYANKWANZI,2024,1030,750,1780,43
KYANKWANZI,2025,1080,780,1860,43
KYEGEGWA,2015,900,870,1770,43
KYEGEGWA,2016,970,940,1910,43
KYEGEGWA,2017,1050,1010,2060,43
KYEGEGWA,2018,1140,1090,2230,43
KYEGEGWA,2019,1230,1170,2400,43
KYEGEGWA,2020,1330,1270,2600,43
KYEGEGWA,2021,1430,1360,2790,43
KYEGEGWA,2022,1550,1470,3020,43
KYEGEGWA,2023,1670,1580,3250,43
KYEGEGWA,2024,1800,1690,3490,43
KYEGEGWA,2025,1940,1820,3760,43
KYENJOJO,2015,1220,1220,2440,43
KYENJOJO,2016,1270,1270,2540,43
KYENJOJO,2017,1320,1310,2630,43
KYENJOJO,2018,1370,1360,2730,43
KYENJOJO,2019,1430,1410,2840,43
KYENJOJO,2020,1480,1460,2940,43
KYENJOJO,2021,1540,1510,3050,43
KYENJOJO,2022,1600,1560,3160,43
KYENJOJO,2023,1660,1620,3280,43
KYENJOJO,2024,1720,1670,3390,43
KYENJOJO,2025,1780,1720,3500,43
KYOTERA,2015,980,910,1890,43
KYOTERA,2016,980,930,1910,43
KYOTERA,2017,990,940,1930,43
KYOTERA,2018,980,950,1930,43
KYOTERA,2019,990,970,1960,43
KYOTERA,2020,1010,990,2000,43
KYOTERA,2021,1020,1020,2040,43
KYOTERA,2022,1050,1060,2110,43
KYOTERA,2023,1070,1080,2150,43
KYOTERA,2024,1100,1120,2220,43
KYOTERA,2025,1130,1160,2290,43
KARENGA,2015,150,170,320,43
KARENGA,2016,150,170,320,43
KARENGA,2017,160,180,340,43
KARENGA,2018,160,180,340,43
KARENGA,2019,160,190,350,43
KARENGA,2020,170,190,360,43
KARENGA,2021,170,190,360,43
KARENGA,2022,180,200,380,43
KARENGA,2023,180,200,380,43
KARENGA,2024,190,210,400,43
KARENGA,2025,190,210,400,43
LAMWO,2015,480,500,980,43
LAMWO,2016,470,510,980,43
LAMWO,2017,460,520,980,43
LAMWO,2018,470,520,990,43
LAMWO,2019,460,530,990,43
LAMWO,2020,460,540,1000,43
LAMWO,2021,480,560,1040,43
LAMWO,2022,480,570,1050,43
LAMWO,2023,490,600,1090,43
LAMWO,2024,510,610,1120,43
LAMWO,2025,510,640,1150,43
LIRA,2015,1040,1080,2120,43
LIRA,2016,1070,1110,2180,43
LIRA,2017,1100,1140,2240,43
LIRA,2018,1140,1170,2310,43
LIRA,2019,1170,1200,2370,43
LIRA,2020,1200,1240,2440,43
LIRA,2021,1230,1270,2500,43
LIRA,2022,1260,1300,2560,43
LIRA,2023,1290,1340,2630,43
LIRA,2024,1320,1370,2690,43
LIRA,2025,1350,1400,2750,43
LUUKA,2015,630,830,1460,43
LUUKA,2016,640,850,1490,43
LUUKA,2017,640,860,1500,43
LUUKA,2018,640,870,1510,43
LUUKA,2019,640,890,1530,43
LUUKA,2020,650,920,1570,43
LUUKA,2021,670,950,1620,43
LUUKA,2022,690,990,1680,43
LUUKA,2023,720,1020,1740,43
LUUKA,2024,730,1060,1790,43
LUUKA,2025,760,1100,1860,43
LUWERO,2015,1680,1700,3380,43
LUWERO,2016,1710,1750,3460,43
LUWERO,2017,1730,1790,3520,43
LUWERO,2018,1740,1830,3570,43
LUWERO,2019,1760,1870,3630,43
LUWERO,2020,1790,1930,3720,43
LUWERO,2021,1850,1990,3840,43
LUWERO,2022,1910,2070,3980,43
LUWERO,2023,1990,2160,4150,43
LUWERO,2024,2050,2260,4310,43
LUWERO,2025,2130,2330,4460,43
LWENGO,2015,940,1010,1950,43
LWENGO,2016,940,1030,1970,43
LWENGO,2017,940,1040,1980,43
LWENGO,2018,940,1040,1980,43
LWENGO,2019,940,1050,1990,43
LWENGO,2020,930,1080,2010,43
LWENGO,2021,950,1090,2040,43
LWENGO,2022,970,1130,2100,43
LWENGO,2023,990,1150,2140,43
LWENGO,2024,1010,1180,2190,43
LWENGO,2025,1030,1220,2250,43
LYANTONDE,2015,340,300,640,43
LYANTONDE,2016,360,320,680,43
LYANTONDE,2017,370,340,710,43
LYANTONDE,2018,380,350,730,43
LYANTONDE,2019,380,360,740,43
LYANTONDE,2020,390,370,760,43
LYANTONDE,2021,400,380,780,43
LYANTONDE,2022,400,390,790,43
LYANTONDE,2023,420,400,820,43
LYANTONDE,2024,440,420,860,43
LYANTONDE,2025,460,440,900,43
MANAFWA,2015,420,460,880,43
MANAFWA,2016,430,470,900,43
MANAFWA,2017,450,480,930,43
MANAFWA,2018,460,490,950,43
MANAFWA,2019,470,500,970,43
MANAFWA,2020,480,510,990,43
MANAFWA,2021,490,520,1010,43
MANAFWA,2022,500,530,1030,43
MANAFWA,2023,510,540,1050,43
MANAFWA,2024,520,550,1070,43
MANAFWA,2025,530,560,1090,43
MARACHA,2015,430,590,1020,43
MARACHA,2016,440,610,1050,43
MARACHA,2017,450,620,1070,43
MARACHA,2018,450,630,1080,43
MARACHA,2019,460,640,1100,43
MARACHA,2020,470,650,1120,43
MARACHA,2021,480,660,1140,43
MARACHA,2022,490,670,1160,43
MARACHA,2023,500,690,1190,43
MARACHA,2024,510,700,1210,43
MARACHA,2025,520,710,1230,43
MASAKA,2015,1100,910,2010,43
MASAKA,2016,1150,970,2120,43
MASAKA,2017,1200,1020,2220,43
MASAKA,2018,1220,1050,2270,43
MASAKA,2019,1230,1070,2300,43
MASAKA,2020,1240,1090,2330,43
MASAKA,2021,1250,1110,2360,43
MASAKA,2022,1270,1140,2410,43
MASAKA,2023,1310,1180,2490,43
MASAKA,2024,1350,1230,2580,43
MASAKA,2025,1390,1280,2670,43
MASINDI,2015,1010,720,1730,43
MASINDI,2016,1040,740,1780,43
MASINDI,2017,1070,760,1830,43
MASINDI,2018,1100,780,1880,43
MASINDI,2019,1130,800,1930,43
MASINDI,2020,1160,820,1980,43
MASINDI,2021,1190,840,2030,43
MASINDI,2022,1220,860,2080,43
MASINDI,2023,1260,880,2140,43
MASINDI,2024,1290,900,2190,43
MASINDI,2025,1320,920,2240,43
MAYUGE,2015,1360,1620,2980,43
MAYUGE,2016,1390,1670,3060,43
MAYUGE,2017,1420,1720,3140,43
MAYUGE,2018,1440,1770,3210,43
MAYUGE,2019,1460,1830,3290,43
MAYUGE,2020,1500,1900,3400,43
MAYUGE,2021,1560,1990,3550,43
MAYUGE,2022,1630,2090,3720,43
MAYUGE,2023,1690,2190,3880,43
MAYUGE,2024,1760,2300,4060,43
MAYUGE,2025,1840,2390,4230,43
MBALE,2015,1670,1860,3530,43
MBALE,2016,1710,1950,3660,43
MBALE,2017,1730,1990,3720,43
MBALE,2018,1750,2060,3810,43
MBALE,2019,1790,2130,3920,43
MBALE,2020,1830,2220,4050,43
MBALE,2021,1890,2330,4220,43
MBALE,2022,1970,2450,4420,43
MBALE,2023,2050,2570,4620,43
MBALE,2024,2140,2700,4840,43
MBALE,2025,2220,2840,5060,43
MBARARA,2015,1130,1000,2130,43
MBARARA,2016,1160,1020,2180,43
MBARARA,2017,1180,1040,2220,43
MBARARA,2018,1210,1060,2270,43
MBARARA,2019,1240,1090,2330,43
MBARARA,2020,1260,1110,2370,43
MBARARA,2021,1290,1130,2420,43
MBARARA,2022,1310,1150,2460,43
MBARARA,2023,1340,1170,2510,43
MBARARA,2024,1360,1190,2550,43
MBARARA,2025,1390,1210,2600,43
MITOOMA,2015,470,640,1110,43
MITOOMA,2016,470,650,1120,43
MITOOMA,2017,480,650,1130,43
MITOOMA,2018,490,660,1150,43
MITOOMA,2019,490,670,1160,43
MITOOMA,2020,500,670,1170,43
MITOOMA,2021,500,680,1180,43
MITOOMA,2022,510,680,1190,43
MITOOMA,2023,510,680,1190,43
MITOOMA,2024,510,690,1200,43
MITOOMA,2025,520,690,1210,43
MITYANA,2015,1280,1250,2530,43
MITYANA,2016,1300,1290,2590,43
MITYANA,2017,1300,1300,2600,43
MITYANA,2018,1310,1320,2630,43
MITYANA,2019,1300,1340,2640,43
MITYANA,2020,1320,1380,2700,43
MITYANA,2021,1350,1420,2770,43
MITYANA,2022,1390,1460,2850,43
MITYANA,2023,1440,1520,2960,43
MITYANA,2024,1480,1570,3050,43
MITYANA,2025,1510,1620,3130,43
MOROTO,2015,310,370,680,43
MOROTO,2016,310,380,690,43
MOROTO,2017,310,400,710,43
MOROTO,2018,310,410,720,43
MOROTO,2019,320,410,730,43
MOROTO,2020,320,430,750,43
MOROTO,2021,330,450,780,43
MOROTO,2022,330,460,790,43
MOROTO,2023,350,480,830,43
MOROTO,2024,370,510,880,43
MOROTO,2025,370,520,890,43
MOYO,2015,260,280,540,43
MOYO,2016,270,290,560,43
MOYO,2017,280,300,580,43
MOYO,2018,280,300,580,43
MOYO,2019,290,310,600,43
MOYO,2020,300,320,620,43
MOYO,2021,300,320,620,43
MOYO,2022,310,330,640,43
MOYO,2023,320,330,650,43
MOYO,2024,330,340,670,43
MOYO,2025,330,350,680,43
MPIGI,2015,950,970,1920,43
MPIGI,2016,960,990,1950,43
MPIGI,2017,970,1010,1980,43
MPIGI,2018,970,1040,2010,43
MPIGI,2019,990,1050,2040,43
MPIGI,2020,1010,1090,2100,43
MPIGI,2021,1040,1140,2180,43
MPIGI,2022,1070,1170,2240,43
MPIGI,2023,1110,1230,2340,43
MPIGI,2024,1140,1270,2410,43
MPIGI,2025,1180,1330,2510,43
MUBENDE,2015,1540,1520,3060,43
MUBENDE,2016,1610,1620,3230,43
MUBENDE,2017,1670,1690,3360,43
MUBENDE,2018,1720,1770,3490,43
MUBENDE,2019,1800,1870,3670,43
MUBENDE,2020,1880,1990,3870,43
MUBENDE,2021,1990,2120,4110,43
MUBENDE,2022,2120,2260,4380,43
MUBENDE,2023,2250,2410,4660,43
MUBENDE,2024,2390,2580,4970,43
MUBENDE,2025,2550,2760,5310,43
MUKONO,2015,2220,2320,4540,43
MUKONO,2016,2270,2410,4680,43
MUKONO,2017,2290,2470,4760,43
MUKONO,2018,2310,2540,4850,43
MUKONO,2019,2350,2610,4960,43
MUKONO,2020,2400,2720,5120,43
MUKONO,2021,2470,2830,5300,43
MUKONO,2022,2560,2960,5520,43
MUKONO,2023,2660,3110,5770,43
MUKONO,2024,2760,3260,6020,43
MUKONO,2025,2860,3400,6260,43
MADI OKOLLO,2015,370,420,790,43
MADI OKOLLO,2016,380,430,810,43
MADI OKOLLO,2017,390,440,830,43
MADI OKOLLO,2018,400,450,850,43
MADI OKOLLO,2019,410,460,870,43
MADI OKOLLO,2020,420,470,890,43
MADI OKOLLO,2021,430,490,920,43
MADI OKOLLO,2022,450,500,950,43
MADI OKOLLO,2023,460,510,970,43
MADI OKOLLO,2024,470,520,990,43
MADI OKOLLO,2025,480,530,1010,43
NABILATUK,2015,150,220,370,43
NABILATUK,2016,150,230,380,43
NABILATUK,2017,160,250,410,43
NABILATUK,2018,170,260,430,43
NABILATUK,2019,180,260,440,43
NABILATUK,2020,180,280,460,43
NABILATUK,2021,190,290,480,43
NABILATUK,2022,210,310,520,43
NABILATUK,2023,220,340,560,43
NABILATUK,2024,230,360,590,43
NABILATUK,2025,240,380,620,43
NAKAPIRIPIRIT,2015,300,270,570,43
NAKAPIRIPIRIT,2016,310,290,600,43
NAKAPIRIPIRIT,2017,310,300,610,43
NAKAPIRIPIRIT,2018,320,300,620,43
NAKAPIRIPIRIT,2019,330,310,640,43
NAKAPIRIPIRIT,2020,350,330,680,43
NAKAPIRIPIRIT,2021,370,350,720,43
NAKAPIRIPIRIT,2022,380,370,750,43
NAKAPIRIPIRIT,2023,400,410,810,43
NAKAPIRIPIRIT,2024,430,430,860,43
NAKAPIRIPIRIT,2025,450,460,910,43
NAKASEKE,2015,710,510,1220,43
NAKASEKE,2016,730,530,1260,43
NAKASEKE,2017,760,540,1300,43
NAKASEKE,2018,790,550,1340,43
NAKASEKE,2019,810,560,1370,43
NAKASEKE,2020,840,580,1420,43
NAKASEKE,2021,870,590,1460,43
NAKASEKE,2022,900,600,1500,43
NAKASEKE,2023,930,610,1540,43
NAKASEKE,2024,960,630,1590,43
NAKASEKE,2025,990,640,1630,43
NAKASONGOLA,2015,760,630,1390,43
NAKASONGOLA,2016,780,640,1420,43
NAKASONGOLA,2017,790,660,1450,43
NAKASONGOLA,2018,800,680,1480,43
NAKASONGOLA,2019,820,700,1520,43
NAKASONGOLA,2020,840,720,1560,43
NAKASONGOLA,2021,870,760,1630,43
NAKASONGOLA,2022,900,790,1690,43
NAKASONGOLA,2023,940,820,1760,43
NAKASONGOLA,2024,970,850,1820,43
NAKASONGOLA,2025,1010,900,1910,43
NAMAYINGO,2015,670,650,1320,43
NAMAYINGO,2016,690,670,1360,43
NAMAYINGO,2017,690,670,1360,43
NAMAYINGO,2018,690,680,1370,43
NAMAYINGO,2019,690,700,1390,43
NAMAYINGO,2020,700,700,1400,43
NAMAYINGO,2021,720,730,1450,43
NAMAYINGO,2022,740,760,1500,43
NAMAYINGO,2023,760,770,1530,43
NAMAYINGO,2024,780,810,1590,43
NAMAYINGO,2025,800,820,1620,43
NAMISINDWA,2015,590,540,1130,43
NAMISINDWA,2016,610,560,1170,43
NAMISINDWA,2017,630,570,1200,43
NAMISINDWA,2018,640,580,1220,43
NAMISINDWA,2019,660,600,1260,43
NAMISINDWA,2020,680,610,1290,43
NAMISINDWA,2021,700,620,1320,43
NAMISINDWA,2022,710,640,1350,43
NAMISINDWA,2023,730,650,1380,43
NAMISINDWA,2024,750,660,1410,43
NAMISINDWA,2025,760,670,1430,43
NAMUTUMBA,2015,750,860,1610,43
NAMUTUMBA,2016,770,890,1660,43
NAMUTUMBA,2017,790,920,1710,43
NAMUTUMBA,2018,800,940,1740,43
NAMUTUMBA,2019,820,970,1790,43
NAMUTUMBA,2020,840,1010,1850,43
NAMUTUMBA,2021,880,1070,1950,43
NAMUTUMBA,2022,910,1120,2030,43
NAMUTUMBA,2023,960,1170,2130,43
NAMUTUMBA,2024,1000,1230,2230,43
NAMUTUMBA,2025,1050,1300,2350,43
NAPAK,2015,300,500,800,43
NAPAK,2016,310,520,830,43
NAPAK,2017,300,530,830,43
NAPAK,2018,310,550,860,43
NAPAK,2019,300,550,850,43
NAPAK,2020,300,570,870,43
NAPAK,2021,320,590,910,43
NAPAK,2022,320,620,940,43
NAPAK,2023,340,630,970,43
NAPAK,2024,340,660,1000,43
NAPAK,2025,350,690,1040,43
NEBBI,2015,710,790,1500,43
NEBBI,2016,740,810,1550,43
NEBBI,2017,760,840,1600,43
NEBBI,2018,780,860,1640,43
NEBBI,2019,810,880,1690,43
NEBBI,2020,830,910,1740,43
NEBBI,2021,860,930,1790,43
NEBBI,2022,880,960,1840,43
NEBBI,2023,910,980,1890,43
NEBBI,2024,930,1000,1930,43
NEBBI,2025,960,1030,1990,43
NGORA,2015,440,520,960,43
NGORA,2016,450,530,980,43
NGORA,2017,450,550,1000,43
NGORA,2018,460,560,1020,43
NGORA,2019,460,570,1030,43
NGORA,2020,470,590,1060,43
NGORA,2021,490,620,1110,43
NGORA,2022,510,640,1150,43
NGORA,2023,520,670,1190,43
NGORA,2024,540,700,1240,43
NGORA,2025,560,730,1290,43
NTOROKO,2015,240,180,420,43
NTOROKO,2016,260,180,440,43
NTOROKO,2017,250,180,430,43
NTOROKO,2018,260,190,450,43
NTOROKO,2019,260,190,450,43
NTOROKO,2020,270,190,460,43
NTOROKO,2021,270,200,470,43
NTOROKO,2022,280,210,490,43
NTOROKO,2023,290,220,510,43
NTOROKO,2024,300,220,520,43
NTOROKO,2025,310,230,540,43
NTUNGAMO,2015,1490,1610,3100,43
NTUNGAMO,2016,1520,1640,3160,43
NTUNGAMO,2017,1560,1670,3230,43
NTUNGAMO,2018,1590,1700,3290,43
NTUNGAMO,2019,1620,1730,3350,43
NTUNGAMO,2020,1650,1760,3410,43
NTUNGAMO,2021,1690,1790,3480,43
NTUNGAMO,2022,1720,1810,3530,43
NTUNGAMO,2023,1750,1840,3590,43
NTUNGAMO,2024,1780,1870,3650,43
NTUNGAMO,2025,1810,1890,3700,43
NWOYA,2015,400,430,830,43
NWOYA,2016,440,480,920,43
NWOYA,2017,480,530,1010,43
NWOYA,2018,540,580,1120,43
NWOYA,2019,590,640,1230,43
NWOYA,2020,650,700,1350,43
NWOYA,2021,720,770,1490,43
NWOYA,2022,790,850,1640,43
NWOYA,2023,870,930,1800,43
NWOYA,2024,960,1020,1980,43
NWOYA,2025,1050,1120,2170,43
OBONGI,2015,130,150,280,43
OBONGI,2016,130,150,280,43
OBONGI,2017,140,160,300,43
OBONGI,2018,140,160,300,43
OBONGI,2019,130,160,290,43
OBONGI,2020,150,170,320,43
OBONGI,2021,150,180,330,43
OBONGI,2022,150,190,340,43
OBONGI,2023,150,190,340,43
OBONGI,2024,160,190,350,43
OBONGI,2025,170,210,380,43
OMORO,2015,600,710,1310,43
OMORO,2016,610,740,1350,43
OMORO,2017,630,770,1400,43
OMORO,2018,640,790,1430,43
OMORO,2019,660,820,1480,43
OMORO,2020,680,850,1530,43
OMORO,2021,710,900,1610,43
OMORO,2022,740,940,1680,43
OMORO,2023,770,990,1760,43
OMORO,2024,810,1050,1860,43
OMORO,2025,850,1100,1950,43
OTUKE,2015,290,300,590,43
OTUKE,2016,300,310,610,43
OTUKE,2017,310,330,640,43
OTUKE,2018,330,340,670,43
OTUKE,2019,340,350,690,43
OTUKE,2020,360,370,730,43
OTUKE,2021,370,380,750,43
OTUKE,2022,390,400,790,43
OTUKE,2023,410,420,830,43
OTUKE,2024,420,430,850,43
OTUKE,2025,440,450,890,43
OYAM,2015,1100,1180,2280,43
OYAM,2016,1130,1210,2340,43
OYAM,2017,1170,1250,2420,43
OYAM,2018,1200,1280,2480,43
OYAM,2019,1240,1320,2560,43
OYAM,2020,1270,1360,2630,43
OYAM,2021,1310,1400,2710,43
OYAM,2022,1340,1430,2770,43
OYAM,2023,1380,1470,2850,43
OYAM,2024,1420,1510,2930,43
OYAM,2025,1450,1540,2990,43
PADER,2015,710,710,1420,43
PADER,2016,710,740,1450,43
PADER,2017,710,750,1460,43
PADER,2018,710,760,1470,43
PADER,2019,720,780,1500,43
PADER,2020,730,800,1530,43
PADER,2021,740,830,1570,43
PADER,2022,750,840,1590,43
PADER,2023,770,880,1650,43
PADER,2024,800,910,1710,43
PADER,2025,820,950,1770,43
PAKWACH,2015,420,480,900,43
PAKWACH,2016,440,500,940,43
PAKWACH,2017,460,510,970,43
PAKWACH,2018,470,530,1000,43
PAKWACH,2019,490,550,1040,43
PAKWACH,2020,510,570,1080,43
PAKWACH,2021,530,590,1120,43
PAKWACH,2022,550,610,1160,43
PAKWACH,2023,580,630,1210,43
PAKWACH,2024,600,650,1250,43
PAKWACH,2025,620,670,1290,43
PALLISA,2015,890,1050,1940,43
PALLISA,2016,920,1110,2030,43
PALLISA,2017,950,1150,2100,43
PALLISA,2018,970,1200,2170,43
PALLISA,2019,1010,1260,2270,43
PALLISA,2020,1040,1310,2350,43
PALLISA,2021,1100,1390,2490,43
PALLISA,2022,1160,1470,2630,43
PALLISA,2023,1220,1560,2780,43
PALLISA,2024,1290,1670,2960,43
PALLISA,2025,1360,1770,3130,43
RAKAI,2015,1010,1070,2080,43
RAKAI,2016,1030,1110,2140,43
RAKAI,2017,1050,1120,2170,43
RAKAI,2018,1060,1150,2210,43
RAKAI,2019,1070,1180,2250,43
RAKAI,2020,1090,1210,2300,43
RAKAI,2021,1120,1260,2380,43
RAKAI,2022,1160,1320,2480,43
RAKAI,2023,1210,1360,2570,43
RAKAI,2024,1250,1420,2670,43
RAKAI,2025,1300,1480,2780,43
RUBANDA,2015,530,770,1300,43
RUBANDA,2016,540,780,1320,43
RUBANDA,2017,540,790,1330,43
RUBANDA,2018,550,790,1340,43
RUBANDA,2019,560,800,1360,43
RUBANDA,2020,560,800,1360,43
RUBANDA,2021,570,810,1380,43
RUBANDA,2022,580,810,1390,43
RUBANDA,2023,580,820,1400,43
RUBANDA,2024,590,820,1410,43
RUBANDA,2025,590,820,1410,43
RUBIRIZI,2015,340,470,810,43
RUBIRIZI,2016,340,480,820,43
RUBIRIZI,2017,350,490,840,43
RUBIRIZI,2018,360,500,860,43
RUBIRIZI,2019,360,510,870,43
RUBIRIZI,2020,370,520,890,43
RUBIRIZI,2021,380,520,900,43
RUBIRIZI,2022,380,530,910,43
RUBIRIZI,2023,390,540,930,43
RUBIRIZI,2024,400,550,950,43
RUBIRIZI,2025,400,560,960,43
RUKIGA,2015,310,380,690,43
RUKIGA,2016,310,380,690,43
RUKIGA,2017,310,380,690,43
RUKIGA,2018,320,380,700,43
RUKIGA,2019,320,390,710,43
RUKIGA,2020,320,390,710,43
RUKIGA,2021,320,390,710,43
RUKIGA,2022,330,390,720,43
RUKIGA,2023,330,390,720,43
RUKIGA,2024,330,400,730,43
RUKIGA,2025,330,400,730,43
RUKUNGIRI,2015,910,1170,2080,43
RUKUNGIRI,2016,920,1180,2100,43
RUKUNGIRI,2017,930,1190,2120,43
RUKUNGIRI,2018,940,1200,2140,43
RUKUNGIRI,2019,950,1210,2160,43
RUKUNGIRI,2020,960,1220,2180,43
RUKUNGIRI,2021,970,1230,2200,43
RUKUNGIRI,2022,980,1240,2220,43
RUKUNGIRI,2023,990,1250,2240,43
RUKUNGIRI,2024,990,1250,2240,43
RUKUNGIRI,2025,1000,1260,2260,43
RWAMPARA,2015,360,450,810,43
RWAMPARA,2016,370,460,830,43
RWAMPARA,2017,370,470,840,43
RWAMPARA,2018,380,480,860,43
RWAMPARA,2019,390,480,870,43
RWAMPARA,2020,400,490,890,43
RWAMPARA,2021,410,500,910,43
RWAMPARA,2022,420,510,930,43
RWAMPARA,2023,420,520,940,43
RWAMPARA,2024,430,530,960,43
RWAMPARA,2025,440,540,980,43
SERERE,2015,990,980,1970,43
SERERE,2016,1020,1030,2050,43
SERERE,2017,1050,1070,2120,43
SERERE,2018,1070,1100,2170,43
SERERE,2019,1110,1150,2260,43
SERERE,2020,1150,1200,2350,43
SERERE,2021,1190,1260,2450,43
SERERE,2022,1260,1330,2590,43
SERERE,2023,1320,1420,2740,43
SERERE,2024,1390,1490,2880,43
SERERE,2025,1460,1590,3050,43
SHEEMA,2015,670,720,1390,43
SHEEMA,2016,680,730,1410,43
SHEEMA,2017,690,740,1430,43
SHEEMA,2018,700,740,1440,43
SHEEMA,2019,710,750,1460,43
SHEEMA,2020,710,760,1470,43
SHEEMA,2021,720,760,1480,43
SHEEMA,2022,730,770,1500,43
SHEEMA,2023,730,780,1510,43
SHEEMA,2024,740,780,1520,43
SHEEMA,2025,740,790,1530,43
SIRONKO,2015,690,650,1340,43
SIRONKO,2016,700,670,1370,43
SIRONKO,2017,720,680,1400,43
SIRONKO,2018,740,690,1430,43
SIRONKO,2019,750,710,1460,43
SIRONKO,2020,770,720,1490,43
SIRONKO,2021,790,730,1520,43
SIRONKO,2022,800,750,1550,43
SIRONKO,2023,820,760,1580,43
SIRONKO,2024,840,770,1610,43
SIRONKO,2025,850,780,1630,43
SOROTI,2015,870,1130,2000,43
SOROTI,2016,930,1210,2140,43
SOROTI,2017,970,1300,2270,43
SOROTI,2018,1000,1350,2350,43
SOROTI,2019,1020,1400,2420,43
SOROTI,2020,1040,1440,2480,43
SOROTI,2021,1070,1500,2570,43
SOROTI,2022,1100,1560,2660,43
SOROTI,2023,1140,1640,2780,43
SOROTI,2024,1200,1720,2920,43
SOROTI,2025,1250,1810,3060,43
SSEMBABULE,2015,950,950,1900,43
SSEMBABULE,2016,980,970,1950,43
SSEMBABULE,2017,990,1000,1990,43
SSEMBABULE,2018,1000,1020,2020,43
SSEMBABULE,2019,1020,1050,2070,43
SSEMBABULE,2020,1040,1090,2130,43
SSEMBABULE,2021,1080,1140,2220,43
SSEMBABULE,2022,1120,1190,2310,43
SSEMBABULE,2023,1160,1240,2400,43
SSEMBABULE,2024,1220,1300,2520,43
SSEMBABULE,2025,1260,1360,2620,43
TORORO,2015,1600,1630,3230,43
TORORO,2016,1640,1670,3310,43
TORORO,2017,1680,1710,3390,43
TORORO,2018,1730,1750,3480,43
TORORO,2019,1770,1800,3570,43
TORORO,2020,1820,1840,3660,43
TORORO,2021,1860,1880,3740,43
TORORO,2022,1900,1920,3820,43
TORORO,2023,1950,1970,3920,43
TORORO,2024,1990,2010,4000,43
TORORO,2025,2030,2050,4080,43
WAKISO,2015,5930,5010,10940,43
WAKISO,2016,6330,5350,11680,43
WAKISO,2017,6750,5720,12470,43
WAKISO,2018,7200,6110,13310,43
WAKISO,2019,7680,6520,14200,43
WAKISO,2020,8180,6950,15130,43
WAKISO,2021,8700,7410,16110,43
WAKISO,2022,9260,7900,17160,43
WAKISO,2023,9850,8410,18260,43
WAKISO,2024,10460,8940,19400,43
WAKISO,2025,11110,9510,20620,43
YUMBE,2015,1140,1200,2340,43
YUMBE,2016,1200,1290,2490,43
YUMBE,2017,1240,1350,2590,43
YUMBE,2018,1280,1430,2710,43
YUMBE,2019,1330,1520,2850,43
YUMBE,2020,1390,1630,3020,43
YUMBE,2021,1460,1740,3200,43
YUMBE,2022,1550,1870,3420,43
YUMBE,2023,1650,2030,3680,43
YUMBE,2024,1760,2180,3940,43
YUMBE,2025,1860,2350,4210,43
ZOMBO,2015,700,770,1470,43
ZOMBO,2016,720,790,1510,43
ZOMBO,2017,740,810,1550,43
ZOMBO,2018,760,830,1590,43
ZOMBO,2019,780,850,1630,43
ZOMBO,2020,810,880,1690,43
ZOMBO,2021,830,900,1730,43
ZOMBO,2022,850,920,1770,43
ZOMBO,2023,880,940,1820,43
ZOMBO,2024,900,970,1870,43
ZOMBO,2025,920,990,1910,43
ABIM,2015,310,300,610,44
ABIM,2016,330,330,660,44
ABIM,2017,340,350,690,44
ABIM,2018,360,370,730,44
ABIM,2019,380,390,770,44
ABIM,2020,400,420,820,44
ABIM,2021,420,450,870,44
ABIM,2022,450,480,930,44
ABIM,2023,490,520,1010,44
ABIM,2024,520,570,1090,44
ABIM,2025,560,610,1170,44
ADJUMANI,2015,490,640,1130,44
ADJUMANI,2016,500,640,1140,44
ADJUMANI,2017,500,650,1150,44
ADJUMANI,2018,500,650,1150,44
ADJUMANI,2019,510,660,1170,44
ADJUMANI,2020,510,670,1180,44
ADJUMANI,2021,510,670,1180,44
ADJUMANI,2022,510,670,1180,44
ADJUMANI,2023,520,680,1200,44
ADJUMANI,2024,520,680,1200,44
ADJUMANI,2025,520,690,1210,44
AGAGO,2015,610,690,1300,44
AGAGO,2016,620,700,1320,44
AGAGO,2017,630,710,1340,44
AGAGO,2018,640,720,1360,44
AGAGO,2019,650,740,1390,44
AGAGO,2020,660,750,1410,44
AGAGO,2021,670,760,1430,44
AGAGO,2022,680,770,1450,44
AGAGO,2023,690,780,1470,44
AGAGO,2024,700,790,1490,44
AGAGO,2025,710,800,1510,44
ALEBTONG,2015,640,820,1460,44
ALEBTONG,2016,670,870,1540,44
ALEBTONG,2017,690,900,1590,44
ALEBTONG,2018,700,920,1620,44
ALEBTONG,2019,700,950,1650,44
ALEBTONG,2020,710,970,1680,44
ALEBTONG,2021,730,1010,1740,44
ALEBTONG,2022,740,1050,1790,44
ALEBTONG,2023,780,1090,1870,44
ALEBTONG,2024,810,1140,1950,44
ALEBTONG,2025,840,1200,2040,44
AMOLATAR,2015,470,450,920,44
AMOLATAR,2016,480,480,960,44
AMOLATAR,2017,490,490,980,44
AMOLATAR,2018,510,500,1010,44
AMOLATAR,2019,510,510,1020,44
AMOLATAR,2020,510,530,1040,44
AMOLATAR,2021,520,550,1070,44
AMOLATAR,2022,540,570,1110,44
AMOLATAR,2023,550,590,1140,44
AMOLATAR,2024,580,600,1180,44
AMOLATAR,2025,600,630,1230,44
AMUDAT,2015,350,300,650,44
AMUDAT,2016,370,320,690,44
AMUDAT,2017,380,340,720,44
AMUDAT,2018,380,350,730,44
AMUDAT,2019,400,370,770,44
AMUDAT,2020,400,380,780,44
AMUDAT,2021,420,410,830,44
AMUDAT,2022,440,430,870,44
AMUDAT,2023,450,470,920,44
AMUDAT,2024,480,490,970,44
AMUDAT,2025,500,530,1030,44
AMURIA,2015,520,640,1160,44
AMURIA,2016,540,670,1210,44
AMURIA,2017,560,700,1260,44
AMURIA,2018,570,720,1290,44
AMURIA,2019,590,740,1330,44
AMURIA,2020,600,770,1370,44
AMURIA,2021,620,810,1430,44
AMURIA,2022,650,850,1500,44
AMURIA,2023,680,890,1570,44
AMURIA,2024,710,940,1650,44
AMURIA,2025,740,990,1730,44
AMURU,2015,480,570,1050,44
AMURU,2016,510,610,1120,44
AMURU,2017,510,620,1130,44
AMURU,2018,520,640,1160,44
AMURU,2019,520,660,1180,44
AMURU,2020,520,670,1190,44
AMURU,2021,540,690,1230,44
AMURU,2022,560,730,1290,44
AMURU,2023,580,750,1330,44
AMURU,2024,600,780,1380,44
AMURU,2025,620,830,1450,44
APAC,2015,530,490,1020,44
APAC,2016,550,510,1060,44
APAC,2017,570,530,1100,44
APAC,2018,590,550,1140,44
APAC,2019,610,560,1170,44
APAC,2020,630,580,1210,44
APAC,2021,660,600,1260,44
APAC,2022,680,620,1300,44
APAC,2023,700,640,1340,44
APAC,2024,720,660,1380,44
APAC,2025,750,680,1430,44
ARUA,2015,1530,1840,3370,44
ARUA,2016,1570,1890,3460,44
ARUA,2017,1610,1940,3550,44
ARUA,2018,1660,1990,3650,44
ARUA,2019,1710,2050,3760,44
ARUA,2020,1750,2100,3850,44
ARUA,2021,1800,2150,3950,44
ARUA,2022,1850,2200,4050,44
ARUA,2023,1890,2260,4150,44
ARUA,2024,1940,2310,4250,44
ARUA,2025,1990,2360,4350,44
BUDAKA,2015,750,880,1630,44
BUDAKA,2016,780,930,1710,44
BUDAKA,2017,810,970,1780,44
BUDAKA,2018,820,1010,1830,44
BUDAKA,2019,840,1030,1870,44
BUDAKA,2020,850,1070,1920,44
BUDAKA,2021,880,1110,1990,44
BUDAKA,2022,920,1170,2090,44
BUDAKA,2023,960,1230,2190,44
BUDAKA,2024,1000,1300,2300,44
BUDAKA,2025,1050,1370,2420,44
BUDUDA,2015,1110,940,2050,44
BUDUDA,2016,1180,1010,2190,44
BUDUDA,2017,1230,1070,2300,44
BUDUDA,2018,1270,1100,2370,44
BUDUDA,2019,1300,1150,2450,44
BUDUDA,2020,1340,1210,2550,44
BUDUDA,2021,1400,1270,2670,44
BUDUDA,2022,1470,1340,2810,44
BUDUDA,2023,1550,1430,2980,44
BUDUDA,2024,1640,1520,3160,44
BUDUDA,2025,1720,1620,3340,44
BUGIRI,2015,1230,1440,2670,44
BUGIRI,2016,1300,1540,2840,44
BUGIRI,2017,1350,1610,2960,44
BUGIRI,2018,1370,1670,3040,44
BUGIRI,2019,1400,1740,3140,44
BUGIRI,2020,1450,1800,3250,44
BUGIRI,2021,1500,1890,3390,44
BUGIRI,2022,1560,1980,3540,44
BUGIRI,2023,1650,2100,3750,44
BUGIRI,2024,1730,2230,3960,44
BUGIRI,2025,1820,2340,4160,44
BUGWERI,2015,420,590,1010,44
BUGWERI,2016,440,620,1060,44
BUGWERI,2017,450,650,1100,44
BUGWERI,2018,450,660,1110,44
BUGWERI,2019,450,670,1120,44
BUGWERI,2020,460,700,1160,44
BUGWERI,2021,480,710,1190,44
BUGWERI,2022,490,740,1230,44
BUGWERI,2023,510,780,1290,44
BUGWERI,2024,530,810,1340,44
BUGWERI,2025,550,840,1390,44
BUHWEJU,2015,380,470,850,44
BUHWEJU,2016,390,480,870,44
BUHWEJU,2017,400,500,900,44
BUHWEJU,2018,420,510,930,44
BUHWEJU,2019,430,530,960,44
BUHWEJU,2020,440,540,980,44
BUHWEJU,2021,460,560,1020,44
BUHWEJU,2022,470,580,1050,44
BUHWEJU,2023,480,590,1070,44
BUHWEJU,2024,500,610,1110,44
BUHWEJU,2025,510,620,1130,44
BUIKWE,2015,1190,1250,2440,44
BUIKWE,2016,1240,1310,2550,44
BUIKWE,2017,1260,1350,2610,44
BUIKWE,2018,1260,1370,2630,44
BUIKWE,2019,1270,1400,2670,44
BUIKWE,2020,1280,1430,2710,44
BUIKWE,2021,1300,1470,2770,44
BUIKWE,2022,1320,1520,2840,44
BUIKWE,2023,1360,1570,2930,44
BUIKWE,2024,1410,1630,3040,44
BUIKWE,2025,1450,1700,3150,44
BUKEDEA,2015,770,790,1560,44
BUKEDEA,2016,820,850,1670,44
BUKEDEA,2017,860,890,1750,44
BUKEDEA,2018,880,920,1800,44
BUKEDEA,2019,890,960,1850,44
BUKEDEA,2020,930,1000,1930,44
BUKEDEA,2021,970,1040,2010,44
BUKEDEA,2022,1010,1100,2110,44
BUKEDEA,2023,1060,1170,2230,44
BUKEDEA,2024,1120,1230,2350,44
BUKEDEA,2025,1190,1300,2490,44
BUKOMANSIMBI,2015,410,570,980,44
BUKOMANSIMBI,2016,410,600,1010,44
BUKOMANSIMBI,2017,420,600,1020,44
BUKOMANSIMBI,2018,420,600,1020,44
BUKOMANSIMBI,2019,410,600,1010,44
BUKOMANSIMBI,2020,400,600,1000,44
BUKOMANSIMBI,2021,410,610,1020,44
BUKOMANSIMBI,2022,420,630,1050,44
BUKOMANSIMBI,2023,420,640,1060,44
BUKOMANSIMBI,2024,430,660,1090,44
BUKOMANSIMBI,2025,430,670,1100,44
BUKWO,2015,290,340,630,44
BUKWO,2016,300,350,650,44
BUKWO,2017,320,370,690,44
BUKWO,2018,330,390,720,44
BUKWO,2019,350,410,760,44
BUKWO,2020,370,430,800,44
BUKWO,2021,390,450,840,44
BUKWO,2022,410,470,880,44
BUKWO,2023,430,490,920,44
BUKWO,2024,450,510,960,44
BUKWO,2025,470,530,1000,44
BULAMBULI,2015,940,840,1780,44
BULAMBULI,2016,1000,890,1890,44
BULAMBULI,2017,1040,950,1990,44
BULAMBULI,2018,1080,1000,2080,44
BULAMBULI,2019,1100,1040,2140,44
BULAMBULI,2020,1150,1090,2240,44
BULAMBULI,2021,1200,1150,2350,44
BULAMBULI,2022,1270,1220,2490,44
BULAMBULI,2023,1340,1310,2650,44
BULAMBULI,2024,1420,1390,2810,44
BULAMBULI,2025,1500,1490,2990,44
BULIISA,2015,370,290,660,44
BULIISA,2016,390,310,700,44
BULIISA,2017,410,320,730,44
BULIISA,2018,430,330,760,44
BULIISA,2019,450,350,800,44
BULIISA,2020,470,360,830,44
BULIISA,2021,500,380,880,44
BULIISA,2022,520,390,910,44
BULIISA,2023,550,410,960,44
BULIISA,2024,580,430,1010,44
BULIISA,2025,610,440,1050,44
BUNDIBUGYO,2015,650,680,1330,44
BUNDIBUGYO,2016,680,730,1410,44
BUNDIBUGYO,2017,700,750,1450,44
BUNDIBUGYO,2018,710,770,1480,44
BUNDIBUGYO,2019,710,790,1500,44
BUNDIBUGYO,2020,720,800,1520,44
BUNDIBUGYO,2021,740,840,1580,44
BUNDIBUGYO,2022,770,870,1640,44
BUNDIBUGYO,2023,800,910,1710,44
BUNDIBUGYO,2024,830,950,1780,44
BUNDIBUGYO,2025,870,1000,1870,44
BUNYANGABU,2015,500,530,1030,44
BUNYANGABU,2016,520,560,1080,44
BUNYANGABU,2017,530,580,1110,44
BUNYANGABU,2018,540,590,1130,44
BUNYANGABU,2019,540,600,1140,44
BUNYANGABU,2020,550,610,1160,44
BUNYANGABU,2021,560,630,1190,44
BUNYANGABU,2022,580,670,1250,44
BUNYANGABU,2023,600,690,1290,44
BUNYANGABU,2024,620,720,1340,44
BUNYANGABU,2025,640,740,1380,44
BUSHENYI,2015,850,900,1750,44
BUSHENYI,2016,860,910,1770,44
BUSHENYI,2017,870,920,1790,44
BUSHENYI,2018,880,930,1810,44
BUSHENYI,2019,890,930,1820,44
BUSHENYI,2020,900,940,1840,44
BUSHENYI,2021,910,950,1860,44
BUSHENYI,2022,920,950,1870,44
BUSHENYI,2023,930,960,1890,44
BUSHENYI,2024,940,960,1900,44
BUSHENYI,2025,940,970,1910,44
BUSIA,2015,1090,1140,2230,44
BUSIA,2016,1140,1200,2340,44
BUSIA,2017,1170,1250,2420,44
BUSIA,2018,1180,1280,2460,44
BUSIA,2019,1190,1320,2510,44
BUSIA,2020,1220,1360,2580,44
BUSIA,2021,1250,1410,2660,44
BUSIA,2022,1300,1470,2770,44
BUSIA,2023,1350,1530,2880,44
BUSIA,2024,1410,1610,3020,44
BUSIA,2025,1470,1680,3150,44
BUTALEJA,2015,880,1060,1940,44
BUTALEJA,2016,920,1120,2040,44
BUTALEJA,2017,950,1170,2120,44
BUTALEJA,2018,970,1210,2180,44
BUTALEJA,2019,980,1240,2220,44
BUTALEJA,2020,1010,1300,2310,44
BUTALEJA,2021,1050,1340,2390,44
BUTALEJA,2022,1080,1420,2500,44
BUTALEJA,2023,1140,1480,2620,44
BUTALEJA,2024,1190,1570,2760,44
BUTALEJA,2025,1250,1660,2910,44
BUTAMBALA,2015,220,260,480,44
BUTAMBALA,2016,220,260,480,44
BUTAMBALA,2017,220,260,480,44
BUTAMBALA,2018,220,280,500,44
BUTAMBALA,2019,220,280,500,44
BUTAMBALA,2020,220,280,500,44
BUTAMBALA,2021,220,280,500,44
BUTAMBALA,2022,230,280,510,44
BUTAMBALA,2023,230,290,520,44
BUTAMBALA,2024,240,310,550,44
BUTAMBALA,2025,240,320,560,44
BUTEBO,2015,390,460,850,44
BUTEBO,2016,390,490,880,44
BUTEBO,2017,400,490,890,44
BUTEBO,2018,390,500,890,44
BUTEBO,2019,400,500,900,44
BUTEBO,2020,390,520,910,44
BUTEBO,2021,400,520,920,44
BUTEBO,2022,400,540,940,44
BUTEBO,2023,420,550,970,44
BUTEBO,2024,430,580,1010,44
BUTEBO,2025,440,590,1030,44
BUVUMA,2015,460,280,740,44
BUVUMA,2016,490,300,790,44
BUVUMA,2017,520,320,840,44
BUVUMA,2018,550,350,900,44
BUVUMA,2019,590,370,960,44
BUVUMA,2020,620,390,1010,44
BUVUMA,2021,660,420,1080,44
BUVUMA,2022,700,440,1140,44
BUVUMA,2023,740,470,1210,44
BUVUMA,2024,780,500,1280,44
BUVUMA,2025,820,540,1360,44
BUYENDE,2015,920,1080,2000,44
BUYENDE,2016,980,1160,2140,44
BUYENDE,2017,1020,1210,2230,44
BUYENDE,2018,1050,1260,2310,44
BUYENDE,2019,1070,1320,2390,44
BUYENDE,2020,1100,1370,2470,44
BUYENDE,2021,1150,1440,2590,44
BUYENDE,2022,1200,1530,2730,44
BUYENDE,2023,1280,1610,2890,44
BUYENDE,2024,1340,1710,3050,44
BUYENDE,2025,1410,1830,3240,44
DOKOLO,2015,490,540,1030,44
DOKOLO,2016,500,550,1050,44
DOKOLO,2017,520,570,1090,44
DOKOLO,2018,530,580,1110,44
DOKOLO,2019,550,600,1150,44
DOKOLO,2020,570,610,1180,44
DOKOLO,2021,580,630,1210,44
DOKOLO,2022,600,650,1250,44
DOKOLO,2023,610,660,1270,44
DOKOLO,2024,630,680,1310,44
DOKOLO,2025,650,690,1340,44
GOMBA,2015,570,510,1080,44
GOMBA,2016,590,540,1130,44
GOMBA,2017,590,540,1130,44
GOMBA,2018,600,550,1150,44
GOMBA,2019,600,550,1150,44
GOMBA,2020,600,560,1160,44
GOMBA,2021,600,570,1170,44
GOMBA,2022,610,590,1200,44
GOMBA,2023,630,600,1230,44
GOMBA,2024,650,630,1280,44
GOMBA,2025,670,640,1310,44
GULU,2015,760,780,1540,44
GULU,2016,780,800,1580,44
GULU,2017,800,820,1620,44
GULU,2018,830,850,1680,44
GULU,2019,850,870,1720,44
GULU,2020,880,900,1780,44
GULU,2021,900,920,1820,44
GULU,2022,920,940,1860,44
GULU,2023,950,970,1920,44
GULU,2024,970,990,1960,44
GULU,2025,1000,1020,2020,44
HOIMA,2015,970,960,1930,44
HOIMA,2016,1010,990,2000,44
HOIMA,2017,1050,1020,2070,44
HOIMA,2018,1090,1060,2150,44
HOIMA,2019,1130,1090,2220,44
HOIMA,2020,1170,1130,2300,44
HOIMA,2021,1210,1170,2380,44
HOIMA,2022,1250,1200,2450,44
HOIMA,2023,1290,1240,2530,44
HOIMA,2024,1340,1280,2620,44
HOIMA,2025,1380,1320,2700,44
IBANDA,2015,860,1000,1860,44
IBANDA,2016,870,1010,1880,44
IBANDA,2017,890,1030,1920,44
IBANDA,2018,910,1050,1960,44
IBANDA,2019,930,1070,2000,44
IBANDA,2020,940,1090,2030,44
IBANDA,2021,960,1100,2060,44
IBANDA,2022,980,1120,2100,44
IBANDA,2023,990,1140,2130,44
IBANDA,2024,1010,1150,2160,44
IBANDA,2025,1020,1170,2190,44
IGANGA,2015,940,1090,2030,44
IGANGA,2016,990,1160,2150,44
IGANGA,2017,1020,1200,2220,44
IGANGA,2018,1030,1240,2270,44
IGANGA,2019,1050,1260,2310,44
IGANGA,2020,1070,1300,2370,44
IGANGA,2021,1100,1340,2440,44
IGANGA,2022,1130,1400,2530,44
IGANGA,2023,1180,1470,2650,44
IGANGA,2024,1230,1540,2770,44
IGANGA,2025,1280,1620,2900,44
ISINGIRO,2015,1670,1870,3540,44
ISINGIRO,2016,1730,1940,3670,44
ISINGIRO,2017,1800,2000,3800,44
ISINGIRO,2018,1860,2070,3930,44
ISINGIRO,2019,1930,2150,4080,44
ISINGIRO,2020,2000,2220,4220,44
ISINGIRO,2021,2070,2290,4360,44
ISINGIRO,2022,2140,2370,4510,44
ISINGIRO,2023,2210,2440,4650,44
ISINGIRO,2024,2290,2520,4810,44
ISINGIRO,2025,2360,2590,4950,44
JINJA,2015,1420,1310,2730,44
JINJA,2016,1450,1330,2780,44
JINJA,2017,1470,1350,2820,44
JINJA,2018,1500,1370,2870,44
JINJA,2019,1520,1390,2910,44
JINJA,2020,1540,1410,2950,44
JINJA,2021,1570,1430,3000,44
JINJA,2022,1590,1450,3040,44
JINJA,2023,1610,1470,3080,44
JINJA,2024,1630,1480,3110,44
JINJA,2025,1650,1500,3150,44
KAABONG,2015,250,310,560,44
KAABONG,2016,250,320,570,44
KAABONG,2017,260,330,590,44
KAABONG,2018,270,340,610,44
KAABONG,2019,280,340,620,44
KAABONG,2020,280,350,630,44
KAABONG,2021,290,360,650,44
KAABONG,2022,300,370,670,44
KAABONG,2023,300,380,680,44
KAABONG,2024,310,380,690,44
KAABONG,2025,320,390,710,44
KABALE,2015,810,1000,1810,44
KABALE,2016,820,1010,1830,44
KABALE,2017,830,1020,1850,44
KABALE,2018,850,1030,1880,44
KABALE,2019,860,1040,1900,44
KABALE,2020,870,1060,1930,44
KABALE,2021,880,1070,1950,44
KABALE,2022,890,1080,1970,44
KABALE,2023,900,1090,1990,44
KABALE,2024,910,1090,2000,44
KABALE,2025,920,1100,2020,44
KABAROLE,2015,890,820,1710,44
KABAROLE,2016,910,840,1750,44
KABAROLE,2017,930,860,1790,44
KABAROLE,2018,950,880,1830,44
KABAROLE,2019,970,890,1860,44
KABAROLE,2020,990,910,1900,44
KABAROLE,2021,1010,930,1940,44
KABAROLE,2022,1030,950,1980,44
KABAROLE,2023,1050,970,2020,44
KABAROLE,2024,1070,980,2050,44
KABAROLE,2025,1080,1000,2080,44
KABERAMAIDO,2015,350,350,700,44
KABERAMAIDO,2016,370,370,740,44
KABERAMAIDO,2017,380,380,760,44
KABERAMAIDO,2018,390,410,800,44
KABERAMAIDO,2019,410,420,830,44
KABERAMAIDO,2020,420,430,850,44
KABERAMAIDO,2021,440,450,890,44
KABERAMAIDO,2022,450,480,930,44
KABERAMAIDO,2023,480,500,980,44
KABERAMAIDO,2024,510,540,1050,44
KABERAMAIDO,2025,520,570,1090,44
KAGADI,2015,1040,1160,2200,44
KAGADI,2016,1080,1210,2290,44
KAGADI,2017,1120,1250,2370,44
KAGADI,2018,1160,1290,2450,44
KAGADI,2019,1210,1340,2550,44
KAGADI,2020,1250,1380,2630,44
KAGADI,2021,1290,1430,2720,44
KAGADI,2022,1340,1470,2810,44
KAGADI,2023,1380,1520,2900,44
KAGADI,2024,1420,1570,2990,44
KAGADI,2025,1470,1620,3090,44
KAKUMIRO,2015,1040,910,1950,44
KAKUMIRO,2016,1130,990,2120,44
KAKUMIRO,2017,1230,1070,2300,44
KAKUMIRO,2018,1340,1160,2500,44
KAKUMIRO,2019,1460,1260,2720,44
KAKUMIRO,2020,1580,1360,2940,44
KAKUMIRO,2021,1720,1470,3190,44
KAKUMIRO,2022,1870,1590,3460,44
KAKUMIRO,2023,2020,1720,3740,44
KAKUMIRO,2024,2190,1860,4050,44
KAKUMIRO,2025,2380,2000,4380,44
KALAKI,2015,330,360,690,44
KALAKI,2016,350,380,730,44
KALAKI,2017,360,390,750,44
KALAKI,2018,380,410,790,44
KALAKI,2019,390,430,820,44
KALAKI,2020,410,440,850,44
KALAKI,2021,430,460,890,44
KALAKI,2022,450,470,920,44
KALAKI,2023,460,490,950,44
KALAKI,2024,480,510,990,44
KALAKI,2025,500,530,1030,44
KALANGALA,2015,410,140,550,44
KALANGALA,2016,420,150,570,44
KALANGALA,2017,440,150,590,44
KALANGALA,2018,450,160,610,44
KALANGALA,2019,470,160,630,44
KALANGALA,2020,490,170,660,44
KALANGALA,2021,500,180,680,44
KALANGALA,2022,520,180,700,44
KALANGALA,2023,530,190,720,44
KALANGALA,2024,550,200,750,44
KALANGALA,2025,570,210,780,44
KALIRO,2015,740,750,1490,44
KALIRO,2016,780,800,1580,44
KALIRO,2017,800,840,1640,44
KALIRO,2018,820,860,1680,44
KALIRO,2019,840,900,1740,44
KALIRO,2020,850,920,1770,44
KALIRO,2021,880,970,1850,44
KALIRO,2022,920,1010,1930,44
KALIRO,2023,950,1070,2020,44
KALIRO,2024,1000,1120,2120,44
KALIRO,2025,1050,1180,2230,44
KALUNGU,2015,520,570,1090,44
KALUNGU,2016,530,600,1130,44
KALUNGU,2017,540,600,1140,44
KALUNGU,2018,540,610,1150,44
KALUNGU,2019,530,610,1140,44
KALUNGU,2020,540,620,1160,44
KALUNGU,2021,530,630,1160,44
KALUNGU,2022,540,640,1180,44
KALUNGU,2023,550,670,1220,44
KALUNGU,2024,560,680,1240,44
KALUNGU,2025,580,700,1280,44
KAMPALA,2015,4490,4080,8570,44
KAMPALA,2016,4580,4160,8740,44
KAMPALA,2017,4670,4240,8910,44
KAMPALA,2018,4760,4320,9080,44
KAMPALA,2019,4850,4410,9260,44
KAMPALA,2020,4940,4480,9420,44
KAMPALA,2021,5030,4560,9590,44
KAMPALA,2022,5110,4640,9750,44
KAMPALA,2023,5190,4710,9900,44
KAMPALA,2024,5270,4790,10060,44
KAMPALA,2025,5350,4860,10210,44
KAMULI,2015,1440,1750,3190,44
KAMULI,2016,1510,1850,3360,44
KAMULI,2017,1530,1900,3430,44
KAMULI,2018,1550,1940,3490,44
KAMULI,2019,1560,1970,3530,44
KAMULI,2020,1580,2030,3610,44
KAMULI,2021,1610,2080,3690,44
KAMULI,2022,1660,2170,3830,44
KAMULI,2023,1720,2250,3970,44
KAMULI,2024,1790,2340,4130,44
KAMULI,2025,1850,2450,4300,44
KAMWENGE,2015,830,910,1740,44
KAMWENGE,2016,870,950,1820,44
KAMWENGE,2017,900,980,1880,44
KAMWENGE,2018,940,1010,1950,44
KAMWENGE,2019,980,1050,2030,44
KAMWENGE,2020,1010,1090,2100,44
KAMWENGE,2021,1050,1120,2170,44
KAMWENGE,2022,1090,1160,2250,44
KAMWENGE,2023,1130,1200,2330,44
KAMWENGE,2024,1170,1240,2410,44
KAMWENGE,2025,1210,1270,2480,44
KANUNGU,2015,810,940,1750,44
KANUNGU,2016,820,960,1780,44
KANUNGU,2017,840,980,1820,44
KANUNGU,2018,850,990,1840,44
KANUNGU,2019,870,1010,1880,44
KANUNGU,2020,880,1020,1900,44
KANUNGU,2021,890,1040,1930,44
KANUNGU,2022,910,1050,1960,44
KANUNGU,2023,920,1060,1980,44
KANUNGU,2024,930,1080,2010,44
KANUNGU,2025,950,1090,2040,44
KAPCHORWA,2015,440,400,840,44
KAPCHORWA,2016,450,410,860,44
KAPCHORWA,2017,460,420,880,44
KAPCHORWA,2018,480,430,910,44
KAPCHORWA,2019,490,440,930,44
KAPCHORWA,2020,510,450,960,44
KAPCHORWA,2021,520,470,990,44
KAPCHORWA,2022,530,480,1010,44
KAPCHORWA,2023,550,490,1040,44
KAPCHORWA,2024,560,500,1060,44
KAPCHORWA,2025,580,510,1090,44
KAPELEBYONG,2015,250,280,530,44
KAPELEBYONG,2016,250,300,550,44
KAPELEBYONG,2017,260,310,570,44
KAPELEBYONG,2018,270,320,590,44
KAPELEBYONG,2019,280,320,600,44
KAPELEBYONG,2020,280,340,620,44
KAPELEBYONG,2021,280,350,630,44
KAPELEBYONG,2022,300,360,660,44
KAPELEBYONG,2023,310,380,690,44
KAPELEBYONG,2024,330,400,730,44
KAPELEBYONG,2025,330,420,750,44
KASESE,2015,2020,2200,4220,44
KASESE,2016,2090,2310,4400,44
KASESE,2017,2140,2390,4530,44
KASESE,2018,2150,2430,4580,44
KASESE,2019,2160,2480,4640,44
KASESE,2020,2200,2530,4730,44
KASESE,2021,2230,2620,4850,44
KASESE,2022,2300,2710,5010,44
KASESE,2023,2380,2820,5200,44
KASESE,2024,2460,2930,5390,44
KASESE,2025,2540,3050,5590,44
KASSANDA,2015,840,850,1690,44
KASSANDA,2016,870,870,1740,44
KASSANDA,2017,890,890,1780,44
KASSANDA,2018,910,900,1810,44
KASSANDA,2019,940,920,1860,44
KASSANDA,2020,970,940,1910,44
KASSANDA,2021,990,960,1950,44
KASSANDA,2022,1020,980,2000,44
KASSANDA,2023,1040,1000,2040,44
KASSANDA,2024,1070,1010,2080,44
KASSANDA,2025,1090,1030,2120,44
KATAKWI,2015,570,560,1130,44
KATAKWI,2016,590,600,1190,44
KATAKWI,2017,610,610,1220,44
KATAKWI,2018,620,620,1240,44
KATAKWI,2019,620,630,1250,44
KATAKWI,2020,630,660,1290,44
KATAKWI,2021,650,680,1330,44
KATAKWI,2022,670,700,1370,44
KATAKWI,2023,700,730,1430,44
KATAKWI,2024,720,770,1490,44
KATAKWI,2025,750,800,1550,44
KAYUNGA,2015,1130,1210,2340,44
KAYUNGA,2016,1170,1260,2430,44
KAYUNGA,2017,1190,1300,2490,44
KAYUNGA,2018,1190,1320,2510,44
KAYUNGA,2019,1190,1330,2520,44
KAYUNGA,2020,1200,1360,2560,44
KAYUNGA,2021,1220,1390,2610,44
KAYUNGA,2022,1250,1430,2680,44
KAYUNGA,2023,1290,1480,2770,44
KAYUNGA,2024,1320,1530,2850,44
KAYUNGA,2025,1360,1590,2950,44
KAZO,2015,700,710,1410,44
KAZO,2016,720,730,1450,44
KAZO,2017,750,760,1510,44
KAZO,2018,780,790,1570,44
KAZO,2019,810,810,1620,44
KAZO,2020,830,840,1670,44
KAZO,2021,870,870,1740,44
KAZO,2022,900,900,1800,44
KAZO,2023,930,920,1850,44
KAZO,2024,960,950,1910,44
KAZO,2025,990,980,1970,44
KIBAALE,2015,450,440,890,44
KIBAALE,2016,480,460,940,44
KIBAALE,2017,510,490,1000,44
KIBAALE,2018,540,520,1060,44
KIBAALE,2019,580,550,1130,44
KIBAALE,2020,610,580,1190,44
KIBAALE,2021,650,610,1260,44
KIBAALE,2022,690,640,1330,44
KIBAALE,2023,730,680,1410,44
KIBAALE,2024,770,720,1490,44
KIBAALE,2025,820,750,1570,44
KIBOGA,2015,490,430,920,44
KIBOGA,2016,510,460,970,44
KIBOGA,2017,530,480,1010,44
KIBOGA,2018,550,490,1040,44
KIBOGA,2019,540,510,1050,44
KIBOGA,2020,550,510,1060,44
KIBOGA,2021,560,530,1090,44
KIBOGA,2022,580,550,1130,44
KIBOGA,2023,590,570,1160,44
KIBOGA,2024,610,590,1200,44
KIBOGA,2025,630,610,1240,44
KIBUKU,2015,730,920,1650,44
KIBUKU,2016,770,980,1750,44
KIBUKU,2017,790,1020,1810,44
KIBUKU,2018,810,1060,1870,44
KIBUKU,2019,830,1090,1920,44
KIBUKU,2020,850,1140,1990,44
KIBUKU,2021,870,1190,2060,44
KIBUKU,2022,910,1240,2150,44
KIBUKU,2023,950,1320,2270,44
KIBUKU,2024,1000,1390,2390,44
KIBUKU,2025,1060,1460,2520,44
KIKUUBE,2015,900,810,1710,44
KIKUUBE,2016,950,850,1800,44
KIKUUBE,2017,1000,890,1890,44
KIKUUBE,2018,1050,940,1990,44
KIKUUBE,2019,1110,980,2090,44
KIKUUBE,2020,1160,1030,2190,44
KIKUUBE,2021,1220,1080,2300,44
KIKUUBE,2022,1290,1140,2430,44
KIKUUBE,2023,1350,1190,2540,44
KIKUUBE,2024,1420,1250,2670,44
KIKUUBE,2025,1480,1300,2780,44
KIRUHURA,2015,640,530,1170,44
KIRUHURA,2016,660,550,1210,44
KIRUHURA,2017,690,570,1260,44
KIRUHURA,2018,710,590,1300,44
KIRUHURA,2019,740,610,1350,44
KIRUHURA,2020,770,630,1400,44
KIRUHURA,2021,790,650,1440,44
KIRUHURA,2022,820,670,1490,44
KIRUHURA,2023,850,690,1540,44
KIRUHURA,2024,880,710,1590,44
KIRUHURA,2025,900,730,1630,44
KIRYANDONGO,2015,770,790,1560,44
KIRYANDONGO,2016,820,840,1660,44
KIRYANDONGO,2017,850,890,1740,44
KIRYANDONGO,2018,870,920,1790,44
KIRYANDONGO,2019,890,940,1830,44
KIRYANDONGO,2020,900,970,1870,44
KIRYANDONGO,2021,910,1000,1910,44
KIRYANDONGO,2022,940,1030,1970,44
KIRYANDONGO,2023,970,1070,2040,44
KIRYANDONGO,2024,1010,1120,2130,44
KIRYANDONGO,2025,1050,1180,2230,44
KISORO,2015,700,1210,1910,44
KISORO,2016,720,1260,1980,44
KISORO,2017,740,1300,2040,44
KISORO,2018,740,1330,2070,44
KISORO,2019,740,1350,2090,44
KISORO,2020,750,1380,2130,44
KISORO,2021,760,1420,2180,44
KISORO,2022,780,1470,2250,44
KISORO,2023,800,1520,2320,44
KISORO,2024,830,1580,2410,44
KISORO,2025,850,1630,2480,44
KITAGWENDA,2015,480,540,1020,44
KITAGWENDA,2016,500,560,1060,44
KITAGWENDA,2017,520,580,1100,44
KITAGWENDA,2018,550,610,1160,44
KITAGWENDA,2019,570,630,1200,44
KITAGWENDA,2020,590,650,1240,44
KITAGWENDA,2021,610,670,1280,44
KITAGWENDA,2022,640,690,1330,44
KITAGWENDA,2023,660,710,1370,44
KITAGWENDA,2024,680,740,1420,44
KITAGWENDA,2025,710,760,1470,44
KITGUM,2015,520,620,1140,44
KITGUM,2016,530,640,1170,44
KITGUM,2017,540,650,1190,44
KITGUM,2018,540,660,1200,44
KITGUM,2019,540,670,1210,44
KITGUM,2020,540,680,1220,44
KITGUM,2021,540,700,1240,44
KITGUM,2022,560,710,1270,44
KITGUM,2023,580,740,1320,44
KITGUM,2024,580,770,1350,44
KITGUM,2025,600,800,1400,44
KOBOKO,2015,510,530,1040,44
KOBOKO,2016,540,570,1110,44
KOBOKO,2017,560,600,1160,44
KOBOKO,2018,570,620,1190,44
KOBOKO,2019,590,650,1240,44
KOBOKO,2020,600,670,1270,44
KOBOKO,2021,620,700,1320,44
KOBOKO,2022,650,740,1390,44
KOBOKO,2023,690,780,1470,44
KOBOKO,2024,720,820,1540,44
KOBOKO,2025,750,870,1620,44
KOLE,2015,640,720,1360,44
KOLE,2016,660,740,1400,44
KOLE,2017,680,760,1440,44
KOLE,2018,710,780,1490,44
KOLE,2019,730,800,1530,44
KOLE,2020,750,820,1570,44
KOLE,2021,770,850,1620,44
KOLE,2022,800,870,1670,44
KOLE,2023,820,890,1710,44
KOLE,2024,840,910,1750,44
KOLE,2025,860,930,1790,44
KOTIDO,2015,510,620,1130,44
KOTIDO,2016,530,640,1170,44
KOTIDO,2017,540,660,1200,44
KOTIDO,2018,540,670,1210,44
KOTIDO,2019,540,680,1220,44
KOTIDO,2020,560,710,1270,44
KOTIDO,2021,570,730,1300,44
KOTIDO,2022,580,750,1330,44
KOTIDO,2023,600,780,1380,44
KOTIDO,2024,620,810,1430,44
KOTIDO,2025,640,840,1480,44
KUMI,2015,800,860,1660,44
KUMI,2016,830,910,1740,44
KUMI,2017,860,950,1810,44
KUMI,2018,870,970,1840,44
KUMI,2019,880,990,1870,44
KUMI,2020,900,1020,1920,44
KUMI,2021,930,1070,2000,44
KUMI,2022,950,1110,2060,44
KUMI,2023,1000,1160,2160,44
KUMI,2024,1030,1210,2240,44
KUMI,2025,1080,1280,2360,44
KWANIA,2015,530,520,1050,44
KWANIA,2016,550,530,1080,44
KWANIA,2017,560,550,1110,44
KWANIA,2018,580,570,1150,44
KWANIA,2019,600,580,1180,44
KWANIA,2020,610,600,1210,44
KWANIA,2021,630,610,1240,44
KWANIA,2022,650,630,1280,44
KWANIA,2023,670,640,1310,44
KWANIA,2024,680,660,1340,44
KWANIA,2025,700,680,1380,44
KWEEN,2015,320,350,670,44
KWEEN,2016,330,350,680,44
KWEEN,2017,340,360,700,44
KWEEN,2018,350,370,720,44
KWEEN,2019,360,380,740,44
KWEEN,2020,370,390,760,44
KWEEN,2021,380,400,780,44
KWEEN,2022,390,410,800,44
KWEEN,2023,400,420,820,44
KWEEN,2024,420,430,850,44
KWEEN,2025,430,430,860,44
KYANKWANZI,2015,810,630,1440,44
KYANKWANZI,2016,850,660,1510,44
KYANKWANZI,2017,890,690,1580,44
KYANKWANZI,2018,940,720,1660,44
KYANKWANZI,2019,990,750,1740,44
KYANKWANZI,2020,1030,790,1820,44
KYANKWANZI,2021,1080,820,1900,44
KYANKWANZI,2022,1140,860,2000,44
KYANKWANZI,2023,1190,900,2090,44
KYANKWANZI,2024,1250,930,2180,44
KYANKWANZI,2025,1300,970,2270,44
KYEGEGWA,2015,950,1030,1980,44
KYEGEGWA,2016,1030,1110,2140,44
KYEGEGWA,2017,1120,1200,2320,44
KYEGEGWA,2018,1210,1290,2500,44
KYEGEGWA,2019,1310,1390,2700,44
KYEGEGWA,2020,1410,1500,2910,44
KYEGEGWA,2021,1530,1620,3150,44
KYEGEGWA,2022,1650,1740,3390,44
KYEGEGWA,2023,1770,1870,3640,44
KYEGEGWA,2024,1910,2010,3920,44
KYEGEGWA,2025,2060,2160,4220,44
KYENJOJO,2015,1310,1250,2560,44
KYENJOJO,2016,1360,1300,2660,44
KYENJOJO,2017,1420,1350,2770,44
KYENJOJO,2018,1480,1400,2880,44
KYENJOJO,2019,1540,1450,2990,44
KYENJOJO,2020,1600,1500,3100,44
KYENJOJO,2021,1660,1550,3210,44
KYENJOJO,2022,1720,1600,3320,44
KYENJOJO,2023,1790,1660,3450,44
KYENJOJO,2024,1850,1710,3560,44
KYENJOJO,2025,1920,1770,3690,44
KYOTERA,2015,820,730,1550,44
KYOTERA,2016,850,760,1610,44
KYOTERA,2017,860,770,1630,44
KYOTERA,2018,850,780,1630,44
KYOTERA,2019,850,790,1640,44
KYOTERA,2020,860,800,1660,44
KYOTERA,2021,870,820,1690,44
KYOTERA,2022,890,840,1730,44
KYOTERA,2023,910,870,1780,44
KYOTERA,2024,930,900,1830,44
KYOTERA,2025,960,920,1880,44
KARENGA,2015,210,210,420,44
KARENGA,2016,210,220,430,44
KARENGA,2017,220,220,440,44
KARENGA,2018,230,230,460,44
KARENGA,2019,230,230,460,44
KARENGA,2020,240,240,480,44
KARENGA,2021,240,250,490,44
KARENGA,2022,250,250,500,44
KARENGA,2023,250,260,510,44
KARENGA,2024,260,260,520,44
KARENGA,2025,260,270,530,44
LAMWO,2015,330,380,710,44
LAMWO,2016,330,390,720,44
LAMWO,2017,330,410,740,44
LAMWO,2018,340,410,750,44
LAMWO,2019,330,420,750,44
LAMWO,2020,330,420,750,44
LAMWO,2021,340,440,780,44
LAMWO,2022,340,440,780,44
LAMWO,2023,340,450,790,44
LAMWO,2024,350,480,830,44
LAMWO,2025,350,490,840,44
LIRA,2015,1020,1060,2080,44
LIRA,2016,1050,1090,2140,44
LIRA,2017,1080,1120,2200,44
LIRA,2018,1110,1150,2260,44
LIRA,2019,1140,1180,2320,44
LIRA,2020,1170,1210,2380,44
LIRA,2021,1200,1240,2440,44
LIRA,2022,1230,1280,2510,44
LIRA,2023,1260,1310,2570,44
LIRA,2024,1290,1340,2630,44
LIRA,2025,1320,1370,2690,44
LUUKA,2015,690,940,1630,44
LUUKA,2016,710,990,1700,44
LUUKA,2017,730,1020,1750,44
LUUKA,2018,730,1030,1760,44
LUUKA,2019,740,1050,1790,44
LUUKA,2020,740,1070,1810,44
LUUKA,2021,750,1100,1850,44
LUUKA,2022,770,1130,1900,44
LUUKA,2023,800,1180,1980,44
LUUKA,2024,820,1230,2050,44
LUUKA,2025,840,1280,2120,44
LUWERO,2015,1480,1460,2940,44
LUWERO,2016,1540,1540,3080,44
LUWERO,2017,1570,1570,3140,44
LUWERO,2018,1590,1610,3200,44
LUWERO,2019,1590,1640,3230,44
LUWERO,2020,1620,1680,3300,44
LUWERO,2021,1640,1730,3370,44
LUWERO,2022,1700,1800,3500,44
LUWERO,2023,1750,1870,3620,44
LUWERO,2024,1820,1940,3760,44
LUWERO,2025,1880,2030,3910,44
LWENGO,2015,910,950,1860,44
LWENGO,2016,930,980,1910,44
LWENGO,2017,930,1000,1930,44
LWENGO,2018,920,1010,1930,44
LWENGO,2019,920,1020,1940,44
LWENGO,2020,920,1020,1940,44
LWENGO,2021,930,1040,1970,44
LWENGO,2022,930,1060,1990,44
LWENGO,2023,950,1090,2040,44
LWENGO,2024,980,1120,2100,44
LWENGO,2025,990,1160,2150,44
LYANTONDE,2015,300,280,580,44
LYANTONDE,2016,320,310,630,44
LYANTONDE,2017,330,320,650,44
LYANTONDE,2018,350,340,690,44
LYANTONDE,2019,360,360,720,44
LYANTONDE,2020,360,360,720,44
LYANTONDE,2021,370,370,740,44
LYANTONDE,2022,380,390,770,44
LYANTONDE,2023,390,410,800,44
LYANTONDE,2024,390,410,800,44
LYANTONDE,2025,410,440,850,44
MANAFWA,2015,620,570,1190,44
MANAFWA,2016,630,590,1220,44
MANAFWA,2017,650,600,1250,44
MANAFWA,2018,660,610,1270,44
MANAFWA,2019,680,630,1310,44
MANAFWA,2020,700,640,1340,44
MANAFWA,2021,710,650,1360,44
MANAFWA,2022,730,670,1400,44
MANAFWA,2023,740,680,1420,44
MANAFWA,2024,760,690,1450,44
MANAFWA,2025,770,700,1470,44
MARACHA,2015,490,620,1110,44
MARACHA,2016,500,640,1140,44
MARACHA,2017,510,650,1160,44
MARACHA,2018,520,660,1180,44
MARACHA,2019,530,670,1200,44
MARACHA,2020,540,680,1220,44
MARACHA,2021,550,700,1250,44
MARACHA,2022,560,710,1270,44
MARACHA,2023,570,720,1290,44
MARACHA,2024,580,730,1310,44
MARACHA,2025,590,740,1330,44
MASAKA,2015,800,780,1580,44
MASAKA,2016,840,830,1670,44
MASAKA,2017,890,880,1770,44
MASAKA,2018,930,920,1850,44
MASAKA,2019,950,960,1910,44
MASAKA,2020,950,970,1920,44
MASAKA,2021,960,980,1940,44
MASAKA,2022,970,1020,1990,44
MASAKA,2023,980,1040,2020,44
MASAKA,2024,1010,1070,2080,44
MASAKA,2025,1030,1110,2140,44
MASINDI,2015,980,820,1800,44
MASINDI,2016,1010,840,1850,44
MASINDI,2017,1040,870,1910,44
MASINDI,2018,1070,890,1960,44
MASINDI,2019,1100,910,2010,44
MASINDI,2020,1130,930,2060,44
MASINDI,2021,1160,960,2120,44
MASINDI,2022,1190,980,2170,44
MASINDI,2023,1220,1000,2220,44
MASINDI,2024,1250,1030,2280,44
MASINDI,2025,1280,1050,2330,44
MAYUGE,2015,1410,1610,3020,44
MAYUGE,2016,1480,1720,3200,44
MAYUGE,2017,1520,1780,3300,44
MAYUGE,2018,1540,1830,3370,44
MAYUGE,2019,1560,1880,3440,44
MAYUGE,2020,1590,1940,3530,44
MAYUGE,2021,1630,2010,3640,44
MAYUGE,2022,1700,2110,3810,44
MAYUGE,2023,1760,2210,3970,44
MAYUGE,2024,1840,2320,4160,44
MAYUGE,2025,1920,2440,4360,44
MBALE,2015,1980,2090,4070,44
MBALE,2016,2070,2220,4290,44
MBALE,2017,2110,2310,4420,44
MBALE,2018,2150,2370,4520,44
MBALE,2019,2180,2450,4630,44
MBALE,2020,2220,2530,4750,44
MBALE,2021,2280,2640,4920,44
MBALE,2022,2350,2760,5110,44
MBALE,2023,2440,2910,5350,44
MBALE,2024,2540,3050,5590,44
MBALE,2025,2640,3210,5850,44
MBARARA,2015,1280,1270,2550,44
MBARARA,2016,1310,1290,2600,44
MBARARA,2017,1340,1320,2660,44
MBARARA,2018,1370,1350,2720,44
MBARARA,2019,1400,1380,2780,44
MBARARA,2020,1430,1410,2840,44
MBARARA,2021,1460,1430,2890,44
MBARARA,2022,1480,1460,2940,44
MBARARA,2023,1520,1490,3010,44
MBARARA,2024,1540,1510,3050,44
MBARARA,2025,1570,1540,3110,44
MITOOMA,2015,490,690,1180,44
MITOOMA,2016,500,700,1200,44
MITOOMA,2017,500,710,1210,44
MITOOMA,2018,510,710,1220,44
MITOOMA,2019,520,720,1240,44
MITOOMA,2020,520,730,1250,44
MITOOMA,2021,530,730,1260,44
MITOOMA,2022,530,740,1270,44
MITOOMA,2023,540,740,1280,44
MITOOMA,2024,540,740,1280,44
MITOOMA,2025,540,750,1290,44
MITYANA,2015,1030,1090,2120,44
MITYANA,2016,1070,1130,2200,44
MITYANA,2017,1090,1170,2260,44
MITYANA,2018,1080,1180,2260,44
MITYANA,2019,1080,1200,2280,44
MITYANA,2020,1090,1210,2300,44
MITYANA,2021,1110,1250,2360,44
MITYANA,2022,1130,1280,2410,44
MITYANA,2023,1160,1320,2480,44
MITYANA,2024,1190,1380,2570,44
MITYANA,2025,1230,1420,2650,44
MOROTO,2015,310,440,750,44
MOROTO,2016,320,460,780,44
MOROTO,2017,320,480,800,44
MOROTO,2018,330,490,820,44
MOROTO,2019,330,500,830,44
MOROTO,2020,330,520,850,44
MOROTO,2021,340,530,870,44
MOROTO,2022,350,550,900,44
MOROTO,2023,350,580,930,44
MOROTO,2024,370,600,970,44
MOROTO,2025,380,630,1010,44
MOYO,2015,270,300,570,44
MOYO,2016,270,310,580,44
MOYO,2017,280,310,590,44
MOYO,2018,290,320,610,44
MOYO,2019,300,330,630,44
MOYO,2020,300,330,630,44
MOYO,2021,310,340,650,44
MOYO,2022,320,350,670,44
MOYO,2023,320,350,670,44
MOYO,2024,330,360,690,44
MOYO,2025,340,370,710,44
MPIGI,2015,810,730,1540,44
MPIGI,2016,840,760,1600,44
MPIGI,2017,860,790,1650,44
MPIGI,2018,870,800,1670,44
MPIGI,2019,860,830,1690,44
MPIGI,2020,870,840,1710,44
MPIGI,2021,890,870,1760,44
MPIGI,2022,920,900,1820,44
MPIGI,2023,950,940,1890,44
MPIGI,2024,980,980,1960,44
MPIGI,2025,1010,1030,2040,44
MUBENDE,2015,1430,1460,2890,44
MUBENDE,2016,1520,1570,3090,44
MUBENDE,2017,1600,1670,3270,44
MUBENDE,2018,1650,1750,3400,44
MUBENDE,2019,1710,1830,3540,44
MUBENDE,2020,1780,1930,3710,44
MUBENDE,2021,1860,2050,3910,44
MUBENDE,2022,1970,2180,4150,44
MUBENDE,2023,2100,2330,4430,44
MUBENDE,2024,2240,2500,4740,44
MUBENDE,2025,2370,2670,5040,44
MUKONO,2015,1840,1820,3660,44
MUKONO,2016,1920,1920,3840,44
MUKONO,2017,1950,1990,3940,44
MUKONO,2018,1980,2050,4030,44
MUKONO,2019,2000,2110,4110,44
MUKONO,2020,2030,2170,4200,44
MUKONO,2021,2080,2240,4320,44
MUKONO,2022,2140,2340,4480,44
MUKONO,2023,2220,2450,4670,44
MUKONO,2024,2300,2570,4870,44
MUKONO,2025,2390,2700,5090,44
MADI OKOLLO,2015,330,390,720,44
MADI OKOLLO,2016,340,410,750,44
MADI OKOLLO,2017,350,410,760,44
MADI OKOLLO,2018,360,430,790,44
MADI OKOLLO,2019,370,440,810,44
MADI OKOLLO,2020,380,450,830,44
MADI OKOLLO,2021,390,460,850,44
MADI OKOLLO,2022,400,470,870,44
MADI OKOLLO,2023,410,480,890,44
MADI OKOLLO,2024,420,490,910,44
MADI OKOLLO,2025,430,510,940,44
NABILATUK,2015,160,220,380,44
NABILATUK,2016,160,230,390,44
NABILATUK,2017,170,240,410,44
NABILATUK,2018,180,250,430,44
NABILATUK,2019,190,260,450,44
NABILATUK,2020,200,280,480,44
NABILATUK,2021,210,290,500,44
NABILATUK,2022,220,310,530,44
NABILATUK,2023,220,330,550,44
NABILATUK,2024,240,350,590,44
NABILATUK,2025,250,370,620,44
NAKAPIRIPIRIT,2015,280,300,580,44
NAKAPIRIPIRIT,2016,300,320,620,44
NAKAPIRIPIRIT,2017,310,340,650,44
NAKAPIRIPIRIT,2018,310,360,670,44
NAKAPIRIPIRIT,2019,330,370,700,44
NAKAPIRIPIRIT,2020,340,380,720,44
NAKAPIRIPIRIT,2021,350,400,750,44
NAKAPIRIPIRIT,2022,370,430,800,44
NAKAPIRIPIRIT,2023,390,450,840,44
NAKAPIRIPIRIT,2024,400,490,890,44
NAKAPIRIPIRIT,2025,430,510,940,44
NAKASEKE,2015,810,490,1300,44
NAKASEKE,2016,840,510,1350,44
NAKASEKE,2017,870,520,1390,44
NAKASEKE,2018,900,530,1430,44
NAKASEKE,2019,940,540,1480,44
NAKASEKE,2020,970,550,1520,44
NAKASEKE,2021,1000,570,1570,44
NAKASEKE,2022,1040,580,1620,44
NAKASEKE,2023,1070,590,1660,44
NAKASEKE,2024,1110,600,1710,44
NAKASEKE,2025,1140,610,1750,44
NAKASONGOLA,2015,720,620,1340,44
NAKASONGOLA,2016,750,640,1390,44
NAKASONGOLA,2017,780,670,1450,44
NAKASONGOLA,2018,790,680,1470,44
NAKASONGOLA,2019,800,690,1490,44
NAKASONGOLA,2020,810,720,1530,44
NAKASONGOLA,2021,840,740,1580,44
NAKASONGOLA,2022,860,780,1640,44
NAKASONGOLA,2023,900,810,1710,44
NAKASONGOLA,2024,930,850,1780,44
NAKASONGOLA,2025,980,880,1860,44
NAMAYINGO,2015,750,720,1470,44
NAMAYINGO,2016,770,750,1520,44
NAMAYINGO,2017,780,770,1550,44
NAMAYINGO,2018,790,780,1570,44
NAMAYINGO,2019,780,790,1570,44
NAMAYINGO,2020,790,800,1590,44
NAMAYINGO,2021,790,820,1610,44
NAMAYINGO,2022,820,850,1670,44
NAMAYINGO,2023,840,870,1710,44
NAMAYINGO,2024,870,900,1770,44
NAMAYINGO,2025,890,930,1820,44
NAMISINDWA,2015,830,770,1600,44
NAMISINDWA,2016,850,790,1640,44
NAMISINDWA,2017,880,810,1690,44
NAMISINDWA,2018,900,830,1730,44
NAMISINDWA,2019,930,850,1780,44
NAMISINDWA,2020,950,860,1810,44
NAMISINDWA,2021,970,880,1850,44
NAMISINDWA,2022,1000,900,1900,44
NAMISINDWA,2023,1020,920,1940,44
NAMISINDWA,2024,1050,940,1990,44
NAMISINDWA,2025,1070,960,2030,44
NAMUTUMBA,2015,760,890,1650,44
NAMUTUMBA,2016,790,940,1730,44
NAMUTUMBA,2017,820,990,1810,44
NAMUTUMBA,2018,840,1020,1860,44
NAMUTUMBA,2019,850,1040,1890,44
NAMUTUMBA,2020,870,1080,1950,44
NAMUTUMBA,2021,900,1130,2030,44
NAMUTUMBA,2022,930,1170,2100,44
NAMUTUMBA,2023,980,1230,2210,44
NAMUTUMBA,2024,1020,1300,2320,44
NAMUTUMBA,2025,1070,1370,2440,44
NAPAK,2015,330,500,830,44
NAPAK,2016,340,520,860,44
NAPAK,2017,340,530,870,44
NAPAK,2018,350,540,890,44
NAPAK,2019,340,550,890,44
NAPAK,2020,350,560,910,44
NAPAK,2021,350,580,930,44
NAPAK,2022,360,600,960,44
NAPAK,2023,370,630,1000,44
NAPAK,2024,370,660,1030,44
NAPAK,2025,390,670,1060,44
NEBBI,2015,690,800,1490,44
NEBBI,2016,720,830,1550,44
NEBBI,2017,740,850,1590,44
NEBBI,2018,760,870,1630,44
NEBBI,2019,790,900,1690,44
NEBBI,2020,810,920,1730,44
NEBBI,2021,830,950,1780,44
NEBBI,2022,860,970,1830,44
NEBBI,2023,880,990,1870,44
NEBBI,2024,910,1020,1930,44
NEBBI,2025,930,1040,1970,44
NGORA,2015,430,450,880,44
NGORA,2016,450,480,930,44
NGORA,2017,460,490,950,44
NGORA,2018,460,500,960,44
NGORA,2019,470,510,980,44
NGORA,2020,480,540,1020,44
NGORA,2021,490,560,1050,44
NGORA,2022,500,580,1080,44
NGORA,2023,520,600,1120,44
NGORA,2024,540,630,1170,44
NGORA,2025,570,660,1230,44
NTOROKO,2015,260,190,450,44
NTOROKO,2016,260,190,450,44
NTOROKO,2017,270,190,460,44
NTOROKO,2018,280,200,480,44
NTOROKO,2019,280,200,480,44
NTOROKO,2020,280,200,480,44
NTOROKO,2021,280,220,500,44
NTOROKO,2022,300,220,520,44
NTOROKO,2023,310,230,540,44
NTOROKO,2024,310,230,540,44
NTOROKO,2025,330,250,580,44
NTUNGAMO,2015,1540,1940,3480,44
NTUNGAMO,2016,1570,1970,3540,44
NTUNGAMO,2017,1600,2010,3610,44
NTUNGAMO,2018,1640,2040,3680,44
NTUNGAMO,2019,1670,2080,3750,44
NTUNGAMO,2020,1710,2120,3830,44
NTUNGAMO,2021,1740,2150,3890,44
NTUNGAMO,2022,1770,2180,3950,44
NTUNGAMO,2023,1800,2220,4020,44
NTUNGAMO,2024,1830,2250,4080,44
NTUNGAMO,2025,1860,2280,4140,44
NWOYA,2015,370,370,740,44
NWOYA,2016,410,410,820,44
NWOYA,2017,450,450,900,44
NWOYA,2018,500,490,990,44
NWOYA,2019,550,540,1090,44
NWOYA,2020,610,600,1210,44
NWOYA,2021,670,660,1330,44
NWOYA,2022,740,720,1460,44
NWOYA,2023,820,790,1610,44
NWOYA,2024,900,870,1770,44
NWOYA,2025,990,950,1940,44
OBONGI,2015,130,130,260,44
OBONGI,2016,140,130,270,44
OBONGI,2017,140,130,270,44
OBONGI,2018,130,140,270,44
OBONGI,2019,130,140,270,44
OBONGI,2020,140,140,280,44
OBONGI,2021,140,150,290,44
OBONGI,2022,140,160,300,44
OBONGI,2023,160,160,320,44
OBONGI,2024,160,170,330,44
OBONGI,2025,160,170,330,44
OMORO,2015,470,560,1030,44
OMORO,2016,480,580,1060,44
OMORO,2017,500,610,1110,44
OMORO,2018,510,640,1150,44
OMORO,2019,520,660,1180,44
OMORO,2020,520,670,1190,44
OMORO,2021,540,700,1240,44
OMORO,2022,570,740,1310,44
OMORO,2023,600,780,1380,44
OMORO,2024,620,820,1440,44
OMORO,2025,650,870,1520,44
OTUKE,2015,300,300,600,44
OTUKE,2016,310,310,620,44
OTUKE,2017,330,320,650,44
OTUKE,2018,340,340,680,44
OTUKE,2019,360,350,710,44
OTUKE,2020,370,360,730,44
OTUKE,2021,390,380,770,44
OTUKE,2022,400,390,790,44
OTUKE,2023,420,410,830,44
OTUKE,2024,440,430,870,44
OTUKE,2025,450,440,890,44
OYAM,2015,1150,1180,2330,44
OYAM,2016,1180,1210,2390,44
OYAM,2017,1220,1250,2470,44
OYAM,2018,1250,1280,2530,44
OYAM,2019,1290,1320,2610,44
OYAM,2020,1330,1360,2690,44
OYAM,2021,1370,1400,2770,44
OYAM,2022,1400,1430,2830,44
OYAM,2023,1440,1470,2910,44
OYAM,2024,1480,1510,2990,44
OYAM,2025,1520,1540,3060,44
PADER,2015,480,480,960,44
PADER,2016,480,500,980,44
PADER,2017,490,520,1010,44
PADER,2018,490,520,1010,44
PADER,2019,500,530,1030,44
PADER,2020,490,540,1030,44
PADER,2021,500,560,1060,44
PADER,2022,510,570,1080,44
PADER,2023,530,590,1120,44
PADER,2024,540,620,1160,44
PADER,2025,560,630,1190,44
PAKWACH,2015,440,510,950,44
PAKWACH,2016,460,530,990,44
PAKWACH,2017,480,550,1030,44
PAKWACH,2018,500,570,1070,44
PAKWACH,2019,520,590,1110,44
PAKWACH,2020,540,610,1150,44
PAKWACH,2021,560,630,1190,44
PAKWACH,2022,590,650,1240,44
PAKWACH,2023,610,670,1280,44
PAKWACH,2024,630,690,1320,44
PAKWACH,2025,650,720,1370,44
PALLISA,2015,970,1040,2010,44
PALLISA,2016,1020,1120,2140,44
PALLISA,2017,1060,1180,2240,44
PALLISA,2018,1090,1240,2330,44
PALLISA,2019,1120,1280,2400,44
PALLISA,2020,1160,1330,2490,44
PALLISA,2021,1200,1410,2610,44
PALLISA,2022,1260,1490,2750,44
PALLISA,2023,1330,1590,2920,44
PALLISA,2024,1410,1670,3080,44
PALLISA,2025,1480,1780,3260,44
RAKAI,2015,1030,1010,2040,44
RAKAI,2016,1070,1060,2130,44
RAKAI,2017,1100,1110,2210,44
RAKAI,2018,1110,1130,2240,44
RAKAI,2019,1120,1150,2270,44
RAKAI,2020,1140,1180,2320,44
RAKAI,2021,1150,1210,2360,44
RAKAI,2022,1190,1260,2450,44
RAKAI,2023,1230,1310,2540,44
RAKAI,2024,1270,1360,2630,44
RAKAI,2025,1320,1410,2730,44
RUBANDA,2015,540,890,1430,44
RUBANDA,2016,550,890,1440,44
RUBANDA,2017,550,900,1450,44
RUBANDA,2018,560,910,1470,44
RUBANDA,2019,570,920,1490,44
RUBANDA,2020,580,920,1500,44
RUBANDA,2021,580,930,1510,44
RUBANDA,2022,590,930,1520,44
RUBANDA,2023,590,940,1530,44
RUBANDA,2024,600,940,1540,44
RUBANDA,2025,600,940,1540,44
RUBIRIZI,2015,380,460,840,44
RUBIRIZI,2016,390,460,850,44
RUBIRIZI,2017,400,470,870,44
RUBIRIZI,2018,410,480,890,44
RUBIRIZI,2019,420,490,910,44
RUBIRIZI,2020,420,500,920,44
RUBIRIZI,2021,430,510,940,44
RUBIRIZI,2022,440,520,960,44
RUBIRIZI,2023,450,520,970,44
RUBIRIZI,2024,450,530,980,44
RUBIRIZI,2025,460,540,1000,44
RUKIGA,2015,340,440,780,44
RUKIGA,2016,340,440,780,44
RUKIGA,2017,350,440,790,44
RUKIGA,2018,350,450,800,44
RUKIGA,2019,350,450,800,44
RUKIGA,2020,360,450,810,44
RUKIGA,2021,360,450,810,44
RUKIGA,2022,360,460,820,44
RUKIGA,2023,360,460,820,44
RUKIGA,2024,370,460,830,44
RUKIGA,2025,370,460,830,44
RUKUNGIRI,2015,1070,1320,2390,44
RUKUNGIRI,2016,1080,1330,2410,44
RUKUNGIRI,2017,1100,1350,2450,44
RUKUNGIRI,2018,1110,1360,2470,44
RUKUNGIRI,2019,1120,1370,2490,44
RUKUNGIRI,2020,1130,1380,2510,44
RUKUNGIRI,2021,1140,1390,2530,44
RUKUNGIRI,2022,1150,1400,2550,44
RUKUNGIRI,2023,1160,1410,2570,44
RUKUNGIRI,2024,1170,1420,2590,44
RUKUNGIRI,2025,1180,1430,2610,44
RWAMPARA,2015,440,450,890,44
RWAMPARA,2016,450,460,910,44
RWAMPARA,2017,470,470,940,44
RWAMPARA,2018,480,480,960,44
RWAMPARA,2019,490,490,980,44
RWAMPARA,2020,500,500,1000,44
RWAMPARA,2021,510,510,1020,44
RWAMPARA,2022,520,520,1040,44
RWAMPARA,2023,530,530,1060,44
RWAMPARA,2024,540,540,1080,44
RWAMPARA,2025,550,550,1100,44
SERERE,2015,850,920,1770,44
SERERE,2016,900,980,1880,44
SERERE,2017,940,1030,1970,44
SERERE,2018,960,1070,2030,44
SERERE,2019,980,1100,2080,44
SERERE,2020,1010,1150,2160,44
SERERE,2021,1050,1200,2250,44
SERERE,2022,1090,1270,2360,44
SERERE,2023,1140,1350,2490,44
SERERE,2024,1200,1430,2630,44
SERERE,2025,1270,1500,2770,44
SHEEMA,2015,720,890,1610,44
SHEEMA,2016,720,900,1620,44
SHEEMA,2017,730,910,1640,44
SHEEMA,2018,740,920,1660,44
SHEEMA,2019,750,930,1680,44
SHEEMA,2020,760,930,1690,44
SHEEMA,2021,770,940,1710,44
SHEEMA,2022,770,950,1720,44
SHEEMA,2023,780,960,1740,44
SHEEMA,2024,790,960,1750,44
SHEEMA,2025,790,970,1760,44
SIRONKO,2015,1120,1040,2160,44
SIRONKO,2016,1140,1060,2200,44
SIRONKO,2017,1170,1080,2250,44
SIRONKO,2018,1200,1100,2300,44
SIRONKO,2019,1230,1120,2350,44
SIRONKO,2020,1250,1140,2390,44
SIRONKO,2021,1280,1160,2440,44
SIRONKO,2022,1310,1180,2490,44
SIRONKO,2023,1330,1200,2530,44
SIRONKO,2024,1360,1220,2580,44
SIRONKO,2025,1380,1240,2620,44
SOROTI,2015,840,800,1640,44
SOROTI,2016,910,870,1780,44
SOROTI,2017,970,950,1920,44
SOROTI,2018,1030,1000,2030,44
SOROTI,2019,1060,1050,2110,44
SOROTI,2020,1080,1080,2160,44
SOROTI,2021,1100,1120,2220,44
SOROTI,2022,1120,1150,2270,44
SOROTI,2023,1150,1210,2360,44
SOROTI,2024,1210,1270,2480,44
SOROTI,2025,1260,1330,2590,44
SSEMBABULE,2015,980,840,1820,44
SSEMBABULE,2016,1020,880,1900,44
SSEMBABULE,2017,1040,910,1950,44
SSEMBABULE,2018,1060,940,2000,44
SSEMBABULE,2019,1070,960,2030,44
SSEMBABULE,2020,1080,980,2060,44
SSEMBABULE,2021,1110,1020,2130,44
SSEMBABULE,2022,1150,1060,2210,44
SSEMBABULE,2023,1200,1110,2310,44
SSEMBABULE,2024,1250,1160,2410,44
SSEMBABULE,2025,1290,1210,2500,44
TORORO,2015,1770,1880,3650,44
TORORO,2016,1820,1930,3750,44
TORORO,2017,1860,1980,3840,44
TORORO,2018,1910,2030,3940,44
TORORO,2019,1960,2070,4030,44
TORORO,2020,2010,2120,4130,44
TORORO,2021,2060,2170,4230,44
TORORO,2022,2110,2220,4330,44
TORORO,2023,2160,2270,4430,44
TORORO,2024,2210,2320,4530,44
TORORO,2025,2250,2360,4610,44
WAKISO,2015,5680,4880,10560,44
WAKISO,2016,6060,5210,11270,44
WAKISO,2017,6460,5570,12030,44
WAKISO,2018,6890,5940,12830,44
WAKISO,2019,7350,6340,13690,44
WAKISO,2020,7830,6760,14590,44
WAKISO,2021,8330,7210,15540,44
WAKISO,2022,8870,7690,16560,44
WAKISO,2023,9430,8180,17610,44
WAKISO,2024,10020,8700,18720,44
WAKISO,2025,10630,9260,19890,44
YUMBE,2015,960,990,1950,44
YUMBE,2016,1020,1070,2090,44
YUMBE,2017,1060,1140,2200,44
YUMBE,2018,1100,1200,2300,44
YUMBE,2019,1140,1270,2410,44
YUMBE,2020,1180,1340,2520,44
YUMBE,2021,1240,1440,2680,44
YUMBE,2022,1300,1540,2840,44
YUMBE,2023,1390,1660,3050,44
YUMBE,2024,1470,1800,3270,44
YUMBE,2025,1560,1930,3490,44
ZOMBO,2015,680,860,1540,44
ZOMBO,2016,700,890,1590,44
ZOMBO,2017,730,910,1640,44
ZOMBO,2018,750,940,1690,44
ZOMBO,2019,770,960,1730,44
ZOMBO,2020,790,990,1780,44
ZOMBO,2021,810,1010,1820,44
ZOMBO,2022,840,1040,1880,44
ZOMBO,2023,860,1060,1920,44
ZOMBO,2024,880,1090,1970,44
ZOMBO,2025,910,1120,2030,44
ABIM,2015,300,350,650,45
ABIM,2016,330,380,710,45
ABIM,2017,350,420,770,45
ABIM,2018,370,450,820,45
ABIM,2019,390,470,860,45
ABIM,2020,410,500,910,45
ABIM,2021,440,530,970,45
ABIM,2022,460,570,1030,45
ABIM,2023,490,610,1100,45
ABIM,2024,520,660,1180,45
ABIM,2025,560,710,1270,45
ADJUMANI,2015,740,910,1650,45
ADJUMANI,2016,740,920,1660,45
ADJUMANI,2017,750,930,1680,45
ADJUMANI,2018,750,940,1690,45
ADJUMANI,2019,760,950,1710,45
ADJUMANI,2020,760,960,1720,45
ADJUMANI,2021,770,960,1730,45
ADJUMANI,2022,770,970,1740,45
ADJUMANI,2023,770,980,1750,45
ADJUMANI,2024,770,980,1750,45
ADJUMANI,2025,780,990,1770,45
AGAGO,2015,740,980,1720,45
AGAGO,2016,750,990,1740,45
AGAGO,2017,760,1010,1770,45
AGAGO,2018,780,1030,1810,45
AGAGO,2019,790,1050,1840,45
AGAGO,2020,800,1060,1860,45
AGAGO,2021,810,1080,1890,45
AGAGO,2022,830,1100,1930,45
AGAGO,2023,840,1110,1950,45
AGAGO,2024,850,1130,1980,45
AGAGO,2025,860,1140,2000,45
ALEBTONG,2015,740,870,1610,45
ALEBTONG,2016,780,930,1710,45
ALEBTONG,2017,810,980,1790,45
ALEBTONG,2018,830,1010,1840,45
ALEBTONG,2019,840,1040,1880,45
ALEBTONG,2020,850,1060,1910,45
ALEBTONG,2021,860,1090,1950,45
ALEBTONG,2022,890,1130,2020,45
ALEBTONG,2023,910,1180,2090,45
ALEBTONG,2024,940,1230,2170,45
ALEBTONG,2025,980,1290,2270,45
AMOLATAR,2015,450,500,950,45
AMOLATAR,2016,470,530,1000,45
AMOLATAR,2017,490,560,1050,45
AMOLATAR,2018,500,580,1080,45
AMOLATAR,2019,500,590,1090,45
AMOLATAR,2020,510,610,1120,45
AMOLATAR,2021,510,620,1130,45
AMOLATAR,2022,530,650,1180,45
AMOLATAR,2023,550,670,1220,45
AMOLATAR,2024,560,700,1260,45
AMOLATAR,2025,590,720,1310,45
AMUDAT,2015,340,250,590,45
AMUDAT,2016,360,270,630,45
AMUDAT,2017,380,290,670,45
AMUDAT,2018,400,310,710,45
AMUDAT,2019,400,320,720,45
AMUDAT,2020,410,340,750,45
AMUDAT,2021,420,350,770,45
AMUDAT,2022,440,370,810,45
AMUDAT,2023,460,400,860,45
AMUDAT,2024,480,420,900,45
AMUDAT,2025,510,440,950,45
AMURIA,2015,530,700,1230,45
AMURIA,2016,570,750,1320,45
AMURIA,2017,600,810,1410,45
AMURIA,2018,620,840,1460,45
AMURIA,2019,630,860,1490,45
AMURIA,2020,650,890,1540,45
AMURIA,2021,660,930,1590,45
AMURIA,2022,680,960,1640,45
AMURIA,2023,710,1010,1720,45
AMURIA,2024,740,1070,1810,45
AMURIA,2025,780,1120,1900,45
AMURU,2015,580,660,1240,45
AMURU,2016,610,710,1320,45
AMURU,2017,640,740,1380,45
AMURU,2018,650,770,1420,45
AMURU,2019,660,790,1450,45
AMURU,2020,670,810,1480,45
AMURU,2021,680,830,1510,45
AMURU,2022,690,860,1550,45
AMURU,2023,710,900,1610,45
AMURU,2024,740,940,1680,45
AMURU,2025,760,980,1740,45
APAC,2015,600,680,1280,45
APAC,2016,620,700,1320,45
APAC,2017,640,730,1370,45
APAC,2018,660,750,1410,45
APAC,2019,690,780,1470,45
APAC,2020,710,800,1510,45
APAC,2021,740,830,1570,45
APAC,2022,760,850,1610,45
APAC,2023,790,880,1670,45
APAC,2024,810,910,1720,45
APAC,2025,840,940,1780,45
ARUA,2015,2660,3280,5940,45
ARUA,2016,2740,3370,6110,45
ARUA,2017,2810,3470,6280,45
ARUA,2018,2890,3560,6450,45
ARUA,2019,2980,3650,6630,45
ARUA,2020,3060,3740,6800,45
ARUA,2021,3140,3840,6980,45
ARUA,2022,3220,3930,7150,45
ARUA,2023,3300,4030,7330,45
ARUA,2024,3380,4120,7500,45
ARUA,2025,3460,4210,7670,45
BUDAKA,2015,610,600,1210,45
BUDAKA,2016,650,650,1300,45
BUDAKA,2017,680,680,1360,45
BUDAKA,2018,700,720,1420,45
BUDAKA,2019,710,740,1450,45
BUDAKA,2020,720,760,1480,45
BUDAKA,2021,740,790,1530,45
BUDAKA,2022,760,820,1580,45
BUDAKA,2023,790,860,1650,45
BUDAKA,2024,830,910,1740,45
BUDAKA,2025,870,950,1820,45
BUDUDA,2015,500,510,1010,45
BUDUDA,2016,540,560,1100,45
BUDUDA,2017,570,600,1170,45
BUDUDA,2018,590,630,1220,45
BUDUDA,2019,610,660,1270,45
BUDUDA,2020,630,680,1310,45
BUDUDA,2021,650,720,1370,45
BUDUDA,2022,680,750,1430,45
BUDUDA,2023,710,800,1510,45
BUDUDA,2024,740,850,1590,45
BUDUDA,2025,790,900,1690,45
BUGIRI,2015,980,1210,2190,45
BUGIRI,2016,1050,1310,2360,45
BUGIRI,2017,1110,1390,2500,45
BUGIRI,2018,1160,1460,2620,45
BUGIRI,2019,1180,1510,2690,45
BUGIRI,2020,1210,1570,2780,45
BUGIRI,2021,1240,1630,2870,45
BUGIRI,2022,1290,1710,3000,45
BUGIRI,2023,1340,1800,3140,45
BUGIRI,2024,1410,1900,3310,45
BUGIRI,2025,1490,2010,3500,45
BUGWERI,2015,520,600,1120,45
BUGWERI,2016,550,640,1190,45
BUGWERI,2017,570,670,1240,45
BUGWERI,2018,590,690,1280,45
BUGWERI,2019,590,710,1300,45
BUGWERI,2020,600,720,1320,45
BUGWERI,2021,610,740,1350,45
BUGWERI,2022,620,770,1390,45
BUGWERI,2023,640,800,1440,45
BUGWERI,2024,670,840,1510,45
BUGWERI,2025,690,870,1560,45
BUHWEJU,2015,420,420,840,45
BUHWEJU,2016,440,430,870,45
BUHWEJU,2017,450,450,900,45
BUHWEJU,2018,470,460,930,45
BUHWEJU,2019,480,470,950,45
BUHWEJU,2020,500,490,990,45
BUHWEJU,2021,510,500,1010,45
BUHWEJU,2022,530,520,1050,45
BUHWEJU,2023,540,530,1070,45
BUHWEJU,2024,560,540,1100,45
BUHWEJU,2025,570,560,1130,45
BUIKWE,2015,1470,1510,2980,45
BUIKWE,2016,1540,1610,3150,45
BUIKWE,2017,1590,1690,3280,45
BUIKWE,2018,1620,1730,3350,45
BUIKWE,2019,1630,1760,3390,45
BUIKWE,2020,1630,1800,3430,45
BUIKWE,2021,1640,1840,3480,45
BUIKWE,2022,1660,1880,3540,45
BUIKWE,2023,1700,1950,3650,45
BUIKWE,2024,1760,2020,3780,45
BUIKWE,2025,1810,2110,3920,45
BUKEDEA,2015,550,630,1180,45
BUKEDEA,2016,590,680,1270,45
BUKEDEA,2017,620,730,1350,45
BUKEDEA,2018,650,770,1420,45
BUKEDEA,2019,660,790,1450,45
BUKEDEA,2020,690,830,1520,45
BUKEDEA,2021,710,860,1570,45
BUKEDEA,2022,730,900,1630,45
BUKEDEA,2023,770,950,1720,45
BUKEDEA,2024,810,1010,1820,45
BUKEDEA,2025,850,1070,1920,45
BUKOMANSIMBI,2015,530,530,1060,45
BUKOMANSIMBI,2016,550,560,1110,45
BUKOMANSIMBI,2017,560,580,1140,45
BUKOMANSIMBI,2018,570,590,1160,45
BUKOMANSIMBI,2019,560,590,1150,45
BUKOMANSIMBI,2020,560,580,1140,45
BUKOMANSIMBI,2021,550,590,1140,45
BUKOMANSIMBI,2022,560,600,1160,45
BUKOMANSIMBI,2023,560,610,1170,45
BUKOMANSIMBI,2024,570,620,1190,45
BUKOMANSIMBI,2025,580,640,1220,45
BUKWO,2015,240,250,490,45
BUKWO,2016,250,260,510,45
BUKWO,2017,270,280,550,45
BUKWO,2018,280,290,570,45
BUKWO,2019,300,310,610,45
BUKWO,2020,310,320,630,45
BUKWO,2021,330,330,660,45
BUKWO,2022,350,350,700,45
BUKWO,2023,360,370,730,45
BUKWO,2024,380,380,760,45
BUKWO,2025,400,400,800,45
BULAMBULI,2015,430,450,880,45
BULAMBULI,2016,460,490,950,45
BULAMBULI,2017,490,530,1020,45
BULAMBULI,2018,510,560,1070,45
BULAMBULI,2019,530,590,1120,45
BULAMBULI,2020,550,610,1160,45
BULAMBULI,2021,570,650,1220,45
BULAMBULI,2022,590,680,1270,45
BULAMBULI,2023,630,720,1350,45
BULAMBULI,2024,670,770,1440,45
BULAMBULI,2025,700,830,1530,45
BULIISA,2015,380,420,800,45
BULIISA,2016,400,440,840,45
BULIISA,2017,420,460,880,45
BULIISA,2018,440,480,920,45
BULIISA,2019,470,500,970,45
BULIISA,2020,490,530,1020,45
BULIISA,2021,520,550,1070,45
BULIISA,2022,540,570,1110,45
BULIISA,2023,570,590,1160,45
BULIISA,2024,600,620,1220,45
BULIISA,2025,630,640,1270,45
BUNDIBUGYO,2015,740,800,1540,45
BUNDIBUGYO,2016,780,860,1640,45
BUNDIBUGYO,2017,820,910,1730,45
BUNDIBUGYO,2018,840,940,1780,45
BUNDIBUGYO,2019,850,960,1810,45
BUNDIBUGYO,2020,860,980,1840,45
BUNDIBUGYO,2021,870,1020,1890,45
BUNDIBUGYO,2022,900,1050,1950,45
BUNDIBUGYO,2023,930,1100,2030,45
BUNDIBUGYO,2024,970,1140,2110,45
BUNDIBUGYO,2025,1000,1190,2190,45
BUNYANGABU,2015,510,550,1060,45
BUNYANGABU,2016,530,590,1120,45
BUNYANGABU,2017,560,620,1180,45
BUNYANGABU,2018,570,640,1210,45
BUNYANGABU,2019,580,660,1240,45
BUNYANGABU,2020,580,660,1240,45
BUNYANGABU,2021,580,680,1260,45
BUNYANGABU,2022,600,700,1300,45
BUNYANGABU,2023,620,730,1350,45
BUNYANGABU,2024,630,750,1380,45
BUNYANGABU,2025,660,790,1450,45
BUSHENYI,2015,990,1080,2070,45
BUSHENYI,2016,1000,1090,2090,45
BUSHENYI,2017,1010,1100,2110,45
BUSHENYI,2018,1030,1110,2140,45
BUSHENYI,2019,1040,1120,2160,45
BUSHENYI,2020,1050,1130,2180,45
BUSHENYI,2021,1060,1130,2190,45
BUSHENYI,2022,1070,1140,2210,45
BUSHENYI,2023,1080,1150,2230,45
BUSHENYI,2024,1090,1150,2240,45
BUSHENYI,2025,1090,1160,2250,45
BUSIA,2015,870,990,1860,45
BUSIA,2016,910,1060,1970,45
BUSIA,2017,960,1120,2080,45
BUSIA,2018,980,1160,2140,45
BUSIA,2019,1000,1200,2200,45
BUSIA,2020,1010,1230,2240,45
BUSIA,2021,1030,1260,2290,45
BUSIA,2022,1060,1310,2370,45
BUSIA,2023,1090,1370,2460,45
BUSIA,2024,1140,1420,2560,45
BUSIA,2025,1190,1500,2690,45
BUTALEJA,2015,690,720,1410,45
BUTALEJA,2016,740,780,1520,45
BUTALEJA,2017,780,820,1600,45
BUTALEJA,2018,810,870,1680,45
BUTALEJA,2019,820,890,1710,45
BUTALEJA,2020,840,920,1760,45
BUTALEJA,2021,860,950,1810,45
BUTALEJA,2022,890,1000,1890,45
BUTALEJA,2023,920,1040,1960,45
BUTALEJA,2024,970,1100,2070,45
BUTALEJA,2025,1020,1170,2190,45
BUTAMBALA,2015,400,410,810,45
BUTAMBALA,2016,420,440,860,45
BUTAMBALA,2017,430,450,880,45
BUTAMBALA,2018,430,460,890,45
BUTAMBALA,2019,430,460,890,45
BUTAMBALA,2020,430,470,900,45
BUTAMBALA,2021,430,470,900,45
BUTAMBALA,2022,440,480,920,45
BUTAMBALA,2023,450,490,940,45
BUTAMBALA,2024,450,510,960,45
BUTAMBALA,2025,470,520,990,45
BUTEBO,2015,260,320,580,45
BUTEBO,2016,270,340,610,45
BUTEBO,2017,280,350,630,45
BUTEBO,2018,280,360,640,45
BUTEBO,2019,280,370,650,45
BUTEBO,2020,280,370,650,45
BUTEBO,2021,280,370,650,45
BUTEBO,2022,290,380,670,45
BUTEBO,2023,290,390,680,45
BUTEBO,2024,300,400,700,45
BUTEBO,2025,310,410,720,45
BUVUMA,2015,610,350,960,45
BUVUMA,2016,650,370,1020,45
BUVUMA,2017,690,400,1090,45
BUVUMA,2018,730,420,1150,45
BUVUMA,2019,770,450,1220,45
BUVUMA,2020,820,480,1300,45
BUVUMA,2021,870,510,1380,45
BUVUMA,2022,920,540,1460,45
BUVUMA,2023,970,580,1550,45
BUVUMA,2024,1030,620,1650,45
BUVUMA,2025,1090,650,1740,45
BUYENDE,2015,890,1000,1890,45
BUYENDE,2016,950,1100,2050,45
BUYENDE,2017,1010,1170,2180,45
BUYENDE,2018,1050,1230,2280,45
BUYENDE,2019,1080,1280,2360,45
BUYENDE,2020,1110,1330,2440,45
BUYENDE,2021,1150,1390,2540,45
BUYENDE,2022,1190,1470,2660,45
BUYENDE,2023,1250,1550,2800,45
BUYENDE,2024,1320,1640,2960,45
BUYENDE,2025,1390,1750,3140,45
DOKOLO,2015,690,800,1490,45
DOKOLO,2016,710,820,1530,45
DOKOLO,2017,730,850,1580,45
DOKOLO,2018,750,870,1620,45
DOKOLO,2019,780,890,1670,45
DOKOLO,2020,800,920,1720,45
DOKOLO,2021,820,940,1760,45
DOKOLO,2022,840,960,1800,45
DOKOLO,2023,870,980,1850,45
DOKOLO,2024,890,1010,1900,45
DOKOLO,2025,910,1030,1940,45
GOMBA,2015,570,540,1110,45
GOMBA,2016,610,570,1180,45
GOMBA,2017,620,590,1210,45
GOMBA,2018,630,600,1230,45
GOMBA,2019,630,610,1240,45
GOMBA,2020,630,610,1240,45
GOMBA,2021,640,620,1260,45
GOMBA,2022,650,640,1290,45
GOMBA,2023,660,650,1310,45
GOMBA,2024,670,670,1340,45
GOMBA,2025,690,690,1380,45
GULU,2015,1150,1160,2310,45
GULU,2016,1180,1190,2370,45
GULU,2017,1220,1220,2440,45
GULU,2018,1260,1260,2520,45
GULU,2019,1290,1290,2580,45
GULU,2020,1330,1330,2660,45
GULU,2021,1370,1370,2740,45
GULU,2022,1410,1400,2810,45
GULU,2023,1440,1440,2880,45
GULU,2024,1480,1480,2960,45
GULU,2025,1520,1510,3030,45
HOIMA,2015,1200,1130,2330,45
HOIMA,2016,1240,1170,2410,45
HOIMA,2017,1290,1210,2500,45
HOIMA,2018,1340,1250,2590,45
HOIMA,2019,1390,1290,2680,45
HOIMA,2020,1440,1340,2780,45
HOIMA,2021,1490,1380,2870,45
HOIMA,2022,1540,1420,2960,45
HOIMA,2023,1590,1470,3060,45
HOIMA,2024,1640,1510,3150,45
HOIMA,2025,1700,1560,3260,45
IBANDA,2015,1000,1060,2060,45
IBANDA,2016,1020,1080,2100,45
IBANDA,2017,1040,1100,2140,45
IBANDA,2018,1060,1120,2180,45
IBANDA,2019,1080,1140,2220,45
IBANDA,2020,1100,1150,2250,45
IBANDA,2021,1120,1170,2290,45
IBANDA,2022,1140,1190,2330,45
IBANDA,2023,1160,1210,2370,45
IBANDA,2024,1170,1220,2390,45
IBANDA,2025,1190,1240,2430,45
IGANGA,2015,1140,1270,2410,45
IGANGA,2016,1210,1360,2570,45
IGANGA,2017,1260,1440,2700,45
IGANGA,2018,1290,1490,2780,45
IGANGA,2019,1310,1530,2840,45
IGANGA,2020,1330,1570,2900,45
IGANGA,2021,1360,1620,2980,45
IGANGA,2022,1400,1680,3080,45
IGANGA,2023,1450,1750,3200,45
IGANGA,2024,1510,1830,3340,45
IGANGA,2025,1570,1920,3490,45
ISINGIRO,2015,2000,2000,4000,45
ISINGIRO,2016,2080,2070,4150,45
ISINGIRO,2017,2150,2150,4300,45
ISINGIRO,2018,2230,2220,4450,45
ISINGIRO,2019,2310,2300,4610,45
ISINGIRO,2020,2400,2370,4770,45
ISINGIRO,2021,2480,2450,4930,45
ISINGIRO,2022,2570,2530,5100,45
ISINGIRO,2023,2650,2610,5260,45
ISINGIRO,2024,2740,2690,5430,45
ISINGIRO,2025,2830,2780,5610,45
JINJA,2015,2240,2080,4320,45
JINJA,2016,2270,2110,4380,45
JINJA,2017,2310,2140,4450,45
JINJA,2018,2350,2170,4520,45
JINJA,2019,2390,2200,4590,45
JINJA,2020,2420,2230,4650,45
JINJA,2021,2460,2260,4720,45
JINJA,2022,2490,2290,4780,45
JINJA,2023,2530,2320,4850,45
JINJA,2024,2560,2350,4910,45
JINJA,2025,2590,2370,4960,45
KAABONG,2015,370,450,820,45
KAABONG,2016,380,460,840,45
KAABONG,2017,390,470,860,45
KAABONG,2018,400,480,880,45
KAABONG,2019,410,490,900,45
KAABONG,2020,420,500,920,45
KAABONG,2021,430,510,940,45
KAABONG,2022,440,520,960,45
KAABONG,2023,450,530,980,45
KAABONG,2024,460,540,1000,45
KAABONG,2025,470,560,1030,45
KABALE,2015,960,1100,2060,45
KABALE,2016,970,1110,2080,45
KABALE,2017,990,1120,2110,45
KABALE,2018,1000,1140,2140,45
KABALE,2019,1020,1150,2170,45
KABALE,2020,1030,1160,2190,45
KABALE,2021,1050,1170,2220,45
KABALE,2022,1060,1180,2240,45
KABALE,2023,1070,1190,2260,45
KABALE,2024,1090,1200,2290,45
KABALE,2025,1100,1210,2310,45
KABAROLE,2015,1250,1070,2320,45
KABAROLE,2016,1280,1090,2370,45
KABAROLE,2017,1310,1120,2430,45
KABAROLE,2018,1340,1140,2480,45
KABAROLE,2019,1370,1160,2530,45
KABAROLE,2020,1390,1190,2580,45
KABAROLE,2021,1420,1210,2630,45
KABAROLE,2022,1450,1230,2680,45
KABAROLE,2023,1470,1260,2730,45
KABAROLE,2024,1500,1280,2780,45
KABAROLE,2025,1530,1300,2830,45
KABERAMAIDO,2015,300,330,630,45
KABERAMAIDO,2016,310,350,660,45
KABERAMAIDO,2017,340,380,720,45
KABERAMAIDO,2018,350,400,750,45
KABERAMAIDO,2019,360,420,780,45
KABERAMAIDO,2020,360,430,790,45
KABERAMAIDO,2021,370,450,820,45
KABERAMAIDO,2022,390,470,860,45
KABERAMAIDO,2023,410,490,900,45
KABERAMAIDO,2024,430,520,950,45
KABERAMAIDO,2025,450,550,1000,45
KAGADI,2015,1150,1210,2360,45
KAGADI,2016,1200,1250,2450,45
KAGADI,2017,1240,1300,2540,45
KAGADI,2018,1290,1340,2630,45
KAGADI,2019,1330,1390,2720,45
KAGADI,2020,1380,1440,2820,45
KAGADI,2021,1430,1480,2910,45
KAGADI,2022,1480,1530,3010,45
KAGADI,2023,1520,1580,3100,45
KAGADI,2024,1570,1630,3200,45
KAGADI,2025,1620,1680,3300,45
KAKUMIRO,2015,1170,970,2140,45
KAKUMIRO,2016,1280,1050,2330,45
KAKUMIRO,2017,1390,1140,2530,45
KAKUMIRO,2018,1510,1240,2750,45
KAKUMIRO,2019,1650,1340,2990,45
KAKUMIRO,2020,1790,1450,3240,45
KAKUMIRO,2021,1940,1570,3510,45
KAKUMIRO,2022,2110,1700,3810,45
KAKUMIRO,2023,2290,1840,4130,45
KAKUMIRO,2024,2480,1980,4460,45
KAKUMIRO,2025,2680,2140,4820,45
KALAKI,2015,370,440,810,45
KALAKI,2016,390,460,850,45
KALAKI,2017,410,480,890,45
KALAKI,2018,420,500,920,45
KALAKI,2019,440,520,960,45
KALAKI,2020,460,540,1000,45
KALAKI,2021,480,560,1040,45
KALAKI,2022,500,580,1080,45
KALAKI,2023,520,600,1120,45
KALAKI,2024,540,620,1160,45
KALAKI,2025,560,640,1200,45
KALANGALA,2015,410,190,600,45
KALANGALA,2016,420,200,620,45
KALANGALA,2017,440,210,650,45
KALANGALA,2018,450,220,670,45
KALANGALA,2019,470,220,690,45
KALANGALA,2020,480,230,710,45
KALANGALA,2021,500,240,740,45
KALANGALA,2022,510,250,760,45
KALANGALA,2023,530,260,790,45
KALANGALA,2024,550,270,820,45
KALANGALA,2025,560,280,840,45
KALIRO,2015,670,760,1430,45
KALIRO,2016,710,820,1530,45
KALIRO,2017,740,870,1610,45
KALIRO,2018,760,910,1670,45
KALIRO,2019,780,940,1720,45
KALIRO,2020,800,970,1770,45
KALIRO,2021,810,1010,1820,45
KALIRO,2022,840,1050,1890,45
KALIRO,2023,880,1100,1980,45
KALIRO,2024,910,1160,2070,45
KALIRO,2025,960,1220,2180,45
KALUNGU,2015,650,640,1290,45
KALUNGU,2016,670,670,1340,45
KALUNGU,2017,690,690,1380,45
KALUNGU,2018,690,710,1400,45
KALUNGU,2019,690,720,1410,45
KALUNGU,2020,690,710,1400,45
KALUNGU,2021,690,730,1420,45
KALUNGU,2022,690,740,1430,45
KALUNGU,2023,700,760,1460,45
KALUNGU,2024,710,770,1480,45
KALUNGU,2025,730,800,1530,45
KAMPALA,2015,7110,5670,12780,45
KAMPALA,2016,7250,5780,13030,45
KAMPALA,2017,7390,5890,13280,45
KAMPALA,2018,7540,6000,13540,45
KAMPALA,2019,7680,6110,13790,45
KAMPALA,2020,7820,6220,14040,45
KAMPALA,2021,7960,6330,14290,45
KAMPALA,2022,8090,6440,14530,45
KAMPALA,2023,8220,6540,14760,45
KAMPALA,2024,8340,6640,14980,45
KAMPALA,2025,8460,6740,15200,45
KAMULI,2015,1490,1800,3290,45
KAMULI,2016,1570,1910,3480,45
KAMULI,2017,1630,2010,3640,45
KAMULI,2018,1680,2070,3750,45
KAMULI,2019,1690,2110,3800,45
KAMULI,2020,1700,2150,3850,45
KAMULI,2021,1730,2210,3940,45
KAMULI,2022,1760,2270,4030,45
KAMULI,2023,1810,2360,4170,45
KAMULI,2024,1890,2450,4340,45
KAMULI,2025,1950,2560,4510,45
KAMWENGE,2015,950,1110,2060,45
KAMWENGE,2016,980,1150,2130,45
KAMWENGE,2017,1020,1190,2210,45
KAMWENGE,2018,1060,1230,2290,45
KAMWENGE,2019,1110,1270,2380,45
KAMWENGE,2020,1150,1310,2460,45
KAMWENGE,2021,1200,1360,2560,45
KAMWENGE,2022,1240,1400,2640,45
KAMWENGE,2023,1280,1450,2730,45
KAMWENGE,2024,1330,1490,2820,45
KAMWENGE,2025,1380,1540,2920,45
KANUNGU,2015,980,1110,2090,45
KANUNGU,2016,1000,1130,2130,45
KANUNGU,2017,1020,1150,2170,45
KANUNGU,2018,1040,1170,2210,45
KANUNGU,2019,1050,1190,2240,45
KANUNGU,2020,1070,1200,2270,45
KANUNGU,2021,1090,1220,2310,45
KANUNGU,2022,1100,1240,2340,45
KANUNGU,2023,1120,1250,2370,45
KANUNGU,2024,1140,1270,2410,45
KANUNGU,2025,1150,1280,2430,45
KAPCHORWA,2015,320,380,700,45
KAPCHORWA,2016,330,390,720,45
KAPCHORWA,2017,340,400,740,45
KAPCHORWA,2018,350,410,760,45
KAPCHORWA,2019,360,420,780,45
KAPCHORWA,2020,370,430,800,45
KAPCHORWA,2021,380,440,820,45
KAPCHORWA,2022,400,450,850,45
KAPCHORWA,2023,410,460,870,45
KAPCHORWA,2024,420,470,890,45
KAPCHORWA,2025,430,480,910,45
KAPELEBYONG,2015,240,280,520,45
KAPELEBYONG,2016,250,300,550,45
KAPELEBYONG,2017,260,320,580,45
KAPELEBYONG,2018,270,330,600,45
KAPELEBYONG,2019,270,340,610,45
KAPELEBYONG,2020,280,350,630,45
KAPELEBYONG,2021,280,360,640,45
KAPELEBYONG,2022,290,370,660,45
KAPELEBYONG,2023,300,390,690,45
KAPELEBYONG,2024,320,400,720,45
KAPELEBYONG,2025,330,420,750,45
KASESE,2015,2380,2650,5030,45
KASESE,2016,2510,2830,5340,45
KASESE,2017,2610,2960,5570,45
KASESE,2018,2660,3050,5710,45
KASESE,2019,2680,3120,5800,45
KASESE,2020,2700,3170,5870,45
KASESE,2021,2740,3250,5990,45
KASESE,2022,2790,3350,6140,45
KASESE,2023,2870,3470,6340,45
KASESE,2024,2960,3610,6570,45
KASESE,2025,3070,3750,6820,45
KASSANDA,2015,1160,1030,2190,45
KASSANDA,2016,1190,1050,2240,45
KASSANDA,2017,1230,1070,2300,45
KASSANDA,2018,1260,1100,2360,45
KASSANDA,2019,1300,1120,2420,45
KASSANDA,2020,1330,1140,2470,45
KASSANDA,2021,1370,1160,2530,45
KASSANDA,2022,1400,1190,2590,45
KASSANDA,2023,1440,1210,2650,45
KASSANDA,2024,1470,1230,2700,45
KASSANDA,2025,1510,1250,2760,45
KATAKWI,2015,450,530,980,45
KATAKWI,2016,480,570,1050,45
KATAKWI,2017,500,600,1100,45
KATAKWI,2018,510,620,1130,45
KATAKWI,2019,510,630,1140,45
KATAKWI,2020,520,640,1160,45
KATAKWI,2021,530,670,1200,45
KATAKWI,2022,540,690,1230,45
KATAKWI,2023,560,710,1270,45
KATAKWI,2024,590,740,1330,45
KATAKWI,2025,610,780,1390,45
KAYUNGA,2015,1240,1360,2600,45
KAYUNGA,2016,1300,1440,2740,45
KAYUNGA,2017,1350,1510,2860,45
KAYUNGA,2018,1370,1550,2920,45
KAYUNGA,2019,1370,1560,2930,45
KAYUNGA,2020,1370,1590,2960,45
KAYUNGA,2021,1390,1620,3010,45
KAYUNGA,2022,1410,1650,3060,45
KAYUNGA,2023,1440,1710,3150,45
KAYUNGA,2024,1480,1760,3240,45
KAYUNGA,2025,1530,1820,3350,45
KAZO,2015,710,790,1500,45
KAZO,2016,740,820,1560,45
KAZO,2017,770,850,1620,45
KAZO,2018,790,880,1670,45
KAZO,2019,830,910,1740,45
KAZO,2020,850,940,1790,45
KAZO,2021,880,970,1850,45
KAZO,2022,920,1000,1920,45
KAZO,2023,950,1030,1980,45
KAZO,2024,980,1060,2040,45
KAZO,2025,1010,1100,2110,45
KIBAALE,2015,430,420,850,45
KIBAALE,2016,460,450,910,45
KIBAALE,2017,490,470,960,45
KIBAALE,2018,520,500,1020,45
KIBAALE,2019,550,530,1080,45
KIBAALE,2020,590,560,1150,45
KIBAALE,2021,620,590,1210,45
KIBAALE,2022,660,620,1280,45
KIBAALE,2023,700,660,1360,45
KIBAALE,2024,740,690,1430,45
KIBAALE,2025,780,730,1510,45
KIBOGA,2015,460,410,870,45
KIBOGA,2016,490,450,940,45
KIBOGA,2017,510,480,990,45
KIBOGA,2018,530,510,1040,45
KIBOGA,2019,540,510,1050,45
KIBOGA,2020,550,530,1080,45
KIBOGA,2021,550,540,1090,45
KIBOGA,2022,570,560,1130,45
KIBOGA,2023,580,580,1160,45
KIBOGA,2024,590,600,1190,45
KIBOGA,2025,610,610,1220,45
KIBUKU,2015,500,530,1030,45
KIBUKU,2016,530,570,1100,45
KIBUKU,2017,560,610,1170,45
KIBUKU,2018,580,630,1210,45
KIBUKU,2019,590,660,1250,45
KIBUKU,2020,600,670,1270,45
KIBUKU,2021,620,700,1320,45
KIBUKU,2022,640,730,1370,45
KIBUKU,2023,660,770,1430,45
KIBUKU,2024,700,810,1510,45
KIBUKU,2025,730,860,1590,45
KIKUUBE,2015,1050,930,1980,45
KIKUUBE,2016,1110,970,2080,45
KIKUUBE,2017,1170,1020,2190,45
KIKUUBE,2018,1230,1080,2310,45
KIKUUBE,2019,1290,1130,2420,45
KIKUUBE,2020,1360,1190,2550,45
KIKUUBE,2021,1430,1240,2670,45
KIKUUBE,2022,1500,1300,2800,45
KIKUUBE,2023,1580,1370,2950,45
KIKUUBE,2024,1650,1430,3080,45
KIKUUBE,2025,1730,1500,3230,45
KIRUHURA,2015,830,650,1480,45
KIRUHURA,2016,860,680,1540,45
KIRUHURA,2017,900,700,1600,45
KIRUHURA,2018,930,730,1660,45
KIRUHURA,2019,960,750,1710,45
KIRUHURA,2020,1000,780,1780,45
KIRUHURA,2021,1040,800,1840,45
KIRUHURA,2022,1070,830,1900,45
KIRUHURA,2023,1110,860,1970,45
KIRUHURA,2024,1150,880,2030,45
KIRUHURA,2025,1180,910,2090,45
KIRYANDONGO,2015,760,790,1550,45
KIRYANDONGO,2016,820,860,1680,45
KIRYANDONGO,2017,870,910,1780,45
KIRYANDONGO,2018,900,960,1860,45
KIRYANDONGO,2019,930,1000,1930,45
KIRYANDONGO,2020,950,1030,1980,45
KIRYANDONGO,2021,960,1050,2010,45
KIRYANDONGO,2022,970,1080,2050,45
KIRYANDONGO,2023,1000,1110,2110,45
KIRYANDONGO,2024,1030,1160,2190,45
KIRYANDONGO,2025,1070,1210,2280,45
KISORO,2015,720,1150,1870,45
KISORO,2016,750,1220,1970,45
KISORO,2017,780,1280,2060,45
KISORO,2018,790,1320,2110,45
KISORO,2019,790,1350,2140,45
KISORO,2020,800,1370,2170,45
KISORO,2021,790,1390,2180,45
KISORO,2022,810,1430,2240,45
KISORO,2023,830,1480,2310,45
KISORO,2024,860,1530,2390,45
KISORO,2025,880,1600,2480,45
KITAGWENDA,2015,570,630,1200,45
KITAGWENDA,2016,590,650,1240,45
KITAGWENDA,2017,610,670,1280,45
KITAGWENDA,2018,640,700,1340,45
KITAGWENDA,2019,660,720,1380,45
KITAGWENDA,2020,690,750,1440,45
KITAGWENDA,2021,720,770,1490,45
KITAGWENDA,2022,740,800,1540,45
KITAGWENDA,2023,770,820,1590,45
KITAGWENDA,2024,800,850,1650,45
KITAGWENDA,2025,830,870,1700,45
KITGUM,2015,560,660,1220,45
KITGUM,2016,590,690,1280,45
KITGUM,2017,600,720,1320,45
KITGUM,2018,610,730,1340,45
KITGUM,2019,610,750,1360,45
KITGUM,2020,610,760,1370,45
KITGUM,2021,620,770,1390,45
KITGUM,2022,620,790,1410,45
KITGUM,2023,630,810,1440,45
KITGUM,2024,650,840,1490,45
KITGUM,2025,670,870,1540,45
KOBOKO,2015,680,750,1430,45
KOBOKO,2016,730,820,1550,45
KOBOKO,2017,770,870,1640,45
KOBOKO,2018,800,910,1710,45
KOBOKO,2019,820,940,1760,45
KOBOKO,2020,840,980,1820,45
KOBOKO,2021,860,1020,1880,45
KOBOKO,2022,890,1060,1950,45
KOBOKO,2023,930,1110,2040,45
KOBOKO,2024,970,1190,2160,45
KOBOKO,2025,1020,1250,2270,45
KOLE,2015,850,910,1760,45
KOLE,2016,880,940,1820,45
KOLE,2017,900,970,1870,45
KOLE,2018,930,990,1920,45
KOLE,2019,960,1020,1980,45
KOLE,2020,990,1050,2040,45
KOLE,2021,1020,1080,2100,45
KOLE,2022,1050,1100,2150,45
KOLE,2023,1080,1130,2210,45
KOLE,2024,1120,1160,2280,45
KOLE,2025,1150,1190,2340,45
KOTIDO,2015,500,610,1110,45
KOTIDO,2016,520,640,1160,45
KOTIDO,2017,540,680,1220,45
KOTIDO,2018,550,700,1250,45
KOTIDO,2019,550,710,1260,45
KOTIDO,2020,560,720,1280,45
KOTIDO,2021,570,740,1310,45
KOTIDO,2022,580,760,1340,45
KOTIDO,2023,590,790,1380,45
KOTIDO,2024,610,830,1440,45
KOTIDO,2025,630,860,1490,45
KUMI,2015,730,810,1540,45
KUMI,2016,780,870,1650,45
KUMI,2017,810,920,1730,45
KUMI,2018,840,950,1790,45
KUMI,2019,850,980,1830,45
KUMI,2020,860,1000,1860,45
KUMI,2021,880,1030,1910,45
KUMI,2022,900,1070,1970,45
KUMI,2023,930,1110,2040,45
KUMI,2024,970,1170,2140,45
KUMI,2025,1010,1220,2230,45
KWANIA,2015,620,630,1250,45
KWANIA,2016,630,650,1280,45
KWANIA,2017,650,670,1320,45
KWANIA,2018,670,690,1360,45
KWANIA,2019,690,710,1400,45
KWANIA,2020,720,730,1450,45
KWANIA,2021,740,750,1490,45
KWANIA,2022,760,770,1530,45
KWANIA,2023,780,780,1560,45
KWANIA,2024,800,800,1600,45
KWANIA,2025,820,820,1640,45
KWEEN,2015,280,300,580,45
KWEEN,2016,290,310,600,45
KWEEN,2017,300,320,620,45
KWEEN,2018,310,330,640,45
KWEEN,2019,320,330,650,45
KWEEN,2020,330,340,670,45
KWEEN,2021,340,350,690,45
KWEEN,2022,350,360,710,45
KWEEN,2023,350,370,720,45
KWEEN,2024,360,370,730,45
KWEEN,2025,370,380,750,45
KYANKWANZI,2015,1000,750,1750,45
KYANKWANZI,2016,1050,790,1840,45
KYANKWANZI,2017,1100,820,1920,45
KYANKWANZI,2018,1160,860,2020,45
KYANKWANZI,2019,1220,900,2120,45
KYANKWANZI,2020,1280,940,2220,45
KYANKWANZI,2021,1340,980,2320,45
KYANKWANZI,2022,1400,1020,2420,45
KYANKWANZI,2023,1470,1070,2540,45
KYANKWANZI,2024,1540,1110,2650,45
KYANKWANZI,2025,1610,1160,2770,45
KYEGEGWA,2015,1040,970,2010,45
KYEGEGWA,2016,1130,1040,2170,45
KYEGEGWA,2017,1220,1120,2340,45
KYEGEGWA,2018,1320,1210,2530,45
KYEGEGWA,2019,1430,1310,2740,45
KYEGEGWA,2020,1540,1410,2950,45
KYEGEGWA,2021,1660,1520,3180,45
KYEGEGWA,2022,1790,1630,3420,45
KYEGEGWA,2023,1940,1760,3700,45
KYEGEGWA,2024,2080,1890,3970,45
KYEGEGWA,2025,2240,2030,4270,45
KYENJOJO,2015,1410,1310,2720,45
KYENJOJO,2016,1470,1350,2820,45
KYENJOJO,2017,1530,1400,2930,45
KYENJOJO,2018,1590,1450,3040,45
KYENJOJO,2019,1650,1510,3160,45
KYENJOJO,2020,1720,1560,3280,45
KYENJOJO,2021,1790,1610,3400,45
KYENJOJO,2022,1850,1670,3520,45
KYENJOJO,2023,1920,1730,3650,45
KYENJOJO,2024,1990,1780,3770,45
KYENJOJO,2025,2060,1840,3900,45
KYOTERA,2015,800,710,1510,45
KYOTERA,2016,840,750,1590,45
KYOTERA,2017,870,780,1650,45
KYOTERA,2018,880,800,1680,45
KYOTERA,2019,870,810,1680,45
KYOTERA,2020,870,820,1690,45
KYOTERA,2021,880,830,1710,45
KYOTERA,2022,890,850,1740,45
KYOTERA,2023,910,870,1780,45
KYOTERA,2024,930,900,1830,45
KYOTERA,2025,960,930,1890,45
KARENGA,2015,210,230,440,45
KARENGA,2016,220,230,450,45
KARENGA,2017,220,240,460,45
KARENGA,2018,230,250,480,45
KARENGA,2019,240,250,490,45
KARENGA,2020,250,260,510,45
KARENGA,2021,250,260,510,45
KARENGA,2022,260,270,530,45
KARENGA,2023,260,280,540,45
KARENGA,2024,270,280,550,45
KARENGA,2025,270,290,560,45
LAMWO,2015,380,490,870,45
LAMWO,2016,400,520,920,45
LAMWO,2017,400,550,950,45
LAMWO,2018,410,560,970,45
LAMWO,2019,400,570,970,45
LAMWO,2020,400,570,970,45
LAMWO,2021,400,580,980,45
LAMWO,2022,400,590,990,45
LAMWO,2023,410,610,1020,45
LAMWO,2024,410,620,1030,45
LAMWO,2025,420,650,1070,45
LIRA,2015,1570,1730,3300,45
LIRA,2016,1610,1780,3390,45
LIRA,2017,1660,1830,3490,45
LIRA,2018,1710,1880,3590,45
LIRA,2019,1750,1930,3680,45
LIRA,2020,1800,1980,3780,45
LIRA,2021,1840,2040,3880,45
LIRA,2022,1890,2090,3980,45
LIRA,2023,1940,2140,4080,45
LIRA,2024,1980,2190,4170,45
LIRA,2025,2030,2250,4280,45
LUUKA,2015,690,910,1600,45
LUUKA,2016,730,970,1700,45
LUUKA,2017,750,1020,1770,45
LUUKA,2018,760,1050,1810,45
LUUKA,2019,770,1070,1840,45
LUUKA,2020,770,1080,1850,45
LUUKA,2021,780,1110,1890,45
LUUKA,2022,790,1140,1930,45
LUUKA,2023,810,1180,1990,45
LUUKA,2024,830,1220,2050,45
LUUKA,2025,860,1270,2130,45
LUWERO,2015,1610,1510,3120,45
LUWERO,2016,1700,1600,3300,45
LUWERO,2017,1760,1680,3440,45
LUWERO,2018,1800,1740,3540,45
LUWERO,2019,1820,1770,3590,45
LUWERO,2020,1830,1800,3630,45
LUWERO,2021,1850,1850,3700,45
LUWERO,2022,1890,1900,3790,45
LUWERO,2023,1950,1980,3930,45
LUWERO,2024,2010,2060,4070,45
LUWERO,2025,2080,2140,4220,45
LWENGO,2015,910,910,1820,45
LWENGO,2016,950,960,1910,45
LWENGO,2017,970,1000,1970,45
LWENGO,2018,980,1010,1990,45
LWENGO,2019,980,1020,2000,45
LWENGO,2020,970,1020,1990,45
LWENGO,2021,970,1030,2000,45
LWENGO,2022,970,1050,2020,45
LWENGO,2023,990,1080,2070,45
LWENGO,2024,1010,1100,2110,45
LWENGO,2025,1030,1140,2170,45
LYANTONDE,2015,260,250,510,45
LYANTONDE,2016,270,270,540,45
LYANTONDE,2017,290,300,590,45
LYANTONDE,2018,310,310,620,45
LYANTONDE,2019,320,330,650,45
LYANTONDE,2020,330,350,680,45
LYANTONDE,2021,340,350,690,45
LYANTONDE,2022,350,370,720,45
LYANTONDE,2023,350,370,720,45
LYANTONDE,2024,360,390,750,45
LYANTONDE,2025,370,390,760,45
MANAFWA,2015,470,580,1050,45
MANAFWA,2016,490,600,1090,45
MANAFWA,2017,500,610,1110,45
MANAFWA,2018,510,620,1130,45
MANAFWA,2019,520,640,1160,45
MANAFWA,2020,540,650,1190,45
MANAFWA,2021,550,660,1210,45
MANAFWA,2022,560,680,1240,45
MANAFWA,2023,570,690,1260,45
MANAFWA,2024,580,700,1280,45
MANAFWA,2025,600,710,1310,45
MARACHA,2015,730,1030,1760,45
MARACHA,2016,750,1050,1800,45
MARACHA,2017,770,1070,1840,45
MARACHA,2018,780,1090,1870,45
MARACHA,2019,800,1110,1910,45
MARACHA,2020,810,1130,1940,45
MARACHA,2021,830,1150,1980,45
MARACHA,2022,840,1170,2010,45
MARACHA,2023,860,1190,2050,45
MARACHA,2024,870,1210,2080,45
MARACHA,2025,890,1220,2110,45
MASAKA,2015,760,750,1510,45
MASAKA,2016,800,800,1600,45
MASAKA,2017,860,860,1720,45
MASAKA,2018,900,930,1830,45
MASAKA,2019,940,970,1910,45
MASAKA,2020,950,990,1940,45
MASAKA,2021,950,1010,1960,45
MASAKA,2022,970,1020,1990,45
MASAKA,2023,970,1040,2010,45
MASAKA,2024,1000,1090,2090,45
MASAKA,2025,1020,1120,2140,45
MASINDI,2015,1270,1060,2330,45
MASINDI,2016,1310,1080,2390,45
MASINDI,2017,1350,1110,2460,45
MASINDI,2018,1390,1140,2530,45
MASINDI,2019,1430,1170,2600,45
MASINDI,2020,1470,1200,2670,45
MASINDI,2021,1510,1230,2740,45
MASINDI,2022,1540,1260,2800,45
MASINDI,2023,1580,1290,2870,45
MASINDI,2024,1620,1320,2940,45
MASINDI,2025,1660,1350,3010,45
MAYUGE,2015,1480,1590,3070,45
MAYUGE,2016,1570,1710,3280,45
MAYUGE,2017,1640,1810,3450,45
MAYUGE,2018,1680,1890,3570,45
MAYUGE,2019,1710,1940,3650,45
MAYUGE,2020,1730,1990,3720,45
MAYUGE,2021,1770,2060,3830,45
MAYUGE,2022,1820,2130,3950,45
MAYUGE,2023,1880,2230,4110,45
MAYUGE,2024,1960,2340,4300,45
MAYUGE,2025,2040,2450,4490,45
MBALE,2015,1540,1560,3100,45
MBALE,2016,1630,1690,3320,45
MBALE,2017,1710,1780,3490,45
MBALE,2018,1750,1860,3610,45
MBALE,2019,1780,1920,3700,45
MBALE,2020,1800,1980,3780,45
MBALE,2021,1830,2050,3880,45
MBALE,2022,1880,2130,4010,45
MBALE,2023,1950,2230,4180,45
MBALE,2024,2020,2350,4370,45
MBALE,2025,2110,2470,4580,45
MBARARA,2015,1600,1490,3090,45
MBARARA,2016,1640,1520,3160,45
MBARARA,2017,1680,1560,3240,45
MBARARA,2018,1720,1590,3310,45
MBARARA,2019,1760,1620,3380,45
MBARARA,2020,1790,1660,3450,45
MBARARA,2021,1830,1690,3520,45
MBARARA,2022,1870,1720,3590,45
MBARARA,2023,1910,1750,3660,45
MBARARA,2024,1940,1780,3720,45
MBARARA,2025,1970,1810,3780,45
MITOOMA,2015,650,800,1450,45
MITOOMA,2016,660,810,1470,45
MITOOMA,2017,670,820,1490,45
MITOOMA,2018,670,820,1490,45
MITOOMA,2019,680,830,1510,45
MITOOMA,2020,690,840,1530,45
MITOOMA,2021,700,840,1540,45
MITOOMA,2022,700,850,1550,45
MITOOMA,2023,710,850,1560,45
MITOOMA,2024,710,860,1570,45
MITOOMA,2025,720,860,1580,45
MITYANA,2015,1160,1100,2260,45
MITYANA,2016,1210,1160,2370,45
MITYANA,2017,1250,1210,2460,45
MITYANA,2018,1270,1240,2510,45
MITYANA,2019,1270,1260,2530,45
MITYANA,2020,1280,1270,2550,45
MITYANA,2021,1280,1300,2580,45
MITYANA,2022,1300,1330,2630,45
MITYANA,2023,1330,1370,2700,45
MITYANA,2024,1360,1420,2780,45
MITYANA,2025,1410,1470,2880,45
MOROTO,2015,310,340,650,45
MOROTO,2016,330,360,690,45
MOROTO,2017,340,380,720,45
MOROTO,2018,350,390,740,45
MOROTO,2019,350,400,750,45
MOROTO,2020,350,410,760,45
MOROTO,2021,360,420,780,45
MOROTO,2022,370,430,800,45
MOROTO,2023,380,450,830,45
MOROTO,2024,390,470,860,45
MOROTO,2025,390,490,880,45
MOYO,2015,420,410,830,45
MOYO,2016,430,420,850,45
MOYO,2017,440,420,860,45
MOYO,2018,450,430,880,45
MOYO,2019,460,440,900,45
MOYO,2020,470,450,920,45
MOYO,2021,490,460,950,45
MOYO,2022,500,470,970,45
MOYO,2023,510,480,990,45
MOYO,2024,520,490,1010,45
MOYO,2025,530,500,1030,45
MPIGI,2015,910,870,1780,45
MPIGI,2016,960,940,1900,45
MPIGI,2017,1000,980,1980,45
MPIGI,2018,1020,1010,2030,45
MPIGI,2019,1020,1030,2050,45
MPIGI,2020,1030,1050,2080,45
MPIGI,2021,1040,1080,2120,45
MPIGI,2022,1060,1110,2170,45
MPIGI,2023,1090,1150,2240,45
MPIGI,2024,1130,1200,2330,45
MPIGI,2025,1170,1250,2420,45
MUBENDE,2015,1270,1220,2490,45
MUBENDE,2016,1380,1340,2720,45
MUBENDE,2017,1470,1450,2920,45
MUBENDE,2018,1550,1540,3090,45
MUBENDE,2019,1600,1610,3210,45
MUBENDE,2020,1660,1690,3350,45
MUBENDE,2021,1730,1780,3510,45
MUBENDE,2022,1810,1880,3690,45
MUBENDE,2023,1920,2000,3920,45
MUBENDE,2024,2040,2150,4190,45
MUBENDE,2025,2160,2290,4450,45
MUKONO,2015,2190,2180,4370,45
MUKONO,2016,2310,2340,4650,45
MUKONO,2017,2400,2480,4880,45
MUKONO,2018,2460,2570,5030,45
MUKONO,2019,2480,2640,5120,45
MUKONO,2020,2510,2700,5210,45
MUKONO,2021,2550,2790,5340,45
MUKONO,2022,2600,2890,5490,45
MUKONO,2023,2680,3020,5700,45
MUKONO,2024,2780,3160,5940,45
MUKONO,2025,2890,3320,6210,45
MADI OKOLLO,2015,620,780,1400,45
MADI OKOLLO,2016,630,800,1430,45
MADI OKOLLO,2017,650,820,1470,45
MADI OKOLLO,2018,670,850,1520,45
MADI OKOLLO,2019,690,870,1560,45
MADI OKOLLO,2020,710,890,1600,45
MADI OKOLLO,2021,730,910,1640,45
MADI OKOLLO,2022,750,940,1690,45
MADI OKOLLO,2023,770,960,1730,45
MADI OKOLLO,2024,780,980,1760,45
MADI OKOLLO,2025,800,1000,1800,45
NABILATUK,2015,150,180,330,45
NABILATUK,2016,160,190,350,45
NABILATUK,2017,170,210,380,45
NABILATUK,2018,190,220,410,45
NABILATUK,2019,190,230,420,45
NABILATUK,2020,200,240,440,45
NABILATUK,2021,200,250,450,45
NABILATUK,2022,210,270,480,45
NABILATUK,2023,230,280,510,45
NABILATUK,2024,240,290,530,45
NABILATUK,2025,260,310,570,45
NAKAPIRIPIRIT,2015,240,260,500,45
NAKAPIRIPIRIT,2016,270,280,550,45
NAKAPIRIPIRIT,2017,280,300,580,45
NAKAPIRIPIRIT,2018,290,310,600,45
NAKAPIRIPIRIT,2019,300,330,630,45
NAKAPIRIPIRIT,2020,310,340,650,45
NAKAPIRIPIRIT,2021,320,360,680,45
NAKAPIRIPIRIT,2022,330,380,710,45
NAKAPIRIPIRIT,2023,340,400,740,45
NAKAPIRIPIRIT,2024,360,420,780,45
NAKAPIRIPIRIT,2025,390,450,840,45
NAKASEKE,2015,1130,820,1950,45
NAKASEKE,2016,1170,830,2000,45
NAKASEKE,2017,1210,850,2060,45
NAKASEKE,2018,1260,880,2140,45
NAKASEKE,2019,1300,900,2200,45
NAKASEKE,2020,1350,920,2270,45
NAKASEKE,2021,1390,940,2330,45
NAKASEKE,2022,1440,960,2400,45
NAKASEKE,2023,1490,980,2470,45
NAKASEKE,2024,1540,990,2530,45
NAKASEKE,2025,1580,1010,2590,45
NAKASONGOLA,2015,630,490,1120,45
NAKASONGOLA,2016,660,510,1170,45
NAKASONGOLA,2017,690,550,1240,45
NAKASONGOLA,2018,720,570,1290,45
NAKASONGOLA,2019,730,580,1310,45
NAKASONGOLA,2020,740,590,1330,45
NAKASONGOLA,2021,750,610,1360,45
NAKASONGOLA,2022,770,630,1400,45
NAKASONGOLA,2023,800,660,1460,45
NAKASONGOLA,2024,830,690,1520,45
NAKASONGOLA,2025,870,710,1580,45
NAMAYINGO,2015,530,610,1140,45
NAMAYINGO,2016,560,640,1200,45
NAMAYINGO,2017,570,670,1240,45
NAMAYINGO,2018,580,680,1260,45
NAMAYINGO,2019,580,690,1270,45
NAMAYINGO,2020,580,700,1280,45
NAMAYINGO,2021,580,710,1290,45
NAMAYINGO,2022,600,720,1320,45
NAMAYINGO,2023,610,750,1360,45
NAMAYINGO,2024,630,770,1400,45
NAMAYINGO,2025,640,800,1440,45
NAMISINDWA,2015,580,570,1150,45
NAMISINDWA,2016,600,580,1180,45
NAMISINDWA,2017,620,600,1220,45
NAMISINDWA,2018,630,610,1240,45
NAMISINDWA,2019,650,630,1280,45
NAMISINDWA,2020,670,640,1310,45
NAMISINDWA,2021,680,650,1330,45
NAMISINDWA,2022,700,670,1370,45
NAMISINDWA,2023,720,680,1400,45
NAMISINDWA,2024,730,690,1420,45
NAMISINDWA,2025,750,710,1460,45
NAMUTUMBA,2015,740,830,1570,45
NAMUTUMBA,2016,780,900,1680,45
NAMUTUMBA,2017,830,950,1780,45
NAMUTUMBA,2018,850,1000,1850,45
NAMUTUMBA,2019,860,1020,1880,45
NAMUTUMBA,2020,880,1050,1930,45
NAMUTUMBA,2021,900,1090,1990,45
NAMUTUMBA,2022,930,1130,2060,45
NAMUTUMBA,2023,970,1190,2160,45
NAMUTUMBA,2024,1010,1250,2260,45
NAMUTUMBA,2025,1050,1310,2360,45
NAPAK,2015,310,470,780,45
NAPAK,2016,320,510,830,45
NAPAK,2017,340,530,870,45
NAPAK,2018,330,540,870,45
NAPAK,2019,340,550,890,45
NAPAK,2020,340,570,910,45
NAPAK,2021,340,580,920,45
NAPAK,2022,340,590,930,45
NAPAK,2023,350,610,960,45
NAPAK,2024,360,630,990,45
NAPAK,2025,370,660,1030,45
NEBBI,2015,830,970,1800,45
NEBBI,2016,860,1000,1860,45
NEBBI,2017,880,1030,1910,45
NEBBI,2018,910,1060,1970,45
NEBBI,2019,940,1090,2030,45
NEBBI,2020,970,1120,2090,45
NEBBI,2021,1000,1150,2150,45
NEBBI,2022,1020,1180,2200,45
NEBBI,2023,1050,1210,2260,45
NEBBI,2024,1080,1230,2310,45
NEBBI,2025,1110,1260,2370,45
NGORA,2015,410,550,960,45
NGORA,2016,440,590,1030,45
NGORA,2017,450,620,1070,45
NGORA,2018,460,640,1100,45
NGORA,2019,470,660,1130,45
NGORA,2020,470,670,1140,45
NGORA,2021,480,690,1170,45
NGORA,2022,500,720,1220,45
NGORA,2023,510,750,1260,45
NGORA,2024,530,770,1300,45
NGORA,2025,550,810,1360,45
NTOROKO,2015,210,220,430,45
NTOROKO,2016,230,230,460,45
NTOROKO,2017,240,240,480,45
NTOROKO,2018,240,240,480,45
NTOROKO,2019,240,250,490,45
NTOROKO,2020,240,250,490,45
NTOROKO,2021,250,260,510,45
NTOROKO,2022,260,270,530,45
NTOROKO,2023,260,280,540,45
NTOROKO,2024,270,280,550,45
NTOROKO,2025,280,290,570,45
NTUNGAMO,2015,2010,2190,4200,45
NTUNGAMO,2016,2050,2230,4280,45
NTUNGAMO,2017,2100,2280,4380,45
NTUNGAMO,2018,2140,2320,4460,45
NTUNGAMO,2019,2190,2360,4550,45
NTUNGAMO,2020,2230,2400,4630,45
NTUNGAMO,2021,2270,2440,4710,45
NTUNGAMO,2022,2310,2480,4790,45
NTUNGAMO,2023,2360,2510,4870,45
NTUNGAMO,2024,2400,2550,4950,45
NTUNGAMO,2025,2430,2590,5020,45
NWOYA,2015,600,550,1150,45
NWOYA,2016,670,600,1270,45
NWOYA,2017,740,660,1400,45
NWOYA,2018,810,730,1540,45
NWOYA,2019,900,810,1710,45
NWOYA,2020,990,890,1880,45
NWOYA,2021,1090,970,2060,45
NWOYA,2022,1200,1070,2270,45
NWOYA,2023,1330,1180,2510,45
NWOYA,2024,1460,1290,2750,45
NWOYA,2025,1600,1420,3020,45
OBONGI,2015,160,170,330,45
OBONGI,2016,160,180,340,45
OBONGI,2017,170,190,360,45
OBONGI,2018,180,190,370,45
OBONGI,2019,180,200,380,45
OBONGI,2020,170,200,370,45
OBONGI,2021,180,210,390,45
OBONGI,2022,190,210,400,45
OBONGI,2023,190,220,410,45
OBONGI,2024,190,230,420,45
OBONGI,2025,200,240,440,45
OMORO,2015,530,570,1100,45
OMORO,2016,570,620,1190,45
OMORO,2017,600,650,1250,45
OMORO,2018,620,680,1300,45
OMORO,2019,630,700,1330,45
OMORO,2020,640,720,1360,45
OMORO,2021,650,750,1400,45
OMORO,2022,680,780,1460,45
OMORO,2023,700,820,1520,45
OMORO,2024,740,860,1600,45
OMORO,2025,770,910,1680,45
OTUKE,2015,440,490,930,45
OTUKE,2016,460,510,970,45
OTUKE,2017,480,530,1010,45
OTUKE,2018,500,550,1050,45
OTUKE,2019,530,580,1110,45
OTUKE,2020,550,600,1150,45
OTUKE,2021,570,630,1200,45
OTUKE,2022,600,650,1250,45
OTUKE,2023,620,680,1300,45
OTUKE,2024,650,700,1350,45
OTUKE,2025,670,730,1400,45
OYAM,2015,1250,1480,2730,45
OYAM,2016,1290,1520,2810,45
OYAM,2017,1330,1570,2900,45
OYAM,2018,1370,1610,2980,45
OYAM,2019,1410,1660,3070,45
OYAM,2020,1450,1710,3160,45
OYAM,2021,1490,1750,3240,45
OYAM,2022,1540,1800,3340,45
OYAM,2023,1580,1840,3420,45
OYAM,2024,1620,1890,3510,45
OYAM,2025,1660,1940,3600,45
PADER,2015,500,630,1130,45
PADER,2016,520,670,1190,45
PADER,2017,540,700,1240,45
PADER,2018,550,730,1280,45
PADER,2019,550,730,1280,45
PADER,2020,550,750,1300,45
PADER,2021,550,760,1310,45
PADER,2022,560,790,1350,45
PADER,2023,570,810,1380,45
PADER,2024,590,840,1430,45
PADER,2025,600,870,1470,45
PAKWACH,2015,600,700,1300,45
PAKWACH,2016,630,730,1360,45
PAKWACH,2017,660,750,1410,45
PAKWACH,2018,680,780,1460,45
PAKWACH,2019,710,810,1520,45
PAKWACH,2020,740,840,1580,45
PAKWACH,2021,770,860,1630,45
PAKWACH,2022,800,890,1690,45
PAKWACH,2023,830,920,1750,45
PAKWACH,2024,860,950,1810,45
PAKWACH,2025,890,980,1870,45
PALLISA,2015,730,880,1610,45
PALLISA,2016,790,950,1740,45
PALLISA,2017,830,1020,1850,45
PALLISA,2018,870,1080,1950,45
PALLISA,2019,900,1120,2020,45
PALLISA,2020,910,1170,2080,45
PALLISA,2021,950,1220,2170,45
PALLISA,2022,990,1280,2270,45
PALLISA,2023,1030,1360,2390,45
PALLISA,2024,1090,1440,2530,45
PALLISA,2025,1150,1530,2680,45
RAKAI,2015,840,900,1740,45
RAKAI,2016,890,960,1850,45
RAKAI,2017,920,1000,1920,45
RAKAI,2018,940,1040,1980,45
RAKAI,2019,950,1060,2010,45
RAKAI,2020,960,1080,2040,45
RAKAI,2021,970,1100,2070,45
RAKAI,2022,990,1140,2130,45
RAKAI,2023,1020,1180,2200,45
RAKAI,2024,1060,1230,2290,45
RAKAI,2025,1100,1280,2380,45
RUBANDA,2015,650,950,1600,45
RUBANDA,2016,660,960,1620,45
RUBANDA,2017,670,960,1630,45
RUBANDA,2018,680,970,1650,45
RUBANDA,2019,690,980,1670,45
RUBANDA,2020,690,980,1670,45
RUBANDA,2021,700,990,1690,45
RUBANDA,2022,710,1000,1710,45
RUBANDA,2023,720,1000,1720,45
RUBANDA,2024,720,1000,1720,45
RUBANDA,2025,730,1010,1740,45
RUBIRIZI,2015,490,590,1080,45
RUBIRIZI,2016,500,600,1100,45
RUBIRIZI,2017,510,620,1130,45
RUBIRIZI,2018,530,630,1160,45
RUBIRIZI,2019,540,640,1180,45
RUBIRIZI,2020,550,650,1200,45
RUBIRIZI,2021,560,660,1220,45
RUBIRIZI,2022,560,670,1230,45
RUBIRIZI,2023,570,680,1250,45
RUBIRIZI,2024,580,690,1270,45
RUBIRIZI,2025,590,700,1290,45
RUKIGA,2015,390,500,890,45
RUKIGA,2016,400,510,910,45
RUKIGA,2017,400,510,910,45
RUKIGA,2018,410,510,920,45
RUKIGA,2019,410,520,930,45
RUKIGA,2020,410,520,930,45
RUKIGA,2021,420,520,940,45
RUKIGA,2022,420,520,940,45
RUKIGA,2023,420,530,950,45
RUKIGA,2024,420,530,950,45
RUKIGA,2025,430,530,960,45
RUKUNGIRI,2015,1190,1390,2580,45
RUKUNGIRI,2016,1210,1410,2620,45
RUKUNGIRI,2017,1220,1420,2640,45
RUKUNGIRI,2018,1240,1430,2670,45
RUKUNGIRI,2019,1250,1450,2700,45
RUKUNGIRI,2020,1260,1460,2720,45
RUKUNGIRI,2021,1280,1470,2750,45
RUKUNGIRI,2022,1290,1480,2770,45
RUKUNGIRI,2023,1300,1490,2790,45
RUKUNGIRI,2024,1310,1500,2810,45
RUKUNGIRI,2025,1320,1510,2830,45
RWAMPARA,2015,560,550,1110,45
RWAMPARA,2016,570,560,1130,45
RWAMPARA,2017,590,570,1160,45
RWAMPARA,2018,600,580,1180,45
RWAMPARA,2019,610,600,1210,45
RWAMPARA,2020,630,610,1240,45
RWAMPARA,2021,640,620,1260,45
RWAMPARA,2022,650,630,1280,45
RWAMPARA,2023,660,640,1300,45
RWAMPARA,2024,680,660,1340,45
RWAMPARA,2025,690,670,1360,45
SERERE,2015,790,1000,1790,45
SERERE,2016,850,1090,1940,45
SERERE,2017,900,1160,2060,45
SERERE,2018,930,1220,2150,45
SERERE,2019,950,1270,2220,45
SERERE,2020,980,1310,2290,45
SERERE,2021,1000,1370,2370,45
SERERE,2022,1040,1430,2470,45
SERERE,2023,1090,1500,2590,45
SERERE,2024,1140,1590,2730,45
SERERE,2025,1200,1680,2880,45
SHEEMA,2015,880,1040,1920,45
SHEEMA,2016,890,1050,1940,45
SHEEMA,2017,900,1060,1960,45
SHEEMA,2018,910,1070,1980,45
SHEEMA,2019,920,1080,2000,45
SHEEMA,2020,930,1090,2020,45
SHEEMA,2021,940,1100,2040,45
SHEEMA,2022,950,1110,2060,45
SHEEMA,2023,960,1120,2080,45
SHEEMA,2024,970,1120,2090,45
SHEEMA,2025,970,1130,2100,45
SIRONKO,2015,940,1020,1960,45
SIRONKO,2016,960,1040,2000,45
SIRONKO,2017,990,1060,2050,45
SIRONKO,2018,1010,1090,2100,45
SIRONKO,2019,1030,1110,2140,45
SIRONKO,2020,1060,1130,2190,45
SIRONKO,2021,1080,1150,2230,45
SIRONKO,2022,1100,1170,2270,45
SIRONKO,2023,1120,1190,2310,45
SIRONKO,2024,1140,1210,2350,45
SIRONKO,2025,1170,1230,2400,45
SOROTI,2015,870,1130,2000,45
SOROTI,2016,930,1210,2140,45
SOROTI,2017,970,1300,2270,45
SOROTI,2018,1000,1350,2350,45
SOROTI,2019,1020,1400,2420,45
SOROTI,2020,1040,1440,2480,45
SOROTI,2021,1070,1500,2570,45
SOROTI,2022,1100,1560,2660,45
SOROTI,2023,1140,1640,2780,45
SOROTI,2024,1200,1720,2920,45
SOROTI,2025,1250,1810,3060,45
SSEMBABULE,2015,880,790,1670,45
SSEMBABULE,2016,940,840,1780,45
SSEMBABULE,2017,970,880,1850,45
SSEMBABULE,2018,1000,920,1920,45
SSEMBABULE,2019,1010,940,1950,45
SSEMBABULE,2020,1020,960,1980,45
SSEMBABULE,2021,1040,990,2030,45
SSEMBABULE,2022,1060,1030,2090,45
SSEMBABULE,2023,1100,1060,2160,45
SSEMBABULE,2024,1140,1110,2250,45
SSEMBABULE,2025,1190,1170,2360,45
TORORO,2015,1880,2010,3890,45
TORORO,2016,1930,2060,3990,45
TORORO,2017,1980,2110,4090,45
TORORO,2018,2030,2160,4190,45
TORORO,2019,2090,2210,4300,45
TORORO,2020,2140,2260,4400,45
TORORO,2021,2190,2320,4510,45
TORORO,2022,2240,2370,4610,45
TORORO,2023,2290,2420,4710,45
TORORO,2024,2350,2470,4820,45
TORORO,2025,2400,2520,4920,45
WAKISO,2015,9670,7480,17150,45
WAKISO,2016,10320,7990,18310,45
WAKISO,2017,11010,8540,19550,45
WAKISO,2018,11740,9120,20860,45
WAKISO,2019,12520,9730,22250,45
WAKISO,2020,13330,10380,23710,45
WAKISO,2021,14190,11070,25260,45
WAKISO,2022,15100,11800,26900,45
WAKISO,2023,16060,12560,28620,45
WAKISO,2024,17060,13360,30420,45
WAKISO,2025,18110,14210,32320,45
YUMBE,2015,1430,1470,2900,45
YUMBE,2016,1550,1620,3170,45
YUMBE,2017,1650,1770,3420,45
YUMBE,2018,1720,1890,3610,45
YUMBE,2019,1790,1990,3780,45
YUMBE,2020,1850,2100,3950,45
YUMBE,2021,1920,2230,4150,45
YUMBE,2022,2010,2380,4390,45
YUMBE,2023,2120,2550,4670,45
YUMBE,2024,2250,2760,5010,45
YUMBE,2025,2390,2970,5360,45
ZOMBO,2015,870,1010,1880,45
ZOMBO,2016,900,1040,1940,45
ZOMBO,2017,930,1070,2000,45
ZOMBO,2018,960,1100,2060,45
ZOMBO,2019,990,1130,2120,45
ZOMBO,2020,1010,1160,2170,45
ZOMBO,2021,1040,1180,2220,45
ZOMBO,2022,1070,1210,2280,45
ZOMBO,2023,1100,1240,2340,45
ZOMBO,2024,1130,1270,2400,45
ZOMBO,2025,1160,1300,2460,45
ABIM,2015,270,250,520,46
ABIM,2016,310,280,590,46
ABIM,2017,340,310,650,46
ABIM,2018,360,340,700,46
ABIM,2019,380,360,740,46
ABIM,2020,400,390,790,46
ABIM,2021,420,400,820,46
ABIM,2022,450,430,880,46
ABIM,2023,470,460,930,46
ABIM,2024,500,490,990,46
ABIM,2025,540,530,1070,46
ADJUMANI,2015,410,520,930,46
ADJUMANI,2016,420,520,940,46
ADJUMANI,2017,420,530,950,46
ADJUMANI,2018,420,530,950,46
ADJUMANI,2019,430,540,970,46
ADJUMANI,2020,430,540,970,46
ADJUMANI,2021,430,540,970,46
ADJUMANI,2022,430,550,980,46
ADJUMANI,2023,440,550,990,46
ADJUMANI,2024,440,560,1000,46
ADJUMANI,2025,440,560,1000,46
AGAGO,2015,510,590,1100,46
AGAGO,2016,520,600,1120,46
AGAGO,2017,530,610,1140,46
AGAGO,2018,540,620,1160,46
AGAGO,2019,550,630,1180,46
AGAGO,2020,560,640,1200,46
AGAGO,2021,560,650,1210,46
AGAGO,2022,570,660,1230,46
AGAGO,2023,580,670,1250,46
AGAGO,2024,590,680,1270,46
AGAGO,2025,600,690,1290,46
ALEBTONG,2015,720,730,1450,46
ALEBTONG,2016,770,800,1570,46
ALEBTONG,2017,820,840,1660,46
ALEBTONG,2018,840,890,1730,46
ALEBTONG,2019,860,930,1790,46
ALEBTONG,2020,870,960,1830,46
ALEBTONG,2021,880,970,1850,46
ALEBTONG,2022,900,1000,1900,46
ALEBTONG,2023,920,1040,1960,46
ALEBTONG,2024,950,1070,2020,46
ALEBTONG,2025,990,1130,2120,46
AMOLATAR,2015,550,490,1040,46
AMOLATAR,2016,580,530,1110,46
AMOLATAR,2017,620,560,1180,46
AMOLATAR,2018,640,590,1230,46
AMOLATAR,2019,650,610,1260,46
AMOLATAR,2020,670,620,1290,46
AMOLATAR,2021,670,640,1310,46
AMOLATAR,2022,670,650,1320,46
AMOLATAR,2023,690,670,1360,46
AMOLATAR,2024,710,690,1400,46
AMOLATAR,2025,730,720,1450,46
AMUDAT,2015,230,170,400,46
AMUDAT,2016,250,180,430,46
AMUDAT,2017,270,200,470,46
AMUDAT,2018,280,220,500,46
AMUDAT,2019,300,220,520,46
AMUDAT,2020,290,240,530,46
AMUDAT,2021,300,250,550,46
AMUDAT,2022,310,260,570,46
AMUDAT,2023,320,270,590,46
AMUDAT,2024,330,290,620,46
AMUDAT,2025,350,310,660,46
AMURIA,2015,470,520,990,46
AMURIA,2016,500,560,1060,46
AMURIA,2017,540,620,1160,46
AMURIA,2018,570,650,1220,46
AMURIA,2019,580,680,1260,46
AMURIA,2020,590,690,1280,46
AMURIA,2021,610,720,1330,46
AMURIA,2022,630,750,1380,46
AMURIA,2023,640,770,1410,46
AMURIA,2024,660,820,1480,46
AMURIA,2025,700,860,1560,46
AMURU,2015,500,530,1030,46
AMURU,2016,530,580,1110,46
AMURU,2017,560,620,1180,46
AMURU,2018,580,660,1240,46
AMURU,2019,600,680,1280,46
AMURU,2020,610,690,1300,46
AMURU,2021,610,710,1320,46
AMURU,2022,610,720,1330,46
AMURU,2023,640,760,1400,46
AMURU,2024,650,790,1440,46
AMURU,2025,670,820,1490,46
APAC,2015,580,480,1060,46
APAC,2016,600,490,1090,46
APAC,2017,620,510,1130,46
APAC,2018,640,530,1170,46
APAC,2019,670,550,1220,46
APAC,2020,690,560,1250,46
APAC,2021,710,580,1290,46
APAC,2022,740,600,1340,46
APAC,2023,760,620,1380,46
APAC,2024,790,640,1430,46
APAC,2025,810,660,1470,46
ARUA,2015,1550,1680,3230,46
ARUA,2016,1600,1720,3320,46
ARUA,2017,1650,1770,3420,46
ARUA,2018,1690,1820,3510,46
ARUA,2019,1740,1870,3610,46
ARUA,2020,1790,1910,3700,46
ARUA,2021,1840,1960,3800,46
ARUA,2022,1880,2010,3890,46
ARUA,2023,1930,2060,3990,46
ARUA,2024,1980,2110,4090,46
ARUA,2025,2020,2150,4170,46
BUDAKA,2015,620,700,1320,46
BUDAKA,2016,660,770,1430,46
BUDAKA,2017,720,830,1550,46
BUDAKA,2018,750,880,1630,46
BUDAKA,2019,770,920,1690,46
BUDAKA,2020,790,940,1730,46
BUDAKA,2021,800,970,1770,46
BUDAKA,2022,830,1000,1830,46
BUDAKA,2023,850,1050,1900,46
BUDAKA,2024,880,1100,1980,46
BUDAKA,2025,930,1160,2090,46
BUDUDA,2015,780,690,1470,46
BUDUDA,2016,840,760,1600,46
BUDUDA,2017,900,830,1730,46
BUDUDA,2018,950,880,1830,46
BUDUDA,2019,1000,930,1930,46
BUDUDA,2020,1030,970,2000,46
BUDUDA,2021,1050,1010,2060,46
BUDUDA,2022,1090,1060,2150,46
BUDUDA,2023,1130,1110,2240,46
BUDUDA,2024,1190,1170,2360,46
BUDUDA,2025,1250,1260,2510,46
BUGIRI,2015,1000,1210,2210,46
BUGIRI,2016,1090,1330,2420,46
BUGIRI,2017,1170,1450,2620,46
BUGIRI,2018,1240,1550,2790,46
BUGIRI,2019,1280,1620,2900,46
BUGIRI,2020,1310,1680,2990,46
BUGIRI,2021,1340,1750,3090,46
BUGIRI,2022,1370,1810,3180,46
BUGIRI,2023,1430,1900,3330,46
BUGIRI,2024,1480,1990,3470,46
BUGIRI,2025,1560,2110,3670,46
BUGWERI,2015,400,550,950,46
BUGWERI,2016,430,590,1020,46
BUGWERI,2017,450,630,1080,46
BUGWERI,2018,470,670,1140,46
BUGWERI,2019,480,690,1170,46
BUGWERI,2020,490,710,1200,46
BUGWERI,2021,490,720,1210,46
BUGWERI,2022,500,740,1240,46
BUGWERI,2023,510,770,1280,46
BUGWERI,2024,520,800,1320,46
BUGWERI,2025,540,830,1370,46
BUHWEJU,2015,330,320,650,46
BUHWEJU,2016,340,330,670,46
BUHWEJU,2017,350,340,690,46
BUHWEJU,2018,360,350,710,46
BUHWEJU,2019,380,360,740,46
BUHWEJU,2020,390,370,760,46
BUHWEJU,2021,400,380,780,46
BUHWEJU,2022,410,390,800,46
BUHWEJU,2023,420,410,830,46
BUHWEJU,2024,430,420,850,46
BUHWEJU,2025,450,430,880,46
BUIKWE,2015,1180,1180,2360,46
BUIKWE,2016,1260,1270,2530,46
BUIKWE,2017,1320,1350,2670,46
BUIKWE,2018,1360,1420,2780,46
BUIKWE,2019,1380,1460,2840,46
BUIKWE,2020,1380,1480,2860,46
BUIKWE,2021,1400,1510,2910,46
BUIKWE,2022,1410,1540,2950,46
BUIKWE,2023,1430,1590,3020,46
BUIKWE,2024,1460,1640,3100,46
BUIKWE,2025,1500,1700,3200,46
BUKEDEA,2015,560,670,1230,46
BUKEDEA,2016,620,730,1350,46
BUKEDEA,2017,660,790,1450,46
BUKEDEA,2018,690,840,1530,46
BUKEDEA,2019,730,890,1620,46
BUKEDEA,2020,750,920,1670,46
BUKEDEA,2021,760,960,1720,46
BUKEDEA,2022,790,1000,1790,46
BUKEDEA,2023,820,1040,1860,46
BUKEDEA,2024,870,1100,1970,46
BUKEDEA,2025,900,1170,2070,46
BUKOMANSIMBI,2015,410,440,850,46
BUKOMANSIMBI,2016,430,460,890,46
BUKOMANSIMBI,2017,440,480,920,46
BUKOMANSIMBI,2018,460,510,970,46
BUKOMANSIMBI,2019,460,510,970,46
BUKOMANSIMBI,2020,450,510,960,46
BUKOMANSIMBI,2021,450,510,960,46
BUKOMANSIMBI,2022,450,510,960,46
BUKOMANSIMBI,2023,450,520,970,46
BUKOMANSIMBI,2024,450,530,980,46
BUKOMANSIMBI,2025,460,540,1000,46
BUKWO,2015,320,290,610,46
BUKWO,2016,330,300,630,46
BUKWO,2017,350,320,670,46
BUKWO,2018,370,330,700,46
BUKWO,2019,390,350,740,46
BUKWO,2020,410,370,780,46
BUKWO,2021,430,380,810,46
BUKWO,2022,450,400,850,46
BUKWO,2023,480,420,900,46
BUKWO,2024,500,440,940,46
BUKWO,2025,520,460,980,46
BULAMBULI,2015,720,720,1440,46
BULAMBULI,2016,780,800,1580,46
BULAMBULI,2017,840,870,1710,46
BULAMBULI,2018,900,930,1830,46
BULAMBULI,2019,930,1000,1930,46
BULAMBULI,2020,970,1040,2010,46
BULAMBULI,2021,1000,1080,2080,46
BULAMBULI,2022,1040,1140,2180,46
BULAMBULI,2023,1080,1210,2290,46
BULAMBULI,2024,1140,1290,2430,46
BULAMBULI,2025,1200,1370,2570,46
BULIISA,2015,310,240,550,46
BULIISA,2016,330,250,580,46
BULIISA,2017,350,260,610,46
BULIISA,2018,370,270,640,46
BULIISA,2019,390,280,670,46
BULIISA,2020,410,290,700,46
BULIISA,2021,430,310,740,46
BULIISA,2022,450,320,770,46
BULIISA,2023,470,330,800,46
BULIISA,2024,500,350,850,46
BULIISA,2025,520,360,880,46
BUNDIBUGYO,2015,550,500,1050,46
BUNDIBUGYO,2016,580,540,1120,46
BUNDIBUGYO,2017,620,580,1200,46
BUNDIBUGYO,2018,650,600,1250,46
BUNDIBUGYO,2019,660,620,1280,46
BUNDIBUGYO,2020,680,640,1320,46
BUNDIBUGYO,2021,680,650,1330,46
BUNDIBUGYO,2022,700,670,1370,46
BUNDIBUGYO,2023,710,700,1410,46
BUNDIBUGYO,2024,740,730,1470,46
BUNDIBUGYO,2025,770,760,1530,46
BUNYANGABU,2015,420,410,830,46
BUNYANGABU,2016,450,450,900,46
BUNYANGABU,2017,480,470,950,46
BUNYANGABU,2018,490,490,980,46
BUNYANGABU,2019,500,510,1010,46
BUNYANGABU,2020,510,530,1040,46
BUNYANGABU,2021,510,530,1040,46
BUNYANGABU,2022,520,540,1060,46
BUNYANGABU,2023,530,560,1090,46
BUNYANGABU,2024,550,590,1140,46
BUNYANGABU,2025,570,600,1170,46
BUSHENYI,2015,650,680,1330,46
BUSHENYI,2016,660,680,1340,46
BUSHENYI,2017,660,690,1350,46
BUSHENYI,2018,670,700,1370,46
BUSHENYI,2019,680,700,1380,46
BUSHENYI,2020,690,710,1400,46
BUSHENYI,2021,690,710,1400,46
BUSHENYI,2022,700,720,1420,46
BUSHENYI,2023,710,720,1430,46
BUSHENYI,2024,710,720,1430,46
BUSHENYI,2025,720,730,1450,46
BUSIA,2015,880,920,1800,46
BUSIA,2016,950,1000,1950,46
BUSIA,2017,1000,1070,2070,46
BUSIA,2018,1050,1140,2190,46
BUSIA,2019,1080,1180,2260,46
BUSIA,2020,1090,1210,2300,46
BUSIA,2021,1110,1250,2360,46
BUSIA,2022,1130,1280,2410,46
BUSIA,2023,1170,1320,2490,46
BUSIA,2024,1200,1390,2590,46
BUSIA,2025,1250,1450,2700,46
BUTALEJA,2015,670,730,1400,46
BUTALEJA,2016,720,800,1520,46
BUTALEJA,2017,770,860,1630,46
BUTALEJA,2018,820,920,1740,46
BUTALEJA,2019,840,960,1800,46
BUTALEJA,2020,860,990,1850,46
BUTALEJA,2021,870,1030,1900,46
BUTALEJA,2022,900,1060,1960,46
BUTALEJA,2023,930,1100,2030,46
BUTALEJA,2024,960,1160,2120,46
BUTALEJA,2025,1010,1210,2220,46
BUTAMBALA,2015,180,230,410,46
BUTAMBALA,2016,190,240,430,46
BUTAMBALA,2017,190,250,440,46
BUTAMBALA,2018,200,270,470,46
BUTAMBALA,2019,210,280,490,46
BUTAMBALA,2020,210,280,490,46
BUTAMBALA,2021,200,280,480,46
BUTAMBALA,2022,200,280,480,46
BUTAMBALA,2023,200,280,480,46
BUTAMBALA,2024,210,290,500,46
BUTAMBALA,2025,220,310,530,46
BUTEBO,2015,310,340,650,46
BUTEBO,2016,330,370,700,46
BUTEBO,2017,340,390,730,46
BUTEBO,2018,350,400,750,46
BUTEBO,2019,360,420,780,46
BUTEBO,2020,350,420,770,46
BUTEBO,2021,360,420,780,46
BUTEBO,2022,350,430,780,46
BUTEBO,2023,370,440,810,46
BUTEBO,2024,370,440,810,46
BUTEBO,2025,370,470,840,46
BUVUMA,2015,370,240,610,46
BUVUMA,2016,390,250,640,46
BUVUMA,2017,410,270,680,46
BUVUMA,2018,440,290,730,46
BUVUMA,2019,460,310,770,46
BUVUMA,2020,490,330,820,46
BUVUMA,2021,520,350,870,46
BUVUMA,2022,550,370,920,46
BUVUMA,2023,590,400,990,46
BUVUMA,2024,620,420,1040,46
BUVUMA,2025,650,450,1100,46
BUYENDE,2015,740,820,1560,46
BUYENDE,2016,810,910,1720,46
BUYENDE,2017,870,990,1860,46
BUYENDE,2018,910,1070,1980,46
BUYENDE,2019,960,1120,2080,46
BUYENDE,2020,980,1170,2150,46
BUYENDE,2021,1010,1220,2230,46
BUYENDE,2022,1040,1270,2310,46
BUYENDE,2023,1080,1340,2420,46
BUYENDE,2024,1140,1400,2540,46
BUYENDE,2025,1200,1490,2690,46
DOKOLO,2015,460,490,950,46
DOKOLO,2016,470,510,980,46
DOKOLO,2017,490,520,1010,46
DOKOLO,2018,500,540,1040,46
DOKOLO,2019,520,550,1070,46
DOKOLO,2020,530,570,1100,46
DOKOLO,2021,550,580,1130,46
DOKOLO,2022,560,590,1150,46
DOKOLO,2023,580,610,1190,46
DOKOLO,2024,590,620,1210,46
DOKOLO,2025,610,640,1250,46
GOMBA,2015,480,410,890,46
GOMBA,2016,510,450,960,46
GOMBA,2017,520,470,990,46
GOMBA,2018,540,490,1030,46
GOMBA,2019,550,500,1050,46
GOMBA,2020,560,500,1060,46
GOMBA,2021,550,510,1060,46
GOMBA,2022,560,510,1070,46
GOMBA,2023,570,520,1090,46
GOMBA,2024,570,540,1110,46
GOMBA,2025,590,560,1150,46
GULU,2015,620,630,1250,46
GULU,2016,640,650,1290,46
GULU,2017,660,670,1330,46
GULU,2018,680,690,1370,46
GULU,2019,700,710,1410,46
GULU,2020,720,730,1450,46
GULU,2021,740,750,1490,46
GULU,2022,760,770,1530,46
GULU,2023,780,790,1570,46
GULU,2024,800,810,1610,46
GULU,2025,820,830,1650,46
HOIMA,2015,840,730,1570,46
HOIMA,2016,870,760,1630,46
HOIMA,2017,900,780,1680,46
HOIMA,2018,930,810,1740,46
HOIMA,2019,970,840,1810,46
HOIMA,2020,1000,860,1860,46
HOIMA,2021,1040,890,1930,46
HOIMA,2022,1080,920,2000,46
HOIMA,2023,1110,950,2060,46
HOIMA,2024,1150,980,2130,46
HOIMA,2025,1190,1010,2200,46
IBANDA,2015,690,740,1430,46
IBANDA,2016,710,750,1460,46
IBANDA,2017,720,770,1490,46
IBANDA,2018,740,780,1520,46
IBANDA,2019,750,790,1540,46
IBANDA,2020,760,810,1570,46
IBANDA,2021,780,820,1600,46
IBANDA,2022,790,830,1620,46
IBANDA,2023,800,840,1640,46
IBANDA,2024,810,860,1670,46
IBANDA,2025,830,870,1700,46
IGANGA,2015,790,950,1740,46
IGANGA,2016,850,1040,1890,46
IGANGA,2017,900,1110,2010,46
IGANGA,2018,940,1170,2110,46
IGANGA,2019,970,1220,2190,46
IGANGA,2020,980,1250,2230,46
IGANGA,2021,1000,1270,2270,46
IGANGA,2022,1020,1320,2340,46
IGANGA,2023,1050,1360,2410,46
IGANGA,2024,1080,1430,2510,46
IGANGA,2025,1130,1490,2620,46
ISINGIRO,2015,1470,1440,2910,46
ISINGIRO,2016,1520,1490,3010,46
ISINGIRO,2017,1580,1540,3120,46
ISINGIRO,2018,1640,1590,3230,46
ISINGIRO,2019,1700,1650,3350,46
ISINGIRO,2020,1760,1700,3460,46
ISINGIRO,2021,1820,1760,3580,46
ISINGIRO,2022,1880,1820,3700,46
ISINGIRO,2023,1940,1880,3820,46
ISINGIRO,2024,2010,1930,3940,46
ISINGIRO,2025,2070,1990,4060,46
JINJA,2015,1320,1230,2550,46
JINJA,2016,1340,1250,2590,46
JINJA,2017,1360,1270,2630,46
JINJA,2018,1380,1290,2670,46
JINJA,2019,1400,1310,2710,46
JINJA,2020,1430,1330,2760,46
JINJA,2021,1450,1340,2790,46
JINJA,2022,1470,1360,2830,46
JINJA,2023,1490,1380,2870,46
JINJA,2024,1500,1390,2890,46
JINJA,2025,1520,1410,2930,46
KAABONG,2015,250,260,510,46
KAABONG,2016,250,270,520,46
KAABONG,2017,260,280,540,46
KAABONG,2018,270,280,550,46
KAABONG,2019,270,290,560,46
KAABONG,2020,280,290,570,46
KAABONG,2021,290,300,590,46
KAABONG,2022,300,310,610,46
KAABONG,2023,300,310,610,46
KAABONG,2024,310,320,630,46
KAABONG,2025,320,330,650,46
KABALE,2015,620,660,1280,46
KABALE,2016,630,670,1300,46
KABALE,2017,640,680,1320,46
KABALE,2018,650,690,1340,46
KABALE,2019,660,690,1350,46
KABALE,2020,670,700,1370,46
KABALE,2021,680,710,1390,46
KABALE,2022,690,710,1400,46
KABALE,2023,700,720,1420,46
KABALE,2024,710,730,1440,46
KABALE,2025,710,730,1440,46
KABAROLE,2015,730,660,1390,46
KABAROLE,2016,750,680,1430,46
KABAROLE,2017,760,690,1450,46
KABAROLE,2018,780,710,1490,46
KABAROLE,2019,800,720,1520,46
KABAROLE,2020,810,730,1540,46
KABAROLE,2021,830,750,1580,46
KABAROLE,2022,840,760,1600,46
KABAROLE,2023,860,780,1640,46
KABAROLE,2024,870,790,1660,46
KABAROLE,2025,890,800,1690,46
KABERAMAIDO,2015,320,280,600,46
KABERAMAIDO,2016,340,310,650,46
KABERAMAIDO,2017,370,330,700,46
KABERAMAIDO,2018,380,360,740,46
KABERAMAIDO,2019,410,370,780,46
KABERAMAIDO,2020,410,390,800,46
KABERAMAIDO,2021,420,400,820,46
KABERAMAIDO,2022,440,420,860,46
KABERAMAIDO,2023,450,440,890,46
KABERAMAIDO,2024,470,460,930,46
KABERAMAIDO,2025,490,480,970,46
KAGADI,2015,790,840,1630,46
KAGADI,2016,810,870,1680,46
KAGADI,2017,850,900,1750,46
KAGADI,2018,880,930,1810,46
KAGADI,2019,910,960,1870,46
KAGADI,2020,940,990,1930,46
KAGADI,2021,970,1020,1990,46
KAGADI,2022,1010,1060,2070,46
KAGADI,2023,1040,1090,2130,46
KAGADI,2024,1070,1130,2200,46
KAGADI,2025,1110,1160,2270,46
KAKUMIRO,2015,850,710,1560,46
KAKUMIRO,2016,920,770,1690,46
KAKUMIRO,2017,1010,830,1840,46
KAKUMIRO,2018,1100,900,2000,46
KAKUMIRO,2019,1190,980,2170,46
KAKUMIRO,2020,1290,1060,2350,46
KAKUMIRO,2021,1410,1140,2550,46
KAKUMIRO,2022,1530,1240,2770,46
KAKUMIRO,2023,1650,1340,2990,46
KAKUMIRO,2024,1790,1440,3230,46
KAKUMIRO,2025,1940,1560,3500,46
KALAKI,2015,280,270,550,46
KALAKI,2016,290,280,570,46
KALAKI,2017,300,290,590,46
KALAKI,2018,310,300,610,46
KALAKI,2019,330,320,650,46
KALAKI,2020,340,330,670,46
KALAKI,2021,350,340,690,46
KALAKI,2022,370,350,720,46
KALAKI,2023,380,370,750,46
KALAKI,2024,400,380,780,46
KALAKI,2025,410,390,800,46
KALANGALA,2015,290,130,420,46
KALANGALA,2016,300,140,440,46
KALANGALA,2017,310,140,450,46
KALANGALA,2018,320,150,470,46
KALANGALA,2019,330,160,490,46
KALANGALA,2020,340,160,500,46
KALANGALA,2021,350,170,520,46
KALANGALA,2022,360,180,540,46
KALANGALA,2023,370,180,550,46
KALANGALA,2024,380,190,570,46
KALANGALA,2025,400,200,600,46
KALIRO,2015,650,570,1220,46
KALIRO,2016,700,630,1330,46
KALIRO,2017,740,680,1420,46
KALIRO,2018,780,710,1490,46
KALIRO,2019,810,750,1560,46
KALIRO,2020,820,780,1600,46
KALIRO,2021,840,800,1640,46
KALIRO,2022,860,830,1690,46
KALIRO,2023,880,870,1750,46
KALIRO,2024,910,900,1810,46
KALIRO,2025,960,950,1910,46
KALUNGU,2015,470,560,1030,46
KALUNGU,2016,500,600,1100,46
KALUNGU,2017,510,630,1140,46
KALUNGU,2018,530,660,1190,46
KALUNGU,2019,530,670,1200,46
KALUNGU,2020,530,680,1210,46
KALUNGU,2021,530,680,1210,46
KALUNGU,2022,520,680,1200,46
KALUNGU,2023,530,700,1230,46
KALUNGU,2024,530,710,1240,46
KALUNGU,2025,550,730,1280,46
KAMPALA,2015,3720,3170,6890,46
KAMPALA,2016,3800,3230,7030,46
KAMPALA,2017,3870,3290,7160,46
KAMPALA,2018,3950,3350,7300,46
KAMPALA,2019,4020,3420,7440,46
KAMPALA,2020,4090,3480,7570,46
KAMPALA,2021,4160,3540,7700,46
KAMPALA,2022,4230,3600,7830,46
KAMPALA,2023,4300,3650,7950,46
KAMPALA,2024,4370,3710,8080,46
KAMPALA,2025,4430,3760,8190,46
KAMULI,2015,1200,1480,2680,46
KAMULI,2016,1280,1590,2870,46
KAMULI,2017,1350,1700,3050,46
KAMULI,2018,1410,1790,3200,46
KAMULI,2019,1440,1850,3290,46
KAMULI,2020,1460,1890,3350,46
KAMULI,2021,1470,1910,3380,46
KAMULI,2022,1490,1960,3450,46
KAMULI,2023,1520,2020,3540,46
KAMULI,2024,1570,2090,3660,46
KAMULI,2025,1620,2180,3800,46
KAMWENGE,2015,640,730,1370,46
KAMWENGE,2016,670,750,1420,46
KAMWENGE,2017,690,780,1470,46
KAMWENGE,2018,720,810,1530,46
KAMWENGE,2019,750,840,1590,46
KAMWENGE,2020,780,860,1640,46
KAMWENGE,2021,810,890,1700,46
KAMWENGE,2022,840,920,1760,46
KAMWENGE,2023,870,950,1820,46
KAMWENGE,2024,900,980,1880,46
KAMWENGE,2025,940,1010,1950,46
KANUNGU,2015,690,730,1420,46
KANUNGU,2016,700,740,1440,46
KANUNGU,2017,710,750,1460,46
KANUNGU,2018,730,760,1490,46
KANUNGU,2019,740,770,1510,46
KANUNGU,2020,750,790,1540,46
KANUNGU,2021,760,800,1560,46
KANUNGU,2022,770,810,1580,46
KANUNGU,2023,790,820,1610,46
KANUNGU,2024,800,830,1630,46
KANUNGU,2025,810,840,1650,46
KAPCHORWA,2015,390,400,790,46
KAPCHORWA,2016,400,410,810,46
KAPCHORWA,2017,410,420,830,46
KAPCHORWA,2018,430,430,860,46
KAPCHORWA,2019,440,440,880,46
KAPCHORWA,2020,450,460,910,46
KAPCHORWA,2021,460,470,930,46
KAPCHORWA,2022,480,480,960,46
KAPCHORWA,2023,490,490,980,46
KAPCHORWA,2024,500,500,1000,46
KAPCHORWA,2025,510,510,1020,46
KAPELEBYONG,2015,230,230,460,46
KAPELEBYONG,2016,240,260,500,46
KAPELEBYONG,2017,260,270,530,46
KAPELEBYONG,2018,270,290,560,46
KAPELEBYONG,2019,280,310,590,46
KAPELEBYONG,2020,280,310,590,46
KAPELEBYONG,2021,290,320,610,46
KAPELEBYONG,2022,300,320,620,46
KAPELEBYONG,2023,290,340,630,46
KAPELEBYONG,2024,310,340,650,46
KAPELEBYONG,2025,320,370,690,46
KASESE,2015,1650,1780,3430,46
KASESE,2016,1770,1920,3690,46
KASESE,2017,1860,2050,3910,46
KASESE,2018,1940,2160,4100,46
KASESE,2019,1980,2220,4200,46
KASESE,2020,1990,2260,4250,46
KASESE,2021,2010,2300,4310,46
KASESE,2022,2030,2360,4390,46
KASESE,2023,2070,2430,4500,46
KASESE,2024,2120,2520,4640,46
KASESE,2025,2200,2620,4820,46
KASSANDA,2015,660,620,1280,46
KASSANDA,2016,680,640,1320,46
KASSANDA,2017,700,650,1350,46
KASSANDA,2018,720,660,1380,46
KASSANDA,2019,740,680,1420,46
KASSANDA,2020,760,690,1450,46
KASSANDA,2021,780,700,1480,46
KASSANDA,2022,800,720,1520,46
KASSANDA,2023,820,730,1550,46
KASSANDA,2024,840,740,1580,46
KASSANDA,2025,860,750,1610,46
KATAKWI,2015,440,440,880,46
KATAKWI,2016,470,460,930,46
KATAKWI,2017,500,500,1000,46
KATAKWI,2018,520,520,1040,46
KATAKWI,2019,540,540,1080,46
KATAKWI,2020,550,550,1100,46
KATAKWI,2021,550,570,1120,46
KATAKWI,2022,560,580,1140,46
KATAKWI,2023,580,600,1180,46
KATAKWI,2024,590,630,1220,46
KATAKWI,2025,610,660,1270,46
KAYUNGA,2015,950,1050,2000,46
KAYUNGA,2016,1010,1130,2140,46
KAYUNGA,2017,1060,1200,2260,46
KAYUNGA,2018,1090,1250,2340,46
KAYUNGA,2019,1110,1290,2400,46
KAYUNGA,2020,1120,1300,2420,46
KAYUNGA,2021,1110,1320,2430,46
KAYUNGA,2022,1120,1350,2470,46
KAYUNGA,2023,1140,1380,2520,46
KAYUNGA,2024,1160,1420,2580,46
KAYUNGA,2025,1200,1460,2660,46
KAZO,2015,630,560,1190,46
KAZO,2016,650,580,1230,46
KAZO,2017,680,600,1280,46
KAZO,2018,700,620,1320,46
KAZO,2019,730,650,1380,46
KAZO,2020,760,670,1430,46
KAZO,2021,780,690,1470,46
KAZO,2022,810,710,1520,46
KAZO,2023,840,740,1580,46
KAZO,2024,870,760,1630,46
KAZO,2025,900,780,1680,46
KIBAALE,2015,370,300,670,46
KIBAALE,2016,390,320,710,46
KIBAALE,2017,420,340,760,46
KIBAALE,2018,440,360,800,46
KIBAALE,2019,470,380,850,46
KIBAALE,2020,500,400,900,46
KIBAALE,2021,530,420,950,46
KIBAALE,2022,560,450,1010,46
KIBAALE,2023,600,470,1070,46
KIBAALE,2024,630,500,1130,46
KIBAALE,2025,670,520,1190,46
KIBOGA,2015,440,380,820,46
KIBOGA,2016,470,410,880,46
KIBOGA,2017,500,450,950,46
KIBOGA,2018,530,470,1000,46
KIBOGA,2019,550,500,1050,46
KIBOGA,2020,570,520,1090,46
KIBOGA,2021,570,540,1110,46
KIBOGA,2022,580,530,1110,46
KIBOGA,2023,580,550,1130,46
KIBOGA,2024,600,570,1170,46
KIBOGA,2025,610,600,1210,46
KIBUKU,2015,520,590,1110,46
KIBUKU,2016,560,640,1200,46
KIBUKU,2017,600,700,1300,46
KIBUKU,2018,630,740,1370,46
KIBUKU,2019,650,780,1430,46
KIBUKU,2020,670,800,1470,46
KIBUKU,2021,680,830,1510,46
KIBUKU,2022,700,860,1560,46
KIBUKU,2023,720,900,1620,46
KIBUKU,2024,760,940,1700,46
KIBUKU,2025,790,990,1780,46
KIKUUBE,2015,770,630,1400,46
KIKUUBE,2016,810,660,1470,46
KIKUUBE,2017,850,690,1540,46
KIKUUBE,2018,900,730,1630,46
KIKUUBE,2019,940,770,1710,46
KIKUUBE,2020,990,800,1790,46
KIKUUBE,2021,1040,840,1880,46
KIKUUBE,2022,1090,880,1970,46
KIKUUBE,2023,1150,930,2080,46
KIKUUBE,2024,1200,970,2170,46
KIKUUBE,2025,1260,1010,2270,46
KIRUHURA,2015,540,400,940,46
KIRUHURA,2016,560,410,970,46
KIRUHURA,2017,580,420,1000,46
KIRUHURA,2018,610,440,1050,46
KIRUHURA,2019,630,450,1080,46
KIRUHURA,2020,650,470,1120,46
KIRUHURA,2021,670,490,1160,46
KIRUHURA,2022,700,500,1200,46
KIRUHURA,2023,720,520,1240,46
KIRUHURA,2024,750,530,1280,46
KIRUHURA,2025,770,550,1320,46
KIRYANDONGO,2015,700,630,1330,46
KIRYANDONGO,2016,750,680,1430,46
KIRYANDONGO,2017,800,750,1550,46
KIRYANDONGO,2018,850,790,1640,46
KIRYANDONGO,2019,890,850,1740,46
KIRYANDONGO,2020,910,870,1780,46
KIRYANDONGO,2021,930,890,1820,46
KIRYANDONGO,2022,940,920,1860,46
KIRYANDONGO,2023,960,940,1900,46
KIRYANDONGO,2024,980,980,1960,46
KIRYANDONGO,2025,1020,1010,2030,46
KISORO,2015,580,900,1480,46
KISORO,2016,620,980,1600,46
KISORO,2017,650,1030,1680,46
KISORO,2018,670,1090,1760,46
KISORO,2019,680,1110,1790,46
KISORO,2020,680,1140,1820,46
KISORO,2021,680,1150,1830,46
KISORO,2022,690,1180,1870,46
KISORO,2023,690,1210,1900,46
KISORO,2024,710,1260,1970,46
KISORO,2025,730,1300,2030,46
KITAGWENDA,2015,410,410,820,46
KITAGWENDA,2016,430,420,850,46
KITAGWENDA,2017,440,440,880,46
KITAGWENDA,2018,460,450,910,46
KITAGWENDA,2019,480,470,950,46
KITAGWENDA,2020,500,480,980,46
KITAGWENDA,2021,520,500,1020,46
KITAGWENDA,2022,540,520,1060,46
KITAGWENDA,2023,560,530,1090,46
KITAGWENDA,2024,580,550,1130,46
KITAGWENDA,2025,600,570,1170,46
KITGUM,2015,500,630,1130,46
KITGUM,2016,530,680,1210,46
KITGUM,2017,560,720,1280,46
KITGUM,2018,580,760,1340,46
KITGUM,2019,590,780,1370,46
KITGUM,2020,580,780,1360,46
KITGUM,2021,580,790,1370,46
KITGUM,2022,590,810,1400,46
KITGUM,2023,590,830,1420,46
KITGUM,2024,610,840,1450,46
KITGUM,2025,630,880,1510,46
KOBOKO,2015,520,560,1080,46
KOBOKO,2016,570,620,1190,46
KOBOKO,2017,610,660,1270,46
KOBOKO,2018,640,700,1340,46
KOBOKO,2019,660,740,1400,46
KOBOKO,2020,690,760,1450,46
KOBOKO,2021,700,790,1490,46
KOBOKO,2022,720,820,1540,46
KOBOKO,2023,740,860,1600,46
KOBOKO,2024,780,900,1680,46
KOBOKO,2025,820,950,1770,46
KOLE,2015,670,590,1260,46
KOLE,2016,700,610,1310,46
KOLE,2017,720,620,1340,46
KOLE,2018,740,640,1380,46
KOLE,2019,760,660,1420,46
KOLE,2020,790,680,1470,46
KOLE,2021,810,700,1510,46
KOLE,2022,840,710,1550,46
KOLE,2023,860,730,1590,46
KOLE,2024,890,750,1640,46
KOLE,2025,910,770,1680,46
KOTIDO,2015,420,520,940,46
KOTIDO,2016,450,560,1010,46
KOTIDO,2017,480,600,1080,46
KOTIDO,2018,490,630,1120,46
KOTIDO,2019,500,650,1150,46
KOTIDO,2020,510,670,1180,46
KOTIDO,2021,510,680,1190,46
KOTIDO,2022,520,700,1220,46
KOTIDO,2023,530,720,1250,46
KOTIDO,2024,550,740,1290,46
KOTIDO,2025,570,780,1350,46
KUMI,2015,670,700,1370,46
KUMI,2016,720,760,1480,46
KUMI,2017,770,820,1590,46
KUMI,2018,800,870,1670,46
KUMI,2019,820,900,1720,46
KUMI,2020,850,920,1770,46
KUMI,2021,860,940,1800,46
KUMI,2022,870,970,1840,46
KUMI,2023,900,1010,1910,46
KUMI,2024,930,1040,1970,46
KUMI,2025,960,1100,2060,46
KWANIA,2015,540,480,1020,46
KWANIA,2016,560,490,1050,46
KWANIA,2017,580,510,1090,46
KWANIA,2018,600,520,1120,46
KWANIA,2019,610,530,1140,46
KWANIA,2020,630,550,1180,46
KWANIA,2021,650,560,1210,46
KWANIA,2022,670,580,1250,46
KWANIA,2023,690,590,1280,46
KWANIA,2024,700,610,1310,46
KWANIA,2025,720,620,1340,46
KWEEN,2015,340,260,600,46
KWEEN,2016,350,270,620,46
KWEEN,2017,360,270,630,46
KWEEN,2018,370,280,650,46
KWEEN,2019,380,290,670,46
KWEEN,2020,390,290,680,46
KWEEN,2021,400,300,700,46
KWEEN,2022,420,310,730,46
KWEEN,2023,430,310,740,46
KWEEN,2024,440,320,760,46
KWEEN,2025,450,330,780,46
KYANKWANZI,2015,630,490,1120,46
KYANKWANZI,2016,660,510,1170,46
KYANKWANZI,2017,690,540,1230,46
KYANKWANZI,2018,730,560,1290,46
KYANKWANZI,2019,770,590,1360,46
KYANKWANZI,2020,800,610,1410,46
KYANKWANZI,2021,840,640,1480,46
KYANKWANZI,2022,880,670,1550,46
KYANKWANZI,2023,930,700,1630,46
KYANKWANZI,2024,970,730,1700,46
KYANKWANZI,2025,1010,760,1770,46
KYEGEGWA,2015,830,720,1550,46
KYEGEGWA,2016,890,770,1660,46
KYEGEGWA,2017,970,830,1800,46
KYEGEGWA,2018,1050,900,1950,46
KYEGEGWA,2019,1130,970,2100,46
KYEGEGWA,2020,1220,1050,2270,46
KYEGEGWA,2021,1320,1130,2450,46
KYEGEGWA,2022,1420,1210,2630,46
KYEGEGWA,2023,1540,1300,2840,46
KYEGEGWA,2024,1660,1400,3060,46
KYEGEGWA,2025,1780,1500,3280,46
KYENJOJO,2015,980,920,1900,46
KYENJOJO,2016,1020,960,1980,46
KYENJOJO,2017,1070,990,2060,46
KYENJOJO,2018,1110,1030,2140,46
KYENJOJO,2019,1150,1060,2210,46
KYENJOJO,2020,1200,1100,2300,46
KYENJOJO,2021,1250,1140,2390,46
KYENJOJO,2022,1290,1180,2470,46
KYENJOJO,2023,1340,1220,2560,46
KYENJOJO,2024,1390,1260,2650,46
KYENJOJO,2025,1440,1300,2740,46
KYOTERA,2015,660,640,1300,46
KYOTERA,2016,700,690,1390,46
KYOTERA,2017,730,720,1450,46
KYOTERA,2018,750,760,1510,46
KYOTERA,2019,760,780,1540,46
KYOTERA,2020,760,790,1550,46
KYOTERA,2021,760,790,1550,46
KYOTERA,2022,770,810,1580,46
KYOTERA,2023,780,820,1600,46
KYOTERA,2024,790,840,1630,46
KYOTERA,2025,820,880,1700,46
KARENGA,2015,140,160,300,46
KARENGA,2016,140,160,300,46
KARENGA,2017,150,170,320,46
KARENGA,2018,150,170,320,46
KARENGA,2019,160,170,330,46
KARENGA,2020,160,180,340,46
KARENGA,2021,160,180,340,46
KARENGA,2022,170,180,350,46
KARENGA,2023,170,190,360,46
KARENGA,2024,180,190,370,46
KARENGA,2025,180,200,380,46
LAMWO,2015,350,380,730,46
LAMWO,2016,370,400,770,46
LAMWO,2017,380,430,810,46
LAMWO,2018,400,440,840,46
LAMWO,2019,390,460,850,46
LAMWO,2020,390,460,850,46
LAMWO,2021,380,460,840,46
LAMWO,2022,390,470,860,46
LAMWO,2023,390,480,870,46
LAMWO,2024,390,500,890,46
LAMWO,2025,400,510,910,46
LIRA,2015,1010,910,1920,46
LIRA,2016,1040,940,1980,46
LIRA,2017,1070,970,2040,46
LIRA,2018,1100,990,2090,46
LIRA,2019,1130,1020,2150,46
LIRA,2020,1160,1050,2210,46
LIRA,2021,1190,1080,2270,46
LIRA,2022,1220,1100,2320,46
LIRA,2023,1250,1130,2380,46
LIRA,2024,1270,1160,2430,46
LIRA,2025,1300,1190,2490,46
LUUKA,2015,620,730,1350,46
LUUKA,2016,650,780,1430,46
LUUKA,2017,680,830,1510,46
LUUKA,2018,700,880,1580,46
LUUKA,2019,730,900,1630,46
LUUKA,2020,730,920,1650,46
LUUKA,2021,730,930,1660,46
LUUKA,2022,730,950,1680,46
LUUKA,2023,740,970,1710,46
LUUKA,2024,760,1000,1760,46
LUUKA,2025,780,1050,1830,46
LUWERO,2015,1210,1300,2510,46
LUWERO,2016,1290,1400,2690,46
LUWERO,2017,1350,1500,2850,46
LUWERO,2018,1410,1570,2980,46
LUWERO,2019,1440,1620,3060,46
LUWERO,2020,1460,1650,3110,46
LUWERO,2021,1470,1690,3160,46
LUWERO,2022,1490,1720,3210,46
LUWERO,2023,1520,1770,3290,46
LUWERO,2024,1550,1840,3390,46
LUWERO,2025,1610,1920,3530,46
LWENGO,2015,780,850,1630,46
LWENGO,2016,820,900,1720,46
LWENGO,2017,850,950,1800,46
LWENGO,2018,880,990,1870,46
LWENGO,2019,870,1000,1870,46
LWENGO,2020,870,1010,1880,46
LWENGO,2021,870,1010,1880,46
LWENGO,2022,860,1030,1890,46
LWENGO,2023,870,1040,1910,46
LWENGO,2024,890,1060,1950,46
LWENGO,2025,900,1100,2000,46
LYANTONDE,2015,270,260,530,46
LYANTONDE,2016,280,280,560,46
LYANTONDE,2017,300,300,600,46
LYANTONDE,2018,330,330,660,46
LYANTONDE,2019,350,350,700,46
LYANTONDE,2020,360,370,730,46
LYANTONDE,2021,370,390,760,46
LYANTONDE,2022,380,400,780,46
LYANTONDE,2023,380,400,780,46
LYANTONDE,2024,390,410,800,46
LYANTONDE,2025,400,420,820,46
MANAFWA,2015,570,530,1100,46
MANAFWA,2016,590,550,1140,46
MANAFWA,2017,600,560,1160,46
MANAFWA,2018,620,570,1190,46
MANAFWA,2019,630,580,1210,46
MANAFWA,2020,650,600,1250,46
MANAFWA,2021,660,610,1270,46
MANAFWA,2022,680,620,1300,46
MANAFWA,2023,690,630,1320,46
MANAFWA,2024,700,640,1340,46
MANAFWA,2025,720,650,1370,46
MARACHA,2015,470,550,1020,46
MARACHA,2016,480,560,1040,46
MARACHA,2017,490,570,1060,46
MARACHA,2018,500,580,1080,46
MARACHA,2019,510,590,1100,46
MARACHA,2020,520,600,1120,46
MARACHA,2021,530,610,1140,46
MARACHA,2022,540,620,1160,46
MARACHA,2023,550,630,1180,46
MARACHA,2024,560,640,1200,46
MARACHA,2025,570,650,1220,46
MASAKA,2015,730,710,1440,46
MASAKA,2016,770,750,1520,46
MASAKA,2017,820,810,1630,46
MASAKA,2018,870,870,1740,46
MASAKA,2019,910,930,1840,46
MASAKA,2020,950,970,1920,46
MASAKA,2021,970,1000,1970,46
MASAKA,2022,970,1010,1980,46
MASAKA,2023,980,1030,2010,46
MASAKA,2024,990,1060,2050,46
MASAKA,2025,1000,1080,2080,46
MASINDI,2015,820,650,1470,46
MASINDI,2016,840,670,1510,46
MASINDI,2017,870,690,1560,46
MASINDI,2018,890,710,1600,46
MASINDI,2019,920,730,1650,46
MASINDI,2020,940,740,1680,46
MASINDI,2021,970,760,1730,46
MASINDI,2022,1000,780,1780,46
MASINDI,2023,1020,800,1820,46
MASINDI,2024,1050,820,1870,46
MASINDI,2025,1070,840,1910,46
MAYUGE,2015,1240,1390,2630,46
MAYUGE,2016,1330,1510,2840,46
MAYUGE,2017,1410,1630,3040,46
MAYUGE,2018,1480,1730,3210,46
MAYUGE,2019,1530,1790,3320,46
MAYUGE,2020,1540,1850,3390,46
MAYUGE,2021,1560,1900,3460,46
MAYUGE,2022,1590,1960,3550,46
MAYUGE,2023,1640,2040,3680,46
MAYUGE,2024,1700,2120,3820,46
MAYUGE,2025,1770,2220,3990,46
MBALE,2015,1720,1890,3610,46
MBALE,2016,1850,2070,3920,46
MBALE,2017,1960,2220,4180,46
MBALE,2018,2050,2350,4400,46
MBALE,2019,2100,2460,4560,46
MBALE,2020,2130,2540,4670,46
MBALE,2021,2160,2610,4770,46
MBALE,2022,2200,2700,4900,46
MBALE,2023,2250,2810,5060,46
MBALE,2024,2340,2930,5270,46
MBALE,2025,2430,3090,5520,46
MBARARA,2015,1060,950,2010,46
MBARARA,2016,1090,970,2060,46
MBARARA,2017,1110,1000,2110,46
MBARARA,2018,1140,1020,2160,46
MBARARA,2019,1170,1040,2210,46
MBARARA,2020,1190,1060,2250,46
MBARARA,2021,1220,1080,2300,46
MBARARA,2022,1240,1100,2340,46
MBARARA,2023,1260,1120,2380,46
MBARARA,2024,1290,1140,2430,46
MBARARA,2025,1310,1160,2470,46
MITOOMA,2015,470,580,1050,46
MITOOMA,2016,470,580,1050,46
MITOOMA,2017,480,590,1070,46
MITOOMA,2018,490,590,1080,46
MITOOMA,2019,490,600,1090,46
MITOOMA,2020,500,600,1100,46
MITOOMA,2021,500,610,1110,46
MITOOMA,2022,510,610,1120,46
MITOOMA,2023,510,620,1130,46
MITOOMA,2024,510,620,1130,46
MITOOMA,2025,520,620,1140,46
MITYANA,2015,890,930,1820,46
MITYANA,2016,950,1000,1950,46
MITYANA,2017,990,1060,2050,46
MITYANA,2018,1030,1100,2130,46
MITYANA,2019,1030,1120,2150,46
MITYANA,2020,1040,1150,2190,46
MITYANA,2021,1040,1160,2200,46
MITYANA,2022,1050,1180,2230,46
MITYANA,2023,1060,1210,2270,46
MITYANA,2024,1080,1240,2320,46
MITYANA,2025,1120,1290,2410,46
MOROTO,2015,230,240,470,46
MOROTO,2016,240,260,500,46
MOROTO,2017,240,280,520,46
MOROTO,2018,260,290,550,46
MOROTO,2019,260,310,570,46
MOROTO,2020,270,310,580,46
MOROTO,2021,260,320,580,46
MOROTO,2022,270,320,590,46
MOROTO,2023,270,340,610,46
MOROTO,2024,280,340,620,46
MOROTO,2025,290,370,660,46
MOYO,2015,270,340,610,46
MOYO,2016,280,350,630,46
MOYO,2017,290,360,650,46
MOYO,2018,290,360,650,46
MOYO,2019,300,370,670,46
MOYO,2020,310,380,690,46
MOYO,2021,320,390,710,46
MOYO,2022,320,390,710,46
MOYO,2023,330,400,730,46
MOYO,2024,340,410,750,46
MOYO,2025,340,410,750,46
MPIGI,2015,640,720,1360,46
MPIGI,2016,680,770,1450,46
MPIGI,2017,720,820,1540,46
MPIGI,2018,740,870,1610,46
MPIGI,2019,760,890,1650,46
MPIGI,2020,760,920,1680,46
MPIGI,2021,780,930,1710,46
MPIGI,2022,780,950,1730,46
MPIGI,2023,800,980,1780,46
MPIGI,2024,820,1020,1840,46
MPIGI,2025,840,1050,1890,46
MUBENDE,2015,1210,1150,2360,46
MUBENDE,2016,1330,1270,2600,46
MUBENDE,2017,1440,1410,2850,46
MUBENDE,2018,1530,1510,3040,46
MUBENDE,2019,1610,1600,3210,46
MUBENDE,2020,1660,1680,3340,46
MUBENDE,2021,1730,1760,3490,46
MUBENDE,2022,1800,1850,3650,46
MUBENDE,2023,1880,1970,3850,46
MUBENDE,2024,1980,2090,4070,46
MUBENDE,2025,2120,2240,4360,46
MUKONO,2015,1720,1770,3490,46
MUKONO,2016,1840,1920,3760,46
MUKONO,2017,1940,2070,4010,46
MUKONO,2018,2030,2190,4220,46
MUKONO,2019,2070,2280,4350,46
MUKONO,2020,2100,2330,4430,46
MUKONO,2021,2110,2400,4510,46
MUKONO,2022,2150,2480,4630,46
MUKONO,2023,2190,2560,4750,46
MUKONO,2024,2270,2670,4940,46
MUKONO,2025,2350,2790,5140,46
MADI OKOLLO,2015,330,380,710,46
MADI OKOLLO,2016,340,390,730,46
MADI OKOLLO,2017,350,400,750,46
MADI OKOLLO,2018,360,410,770,46
MADI OKOLLO,2019,370,420,790,46
MADI OKOLLO,2020,380,430,810,46
MADI OKOLLO,2021,390,440,830,46
MADI OKOLLO,2022,400,450,850,46
MADI OKOLLO,2023,410,460,870,46
MADI OKOLLO,2024,420,470,890,46
MADI OKOLLO,2025,430,480,910,46
NABILATUK,2015,140,160,300,46
NABILATUK,2016,150,170,320,46
NABILATUK,2017,160,190,350,46
NABILATUK,2018,170,190,360,46
NABILATUK,2019,180,210,390,46
NABILATUK,2020,190,220,410,46
NABILATUK,2021,190,220,410,46
NABILATUK,2022,200,240,440,46
NABILATUK,2023,210,250,460,46
NABILATUK,2024,230,270,500,46
NABILATUK,2025,240,280,520,46
NAKAPIRIPIRIT,2015,230,230,460,46
NAKAPIRIPIRIT,2016,240,260,500,46
NAKAPIRIPIRIT,2017,260,280,540,46
NAKAPIRIPIRIT,2018,270,300,570,46
NAKAPIRIPIRIT,2019,280,320,600,46
NAKAPIRIPIRIT,2020,290,330,620,46
NAKAPIRIPIRIT,2021,300,330,630,46
NAKAPIRIPIRIT,2022,320,350,670,46
NAKAPIRIPIRIT,2023,330,380,710,46
NAKAPIRIPIRIT,2024,340,400,740,46
NAKAPIRIPIRIT,2025,360,420,780,46
NAKASEKE,2015,640,400,1040,46
NAKASEKE,2016,670,410,1080,46
NAKASEKE,2017,690,420,1110,46
NAKASEKE,2018,720,430,1150,46
NAKASEKE,2019,740,440,1180,46
NAKASEKE,2020,770,450,1220,46
NAKASEKE,2021,790,460,1250,46
NAKASEKE,2022,820,470,1290,46
NAKASEKE,2023,850,480,1330,46
NAKASEKE,2024,870,490,1360,46
NAKASEKE,2025,900,500,1400,46
NAKASONGOLA,2015,560,500,1060,46
NAKASONGOLA,2016,590,540,1130,46
NAKASONGOLA,2017,630,580,1210,46
NAKASONGOLA,2018,670,620,1290,46
NAKASONGOLA,2019,680,640,1320,46
NAKASONGOLA,2020,690,650,1340,46
NAKASONGOLA,2021,700,670,1370,46
NAKASONGOLA,2022,720,680,1400,46
NAKASONGOLA,2023,740,700,1440,46
NAKASONGOLA,2024,760,730,1490,46
NAKASONGOLA,2025,790,780,1570,46
NAMAYINGO,2015,640,630,1270,46
NAMAYINGO,2016,680,680,1360,46
NAMAYINGO,2017,710,720,1430,46
NAMAYINGO,2018,730,760,1490,46
NAMAYINGO,2019,740,780,1520,46
NAMAYINGO,2020,750,780,1530,46
NAMAYINGO,2021,750,790,1540,46
NAMAYINGO,2022,760,810,1570,46
NAMAYINGO,2023,770,820,1590,46
NAMAYINGO,2024,780,840,1620,46
NAMAYINGO,2025,810,880,1690,46
NAMISINDWA,2015,690,670,1360,46
NAMISINDWA,2016,710,690,1400,46
NAMISINDWA,2017,730,700,1430,46
NAMISINDWA,2018,750,720,1470,46
NAMISINDWA,2019,770,740,1510,46
NAMISINDWA,2020,790,750,1540,46
NAMISINDWA,2021,810,770,1580,46
NAMISINDWA,2022,830,790,1620,46
NAMISINDWA,2023,850,800,1650,46
NAMISINDWA,2024,870,820,1690,46
NAMISINDWA,2025,890,830,1720,46
NAMUTUMBA,2015,700,690,1390,46
NAMUTUMBA,2016,750,760,1510,46
NAMUTUMBA,2017,790,820,1610,46
NAMUTUMBA,2018,840,870,1710,46
NAMUTUMBA,2019,860,900,1760,46
NAMUTUMBA,2020,890,930,1820,46
NAMUTUMBA,2021,900,960,1860,46
NAMUTUMBA,2022,920,990,1910,46
NAMUTUMBA,2023,940,1030,1970,46
NAMUTUMBA,2024,980,1070,2050,46
NAMUTUMBA,2025,1020,1130,2150,46
NAPAK,2015,300,490,790,46
NAPAK,2016,320,530,850,46
NAPAK,2017,330,550,880,46
NAPAK,2018,350,580,930,46
NAPAK,2019,340,600,940,46
NAPAK,2020,350,610,960,46
NAPAK,2021,350,620,970,46
NAPAK,2022,350,630,980,46
NAPAK,2023,350,650,1000,46
NAPAK,2024,360,670,1030,46
NAPAK,2025,370,700,1070,46
NEBBI,2015,630,660,1290,46
NEBBI,2016,650,670,1320,46
NEBBI,2017,670,690,1360,46
NEBBI,2018,690,710,1400,46
NEBBI,2019,720,730,1450,46
NEBBI,2020,740,750,1490,46
NEBBI,2021,760,770,1530,46
NEBBI,2022,780,790,1570,46
NEBBI,2023,800,810,1610,46
NEBBI,2024,820,830,1650,46
NEBBI,2025,850,850,1700,46
NGORA,2015,350,460,810,46
NGORA,2016,380,500,880,46
NGORA,2017,390,540,930,46
NGORA,2018,410,560,970,46
NGORA,2019,420,580,1000,46
NGORA,2020,420,600,1020,46
NGORA,2021,430,610,1040,46
NGORA,2022,440,630,1070,46
NGORA,2023,450,650,1100,46
NGORA,2024,460,670,1130,46
NGORA,2025,480,700,1180,46
NTOROKO,2015,210,150,360,46
NTOROKO,2016,210,170,380,46
NTOROKO,2017,230,170,400,46
NTOROKO,2018,230,180,410,46
NTOROKO,2019,250,180,430,46
NTOROKO,2020,240,190,430,46
NTOROKO,2021,250,190,440,46
NTOROKO,2022,250,190,440,46
NTOROKO,2023,260,200,460,46
NTOROKO,2024,260,210,470,46
NTOROKO,2025,280,220,500,46
NTUNGAMO,2015,1370,1450,2820,46
NTUNGAMO,2016,1400,1480,2880,46
NTUNGAMO,2017,1430,1510,2940,46
NTUNGAMO,2018,1460,1540,3000,46
NTUNGAMO,2019,1490,1560,3050,46
NTUNGAMO,2020,1520,1590,3110,46
NTUNGAMO,2021,1550,1620,3170,46
NTUNGAMO,2022,1570,1640,3210,46
NTUNGAMO,2023,1600,1670,3270,46
NTUNGAMO,2024,1630,1690,3320,46
NTUNGAMO,2025,1660,1720,3380,46
NWOYA,2015,320,330,650,46
NWOYA,2016,350,370,720,46
NWOYA,2017,390,410,800,46
NWOYA,2018,430,450,880,46
NWOYA,2019,470,490,960,46
NWOYA,2020,520,540,1060,46
NWOYA,2021,580,600,1180,46
NWOYA,2022,630,660,1290,46
NWOYA,2023,700,720,1420,46
NWOYA,2024,770,790,1560,46
NWOYA,2025,840,870,1710,46
OBONGI,2015,100,110,210,46
OBONGI,2016,120,120,240,46
OBONGI,2017,120,120,240,46
OBONGI,2018,120,120,240,46
OBONGI,2019,120,120,240,46
OBONGI,2020,130,120,250,46
OBONGI,2021,130,140,270,46
OBONGI,2022,130,140,270,46
OBONGI,2023,130,140,270,46
OBONGI,2024,140,140,280,46
OBONGI,2025,140,150,290,46
OMORO,2015,480,510,990,46
OMORO,2016,520,550,1070,46
OMORO,2017,560,600,1160,46
OMORO,2018,580,630,1210,46
OMORO,2019,600,670,1270,46
OMORO,2020,620,680,1300,46
OMORO,2021,620,710,1330,46
OMORO,2022,640,720,1360,46
OMORO,2023,660,760,1420,46
OMORO,2024,690,800,1490,46
OMORO,2025,710,830,1540,46
OTUKE,2015,290,250,540,46
OTUKE,2016,300,260,560,46
OTUKE,2017,320,270,590,46
OTUKE,2018,330,280,610,46
OTUKE,2019,340,290,630,46
OTUKE,2020,360,300,660,46
OTUKE,2021,370,310,680,46
OTUKE,2022,390,330,720,46
OTUKE,2023,410,340,750,46
OTUKE,2024,420,350,770,46
OTUKE,2025,440,370,810,46
OYAM,2015,1110,1130,2240,46
OYAM,2016,1150,1160,2310,46
OYAM,2017,1180,1190,2370,46
OYAM,2018,1220,1230,2450,46
OYAM,2019,1250,1260,2510,46
OYAM,2020,1290,1300,2590,46
OYAM,2021,1330,1330,2660,46
OYAM,2022,1360,1370,2730,46
OYAM,2023,1400,1400,2800,46
OYAM,2024,1440,1440,2880,46
OYAM,2025,1470,1470,2940,46
PADER,2015,500,550,1050,46
PADER,2016,530,590,1120,46
PADER,2017,550,630,1180,46
PADER,2018,570,660,1230,46
PADER,2019,580,680,1260,46
PADER,2020,580,690,1270,46
PADER,2021,580,690,1270,46
PADER,2022,580,710,1290,46
PADER,2023,590,730,1320,46
PADER,2024,610,760,1370,46
PADER,2025,610,790,1400,46
PAKWACH,2015,380,430,810,46
PAKWACH,2016,400,450,850,46
PAKWACH,2017,420,460,880,46
PAKWACH,2018,430,480,910,46
PAKWACH,2019,450,500,950,46
PAKWACH,2020,470,510,980,46
PAKWACH,2021,490,530,1020,46
PAKWACH,2022,510,550,1060,46
PAKWACH,2023,530,570,1100,46
PAKWACH,2024,550,590,1140,46
PAKWACH,2025,570,600,1170,46
PALLISA,2015,750,750,1500,46
PALLISA,2016,820,830,1650,46
PALLISA,2017,890,910,1800,46
PALLISA,2018,940,980,1920,46
PALLISA,2019,970,1030,2000,46
PALLISA,2020,1010,1070,2080,46
PALLISA,2021,1040,1110,2150,46
PALLISA,2022,1060,1150,2210,46
PALLISA,2023,1110,1210,2320,46
PALLISA,2024,1160,1290,2450,46
PALLISA,2025,1230,1360,2590,46
RAKAI,2015,860,790,1650,46
RAKAI,2016,910,850,1760,46
RAKAI,2017,960,910,1870,46
RAKAI,2018,1000,950,1950,46
RAKAI,2019,1020,990,2010,46
RAKAI,2020,1030,1010,2040,46
RAKAI,2021,1050,1030,2080,46
RAKAI,2022,1060,1060,2120,46
RAKAI,2023,1080,1080,2160,46
RAKAI,2024,1120,1120,2240,46
RAKAI,2025,1150,1170,2320,46
RUBANDA,2015,460,620,1080,46
RUBANDA,2016,460,630,1090,46
RUBANDA,2017,470,630,1100,46
RUBANDA,2018,480,640,1120,46
RUBANDA,2019,480,640,1120,46
RUBANDA,2020,490,650,1140,46
RUBANDA,2021,490,650,1140,46
RUBANDA,2022,500,650,1150,46
RUBANDA,2023,500,660,1160,46
RUBANDA,2024,510,660,1170,46
RUBANDA,2025,510,660,1170,46
RUBIRIZI,2015,360,360,720,46
RUBIRIZI,2016,360,370,730,46
RUBIRIZI,2017,370,380,750,46
RUBIRIZI,2018,380,380,760,46
RUBIRIZI,2019,390,390,780,46
RUBIRIZI,2020,390,400,790,46
RUBIRIZI,2021,400,400,800,46
RUBIRIZI,2022,410,410,820,46
RUBIRIZI,2023,410,420,830,46
RUBIRIZI,2024,420,420,840,46
RUBIRIZI,2025,430,430,860,46
RUKIGA,2015,280,350,630,46
RUKIGA,2016,280,350,630,46
RUKIGA,2017,290,360,650,46
RUKIGA,2018,290,360,650,46
RUKIGA,2019,290,360,650,46
RUKIGA,2020,300,360,660,46
RUKIGA,2021,300,360,660,46
RUKIGA,2022,300,370,670,46
RUKIGA,2023,300,370,670,46
RUKIGA,2024,300,370,670,46
RUKIGA,2025,310,370,680,46
RUKUNGIRI,2015,890,1010,1900,46
RUKUNGIRI,2016,900,1020,1920,46
RUKUNGIRI,2017,910,1030,1940,46
RUKUNGIRI,2018,920,1040,1960,46
RUKUNGIRI,2019,930,1050,1980,46
RUKUNGIRI,2020,940,1060,2000,46
RUKUNGIRI,2021,950,1070,2020,46
RUKUNGIRI,2022,960,1080,2040,46
RUKUNGIRI,2023,970,1080,2050,46
RUKUNGIRI,2024,980,1090,2070,46
RUKUNGIRI,2025,980,1100,2080,46
RWAMPARA,2015,370,350,720,46
RWAMPARA,2016,370,360,730,46
RWAMPARA,2017,380,370,750,46
RWAMPARA,2018,390,380,770,46
RWAMPARA,2019,400,380,780,46
RWAMPARA,2020,410,390,800,46
RWAMPARA,2021,420,400,820,46
RWAMPARA,2022,420,410,830,46
RWAMPARA,2023,430,410,840,46
RWAMPARA,2024,440,420,860,46
RWAMPARA,2025,450,430,880,46
SERERE,2015,750,840,1590,46
SERERE,2016,820,920,1740,46
SERERE,2017,880,1000,1880,46
SERERE,2018,930,1070,2000,46
SERERE,2019,960,1120,2080,46
SERERE,2020,980,1170,2150,46
SERERE,2021,1000,1210,2210,46
SERERE,2022,1030,1250,2280,46
SERERE,2023,1070,1320,2390,46
SERERE,2024,1120,1390,2510,46
SERERE,2025,1170,1460,2630,46
SHEEMA,2015,670,740,1410,46
SHEEMA,2016,680,740,1420,46
SHEEMA,2017,690,750,1440,46
SHEEMA,2018,700,760,1460,46
SHEEMA,2019,700,770,1470,46
SHEEMA,2020,710,770,1480,46
SHEEMA,2021,720,780,1500,46
SHEEMA,2022,730,790,1520,46
SHEEMA,2023,730,790,1520,46
SHEEMA,2024,740,800,1540,46
SHEEMA,2025,740,800,1540,46
SIRONKO,2015,910,850,1760,46
SIRONKO,2016,940,870,1810,46
SIRONKO,2017,960,890,1850,46
SIRONKO,2018,980,910,1890,46
SIRONKO,2019,1000,920,1920,46
SIRONKO,2020,1030,940,1970,46
SIRONKO,2021,1050,960,2010,46
SIRONKO,2022,1070,980,2050,46
SIRONKO,2023,1090,990,2080,46
SIRONKO,2024,1110,1010,2120,46
SIRONKO,2025,1130,1020,2150,46
SOROTI,2015,730,800,1530,46
SOROTI,2016,750,810,1560,46
SOROTI,2017,790,850,1640,46
SOROTI,2018,850,940,1790,46
SOROTI,2019,920,1020,1940,46
SOROTI,2020,990,1110,2100,46
SOROTI,2021,1040,1170,2210,46
SOROTI,2022,1070,1230,2300,46
SOROTI,2023,1100,1260,2360,46
SOROTI,2024,1110,1300,2410,46
SOROTI,2025,1150,1340,2490,46
SSEMBABULE,2015,870,730,1600,46
SSEMBABULE,2016,930,800,1730,46
SSEMBABULE,2017,970,840,1810,46
SSEMBABULE,2018,1030,890,1920,46
SSEMBABULE,2019,1050,930,1980,46
SSEMBABULE,2020,1050,940,1990,46
SSEMBABULE,2021,1070,970,2040,46
SSEMBABULE,2022,1090,1000,2090,46
SSEMBABULE,2023,1120,1030,2150,46
SSEMBABULE,2024,1150,1070,2220,46
SSEMBABULE,2025,1200,1130,2330,46
TORORO,2015,1390,1540,2930,46
TORORO,2016,1430,1580,3010,46
TORORO,2017,1460,1620,3080,46
TORORO,2018,1500,1660,3160,46
TORORO,2019,1540,1700,3240,46
TORORO,2020,1580,1740,3320,46
TORORO,2021,1620,1780,3400,46
TORORO,2022,1660,1820,3480,46
TORORO,2023,1690,1860,3550,46
TORORO,2024,1730,1900,3630,46
TORORO,2025,1770,1940,3710,46
WAKISO,2015,4710,3940,8650,46
WAKISO,2016,5030,4210,9240,46
WAKISO,2017,5370,4500,9870,46
WAKISO,2018,5720,4800,10520,46
WAKISO,2019,6100,5120,11220,46
WAKISO,2020,6500,5460,11960,46
WAKISO,2021,6920,5830,12750,46
WAKISO,2022,7360,6210,13570,46
WAKISO,2023,7830,6610,14440,46
WAKISO,2024,8320,7030,15350,46
WAKISO,2025,8830,7480,16310,46
YUMBE,2015,1000,950,1950,46
YUMBE,2016,1090,1050,2140,46
YUMBE,2017,1180,1160,2340,46
YUMBE,2018,1260,1260,2520,46
YUMBE,2019,1320,1360,2680,46
YUMBE,2020,1370,1430,2800,46
YUMBE,2021,1420,1510,2930,46
YUMBE,2022,1460,1600,3060,46
YUMBE,2023,1530,1710,3240,46
YUMBE,2024,1630,1830,3460,46
YUMBE,2025,1720,1970,3690,46
ZOMBO,2015,690,690,1380,46
ZOMBO,2016,710,700,1410,46
ZOMBO,2017,740,720,1460,46
ZOMBO,2018,760,740,1500,46
ZOMBO,2019,780,760,1540,46
ZOMBO,2020,800,780,1580,46
ZOMBO,2021,830,800,1630,46
ZOMBO,2022,850,830,1680,46
ZOMBO,2023,870,850,1720,46
ZOMBO,2024,900,870,1770,46
ZOMBO,2025,920,890,1810,46
ABIM,2015,250,230,480,47
ABIM,2016,270,250,520,47
ABIM,2017,310,280,590,47
ABIM,2018,330,310,640,47
ABIM,2019,360,330,690,47
ABIM,2020,370,370,740,47
ABIM,2021,400,380,780,47
ABIM,2022,420,410,830,47
ABIM,2023,440,430,870,47
ABIM,2024,460,470,930,47
ABIM,2025,490,490,980,47
ADJUMANI,2015,370,470,840,47
ADJUMANI,2016,380,480,860,47
ADJUMANI,2017,380,480,860,47
ADJUMANI,2018,380,490,870,47
ADJUMANI,2019,390,490,880,47
ADJUMANI,2020,390,500,890,47
ADJUMANI,2021,390,500,890,47
ADJUMANI,2022,390,500,890,47
ADJUMANI,2023,390,510,900,47
ADJUMANI,2024,390,510,900,47
ADJUMANI,2025,400,510,910,47
AGAGO,2015,470,450,920,47
AGAGO,2016,480,460,940,47
AGAGO,2017,490,460,950,47
AGAGO,2018,500,470,970,47
AGAGO,2019,510,480,990,47
AGAGO,2020,510,490,1000,47
AGAGO,2021,520,500,1020,47
AGAGO,2022,530,500,1030,47
AGAGO,2023,540,510,1050,47
AGAGO,2024,540,520,1060,47
AGAGO,2025,550,520,1070,47
ALEBTONG,2015,550,590,1140,47
ALEBTONG,2016,590,640,1230,47
ALEBTONG,2017,640,690,1330,47
ALEBTONG,2018,670,750,1420,47
ALEBTONG,2019,690,790,1480,47
ALEBTONG,2020,720,810,1530,47
ALEBTONG,2021,720,840,1560,47
ALEBTONG,2022,740,850,1590,47
ALEBTONG,2023,740,870,1610,47
ALEBTONG,2024,760,910,1670,47
ALEBTONG,2025,790,950,1740,47
AMOLATAR,2015,410,390,800,47
AMOLATAR,2016,430,430,860,47
AMOLATAR,2017,460,470,930,47
AMOLATAR,2018,490,500,990,47
AMOLATAR,2019,510,530,1040,47
AMOLATAR,2020,530,540,1070,47
AMOLATAR,2021,530,550,1080,47
AMOLATAR,2022,540,560,1100,47
AMOLATAR,2023,540,580,1120,47
AMOLATAR,2024,560,600,1160,47
AMOLATAR,2025,570,620,1190,47
AMUDAT,2015,260,160,420,47
AMUDAT,2016,280,190,470,47
AMUDAT,2017,290,200,490,47
AMUDAT,2018,310,220,530,47
AMUDAT,2019,330,240,570,47
AMUDAT,2020,350,240,590,47
AMUDAT,2021,350,260,610,47
AMUDAT,2022,360,270,630,47
AMUDAT,2023,370,290,660,47
AMUDAT,2024,380,290,670,47
AMUDAT,2025,400,320,720,47
AMURIA,2015,470,560,1030,47
AMURIA,2016,510,610,1120,47
AMURIA,2017,540,660,1200,47
AMURIA,2018,590,720,1310,47
AMURIA,2019,620,770,1390,47
AMURIA,2020,640,800,1440,47
AMURIA,2021,650,830,1480,47
AMURIA,2022,670,850,1520,47
AMURIA,2023,680,870,1550,47
AMURIA,2024,700,910,1610,47
AMURIA,2025,740,960,1700,47
AMURU,2015,390,410,800,47
AMURU,2016,420,440,860,47
AMURU,2017,450,480,930,47
AMURU,2018,480,520,1000,47
AMURU,2019,500,530,1030,47
AMURU,2020,510,550,1060,47
AMURU,2021,500,570,1070,47
AMURU,2022,510,580,1090,47
AMURU,2023,520,600,1120,47
AMURU,2024,530,620,1150,47
AMURU,2025,550,650,1200,47
APAC,2015,400,410,810,47
APAC,2016,420,420,840,47
APAC,2017,430,430,860,47
APAC,2018,450,450,900,47
APAC,2019,470,460,930,47
APAC,2020,480,480,960,47
APAC,2021,500,500,1000,47
APAC,2022,520,510,1030,47
APAC,2023,530,530,1060,47
APAC,2024,550,540,1090,47
APAC,2025,570,560,1130,47
ARUA,2015,1290,1580,2870,47
ARUA,2016,1330,1620,2950,47
ARUA,2017,1370,1670,3040,47
ARUA,2018,1410,1710,3120,47
ARUA,2019,1450,1760,3210,47
ARUA,2020,1480,1800,3280,47
ARUA,2021,1520,1850,3370,47
ARUA,2022,1560,1890,3450,47
ARUA,2023,1600,1940,3540,47
ARUA,2024,1640,1980,3620,47
ARUA,2025,1680,2030,3710,47
BUDAKA,2015,580,540,1120,47
BUDAKA,2016,630,590,1220,47
BUDAKA,2017,660,650,1310,47
BUDAKA,2018,710,690,1400,47
BUDAKA,2019,750,740,1490,47
BUDAKA,2020,770,760,1530,47
BUDAKA,2021,790,790,1580,47
BUDAKA,2022,800,820,1620,47
BUDAKA,2023,820,840,1660,47
BUDAKA,2024,850,880,1730,47
BUDAKA,2025,880,930,1810,47
BUDUDA,2015,630,540,1170,47
BUDUDA,2016,690,600,1290,47
BUDUDA,2017,740,660,1400,47
BUDUDA,2018,810,720,1530,47
BUDUDA,2019,850,770,1620,47
BUDUDA,2020,880,810,1690,47
BUDUDA,2021,910,840,1750,47
BUDUDA,2022,940,880,1820,47
BUDUDA,2023,970,920,1890,47
BUDUDA,2024,1010,960,1970,47
BUDUDA,2025,1060,1030,2090,47
BUGIRI,2015,910,1050,1960,47
BUGIRI,2016,980,1150,2130,47
BUGIRI,2017,1060,1270,2330,47
BUGIRI,2018,1150,1370,2520,47
BUGIRI,2019,1210,1470,2680,47
BUGIRI,2020,1260,1530,2790,47
BUGIRI,2021,1280,1590,2870,47
BUGIRI,2022,1310,1650,2960,47
BUGIRI,2023,1360,1700,3060,47
BUGIRI,2024,1410,1780,3190,47
BUGIRI,2025,1460,1880,3340,47
BUGWERI,2015,420,420,840,47
BUGWERI,2016,450,450,900,47
BUGWERI,2017,480,490,970,47
BUGWERI,2018,510,530,1040,47
BUGWERI,2019,530,550,1080,47
BUGWERI,2020,540,570,1110,47
BUGWERI,2021,560,580,1140,47
BUGWERI,2022,560,590,1150,47
BUGWERI,2023,570,610,1180,47
BUGWERI,2024,580,640,1220,47
BUGWERI,2025,600,660,1260,47
BUHWEJU,2015,280,330,610,47
BUHWEJU,2016,290,340,630,47
BUHWEJU,2017,300,350,650,47
BUHWEJU,2018,310,360,670,47
BUHWEJU,2019,320,370,690,47
BUHWEJU,2020,330,380,710,47
BUHWEJU,2021,340,390,730,47
BUHWEJU,2022,350,400,750,47
BUHWEJU,2023,360,410,770,47
BUHWEJU,2024,370,420,790,47
BUHWEJU,2025,380,430,810,47
BUIKWE,2015,1110,1180,2290,47
BUIKWE,2016,1170,1270,2440,47
BUIKWE,2017,1250,1370,2620,47
BUIKWE,2018,1300,1460,2760,47
BUIKWE,2019,1340,1530,2870,47
BUIKWE,2020,1370,1580,2950,47
BUIKWE,2021,1380,1610,2990,47
BUIKWE,2022,1380,1620,3000,47
BUIKWE,2023,1400,1660,3060,47
BUIKWE,2024,1410,1710,3120,47
BUIKWE,2025,1440,1770,3210,47
BUKEDEA,2015,530,570,1100,47
BUKEDEA,2016,570,630,1200,47
BUKEDEA,2017,620,690,1310,47
BUKEDEA,2018,670,750,1420,47
BUKEDEA,2019,720,800,1520,47
BUKEDEA,2020,750,840,1590,47
BUKEDEA,2021,760,870,1630,47
BUKEDEA,2022,780,900,1680,47
BUKEDEA,2023,810,940,1750,47
BUKEDEA,2024,840,990,1830,47
BUKEDEA,2025,880,1040,1920,47
BUKOMANSIMBI,2015,460,490,950,47
BUKOMANSIMBI,2016,470,520,990,47
BUKOMANSIMBI,2017,490,550,1040,47
BUKOMANSIMBI,2018,520,590,1110,47
BUKOMANSIMBI,2019,530,610,1140,47
BUKOMANSIMBI,2020,530,610,1140,47
BUKOMANSIMBI,2021,520,610,1130,47
BUKOMANSIMBI,2022,520,610,1130,47
BUKOMANSIMBI,2023,520,610,1130,47
BUKOMANSIMBI,2024,520,620,1140,47
BUKOMANSIMBI,2025,520,630,1150,47
BUKWO,2015,200,170,370,47
BUKWO,2016,210,180,390,47
BUKWO,2017,220,190,410,47
BUKWO,2018,230,200,430,47
BUKWO,2019,250,210,460,47
BUKWO,2020,260,220,480,47
BUKWO,2021,270,230,500,47
BUKWO,2022,290,240,530,47
BUKWO,2023,300,250,550,47
BUKWO,2024,310,260,570,47
BUKWO,2025,330,270,600,47
BULAMBULI,2015,570,530,1100,47
BULAMBULI,2016,630,590,1220,47
BULAMBULI,2017,680,650,1330,47
BULAMBULI,2018,740,710,1450,47
BULAMBULI,2019,780,760,1540,47
BULAMBULI,2020,820,810,1630,47
BULAMBULI,2021,850,840,1690,47
BULAMBULI,2022,870,880,1750,47
BULAMBULI,2023,900,920,1820,47
BULAMBULI,2024,940,980,1920,47
BULAMBULI,2025,990,1040,2030,47
BULIISA,2015,220,230,450,47
BULIISA,2016,240,250,490,47
BULIISA,2017,250,260,510,47
BULIISA,2018,260,270,530,47
BULIISA,2019,280,280,560,47
BULIISA,2020,290,290,580,47
BULIISA,2021,310,300,610,47
BULIISA,2022,320,320,640,47
BULIISA,2023,340,330,670,47
BULIISA,2024,360,340,700,47
BULIISA,2025,370,360,730,47
BUNDIBUGYO,2015,540,470,1010,47
BUNDIBUGYO,2016,590,510,1100,47
BUNDIBUGYO,2017,620,560,1180,47
BUNDIBUGYO,2018,670,600,1270,47
BUNDIBUGYO,2019,690,640,1330,47
BUNDIBUGYO,2020,710,660,1370,47
BUNDIBUGYO,2021,720,670,1390,47
BUNDIBUGYO,2022,720,690,1410,47
BUNDIBUGYO,2023,740,710,1450,47
BUNDIBUGYO,2024,760,730,1490,47
BUNDIBUGYO,2025,790,760,1550,47
BUNYANGABU,2015,410,460,870,47
BUNYANGABU,2016,430,490,920,47
BUNYANGABU,2017,450,520,970,47
BUNYANGABU,2018,480,560,1040,47
BUNYANGABU,2019,500,590,1090,47
BUNYANGABU,2020,510,610,1120,47
BUNYANGABU,2021,520,630,1150,47
BUNYANGABU,2022,520,630,1150,47
BUNYANGABU,2023,530,640,1170,47
BUNYANGABU,2024,540,670,1210,47
BUNYANGABU,2025,560,690,1250,47
BUSHENYI,2015,570,610,1180,47
BUSHENYI,2016,580,620,1200,47
BUSHENYI,2017,590,620,1210,47
BUSHENYI,2018,590,630,1220,47
BUSHENYI,2019,600,630,1230,47
BUSHENYI,2020,610,640,1250,47
BUSHENYI,2021,610,640,1250,47
BUSHENYI,2022,620,650,1270,47
BUSHENYI,2023,630,650,1280,47
BUSHENYI,2024,630,650,1280,47
BUSHENYI,2025,630,660,1290,47
BUSIA,2015,780,860,1640,47
BUSIA,2016,830,930,1760,47
BUSIA,2017,890,1020,1910,47
BUSIA,2018,940,1090,2030,47
BUSIA,2019,980,1150,2130,47
BUSIA,2020,1010,1210,2220,47
BUSIA,2021,1040,1240,2280,47
BUSIA,2022,1050,1270,2320,47
BUSIA,2023,1060,1300,2360,47
BUSIA,2024,1090,1350,2440,47
BUSIA,2025,1120,1400,2520,47
BUTALEJA,2015,640,710,1350,47
BUTALEJA,2016,700,770,1470,47
BUTALEJA,2017,760,850,1610,47
BUTALEJA,2018,810,910,1720,47
BUTALEJA,2019,850,970,1820,47
BUTALEJA,2020,870,1020,1890,47
BUTALEJA,2021,900,1050,1950,47
BUTALEJA,2022,910,1080,1990,47
BUTALEJA,2023,930,1120,2050,47
BUTALEJA,2024,970,1180,2150,47
BUTALEJA,2025,1000,1230,2230,47
BUTAMBALA,2015,230,230,460,47
BUTAMBALA,2016,240,240,480,47
BUTAMBALA,2017,250,250,500,47
BUTAMBALA,2018,270,260,530,47
BUTAMBALA,2019,280,270,550,47
BUTAMBALA,2020,280,280,560,47
BUTAMBALA,2021,270,290,560,47
BUTAMBALA,2022,280,290,570,47
BUTAMBALA,2023,280,290,570,47
BUTAMBALA,2024,280,290,570,47
BUTAMBALA,2025,280,300,580,47
BUTEBO,2015,280,290,570,47
BUTEBO,2016,290,310,600,47
BUTEBO,2017,310,320,630,47
BUTEBO,2018,330,340,670,47
BUTEBO,2019,330,360,690,47
BUTEBO,2020,350,370,720,47
BUTEBO,2021,340,370,710,47
BUTEBO,2022,340,380,720,47
BUTEBO,2023,350,380,730,47
BUTEBO,2024,350,390,740,47
BUTEBO,2025,350,390,740,47
BUVUMA,2015,310,190,500,47
BUVUMA,2016,330,200,530,47
BUVUMA,2017,350,210,560,47
BUVUMA,2018,370,230,600,47
BUVUMA,2019,400,240,640,47
BUVUMA,2020,420,260,680,47
BUVUMA,2021,440,280,720,47
BUVUMA,2022,470,290,760,47
BUVUMA,2023,500,310,810,47
BUVUMA,2024,530,330,860,47
BUVUMA,2025,560,350,910,47
BUYENDE,2015,730,680,1410,47
BUYENDE,2016,780,750,1530,47
BUYENDE,2017,850,830,1680,47
BUYENDE,2018,920,900,1820,47
BUYENDE,2019,970,970,1940,47
BUYENDE,2020,1010,1010,2020,47
BUYENDE,2021,1040,1050,2090,47
BUYENDE,2022,1070,1100,2170,47
BUYENDE,2023,1100,1150,2250,47
BUYENDE,2024,1140,1210,2350,47
BUYENDE,2025,1200,1280,2480,47
DOKOLO,2015,370,370,740,47
DOKOLO,2016,380,380,760,47
DOKOLO,2017,400,390,790,47
DOKOLO,2018,410,400,810,47
DOKOLO,2019,420,410,830,47
DOKOLO,2020,430,420,850,47
DOKOLO,2021,440,430,870,47
DOKOLO,2022,460,450,910,47
DOKOLO,2023,470,460,930,47
DOKOLO,2024,480,470,950,47
DOKOLO,2025,490,480,970,47
GOMBA,2015,530,440,970,47
GOMBA,2016,560,480,1040,47
GOMBA,2017,600,510,1110,47
GOMBA,2018,620,540,1160,47
GOMBA,2019,640,560,1200,47
GOMBA,2020,650,570,1220,47
GOMBA,2021,650,580,1230,47
GOMBA,2022,660,580,1240,47
GOMBA,2023,650,580,1230,47
GOMBA,2024,660,600,1260,47
GOMBA,2025,680,620,1300,47
GULU,2015,490,530,1020,47
GULU,2016,510,540,1050,47
GULU,2017,520,560,1080,47
GULU,2018,540,570,1110,47
GULU,2019,550,590,1140,47
GULU,2020,570,610,1180,47
GULU,2021,580,620,1200,47
GULU,2022,600,640,1240,47
GULU,2023,620,650,1270,47
GULU,2024,630,670,1300,47
GULU,2025,650,690,1340,47
HOIMA,2015,780,720,1500,47
HOIMA,2016,810,750,1560,47
HOIMA,2017,840,770,1610,47
HOIMA,2018,870,800,1670,47
HOIMA,2019,900,830,1730,47
HOIMA,2020,940,850,1790,47
HOIMA,2021,970,880,1850,47
HOIMA,2022,1000,910,1910,47
HOIMA,2023,1040,940,1980,47
HOIMA,2024,1070,970,2040,47
HOIMA,2025,1110,1000,2110,47
IBANDA,2015,610,710,1320,47
IBANDA,2016,620,720,1340,47
IBANDA,2017,630,740,1370,47
IBANDA,2018,640,750,1390,47
IBANDA,2019,660,760,1420,47
IBANDA,2020,670,770,1440,47
IBANDA,2021,680,790,1470,47
IBANDA,2022,690,800,1490,47
IBANDA,2023,700,810,1510,47
IBANDA,2024,710,820,1530,47
IBANDA,2025,720,830,1550,47
IGANGA,2015,870,860,1730,47
IGANGA,2016,930,930,1860,47
IGANGA,2017,1010,1020,2030,47
IGANGA,2018,1070,1090,2160,47
IGANGA,2019,1120,1150,2270,47
IGANGA,2020,1150,1190,2340,47
IGANGA,2021,1170,1220,2390,47
IGANGA,2022,1180,1250,2430,47
IGANGA,2023,1210,1290,2500,47
IGANGA,2024,1230,1330,2560,47
IGANGA,2025,1280,1390,2670,47
ISINGIRO,2015,1240,1270,2510,47
ISINGIRO,2016,1280,1310,2590,47
ISINGIRO,2017,1330,1360,2690,47
ISINGIRO,2018,1380,1410,2790,47
ISINGIRO,2019,1430,1450,2880,47
ISINGIRO,2020,1480,1500,2980,47
ISINGIRO,2021,1530,1550,3080,47
ISINGIRO,2022,1580,1600,3180,47
ISINGIRO,2023,1640,1660,3300,47
ISINGIRO,2024,1690,1710,3400,47
ISINGIRO,2025,1750,1760,3510,47
JINJA,2015,1080,1040,2120,47
JINJA,2016,1100,1060,2160,47
JINJA,2017,1120,1080,2200,47
JINJA,2018,1130,1090,2220,47
JINJA,2019,1150,1110,2260,47
JINJA,2020,1170,1120,2290,47
JINJA,2021,1190,1140,2330,47
JINJA,2022,1200,1150,2350,47
JINJA,2023,1220,1170,2390,47
JINJA,2024,1230,1180,2410,47
JINJA,2025,1250,1190,2440,47
KAABONG,2015,200,250,450,47
KAABONG,2016,200,260,460,47
KAABONG,2017,210,270,480,47
KAABONG,2018,210,270,480,47
KAABONG,2019,220,280,500,47
KAABONG,2020,230,290,520,47
KAABONG,2021,230,290,520,47
KAABONG,2022,240,300,540,47
KAABONG,2023,240,300,540,47
KAABONG,2024,250,310,560,47
KAABONG,2025,250,320,570,47
KABALE,2015,530,640,1170,47
KABALE,2016,540,650,1190,47
KABALE,2017,550,660,1210,47
KABALE,2018,550,670,1220,47
KABALE,2019,560,670,1230,47
KABALE,2020,570,680,1250,47
KABALE,2021,580,690,1270,47
KABALE,2022,580,690,1270,47
KABALE,2023,590,700,1290,47
KABALE,2024,600,700,1300,47
KABALE,2025,600,710,1310,47
KABAROLE,2015,620,580,1200,47
KABAROLE,2016,630,590,1220,47
KABAROLE,2017,640,600,1240,47
KABAROLE,2018,660,610,1270,47
KABAROLE,2019,670,630,1300,47
KABAROLE,2020,690,640,1330,47
KABAROLE,2021,700,650,1350,47
KABAROLE,2022,710,660,1370,47
KABAROLE,2023,730,680,1410,47
KABAROLE,2024,740,690,1430,47
KABAROLE,2025,750,700,1450,47
KABERAMAIDO,2015,270,340,610,47
KABERAMAIDO,2016,290,370,660,47
KABERAMAIDO,2017,320,410,730,47
KABERAMAIDO,2018,340,440,780,47
KABERAMAIDO,2019,360,470,830,47
KABERAMAIDO,2020,370,490,860,47
KABERAMAIDO,2021,380,520,900,47
KABERAMAIDO,2022,400,530,930,47
KABERAMAIDO,2023,410,550,960,47
KABERAMAIDO,2024,420,570,990,47
KABERAMAIDO,2025,440,620,1060,47
KAGADI,2015,730,720,1450,47
KAGADI,2016,760,750,1510,47
KAGADI,2017,790,770,1560,47
KAGADI,2018,820,800,1620,47
KAGADI,2019,850,830,1680,47
KAGADI,2020,880,860,1740,47
KAGADI,2021,910,880,1790,47
KAGADI,2022,940,910,1850,47
KAGADI,2023,970,940,1910,47
KAGADI,2024,1000,970,1970,47
KAGADI,2025,1030,1000,2030,47
KAKUMIRO,2015,740,620,1360,47
KAKUMIRO,2016,810,670,1480,47
KAKUMIRO,2017,880,730,1610,47
KAKUMIRO,2018,960,790,1750,47
KAKUMIRO,2019,1040,860,1900,47
KAKUMIRO,2020,1130,930,2060,47
KAKUMIRO,2021,1230,1000,2230,47
KAKUMIRO,2022,1330,1080,2410,47
KAKUMIRO,2023,1450,1170,2620,47
KAKUMIRO,2024,1570,1260,2830,47
KAKUMIRO,2025,1700,1360,3060,47
KALAKI,2015,290,240,530,47
KALAKI,2016,300,250,550,47
KALAKI,2017,320,260,580,47
KALAKI,2018,330,270,600,47
KALAKI,2019,340,280,620,47
KALAKI,2020,360,290,650,47
KALAKI,2021,370,300,670,47
KALAKI,2022,390,310,700,47
KALAKI,2023,400,320,720,47
KALAKI,2024,420,330,750,47
KALAKI,2025,430,340,770,47
KALANGALA,2015,210,100,310,47
KALANGALA,2016,220,100,320,47
KALANGALA,2017,230,110,340,47
KALANGALA,2018,240,110,350,47
KALANGALA,2019,250,120,370,47
KALANGALA,2020,250,120,370,47
KALANGALA,2021,260,120,380,47
KALANGALA,2022,270,130,400,47
KALANGALA,2023,280,130,410,47
KALANGALA,2024,290,140,430,47
KALANGALA,2025,300,140,440,47
KALIRO,2015,570,490,1060,47
KALIRO,2016,610,530,1140,47
KALIRO,2017,660,580,1240,47
KALIRO,2018,700,630,1330,47
KALIRO,2019,730,670,1400,47
KALIRO,2020,760,700,1460,47
KALIRO,2021,780,720,1500,47
KALIRO,2022,790,750,1540,47
KALIRO,2023,810,770,1580,47
KALIRO,2024,840,810,1650,47
KALIRO,2025,870,840,1710,47
KALUNGU,2015,580,560,1140,47
KALUNGU,2016,600,600,1200,47
KALUNGU,2017,640,630,1270,47
KALUNGU,2018,660,680,1340,47
KALUNGU,2019,680,700,1380,47
KALUNGU,2020,680,700,1380,47
KALUNGU,2021,680,720,1400,47
KALUNGU,2022,670,720,1390,47
KALUNGU,2023,680,720,1400,47
KALUNGU,2024,680,730,1410,47
KALUNGU,2025,680,760,1440,47
KAMPALA,2015,3270,2710,5980,47
KAMPALA,2016,3340,2760,6100,47
KAMPALA,2017,3410,2820,6230,47
KAMPALA,2018,3470,2870,6340,47
KAMPALA,2019,3540,2920,6460,47
KAMPALA,2020,3600,2980,6580,47
KAMPALA,2021,3660,3030,6690,47
KAMPALA,2022,3730,3080,6810,47
KAMPALA,2023,3790,3130,6920,47
KAMPALA,2024,3840,3180,7020,47
KAMPALA,2025,3900,3220,7120,47
KAMULI,2015,1160,1330,2490,47
KAMULI,2016,1230,1440,2670,47
KAMULI,2017,1310,1550,2860,47
KAMULI,2018,1390,1650,3040,47
KAMULI,2019,1440,1740,3180,47
KAMULI,2020,1480,1790,3270,47
KAMULI,2021,1490,1830,3320,47
KAMULI,2022,1500,1860,3360,47
KAMULI,2023,1530,1900,3430,47
KAMULI,2024,1550,1970,3520,47
KAMULI,2025,1600,2040,3640,47
KAMWENGE,2015,620,630,1250,47
KAMWENGE,2016,650,660,1310,47
KAMWENGE,2017,670,680,1350,47
KAMWENGE,2018,700,700,1400,47
KAMWENGE,2019,730,730,1460,47
KAMWENGE,2020,760,750,1510,47
KAMWENGE,2021,790,780,1570,47
KAMWENGE,2022,820,800,1620,47
KAMWENGE,2023,850,830,1680,47
KAMWENGE,2024,880,860,1740,47
KAMWENGE,2025,910,880,1790,47
KANUNGU,2015,610,680,1290,47
KANUNGU,2016,620,690,1310,47
KANUNGU,2017,640,700,1340,47
KANUNGU,2018,650,710,1360,47
KANUNGU,2019,660,720,1380,47
KANUNGU,2020,670,730,1400,47
KANUNGU,2021,680,740,1420,47
KANUNGU,2022,690,750,1440,47
KANUNGU,2023,700,760,1460,47
KANUNGU,2024,710,770,1480,47
KANUNGU,2025,720,780,1500,47
KAPCHORWA,2015,300,270,570,47
KAPCHORWA,2016,310,280,590,47
KAPCHORWA,2017,320,290,610,47
KAPCHORWA,2018,330,300,630,47
KAPCHORWA,2019,340,300,640,47
KAPCHORWA,2020,350,310,660,47
KAPCHORWA,2021,360,320,680,47
KAPCHORWA,2022,370,330,700,47
KAPCHORWA,2023,380,340,720,47
KAPCHORWA,2024,390,340,730,47
KAPCHORWA,2025,400,350,750,47
KAPELEBYONG,2015,210,220,430,47
KAPELEBYONG,2016,230,240,470,47
KAPELEBYONG,2017,250,250,500,47
KAPELEBYONG,2018,260,280,540,47
KAPELEBYONG,2019,280,290,570,47
KAPELEBYONG,2020,280,310,590,47
KAPELEBYONG,2021,290,310,600,47
KAPELEBYONG,2022,290,320,610,47
KAPELEBYONG,2023,290,320,610,47
KAPELEBYONG,2024,310,340,650,47
KAPELEBYONG,2025,310,350,660,47
KASESE,2015,1680,1660,3340,47
KASESE,2016,1770,1790,3560,47
KASESE,2017,1900,1930,3830,47
KASESE,2018,2000,2060,4060,47
KASESE,2019,2080,2170,4250,47
KASESE,2020,2130,2230,4360,47
KASESE,2021,2140,2280,4420,47
KASESE,2022,2160,2320,4480,47
KASESE,2023,2180,2360,4540,47
KASESE,2024,2230,2430,4660,47
KASESE,2025,2290,2520,4810,47
KASSANDA,2015,660,630,1290,47
KASSANDA,2016,680,640,1320,47
KASSANDA,2017,700,650,1350,47
KASSANDA,2018,720,670,1390,47
KASSANDA,2019,740,680,1420,47
KASSANDA,2020,760,700,1460,47
KASSANDA,2021,780,710,1490,47
KASSANDA,2022,800,720,1520,47
KASSANDA,2023,820,740,1560,47
KASSANDA,2024,840,750,1590,47
KASSANDA,2025,860,760,1620,47
KATAKWI,2015,410,460,870,47
KATAKWI,2016,430,490,920,47
KATAKWI,2017,460,540,1000,47
KATAKWI,2018,490,570,1060,47
KATAKWI,2019,510,610,1120,47
KATAKWI,2020,540,630,1170,47
KATAKWI,2021,550,640,1190,47
KATAKWI,2022,550,640,1190,47
KATAKWI,2023,560,660,1220,47
KATAKWI,2024,570,680,1250,47
KATAKWI,2025,590,710,1300,47
KAYUNGA,2015,910,970,1880,47
KAYUNGA,2016,970,1040,2010,47
KAYUNGA,2017,1040,1130,2170,47
KAYUNGA,2018,1080,1190,2270,47
KAYUNGA,2019,1120,1240,2360,47
KAYUNGA,2020,1130,1270,2400,47
KAYUNGA,2021,1150,1280,2430,47
KAYUNGA,2022,1140,1310,2450,47
KAYUNGA,2023,1160,1330,2490,47
KAYUNGA,2024,1170,1360,2530,47
KAYUNGA,2025,1190,1400,2590,47
KAZO,2015,520,450,970,47
KAZO,2016,540,470,1010,47
KAZO,2017,560,480,1040,47
KAZO,2018,580,500,1080,47
KAZO,2019,600,520,1120,47
KAZO,2020,620,530,1150,47
KAZO,2021,640,550,1190,47
KAZO,2022,670,570,1240,47
KAZO,2023,690,590,1280,47
KAZO,2024,710,610,1320,47
KAZO,2025,740,630,1370,47
KIBAALE,2015,300,300,600,47
KIBAALE,2016,320,320,640,47
KIBAALE,2017,340,330,670,47
KIBAALE,2018,360,350,710,47
KIBAALE,2019,380,370,750,47
KIBAALE,2020,410,390,800,47
KIBAALE,2021,430,420,850,47
KIBAALE,2022,460,440,900,47
KIBAALE,2023,490,460,950,47
KIBAALE,2024,510,490,1000,47
KIBAALE,2025,540,510,1050,47
KIBOGA,2015,430,340,770,47
KIBOGA,2016,450,350,800,47
KIBOGA,2017,480,380,860,47
KIBOGA,2018,510,410,920,47
KIBOGA,2019,540,440,980,47
KIBOGA,2020,570,470,1040,47
KIBOGA,2021,580,480,1060,47
KIBOGA,2022,590,490,1080,47
KIBOGA,2023,590,500,1090,47
KIBOGA,2024,590,510,1100,47
KIBOGA,2025,610,530,1140,47
KIBUKU,2015,480,520,1000,47
KIBUKU,2016,520,570,1090,47
KIBUKU,2017,570,620,1190,47
KIBUKU,2018,600,680,1280,47
KIBUKU,2019,640,710,1350,47
KIBUKU,2020,660,750,1410,47
KIBUKU,2021,670,780,1450,47
KIBUKU,2022,680,810,1490,47
KIBUKU,2023,700,830,1530,47
KIBUKU,2024,730,870,1600,47
KIBUKU,2025,760,920,1680,47
KIKUUBE,2015,660,550,1210,47
KIKUUBE,2016,700,580,1280,47
KIKUUBE,2017,730,610,1340,47
KIKUUBE,2018,770,640,1410,47
KIKUUBE,2019,810,680,1490,47
KIKUUBE,2020,850,710,1560,47
KIKUUBE,2021,900,740,1640,47
KIKUUBE,2022,940,780,1720,47
KIKUUBE,2023,990,820,1810,47
KIKUUBE,2024,1040,860,1900,47
KIKUUBE,2025,1090,890,1980,47
KIRUHURA,2015,460,400,860,47
KIRUHURA,2016,480,420,900,47
KIRUHURA,2017,500,430,930,47
KIRUHURA,2018,520,440,960,47
KIRUHURA,2019,540,460,1000,47
KIRUHURA,2020,560,480,1040,47
KIRUHURA,2021,580,490,1070,47
KIRUHURA,2022,600,510,1110,47
KIRUHURA,2023,620,520,1140,47
KIRUHURA,2024,640,540,1180,47
KIRUHURA,2025,660,560,1220,47
KIRYANDONGO,2015,550,990,1540,47
KIRYANDONGO,2016,710,1010,1720,47
KIRYANDONGO,2017,740,1040,1780,47
KIRYANDONGO,2018,830,1080,1910,47
KIRYANDONGO,2019,860,1120,1980,47
KIRYANDONGO,2020,950,1170,2120,47
KIRYANDONGO,2021,1000,1230,2230,47
KIRYANDONGO,2022,1270,1280,2550,47
KIRYANDONGO,2023,1310,1340,2650,47
KIRYANDONGO,2024,1370,1390,2760,47
KIRYANDONGO,2025,1420,1450,2870,47
KISORO,2015,540,850,1390,47
KISORO,2016,570,910,1480,47
KISORO,2017,610,990,1600,47
KISORO,2018,640,1050,1690,47
KISORO,2019,670,1090,1760,47
KISORO,2020,680,1130,1810,47
KISORO,2021,680,1150,1830,47
KISORO,2022,680,1160,1840,47
KISORO,2023,680,1180,1860,47
KISORO,2024,690,1220,1910,47
KISORO,2025,710,1260,1970,47
KITAGWENDA,2015,320,380,700,47
KITAGWENDA,2016,340,400,740,47
KITAGWENDA,2017,350,410,760,47
KITAGWENDA,2018,360,420,780,47
KITAGWENDA,2019,380,440,820,47
KITAGWENDA,2020,390,450,840,47
KITAGWENDA,2021,410,470,880,47
KITAGWENDA,2022,420,490,910,47
KITAGWENDA,2023,440,500,940,47
KITAGWENDA,2024,460,520,980,47
KITAGWENDA,2025,470,530,1000,47
KITGUM,2015,480,520,1000,47
KITGUM,2016,510,550,1060,47
KITGUM,2017,530,590,1120,47
KITGUM,2018,560,630,1190,47
KITGUM,2019,580,650,1230,47
KITGUM,2020,580,670,1250,47
KITGUM,2021,590,670,1260,47
KITGUM,2022,590,690,1280,47
KITGUM,2023,580,710,1290,47
KITGUM,2024,600,710,1310,47
KITGUM,2025,600,740,1340,47
KOBOKO,2015,490,480,970,47
KOBOKO,2016,520,520,1040,47
KOBOKO,2017,570,580,1150,47
KOBOKO,2018,620,620,1240,47
KOBOKO,2019,640,670,1310,47
KOBOKO,2020,660,690,1350,47
KOBOKO,2021,680,720,1400,47
KOBOKO,2022,700,750,1450,47
KOBOKO,2023,720,770,1490,47
KOBOKO,2024,740,810,1550,47
KOBOKO,2025,780,850,1630,47
KOLE,2015,430,530,960,47
KOLE,2016,440,540,980,47
KOLE,2017,450,560,1010,47
KOLE,2018,470,570,1040,47
KOLE,2019,480,590,1070,47
KOLE,2020,500,610,1110,47
KOLE,2021,510,620,1130,47
KOLE,2022,530,640,1170,47
KOLE,2023,540,660,1200,47
KOLE,2024,560,670,1230,47
KOLE,2025,580,690,1270,47
KOTIDO,2015,490,470,960,47
KOTIDO,2016,520,510,1030,47
KOTIDO,2017,560,550,1110,47
KOTIDO,2018,590,590,1180,47
KOTIDO,2019,610,620,1230,47
KOTIDO,2020,620,630,1250,47
KOTIDO,2021,630,640,1270,47
KOTIDO,2022,630,660,1290,47
KOTIDO,2023,640,680,1320,47
KOTIDO,2024,650,700,1350,47
KOTIDO,2025,670,710,1380,47
KUMI,2015,550,610,1160,47
KUMI,2016,590,670,1260,47
KUMI,2017,640,720,1360,47
KUMI,2018,670,780,1450,47
KUMI,2019,710,820,1530,47
KUMI,2020,730,860,1590,47
KUMI,2021,740,870,1610,47
KUMI,2022,750,900,1650,47
KUMI,2023,760,920,1680,47
KUMI,2024,780,960,1740,47
KUMI,2025,820,990,1810,47
KWANIA,2015,380,380,760,47
KWANIA,2016,390,390,780,47
KWANIA,2017,400,410,810,47
KWANIA,2018,410,420,830,47
KWANIA,2019,430,430,860,47
KWANIA,2020,440,440,880,47
KWANIA,2021,450,450,900,47
KWANIA,2022,460,460,920,47
KWANIA,2023,480,480,960,47
KWANIA,2024,490,490,980,47
KWANIA,2025,500,500,1000,47
KWEEN,2015,250,260,510,47
KWEEN,2016,260,260,520,47
KWEEN,2017,270,270,540,47
KWEEN,2018,270,280,550,47
KWEEN,2019,280,280,560,47
KWEEN,2020,290,290,580,47
KWEEN,2021,300,300,600,47
KWEEN,2022,310,300,610,47
KWEEN,2023,320,310,630,47
KWEEN,2024,320,320,640,47
KWEEN,2025,330,320,650,47
KYANKWANZI,2015,530,400,930,47
KYANKWANZI,2016,550,420,970,47
KYANKWANZI,2017,580,440,1020,47
KYANKWANZI,2018,610,460,1070,47
KYANKWANZI,2019,640,480,1120,47
KYANKWANZI,2020,670,500,1170,47
KYANKWANZI,2021,710,530,1240,47
KYANKWANZI,2022,740,550,1290,47
KYANKWANZI,2023,780,570,1350,47
KYANKWANZI,2024,810,600,1410,47
KYANKWANZI,2025,850,620,1470,47
KYEGEGWA,2015,660,670,1330,47
KYEGEGWA,2016,710,720,1430,47
KYEGEGWA,2017,770,780,1550,47
KYEGEGWA,2018,840,840,1680,47
KYEGEGWA,2019,900,910,1810,47
KYEGEGWA,2020,980,980,1960,47
KYEGEGWA,2021,1050,1050,2100,47
KYEGEGWA,2022,1140,1130,2270,47
KYEGEGWA,2023,1230,1220,2450,47
KYEGEGWA,2024,1320,1310,2630,47
KYEGEGWA,2025,1420,1410,2830,47
KYENJOJO,2015,870,830,1700,47
KYENJOJO,2016,900,860,1760,47
KYENJOJO,2017,940,890,1830,47
KYENJOJO,2018,980,920,1900,47
KYENJOJO,2019,1020,950,1970,47
KYENJOJO,2020,1060,990,2050,47
KYENJOJO,2021,1100,1020,2120,47
KYENJOJO,2022,1140,1060,2200,47
KYENJOJO,2023,1180,1090,2270,47
KYENJOJO,2024,1230,1130,2360,47
KYENJOJO,2025,1270,1160,2430,47
KYOTERA,2015,730,650,1380,47
KYOTERA,2016,770,680,1450,47
KYOTERA,2017,810,730,1540,47
KYOTERA,2018,850,780,1630,47
KYOTERA,2019,870,820,1690,47
KYOTERA,2020,880,830,1710,47
KYOTERA,2021,890,840,1730,47
KYOTERA,2022,880,840,1720,47
KYOTERA,2023,880,860,1740,47
KYOTERA,2024,890,880,1770,47
KYOTERA,2025,910,900,1810,47
KARENGA,2015,110,120,230,47
KARENGA,2016,110,120,230,47
KARENGA,2017,110,130,240,47
KARENGA,2018,120,130,250,47
KARENGA,2019,120,130,250,47
KARENGA,2020,120,140,260,47
KARENGA,2021,130,140,270,47
KARENGA,2022,130,140,270,47
KARENGA,2023,130,140,270,47
KARENGA,2024,130,150,280,47
KARENGA,2025,140,150,290,47
LAMWO,2015,280,330,610,47
LAMWO,2016,310,360,670,47
LAMWO,2017,320,380,700,47
LAMWO,2018,330,410,740,47
LAMWO,2019,330,420,750,47
LAMWO,2020,350,430,780,47
LAMWO,2021,340,440,780,47
LAMWO,2022,340,440,780,47
LAMWO,2023,330,440,770,47
LAMWO,2024,330,470,800,47
LAMWO,2025,350,470,820,47
LIRA,2015,710,770,1480,47
LIRA,2016,730,800,1530,47
LIRA,2017,750,820,1570,47
LIRA,2018,770,840,1610,47
LIRA,2019,790,860,1650,47
LIRA,2020,810,890,1700,47
LIRA,2021,830,910,1740,47
LIRA,2022,860,940,1800,47
LIRA,2023,880,960,1840,47
LIRA,2024,900,980,1880,47
LIRA,2025,920,1010,1930,47
LUUKA,2015,470,610,1080,47
LUUKA,2016,500,650,1150,47
LUUKA,2017,530,710,1240,47
LUUKA,2018,550,750,1300,47
LUUKA,2019,570,790,1360,47
LUUKA,2020,580,810,1390,47
LUUKA,2021,590,830,1420,47
LUUKA,2022,590,840,1430,47
LUUKA,2023,600,860,1460,47
LUUKA,2024,600,880,1480,47
LUUKA,2025,610,920,1530,47
LUWERO,2015,1280,1290,2570,47
LUWERO,2016,1370,1390,2760,47
LUWERO,2017,1460,1490,2950,47
LUWERO,2018,1550,1600,3150,47
LUWERO,2019,1610,1680,3290,47
LUWERO,2020,1630,1730,3360,47
LUWERO,2021,1650,1770,3420,47
LUWERO,2022,1660,1800,3460,47
LUWERO,2023,1690,1840,3530,47
LUWERO,2024,1730,1910,3640,47
LUWERO,2025,1760,1970,3730,47
LWENGO,2015,710,760,1470,47
LWENGO,2016,750,810,1560,47
LWENGO,2017,800,860,1660,47
LWENGO,2018,820,910,1730,47
LWENGO,2019,850,940,1790,47
LWENGO,2020,860,960,1820,47
LWENGO,2021,850,960,1810,47
LWENGO,2022,840,980,1820,47
LWENGO,2023,840,980,1820,47
LWENGO,2024,850,990,1840,47
LWENGO,2025,860,1030,1890,47
LYANTONDE,2015,230,190,420,47
LYANTONDE,2016,230,190,420,47
LYANTONDE,2017,250,190,440,47
LYANTONDE,2018,260,220,480,47
LYANTONDE,2019,290,230,520,47
LYANTONDE,2020,300,260,560,47
LYANTONDE,2021,320,260,580,47
LYANTONDE,2022,330,280,610,47
LYANTONDE,2023,330,280,610,47
LYANTONDE,2024,340,300,640,47
LYANTONDE,2025,330,300,630,47
MANAFWA,2015,370,430,800,47
MANAFWA,2016,380,440,820,47
MANAFWA,2017,390,450,840,47
MANAFWA,2018,400,460,860,47
MANAFWA,2019,410,470,880,47
MANAFWA,2020,420,480,900,47
MANAFWA,2021,430,490,920,47
MANAFWA,2022,440,500,940,47
MANAFWA,2023,450,510,960,47
MANAFWA,2024,460,520,980,47
MANAFWA,2025,470,530,1000,47
MARACHA,2015,340,430,770,47
MARACHA,2016,340,440,780,47
MARACHA,2017,350,450,800,47
MARACHA,2018,360,450,810,47
MARACHA,2019,370,460,830,47
MARACHA,2020,370,470,840,47
MARACHA,2021,380,480,860,47
MARACHA,2022,390,490,880,47
MARACHA,2023,390,490,880,47
MARACHA,2024,400,500,900,47
MARACHA,2025,410,510,920,47
MASAKA,2015,650,720,1370,47
MASAKA,2016,660,720,1380,47
MASAKA,2017,690,770,1460,47
MASAKA,2018,730,820,1550,47
MASAKA,2019,790,890,1680,47
MASAKA,2020,830,940,1770,47
MASAKA,2021,860,1000,1860,47
MASAKA,2022,870,1020,1890,47
MASAKA,2023,870,1040,1910,47
MASAKA,2024,880,1050,1930,47
MASAKA,2025,880,1070,1950,47
MASINDI,2015,710,580,1290,47
MASINDI,2016,730,590,1320,47
MASINDI,2017,750,610,1360,47
MASINDI,2018,770,620,1390,47
MASINDI,2019,790,640,1430,47
MASINDI,2020,810,660,1470,47
MASINDI,2021,830,670,1500,47
MASINDI,2022,860,690,1550,47
MASINDI,2023,880,700,1580,47
MASINDI,2024,900,720,1620,47
MASINDI,2025,920,740,1660,47
MAYUGE,2015,1100,1320,2420,47
MAYUGE,2016,1170,1430,2600,47
MAYUGE,2017,1260,1550,2810,47
MAYUGE,2018,1340,1680,3020,47
MAYUGE,2019,1400,1770,3170,47
MAYUGE,2020,1440,1850,3290,47
MAYUGE,2021,1460,1900,3360,47
MAYUGE,2022,1490,1950,3440,47
MAYUGE,2023,1510,2010,3520,47
MAYUGE,2024,1550,2080,3630,47
MAYUGE,2025,1600,2180,3780,47
MBALE,2015,1380,1460,2840,47
MBALE,2016,1470,1590,3060,47
MBALE,2017,1580,1730,3310,47
MBALE,2018,1670,1870,3540,47
MBALE,2019,1750,1980,3730,47
MBALE,2020,1800,2060,3860,47
MBALE,2021,1830,2140,3970,47
MBALE,2022,1840,2200,4040,47
MBALE,2023,1870,2270,4140,47
MBALE,2024,1920,2360,4280,47
MBALE,2025,1990,2480,4470,47
MBARARA,2015,920,850,1770,47
MBARARA,2016,940,870,1810,47
MBARARA,2017,960,890,1850,47
MBARARA,2018,980,910,1890,47
MBARARA,2019,1000,930,1930,47
MBARARA,2020,1030,940,1970,47
MBARARA,2021,1050,960,2010,47
MBARARA,2022,1070,980,2050,47
MBARARA,2023,1090,1000,2090,47
MBARARA,2024,1110,1020,2130,47
MBARARA,2025,1130,1030,2160,47
MITOOMA,2015,390,520,910,47
MITOOMA,2016,390,530,920,47
MITOOMA,2017,400,540,940,47
MITOOMA,2018,400,540,940,47
MITOOMA,2019,410,540,950,47
MITOOMA,2020,410,550,960,47
MITOOMA,2021,410,550,960,47
MITOOMA,2022,420,560,980,47
MITOOMA,2023,420,560,980,47
MITOOMA,2024,420,560,980,47
MITOOMA,2025,430,570,1000,47
MITYANA,2015,870,990,1860,47
MITYANA,2016,930,1050,1980,47
MITYANA,2017,980,1130,2110,47
MITYANA,2018,1040,1190,2230,47
MITYANA,2019,1070,1240,2310,47
MITYANA,2020,1080,1280,2360,47
MITYANA,2021,1090,1300,2390,47
MITYANA,2022,1090,1310,2400,47
MITYANA,2023,1090,1330,2420,47
MITYANA,2024,1100,1360,2460,47
MITYANA,2025,1140,1400,2540,47
MOROTO,2015,200,230,430,47
MOROTO,2016,220,250,470,47
MOROTO,2017,230,270,500,47
MOROTO,2018,250,290,540,47
MOROTO,2019,250,300,550,47
MOROTO,2020,250,320,570,47
MOROTO,2021,260,320,580,47
MOROTO,2022,250,340,590,47
MOROTO,2023,270,340,610,47
MOROTO,2024,270,360,630,47
MOROTO,2025,270,360,630,47
MOYO,2015,230,290,520,47
MOYO,2016,230,290,520,47
MOYO,2017,240,300,540,47
MOYO,2018,250,300,550,47
MOYO,2019,250,310,560,47
MOYO,2020,260,320,580,47
MOYO,2021,260,320,580,47
MOYO,2022,270,330,600,47
MOYO,2023,280,340,620,47
MOYO,2024,280,340,620,47
MOYO,2025,290,350,640,47
MPIGI,2015,740,670,1410,47
MPIGI,2016,780,720,1500,47
MPIGI,2017,840,790,1630,47
MPIGI,2018,880,840,1720,47
MPIGI,2019,910,880,1790,47
MPIGI,2020,940,900,1840,47
MPIGI,2021,940,930,1870,47
MPIGI,2022,950,950,1900,47
MPIGI,2023,960,970,1930,47
MPIGI,2024,980,990,1970,47
MPIGI,2025,1000,1030,2030,47
MUBENDE,2015,1190,1150,2340,47
MUBENDE,2016,1310,1270,2580,47
MUBENDE,2017,1430,1410,2840,47
MUBENDE,2018,1560,1550,3110,47
MUBENDE,2019,1660,1670,3330,47
MUBENDE,2020,1740,1770,3510,47
MUBENDE,2021,1810,1870,3680,47
MUBENDE,2022,1880,1950,3830,47
MUBENDE,2023,1950,2060,4010,47
MUBENDE,2024,2040,2170,4210,47
MUBENDE,2025,2170,2300,4470,47
MUKONO,2015,1700,1730,3430,47
MUKONO,2016,1810,1880,3690,47
MUKONO,2017,1940,2040,3980,47
MUKONO,2018,2050,2190,4240,47
MUKONO,2019,2130,2330,4460,47
MUKONO,2020,2180,2420,4600,47
MUKONO,2021,2210,2480,4690,47
MUKONO,2022,2230,2550,4780,47
MUKONO,2023,2270,2620,4890,47
MUKONO,2024,2320,2710,5030,47
MUKONO,2025,2390,2840,5230,47
MADI OKOLLO,2015,280,340,620,47
MADI OKOLLO,2016,290,350,640,47
MADI OKOLLO,2017,300,360,660,47
MADI OKOLLO,2018,300,370,670,47
MADI OKOLLO,2019,310,380,690,47
MADI OKOLLO,2020,320,390,710,47
MADI OKOLLO,2021,330,400,730,47
MADI OKOLLO,2022,340,410,750,47
MADI OKOLLO,2023,350,420,770,47
MADI OKOLLO,2024,360,430,790,47
MADI OKOLLO,2025,360,440,800,47
NABILATUK,2015,140,140,280,47
NABILATUK,2016,140,160,300,47
NABILATUK,2017,160,170,330,47
NABILATUK,2018,160,190,350,47
NABILATUK,2019,180,200,380,47
NABILATUK,2020,190,210,400,47
NABILATUK,2021,190,210,400,47
NABILATUK,2022,200,230,430,47
NABILATUK,2023,210,250,460,47
NABILATUK,2024,210,250,460,47
NABILATUK,2025,230,270,500,47
NAKAPIRIPIRIT,2015,220,190,410,47
NAKAPIRIPIRIT,2016,240,210,450,47
NAKAPIRIPIRIT,2017,250,240,490,47
NAKAPIRIPIRIT,2018,270,260,530,47
NAKAPIRIPIRIT,2019,290,270,560,47
NAKAPIRIPIRIT,2020,300,290,590,47
NAKAPIRIPIRIT,2021,310,310,620,47
NAKAPIRIPIRIT,2022,320,320,640,47
NAKAPIRIPIRIT,2023,330,320,650,47
NAKAPIRIPIRIT,2024,350,340,690,47
NAKAPIRIPIRIT,2025,360,360,720,47
NAKASEKE,2015,590,370,960,47
NAKASEKE,2016,610,380,990,47
NAKASEKE,2017,630,390,1020,47
NAKASEKE,2018,660,400,1060,47
NAKASEKE,2019,680,410,1090,47
NAKASEKE,2020,700,420,1120,47
NAKASEKE,2021,730,430,1160,47
NAKASEKE,2022,750,440,1190,47
NAKASEKE,2023,780,450,1230,47
NAKASEKE,2024,800,460,1260,47
NAKASEKE,2025,830,470,1300,47
NAKASONGOLA,2015,540,470,1010,47
NAKASONGOLA,2016,570,510,1080,47
NAKASONGOLA,2017,620,550,1170,47
NAKASONGOLA,2018,660,590,1250,47
NAKASONGOLA,2019,690,620,1310,47
NAKASONGOLA,2020,720,640,1360,47
NAKASONGOLA,2021,720,660,1380,47
NAKASONGOLA,2022,740,670,1410,47
NAKASONGOLA,2023,740,690,1430,47
NAKASONGOLA,2024,770,710,1480,47
NAKASONGOLA,2025,800,740,1540,47
NAMAYINGO,2015,540,580,1120,47
NAMAYINGO,2016,570,610,1180,47
NAMAYINGO,2017,610,660,1270,47
NAMAYINGO,2018,640,710,1350,47
NAMAYINGO,2019,670,730,1400,47
NAMAYINGO,2020,680,750,1430,47
NAMAYINGO,2021,680,760,1440,47
NAMAYINGO,2022,670,760,1430,47
NAMAYINGO,2023,680,780,1460,47
NAMAYINGO,2024,690,790,1480,47
NAMAYINGO,2025,710,820,1530,47
NAMISINDWA,2015,510,490,1000,47
NAMISINDWA,2016,530,500,1030,47
NAMISINDWA,2017,540,520,1060,47
NAMISINDWA,2018,560,530,1090,47
NAMISINDWA,2019,570,540,1110,47
NAMISINDWA,2020,590,550,1140,47
NAMISINDWA,2021,600,560,1160,47
NAMISINDWA,2022,620,580,1200,47
NAMISINDWA,2023,630,590,1220,47
NAMISINDWA,2024,650,600,1250,47
NAMISINDWA,2025,660,610,1270,47
NAMUTUMBA,2015,580,620,1200,47
NAMUTUMBA,2016,630,680,1310,47
NAMUTUMBA,2017,680,750,1430,47
NAMUTUMBA,2018,720,790,1510,47
NAMUTUMBA,2019,750,850,1600,47
NAMUTUMBA,2020,770,890,1660,47
NAMUTUMBA,2021,790,920,1710,47
NAMUTUMBA,2022,800,930,1730,47
NAMUTUMBA,2023,820,970,1790,47
NAMUTUMBA,2024,850,1010,1860,47
NAMUTUMBA,2025,880,1060,1940,47
NAPAK,2015,260,380,640,47
NAPAK,2016,270,400,670,47
NAPAK,2017,290,440,730,47
NAPAK,2018,300,460,760,47
NAPAK,2019,300,480,780,47
NAPAK,2020,320,500,820,47
NAPAK,2021,310,500,810,47
NAPAK,2022,310,520,830,47
NAPAK,2023,320,520,840,47
NAPAK,2024,320,540,860,47
NAPAK,2025,320,570,890,47
NEBBI,2015,560,590,1150,47
NEBBI,2016,580,610,1190,47
NEBBI,2017,600,630,1230,47
NEBBI,2018,620,650,1270,47
NEBBI,2019,640,660,1300,47
NEBBI,2020,660,680,1340,47
NEBBI,2021,680,700,1380,47
NEBBI,2022,700,720,1420,47
NEBBI,2023,720,740,1460,47
NEBBI,2024,740,750,1490,47
NEBBI,2025,760,770,1530,47
NGORA,2015,310,420,730,47
NGORA,2016,330,440,770,47
NGORA,2017,350,480,830,47
NGORA,2018,370,520,890,47
NGORA,2019,390,550,940,47
NGORA,2020,400,570,970,47
NGORA,2021,410,580,990,47
NGORA,2022,400,590,990,47
NGORA,2023,410,610,1020,47
NGORA,2024,420,620,1040,47
NGORA,2025,440,650,1090,47
NTOROKO,2015,170,140,310,47
NTOROKO,2016,190,150,340,47
NTOROKO,2017,200,170,370,47
NTOROKO,2018,220,180,400,47
NTOROKO,2019,220,180,400,47
NTOROKO,2020,220,180,400,47
NTOROKO,2021,230,180,410,47
NTOROKO,2022,230,200,430,47
NTOROKO,2023,230,200,430,47
NTOROKO,2024,240,200,440,47
NTOROKO,2025,240,210,450,47
NTUNGAMO,2015,1160,1300,2460,47
NTUNGAMO,2016,1190,1320,2510,47
NTUNGAMO,2017,1210,1340,2550,47
NTUNGAMO,2018,1240,1370,2610,47
NTUNGAMO,2019,1270,1390,2660,47
NTUNGAMO,2020,1290,1420,2710,47
NTUNGAMO,2021,1320,1440,2760,47
NTUNGAMO,2022,1340,1460,2800,47
NTUNGAMO,2023,1360,1490,2850,47
NTUNGAMO,2024,1390,1510,2900,47
NTUNGAMO,2025,1410,1530,2940,47
NWOYA,2015,250,280,530,47
NWOYA,2016,270,300,570,47
NWOYA,2017,300,340,640,47
NWOYA,2018,330,370,700,47
NWOYA,2019,370,410,780,47
NWOYA,2020,410,450,860,47
NWOYA,2021,450,490,940,47
NWOYA,2022,500,540,1040,47
NWOYA,2023,540,590,1130,47
NWOYA,2024,600,650,1250,47
NWOYA,2025,660,720,1380,47
OBONGI,2015,110,100,210,47
OBONGI,2016,130,110,240,47
OBONGI,2017,130,110,240,47
OBONGI,2018,140,120,260,47
OBONGI,2019,140,120,260,47
OBONGI,2020,140,120,260,47
OBONGI,2021,150,140,290,47
OBONGI,2022,150,140,290,47
OBONGI,2023,150,140,290,47
OBONGI,2024,150,140,290,47
OBONGI,2025,160,140,300,47
OMORO,2015,440,420,860,47
OMORO,2016,470,470,940,47
OMORO,2017,520,510,1030,47
OMORO,2018,550,540,1090,47
OMORO,2019,580,580,1160,47
OMORO,2020,590,610,1200,47
OMORO,2021,610,630,1240,47
OMORO,2022,620,640,1260,47
OMORO,2023,640,660,1300,47
OMORO,2024,650,700,1350,47
OMORO,2025,680,730,1410,47
OTUKE,2015,200,250,450,47
OTUKE,2016,210,260,470,47
OTUKE,2017,220,270,490,47
OTUKE,2018,230,280,510,47
OTUKE,2019,240,290,530,47
OTUKE,2020,250,310,560,47
OTUKE,2021,260,320,580,47
OTUKE,2022,280,330,610,47
OTUKE,2023,290,350,640,47
OTUKE,2024,300,360,660,47
OTUKE,2025,310,370,680,47
OYAM,2015,860,860,1720,47
OYAM,2016,880,890,1770,47
OYAM,2017,910,910,1820,47
OYAM,2018,940,940,1880,47
OYAM,2019,960,970,1930,47
OYAM,2020,990,990,1980,47
OYAM,2021,1020,1020,2040,47
OYAM,2022,1050,1050,2100,47
OYAM,2023,1080,1080,2160,47
OYAM,2024,1100,1100,2200,47
OYAM,2025,1130,1130,2260,47
PADER,2015,430,430,860,47
PADER,2016,450,470,920,47
PADER,2017,480,490,970,47
PADER,2018,510,530,1040,47
PADER,2019,510,560,1070,47
PADER,2020,530,570,1100,47
PADER,2021,520,580,1100,47
PADER,2022,520,590,1110,47
PADER,2023,530,600,1130,47
PADER,2024,530,620,1150,47
PADER,2025,550,630,1180,47
PAKWACH,2015,360,370,730,47
PAKWACH,2016,380,380,760,47
PAKWACH,2017,400,390,790,47
PAKWACH,2018,410,410,820,47
PAKWACH,2019,430,420,850,47
PAKWACH,2020,450,440,890,47
PAKWACH,2021,460,450,910,47
PAKWACH,2022,480,470,950,47
PAKWACH,2023,500,480,980,47
PAKWACH,2024,520,500,1020,47
PAKWACH,2025,540,510,1050,47
PALLISA,2015,690,770,1460,47
PALLISA,2016,740,850,1590,47
PALLISA,2017,810,940,1750,47
PALLISA,2018,880,1030,1910,47
PALLISA,2019,910,1090,2000,47
PALLISA,2020,950,1160,2110,47
PALLISA,2021,980,1210,2190,47
PALLISA,2022,1020,1250,2270,47
PALLISA,2023,1050,1300,2350,47
PALLISA,2024,1090,1360,2450,47
PALLISA,2025,1140,1450,2590,47
RAKAI,2015,740,800,1540,47
RAKAI,2016,790,850,1640,47
RAKAI,2017,840,930,1770,47
RAKAI,2018,890,990,1880,47
RAKAI,2019,930,1050,1980,47
RAKAI,2020,940,1070,2010,47
RAKAI,2021,950,1100,2050,47
RAKAI,2022,970,1110,2080,47
RAKAI,2023,970,1150,2120,47
RAKAI,2024,1000,1180,2180,47
RAKAI,2025,1030,1220,2250,47
RUBANDA,2015,410,510,920,47
RUBANDA,2016,420,510,930,47
RUBANDA,2017,420,520,940,47
RUBANDA,2018,430,520,950,47
RUBANDA,2019,430,520,950,47
RUBANDA,2020,440,530,970,47
RUBANDA,2021,440,530,970,47
RUBANDA,2022,450,530,980,47
RUBANDA,2023,450,540,990,47
RUBANDA,2024,450,540,990,47
RUBANDA,2025,460,540,1000,47
RUBIRIZI,2015,260,340,600,47
RUBIRIZI,2016,270,350,620,47
RUBIRIZI,2017,270,360,630,47
RUBIRIZI,2018,280,360,640,47
RUBIRIZI,2019,280,370,650,47
RUBIRIZI,2020,290,380,670,47
RUBIRIZI,2021,290,380,670,47
RUBIRIZI,2022,300,390,690,47
RUBIRIZI,2023,300,390,690,47
RUBIRIZI,2024,310,400,710,47
RUBIRIZI,2025,310,410,720,47
RUKIGA,2015,260,310,570,47
RUKIGA,2016,270,320,590,47
RUKIGA,2017,270,320,590,47
RUKIGA,2018,270,320,590,47
RUKIGA,2019,280,320,600,47
RUKIGA,2020,280,320,600,47
RUKIGA,2021,280,320,600,47
RUKIGA,2022,280,330,610,47
RUKIGA,2023,280,330,610,47
RUKIGA,2024,290,330,620,47
RUKIGA,2025,290,330,620,47
RUKUNGIRI,2015,790,890,1680,47
RUKUNGIRI,2016,800,900,1700,47
RUKUNGIRI,2017,810,910,1720,47
RUKUNGIRI,2018,820,920,1740,47
RUKUNGIRI,2019,830,930,1760,47
RUKUNGIRI,2020,840,940,1780,47
RUKUNGIRI,2021,850,940,1790,47
RUKUNGIRI,2022,850,950,1800,47
RUKUNGIRI,2023,860,960,1820,47
RUKUNGIRI,2024,870,960,1830,47
RUKUNGIRI,2025,870,970,1840,47
RWAMPARA,2015,310,370,680,47
RWAMPARA,2016,320,370,690,47
RWAMPARA,2017,330,380,710,47
RWAMPARA,2018,330,390,720,47
RWAMPARA,2019,340,400,740,47
RWAMPARA,2020,350,410,760,47
RWAMPARA,2021,360,410,770,47
RWAMPARA,2022,360,420,780,47
RWAMPARA,2023,370,430,800,47
RWAMPARA,2024,380,440,820,47
RWAMPARA,2025,380,440,820,47
SERERE,2015,710,780,1490,47
SERERE,2016,780,870,1650,47
SERERE,2017,840,940,1780,47
SERERE,2018,900,1030,1930,47
SERERE,2019,940,1110,2050,47
SERERE,2020,980,1150,2130,47
SERERE,2021,1010,1190,2200,47
SERERE,2022,1030,1240,2270,47
SERERE,2023,1060,1290,2350,47
SERERE,2024,1100,1350,2450,47
SERERE,2025,1150,1420,2570,47
SHEEMA,2015,560,580,1140,47
SHEEMA,2016,570,590,1160,47
SHEEMA,2017,570,590,1160,47
SHEEMA,2018,580,600,1180,47
SHEEMA,2019,590,610,1200,47
SHEEMA,2020,590,610,1200,47
SHEEMA,2021,600,620,1220,47
SHEEMA,2022,600,620,1220,47
SHEEMA,2023,610,630,1240,47
SHEEMA,2024,610,630,1240,47
SHEEMA,2025,620,630,1250,47
SIRONKO,2015,720,620,1340,47
SIRONKO,2016,730,630,1360,47
SIRONKO,2017,750,650,1400,47
SIRONKO,2018,770,660,1430,47
SIRONKO,2019,790,670,1460,47
SIRONKO,2020,800,680,1480,47
SIRONKO,2021,820,700,1520,47
SIRONKO,2022,840,710,1550,47
SIRONKO,2023,860,720,1580,47
SIRONKO,2024,870,730,1600,47
SIRONKO,2025,890,740,1630,47
SOROTI,2015,780,730,1510,47
SOROTI,2016,840,800,1640,47
SOROTI,2017,900,870,1770,47
SOROTI,2018,960,940,1900,47
SOROTI,2019,1010,1000,2010,47
SOROTI,2020,1050,1060,2110,47
SOROTI,2021,1060,1090,2150,47
SOROTI,2022,1090,1110,2200,47
SOROTI,2023,1120,1150,2270,47
SOROTI,2024,1150,1210,2360,47
SOROTI,2025,1190,1260,2450,47
SSEMBABULE,2015,760,720,1480,47
SSEMBABULE,2016,820,770,1590,47
SSEMBABULE,2017,880,850,1730,47
SSEMBABULE,2018,930,900,1830,47
SSEMBABULE,2019,970,950,1920,47
SSEMBABULE,2020,1000,980,1980,47
SSEMBABULE,2021,1010,1010,2020,47
SSEMBABULE,2022,1020,1020,2040,47
SSEMBABULE,2023,1040,1060,2100,47
SSEMBABULE,2024,1060,1100,2160,47
SSEMBABULE,2025,1100,1140,2240,47
TORORO,2015,1170,1300,2470,47
TORORO,2016,1200,1340,2540,47
TORORO,2017,1230,1370,2600,47
TORORO,2018,1260,1400,2660,47
TORORO,2019,1300,1440,2740,47
TORORO,2020,1330,1470,2800,47
TORORO,2021,1360,1500,2860,47
TORORO,2022,1390,1540,2930,47
TORORO,2023,1420,1570,2990,47
TORORO,2024,1460,1600,3060,47
TORORO,2025,1490,1640,3130,47
WAKISO,2015,4340,3680,8020,47
WAKISO,2016,4630,3940,8570,47
WAKISO,2017,4940,4210,9150,47
WAKISO,2018,5270,4490,9760,47
WAKISO,2019,5620,4790,10410,47
WAKISO,2020,5990,5110,11100,47
WAKISO,2021,6370,5450,11820,47
WAKISO,2022,6780,5810,12590,47
WAKISO,2023,7210,6180,13390,47
WAKISO,2024,7660,6580,14240,47
WAKISO,2025,8130,6990,15120,47
YUMBE,2015,1010,870,1880,47
YUMBE,2016,1100,970,2070,47
YUMBE,2017,1210,1090,2300,47
YUMBE,2018,1300,1210,2510,47
YUMBE,2019,1390,1320,2710,47
YUMBE,2020,1450,1390,2840,47
YUMBE,2021,1510,1480,2990,47
YUMBE,2022,1560,1560,3120,47
YUMBE,2023,1620,1660,3280,47
YUMBE,2024,1700,1770,3470,47
YUMBE,2025,1790,1890,3680,47
ZOMBO,2015,570,570,1140,47
ZOMBO,2016,580,590,1170,47
ZOMBO,2017,600,610,1210,47
ZOMBO,2018,620,620,1240,47
ZOMBO,2019,640,640,1280,47
ZOMBO,2020,660,660,1320,47
ZOMBO,2021,680,670,1350,47
ZOMBO,2022,690,690,1380,47
ZOMBO,2023,710,710,1420,47
ZOMBO,2024,730,720,1450,47
ZOMBO,2025,750,740,1490,47
ABIM,2015,290,290,580,48
ABIM,2016,310,320,630,48
ABIM,2017,340,350,690,48
ABIM,2018,390,400,790,48
ABIM,2019,420,440,860,48
ABIM,2020,450,490,940,48
ABIM,2021,480,520,1000,48
ABIM,2022,500,540,1040,48
ABIM,2023,520,570,1090,48
ABIM,2024,560,620,1180,48
ABIM,2025,580,660,1240,48
ADJUMANI,2015,500,660,1160,48
ADJUMANI,2016,500,670,1170,48
ADJUMANI,2017,500,680,1180,48
ADJUMANI,2018,510,680,1190,48
ADJUMANI,2019,510,690,1200,48
ADJUMANI,2020,510,690,1200,48
ADJUMANI,2021,520,700,1220,48
ADJUMANI,2022,520,700,1220,48
ADJUMANI,2023,520,710,1230,48
ADJUMANI,2024,520,710,1230,48
ADJUMANI,2025,520,720,1240,48
AGAGO,2015,570,730,1300,48
AGAGO,2016,580,750,1330,48
AGAGO,2017,590,760,1350,48
AGAGO,2018,600,770,1370,48
AGAGO,2019,610,780,1390,48
AGAGO,2020,620,800,1420,48
AGAGO,2021,630,810,1440,48
AGAGO,2022,640,820,1460,48
AGAGO,2023,650,830,1480,48
AGAGO,2024,660,840,1500,48
AGAGO,2025,670,860,1530,48
ALEBTONG,2015,520,640,1160,48
ALEBTONG,2016,550,670,1220,48
ALEBTONG,2017,590,730,1320,48
ALEBTONG,2018,630,790,1420,48
ALEBTONG,2019,660,840,1500,48
ALEBTONG,2020,690,890,1580,48
ALEBTONG,2021,710,930,1640,48
ALEBTONG,2022,720,950,1670,48
ALEBTONG,2023,730,970,1700,48
ALEBTONG,2024,730,1000,1730,48
ALEBTONG,2025,750,1030,1780,48
AMOLATAR,2015,380,400,780,48
AMOLATAR,2016,400,430,830,48
AMOLATAR,2017,430,460,890,48
AMOLATAR,2018,460,500,960,48
AMOLATAR,2019,490,530,1020,48
AMOLATAR,2020,510,560,1070,48
AMOLATAR,2021,510,590,1100,48
AMOLATAR,2022,530,600,1130,48
AMOLATAR,2023,530,610,1140,48
AMOLATAR,2024,540,620,1160,48
AMOLATAR,2025,540,640,1180,48
AMUDAT,2015,290,240,530,48
AMUDAT,2016,310,260,570,48
AMUDAT,2017,330,290,620,48
AMUDAT,2018,360,320,680,48
AMUDAT,2019,390,350,740,48
AMUDAT,2020,400,370,770,48
AMUDAT,2021,420,400,820,48
AMUDAT,2022,430,420,850,48
AMUDAT,2023,440,430,870,48
AMUDAT,2024,450,450,900,48
AMUDAT,2025,460,480,940,48
AMURIA,2015,450,490,940,48
AMURIA,2016,470,520,990,48
AMURIA,2017,510,560,1070,48
AMURIA,2018,550,620,1170,48
AMURIA,2019,590,660,1250,48
AMURIA,2020,630,700,1330,48
AMURIA,2021,650,730,1380,48
AMURIA,2022,660,760,1420,48
AMURIA,2023,670,780,1450,48
AMURIA,2024,690,810,1500,48
AMURIA,2025,710,850,1560,48
AMURU,2015,390,500,890,48
AMURU,2016,410,530,940,48
AMURU,2017,440,570,1010,48
AMURU,2018,470,630,1100,48
AMURU,2019,500,660,1160,48
AMURU,2020,520,700,1220,48
AMURU,2021,520,730,1250,48
AMURU,2022,540,740,1280,48
AMURU,2023,540,760,1300,48
AMURU,2024,550,790,1340,48
AMURU,2025,550,810,1360,48
APAC,2015,480,510,990,48
APAC,2016,500,520,1020,48
APAC,2017,510,540,1050,48
APAC,2018,530,560,1090,48
APAC,2019,550,580,1130,48
APAC,2020,570,600,1170,48
APAC,2021,590,620,1210,48
APAC,2022,610,640,1250,48
APAC,2023,630,660,1290,48
APAC,2024,650,680,1330,48
APAC,2025,670,700,1370,48
ARUA,2015,1840,2650,4490,48
ARUA,2016,1890,2720,4610,48
ARUA,2017,1940,2800,4740,48
ARUA,2018,2000,2870,4870,48
ARUA,2019,2060,2950,5010,48
ARUA,2020,2110,3030,5140,48
ARUA,2021,2170,3100,5270,48
ARUA,2022,2220,3180,5400,48
ARUA,2023,2280,3250,5530,48
ARUA,2024,2340,3330,5670,48
ARUA,2025,2390,3400,5790,48
BUDAKA,2015,520,490,1010,48
BUDAKA,2016,550,520,1070,48
BUDAKA,2017,590,560,1150,48
BUDAKA,2018,640,620,1260,48
BUDAKA,2019,680,660,1340,48
BUDAKA,2020,710,700,1410,48
BUDAKA,2021,740,730,1470,48
BUDAKA,2022,750,750,1500,48
BUDAKA,2023,770,780,1550,48
BUDAKA,2024,780,810,1590,48
BUDAKA,2025,810,840,1650,48
BUDUDA,2015,650,550,1200,48
BUDUDA,2016,690,590,1280,48
BUDUDA,2017,760,650,1410,48
BUDUDA,2018,820,720,1540,48
BUDUDA,2019,880,780,1660,48
BUDUDA,2020,940,840,1780,48
BUDUDA,2021,980,890,1870,48
BUDUDA,2022,1000,920,1920,48
BUDUDA,2023,1030,960,1990,48
BUDUDA,2024,1070,1010,2080,48
BUDUDA,2025,1110,1050,2160,48
BUGIRI,2015,840,940,1780,48
BUGIRI,2016,890,1010,1900,48
BUGIRI,2017,970,1100,2070,48
BUGIRI,2018,1060,1210,2270,48
BUGIRI,2019,1130,1320,2450,48
BUGIRI,2020,1190,1400,2590,48
BUGIRI,2021,1230,1460,2690,48
BUGIRI,2022,1270,1520,2790,48
BUGIRI,2023,1290,1580,2870,48
BUGIRI,2024,1330,1640,2970,48
BUGIRI,2025,1370,1710,3080,48
BUGWERI,2015,430,470,900,48
BUGWERI,2016,450,500,950,48
BUGWERI,2017,470,540,1010,48
BUGWERI,2018,510,590,1100,48
BUGWERI,2019,540,620,1160,48
BUGWERI,2020,570,660,1230,48
BUGWERI,2021,580,680,1260,48
BUGWERI,2022,590,690,1280,48
BUGWERI,2023,590,710,1300,48
BUGWERI,2024,590,720,1310,48
BUGWERI,2025,610,750,1360,48
BUHWEJU,2015,320,370,690,48
BUHWEJU,2016,330,380,710,48
BUHWEJU,2017,340,390,730,48
BUHWEJU,2018,350,400,750,48
BUHWEJU,2019,360,420,780,48
BUHWEJU,2020,380,430,810,48
BUHWEJU,2021,390,440,830,48
BUHWEJU,2022,400,450,850,48
BUHWEJU,2023,410,460,870,48
BUHWEJU,2024,420,480,900,48
BUHWEJU,2025,430,490,920,48
BUIKWE,2015,1120,1090,2210,48
BUIKWE,2016,1160,1150,2310,48
BUIKWE,2017,1230,1230,2460,48
BUIKWE,2018,1310,1330,2640,48
BUIKWE,2019,1380,1420,2800,48
BUIKWE,2020,1420,1480,2900,48
BUIKWE,2021,1450,1530,2980,48
BUIKWE,2022,1450,1560,3010,48
BUIKWE,2023,1460,1580,3040,48
BUIKWE,2024,1470,1610,3080,48
BUIKWE,2025,1490,1660,3150,48
BUKEDEA,2015,530,600,1130,48
BUKEDEA,2016,570,640,1210,48
BUKEDEA,2017,610,700,1310,48
BUKEDEA,2018,660,770,1430,48
BUKEDEA,2019,710,830,1540,48
BUKEDEA,2020,750,890,1640,48
BUKEDEA,2021,780,940,1720,48
BUKEDEA,2022,810,970,1780,48
BUKEDEA,2023,830,1000,1830,48
BUKEDEA,2024,850,1050,1900,48
BUKEDEA,2025,890,1100,1990,48
BUKOMANSIMBI,2015,440,460,900,48
BUKOMANSIMBI,2016,460,470,930,48
BUKOMANSIMBI,2017,470,500,970,48
BUKOMANSIMBI,2018,490,540,1030,48
BUKOMANSIMBI,2019,520,560,1080,48
BUKOMANSIMBI,2020,530,580,1110,48
BUKOMANSIMBI,2021,520,590,1110,48
BUKOMANSIMBI,2022,530,590,1120,48
BUKOMANSIMBI,2023,520,590,1110,48
BUKOMANSIMBI,2024,520,590,1110,48
BUKOMANSIMBI,2025,510,590,1100,48
BUKWO,2015,270,240,510,48
BUKWO,2016,290,250,540,48
BUKWO,2017,300,260,560,48
BUKWO,2018,320,280,600,48
BUKWO,2019,330,290,620,48
BUKWO,2020,350,300,650,48
BUKWO,2021,370,320,690,48
BUKWO,2022,390,330,720,48
BUKWO,2023,410,350,760,48
BUKWO,2024,430,360,790,48
BUKWO,2025,450,380,830,48
BULAMBULI,2015,550,520,1070,48
BULAMBULI,2016,590,560,1150,48
BULAMBULI,2017,640,620,1260,48
BULAMBULI,2018,700,680,1380,48
BULAMBULI,2019,760,750,1510,48
BULAMBULI,2020,820,810,1630,48
BULAMBULI,2021,840,860,1700,48
BULAMBULI,2022,870,900,1770,48
BULAMBULI,2023,900,940,1840,48
BULAMBULI,2024,930,990,1920,48
BULAMBULI,2025,980,1040,2020,48
BULIISA,2015,270,340,610,48
BULIISA,2016,290,350,640,48
BULIISA,2017,300,370,670,48
BULIISA,2018,320,390,710,48
BULIISA,2019,340,400,740,48
BULIISA,2020,350,420,770,48
BULIISA,2021,370,440,810,48
BULIISA,2022,390,460,850,48
BULIISA,2023,410,470,880,48
BULIISA,2024,430,490,920,48
BULIISA,2025,450,510,960,48
BUNDIBUGYO,2015,560,560,1120,48
BUNDIBUGYO,2016,590,590,1180,48
BUNDIBUGYO,2017,640,650,1290,48
BUNDIBUGYO,2018,680,690,1370,48
BUNDIBUGYO,2019,730,740,1470,48
BUNDIBUGYO,2020,760,790,1550,48
BUNDIBUGYO,2021,780,820,1600,48
BUNDIBUGYO,2022,790,840,1630,48
BUNDIBUGYO,2023,800,860,1660,48
BUNDIBUGYO,2024,810,880,1690,48
BUNDIBUGYO,2025,830,910,1740,48
BUNYANGABU,2015,370,360,730,48
BUNYANGABU,2016,400,380,780,48
BUNYANGABU,2017,430,410,840,48
BUNYANGABU,2018,450,440,890,48
BUNYANGABU,2019,480,470,950,48
BUNYANGABU,2020,500,500,1000,48
BUNYANGABU,2021,500,510,1010,48
BUNYANGABU,2022,510,520,1030,48
BUNYANGABU,2023,520,530,1050,48
BUNYANGABU,2024,530,550,1080,48
BUNYANGABU,2025,530,560,1090,48
BUSHENYI,2015,680,740,1420,48
BUSHENYI,2016,690,750,1440,48
BUSHENYI,2017,700,750,1450,48
BUSHENYI,2018,710,760,1470,48
BUSHENYI,2019,710,770,1480,48
BUSHENYI,2020,720,770,1490,48
BUSHENYI,2021,730,780,1510,48
BUSHENYI,2022,740,780,1520,48
BUSHENYI,2023,740,790,1530,48
BUSHENYI,2024,750,790,1540,48
BUSHENYI,2025,750,790,1540,48
BUSIA,2015,710,750,1460,48
BUSIA,2016,740,780,1520,48
BUSIA,2017,800,850,1650,48
BUSIA,2018,850,930,1780,48
BUSIA,2019,900,1000,1900,48
BUSIA,2020,950,1060,2010,48
BUSIA,2021,980,1100,2080,48
BUSIA,2022,980,1130,2110,48
BUSIA,2023,1000,1150,2150,48
BUSIA,2024,1020,1190,2210,48
BUSIA,2025,1050,1230,2280,48
BUTALEJA,2015,550,560,1110,48
BUTALEJA,2016,590,590,1180,48
BUTALEJA,2017,640,650,1290,48
BUTALEJA,2018,690,710,1400,48
BUTALEJA,2019,730,760,1490,48
BUTALEJA,2020,770,820,1590,48
BUTALEJA,2021,800,860,1660,48
BUTALEJA,2022,810,880,1690,48
BUTALEJA,2023,830,910,1740,48
BUTALEJA,2024,850,950,1800,48
BUTALEJA,2025,880,980,1860,48
BUTAMBALA,2015,250,280,530,48
BUTAMBALA,2016,260,280,540,48
BUTAMBALA,2017,270,310,580,48
BUTAMBALA,2018,290,330,620,48
BUTAMBALA,2019,290,340,630,48
BUTAMBALA,2020,310,360,670,48
BUTAMBALA,2021,310,370,680,48
BUTAMBALA,2022,310,370,680,48
BUTAMBALA,2023,310,370,680,48
BUTAMBALA,2024,310,380,690,48
BUTAMBALA,2025,320,380,700,48
BUTEBO,2015,280,280,560,48
BUTEBO,2016,290,280,570,48
BUTEBO,2017,300,300,600,48
BUTEBO,2018,330,330,660,48
BUTEBO,2019,340,340,680,48
BUTEBO,2020,350,360,710,48
BUTEBO,2021,350,370,720,48
BUTEBO,2022,360,370,730,48
BUTEBO,2023,350,380,730,48
BUTEBO,2024,360,380,740,48
BUTEBO,2025,360,380,740,48
BUVUMA,2015,360,250,610,48
BUVUMA,2016,380,270,650,48
BUVUMA,2017,410,290,700,48
BUVUMA,2018,430,310,740,48
BUVUMA,2019,460,330,790,48
BUVUMA,2020,490,350,840,48
BUVUMA,2021,520,370,890,48
BUVUMA,2022,540,400,940,48
BUVUMA,2023,580,420,1000,48
BUVUMA,2024,610,450,1060,48
BUVUMA,2025,640,480,1120,48
BUYENDE,2015,740,740,1480,48
BUYENDE,2016,790,790,1580,48
BUYENDE,2017,860,870,1730,48
BUYENDE,2018,940,960,1900,48
BUYENDE,2019,1010,1060,2070,48
BUYENDE,2020,1060,1130,2190,48
BUYENDE,2021,1110,1180,2290,48
BUYENDE,2022,1140,1230,2370,48
BUYENDE,2023,1170,1290,2460,48
BUYENDE,2024,1210,1330,2540,48
BUYENDE,2025,1260,1400,2660,48
DOKOLO,2015,450,570,1020,48
DOKOLO,2016,470,590,1060,48
DOKOLO,2017,480,600,1080,48
DOKOLO,2018,500,620,1120,48
DOKOLO,2019,510,640,1150,48
DOKOLO,2020,530,650,1180,48
DOKOLO,2021,540,670,1210,48
DOKOLO,2022,560,690,1250,48
DOKOLO,2023,570,700,1270,48
DOKOLO,2024,590,720,1310,48
DOKOLO,2025,600,740,1340,48
GOMBA,2015,490,460,950,48
GOMBA,2016,510,480,990,48
GOMBA,2017,540,520,1060,48
GOMBA,2018,570,550,1120,48
GOMBA,2019,600,580,1180,48
GOMBA,2020,620,600,1220,48
GOMBA,2021,630,620,1250,48
GOMBA,2022,630,620,1250,48
GOMBA,2023,620,630,1250,48
GOMBA,2024,620,630,1250,48
GOMBA,2025,630,650,1280,48
GULU,2015,720,800,1520,48
GULU,2016,740,820,1560,48
GULU,2017,770,840,1610,48
GULU,2018,790,870,1660,48
GULU,2019,810,890,1700,48
GULU,2020,830,920,1750,48
GULU,2021,860,940,1800,48
GULU,2022,880,970,1850,48
GULU,2023,900,990,1890,48
GULU,2024,930,1020,1950,48
GULU,2025,950,1040,1990,48
HOIMA,2015,860,820,1680,48
HOIMA,2016,890,850,1740,48
HOIMA,2017,920,880,1800,48
HOIMA,2018,960,910,1870,48
HOIMA,2019,990,940,1930,48
HOIMA,2020,1030,970,2000,48
HOIMA,2021,1070,1000,2070,48
HOIMA,2022,1100,1030,2130,48
HOIMA,2023,1140,1060,2200,48
HOIMA,2024,1180,1100,2280,48
HOIMA,2025,1220,1130,2350,48
IBANDA,2015,750,830,1580,48
IBANDA,2016,770,840,1610,48
IBANDA,2017,780,860,1640,48
IBANDA,2018,800,880,1680,48
IBANDA,2019,810,890,1700,48
IBANDA,2020,830,910,1740,48
IBANDA,2021,840,920,1760,48
IBANDA,2022,860,930,1790,48
IBANDA,2023,870,950,1820,48
IBANDA,2024,890,960,1850,48
IBANDA,2025,900,970,1870,48
IGANGA,2015,900,870,1770,48
IGANGA,2016,950,920,1870,48
IGANGA,2017,1020,1000,2020,48
IGANGA,2018,1100,1090,2190,48
IGANGA,2019,1170,1170,2340,48
IGANGA,2020,1220,1230,2450,48
IGANGA,2021,1250,1280,2530,48
IGANGA,2022,1270,1310,2580,48
IGANGA,2023,1290,1340,2630,48
IGANGA,2024,1320,1390,2710,48
IGANGA,2025,1350,1430,2780,48
ISINGIRO,2015,1540,1570,3110,48
ISINGIRO,2016,1600,1620,3220,48
ISINGIRO,2017,1660,1680,3340,48
ISINGIRO,2018,1720,1740,3460,48
ISINGIRO,2019,1780,1800,3580,48
ISINGIRO,2020,1850,1860,3710,48
ISINGIRO,2021,1910,1920,3830,48
ISINGIRO,2022,1980,1990,3970,48
ISINGIRO,2023,2040,2050,4090,48
ISINGIRO,2024,2110,2110,4220,48
ISINGIRO,2025,2180,2180,4360,48
JINJA,2015,1350,1390,2740,48
JINJA,2016,1370,1420,2790,48
JINJA,2017,1390,1440,2830,48
JINJA,2018,1420,1460,2880,48
JINJA,2019,1440,1480,2920,48
JINJA,2020,1460,1500,2960,48
JINJA,2021,1480,1520,3000,48
JINJA,2022,1500,1540,3040,48
JINJA,2023,1520,1560,3080,48
JINJA,2024,1540,1580,3120,48
JINJA,2025,1560,1590,3150,48
KAABONG,2015,340,450,790,48
KAABONG,2016,350,460,810,48
KAABONG,2017,360,470,830,48
KAABONG,2018,370,480,850,48
KAABONG,2019,380,490,870,48
KAABONG,2020,390,510,900,48
KAABONG,2021,400,520,920,48
KAABONG,2022,410,530,940,48
KAABONG,2023,420,540,960,48
KAABONG,2024,430,550,980,48
KAABONG,2025,440,560,1000,48
KABALE,2015,610,810,1420,48
KABALE,2016,620,820,1440,48
KABALE,2017,630,830,1460,48
KABALE,2018,640,840,1480,48
KABALE,2019,650,850,1500,48
KABALE,2020,660,860,1520,48
KABALE,2021,670,870,1540,48
KABALE,2022,680,880,1560,48
KABALE,2023,690,880,1570,48
KABALE,2024,690,890,1580,48
KABALE,2025,700,900,1600,48
KABAROLE,2015,710,810,1520,48
KABAROLE,2016,720,830,1550,48
KABAROLE,2017,740,850,1590,48
KABAROLE,2018,750,870,1620,48
KABAROLE,2019,770,880,1650,48
KABAROLE,2020,790,900,1690,48
KABAROLE,2021,800,920,1720,48
KABAROLE,2022,820,940,1760,48
KABAROLE,2023,830,960,1790,48
KABAROLE,2024,850,970,1820,48
KABAROLE,2025,860,990,1850,48
KABERAMAIDO,2015,240,240,480,48
KABERAMAIDO,2016,260,250,510,48
KABERAMAIDO,2017,280,270,550,48
KABERAMAIDO,2018,310,310,620,48
KABERAMAIDO,2019,330,330,660,48
KABERAMAIDO,2020,350,350,700,48
KABERAMAIDO,2021,360,370,730,48
KABERAMAIDO,2022,380,390,770,48
KABERAMAIDO,2023,380,400,780,48
KABERAMAIDO,2024,400,410,810,48
KABERAMAIDO,2025,410,440,850,48
KAGADI,2015,830,910,1740,48
KAGADI,2016,860,940,1800,48
KAGADI,2017,890,970,1860,48
KAGADI,2018,920,1010,1930,48
KAGADI,2019,960,1040,2000,48
KAGADI,2020,990,1080,2070,48
KAGADI,2021,1030,1110,2140,48
KAGADI,2022,1060,1150,2210,48
KAGADI,2023,1100,1180,2280,48
KAGADI,2024,1130,1220,2350,48
KAGADI,2025,1170,1260,2430,48
KAKUMIRO,2015,830,800,1630,48
KAKUMIRO,2016,900,870,1770,48
KAKUMIRO,2017,980,940,1920,48
KAKUMIRO,2018,1060,1020,2080,48
KAKUMIRO,2019,1160,1110,2270,48
KAKUMIRO,2020,1260,1200,2460,48
KAKUMIRO,2021,1370,1300,2670,48
KAKUMIRO,2022,1480,1400,2880,48
KAKUMIRO,2023,1610,1520,3130,48
KAKUMIRO,2024,1740,1640,3380,48
KAKUMIRO,2025,1890,1770,3660,48
KALAKI,2015,300,310,610,48
KALAKI,2016,310,330,640,48
KALAKI,2017,330,340,670,48
KALAKI,2018,340,350,690,48
KALAKI,2019,360,370,730,48
KALAKI,2020,370,380,750,48
KALAKI,2021,390,390,780,48
KALAKI,2022,400,410,810,48
KALAKI,2023,420,420,840,48
KALAKI,2024,430,440,870,48
KALAKI,2025,450,450,900,48
KALANGALA,2015,270,110,380,48
KALANGALA,2016,280,120,400,48
KALANGALA,2017,290,120,410,48
KALANGALA,2018,300,130,430,48
KALANGALA,2019,320,130,450,48
KALANGALA,2020,330,140,470,48
KALANGALA,2021,340,140,480,48
KALANGALA,2022,350,150,500,48
KALANGALA,2023,360,150,510,48
KALANGALA,2024,370,160,530,48
KALANGALA,2025,380,170,550,48
KALIRO,2015,610,600,1210,48
KALIRO,2016,640,650,1290,48
KALIRO,2017,690,700,1390,48
KALIRO,2018,740,770,1510,48
KALIRO,2019,790,820,1610,48
KALIRO,2020,840,880,1720,48
KALIRO,2021,860,920,1780,48
KALIRO,2022,870,950,1820,48
KALIRO,2023,890,980,1870,48
KALIRO,2024,910,1010,1920,48
KALIRO,2025,940,1050,1990,48
KALUNGU,2015,490,560,1050,48
KALUNGU,2016,510,590,1100,48
KALUNGU,2017,540,630,1170,48
KALUNGU,2018,560,660,1220,48
KALUNGU,2019,590,700,1290,48
KALUNGU,2020,600,720,1320,48
KALUNGU,2021,610,740,1350,48
KALUNGU,2022,610,740,1350,48
KALUNGU,2023,600,750,1350,48
KALUNGU,2024,600,760,1360,48
KALUNGU,2025,600,780,1380,48
KAMPALA,2015,3970,3680,7650,48
KAMPALA,2016,4050,3750,7800,48
KAMPALA,2017,4120,3830,7950,48
KAMPALA,2018,4200,3900,8100,48
KAMPALA,2019,4280,3970,8250,48
KAMPALA,2020,4360,4040,8400,48
KAMPALA,2021,4440,4110,8550,48
KAMPALA,2022,4510,4180,8690,48
KAMPALA,2023,4590,4250,8840,48
KAMPALA,2024,4660,4310,8970,48
KAMPALA,2025,4720,4380,9100,48
KAMULI,2015,1190,1230,2420,48
KAMULI,2016,1250,1290,2540,48
KAMULI,2017,1330,1390,2720,48
KAMULI,2018,1420,1510,2930,48
KAMULI,2019,1500,1610,3110,48
KAMULI,2020,1570,1690,3260,48
KAMULI,2021,1590,1750,3340,48
KAMULI,2022,1610,1780,3390,48
KAMULI,2023,1630,1810,3440,48
KAMULI,2024,1650,1850,3500,48
KAMULI,2025,1680,1910,3590,48
KAMWENGE,2015,760,850,1610,48
KAMWENGE,2016,790,880,1670,48
KAMWENGE,2017,820,910,1730,48
KAMWENGE,2018,850,950,1800,48
KAMWENGE,2019,890,980,1870,48
KAMWENGE,2020,920,1010,1930,48
KAMWENGE,2021,960,1040,2000,48
KAMWENGE,2022,990,1080,2070,48
KAMWENGE,2023,1030,1110,2140,48
KAMWENGE,2024,1070,1150,2220,48
KAMWENGE,2025,1110,1190,2300,48
KANUNGU,2015,710,810,1520,48
KANUNGU,2016,720,820,1540,48
KANUNGU,2017,740,840,1580,48
KANUNGU,2018,750,850,1600,48
KANUNGU,2019,760,860,1620,48
KANUNGU,2020,770,880,1650,48
KANUNGU,2021,790,890,1680,48
KANUNGU,2022,800,900,1700,48
KANUNGU,2023,810,910,1720,48
KANUNGU,2024,820,930,1750,48
KANUNGU,2025,830,940,1770,48
KAPCHORWA,2015,340,350,690,48
KAPCHORWA,2016,350,360,710,48
KAPCHORWA,2017,370,370,740,48
KAPCHORWA,2018,380,380,760,48
KAPCHORWA,2019,390,390,780,48
KAPCHORWA,2020,400,400,800,48
KAPCHORWA,2021,410,410,820,48
KAPCHORWA,2022,420,430,850,48
KAPCHORWA,2023,430,440,870,48
KAPCHORWA,2024,440,450,890,48
KAPCHORWA,2025,460,460,920,48
KAPELEBYONG,2015,200,220,420,48
KAPELEBYONG,2016,210,220,430,48
KAPELEBYONG,2017,220,250,470,48
KAPELEBYONG,2018,240,270,510,48
KAPELEBYONG,2019,250,290,540,48
KAPELEBYONG,2020,270,300,570,48
KAPELEBYONG,2021,270,310,580,48
KAPELEBYONG,2022,270,320,590,48
KAPELEBYONG,2023,280,330,610,48
KAPELEBYONG,2024,290,340,630,48
KAPELEBYONG,2025,300,350,650,48
KASESE,2015,1480,1610,3090,48
KASESE,2016,1550,1690,3240,48
KASESE,2017,1650,1820,3470,48
KASESE,2018,1770,1980,3750,48
KASESE,2019,1860,2100,3960,48
KASESE,2020,1930,2200,4130,48
KASESE,2021,1970,2280,4250,48
KASESE,2022,1990,2320,4310,48
KASESE,2023,2000,2360,4360,48
KASESE,2024,2020,2420,4440,48
KASESE,2025,2060,2480,4540,48
KASSANDA,2015,820,810,1630,48
KASSANDA,2016,850,830,1680,48
KASSANDA,2017,870,850,1720,48
KASSANDA,2018,900,870,1770,48
KASSANDA,2019,920,880,1800,48
KASSANDA,2020,950,900,1850,48
KASSANDA,2021,970,920,1890,48
KASSANDA,2022,1000,940,1940,48
KASSANDA,2023,1020,950,1970,48
KASSANDA,2024,1040,970,2010,48
KASSANDA,2025,1070,990,2060,48
KATAKWI,2015,370,480,850,48
KATAKWI,2016,390,500,890,48
KATAKWI,2017,420,550,970,48
KATAKWI,2018,450,590,1040,48
KATAKWI,2019,480,630,1110,48
KATAKWI,2020,500,660,1160,48
KATAKWI,2021,510,690,1200,48
KATAKWI,2022,520,700,1220,48
KATAKWI,2023,530,720,1250,48
KATAKWI,2024,540,740,1280,48
KATAKWI,2025,540,760,1300,48
KAYUNGA,2015,970,1030,2000,48
KAYUNGA,2016,1010,1080,2090,48
KAYUNGA,2017,1080,1150,2230,48
KAYUNGA,2018,1150,1240,2390,48
KAYUNGA,2019,1200,1320,2520,48
KAYUNGA,2020,1240,1380,2620,48
KAYUNGA,2021,1270,1410,2680,48
KAYUNGA,2022,1270,1430,2700,48
KAYUNGA,2023,1270,1450,2720,48
KAYUNGA,2024,1280,1480,2760,48
KAYUNGA,2025,1300,1510,2810,48
KAZO,2015,570,650,1220,48
KAZO,2016,590,680,1270,48
KAZO,2017,620,700,1320,48
KAZO,2018,640,730,1370,48
KAZO,2019,660,750,1410,48
KAZO,2020,690,780,1470,48
KAZO,2021,710,800,1510,48
KAZO,2022,730,830,1560,48
KAZO,2023,760,850,1610,48
KAZO,2024,790,880,1670,48
KAZO,2025,810,910,1720,48
KIBAALE,2015,370,320,690,48
KIBAALE,2016,400,340,740,48
KIBAALE,2017,420,360,780,48
KIBAALE,2018,450,380,830,48
KIBAALE,2019,480,410,890,48
KIBAALE,2020,510,430,940,48
KIBAALE,2021,540,450,990,48
KIBAALE,2022,570,480,1050,48
KIBAALE,2023,610,500,1110,48
KIBAALE,2024,640,530,1170,48
KIBAALE,2025,680,560,1240,48
KIBOGA,2015,390,370,760,48
KIBOGA,2016,390,380,770,48
KIBOGA,2017,410,400,810,48
KIBOGA,2018,440,440,880,48
KIBOGA,2019,470,460,930,48
KIBOGA,2020,500,500,1000,48
KIBOGA,2021,530,530,1060,48
KIBOGA,2022,540,550,1090,48
KIBOGA,2023,530,560,1090,48
KIBOGA,2024,540,560,1100,48
KIBOGA,2025,550,580,1130,48
KIBUKU,2015,450,440,890,48
KIBUKU,2016,470,470,940,48
KIBUKU,2017,510,510,1020,48
KIBUKU,2018,550,560,1110,48
KIBUKU,2019,590,600,1190,48
KIBUKU,2020,620,640,1260,48
KIBUKU,2021,650,680,1330,48
KIBUKU,2022,660,700,1360,48
KIBUKU,2023,670,720,1390,48
KIBUKU,2024,690,750,1440,48
KIBUKU,2025,710,790,1500,48
KIKUUBE,2015,820,700,1520,48
KIKUUBE,2016,860,730,1590,48
KIKUUBE,2017,910,770,1680,48
KIKUUBE,2018,950,810,1760,48
KIKUUBE,2019,1000,850,1850,48
KIKUUBE,2020,1060,890,1950,48
KIKUUBE,2021,1110,930,2040,48
KIKUUBE,2022,1170,980,2150,48
KIKUUBE,2023,1220,1020,2240,48
KIKUUBE,2024,1280,1070,2350,48
KIKUUBE,2025,1350,1120,2470,48
KIRUHURA,2015,570,490,1060,48
KIRUHURA,2016,590,510,1100,48
KIRUHURA,2017,620,520,1140,48
KIRUHURA,2018,640,540,1180,48
KIRUHURA,2019,660,560,1220,48
KIRUHURA,2020,690,580,1270,48
KIRUHURA,2021,710,600,1310,48
KIRUHURA,2022,740,620,1360,48
KIRUHURA,2023,760,640,1400,48
KIRUHURA,2024,790,660,1450,48
KIRUHURA,2025,810,680,1490,48
KIRYANDONGO,2015,550,640,1190,48
KIRYANDONGO,2016,580,670,1250,48
KIRYANDONGO,2017,630,730,1360,48
KIRYANDONGO,2018,670,790,1460,48
KIRYANDONGO,2019,710,840,1550,48
KIRYANDONGO,2020,740,900,1640,48
KIRYANDONGO,2021,760,930,1690,48
KIRYANDONGO,2022,770,950,1720,48
KIRYANDONGO,2023,780,970,1750,48
KIRYANDONGO,2024,790,1000,1790,48
KIRYANDONGO,2025,810,1030,1840,48
KISORO,2015,550,830,1380,48
KISORO,2016,570,870,1440,48
KISORO,2017,610,940,1550,48
KISORO,2018,650,1010,1660,48
KISORO,2019,680,1080,1760,48
KISORO,2020,700,1130,1830,48
KISORO,2021,720,1160,1880,48
KISORO,2022,720,1180,1900,48
KISORO,2023,720,1200,1920,48
KISORO,2024,720,1230,1950,48
KISORO,2025,730,1260,1990,48
KITAGWENDA,2015,410,490,900,48
KITAGWENDA,2016,430,510,940,48
KITAGWENDA,2017,440,530,970,48
KITAGWENDA,2018,460,550,1010,48
KITAGWENDA,2019,480,570,1050,48
KITAGWENDA,2020,500,590,1090,48
KITAGWENDA,2021,520,610,1130,48
KITAGWENDA,2022,540,630,1170,48
KITAGWENDA,2023,560,650,1210,48
KITAGWENDA,2024,580,670,1250,48
KITAGWENDA,2025,600,690,1290,48
KITGUM,2015,480,540,1020,48
KITGUM,2016,500,560,1060,48
KITGUM,2017,530,600,1130,48
KITGUM,2018,560,650,1210,48
KITGUM,2019,590,680,1270,48
KITGUM,2020,610,710,1320,48
KITGUM,2021,620,730,1350,48
KITGUM,2022,620,730,1350,48
KITGUM,2023,620,740,1360,48
KITGUM,2024,610,760,1370,48
KITGUM,2025,620,780,1400,48
KOBOKO,2015,460,540,1000,48
KOBOKO,2016,500,580,1080,48
KOBOKO,2017,540,630,1170,48
KOBOKO,2018,580,690,1270,48
KOBOKO,2019,620,740,1360,48
KOBOKO,2020,660,800,1460,48
KOBOKO,2021,680,840,1520,48
KOBOKO,2022,700,870,1570,48
KOBOKO,2023,710,900,1610,48
KOBOKO,2024,730,920,1650,48
KOBOKO,2025,760,970,1730,48
KOLE,2015,580,670,1250,48
KOLE,2016,600,690,1290,48
KOLE,2017,620,710,1330,48
KOLE,2018,640,730,1370,48
KOLE,2019,660,750,1410,48
KOLE,2020,680,770,1450,48
KOLE,2021,700,790,1490,48
KOLE,2022,720,810,1530,48
KOLE,2023,740,840,1580,48
KOLE,2024,760,860,1620,48
KOLE,2025,780,880,1660,48
KOTIDO,2015,540,610,1150,48
KOTIDO,2016,570,640,1210,48
KOTIDO,2017,610,690,1300,48
KOTIDO,2018,650,750,1400,48
KOTIDO,2019,680,790,1470,48
KOTIDO,2020,710,840,1550,48
KOTIDO,2021,730,870,1600,48
KOTIDO,2022,730,880,1610,48
KOTIDO,2023,740,900,1640,48
KOTIDO,2024,740,910,1650,48
KOTIDO,2025,760,940,1700,48
KUMI,2015,620,660,1280,48
KUMI,2016,660,700,1360,48
KUMI,2017,710,750,1460,48
KUMI,2018,760,820,1580,48
KUMI,2019,800,880,1680,48
KUMI,2020,850,930,1780,48
KUMI,2021,860,960,1820,48
KUMI,2022,880,990,1870,48
KUMI,2023,900,1010,1910,48
KUMI,2024,910,1050,1960,48
KUMI,2025,940,1080,2020,48
KWANIA,2015,450,480,930,48
KWANIA,2016,460,500,960,48
KWANIA,2017,480,510,990,48
KWANIA,2018,490,520,1010,48
KWANIA,2019,510,540,1050,48
KWANIA,2020,520,550,1070,48
KWANIA,2021,540,570,1110,48
KWANIA,2022,550,580,1130,48
KWANIA,2023,570,600,1170,48
KWANIA,2024,580,610,1190,48
KWANIA,2025,600,630,1230,48
KWEEN,2015,310,300,610,48
KWEEN,2016,320,310,630,48
KWEEN,2017,330,310,640,48
KWEEN,2018,340,320,660,48
KWEEN,2019,350,330,680,48
KWEEN,2020,360,340,700,48
KWEEN,2021,370,350,720,48
KWEEN,2022,380,350,730,48
KWEEN,2023,390,360,750,48
KWEEN,2024,400,370,770,48
KWEEN,2025,410,370,780,48
KYANKWANZI,2015,690,600,1290,48
KYANKWANZI,2016,730,630,1360,48
KYANKWANZI,2017,770,660,1430,48
KYANKWANZI,2018,800,690,1490,48
KYANKWANZI,2019,850,720,1570,48
KYANKWANZI,2020,890,750,1640,48
KYANKWANZI,2021,930,780,1710,48
KYANKWANZI,2022,980,820,1800,48
KYANKWANZI,2023,1020,850,1870,48
KYANKWANZI,2024,1070,890,1960,48
KYANKWANZI,2025,1120,930,2050,48
KYEGEGWA,2015,850,810,1660,48
KYEGEGWA,2016,920,880,1800,48
KYEGEGWA,2017,1000,950,1950,48
KYEGEGWA,2018,1080,1020,2100,48
KYEGEGWA,2019,1170,1100,2270,48
KYEGEGWA,2020,1260,1180,2440,48
KYEGEGWA,2021,1360,1280,2640,48
KYEGEGWA,2022,1470,1370,2840,48
KYEGEGWA,2023,1590,1480,3070,48
KYEGEGWA,2024,1710,1590,3300,48
KYEGEGWA,2025,1840,1700,3540,48
KYENJOJO,2015,990,1060,2050,48
KYENJOJO,2016,1040,1100,2140,48
KYENJOJO,2017,1080,1140,2220,48
KYENJOJO,2018,1120,1180,2300,48
KYENJOJO,2019,1170,1220,2390,48
KYENJOJO,2020,1210,1260,2470,48
KYENJOJO,2021,1260,1310,2570,48
KYENJOJO,2022,1310,1350,2660,48
KYENJOJO,2023,1360,1400,2760,48
KYENJOJO,2024,1410,1440,2850,48
KYENJOJO,2025,1460,1490,2950,48
KYOTERA,2015,680,620,1300,48
KYOTERA,2016,710,650,1360,48
KYOTERA,2017,750,690,1440,48
KYOTERA,2018,790,740,1530,48
KYOTERA,2019,830,780,1610,48
KYOTERA,2020,860,820,1680,48
KYOTERA,2021,860,840,1700,48
KYOTERA,2022,860,850,1710,48
KYOTERA,2023,870,850,1720,48
KYOTERA,2024,870,860,1730,48
KYOTERA,2025,880,880,1760,48
KARENGA,2015,120,140,260,48
KARENGA,2016,130,150,280,48
KARENGA,2017,130,150,280,48
KARENGA,2018,130,150,280,48
KARENGA,2019,140,160,300,48
KARENGA,2020,140,160,300,48
KARENGA,2021,140,170,310,48
KARENGA,2022,150,170,320,48
KARENGA,2023,150,170,320,48
KARENGA,2024,150,180,330,48
KARENGA,2025,160,180,340,48
LAMWO,2015,340,390,730,48
LAMWO,2016,350,410,760,48
LAMWO,2017,370,450,820,48
LAMWO,2018,390,470,860,48
LAMWO,2019,400,500,900,48
LAMWO,2020,410,530,940,48
LAMWO,2021,410,530,940,48
LAMWO,2022,410,540,950,48
LAMWO,2023,410,540,950,48
LAMWO,2024,410,560,970,48
LAMWO,2025,410,570,980,48
LIRA,2015,1010,1140,2150,48
LIRA,2016,1030,1170,2200,48
LIRA,2017,1060,1210,2270,48
LIRA,2018,1090,1240,2330,48
LIRA,2019,1120,1270,2390,48
LIRA,2020,1150,1310,2460,48
LIRA,2021,1180,1340,2520,48
LIRA,2022,1210,1380,2590,48
LIRA,2023,1240,1410,2650,48
LIRA,2024,1270,1450,2720,48
LIRA,2025,1300,1480,2780,48
LUUKA,2015,600,680,1280,48
LUUKA,2016,620,720,1340,48
LUUKA,2017,660,760,1420,48
LUUKA,2018,700,830,1530,48
LUUKA,2019,740,880,1620,48
LUUKA,2020,760,920,1680,48
LUUKA,2021,780,950,1730,48
LUUKA,2022,780,960,1740,48
LUUKA,2023,780,980,1760,48
LUUKA,2024,790,1000,1790,48
LUUKA,2025,800,1030,1830,48
LUWERO,2015,1270,1230,2500,48
LUWERO,2016,1330,1290,2620,48
LUWERO,2017,1420,1390,2810,48
LUWERO,2018,1520,1500,3020,48
LUWERO,2019,1610,1610,3220,48
LUWERO,2020,1670,1690,3360,48
LUWERO,2021,1700,1740,3440,48
LUWERO,2022,1720,1780,3500,48
LUWERO,2023,1730,1810,3540,48
LUWERO,2024,1750,1850,3600,48
LUWERO,2025,1790,1900,3690,48
LWENGO,2015,710,800,1510,48
LWENGO,2016,740,830,1570,48
LWENGO,2017,780,880,1660,48
LWENGO,2018,820,930,1750,48
LWENGO,2019,850,990,1840,48
LWENGO,2020,870,1020,1890,48
LWENGO,2021,870,1050,1920,48
LWENGO,2022,870,1050,1920,48
LWENGO,2023,870,1060,1930,48
LWENGO,2024,860,1060,1920,48
LWENGO,2025,870,1080,1950,48
LYANTONDE,2015,270,260,530,48
LYANTONDE,2016,280,280,560,48
LYANTONDE,2017,300,300,600,48
LYANTONDE,2018,330,330,660,48
LYANTONDE,2019,350,350,700,48
LYANTONDE,2020,360,370,730,48
LYANTONDE,2021,370,390,760,48
LYANTONDE,2022,380,400,780,48
LYANTONDE,2023,380,400,780,48
LYANTONDE,2024,390,410,800,48
LYANTONDE,2025,400,420,820,48
MANAFWA,2015,530,550,1080,48
MANAFWA,2016,540,560,1100,48
MANAFWA,2017,550,570,1120,48
MANAFWA,2018,570,580,1150,48
MANAFWA,2019,580,600,1180,48
MANAFWA,2020,590,610,1200,48
MANAFWA,2021,610,620,1230,48
MANAFWA,2022,620,630,1250,48
MANAFWA,2023,630,650,1280,48
MANAFWA,2024,650,660,1310,48
MANAFWA,2025,660,670,1330,48
MARACHA,2015,500,780,1280,48
MARACHA,2016,510,790,1300,48
MARACHA,2017,520,810,1330,48
MARACHA,2018,530,830,1360,48
MARACHA,2019,540,840,1380,48
MARACHA,2020,550,860,1410,48
MARACHA,2021,560,870,1430,48
MARACHA,2022,570,890,1460,48
MARACHA,2023,580,900,1480,48
MARACHA,2024,590,910,1500,48
MARACHA,2025,600,930,1530,48
MASAKA,2015,710,730,1440,48
MASAKA,2016,710,710,1420,48
MASAKA,2017,720,710,1430,48
MASAKA,2018,760,750,1510,48
MASAKA,2019,810,810,1620,48
MASAKA,2020,870,870,1740,48
MASAKA,2021,910,930,1840,48
MASAKA,2022,950,970,1920,48
MASAKA,2023,960,1010,1970,48
MASAKA,2024,970,1020,1990,48
MASAKA,2025,970,1040,2010,48
MASINDI,2015,880,860,1740,48
MASINDI,2016,900,890,1790,48
MASINDI,2017,930,910,1840,48
MASINDI,2018,950,930,1880,48
MASINDI,2019,980,960,1940,48
MASINDI,2020,1010,980,1990,48
MASINDI,2021,1040,1010,2050,48
MASINDI,2022,1060,1030,2090,48
MASINDI,2023,1090,1050,2140,48
MASINDI,2024,1120,1080,2200,48
MASINDI,2025,1140,1100,2240,48
MAYUGE,2015,1070,1140,2210,48
MAYUGE,2016,1130,1210,2340,48
MAYUGE,2017,1210,1310,2520,48
MAYUGE,2018,1310,1430,2740,48
MAYUGE,2019,1390,1540,2930,48
MAYUGE,2020,1460,1630,3090,48
MAYUGE,2021,1490,1690,3180,48
MAYUGE,2022,1520,1740,3260,48
MAYUGE,2023,1540,1790,3330,48
MAYUGE,2024,1570,1840,3410,48
MAYUGE,2025,1610,1910,3520,48
MBALE,2015,1290,1270,2560,48
MBALE,2016,1350,1340,2690,48
MBALE,2017,1450,1460,2910,48
MBALE,2018,1560,1610,3170,48
MBALE,2019,1650,1730,3380,48
MBALE,2020,1720,1830,3550,48
MBALE,2021,1770,1910,3680,48
MBALE,2022,1800,1980,3780,48
MBALE,2023,1820,2030,3850,48
MBALE,2024,1850,2100,3950,48
MBALE,2025,1900,2180,4080,48
MBARARA,2015,1120,1010,2130,48
MBARARA,2016,1140,1030,2170,48
MBARARA,2017,1170,1050,2220,48
MBARARA,2018,1200,1080,2280,48
MBARARA,2019,1220,1100,2320,48
MBARARA,2020,1250,1120,2370,48
MBARARA,2021,1270,1140,2410,48
MBARARA,2022,1300,1160,2460,48
MBARARA,2023,1330,1190,2520,48
MBARARA,2024,1350,1210,2560,48
MBARARA,2025,1370,1230,2600,48
MITOOMA,2015,450,700,1150,48
MITOOMA,2016,460,710,1170,48
MITOOMA,2017,460,720,1180,48
MITOOMA,2018,470,720,1190,48
MITOOMA,2019,470,730,1200,48
MITOOMA,2020,480,730,1210,48
MITOOMA,2021,480,740,1220,48
MITOOMA,2022,490,740,1230,48
MITOOMA,2023,490,750,1240,48
MITOOMA,2024,490,750,1240,48
MITOOMA,2025,500,760,1260,48
MITYANA,2015,860,870,1730,48
MITYANA,2016,890,910,1800,48
MITYANA,2017,950,970,1920,48
MITYANA,2018,1000,1050,2050,48
MITYANA,2019,1050,1110,2160,48
MITYANA,2020,1080,1160,2240,48
MITYANA,2021,1100,1190,2290,48
MITYANA,2022,1110,1200,2310,48
MITYANA,2023,1100,1210,2310,48
MITYANA,2024,1110,1240,2350,48
MITYANA,2025,1130,1260,2390,48
MOROTO,2015,230,240,470,48
MOROTO,2016,250,260,510,48
MOROTO,2017,260,280,540,48
MOROTO,2018,280,300,580,48
MOROTO,2019,290,320,610,48
MOROTO,2020,300,340,640,48
MOROTO,2021,310,360,670,48
MOROTO,2022,300,360,660,48
MOROTO,2023,310,370,680,48
MOROTO,2024,320,380,700,48
MOROTO,2025,320,380,700,48
MOYO,2015,310,390,700,48
MOYO,2016,320,400,720,48
MOYO,2017,330,410,740,48
MOYO,2018,340,420,760,48
MOYO,2019,350,430,780,48
MOYO,2020,350,440,790,48
MOYO,2021,360,450,810,48
MOYO,2022,370,460,830,48
MOYO,2023,380,460,840,48
MOYO,2024,390,470,860,48
MOYO,2025,390,480,870,48
MPIGI,2015,700,690,1390,48
MPIGI,2016,730,720,1450,48
MPIGI,2017,780,780,1560,48
MPIGI,2018,830,850,1680,48
MPIGI,2019,870,900,1770,48
MPIGI,2020,910,950,1860,48
MPIGI,2021,930,980,1910,48
MPIGI,2022,930,1000,1930,48
MPIGI,2023,940,1020,1960,48
MPIGI,2024,950,1050,2000,48
MPIGI,2025,970,1070,2040,48
MUBENDE,2015,1110,990,2100,48
MUBENDE,2016,1190,1070,2260,48
MUBENDE,2017,1300,1190,2490,48
MUBENDE,2018,1430,1320,2750,48
MUBENDE,2019,1560,1450,3010,48
MUBENDE,2020,1660,1560,3220,48
MUBENDE,2021,1740,1660,3400,48
MUBENDE,2022,1810,1740,3550,48
MUBENDE,2023,1860,1820,3680,48
MUBENDE,2024,1940,1920,3860,48
MUBENDE,2025,2030,2030,4060,48
MUKONO,2015,1520,1540,3060,48
MUKONO,2016,1600,1620,3220,48
MUKONO,2017,1710,1760,3470,48
MUKONO,2018,1830,1920,3750,48
MUKONO,2019,1930,2060,3990,48
MUKONO,2020,2010,2180,4190,48
MUKONO,2021,2060,2260,4320,48
MUKONO,2022,2090,2320,4410,48
MUKONO,2023,2110,2380,4490,48
MUKONO,2024,2140,2450,4590,48
MUKONO,2025,2190,2540,4730,48
MADI OKOLLO,2015,450,650,1100,48
MADI OKOLLO,2016,460,670,1130,48
MADI OKOLLO,2017,480,690,1170,48
MADI OKOLLO,2018,490,710,1200,48
MADI OKOLLO,2019,500,730,1230,48
MADI OKOLLO,2020,520,750,1270,48
MADI OKOLLO,2021,530,760,1290,48
MADI OKOLLO,2022,550,780,1330,48
MADI OKOLLO,2023,560,800,1360,48
MADI OKOLLO,2024,570,820,1390,48
MADI OKOLLO,2025,590,840,1430,48
NABILATUK,2015,170,180,350,48
NABILATUK,2016,180,190,370,48
NABILATUK,2017,200,210,410,48
NABILATUK,2018,220,230,450,48
NABILATUK,2019,230,250,480,48
NABILATUK,2020,250,270,520,48
NABILATUK,2021,260,280,540,48
NABILATUK,2022,270,300,570,48
NABILATUK,2023,280,310,590,48
NABILATUK,2024,290,330,620,48
NABILATUK,2025,310,340,650,48
NAKAPIRIPIRIT,2015,210,230,440,48
NAKAPIRIPIRIT,2016,220,250,470,48
NAKAPIRIPIRIT,2017,240,270,510,48
NAKAPIRIPIRIT,2018,260,300,560,48
NAKAPIRIPIRIT,2019,270,330,600,48
NAKAPIRIPIRIT,2020,290,350,640,48
NAKAPIRIPIRIT,2021,310,370,680,48
NAKAPIRIPIRIT,2022,310,390,700,48
NAKAPIRIPIRIT,2023,320,400,720,48
NAKAPIRIPIRIT,2024,330,420,750,48
NAKAPIRIPIRIT,2025,350,440,790,48
NAKASEKE,2015,740,630,1370,48
NAKASEKE,2016,760,650,1410,48
NAKASEKE,2017,790,660,1450,48
NAKASEKE,2018,820,680,1500,48
NAKASEKE,2019,850,690,1540,48
NAKASEKE,2020,880,710,1590,48
NAKASEKE,2021,910,730,1640,48
NAKASEKE,2022,940,740,1680,48
NAKASEKE,2023,970,760,1730,48
NAKASEKE,2024,1000,770,1770,48
NAKASEKE,2025,1030,790,1820,48
NAKASONGOLA,2015,520,480,1000,48
NAKASONGOLA,2016,550,510,1060,48
NAKASONGOLA,2017,590,550,1140,48
NAKASONGOLA,2018,630,600,1230,48
NAKASONGOLA,2019,670,630,1300,48
NAKASONGOLA,2020,700,670,1370,48
NAKASONGOLA,2021,720,700,1420,48
NAKASONGOLA,2022,730,710,1440,48
NAKASONGOLA,2023,740,730,1470,48
NAKASONGOLA,2024,750,750,1500,48
NAKASONGOLA,2025,780,780,1560,48
NAMAYINGO,2015,540,490,1030,48
NAMAYINGO,2016,560,510,1070,48
NAMAYINGO,2017,590,550,1140,48
NAMAYINGO,2018,620,590,1210,48
NAMAYINGO,2019,650,620,1270,48
NAMAYINGO,2020,670,650,1320,48
NAMAYINGO,2021,690,660,1350,48
NAMAYINGO,2022,690,670,1360,48
NAMAYINGO,2023,690,680,1370,48
NAMAYINGO,2024,690,690,1380,48
NAMAYINGO,2025,700,700,1400,48
NAMISINDWA,2015,660,650,1310,48
NAMISINDWA,2016,680,660,1340,48
NAMISINDWA,2017,700,680,1380,48
NAMISINDWA,2018,720,690,1410,48
NAMISINDWA,2019,740,710,1450,48
NAMISINDWA,2020,760,730,1490,48
NAMISINDWA,2021,780,740,1520,48
NAMISINDWA,2022,800,760,1560,48
NAMISINDWA,2023,820,770,1590,48
NAMISINDWA,2024,840,790,1630,48
NAMISINDWA,2025,860,800,1660,48
NAMUTUMBA,2015,620,600,1220,48
NAMUTUMBA,2016,650,650,1300,48
NAMUTUMBA,2017,700,700,1400,48
NAMUTUMBA,2018,760,770,1530,48
NAMUTUMBA,2019,800,820,1620,48
NAMUTUMBA,2020,850,880,1730,48
NAMUTUMBA,2021,870,910,1780,48
NAMUTUMBA,2022,890,940,1830,48
NAMUTUMBA,2023,910,970,1880,48
NAMUTUMBA,2024,930,1000,1930,48
NAMUTUMBA,2025,960,1040,2000,48
NAPAK,2015,290,360,650,48
NAPAK,2016,300,380,680,48
NAPAK,2017,310,410,720,48
NAPAK,2018,340,440,780,48
NAPAK,2019,360,470,830,48
NAPAK,2020,360,490,850,48
NAPAK,2021,370,500,870,48
NAPAK,2022,370,510,880,48
NAPAK,2023,370,520,890,48
NAPAK,2024,370,540,910,48
NAPAK,2025,380,550,930,48
NEBBI,2015,680,830,1510,48
NEBBI,2016,700,850,1550,48
NEBBI,2017,720,880,1600,48
NEBBI,2018,740,900,1640,48
NEBBI,2019,770,920,1690,48
NEBBI,2020,790,950,1740,48
NEBBI,2021,810,970,1780,48
NEBBI,2022,830,1000,1830,48
NEBBI,2023,860,1020,1880,48
NEBBI,2024,880,1050,1930,48
NEBBI,2025,900,1070,1970,48
NGORA,2015,340,440,780,48
NGORA,2016,360,470,830,48
NGORA,2017,380,500,880,48
NGORA,2018,400,540,940,48
NGORA,2019,440,580,1020,48
NGORA,2020,450,610,1060,48
NGORA,2021,460,640,1100,48
NGORA,2022,470,650,1120,48
NGORA,2023,470,670,1140,48
NGORA,2024,480,680,1160,48
NGORA,2025,490,700,1190,48
NTOROKO,2015,150,180,330,48
NTOROKO,2016,160,190,350,48
NTOROKO,2017,170,200,370,48
NTOROKO,2018,190,210,400,48
NTOROKO,2019,190,230,420,48
NTOROKO,2020,210,240,450,48
NTOROKO,2021,210,250,460,48
NTOROKO,2022,210,250,460,48
NTOROKO,2023,210,250,460,48
NTOROKO,2024,220,260,480,48
NTOROKO,2025,220,270,490,48
NTUNGAMO,2015,1320,1680,3000,48
NTUNGAMO,2016,1350,1710,3060,48
NTUNGAMO,2017,1380,1740,3120,48
NTUNGAMO,2018,1410,1770,3180,48
NTUNGAMO,2019,1440,1800,3240,48
NTUNGAMO,2020,1470,1830,3300,48
NTUNGAMO,2021,1500,1860,3360,48
NTUNGAMO,2022,1520,1890,3410,48
NTUNGAMO,2023,1550,1920,3470,48
NTUNGAMO,2024,1580,1950,3530,48
NTUNGAMO,2025,1600,1980,3580,48
NWOYA,2015,360,430,790,48
NWOYA,2016,400,470,870,48
NWOYA,2017,450,520,970,48
NWOYA,2018,490,570,1060,48
NWOYA,2019,540,630,1170,48
NWOYA,2020,600,700,1300,48
NWOYA,2021,660,770,1430,48
NWOYA,2022,730,840,1570,48
NWOYA,2023,800,920,1720,48
NWOYA,2024,880,1020,1900,48
NWOYA,2025,970,1110,2080,48
OBONGI,2015,120,120,240,48
OBONGI,2016,130,120,250,48
OBONGI,2017,130,140,270,48
OBONGI,2018,140,140,280,48
OBONGI,2019,150,150,300,48
OBONGI,2020,150,170,320,48
OBONGI,2021,150,170,320,48
OBONGI,2022,160,170,330,48
OBONGI,2023,160,180,340,48
OBONGI,2024,160,180,340,48
OBONGI,2025,170,180,350,48
OMORO,2015,340,480,820,48
OMORO,2016,370,510,880,48
OMORO,2017,390,550,940,48
OMORO,2018,420,610,1030,48
OMORO,2019,450,650,1100,48
OMORO,2020,470,690,1160,48
OMORO,2021,480,720,1200,48
OMORO,2022,500,750,1250,48
OMORO,2023,510,770,1280,48
OMORO,2024,520,800,1320,48
OMORO,2025,530,830,1360,48
OTUKE,2015,280,310,590,48
OTUKE,2016,300,330,630,48
OTUKE,2017,310,340,650,48
OTUKE,2018,320,360,680,48
OTUKE,2019,340,370,710,48
OTUKE,2020,350,390,740,48
OTUKE,2021,370,400,770,48
OTUKE,2022,380,420,800,48
OTUKE,2023,400,430,830,48
OTUKE,2024,420,450,870,48
OTUKE,2025,430,470,900,48
OYAM,2015,910,1090,2000,48
OYAM,2016,930,1120,2050,48
OYAM,2017,960,1150,2110,48
OYAM,2018,990,1190,2180,48
OYAM,2019,1020,1220,2240,48
OYAM,2020,1050,1250,2300,48
OYAM,2021,1080,1290,2370,48
OYAM,2022,1110,1320,2430,48
OYAM,2023,1140,1360,2500,48
OYAM,2024,1170,1390,2560,48
OYAM,2025,1200,1420,2620,48
PADER,2015,390,550,940,48
PADER,2016,400,580,980,48
PADER,2017,430,620,1050,48
PADER,2018,450,660,1110,48
PADER,2019,480,710,1190,48
PADER,2020,500,750,1250,48
PADER,2021,490,760,1250,48
PADER,2022,500,770,1270,48
PADER,2023,500,780,1280,48
PADER,2024,500,810,1310,48
PADER,2025,500,830,1330,48
PAKWACH,2015,390,520,910,48
PAKWACH,2016,410,540,950,48
PAKWACH,2017,430,560,990,48
PAKWACH,2018,440,580,1020,48
PAKWACH,2019,460,600,1060,48
PAKWACH,2020,480,620,1100,48
PAKWACH,2021,500,650,1150,48
PAKWACH,2022,520,670,1190,48
PAKWACH,2023,540,690,1230,48
PAKWACH,2024,560,710,1270,48
PAKWACH,2025,580,730,1310,48
PALLISA,2015,650,710,1360,48
PALLISA,2016,700,750,1450,48
PALLISA,2017,760,830,1590,48
PALLISA,2018,830,920,1750,48
PALLISA,2019,890,1000,1890,48
PALLISA,2020,950,1070,2020,48
PALLISA,2021,990,1120,2110,48
PALLISA,2022,1010,1170,2180,48
PALLISA,2023,1040,1210,2250,48
PALLISA,2024,1070,1270,2340,48
PALLISA,2025,1120,1330,2450,48
RAKAI,2015,820,800,1620,48
RAKAI,2016,860,840,1700,48
RAKAI,2017,920,900,1820,48
RAKAI,2018,980,970,1950,48
RAKAI,2019,1040,1050,2090,48
RAKAI,2020,1070,1100,2170,48
RAKAI,2021,1100,1130,2230,48
RAKAI,2022,1110,1150,2260,48
RAKAI,2023,1120,1170,2290,48
RAKAI,2024,1130,1200,2330,48
RAKAI,2025,1160,1230,2390,48
RUBANDA,2015,490,650,1140,48
RUBANDA,2016,500,650,1150,48
RUBANDA,2017,510,660,1170,48
RUBANDA,2018,510,660,1170,48
RUBANDA,2019,520,670,1190,48
RUBANDA,2020,530,670,1200,48
RUBANDA,2021,530,670,1200,48
RUBANDA,2022,540,680,1220,48
RUBANDA,2023,540,680,1220,48
RUBANDA,2024,550,680,1230,48
RUBANDA,2025,550,690,1240,48
RUBIRIZI,2015,340,410,750,48
RUBIRIZI,2016,350,420,770,48
RUBIRIZI,2017,360,430,790,48
RUBIRIZI,2018,360,440,800,48
RUBIRIZI,2019,370,440,810,48
RUBIRIZI,2020,380,450,830,48
RUBIRIZI,2021,380,460,840,48
RUBIRIZI,2022,390,470,860,48
RUBIRIZI,2023,400,480,880,48
RUBIRIZI,2024,400,480,880,48
RUBIRIZI,2025,410,490,900,48
RUKIGA,2015,310,400,710,48
RUKIGA,2016,310,410,720,48
RUKIGA,2017,320,410,730,48
RUKIGA,2018,320,410,730,48
RUKIGA,2019,320,410,730,48
RUKIGA,2020,320,420,740,48
RUKIGA,2021,330,420,750,48
RUKIGA,2022,330,420,750,48
RUKIGA,2023,330,420,750,48
RUKIGA,2024,330,420,750,48
RUKIGA,2025,330,420,750,48
RUKUNGIRI,2015,910,1140,2050,48
RUKUNGIRI,2016,920,1150,2070,48
RUKUNGIRI,2017,940,1160,2100,48
RUKUNGIRI,2018,950,1170,2120,48
RUKUNGIRI,2019,960,1180,2140,48
RUKUNGIRI,2020,970,1190,2160,48
RUKUNGIRI,2021,980,1200,2180,48
RUKUNGIRI,2022,990,1210,2200,48
RUKUNGIRI,2023,990,1210,2200,48
RUKUNGIRI,2024,1000,1220,2220,48
RUKUNGIRI,2025,1010,1230,2240,48
RWAMPARA,2015,410,450,860,48
RWAMPARA,2016,410,460,870,48
RWAMPARA,2017,420,470,890,48
RWAMPARA,2018,430,480,910,48
RWAMPARA,2019,440,490,930,48
RWAMPARA,2020,450,500,950,48
RWAMPARA,2021,460,510,970,48
RWAMPARA,2022,470,520,990,48
RWAMPARA,2023,480,530,1010,48
RWAMPARA,2024,490,540,1030,48
RWAMPARA,2025,500,550,1050,48
SERERE,2015,640,750,1390,48
SERERE,2016,680,790,1470,48
SERERE,2017,740,870,1610,48
SERERE,2018,810,960,1770,48
SERERE,2019,860,1050,1910,48
SERERE,2020,910,1120,2030,48
SERERE,2021,950,1170,2120,48
SERERE,2022,970,1210,2180,48
SERERE,2023,990,1250,2240,48
SERERE,2024,1020,1300,2320,48
SERERE,2025,1060,1360,2420,48
SHEEMA,2015,620,730,1350,48
SHEEMA,2016,630,730,1360,48
SHEEMA,2017,640,740,1380,48
SHEEMA,2018,650,750,1400,48
SHEEMA,2019,650,760,1410,48
SHEEMA,2020,660,760,1420,48
SHEEMA,2021,670,770,1440,48
SHEEMA,2022,670,780,1450,48
SHEEMA,2023,680,780,1460,48
SHEEMA,2024,690,790,1480,48
SHEEMA,2025,690,790,1480,48
SIRONKO,2015,930,990,1920,48
SIRONKO,2016,960,1010,1970,48
SIRONKO,2017,980,1030,2010,48
SIRONKO,2018,1000,1060,2060,48
SIRONKO,2019,1030,1080,2110,48
SIRONKO,2020,1050,1100,2150,48
SIRONKO,2021,1070,1120,2190,48
SIRONKO,2022,1090,1140,2230,48
SIRONKO,2023,1120,1160,2280,48
SIRONKO,2024,1140,1170,2310,48
SIRONKO,2025,1160,1190,2350,48
SOROTI,2015,710,760,1470,48
SOROTI,2016,760,810,1570,48
SOROTI,2017,820,880,1700,48
SOROTI,2018,880,960,1840,48
SOROTI,2019,950,1050,2000,48
SOROTI,2020,990,1110,2100,48
SOROTI,2021,1020,1160,2180,48
SOROTI,2022,1050,1190,2240,48
SOROTI,2023,1060,1230,2290,48
SOROTI,2024,1090,1280,2370,48
SOROTI,2025,1120,1330,2450,48
SSEMBABULE,2015,770,730,1500,48
SSEMBABULE,2016,810,780,1590,48
SSEMBABULE,2017,860,840,1700,48
SSEMBABULE,2018,930,910,1840,48
SSEMBABULE,2019,990,980,1970,48
SSEMBABULE,2020,1030,1020,2050,48
SSEMBABULE,2021,1060,1070,2130,48
SSEMBABULE,2022,1070,1090,2160,48
SSEMBABULE,2023,1080,1110,2190,48
SSEMBABULE,2024,1100,1140,2240,48
SSEMBABULE,2025,1130,1180,2310,48
TORORO,2015,1350,1650,3000,48
TORORO,2016,1380,1690,3070,48
TORORO,2017,1420,1730,3150,48
TORORO,2018,1460,1780,3240,48
TORORO,2019,1490,1820,3310,48
TORORO,2020,1530,1860,3390,48
TORORO,2021,1570,1900,3470,48
TORORO,2022,1610,1950,3560,48
TORORO,2023,1640,1990,3630,48
TORORO,2024,1680,2030,3710,48
TORORO,2025,1720,2070,3790,48
WAKISO,2015,5900,4980,10880,48
WAKISO,2016,6290,5320,11610,48
WAKISO,2017,6710,5680,12390,48
WAKISO,2018,7160,6060,13220,48
WAKISO,2019,7630,6470,14100,48
WAKISO,2020,8130,6900,15030,48
WAKISO,2021,8650,7360,16010,48
WAKISO,2022,9210,7850,17060,48
WAKISO,2023,9790,8350,18140,48
WAKISO,2024,10400,8880,19280,48
WAKISO,2025,11040,9450,20490,48
YUMBE,2015,1140,1090,2230,48
YUMBE,2016,1230,1180,2410,48
YUMBE,2017,1350,1320,2670,48
YUMBE,2018,1470,1480,2950,48
YUMBE,2019,1600,1640,3240,48
YUMBE,2020,1700,1780,3480,48
YUMBE,2021,1780,1900,3680,48
YUMBE,2022,1850,2010,3860,48
YUMBE,2023,1910,2120,4030,48
YUMBE,2024,1980,2250,4230,48
YUMBE,2025,2070,2400,4470,48
ZOMBO,2015,640,840,1480,48
ZOMBO,2016,660,860,1520,48
ZOMBO,2017,680,890,1570,48
ZOMBO,2018,700,910,1610,48
ZOMBO,2019,720,940,1660,48
ZOMBO,2020,750,960,1710,48
ZOMBO,2021,770,990,1760,48
ZOMBO,2022,790,1010,1800,48
ZOMBO,2023,810,1040,1850,48
ZOMBO,2024,830,1060,1890,48
ZOMBO,2025,850,1090,1940,48
ABIM,2015,250,210,460,49
ABIM,2016,260,210,470,49
ABIM,2017,280,230,510,49
ABIM,2018,320,270,590,49
ABIM,2019,340,300,640,49
ABIM,2020,370,330,700,49
ABIM,2021,410,370,780,49
ABIM,2022,440,380,820,49
ABIM,2023,460,400,860,49
ABIM,2024,470,430,900,49
ABIM,2025,490,460,950,49
ADJUMANI,2015,370,510,880,49
ADJUMANI,2016,370,520,890,49
ADJUMANI,2017,380,520,900,49
ADJUMANI,2018,380,530,910,49
ADJUMANI,2019,380,530,910,49
ADJUMANI,2020,380,540,920,49
ADJUMANI,2021,390,540,930,49
ADJUMANI,2022,390,550,940,49
ADJUMANI,2023,390,550,940,49
ADJUMANI,2024,390,550,940,49
ADJUMANI,2025,390,560,950,49
AGAGO,2015,350,470,820,49
AGAGO,2016,360,480,840,49
AGAGO,2017,360,490,850,49
AGAGO,2018,370,500,870,49
AGAGO,2019,380,510,890,49
AGAGO,2020,380,510,890,49
AGAGO,2021,390,520,910,49
AGAGO,2022,390,530,920,49
AGAGO,2023,400,540,940,49
AGAGO,2024,410,550,960,49
AGAGO,2025,410,550,960,49
ALEBTONG,2015,570,600,1170,49
ALEBTONG,2016,580,620,1200,49
ALEBTONG,2017,610,650,1260,49
ALEBTONG,2018,650,690,1340,49
ALEBTONG,2019,700,760,1460,49
ALEBTONG,2020,740,810,1550,49
ALEBTONG,2021,770,860,1630,49
ALEBTONG,2022,800,890,1690,49
ALEBTONG,2023,800,900,1700,49
ALEBTONG,2024,820,930,1750,49
ALEBTONG,2025,830,950,1780,49
AMOLATAR,2015,400,390,790,49
AMOLATAR,2016,410,380,790,49
AMOLATAR,2017,420,400,820,49
AMOLATAR,2018,450,440,890,49
AMOLATAR,2019,490,480,970,49
AMOLATAR,2020,520,510,1030,49
AMOLATAR,2021,540,530,1070,49
AMOLATAR,2022,560,550,1110,49
AMOLATAR,2023,560,560,1120,49
AMOLATAR,2024,570,580,1150,49
AMOLATAR,2025,570,600,1170,49
AMUDAT,2015,340,190,530,49
AMUDAT,2016,350,190,540,49
AMUDAT,2017,370,210,580,49
AMUDAT,2018,400,230,630,49
AMUDAT,2019,430,260,690,49
AMUDAT,2020,470,280,750,49
AMUDAT,2021,500,290,790,49
AMUDAT,2022,510,310,820,49
AMUDAT,2023,520,330,850,49
AMUDAT,2024,530,340,870,49
AMUDAT,2025,550,360,910,49
AMURIA,2015,440,470,910,49
AMURIA,2016,450,490,940,49
AMURIA,2017,490,510,1000,49
AMURIA,2018,520,550,1070,49
AMURIA,2019,570,610,1180,49
AMURIA,2020,610,650,1260,49
AMURIA,2021,630,700,1330,49
AMURIA,2022,660,730,1390,49
AMURIA,2023,670,760,1430,49
AMURIA,2024,690,770,1460,49
AMURIA,2025,710,810,1520,49
AMURU,2015,350,370,720,49
AMURU,2016,360,380,740,49
AMURU,2017,380,390,770,49
AMURU,2018,400,420,820,49
AMURU,2019,430,460,890,49
AMURU,2020,460,500,960,49
AMURU,2021,480,530,1010,49
AMURU,2022,480,550,1030,49
AMURU,2023,490,550,1040,49
AMURU,2024,500,560,1060,49
AMURU,2025,510,580,1090,49
APAC,2015,320,390,710,49
APAC,2016,330,410,740,49
APAC,2017,340,420,760,49
APAC,2018,350,430,780,49
APAC,2019,370,450,820,49
APAC,2020,380,460,840,49
APAC,2021,390,480,870,49
APAC,2022,410,490,900,49
APAC,2023,420,510,930,49
APAC,2024,430,530,960,49
APAC,2025,450,540,990,49
ARUA,2015,1260,1540,2800,49
ARUA,2016,1290,1580,2870,49
ARUA,2017,1330,1630,2960,49
ARUA,2018,1370,1670,3040,49
ARUA,2019,1410,1720,3130,49
ARUA,2020,1450,1760,3210,49
ARUA,2021,1490,1800,3290,49
ARUA,2022,1520,1850,3370,49
ARUA,2023,1560,1890,3450,49
ARUA,2024,1600,1940,3540,49
ARUA,2025,1640,1980,3620,49
BUDAKA,2015,520,550,1070,49
BUDAKA,2016,530,570,1100,49
BUDAKA,2017,570,600,1170,49
BUDAKA,2018,620,660,1280,49
BUDAKA,2019,660,720,1380,49
BUDAKA,2020,710,770,1480,49
BUDAKA,2021,740,820,1560,49
BUDAKA,2022,770,860,1630,49
BUDAKA,2023,790,890,1680,49
BUDAKA,2024,790,900,1690,49
BUDAKA,2025,810,940,1750,49
BUDUDA,2015,580,460,1040,49
BUDUDA,2016,610,470,1080,49
BUDUDA,2017,650,500,1150,49
BUDUDA,2018,700,550,1250,49
BUDUDA,2019,780,610,1390,49
BUDUDA,2020,830,670,1500,49
BUDUDA,2021,890,720,1610,49
BUDUDA,2022,920,750,1670,49
BUDUDA,2023,950,790,1740,49
BUDUDA,2024,960,810,1770,49
BUDUDA,2025,1000,850,1850,49
BUGIRI,2015,840,1030,1870,49
BUGIRI,2016,870,1040,1910,49
BUGIRI,2017,930,1120,2050,49
BUGIRI,2018,1010,1220,2230,49
BUGIRI,2019,1090,1350,2440,49
BUGIRI,2020,1170,1470,2640,49
BUGIRI,2021,1230,1550,2780,49
BUGIRI,2022,1290,1630,2920,49
BUGIRI,2023,1320,1690,3010,49
BUGIRI,2024,1340,1750,3090,49
BUGIRI,2025,1380,1820,3200,49
BUGWERI,2015,350,450,800,49
BUGWERI,2016,360,450,810,49
BUGWERI,2017,380,480,860,49
BUGWERI,2018,410,510,920,49
BUGWERI,2019,430,560,990,49
BUGWERI,2020,460,600,1060,49
BUGWERI,2021,480,630,1110,49
BUGWERI,2022,500,650,1150,49
BUGWERI,2023,500,670,1170,49
BUGWERI,2024,500,680,1180,49
BUGWERI,2025,510,700,1210,49
BUHWEJU,2015,250,250,500,49
BUHWEJU,2016,260,260,520,49
BUHWEJU,2017,270,260,530,49
BUHWEJU,2018,280,270,550,49
BUHWEJU,2019,280,280,560,49
BUHWEJU,2020,290,290,580,49
BUHWEJU,2021,300,300,600,49
BUHWEJU,2022,310,300,610,49
BUHWEJU,2023,320,310,630,49
BUHWEJU,2024,330,320,650,49
BUHWEJU,2025,340,330,670,49
BUIKWE,2015,920,980,1900,49
BUIKWE,2016,940,980,1920,49
BUIKWE,2017,980,1040,2020,49
BUIKWE,2018,1050,1110,2160,49
BUIKWE,2019,1110,1200,2310,49
BUIKWE,2020,1170,1280,2450,49
BUIKWE,2021,1200,1330,2530,49
BUIKWE,2022,1230,1380,2610,49
BUIKWE,2023,1230,1390,2620,49
BUIKWE,2024,1240,1420,2660,49
BUIKWE,2025,1250,1450,2700,49
BUKEDEA,2015,510,590,1100,49
BUKEDEA,2016,530,600,1130,49
BUKEDEA,2017,570,650,1220,49
BUKEDEA,2018,620,710,1330,49
BUKEDEA,2019,670,780,1450,49
BUKEDEA,2020,730,850,1580,49
BUKEDEA,2021,770,910,1680,49
BUKEDEA,2022,800,950,1750,49
BUKEDEA,2023,830,990,1820,49
BUKEDEA,2024,850,1020,1870,49
BUKEDEA,2025,870,1070,1940,49
BUKOMANSIMBI,2015,390,390,780,49
BUKOMANSIMBI,2016,390,380,770,49
BUKOMANSIMBI,2017,410,390,800,49
BUKOMANSIMBI,2018,430,420,850,49
BUKOMANSIMBI,2019,450,450,900,49
BUKOMANSIMBI,2020,460,470,930,49
BUKOMANSIMBI,2021,480,480,960,49
BUKOMANSIMBI,2022,480,490,970,49
BUKOMANSIMBI,2023,470,490,960,49
BUKOMANSIMBI,2024,470,490,960,49
BUKOMANSIMBI,2025,460,490,950,49
BUKWO,2015,200,200,400,49
BUKWO,2016,210,210,420,49
BUKWO,2017,220,220,440,49
BUKWO,2018,240,230,470,49
BUKWO,2019,250,250,500,49
BUKWO,2020,260,260,520,49
BUKWO,2021,270,270,540,49
BUKWO,2022,290,280,570,49
BUKWO,2023,300,300,600,49
BUKWO,2024,320,310,630,49
BUKWO,2025,330,320,650,49
BULAMBULI,2015,540,590,1130,49
BULAMBULI,2016,570,600,1170,49
BULAMBULI,2017,610,660,1270,49
BULAMBULI,2018,670,730,1400,49
BULAMBULI,2019,730,800,1530,49
BULAMBULI,2020,790,880,1670,49
BULAMBULI,2021,840,950,1790,49
BULAMBULI,2022,890,1010,1900,49
BULAMBULI,2023,900,1050,1950,49
BULAMBULI,2024,940,1100,2040,49
BULAMBULI,2025,970,1160,2130,49
BULIISA,2015,210,220,430,49
BULIISA,2016,220,230,450,49
BULIISA,2017,230,240,470,49
BULIISA,2018,250,250,500,49
BULIISA,2019,260,260,520,49
BULIISA,2020,270,270,540,49
BULIISA,2021,290,280,570,49
BULIISA,2022,300,300,600,49
BULIISA,2023,320,310,630,49
BULIISA,2024,330,320,650,49
BULIISA,2025,350,330,680,49
BUNDIBUGYO,2015,390,450,840,49
BUNDIBUGYO,2016,400,450,850,49
BUNDIBUGYO,2017,420,480,900,49
BUNDIBUGYO,2018,450,510,960,49
BUNDIBUGYO,2019,490,560,1050,49
BUNDIBUGYO,2020,520,600,1120,49
BUNDIBUGYO,2021,540,640,1180,49
BUNDIBUGYO,2022,560,670,1230,49
BUNDIBUGYO,2023,560,680,1240,49
BUNDIBUGYO,2024,570,700,1270,49
BUNDIBUGYO,2025,580,720,1300,49
BUNYANGABU,2015,380,400,780,49
BUNYANGABU,2016,380,400,780,49
BUNYANGABU,2017,400,430,830,49
BUNYANGABU,2018,430,460,890,49
BUNYANGABU,2019,460,490,950,49
BUNYANGABU,2020,470,530,1000,49
BUNYANGABU,2021,500,560,1060,49
BUNYANGABU,2022,510,580,1090,49
BUNYANGABU,2023,520,580,1100,49
BUNYANGABU,2024,530,590,1120,49
BUNYANGABU,2025,520,610,1130,49
BUSHENYI,2015,470,540,1010,49
BUSHENYI,2016,480,550,1030,49
BUSHENYI,2017,490,550,1040,49
BUSHENYI,2018,490,560,1050,49
BUSHENYI,2019,500,560,1060,49
BUSHENYI,2020,500,560,1060,49
BUSHENYI,2021,510,570,1080,49
BUSHENYI,2022,510,570,1080,49
BUSHENYI,2023,520,570,1090,49
BUSHENYI,2024,520,580,1100,49
BUSHENYI,2025,520,580,1100,49
BUSIA,2015,740,800,1540,49
BUSIA,2016,760,810,1570,49
BUSIA,2017,790,850,1640,49
BUSIA,2018,850,930,1780,49
BUSIA,2019,920,1010,1930,49
BUSIA,2020,980,1080,2060,49
BUSIA,2021,1020,1140,2160,49
BUSIA,2022,1050,1180,2230,49
BUSIA,2023,1070,1210,2280,49
BUSIA,2024,1080,1240,2320,49
BUSIA,2025,1100,1280,2380,49
BUTALEJA,2015,660,650,1310,49
BUTALEJA,2016,690,660,1350,49
BUTALEJA,2017,730,710,1440,49
BUTALEJA,2018,780,770,1550,49
BUTALEJA,2019,850,840,1690,49
BUTALEJA,2020,920,910,1830,49
BUTALEJA,2021,960,970,1930,49
BUTALEJA,2022,990,1020,2010,49
BUTALEJA,2023,1010,1050,2060,49
BUTALEJA,2024,1040,1080,2120,49
BUTALEJA,2025,1060,1120,2180,49
BUTAMBALA,2015,180,250,430,49
BUTAMBALA,2016,180,250,430,49
BUTAMBALA,2017,190,260,450,49
BUTAMBALA,2018,210,270,480,49
BUTAMBALA,2019,220,300,520,49
BUTAMBALA,2020,220,310,530,49
BUTAMBALA,2021,230,320,550,49
BUTAMBALA,2022,230,330,560,49
BUTAMBALA,2023,240,330,570,49
BUTAMBALA,2024,230,340,570,49
BUTAMBALA,2025,230,340,570,49
BUTEBO,2015,290,290,580,49
BUTEBO,2016,280,280,560,49
BUTEBO,2017,290,290,580,49
BUTEBO,2018,320,310,630,49
BUTEBO,2019,330,340,670,49
BUTEBO,2020,340,360,700,49
BUTEBO,2021,360,370,730,49
BUTEBO,2022,360,380,740,49
BUTEBO,2023,360,390,750,49
BUTEBO,2024,370,390,760,49
BUTEBO,2025,360,390,750,49
BUVUMA,2015,240,180,420,49
BUVUMA,2016,250,190,440,49
BUVUMA,2017,270,200,470,49
BUVUMA,2018,280,220,500,49
BUVUMA,2019,300,230,530,49
BUVUMA,2020,320,250,570,49
BUVUMA,2021,340,260,600,49
BUVUMA,2022,360,280,640,49
BUVUMA,2023,380,300,680,49
BUVUMA,2024,400,310,710,49
BUVUMA,2025,420,330,750,49
BUYENDE,2015,660,710,1370,49
BUYENDE,2016,690,730,1420,49
BUYENDE,2017,730,780,1510,49
BUYENDE,2018,800,860,1660,49
BUYENDE,2019,880,950,1830,49
BUYENDE,2020,930,1040,1970,49
BUYENDE,2021,990,1110,2100,49
BUYENDE,2022,1040,1170,2210,49
BUYENDE,2023,1070,1210,2280,49
BUYENDE,2024,1100,1260,2360,49
BUYENDE,2025,1130,1330,2460,49
DOKOLO,2015,370,390,760,49
DOKOLO,2016,380,400,780,49
DOKOLO,2017,390,410,800,49
DOKOLO,2018,400,420,820,49
DOKOLO,2019,420,440,860,49
DOKOLO,2020,430,450,880,49
DOKOLO,2021,440,460,900,49
DOKOLO,2022,450,470,920,49
DOKOLO,2023,470,480,950,49
DOKOLO,2024,480,490,970,49
DOKOLO,2025,490,500,990,49
GOMBA,2015,470,370,840,49
GOMBA,2016,480,370,850,49
GOMBA,2017,490,390,880,49
GOMBA,2018,520,410,930,49
GOMBA,2019,560,440,1000,49
GOMBA,2020,580,470,1050,49
GOMBA,2021,600,480,1080,49
GOMBA,2022,600,490,1090,49
GOMBA,2023,610,500,1110,49
GOMBA,2024,610,500,1110,49
GOMBA,2025,610,510,1120,49
GULU,2015,400,460,860,49
GULU,2016,410,480,890,49
GULU,2017,430,490,920,49
GULU,2018,440,500,940,49
GULU,2019,450,520,970,49
GULU,2020,470,530,1000,49
GULU,2021,480,550,1030,49
GULU,2022,490,560,1050,49
GULU,2023,500,580,1080,49
GULU,2024,520,590,1110,49
GULU,2025,530,610,1140,49
HOIMA,2015,610,670,1280,49
HOIMA,2016,630,700,1330,49
HOIMA,2017,660,720,1380,49
HOIMA,2018,680,750,1430,49
HOIMA,2019,710,770,1480,49
HOIMA,2020,730,800,1530,49
HOIMA,2021,760,820,1580,49
HOIMA,2022,790,850,1640,49
HOIMA,2023,810,880,1690,49
HOIMA,2024,840,900,1740,49
HOIMA,2025,870,930,1800,49
IBANDA,2015,580,630,1210,49
IBANDA,2016,590,640,1230,49
IBANDA,2017,600,650,1250,49
IBANDA,2018,620,660,1280,49
IBANDA,2019,630,680,1310,49
IBANDA,2020,640,690,1330,49
IBANDA,2021,650,700,1350,49
IBANDA,2022,660,710,1370,49
IBANDA,2023,670,720,1390,49
IBANDA,2024,680,730,1410,49
IBANDA,2025,690,740,1430,49
IGANGA,2015,730,900,1630,49
IGANGA,2016,750,920,1670,49
IGANGA,2017,790,970,1760,49
IGANGA,2018,850,1050,1900,49
IGANGA,2019,920,1140,2060,49
IGANGA,2020,980,1240,2220,49
IGANGA,2021,1010,1300,2310,49
IGANGA,2022,1040,1350,2390,49
IGANGA,2023,1050,1380,2430,49
IGANGA,2024,1070,1420,2490,49
IGANGA,2025,1090,1460,2550,49
ISINGIRO,2015,970,1100,2070,49
ISINGIRO,2016,1010,1140,2150,49
ISINGIRO,2017,1050,1180,2230,49
ISINGIRO,2018,1090,1230,2320,49
ISINGIRO,2019,1130,1270,2400,49
ISINGIRO,2020,1170,1310,2480,49
ISINGIRO,2021,1210,1350,2560,49
ISINGIRO,2022,1250,1400,2650,49
ISINGIRO,2023,1290,1440,2730,49
ISINGIRO,2024,1330,1490,2820,49
ISINGIRO,2025,1380,1530,2910,49
JINJA,2015,990,1070,2060,49
JINJA,2016,1010,1080,2090,49
JINJA,2017,1030,1100,2130,49
JINJA,2018,1050,1120,2170,49
JINJA,2019,1060,1130,2190,49
JINJA,2020,1080,1150,2230,49
JINJA,2021,1090,1160,2250,49
JINJA,2022,1110,1180,2290,49
JINJA,2023,1120,1190,2310,49
JINJA,2024,1140,1210,2350,49
JINJA,2025,1150,1220,2370,49
KAABONG,2015,220,290,510,49
KAABONG,2016,220,300,520,49
KAABONG,2017,230,310,540,49
KAABONG,2018,240,320,560,49
KAABONG,2019,240,320,560,49
KAABONG,2020,250,330,580,49
KAABONG,2021,260,340,600,49
KAABONG,2022,260,350,610,49
KAABONG,2023,270,350,620,49
KAABONG,2024,270,360,630,49
KAABONG,2025,280,370,650,49
KABALE,2015,440,680,1120,49
KABALE,2016,450,680,1130,49
KABALE,2017,460,690,1150,49
KABALE,2018,460,700,1160,49
KABALE,2019,470,710,1180,49
KABALE,2020,480,720,1200,49
KABALE,2021,480,720,1200,49
KABALE,2022,490,730,1220,49
KABALE,2023,500,740,1240,49
KABALE,2024,500,740,1240,49
KABALE,2025,510,750,1260,49
KABAROLE,2015,560,590,1150,49
KABAROLE,2016,570,600,1170,49
KABAROLE,2017,580,610,1190,49
KABAROLE,2018,600,630,1230,49
KABAROLE,2019,610,640,1250,49
KABAROLE,2020,620,650,1270,49
KABAROLE,2021,630,670,1300,49
KABAROLE,2022,650,680,1330,49
KABAROLE,2023,660,690,1350,49
KABAROLE,2024,670,700,1370,49
KABAROLE,2025,680,720,1400,49
KABERAMAIDO,2015,260,280,540,49
KABERAMAIDO,2016,270,270,540,49
KABERAMAIDO,2017,290,290,580,49
KABERAMAIDO,2018,320,320,640,49
KABERAMAIDO,2019,340,350,690,49
KABERAMAIDO,2020,370,380,750,49
KABERAMAIDO,2021,390,410,800,49
KABERAMAIDO,2022,410,430,840,49
KABERAMAIDO,2023,420,440,860,49
KABERAMAIDO,2024,420,470,890,49
KABERAMAIDO,2025,440,490,930,49
KAGADI,2015,590,730,1320,49
KAGADI,2016,610,760,1370,49
KAGADI,2017,630,780,1410,49
KAGADI,2018,660,810,1470,49
KAGADI,2019,680,840,1520,49
KAGADI,2020,700,870,1570,49
KAGADI,2021,730,890,1620,49
KAGADI,2022,750,920,1670,49
KAGADI,2023,780,950,1730,49
KAGADI,2024,800,980,1780,49
KAGADI,2025,830,1010,1840,49
KAKUMIRO,2015,600,590,1190,49
KAKUMIRO,2016,650,640,1290,49
KAKUMIRO,2017,710,690,1400,49
KAKUMIRO,2018,770,750,1520,49
KAKUMIRO,2019,840,810,1650,49
KAKUMIRO,2020,910,880,1790,49
KAKUMIRO,2021,990,950,1940,49
KAKUMIRO,2022,1070,1030,2100,49
KAKUMIRO,2023,1160,1110,2270,49
KAKUMIRO,2024,1260,1200,2460,49
KAKUMIRO,2025,1360,1290,2650,49
KALAKI,2015,230,230,460,49
KALAKI,2016,240,240,480,49
KALAKI,2017,260,250,510,49
KALAKI,2018,270,260,530,49
KALAKI,2019,280,270,550,49
KALAKI,2020,290,280,570,49
KALAKI,2021,300,300,600,49
KALAKI,2022,310,310,620,49
KALAKI,2023,320,320,640,49
KALAKI,2024,340,330,670,49
KALAKI,2025,350,340,690,49
KALANGALA,2015,210,110,320,49
KALANGALA,2016,220,110,330,49
KALANGALA,2017,220,120,340,49
KALANGALA,2018,230,120,350,49
KALANGALA,2019,240,120,360,49
KALANGALA,2020,250,130,380,49
KALANGALA,2021,260,130,390,49
KALANGALA,2022,260,140,400,49
KALANGALA,2023,270,150,420,49
KALANGALA,2024,280,150,430,49
KALANGALA,2025,290,160,450,49
KALIRO,2015,560,580,1140,49
KALIRO,2016,580,580,1160,49
KALIRO,2017,610,620,1230,49
KALIRO,2018,660,680,1340,49
KALIRO,2019,720,740,1460,49
KALIRO,2020,760,800,1560,49
KALIRO,2021,800,850,1650,49
KALIRO,2022,830,890,1720,49
KALIRO,2023,840,920,1760,49
KALIRO,2024,850,950,1800,49
KALIRO,2025,870,980,1850,49
KALUNGU,2015,440,520,960,49
KALUNGU,2016,440,520,960,49
KALUNGU,2017,450,540,990,49
KALUNGU,2018,480,570,1050,49
KALUNGU,2019,500,610,1110,49
KALUNGU,2020,520,640,1160,49
KALUNGU,2021,540,670,1210,49
KALUNGU,2022,540,680,1220,49
KALUNGU,2023,530,680,1210,49
KALUNGU,2024,540,680,1220,49
KALUNGU,2025,540,700,1240,49
KAMPALA,2015,2650,2550,5200,49
KAMPALA,2016,2700,2600,5300,49
KAMPALA,2017,2760,2650,5410,49
KAMPALA,2018,2810,2700,5510,49
KAMPALA,2019,2860,2760,5620,49
KAMPALA,2020,2910,2800,5710,49
KAMPALA,2021,2960,2850,5810,49
KAMPALA,2022,3010,2900,5910,49
KAMPALA,2023,3060,2950,6010,49
KAMPALA,2024,3110,2990,6100,49
KAMPALA,2025,3150,3040,6190,49
KAMULI,2015,1130,1270,2400,49
KAMULI,2016,1160,1270,2430,49
KAMULI,2017,1220,1340,2560,49
KAMULI,2018,1310,1440,2750,49
KAMULI,2019,1390,1550,2940,49
KAMULI,2020,1480,1660,3140,49
KAMULI,2021,1540,1740,3280,49
KAMULI,2022,1580,1810,3390,49
KAMULI,2023,1590,1840,3430,49
KAMULI,2024,1590,1870,3460,49
KAMULI,2025,1620,1910,3530,49
KAMWENGE,2015,510,560,1070,49
KAMWENGE,2016,530,590,1120,49
KAMWENGE,2017,560,610,1170,49
KAMWENGE,2018,580,630,1210,49
KAMWENGE,2019,600,650,1250,49
KAMWENGE,2020,620,670,1290,49
KAMWENGE,2021,650,690,1340,49
KAMWENGE,2022,670,720,1390,49
KAMWENGE,2023,700,740,1440,49
KAMWENGE,2024,720,760,1480,49
KAMWENGE,2025,750,790,1540,49
KANUNGU,2015,480,670,1150,49
KANUNGU,2016,490,680,1170,49
KANUNGU,2017,500,690,1190,49
KANUNGU,2018,510,700,1210,49
KANUNGU,2019,520,710,1230,49
KANUNGU,2020,530,720,1250,49
KANUNGU,2021,530,730,1260,49
KANUNGU,2022,540,740,1280,49
KANUNGU,2023,550,750,1300,49
KANUNGU,2024,560,760,1320,49
KANUNGU,2025,570,770,1340,49
KAPCHORWA,2015,260,290,550,49
KAPCHORWA,2016,270,300,570,49
KAPCHORWA,2017,280,300,580,49
KAPCHORWA,2018,280,310,590,49
KAPCHORWA,2019,290,320,610,49
KAPCHORWA,2020,300,330,630,49
KAPCHORWA,2021,310,340,650,49
KAPCHORWA,2022,320,350,670,49
KAPCHORWA,2023,330,350,680,49
KAPCHORWA,2024,330,360,690,49
KAPCHORWA,2025,340,370,710,49
KAPELEBYONG,2015,210,180,390,49
KAPELEBYONG,2016,220,180,400,49
KAPELEBYONG,2017,230,190,420,49
KAPELEBYONG,2018,250,210,460,49
KAPELEBYONG,2019,260,230,490,49
KAPELEBYONG,2020,280,240,520,49
KAPELEBYONG,2021,300,260,560,49
KAPELEBYONG,2022,300,270,570,49
KAPELEBYONG,2023,310,270,580,49
KAPELEBYONG,2024,310,280,590,49
KAPELEBYONG,2025,320,280,600,49
KASESE,2015,1350,1410,2760,49
KASESE,2016,1380,1420,2800,49
KASESE,2017,1460,1500,2960,49
KASESE,2018,1540,1610,3150,49
KASESE,2019,1650,1740,3390,49
KASESE,2020,1750,1850,3600,49
KASESE,2021,1820,1950,3770,49
KASESE,2022,1850,2010,3860,49
KASESE,2023,1870,2040,3910,49
KASESE,2024,1890,2090,3980,49
KASESE,2025,1900,2130,4030,49
KASSANDA,2015,550,560,1110,49
KASSANDA,2016,570,570,1140,49
KASSANDA,2017,590,580,1170,49
KASSANDA,2018,600,590,1190,49
KASSANDA,2019,620,610,1230,49
KASSANDA,2020,640,620,1260,49
KASSANDA,2021,650,630,1280,49
KASSANDA,2022,670,640,1310,49
KASSANDA,2023,690,650,1340,49
KASSANDA,2024,700,670,1370,49
KASSANDA,2025,720,680,1400,49
KATAKWI,2015,380,370,750,49
KATAKWI,2016,390,380,770,49
KATAKWI,2017,410,400,810,49
KATAKWI,2018,440,440,880,49
KATAKWI,2019,470,460,930,49
KATAKWI,2020,500,500,1000,49
KATAKWI,2021,530,530,1060,49
KATAKWI,2022,540,550,1090,49
KATAKWI,2023,550,560,1110,49
KATAKWI,2024,560,560,1120,49
KATAKWI,2025,570,580,1150,49
KAYUNGA,2015,880,930,1810,49
KAYUNGA,2016,910,940,1850,49
KAYUNGA,2017,940,970,1910,49
KAYUNGA,2018,1010,1040,2050,49
KAYUNGA,2019,1060,1120,2180,49
KAYUNGA,2020,1130,1190,2320,49
KAYUNGA,2021,1160,1240,2400,49
KAYUNGA,2022,1170,1270,2440,49
KAYUNGA,2023,1190,1290,2480,49
KAYUNGA,2024,1180,1300,2480,49
KAYUNGA,2025,1190,1330,2520,49
KAZO,2015,420,450,870,49
KAZO,2016,440,470,910,49
KAZO,2017,450,490,940,49
KAZO,2018,470,500,970,49
KAZO,2019,490,520,1010,49
KAZO,2020,510,540,1050,49
KAZO,2021,520,560,1080,49
KAZO,2022,540,570,1110,49
KAZO,2023,560,590,1150,49
KAZO,2024,580,610,1190,49
KAZO,2025,600,630,1230,49
KIBAALE,2015,280,310,590,49
KIBAALE,2016,290,330,620,49
KIBAALE,2017,310,350,660,49
KIBAALE,2018,330,370,700,49
KIBAALE,2019,350,390,740,49
KIBAALE,2020,380,410,790,49
KIBAALE,2021,400,440,840,49
KIBAALE,2022,420,460,880,49
KIBAALE,2023,450,490,940,49
KIBAALE,2024,480,510,990,49
KIBAALE,2025,500,540,1040,49
KIBOGA,2015,370,320,690,49
KIBOGA,2016,370,310,680,49
KIBOGA,2017,380,310,690,49
KIBOGA,2018,400,330,730,49
KIBOGA,2019,420,360,780,49
KIBOGA,2020,460,390,850,49
KIBOGA,2021,490,420,910,49
KIBOGA,2022,500,440,940,49
KIBOGA,2023,520,450,970,49
KIBOGA,2024,520,460,980,49
KIBOGA,2025,530,470,1000,49
KIBUKU,2015,520,510,1030,49
KIBUKU,2016,530,510,1040,49
KIBUKU,2017,570,550,1120,49
KIBUKU,2018,610,600,1210,49
KIBUKU,2019,660,650,1310,49
KIBUKU,2020,710,710,1420,49
KIBUKU,2021,750,760,1510,49
KIBUKU,2022,780,800,1580,49
KIBUKU,2023,790,810,1600,49
KIBUKU,2024,800,840,1640,49
KIBUKU,2025,830,880,1710,49
KIKUUBE,2015,560,540,1100,49
KIKUUBE,2016,590,570,1160,49
KIKUUBE,2017,630,600,1230,49
KIKUUBE,2018,660,630,1290,49
KIKUUBE,2019,690,660,1350,49
KIKUUBE,2020,730,700,1430,49
KIKUUBE,2021,770,730,1500,49
KIKUUBE,2022,810,770,1580,49
KIKUUBE,2023,850,800,1650,49
KIKUUBE,2024,890,840,1730,49
KIKUUBE,2025,930,880,1810,49
KIRUHURA,2015,370,340,710,49
KIRUHURA,2016,380,360,740,49
KIRUHURA,2017,400,370,770,49
KIRUHURA,2018,410,380,790,49
KIRUHURA,2019,430,390,820,49
KIRUHURA,2020,440,410,850,49
KIRUHURA,2021,460,420,880,49
KIRUHURA,2022,470,440,910,49
KIRUHURA,2023,490,450,940,49
KIRUHURA,2024,510,460,970,49
KIRUHURA,2025,520,480,1000,49
KIRYANDONGO,2015,600,620,1220,49
KIRYANDONGO,2016,610,620,1230,49
KIRYANDONGO,2017,650,660,1310,49
KIRYANDONGO,2018,690,710,1400,49
KIRYANDONGO,2019,750,780,1530,49
KIRYANDONGO,2020,790,820,1610,49
KIRYANDONGO,2021,830,860,1690,49
KIRYANDONGO,2022,840,900,1740,49
KIRYANDONGO,2023,860,920,1780,49
KIRYANDONGO,2024,860,950,1810,49
KIRYANDONGO,2025,880,970,1850,49
KISORO,2015,520,810,1330,49
KISORO,2016,530,820,1350,49
KISORO,2017,560,850,1410,49
KISORO,2018,590,910,1500,49
KISORO,2019,630,990,1620,49
KISORO,2020,650,1050,1700,49
KISORO,2021,680,1100,1780,49
KISORO,2022,690,1140,1830,49
KISORO,2023,700,1160,1860,49
KISORO,2024,700,1170,1870,49
KISORO,2025,700,1190,1890,49
KITAGWENDA,2015,280,350,630,49
KITAGWENDA,2016,290,360,650,49
KITAGWENDA,2017,300,370,670,49
KITAGWENDA,2018,310,380,690,49
KITAGWENDA,2019,320,400,720,49
KITAGWENDA,2020,340,410,750,49
KITAGWENDA,2021,350,430,780,49
KITAGWENDA,2022,360,440,800,49
KITAGWENDA,2023,380,450,830,49
KITAGWENDA,2024,390,470,860,49
KITAGWENDA,2025,400,480,880,49
KITGUM,2015,400,490,890,49
KITGUM,2016,400,500,900,49
KITGUM,2017,420,520,940,49
KITGUM,2018,450,550,1000,49
KITGUM,2019,470,600,1070,49
KITGUM,2020,500,640,1140,49
KITGUM,2021,510,660,1170,49
KITGUM,2022,530,680,1210,49
KITGUM,2023,520,680,1200,49
KITGUM,2024,510,700,1210,49
KITGUM,2025,520,720,1240,49
KOBOKO,2015,450,400,850,49
KOBOKO,2016,470,400,870,49
KOBOKO,2017,500,430,930,49
KOBOKO,2018,540,480,1020,49
KOBOKO,2019,590,520,1110,49
KOBOKO,2020,620,570,1190,49
KOBOKO,2021,660,600,1260,49
KOBOKO,2022,690,620,1310,49
KOBOKO,2023,700,650,1350,49
KOBOKO,2024,720,670,1390,49
KOBOKO,2025,740,700,1440,49
KOLE,2015,430,450,880,49
KOLE,2016,450,460,910,49
KOLE,2017,460,480,940,49
KOLE,2018,480,490,970,49
KOLE,2019,490,500,990,49
KOLE,2020,510,520,1030,49
KOLE,2021,520,530,1050,49
KOLE,2022,540,540,1080,49
KOLE,2023,550,560,1110,49
KOLE,2024,570,570,1140,49
KOLE,2025,580,580,1160,49
KOTIDO,2015,510,570,1080,49
KOTIDO,2016,520,570,1090,49
KOTIDO,2017,540,600,1140,49
KOTIDO,2018,580,640,1220,49
KOTIDO,2019,620,690,1310,49
KOTIDO,2020,650,740,1390,49
KOTIDO,2021,680,790,1470,49
KOTIDO,2022,690,810,1500,49
KOTIDO,2023,700,830,1530,49
KOTIDO,2024,700,840,1540,49
KOTIDO,2025,710,850,1560,49
KUMI,2015,560,640,1200,49
KUMI,2016,570,650,1220,49
KUMI,2017,610,680,1290,49
KUMI,2018,650,750,1400,49
KUMI,2019,700,820,1520,49
KUMI,2020,740,870,1610,49
KUMI,2021,780,920,1700,49
KUMI,2022,810,960,1770,49
KUMI,2023,820,980,1800,49
KUMI,2024,830,1010,1840,49
KUMI,2025,840,1030,1870,49
KWANIA,2015,320,330,650,49
KWANIA,2016,330,340,670,49
KWANIA,2017,340,350,690,49
KWANIA,2018,350,360,710,49
KWANIA,2019,360,370,730,49
KWANIA,2020,370,380,750,49
KWANIA,2021,380,390,770,49
KWANIA,2022,400,400,800,49
KWANIA,2023,410,410,820,49
KWANIA,2024,420,420,840,49
KWANIA,2025,430,430,860,49
KWEEN,2015,200,240,440,49
KWEEN,2016,210,240,450,49
KWEEN,2017,220,250,470,49
KWEEN,2018,220,260,480,49
KWEEN,2019,230,260,490,49
KWEEN,2020,240,270,510,49
KWEEN,2021,240,270,510,49
KWEEN,2022,250,280,530,49
KWEEN,2023,260,290,550,49
KWEEN,2024,260,290,550,49
KWEEN,2025,270,300,570,49
KYANKWANZI,2015,440,380,820,49
KYANKWANZI,2016,460,400,860,49
KYANKWANZI,2017,490,420,910,49
KYANKWANZI,2018,510,440,950,49
KYANKWANZI,2019,540,460,1000,49
KYANKWANZI,2020,570,480,1050,49
KYANKWANZI,2021,590,500,1090,49
KYANKWANZI,2022,620,520,1140,49
KYANKWANZI,2023,650,540,1190,49
KYANKWANZI,2024,680,570,1250,49
KYANKWANZI,2025,710,590,1300,49
KYEGEGWA,2015,610,570,1180,49
KYEGEGWA,2016,660,610,1270,49
KYEGEGWA,2017,720,660,1380,49
KYEGEGWA,2018,780,710,1490,49
KYEGEGWA,2019,840,770,1610,49
KYEGEGWA,2020,910,830,1740,49
KYEGEGWA,2021,980,890,1870,49
KYEGEGWA,2022,1060,960,2020,49
KYEGEGWA,2023,1140,1030,2170,49
KYEGEGWA,2024,1230,1110,2340,49
KYEGEGWA,2025,1320,1190,2510,49
KYENJOJO,2015,710,820,1530,49
KYENJOJO,2016,740,850,1590,49
KYENJOJO,2017,770,890,1660,49
KYENJOJO,2018,800,920,1720,49
KYENJOJO,2019,830,950,1780,49
KYENJOJO,2020,860,980,1840,49
KYENJOJO,2021,900,1020,1920,49
KYENJOJO,2022,930,1050,1980,49
KYENJOJO,2023,960,1090,2050,49
KYENJOJO,2024,1000,1130,2130,49
KYENJOJO,2025,1040,1160,2200,49
KYOTERA,2015,610,520,1130,49
KYOTERA,2016,610,520,1130,49
KYOTERA,2017,640,540,1180,49
KYOTERA,2018,670,580,1250,49
KYOTERA,2019,720,610,1330,49
KYOTERA,2020,760,650,1410,49
KYOTERA,2021,770,670,1440,49
KYOTERA,2022,780,700,1480,49
KYOTERA,2023,790,700,1490,49
KYOTERA,2024,770,710,1480,49
KYOTERA,2025,780,720,1500,49
KARENGA,2015,140,140,280,49
KARENGA,2016,150,140,290,49
KARENGA,2017,150,150,300,49
KARENGA,2018,160,150,310,49
KARENGA,2019,160,150,310,49
KARENGA,2020,160,160,320,49
KARENGA,2021,170,160,330,49
KARENGA,2022,170,160,330,49
KARENGA,2023,180,170,350,49
KARENGA,2024,180,170,350,49
KARENGA,2025,180,170,350,49
LAMWO,2015,270,330,600,49
LAMWO,2016,270,330,600,49
LAMWO,2017,280,340,620,49
LAMWO,2018,290,360,650,49
LAMWO,2019,300,400,700,49
LAMWO,2020,330,410,740,49
LAMWO,2021,330,420,750,49
LAMWO,2022,330,440,770,49
LAMWO,2023,330,440,770,49
LAMWO,2024,320,440,760,49
LAMWO,2025,320,460,780,49
LIRA,2015,670,730,1400,49
LIRA,2016,690,750,1440,49
LIRA,2017,710,770,1480,49
LIRA,2018,730,790,1520,49
LIRA,2019,750,810,1560,49
LIRA,2020,770,840,1610,49
LIRA,2021,780,860,1640,49
LIRA,2022,800,880,1680,49
LIRA,2023,820,900,1720,49
LIRA,2024,840,920,1760,49
LIRA,2025,860,950,1810,49
LUUKA,2015,570,640,1210,49
LUUKA,2016,570,640,1210,49
LUUKA,2017,600,670,1270,49
LUUKA,2018,630,730,1360,49
LUUKA,2019,670,790,1460,49
LUUKA,2020,710,840,1550,49
LUUKA,2021,740,880,1620,49
LUUKA,2022,750,900,1650,49
LUUKA,2023,760,920,1680,49
LUUKA,2024,760,930,1690,49
LUUKA,2025,770,950,1720,49
LUWERO,2015,1090,1170,2260,49
LUWERO,2016,1110,1170,2280,49
LUWERO,2017,1170,1240,2410,49
LUWERO,2018,1240,1340,2580,49
LUWERO,2019,1340,1440,2780,49
LUWERO,2020,1410,1540,2950,49
LUWERO,2021,1460,1630,3090,49
LUWERO,2022,1490,1670,3160,49
LUWERO,2023,1510,1700,3210,49
LUWERO,2024,1520,1730,3250,49
LUWERO,2025,1540,1770,3310,49
LWENGO,2015,580,760,1340,49
LWENGO,2016,600,750,1350,49
LWENGO,2017,610,780,1390,49
LWENGO,2018,650,820,1470,49
LWENGO,2019,670,890,1560,49
LWENGO,2020,710,920,1630,49
LWENGO,2021,720,970,1690,49
LWENGO,2022,740,980,1720,49
LWENGO,2023,730,990,1720,49
LWENGO,2024,720,990,1710,49
LWENGO,2025,730,1000,1730,49
LYANTONDE,2015,230,190,420,49
LYANTONDE,2016,230,190,420,49
LYANTONDE,2017,250,190,440,49
LYANTONDE,2018,260,220,480,49
LYANTONDE,2019,290,230,520,49
LYANTONDE,2020,300,260,560,49
LYANTONDE,2021,320,260,580,49
LYANTONDE,2022,330,280,610,49
LYANTONDE,2023,330,280,610,49
LYANTONDE,2024,340,300,640,49
LYANTONDE,2025,330,300,630,49
MANAFWA,2015,380,400,780,49
MANAFWA,2016,390,410,800,49
MANAFWA,2017,400,420,820,49
MANAFWA,2018,410,430,840,49
MANAFWA,2019,420,440,860,49
MANAFWA,2020,430,450,880,49
MANAFWA,2021,440,460,900,49
MANAFWA,2022,450,470,920,49
MANAFWA,2023,460,480,940,49
MANAFWA,2024,470,480,950,49
MANAFWA,2025,470,490,960,49
MARACHA,2015,360,490,850,49
MARACHA,2016,360,500,860,49
MARACHA,2017,370,510,880,49
MARACHA,2018,380,520,900,49
MARACHA,2019,390,530,920,49
MARACHA,2020,390,530,920,49
MARACHA,2021,400,540,940,49
MARACHA,2022,410,550,960,49
MARACHA,2023,420,560,980,49
MARACHA,2024,420,570,990,49
MARACHA,2025,430,580,1010,49
MASAKA,2015,610,750,1360,49
MASAKA,2016,600,710,1310,49
MASAKA,2017,600,690,1290,49
MASAKA,2018,610,690,1300,49
MASAKA,2019,660,730,1390,49
MASAKA,2020,700,790,1490,49
MASAKA,2021,740,860,1600,49
MASAKA,2022,780,910,1690,49
MASAKA,2023,810,950,1760,49
MASAKA,2024,820,980,1800,49
MASAKA,2025,830,1000,1830,49
MASINDI,2015,600,620,1220,49
MASINDI,2016,620,630,1250,49
MASINDI,2017,640,650,1290,49
MASINDI,2018,660,670,1330,49
MASINDI,2019,670,690,1360,49
MASINDI,2020,690,700,1390,49
MASINDI,2021,710,720,1430,49
MASINDI,2022,730,740,1470,49
MASINDI,2023,750,750,1500,49
MASINDI,2024,770,770,1540,49
MASINDI,2025,790,790,1580,49
MAYUGE,2015,1040,1240,2280,49
MAYUGE,2016,1070,1260,2330,49
MAYUGE,2017,1130,1330,2460,49
MAYUGE,2018,1210,1450,2660,49
MAYUGE,2019,1310,1580,2890,49
MAYUGE,2020,1390,1690,3080,49
MAYUGE,2021,1450,1800,3250,49
MAYUGE,2022,1490,1870,3360,49
MAYUGE,2023,1510,1930,3440,49
MAYUGE,2024,1530,1970,3500,49
MAYUGE,2025,1570,2040,3610,49
MBALE,2015,1280,1290,2570,49
MBALE,2016,1320,1310,2630,49
MBALE,2017,1390,1400,2790,49
MBALE,2018,1500,1520,3020,49
MBALE,2019,1610,1660,3270,49
MBALE,2020,1700,1790,3490,49
MBALE,2021,1790,1900,3690,49
MBALE,2022,1830,1980,3810,49
MBALE,2023,1850,2040,3890,49
MBALE,2024,1890,2100,3990,49
MBALE,2025,1910,2180,4090,49
MBARARA,2015,650,720,1370,49
MBARARA,2016,670,730,1400,49
MBARARA,2017,680,750,1430,49
MBARARA,2018,700,770,1470,49
MBARARA,2019,710,780,1490,49
MBARARA,2020,730,800,1530,49
MBARARA,2021,740,810,1550,49
MBARARA,2022,760,830,1590,49
MBARARA,2023,770,840,1610,49
MBARARA,2024,790,860,1650,49
MBARARA,2025,800,870,1670,49
MITOOMA,2015,340,500,840,49
MITOOMA,2016,340,500,840,49
MITOOMA,2017,340,510,850,49
MITOOMA,2018,350,510,860,49
MITOOMA,2019,350,520,870,49
MITOOMA,2020,350,520,870,49
MITOOMA,2021,360,520,880,49
MITOOMA,2022,360,530,890,49
MITOOMA,2023,360,530,890,49
MITOOMA,2024,370,530,900,49
MITOOMA,2025,370,540,910,49
MITYANA,2015,750,820,1570,49
MITYANA,2016,760,820,1580,49
MITYANA,2017,790,850,1640,49
MITYANA,2018,840,910,1750,49
MITYANA,2019,890,980,1870,49
MITYANA,2020,950,1040,1990,49
MITYANA,2021,980,1080,2060,49
MITYANA,2022,990,1110,2100,49
MITYANA,2023,990,1130,2120,49
MITYANA,2024,990,1140,2130,49
MITYANA,2025,1000,1160,2160,49
MOROTO,2015,250,250,500,49
MOROTO,2016,250,260,510,49
MOROTO,2017,260,280,540,49
MOROTO,2018,280,300,580,49
MOROTO,2019,290,330,620,49
MOROTO,2020,310,340,650,49
MOROTO,2021,320,370,690,49
MOROTO,2022,330,370,700,49
MOROTO,2023,330,390,720,49
MOROTO,2024,340,390,730,49
MOROTO,2025,330,400,730,49
MOYO,2015,250,300,550,49
MOYO,2016,260,300,560,49
MOYO,2017,270,310,580,49
MOYO,2018,270,320,590,49
MOYO,2019,280,320,600,49
MOYO,2020,290,330,620,49
MOYO,2021,290,340,630,49
MOYO,2022,300,340,640,49
MOYO,2023,310,350,660,49
MOYO,2024,310,360,670,49
MOYO,2025,320,360,680,49
MPIGI,2015,570,630,1200,49
MPIGI,2016,580,640,1220,49
MPIGI,2017,610,670,1280,49
MPIGI,2018,650,720,1370,49
MPIGI,2019,690,780,1470,49
MPIGI,2020,740,820,1560,49
MPIGI,2021,770,880,1650,49
MPIGI,2022,780,900,1680,49
MPIGI,2023,790,920,1710,49
MPIGI,2024,790,930,1720,49
MPIGI,2025,800,950,1750,49
MUBENDE,2015,1010,920,1930,49
MUBENDE,2016,1060,950,2010,49
MUBENDE,2017,1150,1020,2170,49
MUBENDE,2018,1250,1140,2390,49
MUBENDE,2019,1380,1270,2650,49
MUBENDE,2020,1500,1390,2890,49
MUBENDE,2021,1600,1510,3110,49
MUBENDE,2022,1680,1580,3260,49
MUBENDE,2023,1730,1670,3400,49
MUBENDE,2024,1800,1750,3550,49
MUBENDE,2025,1870,1830,3700,49
MUKONO,2015,1350,1410,2760,49
MUKONO,2016,1380,1420,2800,49
MUKONO,2017,1460,1510,2970,49
MUKONO,2018,1560,1630,3190,49
MUKONO,2019,1670,1780,3450,49
MUKONO,2020,1780,1920,3700,49
MUKONO,2021,1850,2020,3870,49
MUKONO,2022,1890,2100,3990,49
MUKONO,2023,1910,2160,4070,49
MUKONO,2024,1930,2210,4140,49
MUKONO,2025,1960,2280,4240,49
MADI OKOLLO,2015,270,330,600,49
MADI OKOLLO,2016,280,340,620,49
MADI OKOLLO,2017,280,350,630,49
MADI OKOLLO,2018,290,360,650,49
MADI OKOLLO,2019,300,370,670,49
MADI OKOLLO,2020,310,380,690,49
MADI OKOLLO,2021,320,390,710,49
MADI OKOLLO,2022,320,400,720,49
MADI OKOLLO,2023,330,410,740,49
MADI OKOLLO,2024,340,420,760,49
MADI OKOLLO,2025,350,430,780,49
NABILATUK,2015,140,170,310,49
NABILATUK,2016,160,180,340,49
NABILATUK,2017,170,190,360,49
NABILATUK,2018,180,210,390,49
NABILATUK,2019,200,230,430,49
NABILATUK,2020,220,260,480,49
NABILATUK,2021,230,280,510,49
NABILATUK,2022,240,280,520,49
NABILATUK,2023,250,300,550,49
NABILATUK,2024,260,310,570,49
NABILATUK,2025,260,330,590,49
NAKAPIRIPIRIT,2015,190,180,370,49
NAKAPIRIPIRIT,2016,210,190,400,49
NAKAPIRIPIRIT,2017,230,190,420,49
NAKAPIRIPIRIT,2018,250,220,470,49
NAKAPIRIPIRIT,2019,260,250,510,49
NAKAPIRIPIRIT,2020,280,260,540,49
NAKAPIRIPIRIT,2021,300,280,580,49
NAKAPIRIPIRIT,2022,320,300,620,49
NAKAPIRIPIRIT,2023,330,310,640,49
NAKAPIRIPIRIT,2024,340,330,670,49
NAKAPIRIPIRIT,2025,350,330,680,49
NAKASEKE,2015,420,380,800,49
NAKASEKE,2016,430,390,820,49
NAKASEKE,2017,450,400,850,49
NAKASEKE,2018,470,410,880,49
NAKASEKE,2019,480,420,900,49
NAKASEKE,2020,500,430,930,49
NAKASEKE,2021,520,440,960,49
NAKASEKE,2022,530,450,980,49
NAKASEKE,2023,550,450,1000,49
NAKASEKE,2024,570,460,1030,49
NAKASEKE,2025,590,470,1060,49
NAKASONGOLA,2015,430,430,860,49
NAKASONGOLA,2016,440,440,880,49
NAKASONGOLA,2017,460,460,920,49
NAKASONGOLA,2018,500,500,1000,49
NAKASONGOLA,2019,530,540,1070,49
NAKASONGOLA,2020,560,580,1140,49
NAKASONGOLA,2021,600,620,1220,49
NAKASONGOLA,2022,620,640,1260,49
NAKASONGOLA,2023,620,650,1270,49
NAKASONGOLA,2024,630,670,1300,49
NAKASONGOLA,2025,640,690,1330,49
NAMAYINGO,2015,470,520,990,49
NAMAYINGO,2016,480,520,1000,49
NAMAYINGO,2017,500,540,1040,49
NAMAYINGO,2018,520,580,1100,49
NAMAYINGO,2019,560,610,1170,49
NAMAYINGO,2020,590,650,1240,49
NAMAYINGO,2021,620,690,1310,49
NAMAYINGO,2022,620,700,1320,49
NAMAYINGO,2023,620,710,1330,49
NAMAYINGO,2024,630,710,1340,49
NAMAYINGO,2025,620,730,1350,49
NAMISINDWA,2015,400,460,860,49
NAMISINDWA,2016,420,470,890,49
NAMISINDWA,2017,430,490,920,49
NAMISINDWA,2018,440,500,940,49
NAMISINDWA,2019,450,510,960,49
NAMISINDWA,2020,460,520,980,49
NAMISINDWA,2021,470,530,1000,49
NAMISINDWA,2022,490,540,1030,49
NAMISINDWA,2023,500,550,1050,49
NAMISINDWA,2024,510,560,1070,49
NAMISINDWA,2025,520,570,1090,49
NAMUTUMBA,2015,650,630,1280,49
NAMUTUMBA,2016,670,640,1310,49
NAMUTUMBA,2017,710,680,1390,49
NAMUTUMBA,2018,770,750,1520,49
NAMUTUMBA,2019,830,800,1630,49
NAMUTUMBA,2020,890,870,1760,49
NAMUTUMBA,2021,930,920,1850,49
NAMUTUMBA,2022,960,960,1920,49
NAMUTUMBA,2023,980,990,1970,49
NAMUTUMBA,2024,990,1020,2010,49
NAMUTUMBA,2025,1030,1060,2090,49
NAPAK,2015,300,430,730,49
NAPAK,2016,300,440,740,49
NAPAK,2017,320,460,780,49
NAPAK,2018,330,500,830,49
NAPAK,2019,360,540,900,49
NAPAK,2020,370,570,940,49
NAPAK,2021,380,600,980,49
NAPAK,2022,390,620,1010,49
NAPAK,2023,390,620,1010,49
NAPAK,2024,380,640,1020,49
NAPAK,2025,390,660,1050,49
NEBBI,2015,490,600,1090,49
NEBBI,2016,510,610,1120,49
NEBBI,2017,520,630,1150,49
NEBBI,2018,540,650,1190,49
NEBBI,2019,560,670,1230,49
NEBBI,2020,570,680,1250,49
NEBBI,2021,590,700,1290,49
NEBBI,2022,610,720,1330,49
NEBBI,2023,620,740,1360,49
NEBBI,2024,640,760,1400,49
NEBBI,2025,660,770,1430,49
NGORA,2015,320,350,670,49
NGORA,2016,340,360,700,49
NGORA,2017,340,370,710,49
NGORA,2018,370,400,770,49
NGORA,2019,400,440,840,49
NGORA,2020,430,470,900,49
NGORA,2021,440,480,920,49
NGORA,2022,450,500,950,49
NGORA,2023,460,520,980,49
NGORA,2024,470,530,1000,49
NGORA,2025,480,540,1020,49
NTOROKO,2015,160,130,290,49
NTOROKO,2016,160,130,290,49
NTOROKO,2017,170,130,300,49
NTOROKO,2018,180,150,330,49
NTOROKO,2019,190,160,350,49
NTOROKO,2020,210,170,380,49
NTOROKO,2021,210,180,390,49
NTOROKO,2022,210,180,390,49
NTOROKO,2023,220,190,410,49
NTOROKO,2024,220,190,410,49
NTOROKO,2025,220,190,410,49
NTUNGAMO,2015,900,1180,2080,49
NTUNGAMO,2016,920,1200,2120,49
NTUNGAMO,2017,940,1220,2160,49
NTUNGAMO,2018,960,1250,2210,49
NTUNGAMO,2019,980,1270,2250,49
NTUNGAMO,2020,1000,1290,2290,49
NTUNGAMO,2021,1020,1310,2330,49
NTUNGAMO,2022,1040,1330,2370,49
NTUNGAMO,2023,1060,1350,2410,49
NTUNGAMO,2024,1080,1370,2450,49
NTUNGAMO,2025,1090,1390,2480,49
NWOYA,2015,230,230,460,49
NWOYA,2016,250,250,500,49
NWOYA,2017,280,270,550,49
NWOYA,2018,310,300,610,49
NWOYA,2019,340,330,670,49
NWOYA,2020,380,370,750,49
NWOYA,2021,410,400,810,49
NWOYA,2022,460,440,900,49
NWOYA,2023,500,490,990,49
NWOYA,2024,550,530,1080,49
NWOYA,2025,610,590,1200,49
OBONGI,2015,100,110,210,49
OBONGI,2016,100,110,210,49
OBONGI,2017,120,110,230,49
OBONGI,2018,120,120,240,49
OBONGI,2019,130,120,250,49
OBONGI,2020,130,140,270,49
OBONGI,2021,150,150,300,49
OBONGI,2022,150,150,300,49
OBONGI,2023,150,150,300,49
OBONGI,2024,150,150,300,49
OBONGI,2025,150,150,300,49
OMORO,2015,320,370,690,49
OMORO,2016,340,380,720,49
OMORO,2017,360,400,760,49
OMORO,2018,390,440,830,49
OMORO,2019,420,480,900,49
OMORO,2020,440,510,950,49
OMORO,2021,470,540,1010,49
OMORO,2022,480,580,1060,49
OMORO,2023,490,590,1080,49
OMORO,2024,510,610,1120,49
OMORO,2025,520,630,1150,49
OTUKE,2015,200,210,410,49
OTUKE,2016,210,210,420,49
OTUKE,2017,220,220,440,49
OTUKE,2018,230,230,460,49
OTUKE,2019,240,240,480,49
OTUKE,2020,250,250,500,49
OTUKE,2021,260,260,520,49
OTUKE,2022,270,270,540,49
OTUKE,2023,280,280,560,49
OTUKE,2024,300,300,600,49
OTUKE,2025,310,310,620,49
OYAM,2015,700,820,1520,49
OYAM,2016,730,850,1580,49
OYAM,2017,750,870,1620,49
OYAM,2018,770,890,1660,49
OYAM,2019,790,920,1710,49
OYAM,2020,820,950,1770,49
OYAM,2021,840,970,1810,49
OYAM,2022,860,1000,1860,49
OYAM,2023,890,1020,1910,49
OYAM,2024,910,1050,1960,49
OYAM,2025,930,1070,2000,49
PADER,2015,350,390,740,49
PADER,2016,350,390,740,49
PADER,2017,370,400,770,49
PADER,2018,390,440,830,49
PADER,2019,420,480,900,49
PADER,2020,430,500,930,49
PADER,2021,450,530,980,49
PADER,2022,450,550,1000,49
PADER,2023,460,550,1010,49
PADER,2024,450,560,1010,49
PADER,2025,460,570,1030,49
PAKWACH,2015,250,390,640,49
PAKWACH,2016,260,410,670,49
PAKWACH,2017,270,420,690,49
PAKWACH,2018,280,440,720,49
PAKWACH,2019,300,450,750,49
PAKWACH,2020,310,470,780,49
PAKWACH,2021,320,480,800,49
PAKWACH,2022,330,500,830,49
PAKWACH,2023,340,520,860,49
PAKWACH,2024,360,530,890,49
PAKWACH,2025,370,550,920,49
PALLISA,2015,670,690,1360,49
PALLISA,2016,700,700,1400,49
PALLISA,2017,750,760,1510,49
PALLISA,2018,810,820,1630,49
PALLISA,2019,890,910,1800,49
PALLISA,2020,950,1000,1950,49
PALLISA,2021,1010,1070,2080,49
PALLISA,2022,1050,1130,2180,49
PALLISA,2023,1080,1170,2250,49
PALLISA,2024,1110,1220,2330,49
PALLISA,2025,1150,1270,2420,49
RAKAI,2015,560,630,1190,49
RAKAI,2016,570,630,1200,49
RAKAI,2017,610,660,1270,49
RAKAI,2018,650,710,1360,49
RAKAI,2019,690,760,1450,49
RAKAI,2020,730,820,1550,49
RAKAI,2021,750,860,1610,49
RAKAI,2022,780,890,1670,49
RAKAI,2023,790,900,1690,49
RAKAI,2024,790,920,1710,49
RAKAI,2025,800,940,1740,49
RUBANDA,2015,360,580,940,49
RUBANDA,2016,370,580,950,49
RUBANDA,2017,370,590,960,49
RUBANDA,2018,380,590,970,49
RUBANDA,2019,380,590,970,49
RUBANDA,2020,380,600,980,49
RUBANDA,2021,390,600,990,49
RUBANDA,2022,390,600,990,49
RUBANDA,2023,400,610,1010,49
RUBANDA,2024,400,610,1010,49
RUBANDA,2025,400,610,1010,49
RUBIRIZI,2015,250,300,550,49
RUBIRIZI,2016,260,300,560,49
RUBIRIZI,2017,270,310,580,49
RUBIRIZI,2018,270,310,580,49
RUBIRIZI,2019,280,320,600,49
RUBIRIZI,2020,280,320,600,49
RUBIRIZI,2021,290,330,620,49
RUBIRIZI,2022,290,340,630,49
RUBIRIZI,2023,300,340,640,49
RUBIRIZI,2024,300,350,650,49
RUBIRIZI,2025,310,350,660,49
RUKIGA,2015,230,310,540,49
RUKIGA,2016,230,310,540,49
RUKIGA,2017,230,310,540,49
RUKIGA,2018,240,310,550,49
RUKIGA,2019,240,320,560,49
RUKIGA,2020,240,320,560,49
RUKIGA,2021,240,320,560,49
RUKIGA,2022,240,320,560,49
RUKIGA,2023,250,320,570,49
RUKIGA,2024,250,320,570,49
RUKIGA,2025,250,320,570,49
RUKUNGIRI,2015,630,860,1490,49
RUKUNGIRI,2016,640,870,1510,49
RUKUNGIRI,2017,640,880,1520,49
RUKUNGIRI,2018,650,880,1530,49
RUKUNGIRI,2019,660,890,1550,49
RUKUNGIRI,2020,670,900,1570,49
RUKUNGIRI,2021,670,910,1580,49
RUKUNGIRI,2022,680,910,1590,49
RUKUNGIRI,2023,680,920,1600,49
RUKUNGIRI,2024,690,920,1610,49
RUKUNGIRI,2025,690,930,1620,49
RWAMPARA,2015,250,330,580,49
RWAMPARA,2016,260,330,590,49
RWAMPARA,2017,260,340,600,49
RWAMPARA,2018,270,350,620,49
RWAMPARA,2019,280,360,640,49
RWAMPARA,2020,280,360,640,49
RWAMPARA,2021,290,370,660,49
RWAMPARA,2022,290,380,670,49
RWAMPARA,2023,300,390,690,49
RWAMPARA,2024,300,390,690,49
RWAMPARA,2025,310,400,710,49
SERERE,2015,620,600,1220,49
SERERE,2016,650,620,1270,49
SERERE,2017,690,660,1350,49
SERERE,2018,740,720,1460,49
SERERE,2019,800,790,1590,49
SERERE,2020,870,870,1740,49
SERERE,2021,920,920,1840,49
SERERE,2022,950,960,1910,49
SERERE,2023,980,1010,1990,49
SERERE,2024,990,1040,2030,49
SERERE,2025,1030,1070,2100,49
SHEEMA,2015,480,580,1060,49
SHEEMA,2016,480,580,1060,49
SHEEMA,2017,490,590,1080,49
SHEEMA,2018,490,590,1080,49
SHEEMA,2019,500,600,1100,49
SHEEMA,2020,500,610,1110,49
SHEEMA,2021,510,610,1120,49
SHEEMA,2022,510,620,1130,49
SHEEMA,2023,520,620,1140,49
SHEEMA,2024,520,620,1140,49
SHEEMA,2025,530,630,1160,49
SIRONKO,2015,590,610,1200,49
SIRONKO,2016,600,630,1230,49
SIRONKO,2017,620,640,1260,49
SIRONKO,2018,630,650,1280,49
SIRONKO,2019,650,660,1310,49
SIRONKO,2020,660,680,1340,49
SIRONKO,2021,670,690,1360,49
SIRONKO,2022,690,700,1390,49
SIRONKO,2023,700,710,1410,49
SIRONKO,2024,720,720,1440,49
SIRONKO,2025,730,740,1470,49
SOROTI,2015,730,800,1530,49
SOROTI,2016,750,810,1560,49
SOROTI,2017,790,850,1640,49
SOROTI,2018,850,940,1790,49
SOROTI,2019,920,1020,1940,49
SOROTI,2020,990,1110,2100,49
SOROTI,2021,1040,1170,2210,49
SOROTI,2022,1070,1230,2300,49
SOROTI,2023,1100,1260,2360,49
SOROTI,2024,1110,1300,2410,49
SOROTI,2025,1150,1340,2490,49
SSEMBABULE,2015,660,580,1240,49
SSEMBABULE,2016,670,580,1250,49
SSEMBABULE,2017,710,610,1320,49
SSEMBABULE,2018,760,670,1430,49
SSEMBABULE,2019,820,720,1540,49
SSEMBABULE,2020,870,770,1640,49
SSEMBABULE,2021,900,820,1720,49
SSEMBABULE,2022,930,840,1770,49
SSEMBABULE,2023,950,860,1810,49
SSEMBABULE,2024,950,870,1820,49
SSEMBABULE,2025,970,910,1880,49
TORORO,2015,1090,1270,2360,49
TORORO,2016,1120,1310,2430,49
TORORO,2017,1150,1340,2490,49
TORORO,2018,1180,1370,2550,49
TORORO,2019,1210,1400,2610,49
TORORO,2020,1240,1440,2680,49
TORORO,2021,1270,1470,2740,49
TORORO,2022,1300,1500,2800,49
TORORO,2023,1330,1540,2870,49
TORORO,2024,1360,1570,2930,49
TORORO,2025,1390,1600,2990,49
WAKISO,2015,3340,3390,6730,49
WAKISO,2016,3560,3620,7180,49
WAKISO,2017,3800,3870,7670,49
WAKISO,2018,4050,4130,8180,49
WAKISO,2019,4320,4410,8730,49
WAKISO,2020,4600,4700,9300,49
WAKISO,2021,4900,5020,9920,49
WAKISO,2022,5210,5350,10560,49
WAKISO,2023,5540,5690,11230,49
WAKISO,2024,5890,6050,11940,49
WAKISO,2025,6250,6440,12690,49
YUMBE,2015,990,770,1760,49
YUMBE,2016,1040,790,1830,49
YUMBE,2017,1110,860,1970,49
YUMBE,2018,1210,980,2190,49
YUMBE,2019,1340,1090,2430,49
YUMBE,2020,1440,1210,2650,49
YUMBE,2021,1540,1300,2840,49
YUMBE,2022,1610,1410,3020,49
YUMBE,2023,1660,1480,3140,49
YUMBE,2024,1720,1560,3280,49
YUMBE,2025,1780,1650,3430,49
ZOMBO,2015,500,590,1090,49
ZOMBO,2016,520,600,1120,49
ZOMBO,2017,540,620,1160,49
ZOMBO,2018,550,640,1190,49
ZOMBO,2019,570,650,1220,49
ZOMBO,2020,590,670,1260,49
ZOMBO,2021,600,690,1290,49
ZOMBO,2022,620,710,1330,49
ZOMBO,2023,640,720,1360,49
ZOMBO,2024,650,740,1390,49
ZOMBO,2025,670,760,1430,49
ABIM,2015,2070,1960,4030,5
ABIM,2016,2150,2040,4190,5
ABIM,2017,2230,2120,4350,5
ABIM,2018,2360,2230,4590,5
ABIM,2019,2560,2400,4960,5
ABIM,2020,2680,2630,5310,5
ABIM,2021,2820,2770,5590,5
ABIM,2022,2960,2900,5860,5
ABIM,2023,3100,3040,6140,5
ABIM,2024,3260,3180,6440,5
ABIM,2025,3420,3330,6750,5
ADJUMANI,2015,4450,4160,8610,5
ADJUMANI,2016,4490,4200,8690,5
ADJUMANI,2017,4520,4240,8760,5
ADJUMANI,2018,4550,4280,8830,5
ADJUMANI,2019,4580,4320,8900,5
ADJUMANI,2020,4610,4360,8970,5
ADJUMANI,2021,4630,4390,9020,5
ADJUMANI,2022,4650,4420,9070,5
ADJUMANI,2023,4670,4450,9120,5
ADJUMANI,2024,4680,4480,9160,5
ADJUMANI,2025,4690,4500,9190,5
AGAGO,2015,4310,4150,8460,5
AGAGO,2016,4390,4220,8610,5
AGAGO,2017,4460,4290,8750,5
AGAGO,2018,4540,4370,8910,5
AGAGO,2019,4610,4440,9050,5
AGAGO,2020,4690,4510,9200,5
AGAGO,2021,4760,4580,9340,5
AGAGO,2022,4830,4650,9480,5
AGAGO,2023,4900,4720,9620,5
AGAGO,2024,4960,4780,9740,5
AGAGO,2025,5020,4840,9860,5
ALEBTONG,2015,3820,3500,7320,5
ALEBTONG,2016,3840,3520,7360,5
ALEBTONG,2017,3860,3550,7410,5
ALEBTONG,2018,3940,3600,7540,5
ALEBTONG,2019,4140,3750,7890,5
ALEBTONG,2020,4170,4000,8170,5
ALEBTONG,2021,4230,4050,8280,5
ALEBTONG,2022,4300,4110,8410,5
ALEBTONG,2023,4360,4180,8540,5
ALEBTONG,2024,4420,4230,8650,5
ALEBTONG,2025,4480,4290,8770,5
AMOLATAR,2015,2460,2280,4740,5
AMOLATAR,2016,2460,2290,4750,5
AMOLATAR,2017,2470,2300,4770,5
AMOLATAR,2018,2520,2330,4850,5
AMOLATAR,2019,2640,2420,5060,5
AMOLATAR,2020,2660,2570,5230,5
AMOLATAR,2021,2700,2590,5290,5
AMOLATAR,2022,2730,2630,5360,5
AMOLATAR,2023,2770,2670,5440,5
AMOLATAR,2024,2800,2700,5500,5
AMOLATAR,2025,2830,2720,5550,5
AMUDAT,2015,1970,2050,4020,5
AMUDAT,2016,2000,2100,4100,5
AMUDAT,2017,2030,2160,4190,5
AMUDAT,2018,2100,2240,4340,5
AMUDAT,2019,2220,2370,4590,5
AMUDAT,2020,2270,2570,4840,5
AMUDAT,2021,2330,2660,4990,5
AMUDAT,2022,2390,2760,5150,5
AMUDAT,2023,2450,2850,5300,5
AMUDAT,2024,2510,2940,5450,5
AMUDAT,2025,2570,3030,5600,5
AMURIA,2015,3420,3290,6710,5
AMURIA,2016,3460,3330,6790,5
AMURIA,2017,3510,3370,6880,5
AMURIA,2018,3610,3460,7070,5
AMURIA,2019,3830,3640,7470,5
AMURIA,2020,3900,3890,7790,5
AMURIA,2021,4000,3980,7980,5
AMURIA,2022,4100,4080,8180,5
AMURIA,2023,4200,4170,8370,5
AMURIA,2024,4290,4250,8540,5
AMURIA,2025,4380,4350,8730,5
AMURU,2015,3420,3230,6650,5
AMURU,2016,3430,3240,6670,5
AMURU,2017,3440,3260,6700,5
AMURU,2018,3510,3310,6820,5
AMURU,2019,3680,3450,7130,5
AMURU,2020,3700,3670,7370,5
AMURU,2021,3760,3720,7480,5
AMURU,2022,3800,3770,7570,5
AMURU,2023,3860,3830,7690,5
AMURU,2024,3900,3880,7780,5
AMURU,2025,3940,3930,7870,5
APAC,2015,2900,2810,5710,5
APAC,2016,3010,2910,5920,5
APAC,2017,3120,3010,6130,5
APAC,2018,3240,3110,6350,5
APAC,2019,3350,3210,6560,5
APAC,2020,3470,3320,6790,5
APAC,2021,3590,3430,7020,5
APAC,2022,3710,3540,7250,5
APAC,2023,3830,3650,7480,5
APAC,2024,3960,3760,7720,5
APAC,2025,4080,3880,7960,5
ARUA,2015,11440,10480,21920,5
ARUA,2016,11780,10760,22540,5
ARUA,2017,12100,11070,23170,5
ARUA,2018,12450,11360,23810,5
ARUA,2019,12800,11660,24460,5
ARUA,2020,13150,11960,25110,5
ARUA,2021,13510,12250,25760,5
ARUA,2022,13850,12550,26400,5
ARUA,2023,14200,12860,27060,5
ARUA,2024,14550,13150,27700,5
ARUA,2025,14890,13450,28340,5
BUDAKA,2015,3950,3750,7700,5
BUDAKA,2016,3980,3790,7770,5
BUDAKA,2017,4050,3840,7890,5
BUDAKA,2018,4160,3940,8100,5
BUDAKA,2019,4410,4130,8540,5
BUDAKA,2020,4470,4420,8890,5
BUDAKA,2021,4570,4520,9090,5
BUDAKA,2022,4690,4620,9310,5
BUDAKA,2023,4800,4720,9520,5
BUDAKA,2024,4900,4820,9720,5
BUDAKA,2025,5000,4910,9910,5
BUDUDA,2015,3720,3520,7240,5
BUDUDA,2016,3800,3610,7410,5
BUDUDA,2017,3890,3690,7580,5
BUDUDA,2018,4030,3820,7850,5
BUDUDA,2019,4310,4050,8360,5
BUDUDA,2020,4410,4370,8780,5
BUDUDA,2021,4560,4520,9080,5
BUDUDA,2022,4710,4670,9380,5
BUDUDA,2023,4860,4820,9680,5
BUDUDA,2024,5010,4970,9980,5
BUDUDA,2025,5150,5120,10270,5
BUGIRI,2015,7370,6820,14190,5
BUGIRI,2016,7480,6920,14400,5
BUGIRI,2017,7630,7050,14680,5
BUGIRI,2018,7890,7260,15150,5
BUGIRI,2019,8380,7650,16030,5
BUGIRI,2020,8560,8220,16780,5
BUGIRI,2021,8810,8450,17260,5
BUGIRI,2022,9060,8690,17750,5
BUGIRI,2023,9310,8920,18230,5
BUGIRI,2024,9550,9140,18690,5
BUGIRI,2025,9800,9360,19160,5
BUGWERI,2015,2960,2880,5840,5
BUGWERI,2016,2970,2890,5860,5
BUGWERI,2017,2980,2900,5880,5
BUGWERI,2018,3050,2960,6010,5
BUGWERI,2019,3200,3080,6280,5
BUGWERI,2020,3220,3260,6480,5
BUGWERI,2021,3270,3310,6580,5
BUGWERI,2022,3320,3360,6680,5
BUGWERI,2023,3370,3400,6770,5
BUGWERI,2024,3410,3440,6850,5
BUGWERI,2025,3450,3490,6940,5
BUHWEJU,2015,2150,2110,4260,5
BUHWEJU,2016,2220,2170,4390,5
BUHWEJU,2017,2290,2240,4530,5
BUHWEJU,2018,2360,2310,4670,5
BUHWEJU,2019,2440,2380,4820,5
BUHWEJU,2020,2510,2440,4950,5
BUHWEJU,2021,2590,2510,5100,5
BUHWEJU,2022,2670,2580,5250,5
BUHWEJU,2023,2750,2660,5410,5
BUHWEJU,2024,2820,2730,5550,5
BUHWEJU,2025,2900,2800,5700,5
BUIKWE,2015,7160,6310,13470,5
BUIKWE,2016,7140,6290,13430,5
BUIKWE,2017,7130,6290,13420,5
BUIKWE,2018,7220,6360,13580,5
BUIKWE,2019,7530,6580,14110,5
BUIKWE,2020,7520,6950,14470,5
BUIKWE,2021,7580,7020,14600,5
BUIKWE,2022,7640,7070,14710,5
BUIKWE,2023,7700,7130,14830,5
BUIKWE,2024,7750,7180,14930,5
BUIKWE,2025,7790,7230,15020,5
BUKEDEA,2015,3690,3490,7180,5
BUKEDEA,2016,3760,3550,7310,5
BUKEDEA,2017,3850,3620,7470,5
BUKEDEA,2018,3990,3740,7730,5
BUKEDEA,2019,4250,3950,8200,5
BUKEDEA,2020,4350,4250,8600,5
BUKEDEA,2021,4490,4380,8870,5
BUKEDEA,2022,4640,4510,9150,5
BUKEDEA,2023,4780,4640,9420,5
BUKEDEA,2024,4920,4770,9690,5
BUKEDEA,2025,5060,4890,9950,5
BUKOMANSIMBI,2015,2840,2550,5390,5
BUKOMANSIMBI,2016,2790,2500,5290,5
BUKOMANSIMBI,2017,2760,2460,5220,5
BUKOMANSIMBI,2018,2760,2450,5210,5
BUKOMANSIMBI,2019,2840,2500,5340,5
BUKOMANSIMBI,2020,2810,2590,5400,5
BUKOMANSIMBI,2021,2800,2580,5380,5
BUKOMANSIMBI,2022,2790,2560,5350,5
BUKOMANSIMBI,2023,2770,2540,5310,5
BUKOMANSIMBI,2024,2760,2520,5280,5
BUKOMANSIMBI,2025,2740,2490,5230,5
BUKWO,2015,1730,1520,3250,5
BUKWO,2016,1820,1590,3410,5
BUKWO,2017,1920,1670,3590,5
BUKWO,2018,2030,1750,3780,5
BUKWO,2019,2130,1830,3960,5
BUKWO,2020,2240,1920,4160,5
BUKWO,2021,2360,2010,4370,5
BUKWO,2022,2480,2100,4580,5
BUKWO,2023,2600,2200,4800,5
BUKWO,2024,2720,2300,5020,5
BUKWO,2025,2860,2400,5260,5
BULAMBULI,2015,3020,3050,6070,5
BULAMBULI,2016,3100,3130,6230,5
BULAMBULI,2017,3180,3210,6390,5
BULAMBULI,2018,3320,3350,6670,5
BULAMBULI,2019,3550,3560,7110,5
BULAMBULI,2020,3650,3870,7520,5
BULAMBULI,2021,3790,4010,7800,5
BULAMBULI,2022,3930,4160,8090,5
BULAMBULI,2023,4070,4310,8380,5
BULAMBULI,2024,4210,4470,8680,5
BULAMBULI,2025,4350,4620,8970,5
BULIISA,2015,2100,1900,4000,5
BULIISA,2016,2220,1990,4210,5
BULIISA,2017,2340,2070,4410,5
BULIISA,2018,2460,2170,4630,5
BULIISA,2019,2590,2260,4850,5
BULIISA,2020,2730,2350,5080,5
BULIISA,2021,2870,2450,5320,5
BULIISA,2022,3020,2560,5580,5
BULIISA,2023,3170,2660,5830,5
BULIISA,2024,3330,2770,6100,5
BULIISA,2025,3490,2880,6370,5
BUNDIBUGYO,2015,4210,3960,8170,5
BUNDIBUGYO,2016,4230,3970,8200,5
BUNDIBUGYO,2017,4270,4000,8270,5
BUNDIBUGYO,2018,4370,4070,8440,5
BUNDIBUGYO,2019,4600,4250,8850,5
BUNDIBUGYO,2020,4640,4510,9150,5
BUNDIBUGYO,2021,4720,4580,9300,5
BUNDIBUGYO,2022,4800,4660,9460,5
BUNDIBUGYO,2023,4880,4720,9600,5
BUNDIBUGYO,2024,4960,4800,9760,5
BUNDIBUGYO,2025,5030,4860,9890,5
BUNYANGABU,2015,3050,2910,5960,5
BUNYANGABU,2016,3060,2900,5960,5
BUNYANGABU,2017,3070,2910,5980,5
BUNYANGABU,2018,3120,2960,6080,5
BUNYANGABU,2019,3270,3060,6330,5
BUNYANGABU,2020,3280,3240,6520,5
BUNYANGABU,2021,3330,3280,6610,5
BUNYANGABU,2022,3370,3320,6690,5
BUNYANGABU,2023,3420,3350,6770,5
BUNYANGABU,2024,3460,3380,6840,5
BUNYANGABU,2025,3490,3400,6890,5
BUSHENYI,2015,3670,3400,7070,5
BUSHENYI,2016,3720,3430,7150,5
BUSHENYI,2017,3770,3460,7230,5
BUSHENYI,2018,3810,3490,7300,5
BUSHENYI,2019,3850,3520,7370,5
BUSHENYI,2020,3900,3550,7450,5
BUSHENYI,2021,3930,3570,7500,5
BUSHENYI,2022,3970,3600,7570,5
BUSHENYI,2023,4010,3620,7630,5
BUSHENYI,2024,4040,3640,7680,5
BUSHENYI,2025,4060,3650,7710,5
BUSIA,2015,5710,5300,11010,5
BUSIA,2016,5750,5330,11080,5
BUSIA,2017,5800,5380,11180,5
BUSIA,2018,5940,5490,11430,5
BUSIA,2019,6260,5720,11980,5
BUSIA,2020,6330,6090,12420,5
BUSIA,2021,6460,6200,12660,5
BUSIA,2022,6570,6310,12880,5
BUSIA,2023,6700,6410,13110,5
BUSIA,2024,6810,6510,13320,5
BUSIA,2025,6920,6600,13520,5
BUTALEJA,2015,4700,4440,9140,5
BUTALEJA,2016,4760,4490,9250,5
BUTALEJA,2017,4830,4570,9400,5
BUTALEJA,2018,4980,4680,9660,5
BUTALEJA,2019,5280,4920,10200,5
BUTALEJA,2020,5370,5270,10640,5
BUTALEJA,2021,5510,5400,10910,5
BUTALEJA,2022,5650,5530,11180,5
BUTALEJA,2023,5780,5660,11440,5
BUTALEJA,2024,5920,5780,11700,5
BUTALEJA,2025,6050,5900,11950,5
BUTAMBALA,2015,1890,1700,3590,5
BUTAMBALA,2016,1870,1670,3540,5
BUTAMBALA,2017,1860,1650,3510,5
BUTAMBALA,2018,1870,1660,3530,5
BUTAMBALA,2019,1930,1710,3640,5
BUTAMBALA,2020,1920,1780,3700,5
BUTAMBALA,2021,1920,1780,3700,5
BUTAMBALA,2022,1930,1780,3710,5
BUTAMBALA,2023,1930,1770,3700,5
BUTAMBALA,2024,1930,1770,3700,5
BUTAMBALA,2025,1920,1770,3690,5
BUTEBO,2015,2000,1950,3950,5
BUTEBO,2016,1980,1930,3910,5
BUTEBO,2017,1970,1920,3890,5
BUTEBO,2018,1980,1930,3910,5
BUTEBO,2019,2060,1980,4040,5
BUTEBO,2020,2050,2070,4120,5
BUTEBO,2021,2060,2080,4140,5
BUTEBO,2022,2070,2090,4160,5
BUTEBO,2023,2070,2090,4160,5
BUTEBO,2024,2080,2090,4170,5
BUTEBO,2025,2070,2090,4160,5
BUVUMA,2015,1480,1470,2950,5
BUVUMA,2016,1570,1570,3140,5
BUVUMA,2017,1670,1680,3350,5
BUVUMA,2018,1770,1790,3560,5
BUVUMA,2019,1880,1910,3790,5
BUVUMA,2020,1990,2040,4030,5
BUVUMA,2021,2110,2170,4280,5
BUVUMA,2022,2230,2310,4540,5
BUVUMA,2023,2360,2460,4820,5
BUVUMA,2024,2500,2620,5120,5
BUVUMA,2025,2640,2780,5420,5
BUYENDE,2015,6660,6080,12740,5
BUYENDE,2016,6800,6190,12990,5
BUYENDE,2017,6950,6330,13280,5
BUYENDE,2018,7220,6560,13780,5
BUYENDE,2019,7700,6930,14630,5
BUYENDE,2020,7880,7480,15360,5
BUYENDE,2021,8150,7730,15880,5
BUYENDE,2022,8400,7970,16370,5
BUYENDE,2023,8670,8220,16890,5
BUYENDE,2024,8930,8460,17390,5
BUYENDE,2025,9190,8700,17890,5
DOKOLO,2015,3000,2980,5980,5
DOKOLO,2016,3100,3060,6160,5
DOKOLO,2017,3190,3150,6340,5
DOKOLO,2018,3290,3230,6520,5
DOKOLO,2019,3390,3320,6710,5
DOKOLO,2020,3480,3410,6890,5
DOKOLO,2021,3590,3490,7080,5
DOKOLO,2022,3680,3580,7260,5
DOKOLO,2023,3780,3660,7440,5
DOKOLO,2024,3880,3750,7630,5
DOKOLO,2025,3980,3840,7820,5
GOMBA,2015,2890,2560,5450,5
GOMBA,2016,2870,2530,5400,5
GOMBA,2017,2860,2510,5370,5
GOMBA,2018,2890,2510,5400,5
GOMBA,2019,3010,2580,5590,5
GOMBA,2020,2990,2700,5690,5
GOMBA,2021,3010,2710,5720,5
GOMBA,2022,3030,2710,5740,5
GOMBA,2023,3040,2700,5740,5
GOMBA,2024,3040,2700,5740,5
GOMBA,2025,3060,2690,5750,5
GULU,2015,4230,3970,8200,5
GULU,2016,4350,4090,8440,5
GULU,2017,4490,4200,8690,5
GULU,2018,4620,4320,8940,5
GULU,2019,4750,4450,9200,5
GULU,2020,4890,4570,9460,5
GULU,2021,5030,4690,9720,5
GULU,2022,5160,4820,9980,5
GULU,2023,5300,4940,10240,5
GULU,2024,5440,5070,10510,5
GULU,2025,5570,5190,10760,5
HOIMA,2015,5250,4730,9980,5
HOIMA,2016,5450,4890,10340,5
HOIMA,2017,5650,5060,10710,5
HOIMA,2018,5870,5230,11100,5
HOIMA,2019,6080,5410,11490,5
HOIMA,2020,6300,5590,11890,5
HOIMA,2021,6520,5770,12290,5
HOIMA,2022,6750,5960,12710,5
HOIMA,2023,6980,6150,13130,5
HOIMA,2024,7210,6330,13540,5
HOIMA,2025,7440,6520,13960,5
IBANDA,2015,4140,3900,8040,5
IBANDA,2016,4220,3970,8190,5
IBANDA,2017,4300,4040,8340,5
IBANDA,2018,4390,4120,8510,5
IBANDA,2019,4470,4190,8660,5
IBANDA,2020,4550,4260,8810,5
IBANDA,2021,4630,4320,8950,5
IBANDA,2022,4710,4390,9100,5
IBANDA,2023,4790,4460,9250,5
IBANDA,2024,4860,4520,9380,5
IBANDA,2025,4930,4580,9510,5
IGANGA,2015,5720,5430,11150,5
IGANGA,2016,5760,5460,11220,5
IGANGA,2017,5810,5500,11310,5
IGANGA,2018,5950,5610,11560,5
IGANGA,2019,6280,5860,12140,5
IGANGA,2020,6340,6240,12580,5
IGANGA,2021,6460,6340,12800,5
IGANGA,2022,6590,6450,13040,5
IGANGA,2023,6710,6560,13270,5
IGANGA,2024,6820,6670,13490,5
IGANGA,2025,6930,6750,13680,5
ISINGIRO,2015,8890,8480,17370,5
ISINGIRO,2016,9220,8780,18000,5
ISINGIRO,2017,9560,9090,18650,5
ISINGIRO,2018,9920,9410,19330,5
ISINGIRO,2019,10280,9730,20010,5
ISINGIRO,2020,10650,10060,20710,5
ISINGIRO,2021,11020,10390,21410,5
ISINGIRO,2022,11400,10730,22130,5
ISINGIRO,2023,11780,11070,22850,5
ISINGIRO,2024,12170,11420,23590,5
ISINGIRO,2025,12560,11770,24330,5
JINJA,2015,7200,6800,14000,5
JINJA,2016,7330,6910,14240,5
JINJA,2017,7450,7010,14460,5
JINJA,2018,7570,7120,14690,5
JINJA,2019,7690,7220,14910,5
JINJA,2020,7810,7320,15130,5
JINJA,2021,7920,7420,15340,5
JINJA,2022,8030,7520,15550,5
JINJA,2023,8140,7600,15740,5
JINJA,2024,8240,7690,15930,5
JINJA,2025,8330,7770,16100,5
KAABONG,2015,2130,1910,4040,5
KAABONG,2016,2190,1970,4160,5
KAABONG,2017,2260,2020,4280,5
KAABONG,2018,2310,2060,4370,5
KAABONG,2019,2370,2110,4480,5
KAABONG,2020,2430,2160,4590,5
KAABONG,2021,2500,2210,4710,5
KAABONG,2022,2550,2260,4810,5
KAABONG,2023,2620,2300,4920,5
KAABONG,2024,2670,2340,5010,5
KAABONG,2025,2730,2390,5120,5
KABALE,2015,3450,3250,6700,5
KABALE,2016,3500,3290,6790,5
KABALE,2017,3560,3330,6890,5
KABALE,2018,3610,3370,6980,5
KABALE,2019,3660,3410,7070,5
KABALE,2020,3720,3450,7170,5
KABALE,2021,3760,3480,7240,5
KABALE,2022,3810,3510,7320,5
KABALE,2023,3860,3540,7400,5
KABALE,2024,3900,3570,7470,5
KABALE,2025,3940,3600,7540,5
KABAROLE,2015,4780,4420,9200,5
KABAROLE,2016,4890,4510,9400,5
KABAROLE,2017,4990,4610,9600,5
KABAROLE,2018,5100,4710,9810,5
KABAROLE,2019,5210,4810,10020,5
KABAROLE,2020,5310,4910,10220,5
KABAROLE,2021,5420,5000,10420,5
KABAROLE,2022,5520,5100,10620,5
KABAROLE,2023,5630,5190,10820,5
KABAROLE,2024,5720,5280,11000,5
KABAROLE,2025,5820,5370,11190,5
KABERAMAIDO,2015,1830,1760,3590,5
KABERAMAIDO,2016,1860,1780,3640,5
KABERAMAIDO,2017,1900,1820,3720,5
KABERAMAIDO,2018,1970,1880,3850,5
KABERAMAIDO,2019,2100,1970,4070,5
KABERAMAIDO,2020,2150,2120,4270,5
KABERAMAIDO,2021,2210,2180,4390,5
KABERAMAIDO,2022,2280,2240,4520,5
KABERAMAIDO,2023,2340,2300,4640,5
KABERAMAIDO,2024,2420,2360,4780,5
KABERAMAIDO,2025,2470,2430,4900,5
KAGADI,2015,6860,6410,13270,5
KAGADI,2016,7110,6630,13740,5
KAGADI,2017,7380,6870,14250,5
KAGADI,2018,7650,7110,14760,5
KAGADI,2019,7920,7350,15270,5
KAGADI,2020,8200,7600,15800,5
KAGADI,2021,8490,7860,16350,5
KAGADI,2022,8780,8110,16890,5
KAGADI,2023,9070,8370,17440,5
KAGADI,2024,9370,8630,18000,5
KAGADI,2025,9670,8900,18570,5
KAKUMIRO,2015,5880,5400,11280,5
KAKUMIRO,2016,6400,5860,12260,5
KAKUMIRO,2017,6960,6350,13310,5
KAKUMIRO,2018,7580,6890,14470,5
KAKUMIRO,2019,8240,7460,15700,5
KAKUMIRO,2020,8960,8070,17030,5
KAKUMIRO,2021,9730,8740,18470,5
KAKUMIRO,2022,10560,9450,20010,5
KAKUMIRO,2023,11450,10210,21660,5
KAKUMIRO,2024,12410,11020,23430,5
KAKUMIRO,2025,13440,11900,25340,5
KALAKI,2015,1970,2040,4010,5
KALAKI,2016,2060,2120,4180,5
KALAKI,2017,2150,2200,4350,5
KALAKI,2018,2240,2290,4530,5
KALAKI,2019,2330,2380,4710,5
KALAKI,2020,2430,2470,4900,5
KALAKI,2021,2530,2560,5090,5
KALAKI,2022,2630,2650,5280,5
KALAKI,2023,2740,2750,5490,5
KALAKI,2024,2840,2850,5690,5
KALAKI,2025,2950,2950,5900,5
KALANGALA,2015,590,550,1140,5
KALANGALA,2016,610,570,1180,5
KALANGALA,2017,640,590,1230,5
KALANGALA,2018,660,620,1280,5
KALANGALA,2019,680,640,1320,5
KALANGALA,2020,700,670,1370,5
KALANGALA,2021,730,690,1420,5
KALANGALA,2022,750,720,1470,5
KALANGALA,2023,770,750,1520,5
KALANGALA,2024,800,780,1580,5
KALANGALA,2025,820,800,1620,5
KALIRO,2015,4640,4310,8950,5
KALIRO,2016,4690,4370,9060,5
KALIRO,2017,4750,4420,9170,5
KALIRO,2018,4890,4540,9430,5
KALIRO,2019,5170,4770,9940,5
KALIRO,2020,5240,5100,10340,5
KALIRO,2021,5370,5220,10590,5
KALIRO,2022,5500,5350,10850,5
KALIRO,2023,5620,5470,11090,5
KALIRO,2024,5740,5590,11330,5
KALIRO,2025,5850,5700,11550,5
KALUNGU,2015,3280,3050,6330,5
KALUNGU,2016,3230,3010,6240,5
KALUNGU,2017,3200,2980,6180,5
KALUNGU,2018,3210,2980,6190,5
KALUNGU,2019,3320,3060,6380,5
KALUNGU,2020,3280,3200,6480,5
KALUNGU,2021,3290,3190,6480,5
KALUNGU,2022,3280,3180,6460,5
KALUNGU,2023,3280,3170,6450,5
KALUNGU,2024,3270,3170,6440,5
KALUNGU,2025,3260,3160,6420,5
KAMPALA,2015,18750,17370,36120,5
KAMPALA,2016,19130,17710,36840,5
KAMPALA,2017,19500,18050,37550,5
KAMPALA,2018,19880,18400,38280,5
KAMPALA,2019,20250,18740,38990,5
KAMPALA,2020,20620,19070,39690,5
KAMPALA,2021,20980,19400,40380,5
KAMPALA,2022,21340,19730,41070,5
KAMPALA,2023,21680,20050,41730,5
KAMPALA,2024,22010,20350,42360,5
KAMPALA,2025,22330,20650,42980,5
KAMULI,2015,8930,8170,17100,5
KAMULI,2016,8940,8170,17110,5
KAMULI,2017,8980,8190,17170,5
KAMULI,2018,9160,8300,17460,5
KAMULI,2019,9590,8610,18200,5
KAMULI,2020,9650,9110,18760,5
KAMULI,2021,9780,9230,19010,5
KAMULI,2022,9920,9330,19250,5
KAMULI,2023,10040,9430,19470,5
KAMULI,2024,10160,9520,19680,5
KAMULI,2025,10270,9600,19870,5
KAMWENGE,2015,5180,4890,10070,5
KAMWENGE,2016,5390,5070,10460,5
KAMWENGE,2017,5600,5240,10840,5
KAMWENGE,2018,5830,5430,11260,5
KAMWENGE,2019,6060,5620,11680,5
KAMWENGE,2020,6300,5810,12110,5
KAMWENGE,2021,6540,6000,12540,5
KAMWENGE,2022,6790,6190,12980,5
KAMWENGE,2023,7030,6400,13430,5
KAMWENGE,2024,7290,6600,13890,5
KAMWENGE,2025,7550,6800,14350,5
KANUNGU,2015,4540,4410,8950,5
KANUNGU,2016,4630,4480,9110,5
KANUNGU,2017,4710,4550,9260,5
KANUNGU,2018,4790,4630,9420,5
KANUNGU,2019,4870,4700,9570,5
KANUNGU,2020,4960,4760,9720,5
KANUNGU,2021,5030,4830,9860,5
KANUNGU,2022,5110,4900,10010,5
KANUNGU,2023,5180,4960,10140,5
KANUNGU,2024,5260,5020,10280,5
KANUNGU,2025,5320,5080,10400,5
KAPCHORWA,2015,1680,1510,3190,5
KAPCHORWA,2016,1730,1550,3280,5
KAPCHORWA,2017,1790,1590,3380,5
KAPCHORWA,2018,1840,1630,3470,5
KAPCHORWA,2019,1890,1680,3570,5
KAPCHORWA,2020,1950,1720,3670,5
KAPCHORWA,2021,2000,1760,3760,5
KAPCHORWA,2022,2060,1810,3870,5
KAPCHORWA,2023,2110,1850,3960,5
KAPCHORWA,2024,2170,1900,4070,5
KAPCHORWA,2025,2220,1940,4160,5
KAPELEBYONG,2015,1580,1520,3100,5
KAPELEBYONG,2016,1600,1530,3130,5
KAPELEBYONG,2017,1610,1540,3150,5
KAPELEBYONG,2018,1660,1580,3240,5
KAPELEBYONG,2019,1750,1640,3390,5
KAPELEBYONG,2020,1770,1740,3510,5
KAPELEBYONG,2021,1800,1770,3570,5
KAPELEBYONG,2022,1840,1800,3640,5
KAPELEBYONG,2023,1870,1830,3700,5
KAPELEBYONG,2024,1910,1850,3760,5
KAPELEBYONG,2025,1940,1880,3820,5
KASESE,2015,12620,11720,24340,5
KASESE,2016,12600,11710,24310,5
KASESE,2017,12650,11720,24370,5
KASESE,2018,12880,11890,24770,5
KASESE,2019,13460,12330,25790,5
KASESE,2020,13520,13020,26540,5
KASESE,2021,13700,13180,26880,5
KASESE,2022,13860,13320,27180,5
KASESE,2023,14020,13450,27470,5
KASESE,2024,14160,13570,27730,5
KASESE,2025,14290,13680,27970,5
KASSANDA,2015,4830,4270,9100,5
KASSANDA,2016,4970,4370,9340,5
KASSANDA,2017,5120,4460,9580,5
KASSANDA,2018,5260,4550,9810,5
KASSANDA,2019,5410,4640,10050,5
KASSANDA,2020,5550,4740,10290,5
KASSANDA,2021,5700,4830,10530,5
KASSANDA,2022,5840,4920,10760,5
KASSANDA,2023,5990,5010,11000,5
KASSANDA,2024,6130,5100,11230,5
KASSANDA,2025,6280,5180,11460,5
KATAKWI,2015,3070,2780,5850,5
KATAKWI,2016,3080,2790,5870,5
KATAKWI,2017,3110,2800,5910,5
KATAKWI,2018,3180,2850,6030,5
KATAKWI,2019,3340,2960,6300,5
KATAKWI,2020,3370,3150,6520,5
KATAKWI,2021,3430,3190,6620,5
KATAKWI,2022,3490,3240,6730,5
KATAKWI,2023,3550,3280,6830,5
KATAKWI,2024,3600,3320,6920,5
KATAKWI,2025,3650,3350,7000,5
KAYUNGA,2015,6740,6170,12910,5
KAYUNGA,2016,6710,6120,12830,5
KAYUNGA,2017,6700,6110,12810,5
KAYUNGA,2018,6780,6150,12930,5
KAYUNGA,2019,7060,6340,13400,5
KAYUNGA,2020,7050,6670,13720,5
KAYUNGA,2021,7110,6710,13820,5
KAYUNGA,2022,7170,6740,13910,5
KAYUNGA,2023,7210,6780,13990,5
KAYUNGA,2024,7240,6800,14040,5
KAYUNGA,2025,7280,6810,14090,5
KAZO,2015,3240,2930,6170,5
KAZO,2016,3360,3030,6390,5
KAZO,2017,3500,3140,6640,5
KAZO,2018,3620,3250,6870,5
KAZO,2019,3760,3360,7120,5
KAZO,2020,3890,3480,7370,5
KAZO,2021,4030,3590,7620,5
KAZO,2022,4170,3710,7880,5
KAZO,2023,4310,3830,8140,5
KAZO,2024,4460,3950,8410,5
KAZO,2025,4610,4070,8680,5
KIBAALE,2015,2770,2580,5350,5
KIBAALE,2016,2950,2730,5680,5
KIBAALE,2017,3140,2890,6030,5
KIBAALE,2018,3340,3060,6400,5
KIBAALE,2019,3550,3230,6780,5
KIBAALE,2020,3770,3410,7180,5
KIBAALE,2021,4000,3600,7600,5
KIBAALE,2022,4240,3800,8040,5
KIBAALE,2023,4500,4010,8510,5
KIBAALE,2024,4760,4230,8990,5
KIBAALE,2025,5040,4450,9490,5
KIBOGA,2015,2560,2280,4840,5
KIBOGA,2016,2560,2290,4850,5
KIBOGA,2017,2580,2290,4870,5
KIBOGA,2018,2630,2330,4960,5
KIBOGA,2019,2750,2420,5170,5
KIBOGA,2020,2770,2560,5330,5
KIBOGA,2021,2820,2590,5410,5
KIBOGA,2022,2850,2620,5470,5
KIBOGA,2023,2900,2660,5560,5
KIBOGA,2024,2930,2680,5610,5
KIBOGA,2025,2960,2710,5670,5
KIBUKU,2015,3940,3680,7620,5
KIBUKU,2016,3990,3720,7710,5
KIBUKU,2017,4060,3790,7850,5
KIBUKU,2018,4190,3890,8080,5
KIBUKU,2019,4440,4100,8540,5
KIBUKU,2020,4520,4400,8920,5
KIBUKU,2021,4650,4510,9160,5
KIBUKU,2022,4770,4630,9400,5
KIBUKU,2023,4900,4740,9640,5
KIBUKU,2024,5010,4850,9860,5
KIBUKU,2025,5130,4960,10090,5
KIKUUBE,2015,5180,4770,9950,5
KIKUUBE,2016,5460,5010,10470,5
KIKUUBE,2017,5760,5270,11030,5
KIKUUBE,2018,6060,5540,11600,5
KIKUUBE,2019,6380,5810,12190,5
KIKUUBE,2020,6710,6100,12810,5
KIKUUBE,2021,7050,6400,13450,5
KIKUUBE,2022,7410,6710,14120,5
KIKUUBE,2023,7780,7020,14800,5
KIKUUBE,2024,8160,7360,15520,5
KIKUUBE,2025,8550,7690,16240,5
KIRUHURA,2015,2490,2250,4740,5
KIRUHURA,2016,2590,2340,4930,5
KIRUHURA,2017,2680,2420,5100,5
KIRUHURA,2018,2790,2500,5290,5
KIRUHURA,2019,2890,2590,5480,5
KIRUHURA,2020,3000,2670,5670,5
KIRUHURA,2021,3100,2770,5870,5
KIRUHURA,2022,3210,2860,6070,5
KIRUHURA,2023,3320,2950,6270,5
KIRUHURA,2024,3430,3040,6470,5
KIRUHURA,2025,3540,3130,6670,5
KIRYANDONGO,2015,4890,4460,9350,5
KIRYANDONGO,2016,4920,4480,9400,5
KIRYANDONGO,2017,4960,4510,9470,5
KIRYANDONGO,2018,5080,4600,9680,5
KIRYANDONGO,2019,5350,4790,10140,5
KIRYANDONGO,2020,5400,5090,10490,5
KIRYANDONGO,2021,5500,5180,10680,5
KIRYANDONGO,2022,5610,5260,10870,5
KIRYANDONGO,2023,5690,5330,11020,5
KIRYANDONGO,2024,5790,5410,11200,5
KIRYANDONGO,2025,5870,5480,11350,5
KISORO,2015,5000,4750,9750,5
KISORO,2016,4980,4730,9710,5
KISORO,2017,4970,4730,9700,5
KISORO,2018,5040,4780,9820,5
KISORO,2019,5240,4950,10190,5
KISORO,2020,5240,5220,10460,5
KISORO,2021,5280,5270,10550,5
KISORO,2022,5330,5320,10650,5
KISORO,2023,5370,5360,10730,5
KISORO,2024,5390,5400,10790,5
KISORO,2025,5420,5420,10840,5
KITAGWENDA,2015,2770,2600,5370,5
KITAGWENDA,2016,2890,2690,5580,5
KITAGWENDA,2017,3010,2790,5800,5
KITAGWENDA,2018,3130,2890,6020,5
KITAGWENDA,2019,3250,2990,6240,5
KITAGWENDA,2020,3380,3090,6470,5
KITAGWENDA,2021,3510,3200,6710,5
KITAGWENDA,2022,3640,3310,6950,5
KITAGWENDA,2023,3780,3410,7190,5
KITAGWENDA,2024,3910,3510,7420,5
KITAGWENDA,2025,4050,3620,7670,5
KITGUM,2015,3540,3350,6890,5
KITGUM,2016,3510,3320,6830,5
KITGUM,2017,3490,3300,6790,5
KITGUM,2018,3530,3330,6860,5
KITGUM,2019,3660,3430,7090,5
KITGUM,2020,3650,3600,7250,5
KITGUM,2021,3670,3620,7290,5
KITGUM,2022,3680,3640,7320,5
KITGUM,2023,3690,3660,7350,5
KITGUM,2024,3700,3660,7360,5
KITGUM,2025,3700,3670,7370,5
KOBOKO,2015,3980,3630,7610,5
KOBOKO,2016,4040,3680,7720,5
KOBOKO,2017,4110,3750,7860,5
KOBOKO,2018,4250,3860,8110,5
KOBOKO,2019,4510,4070,8580,5
KOBOKO,2020,4590,4360,8950,5
KOBOKO,2021,4730,4490,9220,5
KOBOKO,2022,4860,4610,9470,5
KOBOKO,2023,4990,4720,9710,5
KOBOKO,2024,5110,4840,9950,5
KOBOKO,2025,5230,4960,10190,5
KOLE,2015,4190,3810,8000,5
KOLE,2016,4330,3920,8250,5
KOLE,2017,4470,4040,8510,5
KOLE,2018,4620,4150,8770,5
KOLE,2019,4760,4270,9030,5
KOLE,2020,4910,4380,9290,5
KOLE,2021,5060,4500,9560,5
KOLE,2022,5210,4620,9830,5
KOLE,2023,5360,4740,10100,5
KOLE,2024,5510,4850,10360,5
KOLE,2025,5660,4970,10630,5
KOTIDO,2015,3180,3370,6550,5
KOTIDO,2016,3180,3360,6540,5
KOTIDO,2017,3190,3370,6560,5
KOTIDO,2018,3250,3410,6660,5
KOTIDO,2019,3400,3530,6930,5
KOTIDO,2020,3410,3730,7140,5
KOTIDO,2021,3450,3780,7230,5
KOTIDO,2022,3500,3810,7310,5
KOTIDO,2023,3540,3860,7400,5
KOTIDO,2024,3570,3890,7460,5
KOTIDO,2025,3600,3910,7510,5
KUMI,2015,4270,3980,8250,5
KUMI,2016,4310,3990,8300,5
KUMI,2017,4350,4030,8380,5
KUMI,2018,4460,4110,8570,5
KUMI,2019,4710,4300,9010,5
KUMI,2020,4760,4570,9330,5
KUMI,2021,4860,4650,9510,5
KUMI,2022,4960,4740,9700,5
KUMI,2023,5050,4810,9860,5
KUMI,2024,5140,4890,10030,5
KUMI,2025,5230,4960,10190,5
KWANIA,2015,3060,3000,6060,5
KWANIA,2016,3160,3090,6250,5
KWANIA,2017,3250,3170,6420,5
KWANIA,2018,3350,3270,6620,5
KWANIA,2019,3450,3350,6800,5
KWANIA,2020,3560,3440,7000,5
KWANIA,2021,3660,3540,7200,5
KWANIA,2022,3760,3630,7390,5
KWANIA,2023,3860,3720,7580,5
KWANIA,2024,3960,3810,7770,5
KWANIA,2025,4070,3900,7970,5
KWEEN,2015,1700,1510,3210,5
KWEEN,2016,1750,1550,3300,5
KWEEN,2017,1800,1590,3390,5
KWEEN,2018,1860,1630,3490,5
KWEEN,2019,1920,1670,3590,5
KWEEN,2020,1970,1710,3680,5
KWEEN,2021,2030,1750,3780,5
KWEEN,2022,2090,1790,3880,5
KWEEN,2023,2140,1820,3960,5
KWEEN,2024,2200,1860,4060,5
KWEEN,2025,2260,1900,4160,5
KYANKWANZI,2015,3840,3340,7180,5
KYANKWANZI,2016,4040,3500,7540,5
KYANKWANZI,2017,4240,3660,7900,5
KYANKWANZI,2018,4460,3830,8290,5
KYANKWANZI,2019,4680,4000,8680,5
KYANKWANZI,2020,4910,4180,9090,5
KYANKWANZI,2021,5160,4370,9530,5
KYANKWANZI,2022,5400,4560,9960,5
KYANKWANZI,2023,5660,4760,10420,5
KYANKWANZI,2024,5930,4960,10890,5
KYANKWANZI,2025,6200,5170,11370,5
KYEGEGWA,2015,5300,4970,10270,5
KYEGEGWA,2016,5740,5360,11100,5
KYEGEGWA,2017,6210,5790,12000,5
KYEGEGWA,2018,6720,6240,12960,5
KYEGEGWA,2019,7260,6730,13990,5
KYEGEGWA,2020,7850,7250,15100,5
KYEGEGWA,2021,8470,7810,16280,5
KYEGEGWA,2022,9140,8400,17540,5
KYEGEGWA,2023,9860,9030,18890,5
KYEGEGWA,2024,10620,9710,20330,5
KYEGEGWA,2025,11430,10420,21850,5
KYENJOJO,2015,7960,7350,15310,5
KYENJOJO,2016,8280,7620,15900,5
KYENJOJO,2017,8620,7900,16520,5
KYENJOJO,2018,8980,8190,17170,5
KYENJOJO,2019,9330,8480,17810,5
KYENJOJO,2020,9700,8780,18480,5
KYENJOJO,2021,10080,9090,19170,5
KYENJOJO,2022,10460,9400,19860,5
KYENJOJO,2023,10850,9710,20560,5
KYENJOJO,2024,11240,10030,21270,5
KYENJOJO,2025,11640,10350,21990,5
KYOTERA,2015,4300,3490,7790,5
KYOTERA,2016,4270,3460,7730,5
KYOTERA,2017,4250,3440,7690,5
KYOTERA,2018,4290,3460,7750,5
KYOTERA,2019,4450,3560,8010,5
KYOTERA,2020,4440,3730,8170,5
KYOTERA,2021,4460,3750,8210,5
KYOTERA,2022,4480,3760,8240,5
KYOTERA,2023,4490,3760,8250,5
KYOTERA,2024,4500,3770,8270,5
KYOTERA,2025,4510,3760,8270,5
KARENGA,2015,1100,1210,2310,5
KARENGA,2016,1130,1240,2370,5
KARENGA,2017,1150,1270,2420,5
KARENGA,2018,1190,1300,2490,5
KARENGA,2019,1220,1330,2550,5
KARENGA,2020,1260,1360,2620,5
KARENGA,2021,1280,1390,2670,5
KARENGA,2022,1310,1420,2730,5
KARENGA,2023,1340,1450,2790,5
KARENGA,2024,1380,1480,2860,5
KARENGA,2025,1400,1510,2910,5
LAMWO,2015,2430,2290,4720,5
LAMWO,2016,2400,2270,4670,5
LAMWO,2017,2370,2250,4620,5
LAMWO,2018,2380,2260,4640,5
LAMWO,2019,2450,2330,4780,5
LAMWO,2020,2430,2450,4880,5
LAMWO,2021,2420,2460,4880,5
LAMWO,2022,2410,2460,4870,5
LAMWO,2023,2410,2470,4880,5
LAMWO,2024,2390,2470,4860,5
LAMWO,2025,2380,2480,4860,5
LIRA,2015,6400,6020,12420,5
LIRA,2016,6590,6190,12780,5
LIRA,2017,6770,6370,13140,5
LIRA,2018,6960,6550,13510,5
LIRA,2019,7150,6730,13880,5
LIRA,2020,7340,6910,14250,5
LIRA,2021,7530,7100,14630,5
LIRA,2022,7720,7280,15000,5
LIRA,2023,7910,7460,15370,5
LIRA,2024,8090,7650,15740,5
LIRA,2025,8280,7830,16110,5
LUUKA,2015,4290,4210,8500,5
LUUKA,2016,4270,4180,8450,5
LUUKA,2017,4270,4190,8460,5
LUUKA,2018,4320,4230,8550,5
LUUKA,2019,4510,4380,8890,5
LUUKA,2020,4520,4620,9140,5
LUUKA,2021,4550,4660,9210,5
LUUKA,2022,4590,4700,9290,5
LUUKA,2023,4620,4740,9360,5
LUUKA,2024,4660,4770,9430,5
LUUKA,2025,4680,4800,9480,5
LUWERO,2015,7750,7090,14840,5
LUWERO,2016,7750,7080,14830,5
LUWERO,2017,7780,7090,14870,5
LUWERO,2018,7920,7200,15120,5
LUWERO,2019,8300,7470,15770,5
LUWERO,2020,8330,7890,16220,5
LUWERO,2021,8450,7980,16430,5
LUWERO,2022,8560,8070,16630,5
LUWERO,2023,8660,8160,16820,5
LUWERO,2024,8760,8240,17000,5
LUWERO,2025,8840,8300,17140,5
LWENGO,2015,5230,4680,9910,5
LWENGO,2016,5160,4620,9780,5
LWENGO,2017,5110,4570,9680,5
LWENGO,2018,5120,4570,9690,5
LWENGO,2019,5290,4680,9970,5
LWENGO,2020,5230,4880,10110,5
LWENGO,2021,5230,4880,10110,5
LWENGO,2022,5220,4870,10090,5
LWENGO,2023,5200,4860,10060,5
LWENGO,2024,5180,4830,10010,5
LWENGO,2025,5160,4820,9980,5
LYANTONDE,2015,1720,1490,3210,5
LYANTONDE,2016,1740,1490,3230,5
LYANTONDE,2017,1750,1500,3250,5
LYANTONDE,2018,1790,1530,3320,5
LYANTONDE,2019,1870,1600,3470,5
LYANTONDE,2020,1890,1700,3590,5
LYANTONDE,2021,1930,1730,3660,5
LYANTONDE,2022,1970,1760,3730,5
LYANTONDE,2023,2000,1780,3780,5
LYANTONDE,2024,2030,1810,3840,5
LYANTONDE,2025,2060,1830,3890,5
MANAFWA,2015,2540,2560,5100,5
MANAFWA,2016,2610,2620,5230,5
MANAFWA,2017,2670,2680,5350,5
MANAFWA,2018,2740,2740,5480,5
MANAFWA,2019,2800,2800,5600,5
MANAFWA,2020,2870,2860,5730,5
MANAFWA,2021,2940,2910,5850,5
MANAFWA,2022,3000,2970,5970,5
MANAFWA,2023,3060,3030,6090,5
MANAFWA,2024,3130,3080,6210,5
MANAFWA,2025,3190,3140,6330,5
MARACHA,2015,3530,3170,6700,5
MARACHA,2016,3610,3240,6850,5
MARACHA,2017,3680,3300,6980,5
MARACHA,2018,3760,3360,7120,5
MARACHA,2019,3830,3420,7250,5
MARACHA,2020,3910,3480,7390,5
MARACHA,2021,3980,3550,7530,5
MARACHA,2022,4050,3600,7650,5
MARACHA,2023,4120,3670,7790,5
MARACHA,2024,4190,3720,7910,5
MARACHA,2025,4260,3770,8030,5
MASAKA,2015,5030,4430,9460,5
MASAKA,2016,5020,4420,9440,5
MASAKA,2017,5030,4410,9440,5
MASAKA,2018,5110,4470,9580,5
MASAKA,2019,5330,4630,9960,5
MASAKA,2020,5350,4880,10230,5
MASAKA,2021,5400,4940,10340,5
MASAKA,2022,5460,4980,10440,5
MASAKA,2023,5510,5020,10530,5
MASAKA,2024,5550,5060,10610,5
MASAKA,2025,5590,5090,10680,5
MASINDI,2015,4850,4560,9410,5
MASINDI,2016,4990,4680,9670,5
MASINDI,2017,5140,4810,9950,5
MASINDI,2018,5280,4940,10220,5
MASINDI,2019,5430,5070,10500,5
MASINDI,2020,5580,5190,10770,5
MASINDI,2021,5730,5320,11050,5
MASINDI,2022,5880,5450,11330,5
MASINDI,2023,6030,5580,11610,5
MASINDI,2024,6180,5700,11880,5
MASINDI,2025,6330,5830,12160,5
MAYUGE,2015,8910,8310,17220,5
MAYUGE,2016,8980,8380,17360,5
MAYUGE,2017,9070,8460,17530,5
MAYUGE,2018,9290,8650,17940,5
MAYUGE,2019,9780,9050,18830,5
MAYUGE,2020,9890,9640,19530,5
MAYUGE,2021,10090,9830,19920,5
MAYUGE,2022,10290,10020,20310,5
MAYUGE,2023,10470,10210,20680,5
MAYUGE,2024,10660,10380,21040,5
MAYUGE,2025,10820,10550,21370,5
MBALE,2015,7660,7210,14870,5
MBALE,2016,7700,7280,14980,5
MBALE,2017,7770,7370,15140,5
MBALE,2018,7960,7550,15510,5
MBALE,2019,8370,7920,16290,5
MBALE,2020,8450,8460,16910,5
MBALE,2021,8620,8650,17270,5
MBALE,2022,8770,8840,17610,5
MBALE,2023,8920,9020,17940,5
MBALE,2024,9070,9200,18270,5
MBALE,2025,9200,9380,18580,5
MBARARA,2015,5190,4680,9870,5
MBARARA,2016,5310,4790,10100,5
MBARARA,2017,5430,4890,10320,5
MBARARA,2018,5560,4990,10550,5
MBARARA,2019,5680,5100,10780,5
MBARARA,2020,5800,5200,11000,5
MBARARA,2021,5930,5300,11230,5
MBARARA,2022,6040,5400,11440,5
MBARARA,2023,6160,5500,11660,5
MBARARA,2024,6270,5590,11860,5
MBARARA,2025,6380,5690,12070,5
MITOOMA,2015,3410,3070,6480,5
MITOOMA,2016,3450,3100,6550,5
MITOOMA,2017,3490,3130,6620,5
MITOOMA,2018,3540,3160,6700,5
MITOOMA,2019,3570,3180,6750,5
MITOOMA,2020,3610,3210,6820,5
MITOOMA,2021,3650,3230,6880,5
MITOOMA,2022,3680,3250,6930,5
MITOOMA,2023,3710,3270,6980,5
MITOOMA,2024,3740,3290,7030,5
MITOOMA,2025,3770,3300,7070,5
MITYANA,2015,5650,4900,10550,5
MITYANA,2016,5610,4860,10470,5
MITYANA,2017,5600,4840,10440,5
MITYANA,2018,5660,4880,10540,5
MITYANA,2019,5890,5020,10910,5
MITYANA,2020,5880,5280,11160,5
MITYANA,2021,5920,5300,11220,5
MITYANA,2022,5950,5330,11280,5
MITYANA,2023,5980,5350,11330,5
MITYANA,2024,6010,5370,11380,5
MITYANA,2025,6020,5380,11400,5
MOROTO,2015,1990,2010,4000,5
MOROTO,2016,1980,2020,4000,5
MOROTO,2017,1980,2020,4000,5
MOROTO,2018,2010,2050,4060,5
MOROTO,2019,2100,2140,4240,5
MOROTO,2020,2110,2270,4380,5
MOROTO,2021,2130,2300,4430,5
MOROTO,2022,2150,2340,4490,5
MOROTO,2023,2170,2370,4540,5
MOROTO,2024,2190,2390,4580,5
MOROTO,2025,2210,2420,4630,5
MOYO,2015,1620,1490,3110,5
MOYO,2016,1650,1530,3180,5
MOYO,2017,1700,1560,3260,5
MOYO,2018,1740,1590,3330,5
MOYO,2019,1780,1620,3400,5
MOYO,2020,1820,1660,3480,5
MOYO,2021,1870,1690,3560,5
MOYO,2022,1910,1720,3630,5
MOYO,2023,1950,1750,3700,5
MOYO,2024,2000,1790,3790,5
MOYO,2025,2030,1820,3850,5
MPIGI,2015,4450,3990,8440,5
MPIGI,2016,4440,3990,8430,5
MPIGI,2017,4460,4000,8460,5
MPIGI,2018,4540,4060,8600,5
MPIGI,2019,4750,4210,8960,5
MPIGI,2020,4760,4460,9220,5
MPIGI,2021,4820,4510,9330,5
MPIGI,2022,4870,4570,9440,5
MPIGI,2023,4930,4620,9550,5
MPIGI,2024,4980,4660,9640,5
MPIGI,2025,5020,4700,9720,5
MUBENDE,2015,7430,6850,14280,5
MUBENDE,2016,7640,7030,14670,5
MUBENDE,2017,7870,7250,15120,5
MUBENDE,2018,8240,7560,15800,5
MUBENDE,2019,8860,8060,16920,5
MUBENDE,2020,9140,8760,17900,5
MUBENDE,2021,9520,9120,18640,5
MUBENDE,2022,9900,9480,19380,5
MUBENDE,2023,10290,9850,20140,5
MUBENDE,2024,10690,10220,20910,5
MUBENDE,2025,11090,10600,21690,5
MUKONO,2015,9840,8920,18760,5
MUKONO,2016,9870,8970,18840,5
MUKONO,2017,9930,9060,18990,5
MUKONO,2018,10130,9240,19370,5
MUKONO,2019,10630,9650,20280,5
MUKONO,2020,10700,10280,20980,5
MUKONO,2021,10870,10470,21340,5
MUKONO,2022,11040,10660,21700,5
MUKONO,2023,11190,10840,22030,5
MUKONO,2024,11340,11010,22350,5
MUKONO,2025,11470,11180,22650,5
MADI OKOLLO,2015,2590,2330,4920,5
MADI OKOLLO,2016,2660,2400,5060,5
MADI OKOLLO,2017,2750,2450,5200,5
MADI OKOLLO,2018,2820,2520,5340,5
MADI OKOLLO,2019,2900,2590,5490,5
MADI OKOLLO,2020,2980,2650,5630,5
MADI OKOLLO,2021,3050,2720,5770,5
MADI OKOLLO,2022,3140,2790,5930,5
MADI OKOLLO,2023,3220,2850,6070,5
MADI OKOLLO,2024,3290,2920,6210,5
MADI OKOLLO,2025,3370,2980,6350,5
NABILATUK,2015,1330,1380,2710,5
NABILATUK,2016,1360,1420,2780,5
NABILATUK,2017,1400,1450,2850,5
NABILATUK,2018,1460,1500,2960,5
NABILATUK,2019,1570,1590,3160,5
NABILATUK,2020,1620,1720,3340,5
NABILATUK,2021,1680,1780,3460,5
NABILATUK,2022,1750,1840,3590,5
NABILATUK,2023,1810,1900,3710,5
NABILATUK,2024,1880,1960,3840,5
NABILATUK,2025,1950,2020,3970,5
NAKAPIRIPIRIT,2015,1680,1670,3350,5
NAKAPIRIPIRIT,2016,1720,1700,3420,5
NAKAPIRIPIRIT,2017,1760,1740,3500,5
NAKAPIRIPIRIT,2018,1830,1800,3630,5
NAKAPIRIPIRIT,2019,1940,1910,3850,5
NAKAPIRIPIRIT,2020,1990,2050,4040,5
NAKAPIRIPIRIT,2021,2060,2120,4180,5
NAKAPIRIPIRIT,2022,2120,2190,4310,5
NAKAPIRIPIRIT,2023,2190,2260,4450,5
NAKAPIRIPIRIT,2024,2250,2330,4580,5
NAKAPIRIPIRIT,2025,2320,2390,4710,5
NAKASEKE,2015,3190,2830,6020,5
NAKASEKE,2016,3300,2900,6200,5
NAKASEKE,2017,3420,2970,6390,5
NAKASEKE,2018,3550,3040,6590,5
NAKASEKE,2019,3670,3110,6780,5
NAKASEKE,2020,3800,3180,6980,5
NAKASEKE,2021,3930,3250,7180,5
NAKASEKE,2022,4070,3320,7390,5
NAKASEKE,2023,4200,3390,7590,5
NAKASEKE,2024,4330,3460,7790,5
NAKASEKE,2025,4470,3520,7990,5
NAKASONGOLA,2015,3030,2880,5910,5
NAKASONGOLA,2016,3050,2890,5940,5
NAKASONGOLA,2017,3090,2910,6000,5
NAKASONGOLA,2018,3160,2960,6120,5
NAKASONGOLA,2019,3330,3090,6420,5
NAKASONGOLA,2020,3370,3280,6650,5
NAKASONGOLA,2021,3440,3340,6780,5
NAKASONGOLA,2022,3510,3390,6900,5
NAKASONGOLA,2023,3570,3430,7000,5
NAKASONGOLA,2024,3640,3480,7120,5
NAKASONGOLA,2025,3690,3530,7220,5
NAMAYINGO,2015,3980,3730,7710,5
NAMAYINGO,2016,3950,3700,7650,5
NAMAYINGO,2017,3940,3680,7620,5
NAMAYINGO,2018,3990,3710,7700,5
NAMAYINGO,2019,4150,3810,7960,5
NAMAYINGO,2020,4140,4010,8150,5
NAMAYINGO,2021,4170,4020,8190,5
NAMAYINGO,2022,4200,4040,8240,5
NAMAYINGO,2023,4230,4050,8280,5
NAMAYINGO,2024,4240,4050,8290,5
NAMAYINGO,2025,4250,4050,8300,5
NAMISINDWA,2015,3670,3450,7120,5
NAMISINDWA,2016,3780,3530,7310,5
NAMISINDWA,2017,3890,3620,7510,5
NAMISINDWA,2018,3990,3700,7690,5
NAMISINDWA,2019,4100,3790,7890,5
NAMISINDWA,2020,4210,3870,8080,5
NAMISINDWA,2021,4320,3950,8270,5
NAMISINDWA,2022,4430,4040,8470,5
NAMISINDWA,2023,4530,4120,8650,5
NAMISINDWA,2024,4640,4200,8840,5
NAMISINDWA,2025,4740,4280,9020,5
NAMUTUMBA,2015,4940,4710,9650,5
NAMUTUMBA,2016,5000,4740,9740,5
NAMUTUMBA,2017,5060,4800,9860,5
NAMUTUMBA,2018,5210,4930,10140,5
NAMUTUMBA,2019,5510,5150,10660,5
NAMUTUMBA,2020,5590,5510,11100,5
NAMUTUMBA,2021,5720,5630,11350,5
NAMUTUMBA,2022,5850,5740,11590,5
NAMUTUMBA,2023,5980,5860,11840,5
NAMUTUMBA,2024,6110,5980,12090,5
NAMUTUMBA,2025,6230,6080,12310,5
NAPAK,2015,2740,2860,5600,5
NAPAK,2016,2710,2850,5560,5
NAPAK,2017,2700,2850,5550,5
NAPAK,2018,2730,2890,5620,5
NAPAK,2019,2840,2990,5830,5
NAPAK,2020,2820,3160,5980,5
NAPAK,2021,2840,3190,6030,5
NAPAK,2022,2840,3220,6060,5
NAPAK,2023,2860,3250,6110,5
NAPAK,2024,2870,3280,6150,5
NAPAK,2025,2870,3300,6170,5
NEBBI,2015,4490,4090,8580,5
NEBBI,2016,4640,4200,8840,5
NEBBI,2017,4790,4320,9110,5
NEBBI,2018,4940,4440,9380,5
NEBBI,2019,5090,4570,9660,5
NEBBI,2020,5240,4690,9930,5
NEBBI,2021,5390,4810,10200,5
NEBBI,2022,5550,4930,10480,5
NEBBI,2023,5710,5060,10770,5
NEBBI,2024,5860,5180,11040,5
NEBBI,2025,6020,5300,11320,5
NGORA,2015,2520,2390,4910,5
NGORA,2016,2520,2390,4910,5
NGORA,2017,2540,2410,4950,5
NGORA,2018,2600,2450,5050,5
NGORA,2019,2730,2550,5280,5
NGORA,2020,2750,2700,5450,5
NGORA,2021,2800,2750,5550,5
NGORA,2022,2840,2790,5630,5
NGORA,2023,2890,2830,5720,5
NGORA,2024,2930,2870,5800,5
NGORA,2025,2970,2900,5870,5
NTOROKO,2015,1200,1110,2310,5
NTOROKO,2016,1210,1110,2320,5
NTOROKO,2017,1210,1110,2320,5
NTOROKO,2018,1230,1120,2350,5
NTOROKO,2019,1290,1150,2440,5
NTOROKO,2020,1300,1210,2510,5
NTOROKO,2021,1310,1230,2540,5
NTOROKO,2022,1330,1240,2570,5
NTOROKO,2023,1350,1250,2600,5
NTOROKO,2024,1360,1250,2610,5
NTOROKO,2025,1370,1260,2630,5
NTUNGAMO,2015,8510,8130,16640,5
NTUNGAMO,2016,8690,8280,16970,5
NTUNGAMO,2017,8880,8430,17310,5
NTUNGAMO,2018,9060,8580,17640,5
NTUNGAMO,2019,9250,8740,17990,5
NTUNGAMO,2020,9430,8880,18310,5
NTUNGAMO,2021,9620,9030,18650,5
NTUNGAMO,2022,9790,9170,18960,5
NTUNGAMO,2023,9970,9310,19280,5
NTUNGAMO,2024,10140,9450,19590,5
NTUNGAMO,2025,10300,9580,19880,5
NWOYA,2015,2620,2470,5090,5
NWOYA,2016,2900,2730,5630,5
NWOYA,2017,3200,3000,6200,5
NWOYA,2018,3540,3310,6850,5
NWOYA,2019,3900,3640,7540,5
NWOYA,2020,4310,4010,8320,5
NWOYA,2021,4750,4410,9160,5
NWOYA,2022,5230,4840,10070,5
NWOYA,2023,5750,5320,11070,5
NWOYA,2024,6330,5840,12170,5
NWOYA,2025,6950,6410,13360,5
OBONGI,2015,850,730,1580,5
OBONGI,2016,840,720,1560,5
OBONGI,2017,850,730,1580,5
OBONGI,2018,870,740,1610,5
OBONGI,2019,900,770,1670,5
OBONGI,2020,900,810,1710,5
OBONGI,2021,920,820,1740,5
OBONGI,2022,930,820,1750,5
OBONGI,2023,940,840,1780,5
OBONGI,2024,950,840,1790,5
OBONGI,2025,960,850,1810,5
OMORO,2015,2690,2530,5220,5
OMORO,2016,2710,2550,5260,5
OMORO,2017,2750,2590,5340,5
OMORO,2018,2830,2650,5480,5
OMORO,2019,3000,2780,5780,5
OMORO,2020,3040,2980,6020,5
OMORO,2021,3110,3050,6160,5
OMORO,2022,3180,3120,6300,5
OMORO,2023,3260,3190,6450,5
OMORO,2024,3330,3260,6590,5
OMORO,2025,3390,3330,6720,5
OTUKE,2015,1880,1800,3680,5
OTUKE,2016,1960,1870,3830,5
OTUKE,2017,2050,1950,4000,5
OTUKE,2018,2150,2040,4190,5
OTUKE,2019,2240,2120,4360,5
OTUKE,2020,2340,2210,4550,5
OTUKE,2021,2440,2300,4740,5
OTUKE,2022,2540,2390,4930,5
OTUKE,2023,2650,2490,5140,5
OTUKE,2024,2750,2590,5340,5
OTUKE,2025,2860,2680,5540,5
OYAM,2015,6560,6160,12720,5
OYAM,2016,6760,6350,13110,5
OYAM,2017,6970,6530,13500,5
OYAM,2018,7180,6720,13900,5
OYAM,2019,7390,6910,14300,5
OYAM,2020,7600,7100,14700,5
OYAM,2021,7820,7290,15110,5
OYAM,2022,8040,7490,15530,5
OYAM,2023,8250,7680,15930,5
OYAM,2024,8470,7870,16340,5
OYAM,2025,8680,8070,16750,5
PADER,2015,3120,2910,6030,5
PADER,2016,3090,2890,5980,5
PADER,2017,3080,2890,5970,5
PADER,2018,3110,2930,6040,5
PADER,2019,3230,3020,6250,5
PADER,2020,3230,3190,6420,5
PADER,2021,3240,3210,6450,5
PADER,2022,3260,3240,6500,5
PADER,2023,3270,3260,6530,5
PADER,2024,3280,3280,6560,5
PADER,2025,3290,3300,6590,5
PAKWACH,2015,3010,2680,5690,5
PAKWACH,2016,3140,2780,5920,5
PAKWACH,2017,3270,2870,6140,5
PAKWACH,2018,3410,2980,6390,5
PAKWACH,2019,3550,3080,6630,5
PAKWACH,2020,3690,3190,6880,5
PAKWACH,2021,3840,3300,7140,5
PAKWACH,2022,3990,3410,7400,5
PAKWACH,2023,4140,3530,7670,5
PAKWACH,2024,4290,3640,7930,5
PAKWACH,2025,4450,3760,8210,5
PALLISA,2015,5020,4760,9780,5
PALLISA,2016,5110,4850,9960,5
PALLISA,2017,5240,4950,10190,5
PALLISA,2018,5430,5130,10560,5
PALLISA,2019,5790,5430,11220,5
PALLISA,2020,5930,5860,11790,5
PALLISA,2021,6130,6050,12180,5
PALLISA,2022,6340,6240,12580,5
PALLISA,2023,6530,6440,12970,5
PALLISA,2024,6730,6630,13360,5
PALLISA,2025,6930,6820,13750,5
RAKAI,2015,5190,4750,9940,5
RAKAI,2016,5190,4740,9930,5
RAKAI,2017,5210,4760,9970,5
RAKAI,2018,5310,4820,10130,5
RAKAI,2019,5570,5010,10580,5
RAKAI,2020,5590,5300,10890,5
RAKAI,2021,5670,5360,11030,5
RAKAI,2022,5740,5420,11160,5
RAKAI,2023,5820,5480,11300,5
RAKAI,2024,5880,5530,11410,5
RAKAI,2025,5940,5580,11520,5
RUBANDA,2015,3280,3110,6390,5
RUBANDA,2016,3330,3130,6460,5
RUBANDA,2017,3370,3160,6530,5
RUBANDA,2018,3410,3180,6590,5
RUBANDA,2019,3460,3210,6670,5
RUBANDA,2020,3500,3230,6730,5
RUBANDA,2021,3540,3250,6790,5
RUBANDA,2022,3570,3260,6830,5
RUBANDA,2023,3610,3280,6890,5
RUBANDA,2024,3640,3290,6930,5
RUBANDA,2025,3670,3300,6970,5
RUBIRIZI,2015,2370,2230,4600,5
RUBIRIZI,2016,2420,2280,4700,5
RUBIRIZI,2017,2470,2320,4790,5
RUBIRIZI,2018,2510,2360,4870,5
RUBIRIZI,2019,2560,2410,4970,5
RUBIRIZI,2020,2610,2450,5060,5
RUBIRIZI,2021,2660,2490,5150,5
RUBIRIZI,2022,2700,2530,5230,5
RUBIRIZI,2023,2750,2570,5320,5
RUBIRIZI,2024,2790,2610,5400,5
RUBIRIZI,2025,2840,2650,5490,5
RUKIGA,2015,1600,1480,3080,5
RUKIGA,2016,1610,1490,3100,5
RUKIGA,2017,1630,1510,3140,5
RUKIGA,2018,1650,1510,3160,5
RUKIGA,2019,1660,1520,3180,5
RUKIGA,2020,1680,1530,3210,5
RUKIGA,2021,1690,1540,3230,5
RUKIGA,2022,1700,1550,3250,5
RUKIGA,2023,1710,1550,3260,5
RUKIGA,2024,1720,1560,3280,5
RUKIGA,2025,1730,1560,3290,5
RUKUNGIRI,2015,5320,4840,10160,5
RUKUNGIRI,2016,5380,4890,10270,5
RUKUNGIRI,2017,5450,4940,10390,5
RUKUNGIRI,2018,5510,4990,10500,5
RUKUNGIRI,2019,5580,5030,10610,5
RUKUNGIRI,2020,5630,5070,10700,5
RUKUNGIRI,2021,5690,5110,10800,5
RUKUNGIRI,2022,5740,5150,10890,5
RUKUNGIRI,2023,5790,5180,10970,5
RUKUNGIRI,2024,5830,5210,11040,5
RUKUNGIRI,2025,5870,5240,11110,5
RWAMPARA,2015,2190,2050,4240,5
RWAMPARA,2016,2240,2100,4340,5
RWAMPARA,2017,2290,2140,4430,5
RWAMPARA,2018,2340,2190,4530,5
RWAMPARA,2019,2390,2230,4620,5
RWAMPARA,2020,2440,2280,4720,5
RWAMPARA,2021,2490,2320,4810,5
RWAMPARA,2022,2540,2370,4910,5
RWAMPARA,2023,2590,2410,5000,5
RWAMPARA,2024,2640,2460,5100,5
RWAMPARA,2025,2680,2500,5180,5
SERERE,2015,5460,5280,10740,5
SERERE,2016,5550,5360,10910,5
SERERE,2017,5660,5460,11120,5
SERERE,2018,5850,5640,11490,5
SERERE,2019,6220,5940,12160,5
SERERE,2020,6350,6380,12730,5
SERERE,2021,6540,6570,13110,5
SERERE,2022,6720,6750,13470,5
SERERE,2023,6900,6940,13840,5
SERERE,2024,7090,7120,14210,5
SERERE,2025,7270,7290,14560,5
SHEEMA,2015,3230,3000,6230,5
SHEEMA,2016,3270,3030,6300,5
SHEEMA,2017,3310,3070,6380,5
SHEEMA,2018,3350,3100,6450,5
SHEEMA,2019,3380,3130,6510,5
SHEEMA,2020,3420,3160,6580,5
SHEEMA,2021,3460,3180,6640,5
SHEEMA,2022,3490,3210,6700,5
SHEEMA,2023,3520,3230,6750,5
SHEEMA,2024,3550,3250,6800,5
SHEEMA,2025,3570,3270,6840,5
SIRONKO,2015,3960,3600,7560,5
SIRONKO,2016,4060,3680,7740,5
SIRONKO,2017,4160,3750,7910,5
SIRONKO,2018,4250,3830,8080,5
SIRONKO,2019,4350,3900,8250,5
SIRONKO,2020,4450,3970,8420,5
SIRONKO,2021,4540,4050,8590,5
SIRONKO,2022,4640,4120,8760,5
SIRONKO,2023,4730,4190,8920,5
SIRONKO,2024,4820,4260,9080,5
SIRONKO,2025,4910,4330,9240,5
SOROTI,2015,5110,4810,9920,5
SOROTI,2016,5170,4860,10030,5
SOROTI,2017,5250,4930,10180,5
SOROTI,2018,5390,5060,10450,5
SOROTI,2019,5710,5320,11030,5
SOROTI,2020,5800,5680,11480,5
SOROTI,2021,5950,5820,11770,5
SOROTI,2022,6090,5960,12050,5
SOROTI,2023,6230,6090,12320,5
SOROTI,2024,6370,6230,12600,5
SOROTI,2025,6500,6350,12850,5
SSEMBABULE,2015,4610,4280,8890,5
SSEMBABULE,2016,4620,4290,8910,5
SSEMBABULE,2017,4660,4320,8980,5
SSEMBABULE,2018,4760,4400,9160,5
SSEMBABULE,2019,5000,4580,9580,5
SSEMBABULE,2020,5050,4860,9910,5
SSEMBABULE,2021,5130,4940,10070,5
SSEMBABULE,2022,5230,5020,10250,5
SSEMBABULE,2023,5300,5090,10390,5
SSEMBABULE,2024,5380,5160,10540,5
SSEMBABULE,2025,5460,5220,10680,5
TORORO,2015,8980,8220,17200,5
TORORO,2016,9230,8430,17660,5
TORORO,2017,9470,8640,18110,5
TORORO,2018,9720,8850,18570,5
TORORO,2019,9970,9070,19040,5
TORORO,2020,10220,9280,19500,5
TORORO,2021,10470,9490,19960,5
TORORO,2022,10720,9700,20420,5
TORORO,2023,10960,9920,20880,5
TORORO,2024,11210,10120,21330,5
TORORO,2025,11440,10330,21770,5
WAKISO,2015,31850,29630,61480,5
WAKISO,2016,33980,31650,65630,5
WAKISO,2017,36260,33830,70090,5
WAKISO,2018,38660,36110,74770,5
WAKISO,2019,41230,38540,79770,5
WAKISO,2020,43920,41100,85020,5
WAKISO,2021,46740,43830,90570,5
WAKISO,2022,49740,46720,96460,5
WAKISO,2023,52890,49720,102610,5
WAKISO,2024,56180,52890,109070,5
WAKISO,2025,59640,56250,115890,5
YUMBE,2015,10020,10530,20550,5
YUMBE,2016,10270,10900,21170,5
YUMBE,2017,10590,11320,21910,5
YUMBE,2018,11050,11890,22940,5
YUMBE,2019,11860,12770,24630,5
YUMBE,2020,12220,13990,26210,5
YUMBE,2021,12720,14670,27390,5
YUMBE,2022,13200,15360,28560,5
YUMBE,2023,13710,16090,29800,5
YUMBE,2024,14210,16820,31030,5
YUMBE,2025,14720,17560,32280,5
ZOMBO,2015,4720,4330,9050,5
ZOMBO,2016,4870,4450,9320,5
ZOMBO,2017,5010,4580,9590,5
ZOMBO,2018,5170,4700,9870,5
ZOMBO,2019,5320,4830,10150,5
ZOMBO,2020,5480,4960,10440,5
ZOMBO,2021,5630,5080,10710,5
ZOMBO,2022,5790,5210,11000,5
ZOMBO,2023,5950,5340,11290,5
ZOMBO,2024,6110,5470,11580,5
ZOMBO,2025,6260,5600,11860,5
ABIM,2015,250,240,490,50
ABIM,2016,270,240,510,50
ABIM,2017,280,250,530,50
ABIM,2018,310,270,580,50
ABIM,2019,340,310,650,50
ABIM,2020,380,340,720,50
ABIM,2021,410,380,790,50
ABIM,2022,450,410,860,50
ABIM,2023,470,440,910,50
ABIM,2024,500,470,970,50
ABIM,2025,520,500,1020,50
ADJUMANI,2015,600,980,1580,50
ADJUMANI,2016,600,990,1590,50
ADJUMANI,2017,610,990,1600,50
ADJUMANI,2018,610,1000,1610,50
ADJUMANI,2019,620,1010,1630,50
ADJUMANI,2020,620,1020,1640,50
ADJUMANI,2021,620,1030,1650,50
ADJUMANI,2022,630,1040,1670,50
ADJUMANI,2023,630,1040,1670,50
ADJUMANI,2024,630,1050,1680,50
ADJUMANI,2025,630,1050,1680,50
AGAGO,2015,590,1060,1650,50
AGAGO,2016,600,1080,1680,50
AGAGO,2017,610,1090,1700,50
AGAGO,2018,620,1110,1730,50
AGAGO,2019,630,1130,1760,50
AGAGO,2020,640,1150,1790,50
AGAGO,2021,650,1170,1820,50
AGAGO,2022,660,1190,1850,50
AGAGO,2023,670,1200,1870,50
AGAGO,2024,680,1220,1900,50
AGAGO,2025,690,1240,1930,50
ALEBTONG,2015,450,630,1080,50
ALEBTONG,2016,450,620,1070,50
ALEBTONG,2017,460,620,1080,50
ALEBTONG,2018,490,660,1150,50
ALEBTONG,2019,520,710,1230,50
ALEBTONG,2020,560,770,1330,50
ALEBTONG,2021,600,830,1430,50
ALEBTONG,2022,610,870,1480,50
ALEBTONG,2023,630,900,1530,50
ALEBTONG,2024,640,930,1570,50
ALEBTONG,2025,640,950,1590,50
AMOLATAR,2015,310,350,660,50
AMOLATAR,2016,310,350,660,50
AMOLATAR,2017,320,350,670,50
AMOLATAR,2018,340,370,710,50
AMOLATAR,2019,360,390,750,50
AMOLATAR,2020,380,430,810,50
AMOLATAR,2021,410,460,870,50
AMOLATAR,2022,420,480,900,50
AMOLATAR,2023,430,500,930,50
AMOLATAR,2024,430,510,940,50
AMOLATAR,2025,440,520,960,50
AMUDAT,2015,250,190,440,50
AMUDAT,2016,250,190,440,50
AMUDAT,2017,270,190,460,50
AMUDAT,2018,280,210,490,50
AMUDAT,2019,310,240,550,50
AMUDAT,2020,330,260,590,50
AMUDAT,2021,350,280,630,50
AMUDAT,2022,370,300,670,50
AMUDAT,2023,380,320,700,50
AMUDAT,2024,390,330,720,50
AMUDAT,2025,400,350,750,50
AMURIA,2015,380,530,910,50
AMURIA,2016,390,520,910,50
AMURIA,2017,400,540,940,50
AMURIA,2018,430,570,1000,50
AMURIA,2019,470,620,1090,50
AMURIA,2020,500,680,1180,50
AMURIA,2021,530,740,1270,50
AMURIA,2022,570,780,1350,50
AMURIA,2023,580,820,1400,50
AMURIA,2024,600,840,1440,50
AMURIA,2025,610,870,1480,50
AMURU,2015,350,440,790,50
AMURU,2016,360,430,790,50
AMURU,2017,370,440,810,50
AMURU,2018,390,460,850,50
AMURU,2019,410,510,920,50
AMURU,2020,450,550,1000,50
AMURU,2021,470,590,1060,50
AMURU,2022,490,620,1110,50
AMURU,2023,500,640,1140,50
AMURU,2024,500,650,1150,50
AMURU,2025,510,670,1180,50
APAC,2015,490,660,1150,50
APAC,2016,500,680,1180,50
APAC,2017,520,700,1220,50
APAC,2018,540,730,1270,50
APAC,2019,560,750,1310,50
APAC,2020,580,780,1360,50
APAC,2021,600,800,1400,50
APAC,2022,620,830,1450,50
APAC,2023,640,850,1490,50
APAC,2024,660,880,1540,50
APAC,2025,680,910,1590,50
ARUA,2015,1940,2940,4880,50
ARUA,2016,2000,3020,5020,50
ARUA,2017,2060,3100,5160,50
ARUA,2018,2120,3180,5300,50
ARUA,2019,2180,3270,5450,50
ARUA,2020,2230,3350,5580,50
ARUA,2021,2300,3430,5730,50
ARUA,2022,2350,3520,5870,50
ARUA,2023,2410,3600,6010,50
ARUA,2024,2470,3690,6160,50
ARUA,2025,2530,3770,6300,50
BUDAKA,2015,500,500,1000,50
BUDAKA,2016,510,490,1000,50
BUDAKA,2017,530,500,1030,50
BUDAKA,2018,570,530,1100,50
BUDAKA,2019,600,580,1180,50
BUDAKA,2020,650,640,1290,50
BUDAKA,2021,700,680,1380,50
BUDAKA,2022,730,730,1460,50
BUDAKA,2023,760,760,1520,50
BUDAKA,2024,780,780,1560,50
BUDAKA,2025,790,810,1600,50
BUDUDA,2015,470,350,820,50
BUDUDA,2016,480,350,830,50
BUDUDA,2017,500,350,850,50
BUDUDA,2018,540,380,920,50
BUDUDA,2019,590,420,1010,50
BUDUDA,2020,640,460,1100,50
BUDUDA,2021,690,500,1190,50
BUDUDA,2022,730,540,1270,50
BUDUDA,2023,760,570,1330,50
BUDUDA,2024,790,590,1380,50
BUDUDA,2025,810,620,1430,50
BUGIRI,2015,900,1030,1930,50
BUGIRI,2016,910,1020,1930,50
BUGIRI,2017,950,1040,1990,50
BUGIRI,2018,1020,1110,2130,50
BUGIRI,2019,1110,1220,2330,50
BUGIRI,2020,1200,1350,2550,50
BUGIRI,2021,1280,1460,2740,50
BUGIRI,2022,1360,1560,2920,50
BUGIRI,2023,1410,1630,3040,50
BUGIRI,2024,1450,1690,3140,50
BUGIRI,2025,1470,1750,3220,50
BUGWERI,2015,520,590,1110,50
BUGWERI,2016,520,580,1100,50
BUGWERI,2017,540,590,1130,50
BUGWERI,2018,570,620,1190,50
BUGWERI,2019,610,670,1280,50
BUGWERI,2020,650,730,1380,50
BUGWERI,2021,690,780,1470,50
BUGWERI,2022,720,820,1540,50
BUGWERI,2023,740,850,1590,50
BUGWERI,2024,750,870,1620,50
BUGWERI,2025,750,890,1640,50
BUHWEJU,2015,340,470,810,50
BUHWEJU,2016,350,490,840,50
BUHWEJU,2017,370,500,870,50
BUHWEJU,2018,380,520,900,50
BUHWEJU,2019,390,530,920,50
BUHWEJU,2020,400,550,950,50
BUHWEJU,2021,410,560,970,50
BUHWEJU,2022,430,580,1010,50
BUHWEJU,2023,440,590,1030,50
BUHWEJU,2024,450,610,1060,50
BUHWEJU,2025,460,630,1090,50
BUIKWE,2015,1240,1360,2600,50
BUIKWE,2016,1240,1320,2560,50
BUIKWE,2017,1270,1330,2600,50
BUIKWE,2018,1320,1390,2710,50
BUIKWE,2019,1400,1500,2900,50
BUIKWE,2020,1490,1620,3110,50
BUIKWE,2021,1570,1720,3290,50
BUIKWE,2022,1620,1810,3430,50
BUIKWE,2023,1660,1860,3520,50
BUIKWE,2024,1660,1900,3560,50
BUIKWE,2025,1670,1920,3590,50
BUKEDEA,2015,420,540,960,50
BUKEDEA,2016,430,530,960,50
BUKEDEA,2017,450,550,1000,50
BUKEDEA,2018,480,580,1060,50
BUKEDEA,2019,520,640,1160,50
BUKEDEA,2020,570,710,1280,50
BUKEDEA,2021,620,770,1390,50
BUKEDEA,2022,650,820,1470,50
BUKEDEA,2023,680,860,1540,50
BUKEDEA,2024,700,900,1600,50
BUKEDEA,2025,710,930,1640,50
BUKOMANSIMBI,2015,400,470,870,50
BUKOMANSIMBI,2016,400,450,850,50
BUKOMANSIMBI,2017,400,450,850,50
BUKOMANSIMBI,2018,410,460,870,50
BUKOMANSIMBI,2019,440,490,930,50
BUKOMANSIMBI,2020,460,520,980,50
BUKOMANSIMBI,2021,470,550,1020,50
BUKOMANSIMBI,2022,490,560,1050,50
BUKOMANSIMBI,2023,490,570,1060,50
BUKOMANSIMBI,2024,480,570,1050,50
BUKOMANSIMBI,2025,480,570,1050,50
BUKWO,2015,260,270,530,50
BUKWO,2016,280,280,560,50
BUKWO,2017,290,300,590,50
BUKWO,2018,310,310,620,50
BUKWO,2019,320,330,650,50
BUKWO,2020,340,340,680,50
BUKWO,2021,360,360,720,50
BUKWO,2022,380,380,760,50
BUKWO,2023,390,390,780,50
BUKWO,2024,410,410,820,50
BUKWO,2025,430,430,860,50
BULAMBULI,2015,380,400,780,50
BULAMBULI,2016,400,400,800,50
BULAMBULI,2017,420,410,830,50
BULAMBULI,2018,450,440,890,50
BULAMBULI,2019,490,490,980,50
BULAMBULI,2020,540,540,1080,50
BULAMBULI,2021,580,590,1170,50
BULAMBULI,2022,620,640,1260,50
BULAMBULI,2023,640,680,1320,50
BULAMBULI,2024,670,710,1380,50
BULAMBULI,2025,690,740,1430,50
BULIISA,2015,360,530,890,50
BULIISA,2016,380,550,930,50
BULIISA,2017,400,570,970,50
BULIISA,2018,430,600,1030,50
BULIISA,2019,450,620,1070,50
BULIISA,2020,470,650,1120,50
BULIISA,2021,500,680,1180,50
BULIISA,2022,520,710,1230,50
BULIISA,2023,550,740,1290,50
BULIISA,2024,570,770,1340,50
BULIISA,2025,600,800,1400,50
BUNDIBUGYO,2015,510,660,1170,50
BUNDIBUGYO,2016,520,650,1170,50
BUNDIBUGYO,2017,540,660,1200,50
BUNDIBUGYO,2018,570,700,1270,50
BUNDIBUGYO,2019,600,750,1350,50
BUNDIBUGYO,2020,650,820,1470,50
BUNDIBUGYO,2021,690,880,1570,50
BUNDIBUGYO,2022,720,930,1650,50
BUNDIBUGYO,2023,740,970,1710,50
BUNDIBUGYO,2024,750,990,1740,50
BUNDIBUGYO,2025,760,1010,1770,50
BUNYANGABU,2015,400,500,900,50
BUNYANGABU,2016,400,490,890,50
BUNYANGABU,2017,410,490,900,50
BUNYANGABU,2018,430,520,950,50
BUNYANGABU,2019,460,560,1020,50
BUNYANGABU,2020,490,610,1100,50
BUNYANGABU,2021,520,650,1170,50
BUNYANGABU,2022,540,680,1220,50
BUNYANGABU,2023,550,700,1250,50
BUNYANGABU,2024,560,720,1280,50
BUNYANGABU,2025,560,720,1280,50
BUSHENYI,2015,840,1170,2010,50
BUSHENYI,2016,850,1180,2030,50
BUSHENYI,2017,860,1190,2050,50
BUSHENYI,2018,870,1200,2070,50
BUSHENYI,2019,880,1210,2090,50
BUSHENYI,2020,890,1220,2110,50
BUSHENYI,2021,900,1220,2120,50
BUSHENYI,2022,910,1230,2140,50
BUSHENYI,2023,920,1240,2160,50
BUSHENYI,2024,920,1250,2170,50
BUSHENYI,2025,930,1250,2180,50
BUSIA,2015,600,710,1310,50
BUSIA,2016,600,690,1290,50
BUSIA,2017,620,700,1320,50
BUSIA,2018,660,750,1410,50
BUSIA,2019,710,810,1520,50
BUSIA,2020,760,880,1640,50
BUSIA,2021,810,950,1760,50
BUSIA,2022,840,1000,1840,50
BUSIA,2023,870,1030,1900,50
BUSIA,2024,880,1060,1940,50
BUSIA,2025,890,1090,1980,50
BUTALEJA,2015,540,590,1130,50
BUTALEJA,2016,550,590,1140,50
BUTALEJA,2017,570,600,1170,50
BUTALEJA,2018,610,640,1250,50
BUTALEJA,2019,660,690,1350,50
BUTALEJA,2020,710,770,1480,50
BUTALEJA,2021,770,830,1600,50
BUTALEJA,2022,800,880,1680,50
BUTALEJA,2023,840,920,1760,50
BUTALEJA,2024,850,950,1800,50
BUTALEJA,2025,870,970,1840,50
BUTAMBALA,2015,400,380,780,50
BUTAMBALA,2016,400,360,760,50
BUTAMBALA,2017,400,360,760,50
BUTAMBALA,2018,410,380,790,50
BUTAMBALA,2019,440,400,840,50
BUTAMBALA,2020,460,430,890,50
BUTAMBALA,2021,490,450,940,50
BUTAMBALA,2022,490,470,960,50
BUTAMBALA,2023,500,480,980,50
BUTAMBALA,2024,500,480,980,50
BUTAMBALA,2025,500,480,980,50
BUTEBO,2015,230,270,500,50
BUTEBO,2016,220,260,480,50
BUTEBO,2017,230,250,480,50
BUTEBO,2018,240,270,510,50
BUTEBO,2019,250,290,540,50
BUTEBO,2020,270,310,580,50
BUTEBO,2021,280,330,610,50
BUTEBO,2022,290,340,630,50
BUTEBO,2023,290,350,640,50
BUTEBO,2024,290,350,640,50
BUTEBO,2025,290,350,640,50
BUVUMA,2015,480,390,870,50
BUVUMA,2016,510,410,920,50
BUVUMA,2017,550,440,990,50
BUVUMA,2018,580,470,1050,50
BUVUMA,2019,610,500,1110,50
BUVUMA,2020,650,530,1180,50
BUVUMA,2021,690,570,1260,50
BUVUMA,2022,730,610,1340,50
BUVUMA,2023,770,640,1410,50
BUVUMA,2024,820,690,1510,50
BUVUMA,2025,860,730,1590,50
BUYENDE,2015,880,1020,1900,50
BUYENDE,2016,900,1010,1910,50
BUYENDE,2017,940,1040,1980,50
BUYENDE,2018,1010,1120,2130,50
BUYENDE,2019,1090,1230,2320,50
BUYENDE,2020,1190,1360,2550,50
BUYENDE,2021,1280,1480,2760,50
BUYENDE,2022,1360,1590,2950,50
BUYENDE,2023,1420,1670,3090,50
BUYENDE,2024,1450,1740,3190,50
BUYENDE,2025,1500,1800,3300,50
DOKOLO,2015,530,760,1290,50
DOKOLO,2016,540,780,1320,50
DOKOLO,2017,560,800,1360,50
DOKOLO,2018,580,830,1410,50
DOKOLO,2019,590,850,1440,50
DOKOLO,2020,610,870,1480,50
DOKOLO,2021,630,890,1520,50
DOKOLO,2022,640,910,1550,50
DOKOLO,2023,660,940,1600,50
DOKOLO,2024,680,960,1640,50
DOKOLO,2025,700,980,1680,50
GOMBA,2015,470,480,950,50
GOMBA,2016,470,460,930,50
GOMBA,2017,480,460,940,50
GOMBA,2018,500,480,980,50
GOMBA,2019,530,510,1040,50
GOMBA,2020,560,550,1110,50
GOMBA,2021,590,580,1170,50
GOMBA,2022,610,600,1210,50
GOMBA,2023,610,620,1230,50
GOMBA,2024,610,620,1230,50
GOMBA,2025,620,630,1250,50
GULU,2015,760,1100,1860,50
GULU,2016,790,1130,1920,50
GULU,2017,810,1160,1970,50
GULU,2018,830,1190,2020,50
GULU,2019,860,1230,2090,50
GULU,2020,880,1260,2140,50
GULU,2021,910,1300,2210,50
GULU,2022,930,1330,2260,50
GULU,2023,960,1370,2330,50
GULU,2024,980,1400,2380,50
GULU,2025,1010,1430,2440,50
HOIMA,2015,1010,1070,2080,50
HOIMA,2016,1040,1110,2150,50
HOIMA,2017,1080,1140,2220,50
HOIMA,2018,1120,1180,2300,50
HOIMA,2019,1160,1220,2380,50
HOIMA,2020,1210,1270,2480,50
HOIMA,2021,1250,1310,2560,50
HOIMA,2022,1290,1350,2640,50
HOIMA,2023,1340,1390,2730,50
HOIMA,2024,1380,1430,2810,50
HOIMA,2025,1420,1480,2900,50
IBANDA,2015,770,1090,1860,50
IBANDA,2016,790,1110,1900,50
IBANDA,2017,800,1130,1930,50
IBANDA,2018,820,1150,1970,50
IBANDA,2019,830,1170,2000,50
IBANDA,2020,850,1190,2040,50
IBANDA,2021,860,1210,2070,50
IBANDA,2022,880,1230,2110,50
IBANDA,2023,890,1250,2140,50
IBANDA,2024,900,1270,2170,50
IBANDA,2025,920,1280,2200,50
IGANGA,2015,930,1040,1970,50
IGANGA,2016,930,1020,1950,50
IGANGA,2017,970,1040,2010,50
IGANGA,2018,1020,1100,2120,50
IGANGA,2019,1100,1190,2290,50
IGANGA,2020,1180,1300,2480,50
IGANGA,2021,1250,1400,2650,50
IGANGA,2022,1310,1470,2780,50
IGANGA,2023,1350,1530,2880,50
IGANGA,2024,1370,1570,2940,50
IGANGA,2025,1390,1610,3000,50
ISINGIRO,2015,1690,2190,3880,50
ISINGIRO,2016,1750,2260,4010,50
ISINGIRO,2017,1810,2340,4150,50
ISINGIRO,2018,1880,2420,4300,50
ISINGIRO,2019,1950,2510,4460,50
ISINGIRO,2020,2020,2590,4610,50
ISINGIRO,2021,2090,2680,4770,50
ISINGIRO,2022,2160,2770,4930,50
ISINGIRO,2023,2240,2850,5090,50
ISINGIRO,2024,2310,2940,5250,50
ISINGIRO,2025,2380,3030,5410,50
JINJA,2015,1820,2300,4120,50
JINJA,2016,1850,2330,4180,50
JINJA,2017,1880,2370,4250,50
JINJA,2018,1910,2400,4310,50
JINJA,2019,1950,2440,4390,50
JINJA,2020,1970,2470,4440,50
JINJA,2021,2000,2510,4510,50
JINJA,2022,2030,2540,4570,50
JINJA,2023,2060,2570,4630,50
JINJA,2024,2080,2600,4680,50
JINJA,2025,2110,2620,4730,50
KAABONG,2015,350,530,880,50
KAABONG,2016,350,550,900,50
KAABONG,2017,370,560,930,50
KAABONG,2018,370,570,940,50
KAABONG,2019,380,590,970,50
KAABONG,2020,390,600,990,50
KAABONG,2021,400,610,1010,50
KAABONG,2022,410,630,1040,50
KAABONG,2023,420,640,1060,50
KAABONG,2024,430,650,1080,50
KAABONG,2025,440,670,1110,50
KABALE,2015,770,1190,1960,50
KABALE,2016,780,1200,1980,50
KABALE,2017,790,1210,2000,50
KABALE,2018,800,1230,2030,50
KABALE,2019,810,1240,2050,50
KABALE,2020,830,1260,2090,50
KABALE,2021,840,1270,2110,50
KABALE,2022,850,1280,2130,50
KABALE,2023,860,1290,2150,50
KABALE,2024,870,1300,2170,50
KABALE,2025,880,1310,2190,50
KABAROLE,2015,1010,1340,2350,50
KABAROLE,2016,1030,1370,2400,50
KABAROLE,2017,1050,1400,2450,50
KABAROLE,2018,1070,1430,2500,50
KABAROLE,2019,1100,1460,2560,50
KABAROLE,2020,1120,1490,2610,50
KABAROLE,2021,1140,1510,2650,50
KABAROLE,2022,1160,1540,2700,50
KABAROLE,2023,1190,1570,2760,50
KABAROLE,2024,1210,1600,2810,50
KABAROLE,2025,1230,1630,2860,50
KABERAMAIDO,2015,220,210,430,50
KABERAMAIDO,2016,220,210,430,50
KABERAMAIDO,2017,220,220,440,50
KABERAMAIDO,2018,240,230,470,50
KABERAMAIDO,2019,260,260,520,50
KABERAMAIDO,2020,290,280,570,50
KABERAMAIDO,2021,310,310,620,50
KABERAMAIDO,2022,330,330,660,50
KABERAMAIDO,2023,340,340,680,50
KABERAMAIDO,2024,350,350,700,50
KABERAMAIDO,2025,360,370,730,50
KAGADI,2015,960,1250,2210,50
KAGADI,2016,990,1300,2290,50
KAGADI,2017,1030,1350,2380,50
KAGADI,2018,1070,1390,2460,50
KAGADI,2019,1110,1440,2550,50
KAGADI,2020,1140,1490,2630,50
KAGADI,2021,1180,1540,2720,50
KAGADI,2022,1220,1590,2810,50
KAGADI,2023,1270,1640,2910,50
KAGADI,2024,1310,1690,3000,50
KAGADI,2025,1350,1740,3090,50
KAKUMIRO,2015,840,940,1780,50
KAKUMIRO,2016,920,1020,1940,50
KAKUMIRO,2017,1000,1110,2110,50
KAKUMIRO,2018,1080,1200,2280,50
KAKUMIRO,2019,1180,1300,2480,50
KAKUMIRO,2020,1280,1410,2690,50
KAKUMIRO,2021,1390,1530,2920,50
KAKUMIRO,2022,1510,1650,3160,50
KAKUMIRO,2023,1640,1780,3420,50
KAKUMIRO,2024,1780,1930,3710,50
KAKUMIRO,2025,1920,2080,4000,50
KALAKI,2015,300,360,660,50
KALAKI,2016,310,380,690,50
KALAKI,2017,330,390,720,50
KALAKI,2018,340,410,750,50
KALAKI,2019,360,420,780,50
KALAKI,2020,370,440,810,50
KALAKI,2021,390,460,850,50
KALAKI,2022,400,470,870,50
KALAKI,2023,420,490,910,50
KALAKI,2024,430,510,940,50
KALAKI,2025,450,520,970,50
KALANGALA,2015,240,150,390,50
KALANGALA,2016,250,150,400,50
KALANGALA,2017,260,160,420,50
KALANGALA,2018,270,170,440,50
KALANGALA,2019,280,170,450,50
KALANGALA,2020,290,180,470,50
KALANGALA,2021,300,190,490,50
KALANGALA,2022,310,190,500,50
KALANGALA,2023,320,200,520,50
KALANGALA,2024,330,210,540,50
KALANGALA,2025,340,220,560,50
KALIRO,2015,690,700,1390,50
KALIRO,2016,700,690,1390,50
KALIRO,2017,720,700,1420,50
KALIRO,2018,770,750,1520,50
KALIRO,2019,830,820,1650,50
KALIRO,2020,900,890,1790,50
KALIRO,2021,960,970,1930,50
KALIRO,2022,1000,1030,2030,50
KALIRO,2023,1040,1070,2110,50
KALIRO,2024,1060,1100,2160,50
KALIRO,2025,1080,1140,2220,50
KALUNGU,2015,500,580,1080,50
KALUNGU,2016,500,560,1060,50
KALUNGU,2017,500,550,1050,50
KALUNGU,2018,520,570,1090,50
KALUNGU,2019,550,610,1160,50
KALUNGU,2020,580,660,1240,50
KALUNGU,2021,600,690,1290,50
KALUNGU,2022,610,710,1320,50
KALUNGU,2023,620,730,1350,50
KALUNGU,2024,610,740,1350,50
KALUNGU,2025,610,740,1350,50
KAMPALA,2015,4670,4590,9260,50
KAMPALA,2016,4760,4680,9440,50
KAMPALA,2017,4860,4770,9630,50
KAMPALA,2018,4950,4870,9820,50
KAMPALA,2019,5040,4960,10000,50
KAMPALA,2020,5130,5040,10170,50
KAMPALA,2021,5220,5130,10350,50
KAMPALA,2022,5310,5220,10530,50
KAMPALA,2023,5400,5300,10700,50
KAMPALA,2024,5480,5380,10860,50
KAMPALA,2025,5560,5460,11020,50
KAMULI,2015,1390,1630,3020,50
KAMULI,2016,1400,1580,2980,50
KAMULI,2017,1440,1590,3030,50
KAMULI,2018,1520,1680,3200,50
KAMULI,2019,1610,1810,3420,50
KAMULI,2020,1730,1960,3690,50
KAMULI,2021,1820,2090,3910,50
KAMULI,2022,1900,2200,4100,50
KAMULI,2023,1950,2260,4210,50
KAMULI,2024,1970,2310,4280,50
KAMULI,2025,1990,2350,4340,50
KAMWENGE,2015,840,1170,2010,50
KAMWENGE,2016,880,1210,2090,50
KAMWENGE,2017,910,1250,2160,50
KAMWENGE,2018,950,1300,2250,50
KAMWENGE,2019,990,1340,2330,50
KAMWENGE,2020,1020,1390,2410,50
KAMWENGE,2021,1060,1440,2500,50
KAMWENGE,2022,1100,1480,2580,50
KAMWENGE,2023,1140,1530,2670,50
KAMWENGE,2024,1180,1580,2760,50
KAMWENGE,2025,1230,1630,2860,50
KANUNGU,2015,790,1140,1930,50
KANUNGU,2016,810,1160,1970,50
KANUNGU,2017,820,1180,2000,50
KANUNGU,2018,840,1200,2040,50
KANUNGU,2019,850,1220,2070,50
KANUNGU,2020,860,1240,2100,50
KANUNGU,2021,880,1250,2130,50
KANUNGU,2022,890,1270,2160,50
KANUNGU,2023,900,1290,2190,50
KANUNGU,2024,920,1300,2220,50
KANUNGU,2025,930,1320,2250,50
KAPCHORWA,2015,350,390,740,50
KAPCHORWA,2016,360,400,760,50
KAPCHORWA,2017,370,410,780,50
KAPCHORWA,2018,380,430,810,50
KAPCHORWA,2019,400,440,840,50
KAPCHORWA,2020,410,450,860,50
KAPCHORWA,2021,420,460,880,50
KAPCHORWA,2022,430,470,900,50
KAPCHORWA,2023,440,480,920,50
KAPCHORWA,2024,450,490,940,50
KAPCHORWA,2025,460,510,970,50
KAPELEBYONG,2015,180,270,450,50
KAPELEBYONG,2016,180,260,440,50
KAPELEBYONG,2017,190,270,460,50
KAPELEBYONG,2018,200,280,480,50
KAPELEBYONG,2019,220,300,520,50
KAPELEBYONG,2020,240,330,570,50
KAPELEBYONG,2021,250,350,600,50
KAPELEBYONG,2022,260,370,630,50
KAPELEBYONG,2023,260,390,650,50
KAPELEBYONG,2024,280,400,680,50
KAPELEBYONG,2025,270,400,670,50
KASESE,2015,2130,2380,4510,50
KASESE,2016,2130,2320,4450,50
KASESE,2017,2190,2330,4520,50
KASESE,2018,2300,2450,4750,50
KASESE,2019,2450,2640,5090,50
KASESE,2020,2620,2860,5480,50
KASESE,2021,2760,3050,5810,50
KASESE,2022,2870,3200,6070,50
KASESE,2023,2940,3310,6250,50
KASESE,2024,2960,3370,6330,50
KASESE,2025,2980,3430,6410,50
KASSANDA,2015,980,1270,2250,50
KASSANDA,2016,1010,1300,2310,50
KASSANDA,2017,1040,1330,2370,50
KASSANDA,2018,1070,1360,2430,50
KASSANDA,2019,1100,1390,2490,50
KASSANDA,2020,1130,1410,2540,50
KASSANDA,2021,1160,1440,2600,50
KASSANDA,2022,1190,1470,2660,50
KASSANDA,2023,1220,1500,2720,50
KASSANDA,2024,1250,1520,2770,50
KASSANDA,2025,1280,1550,2830,50
KATAKWI,2015,350,390,740,50
KATAKWI,2016,360,380,740,50
KATAKWI,2017,370,390,760,50
KATAKWI,2018,390,410,800,50
KATAKWI,2019,410,440,850,50
KATAKWI,2020,450,480,930,50
KATAKWI,2021,480,520,1000,50
KATAKWI,2022,490,540,1030,50
KATAKWI,2023,510,560,1070,50
KATAKWI,2024,520,570,1090,50
KATAKWI,2025,520,590,1110,50
KAYUNGA,2015,1100,1290,2390,50
KAYUNGA,2016,1100,1250,2350,50
KAYUNGA,2017,1120,1260,2380,50
KAYUNGA,2018,1170,1310,2480,50
KAYUNGA,2019,1240,1410,2650,50
KAYUNGA,2020,1320,1520,2840,50
KAYUNGA,2021,1390,1600,2990,50
KAYUNGA,2022,1440,1680,3120,50
KAYUNGA,2023,1460,1720,3180,50
KAYUNGA,2024,1460,1750,3210,50
KAYUNGA,2025,1470,1770,3240,50
KAZO,2015,680,870,1550,50
KAZO,2016,710,910,1620,50
KAZO,2017,740,940,1680,50
KAZO,2018,760,970,1730,50
KAZO,2019,790,1000,1790,50
KAZO,2020,820,1040,1860,50
KAZO,2021,850,1070,1920,50
KAZO,2022,880,1110,1990,50
KAZO,2023,910,1140,2050,50
KAZO,2024,940,1180,2120,50
KAZO,2025,970,1220,2190,50
KIBAALE,2015,410,400,810,50
KIBAALE,2016,430,420,850,50
KIBAALE,2017,460,440,900,50
KIBAALE,2018,490,470,960,50
KIBAALE,2019,520,500,1020,50
KIBAALE,2020,550,520,1070,50
KIBAALE,2021,580,550,1130,50
KIBAALE,2022,620,580,1200,50
KIBAALE,2023,660,620,1280,50
KIBAALE,2024,700,650,1350,50
KIBAALE,2025,740,680,1420,50
KIBOGA,2015,390,430,820,50
KIBOGA,2016,380,420,800,50
KIBOGA,2017,380,410,790,50
KIBOGA,2018,400,400,800,50
KIBOGA,2019,420,430,850,50
KIBOGA,2020,450,460,910,50
KIBOGA,2021,490,510,1000,50
KIBOGA,2022,500,530,1030,50
KIBOGA,2023,530,560,1090,50
KIBOGA,2024,540,580,1120,50
KIBOGA,2025,550,600,1150,50
KIBUKU,2015,450,500,950,50
KIBUKU,2016,460,500,960,50
KIBUKU,2017,470,510,980,50
KIBUKU,2018,500,540,1040,50
KIBUKU,2019,550,590,1140,50
KIBUKU,2020,590,650,1240,50
KIBUKU,2021,630,700,1330,50
KIBUKU,2022,660,750,1410,50
KIBUKU,2023,680,780,1460,50
KIBUKU,2024,700,810,1510,50
KIBUKU,2025,720,840,1560,50
KIKUUBE,2015,820,880,1700,50
KIKUUBE,2016,870,930,1800,50
KIKUUBE,2017,910,980,1890,50
KIKUUBE,2018,960,1030,1990,50
KIKUUBE,2019,1010,1080,2090,50
KIKUUBE,2020,1070,1130,2200,50
KIKUUBE,2021,1120,1190,2310,50
KIKUUBE,2022,1180,1240,2420,50
KIKUUBE,2023,1240,1300,2540,50
KIKUUBE,2024,1300,1360,2660,50
KIKUUBE,2025,1360,1430,2790,50
KIRUHURA,2015,780,780,1560,50
KIRUHURA,2016,810,810,1620,50
KIRUHURA,2017,840,830,1670,50
KIRUHURA,2018,870,860,1730,50
KIRUHURA,2019,900,890,1790,50
KIRUHURA,2020,940,920,1860,50
KIRUHURA,2021,970,950,1920,50
KIRUHURA,2022,1010,990,2000,50
KIRUHURA,2023,1040,1020,2060,50
KIRUHURA,2024,1070,1050,2120,50
KIRUHURA,2025,1110,1080,2190,50
KIRYANDONGO,2015,560,640,1200,50
KIRYANDONGO,2016,560,630,1190,50
KIRYANDONGO,2017,580,630,1210,50
KIRYANDONGO,2018,610,670,1280,50
KIRYANDONGO,2019,650,720,1370,50
KIRYANDONGO,2020,710,790,1500,50
KIRYANDONGO,2021,750,850,1600,50
KIRYANDONGO,2022,780,890,1670,50
KIRYANDONGO,2023,800,920,1720,50
KIRYANDONGO,2024,820,950,1770,50
KIRYANDONGO,2025,820,970,1790,50
KISORO,2015,670,1020,1690,50
KISORO,2016,670,990,1660,50
KISORO,2017,690,1000,1690,50
KISORO,2018,720,1050,1770,50
KISORO,2019,760,1120,1880,50
KISORO,2020,810,1220,2030,50
KISORO,2021,850,1290,2140,50
KISORO,2022,880,1360,2240,50
KISORO,2023,900,1390,2290,50
KISORO,2024,900,1420,2320,50
KISORO,2025,910,1440,2350,50
KITAGWENDA,2015,480,680,1160,50
KITAGWENDA,2016,500,710,1210,50
KITAGWENDA,2017,520,730,1250,50
KITAGWENDA,2018,550,760,1310,50
KITAGWENDA,2019,570,790,1360,50
KITAGWENDA,2020,590,810,1400,50
KITAGWENDA,2021,610,840,1450,50
KITAGWENDA,2022,640,870,1510,50
KITAGWENDA,2023,660,900,1560,50
KITAGWENDA,2024,680,920,1600,50
KITAGWENDA,2025,710,950,1660,50
KITGUM,2015,380,550,930,50
KITGUM,2016,370,530,900,50
KITGUM,2017,380,540,920,50
KITGUM,2018,400,560,960,50
KITGUM,2019,410,600,1010,50
KITGUM,2020,440,640,1080,50
KITGUM,2021,460,680,1140,50
KITGUM,2022,480,710,1190,50
KITGUM,2023,490,730,1220,50
KITGUM,2024,490,740,1230,50
KITGUM,2025,480,750,1230,50
KOBOKO,2015,420,490,910,50
KOBOKO,2016,430,480,910,50
KOBOKO,2017,440,490,930,50
KOBOKO,2018,470,530,1000,50
KOBOKO,2019,520,580,1100,50
KOBOKO,2020,550,640,1190,50
KOBOKO,2021,600,680,1280,50
KOBOKO,2022,630,730,1360,50
KOBOKO,2023,650,770,1420,50
KOBOKO,2024,670,800,1470,50
KOBOKO,2025,680,820,1500,50
KOLE,2015,600,780,1380,50
KOLE,2016,620,800,1420,50
KOLE,2017,640,820,1460,50
KOLE,2018,660,850,1510,50
KOLE,2019,680,870,1550,50
KOLE,2020,710,900,1610,50
KOLE,2021,730,920,1650,50
KOLE,2022,750,940,1690,50
KOLE,2023,770,970,1740,50
KOLE,2024,790,990,1780,50
KOLE,2025,810,1010,1820,50
KOTIDO,2015,490,460,950,50
KOTIDO,2016,500,450,950,50
KOTIDO,2017,510,450,960,50
KOTIDO,2018,540,480,1020,50
KOTIDO,2019,570,520,1090,50
KOTIDO,2020,610,560,1170,50
KOTIDO,2021,640,590,1230,50
KOTIDO,2022,670,620,1290,50
KOTIDO,2023,680,650,1330,50
KOTIDO,2024,690,650,1340,50
KOTIDO,2025,700,670,1370,50
KUMI,2015,540,640,1180,50
KUMI,2016,540,620,1160,50
KUMI,2017,560,630,1190,50
KUMI,2018,590,670,1260,50
KUMI,2019,630,720,1350,50
KUMI,2020,680,790,1470,50
KUMI,2021,730,850,1580,50
KUMI,2022,760,900,1660,50
KUMI,2023,780,930,1710,50
KUMI,2024,790,950,1740,50
KUMI,2025,810,980,1790,50
KWANIA,2015,460,620,1080,50
KWANIA,2016,480,640,1120,50
KWANIA,2017,490,660,1150,50
KWANIA,2018,510,680,1190,50
KWANIA,2019,520,690,1210,50
KWANIA,2020,540,710,1250,50
KWANIA,2021,550,730,1280,50
KWANIA,2022,570,750,1320,50
KWANIA,2023,580,770,1350,50
KWANIA,2024,600,790,1390,50
KWANIA,2025,610,810,1420,50
KWEEN,2015,300,330,630,50
KWEEN,2016,310,340,650,50
KWEEN,2017,320,350,670,50
KWEEN,2018,330,360,690,50
KWEEN,2019,340,370,710,50
KWEEN,2020,350,380,730,50
KWEEN,2021,360,380,740,50
KWEEN,2022,370,390,760,50
KWEEN,2023,380,400,780,50
KWEEN,2024,390,410,800,50
KWEEN,2025,400,420,820,50
KYANKWANZI,2015,760,780,1540,50
KYANKWANZI,2016,790,820,1610,50
KYANKWANZI,2017,830,850,1680,50
KYANKWANZI,2018,880,890,1770,50
KYANKWANZI,2019,920,930,1850,50
KYANKWANZI,2020,970,980,1950,50
KYANKWANZI,2021,1010,1020,2030,50
KYANKWANZI,2022,1060,1070,2130,50
KYANKWANZI,2023,1110,1110,2220,50
KYANKWANZI,2024,1170,1160,2330,50
KYANKWANZI,2025,1220,1210,2430,50
KYEGEGWA,2015,830,850,1680,50
KYEGEGWA,2016,900,920,1820,50
KYEGEGWA,2017,970,990,1960,50
KYEGEGWA,2018,1050,1070,2120,50
KYEGEGWA,2019,1130,1150,2280,50
KYEGEGWA,2020,1230,1240,2470,50
KYEGEGWA,2021,1320,1340,2660,50
KYEGEGWA,2022,1430,1440,2870,50
KYEGEGWA,2023,1540,1550,3090,50
KYEGEGWA,2024,1660,1660,3320,50
KYEGEGWA,2025,1790,1780,3570,50
KYENJOJO,2015,1130,1310,2440,50
KYENJOJO,2016,1180,1360,2540,50
KYENJOJO,2017,1220,1410,2630,50
KYENJOJO,2018,1270,1460,2730,50
KYENJOJO,2019,1330,1510,2840,50
KYENJOJO,2020,1380,1560,2940,50
KYENJOJO,2021,1430,1620,3050,50
KYENJOJO,2022,1490,1670,3160,50
KYENJOJO,2023,1540,1730,3270,50
KYENJOJO,2024,1600,1780,3380,50
KYENJOJO,2025,1650,1840,3490,50
KYOTERA,2015,540,610,1150,50
KYOTERA,2016,550,590,1140,50
KYOTERA,2017,550,590,1140,50
KYOTERA,2018,580,610,1190,50
KYOTERA,2019,610,650,1260,50
KYOTERA,2020,640,710,1350,50
KYOTERA,2021,680,740,1420,50
KYOTERA,2022,700,770,1470,50
KYOTERA,2023,710,800,1510,50
KYOTERA,2024,710,800,1510,50
KYOTERA,2025,710,810,1520,50
KARENGA,2015,190,200,390,50
KARENGA,2016,200,200,400,50
KARENGA,2017,200,210,410,50
KARENGA,2018,210,210,420,50
KARENGA,2019,220,220,440,50
KARENGA,2020,220,220,440,50
KARENGA,2021,230,230,460,50
KARENGA,2022,230,230,460,50
KARENGA,2023,240,240,480,50
KARENGA,2024,240,240,480,50
KARENGA,2025,250,240,490,50
LAMWO,2015,260,370,630,50
LAMWO,2016,270,360,630,50
LAMWO,2017,270,360,630,50
LAMWO,2018,280,370,650,50
LAMWO,2019,290,400,690,50
LAMWO,2020,300,430,730,50
LAMWO,2021,320,460,780,50
LAMWO,2022,330,480,810,50
LAMWO,2023,330,480,810,50
LAMWO,2024,320,490,810,50
LAMWO,2025,330,500,830,50
LIRA,2015,1060,1570,2630,50
LIRA,2016,1090,1620,2710,50
LIRA,2017,1120,1670,2790,50
LIRA,2018,1150,1710,2860,50
LIRA,2019,1180,1760,2940,50
LIRA,2020,1210,1810,3020,50
LIRA,2021,1240,1860,3100,50
LIRA,2022,1280,1900,3180,50
LIRA,2023,1310,1950,3260,50
LIRA,2024,1340,2000,3340,50
LIRA,2025,1370,2050,3420,50
LUUKA,2015,670,830,1500,50
LUUKA,2016,670,800,1470,50
LUUKA,2017,690,810,1500,50
LUUKA,2018,720,850,1570,50
LUUKA,2019,770,910,1680,50
LUUKA,2020,820,980,1800,50
LUUKA,2021,860,1040,1900,50
LUUKA,2022,890,1100,1990,50
LUUKA,2023,910,1130,2040,50
LUUKA,2024,910,1150,2060,50
LUUKA,2025,920,1170,2090,50
LUWERO,2015,1220,1350,2570,50
LUWERO,2016,1220,1310,2530,50
LUWERO,2017,1250,1310,2560,50
LUWERO,2018,1320,1390,2710,50
LUWERO,2019,1410,1490,2900,50
LUWERO,2020,1500,1620,3120,50
LUWERO,2021,1590,1730,3320,50
LUWERO,2022,1660,1810,3470,50
LUWERO,2023,1700,1870,3570,50
LUWERO,2024,1710,1910,3620,50
LUWERO,2025,1720,1940,3660,50
LWENGO,2015,630,810,1440,50
LWENGO,2016,630,780,1410,50
LWENGO,2017,630,770,1400,50
LWENGO,2018,660,800,1460,50
LWENGO,2019,690,850,1540,50
LWENGO,2020,720,910,1630,50
LWENGO,2021,750,960,1710,50
LWENGO,2022,770,990,1760,50
LWENGO,2023,780,1010,1790,50
LWENGO,2024,780,1020,1800,50
LWENGO,2025,770,1020,1790,50
LYANTONDE,2015,270,250,520,50
LYANTONDE,2016,280,250,530,50
LYANTONDE,2017,290,250,540,50
LYANTONDE,2018,300,260,560,50
LYANTONDE,2019,320,280,600,50
LYANTONDE,2020,350,310,660,50
LYANTONDE,2021,370,330,700,50
LYANTONDE,2022,380,350,730,50
LYANTONDE,2023,400,370,770,50
LYANTONDE,2024,400,370,770,50
LYANTONDE,2025,400,380,780,50
MANAFWA,2015,470,570,1040,50
MANAFWA,2016,480,580,1060,50
MANAFWA,2017,490,590,1080,50
MANAFWA,2018,510,610,1120,50
MANAFWA,2019,520,620,1140,50
MANAFWA,2020,530,630,1160,50
MANAFWA,2021,540,650,1190,50
MANAFWA,2022,560,660,1220,50
MANAFWA,2023,570,670,1240,50
MANAFWA,2024,580,680,1260,50
MANAFWA,2025,590,700,1290,50
MARACHA,2015,590,880,1470,50
MARACHA,2016,600,890,1490,50
MARACHA,2017,610,910,1520,50
MARACHA,2018,630,930,1560,50
MARACHA,2019,640,950,1590,50
MARACHA,2020,650,960,1610,50
MARACHA,2021,660,980,1640,50
MARACHA,2022,670,1000,1670,50
MARACHA,2023,690,1010,1700,50
MARACHA,2024,700,1030,1730,50
MARACHA,2025,710,1040,1750,50
MASAKA,2015,630,710,1340,50
MASAKA,2016,620,690,1310,50
MASAKA,2017,620,660,1280,50
MASAKA,2018,620,640,1260,50
MASAKA,2019,640,640,1280,50
MASAKA,2020,670,680,1350,50
MASAKA,2021,710,720,1430,50
MASAKA,2022,760,780,1540,50
MASAKA,2023,790,830,1620,50
MASAKA,2024,830,870,1700,50
MASAKA,2025,850,900,1750,50
MASINDI,2015,1000,1100,2100,50
MASINDI,2016,1020,1130,2150,50
MASINDI,2017,1050,1160,2210,50
MASINDI,2018,1090,1190,2280,50
MASINDI,2019,1120,1220,2340,50
MASINDI,2020,1150,1250,2400,50
MASINDI,2021,1180,1280,2460,50
MASINDI,2022,1210,1310,2520,50
MASINDI,2023,1240,1340,2580,50
MASINDI,2024,1270,1370,2640,50
MASINDI,2025,1300,1400,2700,50
MAYUGE,2015,1210,1510,2720,50
MAYUGE,2016,1220,1480,2700,50
MAYUGE,2017,1260,1500,2760,50
MAYUGE,2018,1330,1590,2920,50
MAYUGE,2019,1430,1740,3170,50
MAYUGE,2020,1540,1890,3430,50
MAYUGE,2021,1640,2030,3670,50
MAYUGE,2022,1720,2160,3880,50
MAYUGE,2023,1770,2240,4010,50
MAYUGE,2024,1790,2300,4090,50
MAYUGE,2025,1820,2370,4190,50
MBALE,2015,1200,1220,2420,50
MBALE,2016,1210,1200,2410,50
MBALE,2017,1250,1220,2470,50
MBALE,2018,1320,1300,2620,50
MBALE,2019,1420,1410,2830,50
MBALE,2020,1520,1550,3070,50
MBALE,2021,1610,1670,3280,50
MBALE,2022,1690,1770,3460,50
MBALE,2023,1730,1840,3570,50
MBALE,2024,1760,1900,3660,50
MBALE,2025,1790,1960,3750,50
MBARARA,2015,1190,1370,2560,50
MBARARA,2016,1220,1400,2620,50
MBARARA,2017,1240,1430,2670,50
MBARARA,2018,1270,1460,2730,50
MBARARA,2019,1300,1490,2790,50
MBARARA,2020,1330,1520,2850,50
MBARARA,2021,1360,1550,2910,50
MBARARA,2022,1380,1580,2960,50
MBARARA,2023,1410,1610,3020,50
MBARARA,2024,1440,1640,3080,50
MBARARA,2025,1460,1660,3120,50
MITOOMA,2015,530,980,1510,50
MITOOMA,2016,540,990,1530,50
MITOOMA,2017,540,1000,1540,50
MITOOMA,2018,550,1010,1560,50
MITOOMA,2019,560,1020,1580,50
MITOOMA,2020,560,1030,1590,50
MITOOMA,2021,570,1030,1600,50
MITOOMA,2022,570,1040,1610,50
MITOOMA,2023,580,1050,1630,50
MITOOMA,2024,580,1050,1630,50
MITOOMA,2025,590,1060,1650,50
MITYANA,2015,890,990,1880,50
MITYANA,2016,890,960,1850,50
MITYANA,2017,910,960,1870,50
MITYANA,2018,940,1000,1940,50
MITYANA,2019,1000,1070,2070,50
MITYANA,2020,1060,1150,2210,50
MITYANA,2021,1110,1220,2330,50
MITYANA,2022,1150,1280,2430,50
MITYANA,2023,1170,1310,2480,50
MITYANA,2024,1170,1320,2490,50
MITYANA,2025,1170,1340,2510,50
MOROTO,2015,260,240,500,50
MOROTO,2016,260,240,500,50
MOROTO,2017,270,240,510,50
MOROTO,2018,280,250,530,50
MOROTO,2019,300,270,570,50
MOROTO,2020,320,290,610,50
MOROTO,2021,340,310,650,50
MOROTO,2022,350,330,680,50
MOROTO,2023,360,340,700,50
MOROTO,2024,350,350,700,50
MOROTO,2025,360,350,710,50
MOYO,2015,340,430,770,50
MOYO,2016,350,440,790,50
MOYO,2017,360,450,810,50
MOYO,2018,360,460,820,50
MOYO,2019,370,470,840,50
MOYO,2020,380,480,860,50
MOYO,2021,390,480,870,50
MOYO,2022,400,490,890,50
MOYO,2023,410,500,910,50
MOYO,2024,420,510,930,50
MOYO,2025,430,520,950,50
MPIGI,2015,670,730,1400,50
MPIGI,2016,670,710,1380,50
MPIGI,2017,690,720,1410,50
MPIGI,2018,730,760,1490,50
MPIGI,2019,770,820,1590,50
MPIGI,2020,830,890,1720,50
MPIGI,2021,870,950,1820,50
MPIGI,2022,910,990,1900,50
MPIGI,2023,920,1030,1950,50
MPIGI,2024,940,1050,1990,50
MPIGI,2025,940,1070,2010,50
MUBENDE,2015,1020,970,1990,50
MUBENDE,2016,1050,970,2020,50
MUBENDE,2017,1100,1000,2100,50
MUBENDE,2018,1190,1090,2280,50
MUBENDE,2019,1310,1210,2520,50
MUBENDE,2020,1440,1340,2780,50
MUBENDE,2021,1560,1470,3030,50
MUBENDE,2022,1670,1590,3260,50
MUBENDE,2023,1750,1690,3440,50
MUBENDE,2024,1820,1770,3590,50
MUBENDE,2025,1880,1850,3730,50
MUKONO,2015,1540,1750,3290,50
MUKONO,2016,1550,1720,3270,50
MUKONO,2017,1590,1740,3330,50
MUKONO,2018,1680,1840,3520,50
MUKONO,2019,1800,2000,3800,50
MUKONO,2020,1920,2180,4100,50
MUKONO,2021,2040,2330,4370,50
MUKONO,2022,2120,2470,4590,50
MUKONO,2023,2170,2570,4740,50
MUKONO,2024,2190,2640,4830,50
MUKONO,2025,2220,2700,4920,50
NABILATUK,2015,150,140,290,50
NABILATUK,2016,150,140,290,50
NABILATUK,2017,160,150,310,50
NABILATUK,2018,170,160,330,50
NABILATUK,2019,190,180,370,50
NABILATUK,2020,200,190,390,50
NABILATUK,2021,230,210,440,50
NABILATUK,2022,240,230,470,50
NABILATUK,2023,250,240,490,50
NABILATUK,2024,260,250,510,50
NABILATUK,2025,260,260,520,50
NAKAPIRIPIRIT,2015,170,180,350,50
NAKAPIRIPIRIT,2016,180,190,370,50
NAKAPIRIPIRIT,2017,190,190,380,50
NAKAPIRIPIRIT,2018,200,210,410,50
NAKAPIRIPIRIT,2019,220,220,440,50
NAKAPIRIPIRIT,2020,240,250,490,50
NAKAPIRIPIRIT,2021,260,270,530,50
NAKAPIRIPIRIT,2022,270,290,560,50
NAKAPIRIPIRIT,2023,290,310,600,50
NAKAPIRIPIRIT,2024,290,320,610,50
NAKAPIRIPIRIT,2025,290,330,620,50
NAKASEKE,2015,910,1080,1990,50
NAKASEKE,2016,940,1100,2040,50
NAKASEKE,2017,980,1130,2110,50
NAKASEKE,2018,1010,1150,2160,50
NAKASEKE,2019,1050,1180,2230,50
NAKASEKE,2020,1090,1210,2300,50
NAKASEKE,2021,1120,1230,2350,50
NAKASEKE,2022,1160,1260,2420,50
NAKASEKE,2023,1200,1290,2490,50
NAKASEKE,2024,1240,1310,2550,50
NAKASEKE,2025,1270,1340,2610,50
NAKASONGOLA,2015,470,440,910,50
NAKASONGOLA,2016,480,430,910,50
NAKASONGOLA,2017,500,430,930,50
NAKASONGOLA,2018,520,460,980,50
NAKASONGOLA,2019,570,490,1060,50
NAKASONGOLA,2020,610,540,1150,50
NAKASONGOLA,2021,640,580,1220,50
NAKASONGOLA,2022,680,610,1290,50
NAKASONGOLA,2023,690,630,1320,50
NAKASONGOLA,2024,710,650,1360,50
NAKASONGOLA,2025,710,660,1370,50
NAMAYINGO,2015,430,480,910,50
NAMAYINGO,2016,440,460,900,50
NAMAYINGO,2017,440,460,900,50
NAMAYINGO,2018,460,480,940,50
NAMAYINGO,2019,490,520,1010,50
NAMAYINGO,2020,520,560,1080,50
NAMAYINGO,2021,550,590,1140,50
NAMAYINGO,2022,570,610,1180,50
NAMAYINGO,2023,570,630,1200,50
NAMAYINGO,2024,570,630,1200,50
NAMAYINGO,2025,570,640,1210,50
NAMISINDWA,2015,610,640,1250,50
NAMISINDWA,2016,630,650,1280,50
NAMISINDWA,2017,650,670,1320,50
NAMISINDWA,2018,660,680,1340,50
NAMISINDWA,2019,680,700,1380,50
NAMISINDWA,2020,700,710,1410,50
NAMISINDWA,2021,720,730,1450,50
NAMISINDWA,2022,740,740,1480,50
NAMISINDWA,2023,750,760,1510,50
NAMISINDWA,2024,770,770,1540,50
NAMISINDWA,2025,790,790,1580,50
NAMUTUMBA,2015,700,730,1430,50
NAMUTUMBA,2016,720,720,1440,50
NAMUTUMBA,2017,740,730,1470,50
NAMUTUMBA,2018,780,780,1560,50
NAMUTUMBA,2019,840,850,1690,50
NAMUTUMBA,2020,910,930,1840,50
NAMUTUMBA,2021,970,1000,1970,50
NAMUTUMBA,2022,1030,1060,2090,50
NAMUTUMBA,2023,1060,1100,2160,50
NAMUTUMBA,2024,1080,1140,2220,50
NAMUTUMBA,2025,1090,1170,2260,50
NAPAK,2015,260,350,610,50
NAPAK,2016,260,340,600,50
NAPAK,2017,270,340,610,50
NAPAK,2018,280,360,640,50
NAPAK,2019,290,380,670,50
NAPAK,2020,310,410,720,50
NAPAK,2021,330,440,770,50
NAPAK,2022,330,460,790,50
NAPAK,2023,340,480,820,50
NAPAK,2024,340,480,820,50
NAPAK,2025,340,490,830,50
NEBBI,2015,720,950,1670,50
NEBBI,2016,750,980,1730,50
NEBBI,2017,770,1010,1780,50
NEBBI,2018,790,1040,1830,50
NEBBI,2019,820,1070,1890,50
NEBBI,2020,840,1090,1930,50
NEBBI,2021,870,1120,1990,50
NEBBI,2022,890,1150,2040,50
NEBBI,2023,920,1180,2100,50
NEBBI,2024,940,1210,2150,50
NEBBI,2025,970,1240,2210,50
NGORA,2015,350,450,800,50
NGORA,2016,350,440,790,50
NGORA,2017,370,440,810,50
NGORA,2018,380,470,850,50
NGORA,2019,410,510,920,50
NGORA,2020,440,550,990,50
NGORA,2021,470,590,1060,50
NGORA,2022,490,620,1110,50
NGORA,2023,500,650,1150,50
NGORA,2024,510,660,1170,50
NGORA,2025,510,670,1180,50
NTOROKO,2015,220,200,420,50
NTOROKO,2016,220,190,410,50
NTOROKO,2017,220,190,410,50
NTOROKO,2018,230,200,430,50
NTOROKO,2019,250,210,460,50
NTOROKO,2020,270,230,500,50
NTOROKO,2021,280,250,530,50
NTOROKO,2022,290,260,550,50
NTOROKO,2023,290,270,560,50
NTOROKO,2024,300,270,570,50
NTOROKO,2025,300,270,570,50
NTUNGAMO,2015,1720,2480,4200,50
NTUNGAMO,2016,1760,2530,4290,50
NTUNGAMO,2017,1790,2580,4370,50
NTUNGAMO,2018,1830,2620,4450,50
NTUNGAMO,2019,1870,2670,4540,50
NTUNGAMO,2020,1910,2720,4630,50
NTUNGAMO,2021,1940,2760,4700,50
NTUNGAMO,2022,1980,2810,4790,50
NTUNGAMO,2023,2010,2850,4860,50
NTUNGAMO,2024,2050,2890,4940,50
NTUNGAMO,2025,2080,2930,5010,50
NWOYA,2015,420,620,1040,50
NWOYA,2016,460,680,1140,50
NWOYA,2017,510,750,1260,50
NWOYA,2018,570,830,1400,50
NWOYA,2019,620,910,1530,50
NWOYA,2020,690,1000,1690,50
NWOYA,2021,760,1100,1860,50
NWOYA,2022,840,1210,2050,50
NWOYA,2023,920,1330,2250,50
NWOYA,2024,1010,1460,2470,50
NWOYA,2025,1110,1600,2710,50
OBONGI,2015,100,100,200,50
OBONGI,2016,100,100,200,50
OBONGI,2017,100,100,200,50
OBONGI,2018,110,110,220,50
OBONGI,2019,120,120,240,50
OBONGI,2020,120,120,240,50
OBONGI,2021,130,130,260,50
OBONGI,2022,140,140,280,50
OBONGI,2023,140,140,280,50
OBONGI,2024,140,140,280,50
OBONGI,2025,140,150,290,50
OMORO,2015,310,420,730,50
OMORO,2016,320,410,730,50
OMORO,2017,330,420,750,50
OMORO,2018,350,440,790,50
OMORO,2019,380,480,860,50
OMORO,2020,410,530,940,50
OMORO,2021,440,570,1010,50
OMORO,2022,460,600,1060,50
OMORO,2023,480,630,1110,50
OMORO,2024,480,650,1130,50
OMORO,2025,490,670,1160,50
OTUKE,2015,330,530,860,50
OTUKE,2016,340,550,890,50
OTUKE,2017,360,580,940,50
OTUKE,2018,370,600,970,50
OTUKE,2019,390,630,1020,50
OTUKE,2020,410,650,1060,50
OTUKE,2021,430,680,1110,50
OTUKE,2022,440,710,1150,50
OTUKE,2023,460,730,1190,50
OTUKE,2024,480,760,1240,50
OTUKE,2025,500,790,1290,50
OYAM,2015,950,1380,2330,50
OYAM,2016,970,1420,2390,50
OYAM,2017,1000,1460,2460,50
OYAM,2018,1030,1510,2540,50
OYAM,2019,1070,1550,2620,50
OYAM,2020,1100,1590,2690,50
OYAM,2021,1130,1640,2770,50
OYAM,2022,1160,1680,2840,50
OYAM,2023,1190,1720,2910,50
OYAM,2024,1220,1770,2990,50
OYAM,2025,1250,1810,3060,50
PADER,2015,360,500,860,50
PADER,2016,360,490,850,50
PADER,2017,370,490,860,50
PADER,2018,380,510,890,50
PADER,2019,410,550,960,50
PADER,2020,430,590,1020,50
PADER,2021,450,630,1080,50
PADER,2022,470,670,1140,50
PADER,2023,480,680,1160,50
PADER,2024,480,700,1180,50
PADER,2025,470,700,1170,50
PAKWACH,2015,490,620,1110,50
PAKWACH,2016,510,640,1150,50
PAKWACH,2017,530,670,1200,50
PAKWACH,2018,550,690,1240,50
PAKWACH,2019,580,710,1290,50
PAKWACH,2020,600,740,1340,50
PAKWACH,2021,620,760,1380,50
PAKWACH,2022,650,790,1440,50
PAKWACH,2023,670,820,1490,50
PAKWACH,2024,700,840,1540,50
PAKWACH,2025,720,870,1590,50
PALLISA,2015,630,730,1360,50
PALLISA,2016,650,730,1380,50
PALLISA,2017,680,750,1430,50
PALLISA,2018,730,800,1530,50
PALLISA,2019,790,880,1670,50
PALLISA,2020,870,980,1850,50
PALLISA,2021,930,1060,1990,50
PALLISA,2022,990,1140,2130,50
PALLISA,2023,1030,1200,2230,50
PALLISA,2024,1050,1250,2300,50
PALLISA,2025,1090,1300,2390,50
RAKAI,2015,650,810,1460,50
RAKAI,2016,650,790,1440,50
RAKAI,2017,670,790,1460,50
RAKAI,2018,710,830,1540,50
RAKAI,2019,760,900,1660,50
RAKAI,2020,800,970,1770,50
RAKAI,2021,850,1040,1890,50
RAKAI,2022,880,1090,1970,50
RAKAI,2023,910,1120,2030,50
RAKAI,2024,910,1150,2060,50
RAKAI,2025,920,1170,2090,50
RUBANDA,2015,620,1050,1670,50
RUBANDA,2016,630,1060,1690,50
RUBANDA,2017,630,1070,1700,50
RUBANDA,2018,640,1070,1710,50
RUBANDA,2019,650,1080,1730,50
RUBANDA,2020,660,1090,1750,50
RUBANDA,2021,670,1090,1760,50
RUBANDA,2022,670,1100,1770,50
RUBANDA,2023,680,1110,1790,50
RUBANDA,2024,680,1110,1790,50
RUBANDA,2025,690,1110,1800,50
RUBIRIZI,2015,380,610,990,50
RUBIRIZI,2016,390,630,1020,50
RUBIRIZI,2017,400,640,1040,50
RUBIRIZI,2018,410,650,1060,50
RUBIRIZI,2019,410,660,1070,50
RUBIRIZI,2020,420,670,1090,50
RUBIRIZI,2021,430,690,1120,50
RUBIRIZI,2022,440,700,1140,50
RUBIRIZI,2023,440,710,1150,50
RUBIRIZI,2024,450,720,1170,50
RUBIRIZI,2025,460,730,1190,50
RUKIGA,2015,380,530,910,50
RUKIGA,2016,380,540,920,50
RUKIGA,2017,390,540,930,50
RUKIGA,2018,390,540,930,50
RUKIGA,2019,400,550,950,50
RUKIGA,2020,400,550,950,50
RUKIGA,2021,400,550,950,50
RUKIGA,2022,410,560,970,50
RUKIGA,2023,410,560,970,50
RUKIGA,2024,410,560,970,50
RUKIGA,2025,410,560,970,50
RUKUNGIRI,2015,1070,1580,2650,50
RUKUNGIRI,2016,1080,1600,2680,50
RUKUNGIRI,2017,1100,1620,2720,50
RUKUNGIRI,2018,1110,1630,2740,50
RUKUNGIRI,2019,1120,1650,2770,50
RUKUNGIRI,2020,1130,1660,2790,50
RUKUNGIRI,2021,1140,1670,2810,50
RUKUNGIRI,2022,1150,1680,2830,50
RUKUNGIRI,2023,1160,1690,2850,50
RUKUNGIRI,2024,1170,1700,2870,50
RUKUNGIRI,2025,1180,1710,2890,50
RWAMPARA,2015,410,610,1020,50
RWAMPARA,2016,420,630,1050,50
RWAMPARA,2017,430,640,1070,50
RWAMPARA,2018,440,650,1090,50
RWAMPARA,2019,450,670,1120,50
RWAMPARA,2020,460,680,1140,50
RWAMPARA,2021,470,690,1160,50
RWAMPARA,2022,480,710,1190,50
RWAMPARA,2023,490,720,1210,50
RWAMPARA,2024,500,730,1230,50
RWAMPARA,2025,500,740,1240,50
SERERE,2015,670,800,1470,50
SERERE,2016,680,790,1470,50
SERERE,2017,720,810,1530,50
SERERE,2018,760,860,1620,50
SERERE,2019,830,950,1780,50
SERERE,2020,900,1040,1940,50
SERERE,2021,960,1130,2090,50
SERERE,2022,1020,1210,2230,50
SERERE,2023,1050,1260,2310,50
SERERE,2024,1090,1320,2410,50
SERERE,2025,1110,1360,2470,50
SHEEMA,2015,740,1130,1870,50
SHEEMA,2016,750,1140,1890,50
SHEEMA,2017,750,1150,1900,50
SHEEMA,2018,760,1160,1920,50
SHEEMA,2019,770,1170,1940,50
SHEEMA,2020,780,1180,1960,50
SHEEMA,2021,790,1190,1980,50
SHEEMA,2022,800,1200,2000,50
SHEEMA,2023,800,1210,2010,50
SHEEMA,2024,810,1220,2030,50
SHEEMA,2025,810,1230,2040,50
SIRONKO,2015,1180,1200,2380,50
SIRONKO,2016,1210,1230,2440,50
SIRONKO,2017,1240,1250,2490,50
SIRONKO,2018,1270,1280,2550,50
SIRONKO,2019,1300,1300,2600,50
SIRONKO,2020,1320,1320,2640,50
SIRONKO,2021,1350,1350,2700,50
SIRONKO,2022,1380,1370,2750,50
SIRONKO,2023,1410,1400,2810,50
SIRONKO,2024,1440,1420,2860,50
SIRONKO,2025,1460,1440,2900,50
SOROTI,2015,670,840,1510,50
SOROTI,2016,680,820,1500,50
SOROTI,2017,710,840,1550,50
SOROTI,2018,750,890,1640,50
SOROTI,2019,810,980,1790,50
SOROTI,2020,880,1070,1950,50
SOROTI,2021,940,1150,2090,50
SOROTI,2022,990,1230,2220,50
SOROTI,2023,1020,1280,2300,50
SOROTI,2024,1040,1320,2360,50
SOROTI,2025,1060,1360,2420,50
SSEMBABULE,2015,640,680,1320,50
SSEMBABULE,2016,650,660,1310,50
SSEMBABULE,2017,670,670,1340,50
SSEMBABULE,2018,710,710,1420,50
SSEMBABULE,2019,760,770,1530,50
SSEMBABULE,2020,810,830,1640,50
SSEMBABULE,2021,860,890,1750,50
SSEMBABULE,2022,900,940,1840,50
SSEMBABULE,2023,920,970,1890,50
SSEMBABULE,2024,930,1000,1930,50
SSEMBABULE,2025,940,1020,1960,50
TORORO,2015,1580,2090,3670,50
TORORO,2016,1630,2150,3780,50
TORORO,2017,1670,2200,3870,50
TORORO,2018,1710,2250,3960,50
TORORO,2019,1760,2310,4070,50
TORORO,2020,1800,2360,4160,50
TORORO,2021,1850,2420,4270,50
TORORO,2022,1890,2470,4360,50
TORORO,2023,1930,2520,4450,50
TORORO,2024,1980,2580,4560,50
TORORO,2025,2020,2630,4650,50
WAKISO,2015,6790,7000,13790,50
WAKISO,2016,7240,7480,14720,50
WAKISO,2017,7730,8000,15730,50
WAKISO,2018,8240,8540,16780,50
WAKISO,2019,8790,9110,17900,50
WAKISO,2020,9360,9720,19080,50
WAKISO,2021,9960,10360,20320,50
WAKISO,2022,10600,11040,21640,50
WAKISO,2023,11270,11750,23020,50
WAKISO,2024,11970,12500,24470,50
WAKISO,2025,12710,13300,26010,50
YUMBE,2015,990,760,1750,50
YUMBE,2016,1020,760,1780,50
YUMBE,2017,1080,800,1880,50
YUMBE,2018,1170,860,2030,50
YUMBE,2019,1270,970,2240,50
YUMBE,2020,1400,1090,2490,50
YUMBE,2021,1510,1200,2710,50
YUMBE,2022,1620,1300,2920,50
YUMBE,2023,1700,1390,3090,50
YUMBE,2024,1750,1470,3220,50
YUMBE,2025,1810,1550,3360,50
ZOMBO,2015,710,890,1600,50
ZOMBO,2016,730,910,1640,50
ZOMBO,2017,750,940,1690,50
ZOMBO,2018,780,970,1750,50
ZOMBO,2019,800,990,1790,50
ZOMBO,2020,820,1020,1840,50
ZOMBO,2021,850,1040,1890,50
ZOMBO,2022,870,1070,1940,50
ZOMBO,2023,890,1100,1990,50
ZOMBO,2024,920,1120,2040,50
ZOMBO,2025,940,1150,2090,50
MADI OKOLLO,2015,490,720,1210,50
MADI OKOLLO,2016,510,740,1250,50
MADI OKOLLO,2017,520,760,1280,50
MADI OKOLLO,2018,540,780,1320,50
MADI OKOLLO,2019,550,800,1350,50
MADI OKOLLO,2020,570,820,1390,50
MADI OKOLLO,2021,580,840,1420,50
MADI OKOLLO,2022,600,860,1460,50
MADI OKOLLO,2023,610,880,1490,50
MADI OKOLLO,2024,630,900,1530,50
MADI OKOLLO,2025,640,920,1560,50
ABIM,2015,200,210,410,51
ABIM,2016,210,210,420,51
ABIM,2017,220,210,430,51
ABIM,2018,230,220,450,51
ABIM,2019,260,240,500,51
ABIM,2020,290,260,550,51
ABIM,2021,310,290,600,51
ABIM,2022,350,320,670,51
ABIM,2023,380,360,740,51
ABIM,2024,400,380,780,51
ABIM,2025,420,400,820,51
ADJUMANI,2015,360,450,810,51
ADJUMANI,2016,370,450,820,51
ADJUMANI,2017,370,460,830,51
ADJUMANI,2018,370,460,830,51
ADJUMANI,2019,370,460,830,51
ADJUMANI,2020,380,470,850,51
ADJUMANI,2021,380,470,850,51
ADJUMANI,2022,380,470,850,51
ADJUMANI,2023,380,480,860,51
ADJUMANI,2024,380,480,860,51
ADJUMANI,2025,380,480,860,51
AGAGO,2015,420,450,870,51
AGAGO,2016,430,460,890,51
AGAGO,2017,430,470,900,51
AGAGO,2018,440,480,920,51
AGAGO,2019,450,490,940,51
AGAGO,2020,460,490,950,51
AGAGO,2021,460,500,960,51
AGAGO,2022,470,510,980,51
AGAGO,2023,480,520,1000,51
AGAGO,2024,480,520,1000,51
AGAGO,2025,490,530,1020,51
ALEBTONG,2015,550,540,1090,51
ALEBTONG,2016,560,520,1080,51
ALEBTONG,2017,560,510,1070,51
ALEBTONG,2018,580,510,1090,51
ALEBTONG,2019,600,540,1140,51
ALEBTONG,2020,660,580,1240,51
ALEBTONG,2021,700,630,1330,51
ALEBTONG,2022,740,680,1420,51
ALEBTONG,2023,770,710,1480,51
ALEBTONG,2024,790,730,1520,51
ALEBTONG,2025,800,750,1550,51
AMOLATAR,2015,350,400,750,51
AMOLATAR,2016,350,390,740,51
AMOLATAR,2017,360,380,740,51
AMOLATAR,2018,370,380,750,51
AMOLATAR,2019,380,400,780,51
AMOLATAR,2020,410,440,850,51
AMOLATAR,2021,440,460,900,51
AMOLATAR,2022,470,500,970,51
AMOLATAR,2023,480,530,1010,51
AMOLATAR,2024,490,550,1040,51
AMOLATAR,2025,500,550,1050,51
AMUDAT,2015,160,130,290,51
AMUDAT,2016,160,130,290,51
AMUDAT,2017,170,120,290,51
AMUDAT,2018,170,120,290,51
AMUDAT,2019,180,140,320,51
AMUDAT,2020,190,150,340,51
AMUDAT,2021,210,170,380,51
AMUDAT,2022,220,180,400,51
AMUDAT,2023,240,200,440,51
AMUDAT,2024,240,210,450,51
AMUDAT,2025,250,210,460,51
AMURIA,2015,430,420,850,51
AMURIA,2016,430,400,830,51
AMURIA,2017,450,400,850,51
AMURIA,2018,460,400,860,51
AMURIA,2019,490,430,920,51
AMURIA,2020,530,460,990,51
AMURIA,2021,570,520,1090,51
AMURIA,2022,620,560,1180,51
AMURIA,2023,650,590,1240,51
AMURIA,2024,660,610,1270,51
AMURIA,2025,680,630,1310,51
AMURU,2015,350,390,740,51
AMURU,2016,340,360,700,51
AMURU,2017,350,360,710,51
AMURU,2018,360,370,730,51
AMURU,2019,370,390,760,51
AMURU,2020,400,420,820,51
AMURU,2021,430,450,880,51
AMURU,2022,460,480,940,51
AMURU,2023,470,510,980,51
AMURU,2024,480,520,1000,51
AMURU,2025,490,540,1030,51
APAC,2015,290,330,620,51
APAC,2016,300,340,640,51
APAC,2017,310,360,670,51
APAC,2018,320,370,690,51
APAC,2019,330,380,710,51
APAC,2020,350,390,740,51
APAC,2021,360,410,770,51
APAC,2022,370,420,790,51
APAC,2023,380,430,810,51
APAC,2024,400,450,850,51
APAC,2025,410,460,870,51
ARUA,2015,1150,1170,2320,51
ARUA,2016,1180,1200,2380,51
ARUA,2017,1220,1230,2450,51
ARUA,2018,1250,1260,2510,51
ARUA,2019,1290,1300,2590,51
ARUA,2020,1320,1330,2650,51
ARUA,2021,1360,1360,2720,51
ARUA,2022,1390,1400,2790,51
ARUA,2023,1430,1430,2860,51
ARUA,2024,1460,1460,2920,51
ARUA,2025,1500,1500,3000,51
BUDAKA,2015,510,650,1160,51
BUDAKA,2016,520,620,1140,51
BUDAKA,2017,520,620,1140,51
BUDAKA,2018,550,630,1180,51
BUDAKA,2019,580,660,1240,51
BUDAKA,2020,630,730,1360,51
BUDAKA,2021,670,800,1470,51
BUDAKA,2022,720,870,1590,51
BUDAKA,2023,750,910,1660,51
BUDAKA,2024,780,950,1730,51
BUDAKA,2025,800,980,1780,51
BUDUDA,2015,550,460,1010,51
BUDUDA,2016,560,440,1000,51
BUDUDA,2017,580,440,1020,51
BUDUDA,2018,600,450,1050,51
BUDUDA,2019,660,490,1150,51
BUDUDA,2020,710,540,1250,51
BUDUDA,2021,770,590,1360,51
BUDUDA,2022,830,650,1480,51
BUDUDA,2023,890,700,1590,51
BUDUDA,2024,910,730,1640,51
BUDUDA,2025,950,770,1720,51
BUGIRI,2015,920,1040,1960,51
BUGIRI,2016,930,1010,1940,51
BUGIRI,2017,950,1000,1950,51
BUGIRI,2018,990,1020,2010,51
BUGIRI,2019,1050,1090,2140,51
BUGIRI,2020,1150,1190,2340,51
BUGIRI,2021,1240,1310,2550,51
BUGIRI,2022,1330,1420,2750,51
BUGIRI,2023,1410,1510,2920,51
BUGIRI,2024,1450,1590,3040,51
BUGIRI,2025,1500,1640,3140,51
BUGWERI,2015,320,390,710,51
BUGWERI,2016,310,380,690,51
BUGWERI,2017,320,370,690,51
BUGWERI,2018,330,380,710,51
BUGWERI,2019,340,390,730,51
BUGWERI,2020,370,420,790,51
BUGWERI,2021,400,460,860,51
BUGWERI,2022,430,500,930,51
BUGWERI,2023,440,510,950,51
BUGWERI,2024,450,540,990,51
BUGWERI,2025,460,550,1010,51
BUHWEJU,2015,200,270,470,51
BUHWEJU,2016,210,280,490,51
BUHWEJU,2017,220,290,510,51
BUHWEJU,2018,220,290,510,51
BUHWEJU,2019,230,300,530,51
BUHWEJU,2020,240,310,550,51
BUHWEJU,2021,250,320,570,51
BUHWEJU,2022,250,330,580,51
BUHWEJU,2023,260,340,600,51
BUHWEJU,2024,270,350,620,51
BUHWEJU,2025,280,360,640,51
BUIKWE,2015,810,1000,1810,51
BUIKWE,2016,800,960,1760,51
BUIKWE,2017,790,930,1720,51
BUIKWE,2018,820,940,1760,51
BUIKWE,2019,850,980,1830,51
BUIKWE,2020,900,1060,1960,51
BUIKWE,2021,960,1140,2100,51
BUIKWE,2022,1020,1200,2220,51
BUIKWE,2023,1050,1270,2320,51
BUIKWE,2024,1060,1300,2360,51
BUIKWE,2025,1070,1320,2390,51
BUKEDEA,2015,460,570,1030,51
BUKEDEA,2016,470,550,1020,51
BUKEDEA,2017,470,540,1010,51
BUKEDEA,2018,500,560,1060,51
BUKEDEA,2019,540,600,1140,51
BUKEDEA,2020,590,650,1240,51
BUKEDEA,2021,640,720,1360,51
BUKEDEA,2022,680,780,1460,51
BUKEDEA,2023,720,830,1550,51
BUKEDEA,2024,750,870,1620,51
BUKEDEA,2025,770,900,1670,51
BUKOMANSIMBI,2015,340,460,800,51
BUKOMANSIMBI,2016,340,430,770,51
BUKOMANSIMBI,2017,330,410,740,51
BUKOMANSIMBI,2018,330,400,730,51
BUKOMANSIMBI,2019,340,430,770,51
BUKOMANSIMBI,2020,360,450,810,51
BUKOMANSIMBI,2021,390,480,870,51
BUKOMANSIMBI,2022,400,500,900,51
BUKOMANSIMBI,2023,410,510,920,51
BUKOMANSIMBI,2024,400,520,920,51
BUKOMANSIMBI,2025,400,520,920,51
BUKWO,2015,190,150,340,51
BUKWO,2016,200,160,360,51
BUKWO,2017,210,170,380,51
BUKWO,2018,220,180,400,51
BUKWO,2019,230,190,420,51
BUKWO,2020,240,200,440,51
BUKWO,2021,250,210,460,51
BUKWO,2022,270,210,480,51
BUKWO,2023,280,220,500,51
BUKWO,2024,290,230,520,51
BUKWO,2025,310,240,550,51
BULAMBULI,2015,430,500,930,51
BULAMBULI,2016,430,490,920,51
BULAMBULI,2017,450,480,930,51
BULAMBULI,2018,470,500,970,51
BULAMBULI,2019,510,540,1050,51
BULAMBULI,2020,550,600,1150,51
BULAMBULI,2021,600,670,1270,51
BULAMBULI,2022,650,730,1380,51
BULAMBULI,2023,710,790,1500,51
BULAMBULI,2024,730,830,1560,51
BULAMBULI,2025,760,870,1630,51
BULIISA,2015,210,200,410,51
BULIISA,2016,220,210,430,51
BULIISA,2017,240,210,450,51
BULIISA,2018,250,220,470,51
BULIISA,2019,260,230,490,51
BULIISA,2020,270,240,510,51
BULIISA,2021,290,250,540,51
BULIISA,2022,300,260,560,51
BULIISA,2023,320,280,600,51
BULIISA,2024,340,290,630,51
BULIISA,2025,350,300,650,51
BUNDIBUGYO,2015,350,330,680,51
BUNDIBUGYO,2016,350,320,670,51
BUNDIBUGYO,2017,350,320,670,51
BUNDIBUGYO,2018,360,320,680,51
BUNDIBUGYO,2019,380,340,720,51
BUNDIBUGYO,2020,410,370,780,51
BUNDIBUGYO,2021,440,390,830,51
BUNDIBUGYO,2022,470,430,900,51
BUNDIBUGYO,2023,480,450,930,51
BUNDIBUGYO,2024,490,460,950,51
BUNDIBUGYO,2025,500,480,980,51
BUNYANGABU,2015,320,460,780,51
BUNYANGABU,2016,310,440,750,51
BUNYANGABU,2017,320,430,750,51
BUNYANGABU,2018,330,440,770,51
BUNYANGABU,2019,340,450,790,51
BUNYANGABU,2020,370,490,860,51
BUNYANGABU,2021,400,530,930,51
BUNYANGABU,2022,410,570,980,51
BUNYANGABU,2023,440,590,1030,51
BUNYANGABU,2024,430,610,1040,51
BUNYANGABU,2025,440,630,1070,51
BUSHENYI,2015,460,520,980,51
BUSHENYI,2016,470,530,1000,51
BUSHENYI,2017,470,530,1000,51
BUSHENYI,2018,480,540,1020,51
BUSHENYI,2019,480,540,1020,51
BUSHENYI,2020,490,540,1030,51
BUSHENYI,2021,490,550,1040,51
BUSHENYI,2022,500,550,1050,51
BUSHENYI,2023,500,550,1050,51
BUSHENYI,2024,510,560,1070,51
BUSHENYI,2025,510,560,1070,51
BUSIA,2015,750,990,1740,51
BUSIA,2016,760,950,1710,51
BUSIA,2017,770,930,1700,51
BUSIA,2018,790,950,1740,51
BUSIA,2019,830,1000,1830,51
BUSIA,2020,890,1090,1980,51
BUSIA,2021,960,1180,2140,51
BUSIA,2022,1020,1260,2280,51
BUSIA,2023,1070,1330,2400,51
BUSIA,2024,1090,1390,2480,51
BUSIA,2025,1110,1430,2540,51
BUTALEJA,2015,580,650,1230,51
BUTALEJA,2016,590,640,1230,51
BUTALEJA,2017,590,630,1220,51
BUTALEJA,2018,610,630,1240,51
BUTALEJA,2019,660,680,1340,51
BUTALEJA,2020,710,740,1450,51
BUTALEJA,2021,770,810,1580,51
BUTALEJA,2022,830,880,1710,51
BUTALEJA,2023,860,940,1800,51
BUTALEJA,2024,880,980,1860,51
BUTALEJA,2025,900,1000,1900,51
BUTAMBALA,2015,200,190,390,51
BUTAMBALA,2016,200,190,390,51
BUTAMBALA,2017,190,190,380,51
BUTAMBALA,2018,200,180,380,51
BUTAMBALA,2019,210,190,400,51
BUTAMBALA,2020,220,200,420,51
BUTAMBALA,2021,230,210,440,51
BUTAMBALA,2022,240,220,460,51
BUTAMBALA,2023,260,240,500,51
BUTAMBALA,2024,250,240,490,51
BUTAMBALA,2025,250,250,500,51
BUTEBO,2015,300,280,580,51
BUTEBO,2016,290,270,560,51
BUTEBO,2017,280,260,540,51
BUTEBO,2018,290,260,550,51
BUTEBO,2019,300,280,580,51
BUTEBO,2020,310,290,600,51
BUTEBO,2021,340,310,650,51
BUTEBO,2022,350,320,670,51
BUTEBO,2023,360,330,690,51
BUTEBO,2024,370,350,720,51
BUTEBO,2025,370,350,720,51
BUVUMA,2015,230,140,370,51
BUVUMA,2016,250,150,400,51
BUVUMA,2017,260,160,420,51
BUVUMA,2018,280,180,460,51
BUVUMA,2019,300,190,490,51
BUVUMA,2020,310,200,510,51
BUVUMA,2021,330,210,540,51
BUVUMA,2022,350,230,580,51
BUVUMA,2023,370,240,610,51
BUVUMA,2024,390,260,650,51
BUVUMA,2025,420,270,690,51
BUYENDE,2015,700,790,1490,51
BUYENDE,2016,720,770,1490,51
BUYENDE,2017,730,770,1500,51
BUYENDE,2018,770,790,1560,51
BUYENDE,2019,810,840,1650,51
BUYENDE,2020,890,930,1820,51
BUYENDE,2021,970,1020,1990,51
BUYENDE,2022,1050,1120,2170,51
BUYENDE,2023,1110,1190,2300,51
BUYENDE,2024,1150,1250,2400,51
BUYENDE,2025,1190,1300,2490,51
DOKOLO,2015,350,380,730,51
DOKOLO,2016,360,390,750,51
DOKOLO,2017,370,400,770,51
DOKOLO,2018,380,410,790,51
DOKOLO,2019,390,420,810,51
DOKOLO,2020,400,430,830,51
DOKOLO,2021,410,450,860,51
DOKOLO,2022,420,460,880,51
DOKOLO,2023,440,470,910,51
DOKOLO,2024,450,480,930,51
DOKOLO,2025,460,490,950,51
GOMBA,2015,390,490,880,51
GOMBA,2016,390,450,840,51
GOMBA,2017,380,440,820,51
GOMBA,2018,400,440,840,51
GOMBA,2019,410,450,860,51
GOMBA,2020,440,490,930,51
GOMBA,2021,460,520,980,51
GOMBA,2022,490,540,1030,51
GOMBA,2023,500,570,1070,51
GOMBA,2024,510,580,1090,51
GOMBA,2025,500,580,1080,51
GULU,2015,350,470,820,51
GULU,2016,360,480,840,51
GULU,2017,370,490,860,51
GULU,2018,380,510,890,51
GULU,2019,400,520,920,51
GULU,2020,410,540,950,51
GULU,2021,420,550,970,51
GULU,2022,430,570,1000,51
GULU,2023,440,580,1020,51
GULU,2024,450,600,1050,51
GULU,2025,460,610,1070,51
HOIMA,2015,580,540,1120,51
HOIMA,2016,600,560,1160,51
HOIMA,2017,630,580,1210,51
HOIMA,2018,650,600,1250,51
HOIMA,2019,670,620,1290,51
HOIMA,2020,700,640,1340,51
HOIMA,2021,720,660,1380,51
HOIMA,2022,750,680,1430,51
HOIMA,2023,770,700,1470,51
HOIMA,2024,800,720,1520,51
HOIMA,2025,820,740,1560,51
IBANDA,2015,480,620,1100,51
IBANDA,2016,490,630,1120,51
IBANDA,2017,500,640,1140,51
IBANDA,2018,510,650,1160,51
IBANDA,2019,520,670,1190,51
IBANDA,2020,530,680,1210,51
IBANDA,2021,540,690,1230,51
IBANDA,2022,550,700,1250,51
IBANDA,2023,560,710,1270,51
IBANDA,2024,560,720,1280,51
IBANDA,2025,570,730,1300,51
IGANGA,2015,620,810,1430,51
IGANGA,2016,610,780,1390,51
IGANGA,2017,630,750,1380,51
IGANGA,2018,640,770,1410,51
IGANGA,2019,680,810,1490,51
IGANGA,2020,740,890,1630,51
IGANGA,2021,790,950,1740,51
IGANGA,2022,840,1030,1870,51
IGANGA,2023,890,1090,1980,51
IGANGA,2024,900,1130,2030,51
IGANGA,2025,920,1160,2080,51
ISINGIRO,2015,1040,1210,2250,51
ISINGIRO,2016,1080,1250,2330,51
ISINGIRO,2017,1120,1300,2420,51
ISINGIRO,2018,1160,1340,2500,51
ISINGIRO,2019,1210,1390,2600,51
ISINGIRO,2020,1250,1440,2690,51
ISINGIRO,2021,1290,1480,2770,51
ISINGIRO,2022,1340,1530,2870,51
ISINGIRO,2023,1380,1580,2960,51
ISINGIRO,2024,1430,1630,3060,51
ISINGIRO,2025,1470,1680,3150,51
JINJA,2015,830,900,1730,51
JINJA,2016,840,910,1750,51
JINJA,2017,860,930,1790,51
JINJA,2018,870,940,1810,51
JINJA,2019,890,960,1850,51
JINJA,2020,900,970,1870,51
JINJA,2021,910,980,1890,51
JINJA,2022,920,1000,1920,51
JINJA,2023,940,1010,1950,51
JINJA,2024,950,1020,1970,51
JINJA,2025,960,1030,1990,51
KAABONG,2015,180,240,420,51
KAABONG,2016,190,240,430,51
KAABONG,2017,200,250,450,51
KAABONG,2018,200,250,450,51
KAABONG,2019,210,260,470,51
KAABONG,2020,210,270,480,51
KAABONG,2021,220,270,490,51
KAABONG,2022,220,280,500,51
KAABONG,2023,230,280,510,51
KAABONG,2024,230,290,520,51
KAABONG,2025,240,290,530,51
KABALE,2015,470,660,1130,51
KABALE,2016,480,670,1150,51
KABALE,2017,490,680,1170,51
KABALE,2018,490,690,1180,51
KABALE,2019,500,690,1190,51
KABALE,2020,510,700,1210,51
KABALE,2021,520,710,1230,51
KABALE,2022,520,710,1230,51
KABALE,2023,530,720,1250,51
KABALE,2024,530,730,1260,51
KABALE,2025,540,730,1270,51
KABAROLE,2015,460,570,1030,51
KABAROLE,2016,470,580,1050,51
KABAROLE,2017,480,600,1080,51
KABAROLE,2018,490,610,1100,51
KABAROLE,2019,500,620,1120,51
KABAROLE,2020,510,630,1140,51
KABAROLE,2021,520,650,1170,51
KABAROLE,2022,530,660,1190,51
KABAROLE,2023,540,670,1210,51
KABAROLE,2024,550,680,1230,51
KABAROLE,2025,560,690,1250,51
KABERAMAIDO,2015,270,250,520,51
KABERAMAIDO,2016,270,250,520,51
KABERAMAIDO,2017,280,250,530,51
KABERAMAIDO,2018,290,260,550,51
KABERAMAIDO,2019,320,260,580,51
KABERAMAIDO,2020,340,290,630,51
KABERAMAIDO,2021,370,320,690,51
KABERAMAIDO,2022,400,350,750,51
KABERAMAIDO,2023,420,380,800,51
KABERAMAIDO,2024,430,400,830,51
KABERAMAIDO,2025,440,410,850,51
KAGADI,2015,530,660,1190,51
KAGADI,2016,550,680,1230,51
KAGADI,2017,570,710,1280,51
KAGADI,2018,590,730,1320,51
KAGADI,2019,610,760,1370,51
KAGADI,2020,630,780,1410,51
KAGADI,2021,650,810,1460,51
KAGADI,2022,670,840,1510,51
KAGADI,2023,700,860,1560,51
KAGADI,2024,720,890,1610,51
KAGADI,2025,740,920,1660,51
KAKUMIRO,2015,650,590,1240,51
KAKUMIRO,2016,700,640,1340,51
KAKUMIRO,2017,770,700,1470,51
KAKUMIRO,2018,830,760,1590,51
KAKUMIRO,2019,910,820,1730,51
KAKUMIRO,2020,990,890,1880,51
KAKUMIRO,2021,1070,960,2030,51
KAKUMIRO,2022,1160,1040,2200,51
KAKUMIRO,2023,1260,1120,2380,51
KAKUMIRO,2024,1370,1210,2580,51
KAKUMIRO,2025,1480,1310,2790,51
KALAKI,2015,210,180,390,51
KALAKI,2016,220,190,410,51
KALAKI,2017,230,200,430,51
KALAKI,2018,240,210,450,51
KALAKI,2019,250,210,460,51
KALAKI,2020,260,220,480,51
KALAKI,2021,270,230,500,51
KALAKI,2022,280,240,520,51
KALAKI,2023,300,250,550,51
KALAKI,2024,310,260,570,51
KALAKI,2025,320,270,590,51
KALANGALA,2015,160,70,230,51
KALANGALA,2016,160,70,230,51
KALANGALA,2017,170,80,250,51
KALANGALA,2018,180,80,260,51
KALANGALA,2019,180,80,260,51
KALANGALA,2020,190,80,270,51
KALANGALA,2021,190,90,280,51
KALANGALA,2022,200,90,290,51
KALANGALA,2023,210,90,300,51
KALANGALA,2024,210,100,310,51
KALANGALA,2025,220,100,320,51
KALIRO,2015,580,530,1110,51
KALIRO,2016,590,520,1110,51
KALIRO,2017,600,510,1110,51
KALIRO,2018,610,520,1130,51
KALIRO,2019,660,550,1210,51
KALIRO,2020,710,600,1310,51
KALIRO,2021,770,660,1430,51
KALIRO,2022,810,700,1510,51
KALIRO,2023,860,760,1620,51
KALIRO,2024,880,780,1660,51
KALIRO,2025,900,810,1710,51
KALUNGU,2015,360,530,890,51
KALUNGU,2016,350,490,840,51
KALUNGU,2017,350,470,820,51
KALUNGU,2018,350,470,820,51
KALUNGU,2019,370,490,860,51
KALUNGU,2020,380,520,900,51
KALUNGU,2021,400,560,960,51
KALUNGU,2022,430,590,1020,51
KALUNGU,2023,440,610,1050,51
KALUNGU,2024,430,610,1040,51
KALUNGU,2025,430,630,1060,51
KAMPALA,2015,2090,2100,4190,51
KAMPALA,2016,2130,2140,4270,51
KAMPALA,2017,2180,2180,4360,51
KAMPALA,2018,2220,2220,4440,51
KAMPALA,2019,2260,2260,4520,51
KAMPALA,2020,2300,2310,4610,51
KAMPALA,2021,2340,2350,4690,51
KAMPALA,2022,2380,2380,4760,51
KAMPALA,2023,2420,2420,4840,51
KAMPALA,2024,2460,2460,4920,51
KAMPALA,2025,2490,2500,4990,51
KAMULI,2015,1010,1310,2320,51
KAMULI,2016,1010,1250,2260,51
KAMULI,2017,1020,1210,2230,51
KAMULI,2018,1050,1220,2270,51
KAMULI,2019,1100,1280,2380,51
KAMULI,2020,1180,1390,2570,51
KAMULI,2021,1260,1500,2760,51
KAMULI,2022,1330,1600,2930,51
KAMULI,2023,1380,1680,3060,51
KAMULI,2024,1410,1730,3140,51
KAMULI,2025,1420,1760,3180,51
KAMWENGE,2015,520,570,1090,51
KAMWENGE,2016,540,590,1130,51
KAMWENGE,2017,560,610,1170,51
KAMWENGE,2018,580,630,1210,51
KAMWENGE,2019,600,650,1250,51
KAMWENGE,2020,630,680,1310,51
KAMWENGE,2021,650,700,1350,51
KAMWENGE,2022,680,720,1400,51
KAMWENGE,2023,700,750,1450,51
KAMWENGE,2024,730,770,1500,51
KAMWENGE,2025,750,790,1540,51
KANUNGU,2015,530,650,1180,51
KANUNGU,2016,540,660,1200,51
KANUNGU,2017,550,670,1220,51
KANUNGU,2018,560,680,1240,51
KANUNGU,2019,570,690,1260,51
KANUNGU,2020,580,700,1280,51
KANUNGU,2021,590,710,1300,51
KANUNGU,2022,600,720,1320,51
KANUNGU,2023,610,730,1340,51
KANUNGU,2024,620,740,1360,51
KANUNGU,2025,620,750,1370,51
KAPCHORWA,2015,210,190,400,51
KAPCHORWA,2016,220,200,420,51
KAPCHORWA,2017,230,200,430,51
KAPCHORWA,2018,230,210,440,51
KAPCHORWA,2019,240,210,450,51
KAPCHORWA,2020,250,220,470,51
KAPCHORWA,2021,250,220,470,51
KAPCHORWA,2022,260,230,490,51
KAPCHORWA,2023,270,230,500,51
KAPCHORWA,2024,280,240,520,51
KAPCHORWA,2025,280,240,520,51
KAPELEBYONG,2015,230,190,420,51
KAPELEBYONG,2016,240,180,420,51
KAPELEBYONG,2017,230,190,420,51
KAPELEBYONG,2018,240,180,420,51
KAPELEBYONG,2019,250,200,450,51
KAPELEBYONG,2020,270,210,480,51
KAPELEBYONG,2021,300,240,540,51
KAPELEBYONG,2022,310,250,560,51
KAPELEBYONG,2023,330,260,590,51
KAPELEBYONG,2024,330,280,610,51
KAPELEBYONG,2025,340,280,620,51
KASESE,2015,1250,1310,2560,51
KASESE,2016,1240,1260,2500,51
KASESE,2017,1250,1220,2470,51
KASESE,2018,1280,1230,2510,51
KASESE,2019,1350,1290,2640,51
KASESE,2020,1440,1390,2830,51
KASESE,2021,1530,1500,3030,51
KASESE,2022,1620,1600,3220,51
KASESE,2023,1680,1680,3360,51
KASESE,2024,1720,1730,3450,51
KASESE,2025,1740,1760,3500,51
KASSANDA,2015,440,510,950,51
KASSANDA,2016,450,520,970,51
KASSANDA,2017,460,530,990,51
KASSANDA,2018,480,540,1020,51
KASSANDA,2019,490,550,1040,51
KASSANDA,2020,500,560,1060,51
KASSANDA,2021,510,580,1090,51
KASSANDA,2022,530,590,1120,51
KASSANDA,2023,540,600,1140,51
KASSANDA,2024,550,610,1160,51
KASSANDA,2025,570,620,1190,51
KATAKWI,2015,420,400,820,51
KATAKWI,2016,420,390,810,51
KATAKWI,2017,420,380,800,51
KATAKWI,2018,440,380,820,51
KATAKWI,2019,460,400,860,51
KATAKWI,2020,490,440,930,51
KATAKWI,2021,530,480,1010,51
KATAKWI,2022,560,500,1060,51
KATAKWI,2023,590,530,1120,51
KATAKWI,2024,600,550,1150,51
KATAKWI,2025,610,570,1180,51
KAYUNGA,2015,800,930,1730,51
KAYUNGA,2016,780,900,1680,51
KAYUNGA,2017,780,860,1640,51
KAYUNGA,2018,790,860,1650,51
KAYUNGA,2019,840,900,1740,51
KAYUNGA,2020,890,970,1860,51
KAYUNGA,2021,940,1040,1980,51
KAYUNGA,2022,990,1100,2090,51
KAYUNGA,2023,1020,1150,2170,51
KAYUNGA,2024,1030,1180,2210,51
KAYUNGA,2025,1040,1200,2240,51
KAZO,2015,510,480,990,51
KAZO,2016,530,490,1020,51
KAZO,2017,550,510,1060,51
KAZO,2018,570,530,1100,51
KAZO,2019,600,550,1150,51
KAZO,2020,620,570,1190,51
KAZO,2021,640,590,1230,51
KAZO,2022,660,610,1270,51
KAZO,2023,680,620,1300,51
KAZO,2024,710,640,1350,51
KAZO,2025,730,660,1390,51
KIBAALE,2015,270,270,540,51
KIBAALE,2016,290,290,580,51
KIBAALE,2017,310,310,620,51
KIBAALE,2018,330,320,650,51
KIBAALE,2019,350,340,690,51
KIBAALE,2020,370,360,730,51
KIBAALE,2021,390,380,770,51
KIBAALE,2022,420,400,820,51
KIBAALE,2023,440,420,860,51
KIBAALE,2024,470,450,920,51
KIBAALE,2025,490,470,960,51
KIBOGA,2015,370,390,760,51
KIBOGA,2016,380,370,750,51
KIBOGA,2017,380,360,740,51
KIBOGA,2018,380,350,730,51
KIBOGA,2019,390,350,740,51
KIBOGA,2020,420,370,790,51
KIBOGA,2021,440,400,840,51
KIBOGA,2022,470,440,910,51
KIBOGA,2023,500,470,970,51
KIBOGA,2024,520,490,1010,51
KIBOGA,2025,530,510,1040,51
KIBUKU,2015,530,560,1090,51
KIBUKU,2016,520,530,1050,51
KIBUKU,2017,540,520,1060,51
KIBUKU,2018,560,540,1100,51
KIBUKU,2019,590,580,1170,51
KIBUKU,2020,640,620,1260,51
KIBUKU,2021,700,690,1390,51
KIBUKU,2022,740,750,1490,51
KIBUKU,2023,780,790,1570,51
KIBUKU,2024,810,830,1640,51
KIBUKU,2025,830,860,1690,51
KIKUUBE,2015,470,500,970,51
KIKUUBE,2016,490,520,1010,51
KIKUUBE,2017,520,550,1070,51
KIKUUBE,2018,550,580,1130,51
KIKUUBE,2019,580,600,1180,51
KIKUUBE,2020,610,640,1250,51
KIKUUBE,2021,640,670,1310,51
KIKUUBE,2022,670,700,1370,51
KIKUUBE,2023,700,730,1430,51
KIKUUBE,2024,740,770,1510,51
KIKUUBE,2025,770,800,1570,51
KIRUHURA,2015,370,350,720,51
KIRUHURA,2016,380,360,740,51
KIRUHURA,2017,400,380,780,51
KIRUHURA,2018,410,390,800,51
KIRUHURA,2019,430,400,830,51
KIRUHURA,2020,450,420,870,51
KIRUHURA,2021,460,430,890,51
KIRUHURA,2022,480,440,920,51
KIRUHURA,2023,490,460,950,51
KIRUHURA,2024,510,470,980,51
KIRUHURA,2025,530,490,1020,51
KIRYANDONGO,2015,590,630,1220,51
KIRYANDONGO,2016,590,600,1190,51
KIRYANDONGO,2017,590,580,1170,51
KIRYANDONGO,2018,610,580,1190,51
KIRYANDONGO,2019,640,630,1270,51
KIRYANDONGO,2020,700,680,1380,51
KIRYANDONGO,2021,740,730,1470,51
KIRYANDONGO,2022,800,790,1590,51
KIRYANDONGO,2023,830,830,1660,51
KIRYANDONGO,2024,850,860,1710,51
KIRYANDONGO,2025,860,870,1730,51
KISORO,2015,580,770,1350,51
KISORO,2016,560,740,1300,51
KISORO,2017,560,720,1280,51
KISORO,2018,580,720,1300,51
KISORO,2019,600,750,1350,51
KISORO,2020,640,810,1450,51
KISORO,2021,690,870,1560,51
KISORO,2022,720,920,1640,51
KISORO,2023,750,970,1720,51
KISORO,2024,750,990,1740,51
KISORO,2025,760,1010,1770,51
KITAGWENDA,2015,290,330,620,51
KITAGWENDA,2016,300,340,640,51
KITAGWENDA,2017,310,350,660,51
KITAGWENDA,2018,320,360,680,51
KITAGWENDA,2019,340,370,710,51
KITAGWENDA,2020,350,390,740,51
KITAGWENDA,2021,360,400,760,51
KITAGWENDA,2022,380,410,790,51
KITAGWENDA,2023,390,430,820,51
KITAGWENDA,2024,410,440,850,51
KITAGWENDA,2025,420,450,870,51
KITGUM,2015,440,540,980,51
KITGUM,2016,430,510,940,51
KITGUM,2017,430,490,920,51
KITGUM,2018,440,490,930,51
KITGUM,2019,460,510,970,51
KITGUM,2020,480,560,1040,51
KITGUM,2021,510,590,1100,51
KITGUM,2022,530,630,1160,51
KITGUM,2023,560,650,1210,51
KITGUM,2024,550,670,1220,51
KITGUM,2025,560,670,1230,51
KOBOKO,2015,390,320,710,51
KOBOKO,2016,390,310,700,51
KOBOKO,2017,410,310,720,51
KOBOKO,2018,420,320,740,51
KOBOKO,2019,450,340,790,51
KOBOKO,2020,490,370,860,51
KOBOKO,2021,530,410,940,51
KOBOKO,2022,560,440,1000,51
KOBOKO,2023,600,470,1070,51
KOBOKO,2024,610,490,1100,51
KOBOKO,2025,640,510,1150,51
KOLE,2015,390,420,810,51
KOLE,2016,400,430,830,51
KOLE,2017,410,440,850,51
KOLE,2018,430,460,890,51
KOLE,2019,440,470,910,51
KOLE,2020,450,480,930,51
KOLE,2021,470,500,970,51
KOLE,2022,480,510,990,51
KOLE,2023,500,520,1020,51
KOLE,2024,510,530,1040,51
KOLE,2025,520,550,1070,51
KOTIDO,2015,320,310,630,51
KOTIDO,2016,330,290,620,51
KOTIDO,2017,330,280,610,51
KOTIDO,2018,330,280,610,51
KOTIDO,2019,350,290,640,51
KOTIDO,2020,370,320,690,51
KOTIDO,2021,400,340,740,51
KOTIDO,2022,430,370,800,51
KOTIDO,2023,440,380,820,51
KOTIDO,2024,450,400,850,51
KOTIDO,2025,460,400,860,51
KUMI,2015,590,680,1270,51
KUMI,2016,590,650,1240,51
KUMI,2017,600,630,1230,51
KUMI,2018,610,650,1260,51
KUMI,2019,660,680,1340,51
KUMI,2020,700,740,1440,51
KUMI,2021,760,800,1560,51
KUMI,2022,800,870,1670,51
KUMI,2023,840,910,1750,51
KUMI,2024,870,950,1820,51
KUMI,2025,880,970,1850,51
KWANIA,2015,320,290,610,51
KWANIA,2016,330,300,630,51
KWANIA,2017,340,310,650,51
KWANIA,2018,350,320,670,51
KWANIA,2019,360,320,680,51
KWANIA,2020,370,330,700,51
KWANIA,2021,380,340,720,51
KWANIA,2022,390,350,740,51
KWANIA,2023,400,360,760,51
KWANIA,2024,410,370,780,51
KWANIA,2025,420,380,800,51
KWEEN,2015,180,170,350,51
KWEEN,2016,180,180,360,51
KWEEN,2017,190,180,370,51
KWEEN,2018,190,190,380,51
KWEEN,2019,200,190,390,51
KWEEN,2020,200,200,400,51
KWEEN,2021,210,200,410,51
KWEEN,2022,220,200,420,51
KWEEN,2023,220,210,430,51
KWEEN,2024,230,210,440,51
KWEEN,2025,230,220,450,51
KYANKWANZI,2015,370,340,710,51
KYANKWANZI,2016,390,360,750,51
KYANKWANZI,2017,410,380,790,51
KYANKWANZI,2018,430,390,820,51
KYANKWANZI,2019,450,410,860,51
KYANKWANZI,2020,470,430,900,51
KYANKWANZI,2021,490,450,940,51
KYANKWANZI,2022,520,470,990,51
KYANKWANZI,2023,540,490,1030,51
KYANKWANZI,2024,570,510,1080,51
KYANKWANZI,2025,590,530,1120,51
KYEGEGWA,2015,540,560,1100,51
KYEGEGWA,2016,580,600,1180,51
KYEGEGWA,2017,630,650,1280,51
KYEGEGWA,2018,680,700,1380,51
KYEGEGWA,2019,730,750,1480,51
KYEGEGWA,2020,790,810,1600,51
KYEGEGWA,2021,860,870,1730,51
KYEGEGWA,2022,920,940,1860,51
KYEGEGWA,2023,1000,1010,2010,51
KYEGEGWA,2024,1070,1090,2160,51
KYEGEGWA,2025,1160,1170,2330,51
KYENJOJO,2015,660,780,1440,51
KYENJOJO,2016,690,800,1490,51
KYENJOJO,2017,720,830,1550,51
KYENJOJO,2018,750,860,1610,51
KYENJOJO,2019,780,900,1680,51
KYENJOJO,2020,810,930,1740,51
KYENJOJO,2021,840,960,1800,51
KYENJOJO,2022,870,990,1860,51
KYENJOJO,2023,900,1030,1930,51
KYENJOJO,2024,940,1060,2000,51
KYENJOJO,2025,970,1090,2060,51
KYOTERA,2015,470,600,1070,51
KYOTERA,2016,470,570,1040,51
KYOTERA,2017,470,540,1010,51
KYOTERA,2018,470,550,1020,51
KYOTERA,2019,500,560,1060,51
KYOTERA,2020,530,610,1140,51
KYOTERA,2021,560,650,1210,51
KYOTERA,2022,590,690,1280,51
KYOTERA,2023,600,710,1310,51
KYOTERA,2024,610,730,1340,51
KYOTERA,2025,610,740,1350,51
KARENGA,2015,80,90,170,51
KARENGA,2016,80,90,170,51
KARENGA,2017,80,90,170,51
KARENGA,2018,80,90,170,51
KARENGA,2019,90,100,190,51
KARENGA,2020,90,100,190,51
KARENGA,2021,90,100,190,51
KARENGA,2022,90,100,190,51
KARENGA,2023,90,110,200,51
KARENGA,2024,100,110,210,51
KARENGA,2025,100,110,210,51
LAMWO,2015,270,280,550,51
LAMWO,2016,260,260,520,51
LAMWO,2017,260,250,510,51
LAMWO,2018,260,240,500,51
LAMWO,2019,260,260,520,51
LAMWO,2020,290,280,570,51
LAMWO,2021,300,290,590,51
LAMWO,2022,310,320,630,51
LAMWO,2023,320,330,650,51
LAMWO,2024,310,340,650,51
LAMWO,2025,310,340,650,51
LIRA,2015,700,730,1430,51
LIRA,2016,720,750,1470,51
LIRA,2017,740,770,1510,51
LIRA,2018,760,790,1550,51
LIRA,2019,780,810,1590,51
LIRA,2020,800,840,1640,51
LIRA,2021,820,860,1680,51
LIRA,2022,840,880,1720,51
LIRA,2023,860,900,1760,51
LIRA,2024,880,920,1800,51
LIRA,2025,900,950,1850,51
LUUKA,2015,540,630,1170,51
LUUKA,2016,540,600,1140,51
LUUKA,2017,540,580,1120,51
LUUKA,2018,540,570,1110,51
LUUKA,2019,560,600,1160,51
LUUKA,2020,600,650,1250,51
LUUKA,2021,640,700,1340,51
LUUKA,2022,680,750,1430,51
LUUKA,2023,710,790,1500,51
LUUKA,2024,700,810,1510,51
LUUKA,2025,710,810,1520,51
LUWERO,2015,1020,1110,2130,51
LUWERO,2016,1020,1060,2080,51
LUWERO,2017,1020,1040,2060,51
LUWERO,2018,1050,1050,2100,51
LUWERO,2019,1120,1100,2220,51
LUWERO,2020,1190,1190,2380,51
LUWERO,2021,1270,1280,2550,51
LUWERO,2022,1340,1370,2710,51
LUWERO,2023,1400,1440,2840,51
LUWERO,2024,1420,1480,2900,51
LUWERO,2025,1440,1500,2940,51
LWENGO,2015,630,860,1490,51
LWENGO,2016,610,810,1420,51
LWENGO,2017,610,780,1390,51
LWENGO,2018,610,780,1390,51
LWENGO,2019,640,800,1440,51
LWENGO,2020,670,860,1530,51
LWENGO,2021,710,910,1620,51
LWENGO,2022,740,950,1690,51
LWENGO,2023,770,1000,1770,51
LWENGO,2024,760,1010,1770,51
LWENGO,2025,760,1010,1770,51
LYANTONDE,2015,260,250,510,51
LYANTONDE,2016,250,250,500,51
LYANTONDE,2017,260,230,490,51
LYANTONDE,2018,260,240,500,51
LYANTONDE,2019,280,250,530,51
LYANTONDE,2020,300,280,580,51
LYANTONDE,2021,310,290,600,51
LYANTONDE,2022,340,320,660,51
LYANTONDE,2023,360,330,690,51
LYANTONDE,2024,360,350,710,51
LYANTONDE,2025,370,350,720,51
MANAFWA,2015,340,350,690,51
MANAFWA,2016,350,360,710,51
MANAFWA,2017,350,370,720,51
MANAFWA,2018,360,370,730,51
MANAFWA,2019,370,380,750,51
MANAFWA,2020,380,390,770,51
MANAFWA,2021,390,400,790,51
MANAFWA,2022,400,410,810,51
MANAFWA,2023,410,410,820,51
MANAFWA,2024,410,420,830,51
MANAFWA,2025,420,430,850,51
MARACHA,2015,350,370,720,51
MARACHA,2016,360,380,740,51
MARACHA,2017,370,380,750,51
MARACHA,2018,370,390,760,51
MARACHA,2019,380,400,780,51
MARACHA,2020,390,410,800,51
MARACHA,2021,400,410,810,51
MARACHA,2022,400,420,820,51
MARACHA,2023,410,430,840,51
MARACHA,2024,420,430,850,51
MARACHA,2025,420,440,860,51
MASAKA,2015,580,810,1390,51
MASAKA,2016,590,810,1400,51
MASAKA,2017,600,780,1380,51
MASAKA,2018,590,740,1330,51
MASAKA,2019,600,720,1320,51
MASAKA,2020,620,720,1340,51
MASAKA,2021,650,760,1410,51
MASAKA,2022,680,820,1500,51
MASAKA,2023,720,880,1600,51
MASAKA,2024,760,940,1700,51
MASAKA,2025,790,990,1780,51
MASINDI,2015,560,510,1070,51
MASINDI,2016,580,520,1100,51
MASINDI,2017,590,530,1120,51
MASINDI,2018,610,550,1160,51
MASINDI,2019,630,560,1190,51
MASINDI,2020,640,580,1220,51
MASINDI,2021,660,590,1250,51
MASINDI,2022,680,600,1280,51
MASINDI,2023,700,620,1320,51
MASINDI,2024,710,630,1340,51
MASINDI,2025,730,650,1380,51
MAYUGE,2015,940,1290,2230,51
MAYUGE,2016,940,1250,2190,51
MAYUGE,2017,950,1210,2160,51
MAYUGE,2018,990,1230,2220,51
MAYUGE,2019,1040,1300,2340,51
MAYUGE,2020,1120,1420,2540,51
MAYUGE,2021,1200,1540,2740,51
MAYUGE,2022,1280,1670,2950,51
MAYUGE,2023,1340,1770,3110,51
MAYUGE,2024,1380,1840,3220,51
MAYUGE,2025,1390,1890,3280,51
MBALE,2015,1190,1430,2620,51
MBALE,2016,1190,1380,2570,51
MBALE,2017,1190,1360,2550,51
MBALE,2018,1230,1380,2610,51
MBALE,2019,1300,1470,2770,51
MBALE,2020,1390,1600,2990,51
MBALE,2021,1500,1750,3250,51
MBALE,2022,1590,1880,3470,51
MBALE,2023,1670,2000,3670,51
MBALE,2024,1710,2080,3790,51
MBALE,2025,1740,2150,3890,51
MBARARA,2015,680,700,1380,51
MBARARA,2016,690,720,1410,51
MBARARA,2017,710,730,1440,51
MBARARA,2018,730,750,1480,51
MBARARA,2019,740,760,1500,51
MBARARA,2020,760,780,1540,51
MBARARA,2021,770,790,1560,51
MBARARA,2022,790,810,1600,51
MBARARA,2023,810,820,1630,51
MBARARA,2024,820,840,1660,51
MBARARA,2025,830,850,1680,51
MITOOMA,2015,330,510,840,51
MITOOMA,2016,340,520,860,51
MITOOMA,2017,340,520,860,51
MITOOMA,2018,350,520,870,51
MITOOMA,2019,350,530,880,51
MITOOMA,2020,350,530,880,51
MITOOMA,2021,360,540,900,51
MITOOMA,2022,360,540,900,51
MITOOMA,2023,360,540,900,51
MITOOMA,2024,370,550,920,51
MITOOMA,2025,370,550,920,51
MITYANA,2015,770,1000,1770,51
MITYANA,2016,760,950,1710,51
MITYANA,2017,770,930,1700,51
MITYANA,2018,780,930,1710,51
MITYANA,2019,810,970,1780,51
MITYANA,2020,860,1030,1890,51
MITYANA,2021,910,1110,2020,51
MITYANA,2022,960,1170,2130,51
MITYANA,2023,990,1230,2220,51
MITYANA,2024,1000,1250,2250,51
MITYANA,2025,1010,1270,2280,51
MOROTO,2015,190,190,380,51
MOROTO,2016,180,180,360,51
MOROTO,2017,190,170,360,51
MOROTO,2018,190,180,370,51
MOROTO,2019,200,190,390,51
MOROTO,2020,220,200,420,51
MOROTO,2021,230,220,450,51
MOROTO,2022,240,230,470,51
MOROTO,2023,240,240,480,51
MOROTO,2024,250,260,510,51
MOROTO,2025,250,260,510,51
MOYO,2015,230,260,490,51
MOYO,2016,230,270,500,51
MOYO,2017,240,270,510,51
MOYO,2018,250,280,530,51
MOYO,2019,250,290,540,51
MOYO,2020,260,290,550,51
MOYO,2021,260,300,560,51
MOYO,2022,270,300,570,51
MOYO,2023,280,310,590,51
MOYO,2024,280,310,590,51
MOYO,2025,290,320,610,51
MPIGI,2015,580,680,1260,51
MPIGI,2016,570,650,1220,51
MPIGI,2017,580,630,1210,51
MPIGI,2018,590,630,1220,51
MPIGI,2019,620,660,1280,51
MPIGI,2020,660,720,1380,51
MPIGI,2021,700,770,1470,51
MPIGI,2022,740,840,1580,51
MPIGI,2023,770,880,1650,51
MPIGI,2024,780,900,1680,51
MPIGI,2025,790,920,1710,51
MUBENDE,2015,870,990,1860,51
MUBENDE,2016,950,1080,2030,51
MUBENDE,2017,990,1110,2100,51
MUBENDE,2018,1020,1110,2130,51
MUBENDE,2019,1060,1090,2150,51
MUBENDE,2020,1090,1090,2180,51
MUBENDE,2021,1150,1130,2280,51
MUBENDE,2022,1250,1220,2470,51
MUBENDE,2023,1360,1350,2710,51
MUBENDE,2024,1490,1510,3000,51
MUBENDE,2025,1620,1640,3260,51
MUKONO,2015,1210,1450,2660,51
MUKONO,2016,1200,1390,2590,51
MUKONO,2017,1210,1360,2570,51
MUKONO,2018,1240,1380,2620,51
MUKONO,2019,1310,1450,2760,51
MUKONO,2020,1410,1580,2990,51
MUKONO,2021,1500,1730,3230,51
MUKONO,2022,1590,1850,3440,51
MUKONO,2023,1670,1950,3620,51
MUKONO,2024,1690,2020,3710,51
MUKONO,2025,1720,2080,3800,51
NABILATUK,2015,80,140,220,51
NABILATUK,2016,80,130,210,51
NABILATUK,2017,80,140,220,51
NABILATUK,2018,90,130,220,51
NABILATUK,2019,90,140,230,51
NABILATUK,2020,100,160,260,51
NABILATUK,2021,110,170,280,51
NABILATUK,2022,120,190,310,51
NABILATUK,2023,120,210,330,51
NABILATUK,2024,130,210,340,51
NABILATUK,2025,130,230,360,51
NAKAPIRIPIRIT,2015,180,190,370,51
NAKAPIRIPIRIT,2016,180,180,360,51
NAKAPIRIPIRIT,2017,180,190,370,51
NAKAPIRIPIRIT,2018,190,190,380,51
NAKAPIRIPIRIT,2019,200,200,400,51
NAKAPIRIPIRIT,2020,220,230,450,51
NAKAPIRIPIRIT,2021,240,250,490,51
NAKAPIRIPIRIT,2022,270,260,530,51
NAKAPIRIPIRIT,2023,270,290,560,51
NAKAPIRIPIRIT,2024,280,310,590,51
NAKAPIRIPIRIT,2025,300,320,620,51
NAKASEKE,2015,400,310,710,51
NAKASEKE,2016,420,320,740,51
NAKASEKE,2017,430,330,760,51
NAKASEKE,2018,450,340,790,51
NAKASEKE,2019,470,340,810,51
NAKASEKE,2020,480,350,830,51
NAKASEKE,2021,500,360,860,51
NAKASEKE,2022,520,370,890,51
NAKASEKE,2023,530,370,900,51
NAKASEKE,2024,550,380,930,51
NAKASEKE,2025,570,390,960,51
NAKASONGOLA,2015,440,430,870,51
NAKASONGOLA,2016,440,420,860,51
NAKASONGOLA,2017,450,410,860,51
NAKASONGOLA,2018,460,410,870,51
NAKASONGOLA,2019,490,440,930,51
NAKASONGOLA,2020,530,480,1010,51
NAKASONGOLA,2021,570,520,1090,51
NAKASONGOLA,2022,610,560,1170,51
NAKASONGOLA,2023,630,570,1200,51
NAKASONGOLA,2024,640,600,1240,51
NAKASONGOLA,2025,670,610,1280,51
NAMAYINGO,2015,490,570,1060,51
NAMAYINGO,2016,480,530,1010,51
NAMAYINGO,2017,490,520,1010,51
NAMAYINGO,2018,490,520,1010,51
NAMAYINGO,2019,510,540,1050,51
NAMAYINGO,2020,550,580,1130,51
NAMAYINGO,2021,590,620,1210,51
NAMAYINGO,2022,610,660,1270,51
NAMAYINGO,2023,630,680,1310,51
NAMAYINGO,2024,640,700,1340,51
NAMAYINGO,2025,640,700,1340,51
NAMISINDWA,2015,410,460,870,51
NAMISINDWA,2016,420,470,890,51
NAMISINDWA,2017,430,480,910,51
NAMISINDWA,2018,450,490,940,51
NAMISINDWA,2019,460,500,960,51
NAMISINDWA,2020,470,510,980,51
NAMISINDWA,2021,480,520,1000,51
NAMISINDWA,2022,490,540,1030,51
NAMISINDWA,2023,510,550,1060,51
NAMISINDWA,2024,520,560,1080,51
NAMISINDWA,2025,530,570,1100,51
NAMUTUMBA,2015,620,710,1330,51
NAMUTUMBA,2016,630,690,1320,51
NAMUTUMBA,2017,640,670,1310,51
NAMUTUMBA,2018,670,680,1350,51
NAMUTUMBA,2019,710,730,1440,51
NAMUTUMBA,2020,750,790,1540,51
NAMUTUMBA,2021,810,870,1680,51
NAMUTUMBA,2022,870,920,1790,51
NAMUTUMBA,2023,920,980,1900,51
NAMUTUMBA,2024,940,1030,1970,51
NAMUTUMBA,2025,960,1060,2020,51
NAPAK,2015,190,360,550,51
NAPAK,2016,180,350,530,51
NAPAK,2017,180,330,510,51
NAPAK,2018,180,340,520,51
NAPAK,2019,200,350,550,51
NAPAK,2020,210,380,590,51
NAPAK,2021,210,420,630,51
NAPAK,2022,220,440,660,51
NAPAK,2023,230,470,700,51
NAPAK,2024,240,470,710,51
NAPAK,2025,240,490,730,51
NEBBI,2015,460,590,1050,51
NEBBI,2016,470,610,1080,51
NEBBI,2017,490,630,1120,51
NEBBI,2018,500,640,1140,51
NEBBI,2019,520,660,1180,51
NEBBI,2020,530,680,1210,51
NEBBI,2021,550,700,1250,51
NEBBI,2022,560,710,1270,51
NEBBI,2023,580,730,1310,51
NEBBI,2024,590,750,1340,51
NEBBI,2025,610,770,1380,51
NGORA,2015,360,380,740,51
NGORA,2016,370,360,730,51
NGORA,2017,370,360,730,51
NGORA,2018,380,370,750,51
NGORA,2019,410,380,790,51
NGORA,2020,440,410,850,51
NGORA,2021,460,450,910,51
NGORA,2022,490,480,970,51
NGORA,2023,510,500,1010,51
NGORA,2024,520,520,1040,51
NGORA,2025,530,540,1070,51
NTOROKO,2015,130,130,260,51
NTOROKO,2016,130,120,250,51
NTOROKO,2017,140,110,250,51
NTOROKO,2018,140,120,260,51
NTOROKO,2019,140,130,270,51
NTOROKO,2020,150,130,280,51
NTOROKO,2021,170,140,310,51
NTOROKO,2022,180,150,330,51
NTOROKO,2023,180,170,350,51
NTOROKO,2024,190,170,360,51
NTOROKO,2025,190,170,360,51
NTUNGAMO,2015,960,1220,2180,51
NTUNGAMO,2016,980,1250,2230,51
NTUNGAMO,2017,1000,1270,2270,51
NTUNGAMO,2018,1020,1290,2310,51
NTUNGAMO,2019,1040,1320,2360,51
NTUNGAMO,2020,1060,1340,2400,51
NTUNGAMO,2021,1080,1360,2440,51
NTUNGAMO,2022,1100,1380,2480,51
NTUNGAMO,2023,1120,1400,2520,51
NTUNGAMO,2024,1140,1420,2560,51
NTUNGAMO,2025,1160,1440,2600,51
NWOYA,2015,290,310,600,51
NWOYA,2016,320,340,660,51
NWOYA,2017,360,380,740,51
NWOYA,2018,400,420,820,51
NWOYA,2019,440,460,900,51
NWOYA,2020,480,500,980,51
NWOYA,2021,530,550,1080,51
NWOYA,2022,590,610,1200,51
NWOYA,2023,640,670,1310,51
NWOYA,2024,710,730,1440,51
NWOYA,2025,780,800,1580,51
OBONGI,2015,120,110,230,51
OBONGI,2016,120,120,240,51
OBONGI,2017,130,110,240,51
OBONGI,2018,130,110,240,51
OBONGI,2019,130,110,240,51
OBONGI,2020,140,120,260,51
OBONGI,2021,160,130,290,51
OBONGI,2022,160,150,310,51
OBONGI,2023,170,150,320,51
OBONGI,2024,160,150,310,51
OBONGI,2025,160,150,310,51
OMORO,2015,340,450,790,51
OMORO,2016,340,430,770,51
OMORO,2017,350,420,770,51
OMORO,2018,360,430,790,51
OMORO,2019,380,450,830,51
OMORO,2020,410,500,910,51
OMORO,2021,440,550,990,51
OMORO,2022,470,590,1060,51
OMORO,2023,500,620,1120,51
OMORO,2024,510,640,1150,51
OMORO,2025,520,670,1190,51
OTUKE,2015,230,180,410,51
OTUKE,2016,240,180,420,51
OTUKE,2017,250,190,440,51
OTUKE,2018,260,200,460,51
OTUKE,2019,280,210,490,51
OTUKE,2020,290,220,510,51
OTUKE,2021,300,230,530,51
OTUKE,2022,310,240,550,51
OTUKE,2023,330,240,570,51
OTUKE,2024,340,250,590,51
OTUKE,2025,350,260,610,51
OYAM,2015,720,830,1550,51
OYAM,2016,740,860,1600,51
OYAM,2017,760,880,1640,51
OYAM,2018,780,910,1690,51
OYAM,2019,810,930,1740,51
OYAM,2020,830,960,1790,51
OYAM,2021,850,990,1840,51
OYAM,2022,880,1010,1890,51
OYAM,2023,900,1040,1940,51
OYAM,2024,930,1060,1990,51
OYAM,2025,950,1090,2040,51
PADER,2015,390,310,700,51
PADER,2016,380,290,670,51
PADER,2017,380,280,660,51
PADER,2018,380,280,660,51
PADER,2019,410,300,710,51
PADER,2020,420,320,740,51
PADER,2021,460,340,800,51
PADER,2022,470,370,840,51
PADER,2023,500,380,880,51
PADER,2024,490,400,890,51
PADER,2025,500,400,900,51
PAKWACH,2015,290,350,640,51
PAKWACH,2016,300,360,660,51
PAKWACH,2017,310,370,680,51
PAKWACH,2018,330,390,720,51
PAKWACH,2019,340,400,740,51
PAKWACH,2020,350,410,760,51
PAKWACH,2021,370,430,800,51
PAKWACH,2022,380,440,820,51
PAKWACH,2023,400,460,860,51
PAKWACH,2024,410,470,880,51
PAKWACH,2025,430,490,920,51
PALLISA,2015,650,700,1350,51
PALLISA,2016,650,690,1340,51
PALLISA,2017,680,680,1360,51
PALLISA,2018,700,690,1390,51
PALLISA,2019,760,750,1510,51
PALLISA,2020,820,820,1640,51
PALLISA,2021,900,910,1810,51
PALLISA,2022,970,980,1950,51
PALLISA,2023,1020,1060,2080,51
PALLISA,2024,1060,1120,2180,51
PALLISA,2025,1100,1160,2260,51
RAKAI,2015,590,680,1270,51
RAKAI,2016,590,650,1240,51
RAKAI,2017,590,630,1220,51
RAKAI,2018,610,630,1240,51
RAKAI,2019,640,660,1300,51
RAKAI,2020,680,720,1400,51
RAKAI,2021,730,790,1520,51
RAKAI,2022,770,840,1610,51
RAKAI,2023,810,880,1690,51
RAKAI,2024,820,900,1720,51
RAKAI,2025,830,920,1750,51
RUBANDA,2015,400,570,970,51
RUBANDA,2016,410,570,980,51
RUBANDA,2017,410,580,990,51
RUBANDA,2018,420,580,1000,51
RUBANDA,2019,420,590,1010,51
RUBANDA,2020,430,590,1020,51
RUBANDA,2021,430,590,1020,51
RUBANDA,2022,440,600,1040,51
RUBANDA,2023,440,600,1040,51
RUBANDA,2024,440,600,1040,51
RUBANDA,2025,450,600,1050,51
RUBIRIZI,2015,240,290,530,51
RUBIRIZI,2016,250,300,550,51
RUBIRIZI,2017,250,300,550,51
RUBIRIZI,2018,260,310,570,51
RUBIRIZI,2019,260,310,570,51
RUBIRIZI,2020,270,320,590,51
RUBIRIZI,2021,270,320,590,51
RUBIRIZI,2022,280,330,610,51
RUBIRIZI,2023,280,340,620,51
RUBIRIZI,2024,290,340,630,51
RUBIRIZI,2025,290,340,630,51
RUKIGA,2015,230,280,510,51
RUKIGA,2016,230,280,510,51
RUKIGA,2017,230,290,520,51
RUKIGA,2018,240,290,530,51
RUKIGA,2019,240,290,530,51
RUKIGA,2020,240,290,530,51
RUKIGA,2021,240,290,530,51
RUKIGA,2022,240,290,530,51
RUKIGA,2023,250,290,540,51
RUKIGA,2024,250,300,550,51
RUKIGA,2025,250,300,550,51
RUKUNGIRI,2015,710,900,1610,51
RUKUNGIRI,2016,710,910,1620,51
RUKUNGIRI,2017,720,920,1640,51
RUKUNGIRI,2018,730,930,1660,51
RUKUNGIRI,2019,740,940,1680,51
RUKUNGIRI,2020,750,950,1700,51
RUKUNGIRI,2021,750,950,1700,51
RUKUNGIRI,2022,760,960,1720,51
RUKUNGIRI,2023,770,970,1740,51
RUKUNGIRI,2024,770,970,1740,51
RUKUNGIRI,2025,780,980,1760,51
RWAMPARA,2015,270,360,630,51
RWAMPARA,2016,280,370,650,51
RWAMPARA,2017,280,380,660,51
RWAMPARA,2018,290,390,680,51
RWAMPARA,2019,290,390,680,51
RWAMPARA,2020,300,400,700,51
RWAMPARA,2021,310,410,720,51
RWAMPARA,2022,310,420,730,51
RWAMPARA,2023,320,430,750,51
RWAMPARA,2024,320,430,750,51
RWAMPARA,2025,330,440,770,51
SERERE,2015,630,650,1280,51
SERERE,2016,640,640,1280,51
SERERE,2017,650,630,1280,51
SERERE,2018,680,650,1330,51
SERERE,2019,740,690,1430,51
SERERE,2020,790,750,1540,51
SERERE,2021,860,830,1690,51
SERERE,2022,930,900,1830,51
SERERE,2023,980,950,1930,51
SERERE,2024,1000,990,1990,51
SERERE,2025,1040,1040,2080,51
SHEEMA,2015,440,570,1010,51
SHEEMA,2016,450,580,1030,51
SHEEMA,2017,450,590,1040,51
SHEEMA,2018,460,590,1050,51
SHEEMA,2019,460,600,1060,51
SHEEMA,2020,470,600,1070,51
SHEEMA,2021,470,610,1080,51
SHEEMA,2022,480,610,1090,51
SHEEMA,2023,480,620,1100,51
SHEEMA,2024,490,620,1110,51
SHEEMA,2025,490,620,1110,51
SIRONKO,2015,560,560,1120,51
SIRONKO,2016,570,570,1140,51
SIRONKO,2017,590,590,1180,51
SIRONKO,2018,600,600,1200,51
SIRONKO,2019,620,610,1230,51
SIRONKO,2020,630,620,1250,51
SIRONKO,2021,640,630,1270,51
SIRONKO,2022,660,640,1300,51
SIRONKO,2023,670,650,1320,51
SIRONKO,2024,680,660,1340,51
SIRONKO,2025,700,670,1370,51
SOROTI,2015,740,670,1410,51
SOROTI,2016,740,650,1390,51
SOROTI,2017,750,640,1390,51
SOROTI,2018,780,660,1440,51
SOROTI,2019,830,700,1530,51
SOROTI,2020,900,750,1650,51
SOROTI,2021,970,830,1800,51
SOROTI,2022,1030,900,1930,51
SOROTI,2023,1100,950,2050,51
SOROTI,2024,1120,990,2110,51
SOROTI,2025,1140,1030,2170,51
SSEMBABULE,2015,670,720,1390,51
SSEMBABULE,2016,680,690,1370,51
SSEMBABULE,2017,680,680,1360,51
SSEMBABULE,2018,700,680,1380,51
SSEMBABULE,2019,750,730,1480,51
SSEMBABULE,2020,790,780,1570,51
SSEMBABULE,2021,860,860,1720,51
SSEMBABULE,2022,900,910,1810,51
SSEMBABULE,2023,950,950,1900,51
SSEMBABULE,2024,970,990,1960,51
SSEMBABULE,2025,980,1010,1990,51
TORORO,2015,1170,1350,2520,51
TORORO,2016,1200,1380,2580,51
TORORO,2017,1230,1410,2640,51
TORORO,2018,1260,1450,2710,51
TORORO,2019,1300,1480,2780,51
TORORO,2020,1330,1520,2850,51
TORORO,2021,1360,1550,2910,51
TORORO,2022,1390,1590,2980,51
TORORO,2023,1430,1620,3050,51
TORORO,2024,1460,1660,3120,51
TORORO,2025,1490,1690,3180,51
WAKISO,2015,2640,2930,5570,51
WAKISO,2016,2820,3130,5950,51
WAKISO,2017,3010,3340,6350,51
WAKISO,2018,3210,3570,6780,51
WAKISO,2019,3420,3810,7230,51
WAKISO,2020,3650,4060,7710,51
WAKISO,2021,3880,4330,8210,51
WAKISO,2022,4130,4620,8750,51
WAKISO,2023,4390,4910,9300,51
WAKISO,2024,4670,5230,9900,51
WAKISO,2025,4950,5560,10510,51
YUMBE,2015,800,540,1340,51
YUMBE,2016,810,550,1360,51
YUMBE,2017,840,540,1380,51
YUMBE,2018,880,570,1450,51
YUMBE,2019,960,630,1590,51
YUMBE,2020,1040,690,1730,51
YUMBE,2021,1140,770,1910,51
YUMBE,2022,1240,850,2090,51
YUMBE,2023,1320,940,2260,51
YUMBE,2024,1390,990,2380,51
YUMBE,2025,1440,1060,2500,51
ZOMBO,2015,480,530,1010,51
ZOMBO,2016,500,540,1040,51
ZOMBO,2017,510,560,1070,51
ZOMBO,2018,530,570,1100,51
ZOMBO,2019,550,590,1140,51
ZOMBO,2020,560,600,1160,51
ZOMBO,2021,580,620,1200,51
ZOMBO,2022,600,630,1230,51
ZOMBO,2023,610,650,1260,51
ZOMBO,2024,630,670,1300,51
ZOMBO,2025,640,680,1320,51
MADI OKOLLO,2015,250,280,530,51
MADI OKOLLO,2016,260,290,550,51
MADI OKOLLO,2017,270,300,570,51
MADI OKOLLO,2018,270,310,580,51
MADI OKOLLO,2019,280,310,590,51
MADI OKOLLO,2020,290,320,610,51
MADI OKOLLO,2021,300,330,630,51
MADI OKOLLO,2022,310,340,650,51
MADI OKOLLO,2023,310,350,660,51
MADI OKOLLO,2024,320,350,670,51
MADI OKOLLO,2025,330,360,690,51
ABIM,2015,250,220,470,52
ABIM,2016,260,220,480,52
ABIM,2017,270,220,490,52
ABIM,2018,280,220,500,52
ABIM,2019,310,230,540,52
ABIM,2020,330,250,580,52
ABIM,2021,370,280,650,52
ABIM,2022,410,310,720,52
ABIM,2023,450,350,800,52
ABIM,2024,490,380,870,52
ABIM,2025,510,400,910,52
ADJUMANI,2015,490,520,1010,52
ADJUMANI,2016,500,520,1020,52
ADJUMANI,2017,500,530,1030,52
ADJUMANI,2018,500,530,1030,52
ADJUMANI,2019,510,540,1050,52
ADJUMANI,2020,510,540,1050,52
ADJUMANI,2021,510,550,1060,52
ADJUMANI,2022,520,550,1070,52
ADJUMANI,2023,520,550,1070,52
ADJUMANI,2024,520,560,1080,52
ADJUMANI,2025,520,560,1080,52
AGAGO,2015,610,680,1290,52
AGAGO,2016,620,690,1310,52
AGAGO,2017,630,700,1330,52
AGAGO,2018,640,710,1350,52
AGAGO,2019,650,720,1370,52
AGAGO,2020,660,740,1400,52
AGAGO,2021,670,750,1420,52
AGAGO,2022,680,760,1440,52
AGAGO,2023,690,770,1460,52
AGAGO,2024,700,780,1480,52
AGAGO,2025,710,790,1500,52
ALEBTONG,2015,640,640,1280,52
ALEBTONG,2016,640,630,1270,52
ALEBTONG,2017,640,600,1240,52
ALEBTONG,2018,650,580,1230,52
ALEBTONG,2019,670,590,1260,52
ALEBTONG,2020,710,630,1340,52
ALEBTONG,2021,750,680,1430,52
ALEBTONG,2022,810,740,1550,52
ALEBTONG,2023,860,780,1640,52
ALEBTONG,2024,900,830,1730,52
ALEBTONG,2025,910,860,1770,52
AMOLATAR,2015,410,460,870,52
AMOLATAR,2016,410,450,860,52
AMOLATAR,2017,400,430,830,52
AMOLATAR,2018,400,420,820,52
AMOLATAR,2019,420,430,850,52
AMOLATAR,2020,440,450,890,52
AMOLATAR,2021,470,480,950,52
AMOLATAR,2022,510,520,1030,52
AMOLATAR,2023,530,560,1090,52
AMOLATAR,2024,550,580,1130,52
AMOLATAR,2025,570,610,1180,52
AMUDAT,2015,140,130,270,52
AMUDAT,2016,140,130,270,52
AMUDAT,2017,140,120,260,52
AMUDAT,2018,150,130,280,52
AMUDAT,2019,150,130,280,52
AMUDAT,2020,160,140,300,52
AMUDAT,2021,170,150,320,52
AMUDAT,2022,190,170,360,52
AMUDAT,2023,200,190,390,52
AMUDAT,2024,210,190,400,52
AMUDAT,2025,220,210,430,52
AMURIA,2015,460,410,870,52
AMURIA,2016,470,390,860,52
AMURIA,2017,470,390,860,52
AMURIA,2018,480,380,860,52
AMURIA,2019,500,390,890,52
AMURIA,2020,530,410,940,52
AMURIA,2021,570,450,1020,52
AMURIA,2022,620,480,1100,52
AMURIA,2023,660,530,1190,52
AMURIA,2024,700,560,1260,52
AMURIA,2025,720,580,1300,52
AMURU,2015,490,570,1060,52
AMURU,2016,490,550,1040,52
AMURU,2017,490,530,1020,52
AMURU,2018,490,520,1010,52
AMURU,2019,510,530,1040,52
AMURU,2020,530,560,1090,52
AMURU,2021,570,600,1170,52
AMURU,2022,610,650,1260,52
AMURU,2023,650,700,1350,52
AMURU,2024,670,740,1410,52
AMURU,2025,690,760,1450,52
APAC,2015,520,530,1050,52
APAC,2016,540,550,1090,52
APAC,2017,560,570,1130,52
APAC,2018,580,590,1170,52
APAC,2019,600,610,1210,52
APAC,2020,630,630,1260,52
APAC,2021,650,650,1300,52
APAC,2022,670,670,1340,52
APAC,2023,690,690,1380,52
APAC,2024,710,710,1420,52
APAC,2025,740,730,1470,52
ARUA,2015,1870,2050,3920,52
ARUA,2016,1920,2100,4020,52
ARUA,2017,1970,2160,4130,52
ARUA,2018,2030,2220,4250,52
ARUA,2019,2090,2280,4370,52
ARUA,2020,2140,2330,4470,52
ARUA,2021,2200,2390,4590,52
ARUA,2022,2260,2450,4710,52
ARUA,2023,2320,2510,4830,52
ARUA,2024,2370,2570,4940,52
ARUA,2025,2430,2630,5060,52
BUDAKA,2015,470,510,980,52
BUDAKA,2016,470,510,980,52
BUDAKA,2017,480,490,970,52
BUDAKA,2018,490,480,970,52
BUDAKA,2019,500,490,990,52
BUDAKA,2020,530,520,1050,52
BUDAKA,2021,580,570,1150,52
BUDAKA,2022,620,630,1250,52
BUDAKA,2023,660,680,1340,52
BUDAKA,2024,700,720,1420,52
BUDAKA,2025,720,750,1470,52
BUDUDA,2015,520,490,1010,52
BUDUDA,2016,530,500,1030,52
BUDUDA,2017,540,480,1020,52
BUDUDA,2018,560,480,1040,52
BUDUDA,2019,580,490,1070,52
BUDUDA,2020,620,520,1140,52
BUDUDA,2021,680,580,1260,52
BUDUDA,2022,740,650,1390,52
BUDUDA,2023,800,700,1500,52
BUDUDA,2024,850,750,1600,52
BUDUDA,2025,890,790,1680,52
BUGIRI,2015,830,1120,1950,52
BUGIRI,2016,840,1100,1940,52
BUGIRI,2017,850,1070,1920,52
BUGIRI,2018,870,1050,1920,52
BUGIRI,2019,910,1080,1990,52
BUGIRI,2020,960,1150,2110,52
BUGIRI,2021,1050,1260,2310,52
BUGIRI,2022,1140,1390,2530,52
BUGIRI,2023,1230,1500,2730,52
BUGIRI,2024,1290,1610,2900,52
BUGIRI,2025,1330,1680,3010,52
BUGWERI,2015,400,480,880,52
BUGWERI,2016,400,480,880,52
BUGWERI,2017,400,460,860,52
BUGWERI,2018,400,440,840,52
BUGWERI,2019,410,450,860,52
BUGWERI,2020,440,470,910,52
BUGWERI,2021,470,510,980,52
BUGWERI,2022,500,560,1060,52
BUGWERI,2023,530,600,1130,52
BUGWERI,2024,550,620,1170,52
BUGWERI,2025,560,640,1200,52
BUHWEJU,2015,280,300,580,52
BUHWEJU,2016,290,310,600,52
BUHWEJU,2017,300,320,620,52
BUHWEJU,2018,310,330,640,52
BUHWEJU,2019,320,340,660,52
BUHWEJU,2020,330,350,680,52
BUHWEJU,2021,340,360,700,52
BUHWEJU,2022,350,370,720,52
BUHWEJU,2023,360,380,740,52
BUHWEJU,2024,370,390,760,52
BUHWEJU,2025,380,400,780,52
BUIKWE,2015,990,1270,2260,52
BUIKWE,2016,990,1230,2220,52
BUIKWE,2017,980,1160,2140,52
BUIKWE,2018,990,1130,2120,52
BUIKWE,2019,1000,1130,2130,52
BUIKWE,2020,1060,1190,2250,52
BUIKWE,2021,1120,1290,2410,52
BUIKWE,2022,1190,1390,2580,52
BUIKWE,2023,1250,1480,2730,52
BUIKWE,2024,1300,1550,2850,52
BUIKWE,2025,1310,1590,2900,52
BUKEDEA,2015,490,570,1060,52
BUKEDEA,2016,500,570,1070,52
BUKEDEA,2017,510,550,1060,52
BUKEDEA,2018,520,550,1070,52
BUKEDEA,2019,540,560,1100,52
BUKEDEA,2020,580,600,1180,52
BUKEDEA,2021,630,660,1290,52
BUKEDEA,2022,690,720,1410,52
BUKEDEA,2023,740,780,1520,52
BUKEDEA,2024,790,840,1630,52
BUKEDEA,2025,820,880,1700,52
BUKOMANSIMBI,2015,370,490,860,52
BUKOMANSIMBI,2016,360,480,840,52
BUKOMANSIMBI,2017,350,450,800,52
BUKOMANSIMBI,2018,350,430,780,52
BUKOMANSIMBI,2019,360,420,780,52
BUKOMANSIMBI,2020,370,430,800,52
BUKOMANSIMBI,2021,380,460,840,52
BUKOMANSIMBI,2022,400,490,890,52
BUKOMANSIMBI,2023,420,520,940,52
BUKOMANSIMBI,2024,430,530,960,52
BUKOMANSIMBI,2025,430,540,970,52
BUKWO,2015,210,230,440,52
BUKWO,2016,230,240,470,52
BUKWO,2017,240,250,490,52
BUKWO,2018,250,260,510,52
BUKWO,2019,260,270,530,52
BUKWO,2020,280,290,570,52
BUKWO,2021,290,300,590,52
BUKWO,2022,310,310,620,52
BUKWO,2023,320,330,650,52
BUKWO,2024,340,340,680,52
BUKWO,2025,350,360,710,52
BULAMBULI,2015,460,450,910,52
BULAMBULI,2016,470,440,910,52
BULAMBULI,2017,490,440,930,52
BULAMBULI,2018,500,430,930,52
BULAMBULI,2019,530,450,980,52
BULAMBULI,2020,570,480,1050,52
BULAMBULI,2021,620,540,1160,52
BULAMBULI,2022,670,600,1270,52
BULAMBULI,2023,730,660,1390,52
BULAMBULI,2024,770,700,1470,52
BULAMBULI,2025,810,740,1550,52
BULIISA,2015,270,320,590,52
BULIISA,2016,280,340,620,52
BULIISA,2017,300,350,650,52
BULIISA,2018,310,370,680,52
BULIISA,2019,330,380,710,52
BULIISA,2020,350,400,750,52
BULIISA,2021,360,420,780,52
BULIISA,2022,380,430,810,52
BULIISA,2023,400,450,850,52
BULIISA,2024,420,470,890,52
BULIISA,2025,440,490,930,52
BUNDIBUGYO,2015,480,470,950,52
BUNDIBUGYO,2016,470,460,930,52
BUNDIBUGYO,2017,480,450,930,52
BUNDIBUGYO,2018,490,430,920,52
BUNDIBUGYO,2019,500,440,940,52
BUNDIBUGYO,2020,520,470,990,52
BUNDIBUGYO,2021,560,500,1060,52
BUNDIBUGYO,2022,610,540,1150,52
BUNDIBUGYO,2023,650,590,1240,52
BUNDIBUGYO,2024,680,610,1290,52
BUNDIBUGYO,2025,690,630,1320,52
BUNYANGABU,2015,370,530,900,52
BUNYANGABU,2016,360,520,880,52
BUNYANGABU,2017,370,490,860,52
BUNYANGABU,2018,370,480,850,52
BUNYANGABU,2019,380,480,860,52
BUNYANGABU,2020,400,510,910,52
BUNYANGABU,2021,420,550,970,52
BUNYANGABU,2022,450,590,1040,52
BUNYANGABU,2023,480,630,1110,52
BUNYANGABU,2024,500,670,1170,52
BUNYANGABU,2025,510,680,1190,52
BUSHENYI,2015,580,690,1270,52
BUSHENYI,2016,590,700,1290,52
BUSHENYI,2017,600,710,1310,52
BUSHENYI,2018,600,710,1310,52
BUSHENYI,2019,610,720,1330,52
BUSHENYI,2020,620,720,1340,52
BUSHENYI,2021,620,730,1350,52
BUSHENYI,2022,630,730,1360,52
BUSHENYI,2023,640,740,1380,52
BUSHENYI,2024,640,740,1380,52
BUSHENYI,2025,650,740,1390,52
BUSIA,2015,670,990,1660,52
BUSIA,2016,680,960,1640,52
BUSIA,2017,670,930,1600,52
BUSIA,2018,690,910,1600,52
BUSIA,2019,710,920,1630,52
BUSIA,2020,750,970,1720,52
BUSIA,2021,810,1050,1860,52
BUSIA,2022,870,1160,2030,52
BUSIA,2023,930,1240,2170,52
BUSIA,2024,960,1310,2270,52
BUSIA,2025,990,1360,2350,52
BUTALEJA,2015,510,550,1060,52
BUTALEJA,2016,520,540,1060,52
BUTALEJA,2017,530,530,1060,52
BUTALEJA,2018,530,520,1050,52
BUTALEJA,2019,550,530,1080,52
BUTALEJA,2020,590,560,1150,52
BUTALEJA,2021,640,620,1260,52
BUTALEJA,2022,690,670,1360,52
BUTALEJA,2023,740,720,1460,52
BUTALEJA,2024,780,770,1550,52
BUTALEJA,2025,800,810,1610,52
BUTAMBALA,2015,200,290,490,52
BUTAMBALA,2016,200,270,470,52
BUTAMBALA,2017,200,250,450,52
BUTAMBALA,2018,190,240,430,52
BUTAMBALA,2019,200,250,450,52
BUTAMBALA,2020,210,250,460,52
BUTAMBALA,2021,220,270,490,52
BUTAMBALA,2022,230,280,510,52
BUTAMBALA,2023,240,310,550,52
BUTAMBALA,2024,250,320,570,52
BUTAMBALA,2025,250,320,570,52
BUTEBO,2015,230,260,490,52
BUTEBO,2016,230,250,480,52
BUTEBO,2017,230,240,470,52
BUTEBO,2018,230,230,460,52
BUTEBO,2019,230,230,460,52
BUTEBO,2020,240,240,480,52
BUTEBO,2021,260,250,510,52
BUTEBO,2022,270,280,550,52
BUTEBO,2023,280,290,570,52
BUTEBO,2024,300,300,600,52
BUTEBO,2025,300,300,600,52
BUVUMA,2015,320,180,500,52
BUVUMA,2016,340,190,530,52
BUVUMA,2017,360,210,570,52
BUVUMA,2018,380,220,600,52
BUVUMA,2019,410,240,650,52
BUVUMA,2020,430,250,680,52
BUVUMA,2021,460,270,730,52
BUVUMA,2022,480,290,770,52
BUVUMA,2023,510,300,810,52
BUVUMA,2024,540,320,860,52
BUVUMA,2025,570,340,910,52
BUYENDE,2015,700,770,1470,52
BUYENDE,2016,710,760,1470,52
BUYENDE,2017,720,740,1460,52
BUYENDE,2018,740,730,1470,52
BUYENDE,2019,780,760,1540,52
BUYENDE,2020,840,810,1650,52
BUYENDE,2021,910,890,1800,52
BUYENDE,2022,1000,990,1990,52
BUYENDE,2023,1070,1070,2140,52
BUYENDE,2024,1130,1150,2280,52
BUYENDE,2025,1180,1200,2380,52
DOKOLO,2015,570,550,1120,52
DOKOLO,2016,590,560,1150,52
DOKOLO,2017,610,580,1190,52
DOKOLO,2018,630,590,1220,52
DOKOLO,2019,650,610,1260,52
DOKOLO,2020,670,630,1300,52
DOKOLO,2021,690,640,1330,52
DOKOLO,2022,700,660,1360,52
DOKOLO,2023,720,670,1390,52
DOKOLO,2024,740,690,1430,52
DOKOLO,2025,760,700,1460,52
GOMBA,2015,380,480,860,52
GOMBA,2016,380,460,840,52
GOMBA,2017,380,440,820,52
GOMBA,2018,380,430,810,52
GOMBA,2019,390,420,810,52
GOMBA,2020,400,440,840,52
GOMBA,2021,420,460,880,52
GOMBA,2022,450,500,950,52
GOMBA,2023,480,530,1010,52
GOMBA,2024,490,550,1040,52
GOMBA,2025,500,560,1060,52
GULU,2015,660,810,1470,52
GULU,2016,680,830,1510,52
GULU,2017,700,850,1550,52
GULU,2018,720,880,1600,52
GULU,2019,750,900,1650,52
GULU,2020,770,930,1700,52
GULU,2021,790,950,1740,52
GULU,2022,810,980,1790,52
GULU,2023,830,1000,1830,52
GULU,2024,850,1030,1880,52
GULU,2025,870,1050,1920,52
HOIMA,2015,760,780,1540,52
HOIMA,2016,790,810,1600,52
HOIMA,2017,820,830,1650,52
HOIMA,2018,850,860,1710,52
HOIMA,2019,880,890,1770,52
HOIMA,2020,910,920,1830,52
HOIMA,2021,940,950,1890,52
HOIMA,2022,980,980,1960,52
HOIMA,2023,1010,1010,2020,52
HOIMA,2024,1040,1040,2080,52
HOIMA,2025,1080,1070,2150,52
IBANDA,2015,680,770,1450,52
IBANDA,2016,700,790,1490,52
IBANDA,2017,710,800,1510,52
IBANDA,2018,720,810,1530,52
IBANDA,2019,740,830,1570,52
IBANDA,2020,750,840,1590,52
IBANDA,2021,760,860,1620,52
IBANDA,2022,780,870,1650,52
IBANDA,2023,790,880,1670,52
IBANDA,2024,800,890,1690,52
IBANDA,2025,810,910,1720,52
IGANGA,2015,770,920,1690,52
IGANGA,2016,770,890,1660,52
IGANGA,2017,770,860,1630,52
IGANGA,2018,780,840,1620,52
IGANGA,2019,810,850,1660,52
IGANGA,2020,860,910,1770,52
IGANGA,2021,920,970,1890,52
IGANGA,2022,990,1060,2050,52
IGANGA,2023,1060,1140,2200,52
IGANGA,2024,1100,1210,2310,52
IGANGA,2025,1130,1260,2390,52
ISINGIRO,2015,1530,1590,3120,52
ISINGIRO,2016,1590,1650,3240,52
ISINGIRO,2017,1650,1710,3360,52
ISINGIRO,2018,1710,1770,3480,52
ISINGIRO,2019,1770,1830,3600,52
ISINGIRO,2020,1830,1890,3720,52
ISINGIRO,2021,1900,1950,3850,52
ISINGIRO,2022,1960,2020,3980,52
ISINGIRO,2023,2030,2080,4110,52
ISINGIRO,2024,2090,2140,4230,52
ISINGIRO,2025,2160,2210,4370,52
JINJA,2015,1240,1190,2430,52
JINJA,2016,1260,1210,2470,52
JINJA,2017,1290,1230,2520,52
JINJA,2018,1310,1250,2560,52
JINJA,2019,1330,1260,2590,52
JINJA,2020,1350,1280,2630,52
JINJA,2021,1370,1300,2670,52
JINJA,2022,1390,1320,2710,52
JINJA,2023,1400,1330,2730,52
JINJA,2024,1420,1350,2770,52
JINJA,2025,1440,1360,2800,52
KAABONG,2015,190,270,460,52
KAABONG,2016,200,270,470,52
KAABONG,2017,200,280,480,52
KAABONG,2018,210,290,500,52
KAABONG,2019,210,290,500,52
KAABONG,2020,220,300,520,52
KAABONG,2021,230,310,540,52
KAABONG,2022,230,320,550,52
KAABONG,2023,240,320,560,52
KAABONG,2024,240,330,570,52
KAABONG,2025,250,330,580,52
KABALE,2015,630,790,1420,52
KABALE,2016,640,800,1440,52
KABALE,2017,650,810,1460,52
KABALE,2018,660,820,1480,52
KABALE,2019,670,830,1500,52
KABALE,2020,680,840,1520,52
KABALE,2021,690,850,1540,52
KABALE,2022,700,860,1560,52
KABALE,2023,710,860,1570,52
KABALE,2024,720,870,1590,52
KABALE,2025,720,880,1600,52
KABAROLE,2015,770,840,1610,52
KABAROLE,2016,780,850,1630,52
KABAROLE,2017,800,870,1670,52
KABAROLE,2018,820,890,1710,52
KABAROLE,2019,840,910,1750,52
KABAROLE,2020,850,930,1780,52
KABAROLE,2021,870,950,1820,52
KABAROLE,2022,890,960,1850,52
KABAROLE,2023,900,980,1880,52
KABAROLE,2024,920,1000,1920,52
KABAROLE,2025,930,1020,1950,52
KABERAMAIDO,2015,260,290,550,52
KABERAMAIDO,2016,260,280,540,52
KABERAMAIDO,2017,260,270,530,52
KABERAMAIDO,2018,270,270,540,52
KABERAMAIDO,2019,280,280,560,52
KABERAMAIDO,2020,300,300,600,52
KABERAMAIDO,2021,330,320,650,52
KABERAMAIDO,2022,350,360,710,52
KABERAMAIDO,2023,380,390,770,52
KABERAMAIDO,2024,410,410,820,52
KABERAMAIDO,2025,420,440,860,52
KAGADI,2015,830,890,1720,52
KAGADI,2016,860,920,1780,52
KAGADI,2017,890,950,1840,52
KAGADI,2018,920,980,1900,52
KAGADI,2019,950,1020,1970,52
KAGADI,2020,990,1050,2040,52
KAGADI,2021,1020,1090,2110,52
KAGADI,2022,1060,1120,2180,52
KAGADI,2023,1090,1160,2250,52
KAGADI,2024,1130,1200,2330,52
KAGADI,2025,1160,1230,2390,52
KAKUMIRO,2015,800,700,1500,52
KAKUMIRO,2016,880,760,1640,52
KAKUMIRO,2017,950,830,1780,52
KAKUMIRO,2018,1040,890,1930,52
KAKUMIRO,2019,1130,970,2100,52
KAKUMIRO,2020,1230,1050,2280,52
KAKUMIRO,2021,1330,1130,2460,52
KAKUMIRO,2022,1440,1230,2670,52
KAKUMIRO,2023,1570,1330,2900,52
KAKUMIRO,2024,1700,1430,3130,52
KAKUMIRO,2025,1840,1540,3380,52
KALAKI,2015,270,230,500,52
KALAKI,2016,280,230,510,52
KALAKI,2017,300,240,540,52
KALAKI,2018,310,250,560,52
KALAKI,2019,320,260,580,52
KALAKI,2020,330,270,600,52
KALAKI,2021,350,280,630,52
KALAKI,2022,360,290,650,52
KALAKI,2023,380,300,680,52
KALAKI,2024,390,320,710,52
KALAKI,2025,410,330,740,52
KALANGALA,2015,240,100,340,52
KALANGALA,2016,250,100,350,52
KALANGALA,2017,260,110,370,52
KALANGALA,2018,270,110,380,52
KALANGALA,2019,280,120,400,52
KALANGALA,2020,290,120,410,52
KALANGALA,2021,300,120,420,52
KALANGALA,2022,310,130,440,52
KALANGALA,2023,320,130,450,52
KALANGALA,2024,330,140,470,52
KALANGALA,2025,340,140,480,52
KALIRO,2015,520,490,1010,52
KALIRO,2016,530,490,1020,52
KALIRO,2017,530,460,990,52
KALIRO,2018,530,460,990,52
KALIRO,2019,560,470,1030,52
KALIRO,2020,590,500,1090,52
KALIRO,2021,640,550,1190,52
KALIRO,2022,690,600,1290,52
KALIRO,2023,740,650,1390,52
KALIRO,2024,770,690,1460,52
KALIRO,2025,800,720,1520,52
KALUNGU,2015,440,580,1020,52
KALUNGU,2016,430,560,990,52
KALUNGU,2017,430,530,960,52
KALUNGU,2018,420,510,930,52
KALUNGU,2019,430,500,930,52
KALUNGU,2020,440,520,960,52
KALUNGU,2021,470,550,1020,52
KALUNGU,2022,490,600,1090,52
KALUNGU,2023,510,630,1140,52
KALUNGU,2024,520,660,1180,52
KALUNGU,2025,530,660,1190,52
KAMPALA,2015,3080,3000,6080,52
KAMPALA,2016,3140,3060,6200,52
KAMPALA,2017,3200,3120,6320,52
KAMPALA,2018,3260,3180,6440,52
KAMPALA,2019,3330,3240,6570,52
KAMPALA,2020,3390,3300,6690,52
KAMPALA,2021,3450,3360,6810,52
KAMPALA,2022,3500,3410,6910,52
KAMPALA,2023,3560,3470,7030,52
KAMPALA,2024,3610,3520,7130,52
KAMPALA,2025,3670,3570,7240,52
KAMULI,2015,1040,1330,2370,52
KAMULI,2016,1040,1280,2320,52
KAMULI,2017,1040,1230,2270,52
KAMULI,2018,1040,1190,2230,52
KAMULI,2019,1080,1200,2280,52
KAMULI,2020,1130,1260,2390,52
KAMULI,2021,1200,1360,2560,52
KAMULI,2022,1290,1470,2760,52
KAMULI,2023,1370,1570,2940,52
KAMULI,2024,1420,1650,3070,52
KAMULI,2025,1460,1700,3160,52
KAMWENGE,2015,800,770,1570,52
KAMWENGE,2016,830,790,1620,52
KAMWENGE,2017,860,820,1680,52
KAMWENGE,2018,900,850,1750,52
KAMWENGE,2019,930,880,1810,52
KAMWENGE,2020,970,910,1880,52
KAMWENGE,2021,1010,940,1950,52
KAMWENGE,2022,1050,970,2020,52
KAMWENGE,2023,1080,1000,2080,52
KAMWENGE,2024,1120,1030,2150,52
KAMWENGE,2025,1160,1070,2230,52
KANUNGU,2015,690,880,1570,52
KANUNGU,2016,710,900,1610,52
KANUNGU,2017,720,910,1630,52
KANUNGU,2018,730,930,1660,52
KANUNGU,2019,740,940,1680,52
KANUNGU,2020,760,950,1710,52
KANUNGU,2021,770,970,1740,52
KANUNGU,2022,780,980,1760,52
KANUNGU,2023,790,990,1780,52
KANUNGU,2024,800,1000,1800,52
KANUNGU,2025,810,1020,1830,52
KAPCHORWA,2015,320,250,570,52
KAPCHORWA,2016,330,250,580,52
KAPCHORWA,2017,340,260,600,52
KAPCHORWA,2018,350,270,620,52
KAPCHORWA,2019,360,270,630,52
KAPCHORWA,2020,370,280,650,52
KAPCHORWA,2021,380,290,670,52
KAPCHORWA,2022,390,300,690,52
KAPCHORWA,2023,400,300,700,52
KAPCHORWA,2024,410,310,720,52
KAPCHORWA,2025,420,320,740,52
KAPELEBYONG,2015,180,180,360,52
KAPELEBYONG,2016,190,170,360,52
KAPELEBYONG,2017,190,170,360,52
KAPELEBYONG,2018,190,160,350,52
KAPELEBYONG,2019,190,160,350,52
KAPELEBYONG,2020,210,170,380,52
KAPELEBYONG,2021,230,190,420,52
KAPELEBYONG,2022,240,200,440,52
KAPELEBYONG,2023,250,220,470,52
KAPELEBYONG,2024,270,230,500,52
KAPELEBYONG,2025,280,240,520,52
KASESE,2015,1460,1760,3220,52
KASESE,2016,1470,1700,3170,52
KASESE,2017,1460,1630,3090,52
KASESE,2018,1470,1590,3060,52
KASESE,2019,1500,1590,3090,52
KASESE,2020,1580,1680,3260,52
KASESE,2021,1690,1810,3500,52
KASESE,2022,1800,1960,3760,52
KASESE,2023,1910,2090,4000,52
KASESE,2024,1980,2190,4170,52
KASESE,2025,2020,2250,4270,52
KASSANDA,2015,750,770,1520,52
KASSANDA,2016,770,790,1560,52
KASSANDA,2017,790,810,1600,52
KASSANDA,2018,820,820,1640,52
KASSANDA,2019,840,840,1680,52
KASSANDA,2020,860,860,1720,52
KASSANDA,2021,880,870,1750,52
KASSANDA,2022,910,890,1800,52
KASSANDA,2023,930,910,1840,52
KASSANDA,2024,950,920,1870,52
KASSANDA,2025,970,940,1910,52
KATAKWI,2015,370,400,770,52
KATAKWI,2016,370,380,750,52
KATAKWI,2017,370,370,740,52
KATAKWI,2018,380,370,750,52
KATAKWI,2019,390,370,760,52
KATAKWI,2020,420,390,810,52
KATAKWI,2021,440,420,860,52
KATAKWI,2022,480,460,940,52
KATAKWI,2023,510,490,1000,52
KATAKWI,2024,520,510,1030,52
KATAKWI,2025,540,530,1070,52
KAYUNGA,2015,830,1010,1840,52
KAYUNGA,2016,820,970,1790,52
KAYUNGA,2017,810,920,1730,52
KAYUNGA,2018,820,890,1710,52
KAYUNGA,2019,830,900,1730,52
KAYUNGA,2020,870,930,1800,52
KAYUNGA,2021,930,1000,1930,52
KAYUNGA,2022,990,1070,2060,52
KAYUNGA,2023,1040,1140,2180,52
KAYUNGA,2024,1080,1190,2270,52
KAYUNGA,2025,1090,1220,2310,52
KAZO,2015,640,590,1230,52
KAZO,2016,670,610,1280,52
KAZO,2017,690,630,1320,52
KAZO,2018,720,650,1370,52
KAZO,2019,750,670,1420,52
KAZO,2020,770,700,1470,52
KAZO,2021,800,720,1520,52
KAZO,2022,830,740,1570,52
KAZO,2023,850,770,1620,52
KAZO,2024,880,790,1670,52
KAZO,2025,910,820,1730,52
KIBAALE,2015,340,330,670,52
KIBAALE,2016,360,350,710,52
KIBAALE,2017,380,370,750,52
KIBAALE,2018,400,390,790,52
KIBAALE,2019,430,410,840,52
KIBAALE,2020,460,430,890,52
KIBAALE,2021,480,460,940,52
KIBAALE,2022,510,480,990,52
KIBAALE,2023,540,510,1050,52
KIBAALE,2024,580,540,1120,52
KIBAALE,2025,610,570,1180,52
KIBOGA,2015,350,400,750,52
KIBOGA,2016,360,410,770,52
KIBOGA,2017,370,390,760,52
KIBOGA,2018,360,380,740,52
KIBOGA,2019,370,360,730,52
KIBOGA,2020,370,370,740,52
KIBOGA,2021,390,390,780,52
KIBOGA,2022,420,420,840,52
KIBOGA,2023,440,460,900,52
KIBOGA,2024,470,480,950,52
KIBOGA,2025,500,510,1010,52
KIBUKU,2015,430,450,880,52
KIBUKU,2016,420,440,860,52
KIBUKU,2017,430,420,850,52
KIBUKU,2018,440,420,860,52
KIBUKU,2019,460,430,890,52
KIBUKU,2020,490,460,950,52
KIBUKU,2021,530,500,1030,52
KIBUKU,2022,570,550,1120,52
KIBUKU,2023,620,590,1210,52
KIBUKU,2024,650,620,1270,52
KIBUKU,2025,670,650,1320,52
KIKUUBE,2015,750,630,1380,52
KIKUUBE,2016,800,670,1470,52
KIKUUBE,2017,840,700,1540,52
KIKUUBE,2018,880,730,1610,52
KIKUUBE,2019,930,770,1700,52
KIKUUBE,2020,980,810,1790,52
KIKUUBE,2021,1030,850,1880,52
KIKUUBE,2022,1080,890,1970,52
KIKUUBE,2023,1130,930,2060,52
KIKUUBE,2024,1190,980,2170,52
KIKUUBE,2025,1240,1020,2260,52
KIRUHURA,2015,520,450,970,52
KIRUHURA,2016,540,460,1000,52
KIRUHURA,2017,560,480,1040,52
KIRUHURA,2018,580,490,1070,52
KIRUHURA,2019,600,510,1110,52
KIRUHURA,2020,620,530,1150,52
KIRUHURA,2021,640,550,1190,52
KIRUHURA,2022,670,570,1240,52
KIRUHURA,2023,690,580,1270,52
KIRUHURA,2024,710,600,1310,52
KIRUHURA,2025,730,620,1350,52
KIRYANDONGO,2015,580,630,1210,52
KIRYANDONGO,2016,590,620,1210,52
KIRYANDONGO,2017,580,600,1180,52
KIRYANDONGO,2018,600,580,1180,52
KIRYANDONGO,2019,610,590,1200,52
KIRYANDONGO,2020,650,630,1280,52
KIRYANDONGO,2021,690,670,1360,52
KIRYANDONGO,2022,750,730,1480,52
KIRYANDONGO,2023,790,780,1570,52
KIRYANDONGO,2024,830,830,1660,52
KIRYANDONGO,2025,860,860,1720,52
KISORO,2015,550,830,1380,52
KISORO,2016,550,800,1350,52
KISORO,2017,540,760,1300,52
KISORO,2018,540,740,1280,52
KISORO,2019,560,740,1300,52
KISORO,2020,580,780,1360,52
KISORO,2021,620,840,1460,52
KISORO,2022,660,900,1560,52
KISORO,2023,690,960,1650,52
KISORO,2024,710,1000,1710,52
KISORO,2025,720,1040,1760,52
KITAGWENDA,2015,420,510,930,52
KITAGWENDA,2016,440,520,960,52
KITAGWENDA,2017,460,540,1000,52
KITAGWENDA,2018,480,560,1040,52
KITAGWENDA,2019,490,580,1070,52
KITAGWENDA,2020,520,600,1120,52
KITAGWENDA,2021,530,620,1150,52
KITAGWENDA,2022,550,640,1190,52
KITAGWENDA,2023,580,660,1240,52
KITAGWENDA,2024,600,680,1280,52
KITAGWENDA,2025,620,700,1320,52
KITGUM,2015,490,600,1090,52
KITGUM,2016,480,580,1060,52
KITGUM,2017,480,550,1030,52
KITGUM,2018,480,530,1010,52
KITGUM,2019,490,530,1020,52
KITGUM,2020,510,560,1070,52
KITGUM,2021,540,600,1140,52
KITGUM,2022,570,650,1220,52
KITGUM,2023,600,690,1290,52
KITGUM,2024,620,710,1330,52
KITGUM,2025,620,730,1350,52
KOBOKO,2015,460,410,870,52
KOBOKO,2016,470,400,870,52
KOBOKO,2017,480,390,870,52
KOBOKO,2018,490,380,870,52
KOBOKO,2019,500,390,890,52
KOBOKO,2020,540,410,950,52
KOBOKO,2021,580,460,1040,52
KOBOKO,2022,630,500,1130,52
KOBOKO,2023,680,550,1230,52
KOBOKO,2024,710,580,1290,52
KOBOKO,2025,740,610,1350,52
KOLE,2015,670,630,1300,52
KOLE,2016,690,650,1340,52
KOLE,2017,710,670,1380,52
KOLE,2018,730,690,1420,52
KOLE,2019,760,710,1470,52
KOLE,2020,780,720,1500,52
KOLE,2021,800,740,1540,52
KOLE,2022,830,760,1590,52
KOLE,2023,850,780,1630,52
KOLE,2024,880,800,1680,52
KOLE,2025,900,820,1720,52
KOTIDO,2015,290,330,620,52
KOTIDO,2016,290,320,610,52
KOTIDO,2017,290,310,600,52
KOTIDO,2018,290,290,580,52
KOTIDO,2019,300,300,600,52
KOTIDO,2020,310,310,620,52
KOTIDO,2021,330,340,670,52
KOTIDO,2022,350,360,710,52
KOTIDO,2023,370,390,760,52
KOTIDO,2024,390,410,800,52
KOTIDO,2025,400,410,810,52
KUMI,2015,560,650,1210,52
KUMI,2016,560,640,1200,52
KUMI,2017,560,610,1170,52
KUMI,2018,570,600,1170,52
KUMI,2019,590,610,1200,52
KUMI,2020,620,640,1260,52
KUMI,2021,680,700,1380,52
KUMI,2022,720,760,1480,52
KUMI,2023,770,810,1580,52
KUMI,2024,810,860,1670,52
KUMI,2025,830,890,1720,52
KWANIA,2015,480,540,1020,52
KWANIA,2016,500,560,1060,52
KWANIA,2017,510,570,1080,52
KWANIA,2018,530,590,1120,52
KWANIA,2019,540,600,1140,52
KWANIA,2020,560,620,1180,52
KWANIA,2021,580,640,1220,52
KWANIA,2022,590,650,1240,52
KWANIA,2023,610,670,1280,52
KWANIA,2024,620,690,1310,52
KWANIA,2025,640,700,1340,52
KWEEN,2015,250,220,470,52
KWEEN,2016,260,230,490,52
KWEEN,2017,260,240,500,52
KWEEN,2018,270,240,510,52
KWEEN,2019,280,250,530,52
KWEEN,2020,290,250,540,52
KWEEN,2021,300,260,560,52
KWEEN,2022,300,270,570,52
KWEEN,2023,310,270,580,52
KWEEN,2024,320,280,600,52
KWEEN,2025,330,280,610,52
KYANKWANZI,2015,670,550,1220,52
KYANKWANZI,2016,710,570,1280,52
KYANKWANZI,2017,740,600,1340,52
KYANKWANZI,2018,780,630,1410,52
KYANKWANZI,2019,820,650,1470,52
KYANKWANZI,2020,860,680,1540,52
KYANKWANZI,2021,900,720,1620,52
KYANKWANZI,2022,950,750,1700,52
KYANKWANZI,2023,990,780,1770,52
KYANKWANZI,2024,1040,810,1850,52
KYANKWANZI,2025,1080,850,1930,52
KYEGEGWA,2015,810,710,1520,52
KYEGEGWA,2016,880,770,1650,52
KYEGEGWA,2017,950,830,1780,52
KYEGEGWA,2018,1030,900,1930,52
KYEGEGWA,2019,1110,970,2080,52
KYEGEGWA,2020,1200,1040,2240,52
KYEGEGWA,2021,1290,1120,2410,52
KYEGEGWA,2022,1400,1210,2610,52
KYEGEGWA,2023,1500,1300,2800,52
KYEGEGWA,2024,1620,1400,3020,52
KYEGEGWA,2025,1740,1500,3240,52
KYENJOJO,2015,980,1040,2020,52
KYENJOJO,2016,1020,1080,2100,52
KYENJOJO,2017,1060,1120,2180,52
KYENJOJO,2018,1100,1160,2260,52
KYENJOJO,2019,1150,1200,2350,52
KYENJOJO,2020,1190,1240,2430,52
KYENJOJO,2021,1240,1290,2530,52
KYENJOJO,2022,1280,1330,2610,52
KYENJOJO,2023,1330,1380,2710,52
KYENJOJO,2024,1380,1420,2800,52
KYENJOJO,2025,1430,1470,2900,52
KYOTERA,2015,500,690,1190,52
KYOTERA,2016,500,670,1170,52
KYOTERA,2017,490,630,1120,52
KYOTERA,2018,490,610,1100,52
KYOTERA,2019,500,610,1110,52
KYOTERA,2020,520,630,1150,52
KYOTERA,2021,550,680,1230,52
KYOTERA,2022,590,720,1310,52
KYOTERA,2023,620,760,1380,52
KYOTERA,2024,640,800,1440,52
KYOTERA,2025,650,820,1470,52
KARENGA,2015,130,130,260,52
KARENGA,2016,130,140,270,52
KARENGA,2017,130,140,270,52
KARENGA,2018,140,140,280,52
KARENGA,2019,140,150,290,52
KARENGA,2020,150,150,300,52
KARENGA,2021,150,150,300,52
KARENGA,2022,150,160,310,52
KARENGA,2023,150,160,310,52
KARENGA,2024,160,160,320,52
KARENGA,2025,160,170,330,52
LAMWO,2015,320,390,710,52
LAMWO,2016,320,370,690,52
LAMWO,2017,310,350,660,52
LAMWO,2018,320,340,660,52
LAMWO,2019,320,350,670,52
LAMWO,2020,320,360,680,52
LAMWO,2021,350,380,730,52
LAMWO,2022,360,410,770,52
LAMWO,2023,370,440,810,52
LAMWO,2024,380,450,830,52
LAMWO,2025,390,460,850,52
LIRA,2015,1040,1040,2080,52
LIRA,2016,1070,1060,2130,52
LIRA,2017,1100,1100,2200,52
LIRA,2018,1130,1130,2260,52
LIRA,2019,1160,1160,2320,52
LIRA,2020,1190,1190,2380,52
LIRA,2021,1220,1220,2440,52
LIRA,2022,1250,1250,2500,52
LIRA,2023,1280,1280,2560,52
LIRA,2024,1310,1320,2630,52
LIRA,2025,1340,1350,2690,52
LUUKA,2015,490,660,1150,52
LUUKA,2016,480,650,1130,52
LUUKA,2017,480,610,1090,52
LUUKA,2018,480,600,1080,52
LUUKA,2019,490,600,1090,52
LUUKA,2020,520,630,1150,52
LUUKA,2021,550,680,1230,52
LUUKA,2022,580,730,1310,52
LUUKA,2023,610,770,1380,52
LUUKA,2024,630,810,1440,52
LUUKA,2025,650,830,1480,52
LUWERO,2015,1030,1200,2230,52
LUWERO,2016,1030,1160,2190,52
LUWERO,2017,1020,1110,2130,52
LUWERO,2018,1030,1080,2110,52
LUWERO,2019,1060,1090,2150,52
LUWERO,2020,1110,1140,2250,52
LUWERO,2021,1190,1230,2420,52
LUWERO,2022,1270,1340,2610,52
LUWERO,2023,1340,1420,2760,52
LUWERO,2024,1390,1490,2880,52
LUWERO,2025,1420,1540,2960,52
LWENGO,2015,560,840,1400,52
LWENGO,2016,550,810,1360,52
LWENGO,2017,540,750,1290,52
LWENGO,2018,530,730,1260,52
LWENGO,2019,540,720,1260,52
LWENGO,2020,570,750,1320,52
LWENGO,2021,590,800,1390,52
LWENGO,2022,620,850,1470,52
LWENGO,2023,650,890,1540,52
LWENGO,2024,670,930,1600,52
LWENGO,2025,670,940,1610,52
LYANTONDE,2015,260,270,530,52
LYANTONDE,2016,260,250,510,52
LYANTONDE,2017,260,250,510,52
LYANTONDE,2018,270,240,510,52
LYANTONDE,2019,270,250,520,52
LYANTONDE,2020,290,250,540,52
LYANTONDE,2021,310,280,590,52
LYANTONDE,2022,330,300,630,52
LYANTONDE,2023,360,330,690,52
LYANTONDE,2024,370,350,720,52
LYANTONDE,2025,380,350,730,52
MANAFWA,2015,430,550,980,52
MANAFWA,2016,440,570,1010,52
MANAFWA,2017,450,580,1030,52
MANAFWA,2018,460,590,1050,52
MANAFWA,2019,470,600,1070,52
MANAFWA,2020,480,620,1100,52
MANAFWA,2021,500,630,1130,52
MANAFWA,2022,510,640,1150,52
MANAFWA,2023,520,650,1170,52
MANAFWA,2024,530,670,1200,52
MANAFWA,2025,540,680,1220,52
MARACHA,2015,560,620,1180,52
MARACHA,2016,580,630,1210,52
MARACHA,2017,590,640,1230,52
MARACHA,2018,600,650,1250,52
MARACHA,2019,610,670,1280,52
MARACHA,2020,620,680,1300,52
MARACHA,2021,640,690,1330,52
MARACHA,2022,650,700,1350,52
MARACHA,2023,660,710,1370,52
MARACHA,2024,670,720,1390,52
MARACHA,2025,680,730,1410,52
MASAKA,2015,580,720,1300,52
MASAKA,2016,620,760,1380,52
MASAKA,2017,630,760,1390,52
MASAKA,2018,630,740,1370,52
MASAKA,2019,630,700,1330,52
MASAKA,2020,630,690,1320,52
MASAKA,2021,640,690,1330,52
MASAKA,2022,680,720,1400,52
MASAKA,2023,720,780,1500,52
MASAKA,2024,760,840,1600,52
MASAKA,2025,800,890,1690,52
MASINDI,2015,860,670,1530,52
MASINDI,2016,890,690,1580,52
MASINDI,2017,910,710,1620,52
MASINDI,2018,940,730,1670,52
MASINDI,2019,970,740,1710,52
MASINDI,2020,990,760,1750,52
MASINDI,2021,1020,780,1800,52
MASINDI,2022,1050,800,1850,52
MASINDI,2023,1070,820,1890,52
MASINDI,2024,1100,840,1940,52
MASINDI,2025,1120,860,1980,52
MAYUGE,2015,1030,1200,2230,52
MAYUGE,2016,1030,1170,2200,52
MAYUGE,2017,1040,1130,2170,52
MAYUGE,2018,1050,1110,2160,52
MAYUGE,2019,1080,1130,2210,52
MAYUGE,2020,1150,1190,2340,52
MAYUGE,2021,1230,1300,2530,52
MAYUGE,2022,1330,1410,2740,52
MAYUGE,2023,1410,1520,2930,52
MAYUGE,2024,1480,1610,3090,52
MAYUGE,2025,1510,1670,3180,52
MBALE,2015,1220,1460,2680,52
MBALE,2016,1220,1430,2650,52
MBALE,2017,1230,1380,2610,52
MBALE,2018,1240,1360,2600,52
MBALE,2019,1280,1380,2660,52
MBALE,2020,1360,1470,2830,52
MBALE,2021,1450,1600,3050,52
MBALE,2022,1560,1750,3310,52
MBALE,2023,1660,1890,3550,52
MBALE,2024,1730,2000,3730,52
MBALE,2025,1780,2080,3860,52
MBARARA,2015,940,960,1900,52
MBARARA,2016,960,980,1940,52
MBARARA,2017,980,1000,1980,52
MBARARA,2018,1010,1020,2030,52
MBARARA,2019,1030,1040,2070,52
MBARARA,2020,1050,1060,2110,52
MBARARA,2021,1070,1080,2150,52
MBARARA,2022,1090,1100,2190,52
MBARARA,2023,1110,1120,2230,52
MBARARA,2024,1130,1140,2270,52
MBARARA,2025,1150,1160,2310,52
MITOOMA,2015,460,650,1110,52
MITOOMA,2016,460,660,1120,52
MITOOMA,2017,470,670,1140,52
MITOOMA,2018,470,670,1140,52
MITOOMA,2019,480,680,1160,52
MITOOMA,2020,480,680,1160,52
MITOOMA,2021,490,690,1180,52
MITOOMA,2022,490,690,1180,52
MITOOMA,2023,500,700,1200,52
MITOOMA,2024,500,700,1200,52
MITOOMA,2025,500,700,1200,52
MITYANA,2015,780,970,1750,52
MITYANA,2016,770,940,1710,52
MITYANA,2017,760,880,1640,52
MITYANA,2018,770,860,1630,52
MITYANA,2019,780,850,1630,52
MITYANA,2020,810,900,1710,52
MITYANA,2021,870,960,1830,52
MITYANA,2022,920,1030,1950,52
MITYANA,2023,960,1090,2050,52
MITYANA,2024,1000,1140,2140,52
MITYANA,2025,1010,1170,2180,52
MOROTO,2015,150,190,340,52
MOROTO,2016,140,190,330,52
MOROTO,2017,150,180,330,52
MOROTO,2018,150,180,330,52
MOROTO,2019,150,170,320,52
MOROTO,2020,160,190,350,52
MOROTO,2021,160,200,360,52
MOROTO,2022,180,220,400,52
MOROTO,2023,190,230,420,52
MOROTO,2024,190,250,440,52
MOROTO,2025,200,250,450,52
MOYO,2015,290,310,600,52
MOYO,2016,300,320,620,52
MOYO,2017,300,330,630,52
MOYO,2018,310,340,650,52
MOYO,2019,320,340,660,52
MOYO,2020,330,350,680,52
MOYO,2021,330,360,690,52
MOYO,2022,340,360,700,52
MOYO,2023,350,370,720,52
MOYO,2024,360,380,740,52
MOYO,2025,360,380,740,52
MPIGI,2015,530,710,1240,52
MPIGI,2016,530,680,1210,52
MPIGI,2017,530,660,1190,52
MPIGI,2018,530,640,1170,52
MPIGI,2019,550,640,1190,52
MPIGI,2020,570,680,1250,52
MPIGI,2021,620,730,1350,52
MPIGI,2022,650,790,1440,52
MPIGI,2023,690,840,1530,52
MPIGI,2024,720,880,1600,52
MPIGI,2025,730,910,1640,52
MUBENDE,2015,840,780,1620,52
MUBENDE,2016,950,890,1840,52
MUBENDE,2017,1040,970,2010,52
MUBENDE,2018,1090,1010,2100,52
MUBENDE,2019,1130,1010,2140,52
MUBENDE,2020,1150,980,2130,52
MUBENDE,2021,1190,980,2170,52
MUBENDE,2022,1260,1020,2280,52
MUBENDE,2023,1360,1100,2460,52
MUBENDE,2024,1490,1220,2710,52
MUBENDE,2025,1630,1360,2990,52
MUKONO,2015,1360,1740,3100,52
MUKONO,2016,1370,1700,3070,52
MUKONO,2017,1360,1630,2990,52
MUKONO,2018,1370,1600,2970,52
MUKONO,2019,1410,1620,3030,52
MUKONO,2020,1490,1710,3200,52
MUKONO,2021,1590,1860,3450,52
MUKONO,2022,1700,2020,3720,52
MUKONO,2023,1800,2170,3970,52
MUKONO,2024,1890,2290,4180,52
MUKONO,2025,1920,2390,4310,52
MADI OKOLLO,2015,520,520,1040,52
MADI OKOLLO,2016,530,540,1070,52
MADI OKOLLO,2017,550,550,1100,52
MADI OKOLLO,2018,560,570,1130,52
MADI OKOLLO,2019,580,580,1160,52
MADI OKOLLO,2020,600,590,1190,52
MADI OKOLLO,2021,610,610,1220,52
MADI OKOLLO,2022,630,630,1260,52
MADI OKOLLO,2023,640,640,1280,52
MADI OKOLLO,2024,660,650,1310,52
MADI OKOLLO,2025,670,670,1340,52
NABILATUK,2015,80,120,200,52
NABILATUK,2016,80,120,200,52
NABILATUK,2017,80,110,190,52
NABILATUK,2018,90,120,210,52
NABILATUK,2019,90,120,210,52
NABILATUK,2020,100,130,230,52
NABILATUK,2021,100,140,240,52
NABILATUK,2022,120,160,280,52
NABILATUK,2023,130,170,300,52
NABILATUK,2024,130,180,310,52
NABILATUK,2025,140,200,340,52
NAKAPIRIPIRIT,2015,170,170,340,52
NAKAPIRIPIRIT,2016,180,170,350,52
NAKAPIRIPIRIT,2017,180,170,350,52
NAKAPIRIPIRIT,2018,190,170,360,52
NAKAPIRIPIRIT,2019,190,160,350,52
NAKAPIRIPIRIT,2020,210,180,390,52
NAKAPIRIPIRIT,2021,230,200,430,52
NAKAPIRIPIRIT,2022,240,220,460,52
NAKAPIRIPIRIT,2023,260,240,500,52
NAKAPIRIPIRIT,2024,280,260,540,52
NAKAPIRIPIRIT,2025,300,270,570,52
NAKASEKE,2015,650,500,1150,52
NAKASEKE,2016,680,510,1190,52
NAKASEKE,2017,700,520,1220,52
NAKASEKE,2018,730,530,1260,52
NAKASEKE,2019,750,540,1290,52
NAKASEKE,2020,780,560,1340,52
NAKASEKE,2021,810,570,1380,52
NAKASEKE,2022,830,580,1410,52
NAKASEKE,2023,860,590,1450,52
NAKASEKE,2024,890,600,1490,52
NAKASEKE,2025,920,620,1540,52
NAKASONGOLA,2015,430,430,860,52
NAKASONGOLA,2016,440,440,880,52
NAKASONGOLA,2017,460,460,920,52
NAKASONGOLA,2018,500,500,1000,52
NAKASONGOLA,2019,530,540,1070,52
NAKASONGOLA,2020,560,580,1140,52
NAKASONGOLA,2021,600,620,1220,52
NAKASONGOLA,2022,620,640,1260,52
NAKASONGOLA,2023,620,650,1270,52
NAKASONGOLA,2024,630,670,1300,52
NAKASONGOLA,2025,640,690,1330,52
NAMAYINGO,2015,530,550,1080,52
NAMAYINGO,2016,530,530,1060,52
NAMAYINGO,2017,520,510,1030,52
NAMAYINGO,2018,520,480,1000,52
NAMAYINGO,2019,530,480,1010,52
NAMAYINGO,2020,560,510,1070,52
NAMAYINGO,2021,590,550,1140,52
NAMAYINGO,2022,620,580,1200,52
NAMAYINGO,2023,650,620,1270,52
NAMAYINGO,2024,680,650,1330,52
NAMAYINGO,2025,690,650,1340,52
NAMISINDWA,2015,560,610,1170,52
NAMISINDWA,2016,580,620,1200,52
NAMISINDWA,2017,590,640,1230,52
NAMISINDWA,2018,610,650,1260,52
NAMISINDWA,2019,630,670,1300,52
NAMISINDWA,2020,640,680,1320,52
NAMISINDWA,2021,660,700,1360,52
NAMISINDWA,2022,670,710,1380,52
NAMISINDWA,2023,690,730,1420,52
NAMISINDWA,2024,710,740,1450,52
NAMISINDWA,2025,720,760,1480,52
NAMUTUMBA,2015,560,620,1180,52
NAMUTUMBA,2016,560,610,1170,52
NAMUTUMBA,2017,560,590,1150,52
NAMUTUMBA,2018,570,580,1150,52
NAMUTUMBA,2019,590,590,1180,52
NAMUTUMBA,2020,630,630,1260,52
NAMUTUMBA,2021,680,680,1360,52
NAMUTUMBA,2022,730,750,1480,52
NAMUTUMBA,2023,790,800,1590,52
NAMUTUMBA,2024,830,850,1680,52
NAMUTUMBA,2025,850,880,1730,52
NAPAK,2015,210,410,620,52
NAPAK,2016,200,390,590,52
NAPAK,2017,210,380,590,52
NAPAK,2018,200,370,570,52
NAPAK,2019,200,370,570,52
NAPAK,2020,220,390,610,52
NAPAK,2021,230,420,650,52
NAPAK,2022,240,450,690,52
NAPAK,2023,250,480,730,52
NAPAK,2024,260,500,760,52
NAPAK,2025,270,520,790,52
NEBBI,2015,640,780,1420,52
NEBBI,2016,660,800,1460,52
NEBBI,2017,690,820,1510,52
NEBBI,2018,710,850,1560,52
NEBBI,2019,730,870,1600,52
NEBBI,2020,750,890,1640,52
NEBBI,2021,770,920,1690,52
NEBBI,2022,800,940,1740,52
NEBBI,2023,820,960,1780,52
NEBBI,2024,840,990,1830,52
NEBBI,2025,860,1010,1870,52
NGORA,2015,330,350,680,52
NGORA,2016,330,340,670,52
NGORA,2017,330,320,650,52
NGORA,2018,330,320,650,52
NGORA,2019,340,320,660,52
NGORA,2020,360,340,700,52
NGORA,2021,390,360,750,52
NGORA,2022,420,390,810,52
NGORA,2023,440,420,860,52
NGORA,2024,460,440,900,52
NGORA,2025,470,460,930,52
NTOROKO,2015,180,180,360,52
NTOROKO,2016,190,170,360,52
NTOROKO,2017,180,170,350,52
NTOROKO,2018,190,160,350,52
NTOROKO,2019,190,160,350,52
NTOROKO,2020,200,170,370,52
NTOROKO,2021,220,180,400,52
NTOROKO,2022,230,190,420,52
NTOROKO,2023,240,210,450,52
NTOROKO,2024,250,220,470,52
NTOROKO,2025,260,220,480,52
NTUNGAMO,2015,1330,1630,2960,52
NTUNGAMO,2016,1360,1660,3020,52
NTUNGAMO,2017,1390,1690,3080,52
NTUNGAMO,2018,1420,1720,3140,52
NTUNGAMO,2019,1450,1750,3200,52
NTUNGAMO,2020,1480,1780,3260,52
NTUNGAMO,2021,1510,1810,3320,52
NTUNGAMO,2022,1540,1840,3380,52
NTUNGAMO,2023,1560,1870,3430,52
NTUNGAMO,2024,1590,1900,3490,52
NTUNGAMO,2025,1610,1920,3530,52
NWOYA,2015,360,460,820,52
NWOYA,2016,400,510,910,52
NWOYA,2017,440,560,1000,52
NWOYA,2018,490,620,1110,52
NWOYA,2019,540,680,1220,52
NWOYA,2020,600,750,1350,52
NWOYA,2021,660,820,1480,52
NWOYA,2022,720,900,1620,52
NWOYA,2023,800,990,1790,52
NWOYA,2024,880,1090,1970,52
NWOYA,2025,960,1190,2150,52
OBONGI,2015,100,90,190,52
OBONGI,2016,110,80,190,52
OBONGI,2017,110,80,190,52
OBONGI,2018,110,80,190,52
OBONGI,2019,110,80,190,52
OBONGI,2020,120,80,200,52
OBONGI,2021,120,90,210,52
OBONGI,2022,140,90,230,52
OBONGI,2023,140,110,250,52
OBONGI,2024,140,110,250,52
OBONGI,2025,150,110,260,52
OMORO,2015,390,470,860,52
OMORO,2016,400,460,860,52
OMORO,2017,400,450,850,52
OMORO,2018,400,440,840,52
OMORO,2019,420,450,870,52
OMORO,2020,450,470,920,52
OMORO,2021,490,520,1010,52
OMORO,2022,530,570,1100,52
OMORO,2023,560,620,1180,52
OMORO,2024,580,660,1240,52
OMORO,2025,600,680,1280,52
OTUKE,2015,310,280,590,52
OTUKE,2016,320,290,610,52
OTUKE,2017,330,300,630,52
OTUKE,2018,350,320,670,52
OTUKE,2019,370,330,700,52
OTUKE,2020,380,340,720,52
OTUKE,2021,400,360,760,52
OTUKE,2022,410,370,780,52
OTUKE,2023,430,390,820,52
OTUKE,2024,450,400,850,52
OTUKE,2025,470,420,890,52
OYAM,2015,1030,1200,2230,52
OYAM,2016,1060,1230,2290,52
OYAM,2017,1090,1270,2360,52
OYAM,2018,1120,1310,2430,52
OYAM,2019,1160,1340,2500,52
OYAM,2020,1190,1380,2570,52
OYAM,2021,1220,1420,2640,52
OYAM,2022,1260,1460,2720,52
OYAM,2023,1290,1490,2780,52
OYAM,2024,1330,1530,2860,52
OYAM,2025,1360,1570,2930,52
PADER,2015,460,450,910,52
PADER,2016,460,440,900,52
PADER,2017,450,410,860,52
PADER,2018,450,400,850,52
PADER,2019,460,400,860,52
PADER,2020,480,420,900,52
PADER,2021,510,460,970,52
PADER,2022,540,490,1030,52
PADER,2023,570,530,1100,52
PADER,2024,590,540,1130,52
PADER,2025,600,560,1160,52
PAKWACH,2015,460,520,980,52
PAKWACH,2016,480,530,1010,52
PAKWACH,2017,500,550,1050,52
PAKWACH,2018,520,570,1090,52
PAKWACH,2019,540,590,1130,52
PAKWACH,2020,560,610,1170,52
PAKWACH,2021,580,640,1220,52
PAKWACH,2022,610,660,1270,52
PAKWACH,2023,630,680,1310,52
PAKWACH,2024,650,700,1350,52
PAKWACH,2025,680,720,1400,52
PALLISA,2015,600,630,1230,52
PALLISA,2016,610,630,1240,52
PALLISA,2017,630,610,1240,52
PALLISA,2018,640,600,1240,52
PALLISA,2019,670,620,1290,52
PALLISA,2020,720,670,1390,52
PALLISA,2021,780,730,1510,52
PALLISA,2022,850,810,1660,52
PALLISA,2023,920,880,1800,52
PALLISA,2024,970,940,1910,52
PALLISA,2025,1010,1000,2010,52
RAKAI,2015,640,780,1420,52
RAKAI,2016,640,750,1390,52
RAKAI,2017,640,720,1360,52
RAKAI,2018,650,700,1350,52
RAKAI,2019,660,710,1370,52
RAKAI,2020,700,750,1450,52
RAKAI,2021,750,800,1550,52
RAKAI,2022,800,860,1660,52
RAKAI,2023,840,920,1760,52
RAKAI,2024,880,970,1850,52
RAKAI,2025,900,1010,1910,52
RUBANDA,2015,540,710,1250,52
RUBANDA,2016,550,710,1260,52
RUBANDA,2017,550,720,1270,52
RUBANDA,2018,560,720,1280,52
RUBANDA,2019,570,730,1300,52
RUBANDA,2020,570,730,1300,52
RUBANDA,2021,580,740,1320,52
RUBANDA,2022,590,740,1330,52
RUBANDA,2023,590,740,1330,52
RUBANDA,2024,600,750,1350,52
RUBANDA,2025,600,750,1350,52
RUBIRIZI,2015,350,380,730,52
RUBIRIZI,2016,360,390,750,52
RUBIRIZI,2017,370,400,770,52
RUBIRIZI,2018,370,400,770,52
RUBIRIZI,2019,380,410,790,52
RUBIRIZI,2020,390,420,810,52
RUBIRIZI,2021,400,420,820,52
RUBIRIZI,2022,400,430,830,52
RUBIRIZI,2023,410,440,850,52
RUBIRIZI,2024,420,440,860,52
RUBIRIZI,2025,420,450,870,52
RUKIGA,2015,310,400,710,52
RUKIGA,2016,320,410,730,52
RUKIGA,2017,320,410,730,52
RUKIGA,2018,320,410,730,52
RUKIGA,2019,330,420,750,52
RUKIGA,2020,330,420,750,52
RUKIGA,2021,330,420,750,52
RUKIGA,2022,330,420,750,52
RUKIGA,2023,340,420,760,52
RUKIGA,2024,340,430,770,52
RUKIGA,2025,340,430,770,52
RUKUNGIRI,2015,880,1190,2070,52
RUKUNGIRI,2016,890,1200,2090,52
RUKUNGIRI,2017,900,1220,2120,52
RUKUNGIRI,2018,910,1230,2140,52
RUKUNGIRI,2019,920,1240,2160,52
RUKUNGIRI,2020,930,1250,2180,52
RUKUNGIRI,2021,940,1260,2200,52
RUKUNGIRI,2022,950,1270,2220,52
RUKUNGIRI,2023,950,1280,2230,52
RUKUNGIRI,2024,960,1280,2240,52
RUKUNGIRI,2025,970,1290,2260,52
RWAMPARA,2015,340,450,790,52
RWAMPARA,2016,350,460,810,52
RWAMPARA,2017,360,470,830,52
RWAMPARA,2018,370,480,850,52
RWAMPARA,2019,370,480,850,52
RWAMPARA,2020,380,490,870,52
RWAMPARA,2021,390,500,890,52
RWAMPARA,2022,400,510,910,52
RWAMPARA,2023,400,520,920,52
RWAMPARA,2024,410,530,940,52
RWAMPARA,2025,420,540,960,52
SERERE,2015,570,630,1200,52
SERERE,2016,590,620,1210,52
SERERE,2017,590,600,1190,52
SERERE,2018,610,590,1200,52
SERERE,2019,630,610,1240,52
SERERE,2020,670,650,1320,52
SERERE,2021,740,720,1460,52
SERERE,2022,800,790,1590,52
SERERE,2023,850,850,1700,52
SERERE,2024,900,910,1810,52
SERERE,2025,930,950,1880,52
SHEEMA,2015,600,800,1400,52
SHEEMA,2016,610,810,1420,52
SHEEMA,2017,620,820,1440,52
SHEEMA,2018,620,820,1440,52
SHEEMA,2019,630,830,1460,52
SHEEMA,2020,640,840,1480,52
SHEEMA,2021,640,850,1490,52
SHEEMA,2022,650,850,1500,52
SHEEMA,2023,660,860,1520,52
SHEEMA,2024,660,860,1520,52
SHEEMA,2025,660,870,1530,52
SIRONKO,2015,860,810,1670,52
SIRONKO,2016,880,820,1700,52
SIRONKO,2017,900,840,1740,52
SIRONKO,2018,920,860,1780,52
SIRONKO,2019,940,870,1810,52
SIRONKO,2020,970,890,1860,52
SIRONKO,2021,990,910,1900,52
SIRONKO,2022,1010,920,1930,52
SIRONKO,2023,1030,940,1970,52
SIRONKO,2024,1050,950,2000,52
SIRONKO,2025,1070,970,2040,52
SOROTI,2015,640,710,1350,52
SOROTI,2016,640,690,1330,52
SOROTI,2017,640,670,1310,52
SOROTI,2018,660,660,1320,52
SOROTI,2019,680,670,1350,52
SOROTI,2020,720,720,1440,52
SOROTI,2021,780,790,1570,52
SOROTI,2022,840,850,1690,52
SOROTI,2023,910,920,1830,52
SOROTI,2024,950,980,1930,52
SOROTI,2025,980,1030,2010,52
SSEMBABULE,2015,660,620,1280,52
SSEMBABULE,2016,660,600,1260,52
SSEMBABULE,2017,670,580,1250,52
SSEMBABULE,2018,670,570,1240,52
SSEMBABULE,2019,700,570,1270,52
SSEMBABULE,2020,730,600,1330,52
SSEMBABULE,2021,780,650,1430,52
SSEMBABULE,2022,840,710,1550,52
SSEMBABULE,2023,890,750,1640,52
SSEMBABULE,2024,930,800,1730,52
SSEMBABULE,2025,950,830,1780,52
TORORO,2015,1450,1570,3020,52
TORORO,2016,1490,1610,3100,52
TORORO,2017,1530,1650,3180,52
TORORO,2018,1570,1690,3260,52
TORORO,2019,1610,1730,3340,52
TORORO,2020,1650,1770,3420,52
TORORO,2021,1690,1810,3500,52
TORORO,2022,1730,1850,3580,52
TORORO,2023,1770,1890,3660,52
TORORO,2024,1810,1930,3740,52
TORORO,2025,1850,1970,3820,52
WAKISO,2015,4160,4130,8290,52
WAKISO,2016,4430,4420,8850,52
WAKISO,2017,4730,4720,9450,52
WAKISO,2018,5040,5040,10080,52
WAKISO,2019,5380,5380,10760,52
WAKISO,2020,5730,5730,11460,52
WAKISO,2021,6100,6110,12210,52
WAKISO,2022,6490,6520,13010,52
WAKISO,2023,6900,6940,13840,52
WAKISO,2024,7330,7380,14710,52
WAKISO,2025,7780,7850,15630,52
YUMBE,2015,780,580,1360,52
YUMBE,2016,810,590,1400,52
YUMBE,2017,820,590,1410,52
YUMBE,2018,850,590,1440,52
YUMBE,2019,900,620,1520,52
YUMBE,2020,970,670,1640,52
YUMBE,2021,1060,750,1810,52
YUMBE,2022,1160,840,2000,52
YUMBE,2023,1260,920,2180,52
YUMBE,2024,1340,1000,2340,52
YUMBE,2025,1410,1080,2490,52
ZOMBO,2015,670,720,1390,52
ZOMBO,2016,700,740,1440,52
ZOMBO,2017,720,760,1480,52
ZOMBO,2018,740,780,1520,52
ZOMBO,2019,760,800,1560,52
ZOMBO,2020,780,830,1610,52
ZOMBO,2021,810,850,1660,52
ZOMBO,2022,830,870,1700,52
ZOMBO,2023,850,890,1740,52
ZOMBO,2024,870,910,1780,52
ZOMBO,2025,890,930,1820,52
ABIM,2015,190,190,380,53
ABIM,2016,190,210,400,53
ABIM,2017,200,190,390,53
ABIM,2018,210,200,410,53
ABIM,2019,220,200,420,53
ABIM,2020,230,210,440,53
ABIM,2021,260,230,490,53
ABIM,2022,280,260,540,53
ABIM,2023,310,290,600,53
ABIM,2024,340,320,660,53
ABIM,2025,380,340,720,53
ADJUMANI,2015,220,300,520,53
ADJUMANI,2016,220,300,520,53
ADJUMANI,2017,220,300,520,53
ADJUMANI,2018,220,310,530,53
ADJUMANI,2019,220,310,530,53
ADJUMANI,2020,230,310,540,53
ADJUMANI,2021,230,310,540,53
ADJUMANI,2022,230,320,550,53
ADJUMANI,2023,230,320,550,53
ADJUMANI,2024,230,320,550,53
ADJUMANI,2025,230,320,550,53
AGAGO,2015,290,400,690,53
AGAGO,2016,300,410,710,53
AGAGO,2017,300,420,720,53
AGAGO,2018,310,420,730,53
AGAGO,2019,310,430,740,53
AGAGO,2020,320,440,760,53
AGAGO,2021,320,440,760,53
AGAGO,2022,320,450,770,53
AGAGO,2023,330,460,790,53
AGAGO,2024,330,460,790,53
AGAGO,2025,340,470,810,53
ALEBTONG,2015,460,560,1020,53
ALEBTONG,2016,470,570,1040,53
ALEBTONG,2017,470,550,1020,53
ALEBTONG,2018,460,530,990,53
ALEBTONG,2019,470,520,990,53
ALEBTONG,2020,480,530,1010,53
ALEBTONG,2021,510,560,1070,53
ALEBTONG,2022,550,600,1150,53
ALEBTONG,2023,590,650,1240,53
ALEBTONG,2024,630,700,1330,53
ALEBTONG,2025,660,740,1400,53
AMOLATAR,2015,310,320,630,53
AMOLATAR,2016,310,330,640,53
AMOLATAR,2017,320,310,630,53
AMOLATAR,2018,330,310,640,53
AMOLATAR,2019,320,310,630,53
AMOLATAR,2020,340,300,640,53
AMOLATAR,2021,350,330,680,53
AMOLATAR,2022,380,340,720,53
AMOLATAR,2023,390,380,770,53
AMOLATAR,2024,420,400,820,53
AMOLATAR,2025,450,430,880,53
AMUDAT,2015,170,110,280,53
AMUDAT,2016,170,130,300,53
AMUDAT,2017,180,120,300,53
AMUDAT,2018,180,110,290,53
AMUDAT,2019,190,120,310,53
AMUDAT,2020,190,120,310,53
AMUDAT,2021,210,120,330,53
AMUDAT,2022,220,140,360,53
AMUDAT,2023,250,150,400,53
AMUDAT,2024,250,180,430,53
AMUDAT,2025,280,180,460,53
AMURIA,2015,420,470,890,53
AMURIA,2016,440,470,910,53
AMURIA,2017,440,460,900,53
AMURIA,2018,450,460,910,53
AMURIA,2019,450,450,900,53
AMURIA,2020,470,460,930,53
AMURIA,2021,500,490,990,53
AMURIA,2022,530,530,1060,53
AMURIA,2023,590,580,1170,53
AMURIA,2024,630,620,1250,53
AMURIA,2025,660,660,1320,53
AMURU,2015,360,420,780,53
AMURU,2016,380,430,810,53
AMURU,2017,370,420,790,53
AMURU,2018,370,410,780,53
AMURU,2019,380,390,770,53
AMURU,2020,380,390,770,53
AMURU,2021,410,420,830,53
AMURU,2022,440,450,890,53
AMURU,2023,460,490,950,53
AMURU,2024,490,530,1020,53
AMURU,2025,520,560,1080,53
APAC,2015,230,240,470,53
APAC,2016,240,250,490,53
APAC,2017,250,250,500,53
APAC,2018,260,260,520,53
APAC,2019,270,270,540,53
APAC,2020,280,280,560,53
APAC,2021,280,290,570,53
APAC,2022,290,300,590,53
APAC,2023,300,310,610,53
APAC,2024,310,320,630,53
APAC,2025,320,330,650,53
ARUA,2015,880,1070,1950,53
ARUA,2016,910,1100,2010,53
ARUA,2017,930,1130,2060,53
ARUA,2018,960,1160,2120,53
ARUA,2019,980,1190,2170,53
ARUA,2020,1010,1220,2230,53
ARUA,2021,1040,1250,2290,53
ARUA,2022,1060,1280,2340,53
ARUA,2023,1090,1310,2400,53
ARUA,2024,1120,1340,2460,53
ARUA,2025,1150,1370,2520,53
BUDAKA,2015,520,600,1120,53
BUDAKA,2016,530,600,1130,53
BUDAKA,2017,550,600,1150,53
BUDAKA,2018,550,570,1120,53
BUDAKA,2019,550,560,1110,53
BUDAKA,2020,590,580,1170,53
BUDAKA,2021,620,610,1230,53
BUDAKA,2022,680,670,1350,53
BUDAKA,2023,720,730,1450,53
BUDAKA,2024,760,780,1540,53
BUDAKA,2025,810,840,1650,53
BUDUDA,2015,500,370,870,53
BUDUDA,2016,520,400,920,53
BUDUDA,2017,540,390,930,53
BUDUDA,2018,530,380,910,53
BUDUDA,2019,550,370,920,53
BUDUDA,2020,590,380,970,53
BUDUDA,2021,630,410,1040,53
BUDUDA,2022,680,460,1140,53
BUDUDA,2023,740,500,1240,53
BUDUDA,2024,800,540,1340,53
BUDUDA,2025,850,590,1440,53
BUGIRI,2015,710,950,1660,53
BUGIRI,2016,740,980,1720,53
BUGIRI,2017,750,960,1710,53
BUGIRI,2018,760,940,1700,53
BUGIRI,2019,770,920,1690,53
BUGIRI,2020,810,950,1760,53
BUGIRI,2021,860,1000,1860,53
BUGIRI,2022,930,1110,2040,53
BUGIRI,2023,1020,1220,2240,53
BUGIRI,2024,1080,1320,2400,53
BUGIRI,2025,1140,1400,2540,53
BUGWERI,2015,310,340,650,53
BUGWERI,2016,310,350,660,53
BUGWERI,2017,320,330,650,53
BUGWERI,2018,310,320,630,53
BUGWERI,2019,320,310,630,53
BUGWERI,2020,340,320,660,53
BUGWERI,2021,350,340,690,53
BUGWERI,2022,380,360,740,53
BUGWERI,2023,390,400,790,53
BUGWERI,2024,420,410,830,53
BUGWERI,2025,450,440,890,53
BUHWEJU,2015,180,220,400,53
BUHWEJU,2016,190,230,420,53
BUHWEJU,2017,190,240,430,53
BUHWEJU,2018,200,240,440,53
BUHWEJU,2019,210,250,460,53
BUHWEJU,2020,210,260,470,53
BUHWEJU,2021,220,260,480,53
BUHWEJU,2022,230,270,500,53
BUHWEJU,2023,230,280,510,53
BUHWEJU,2024,240,290,530,53
BUHWEJU,2025,250,290,540,53
BUIKWE,2015,800,980,1780,53
BUIKWE,2016,810,980,1790,53
BUIKWE,2017,810,940,1750,53
BUIKWE,2018,800,900,1700,53
BUIKWE,2019,800,880,1680,53
BUIKWE,2020,820,880,1700,53
BUIKWE,2021,860,920,1780,53
BUIKWE,2022,910,990,1900,53
BUIKWE,2023,970,1070,2040,53
BUIKWE,2024,1020,1150,2170,53
BUIKWE,2025,1050,1200,2250,53
BUKEDEA,2015,520,630,1150,53
BUKEDEA,2016,550,630,1180,53
BUKEDEA,2017,550,630,1180,53
BUKEDEA,2018,560,620,1180,53
BUKEDEA,2019,580,610,1190,53
BUKEDEA,2020,620,620,1240,53
BUKEDEA,2021,650,660,1310,53
BUKEDEA,2022,710,730,1440,53
BUKEDEA,2023,770,810,1580,53
BUKEDEA,2024,830,880,1710,53
BUKEDEA,2025,880,940,1820,53
BUKOMANSIMBI,2015,380,480,860,53
BUKOMANSIMBI,2016,380,470,850,53
BUKOMANSIMBI,2017,370,450,820,53
BUKOMANSIMBI,2018,370,420,790,53
BUKOMANSIMBI,2019,370,400,770,53
BUKOMANSIMBI,2020,370,410,780,53
BUKOMANSIMBI,2021,380,420,800,53
BUKOMANSIMBI,2022,390,450,840,53
BUKOMANSIMBI,2023,410,470,880,53
BUKOMANSIMBI,2024,440,490,930,53
BUKOMANSIMBI,2025,450,510,960,53
BUKWO,2015,120,120,240,53
BUKWO,2016,120,130,250,53
BUKWO,2017,130,140,270,53
BUKWO,2018,140,140,280,53
BUKWO,2019,140,150,290,53
BUKWO,2020,150,160,310,53
BUKWO,2021,160,160,320,53
BUKWO,2022,170,170,340,53
BUKWO,2023,180,180,360,53
BUKWO,2024,190,190,380,53
BUKWO,2025,190,200,390,53
BULAMBULI,2015,440,440,880,53
BULAMBULI,2016,450,440,890,53
BULAMBULI,2017,460,450,910,53
BULAMBULI,2018,480,430,910,53
BULAMBULI,2019,500,430,930,53
BULAMBULI,2020,510,450,960,53
BULAMBULI,2021,560,490,1050,53
BULAMBULI,2022,610,530,1140,53
BULAMBULI,2023,660,590,1250,53
BULAMBULI,2024,710,650,1360,53
BULAMBULI,2025,760,690,1450,53
BULIISA,2015,160,160,320,53
BULIISA,2016,170,170,340,53
BULIISA,2017,180,180,360,53
BULIISA,2018,190,190,380,53
BULIISA,2019,200,190,390,53
BULIISA,2020,210,200,410,53
BULIISA,2021,220,210,430,53
BULIISA,2022,230,220,450,53
BULIISA,2023,240,230,470,53
BULIISA,2024,250,240,490,53
BULIISA,2025,260,250,510,53
BUNDIBUGYO,2015,410,550,960,53
BUNDIBUGYO,2016,420,550,970,53
BUNDIBUGYO,2017,430,540,970,53
BUNDIBUGYO,2018,430,500,930,53
BUNDIBUGYO,2019,440,490,930,53
BUNDIBUGYO,2020,450,500,950,53
BUNDIBUGYO,2021,470,530,1000,53
BUNDIBUGYO,2022,500,570,1070,53
BUNDIBUGYO,2023,540,620,1160,53
BUNDIBUGYO,2024,580,670,1250,53
BUNDIBUGYO,2025,600,710,1310,53
BUNYANGABU,2015,380,470,850,53
BUNYANGABU,2016,390,470,860,53
BUNYANGABU,2017,380,450,830,53
BUNYANGABU,2018,390,430,820,53
BUNYANGABU,2019,380,430,810,53
BUNYANGABU,2020,400,420,820,53
BUNYANGABU,2021,420,450,870,53
BUNYANGABU,2022,440,490,930,53
BUNYANGABU,2023,480,520,1000,53
BUNYANGABU,2024,510,560,1070,53
BUNYANGABU,2025,520,590,1110,53
BUSHENYI,2015,370,460,830,53
BUSHENYI,2016,370,460,830,53
BUSHENYI,2017,380,460,840,53
BUSHENYI,2018,380,470,850,53
BUSHENYI,2019,390,470,860,53
BUSHENYI,2020,390,480,870,53
BUSHENYI,2021,390,480,870,53
BUSHENYI,2022,400,480,880,53
BUSHENYI,2023,400,490,890,53
BUSHENYI,2024,400,490,890,53
BUSHENYI,2025,410,490,900,53
BUSIA,2015,690,770,1460,53
BUSIA,2016,720,770,1490,53
BUSIA,2017,720,760,1480,53
BUSIA,2018,730,730,1460,53
BUSIA,2019,730,720,1450,53
BUSIA,2020,760,720,1480,53
BUSIA,2021,800,770,1570,53
BUSIA,2022,860,830,1690,53
BUSIA,2023,930,910,1840,53
BUSIA,2024,980,970,1950,53
BUSIA,2025,1040,1020,2060,53
BUTALEJA,2015,520,640,1160,53
BUTALEJA,2016,530,660,1190,53
BUTALEJA,2017,540,640,1180,53
BUTALEJA,2018,550,630,1180,53
BUTALEJA,2019,550,610,1160,53
BUTALEJA,2020,590,630,1220,53
BUTALEJA,2021,620,660,1280,53
BUTALEJA,2022,680,730,1410,53
BUTALEJA,2023,720,810,1530,53
BUTALEJA,2024,780,860,1640,53
BUTALEJA,2025,810,920,1730,53
BUTAMBALA,2015,220,270,490,53
BUTAMBALA,2016,230,270,500,53
BUTAMBALA,2017,230,250,480,53
BUTAMBALA,2018,220,250,470,53
BUTAMBALA,2019,220,240,460,53
BUTAMBALA,2020,220,240,460,53
BUTAMBALA,2021,240,240,480,53
BUTAMBALA,2022,250,260,510,53
BUTAMBALA,2023,260,270,530,53
BUTAMBALA,2024,270,290,560,53
BUTAMBALA,2025,280,300,580,53
BUTEBO,2015,270,290,560,53
BUTEBO,2016,280,280,560,53
BUTEBO,2017,280,280,560,53
BUTEBO,2018,270,270,540,53
BUTEBO,2019,280,250,530,53
BUTEBO,2020,280,250,530,53
BUTEBO,2021,290,260,550,53
BUTEBO,2022,300,290,590,53
BUTEBO,2023,330,300,630,53
BUTEBO,2024,340,320,660,53
BUTEBO,2025,350,330,680,53
BUVUMA,2015,160,100,260,53
BUVUMA,2016,170,110,280,53
BUVUMA,2017,180,110,290,53
BUVUMA,2018,190,120,310,53
BUVUMA,2019,200,130,330,53
BUVUMA,2020,210,140,350,53
BUVUMA,2021,220,150,370,53
BUVUMA,2022,240,160,400,53
BUVUMA,2023,250,170,420,53
BUVUMA,2024,270,180,450,53
BUVUMA,2025,280,190,470,53
BUYENDE,2015,630,690,1320,53
BUYENDE,2016,660,710,1370,53
BUYENDE,2017,660,690,1350,53
BUYENDE,2018,670,670,1340,53
BUYENDE,2019,690,670,1360,53
BUYENDE,2020,730,700,1430,53
BUYENDE,2021,780,750,1530,53
BUYENDE,2022,850,820,1670,53
BUYENDE,2023,920,900,1820,53
BUYENDE,2024,980,990,1970,53
BUYENDE,2025,1050,1050,2100,53
DOKOLO,2015,220,280,500,53
DOKOLO,2016,230,290,520,53
DOKOLO,2017,240,300,540,53
DOKOLO,2018,250,310,560,53
DOKOLO,2019,250,320,570,53
DOKOLO,2020,260,320,580,53
DOKOLO,2021,270,330,600,53
DOKOLO,2022,270,340,610,53
DOKOLO,2023,280,350,630,53
DOKOLO,2024,290,360,650,53
DOKOLO,2025,300,370,670,53
GOMBA,2015,440,520,960,53
GOMBA,2016,440,520,960,53
GOMBA,2017,440,490,930,53
GOMBA,2018,430,460,890,53
GOMBA,2019,440,450,890,53
GOMBA,2020,440,450,890,53
GOMBA,2021,470,460,930,53
GOMBA,2022,490,500,990,53
GOMBA,2023,520,530,1050,53
GOMBA,2024,540,560,1100,53
GOMBA,2025,570,570,1140,53
GULU,2015,310,400,710,53
GULU,2016,320,420,740,53
GULU,2017,330,430,760,53
GULU,2018,340,440,780,53
GULU,2019,350,450,800,53
GULU,2020,360,470,830,53
GULU,2021,370,480,850,53
GULU,2022,380,490,870,53
GULU,2023,390,500,890,53
GULU,2024,400,520,920,53
GULU,2025,410,530,940,53
HOIMA,2015,430,510,940,53
HOIMA,2016,440,530,970,53
HOIMA,2017,460,550,1010,53
HOIMA,2018,480,570,1050,53
HOIMA,2019,490,590,1080,53
HOIMA,2020,510,610,1120,53
HOIMA,2021,530,630,1160,53
HOIMA,2022,550,650,1200,53
HOIMA,2023,570,670,1240,53
HOIMA,2024,590,690,1280,53
HOIMA,2025,600,710,1310,53
IBANDA,2015,420,530,950,53
IBANDA,2016,430,540,970,53
IBANDA,2017,440,550,990,53
IBANDA,2018,450,560,1010,53
IBANDA,2019,460,570,1030,53
IBANDA,2020,460,580,1040,53
IBANDA,2021,470,590,1060,53
IBANDA,2022,480,590,1070,53
IBANDA,2023,490,600,1090,53
IBANDA,2024,500,610,1110,53
IBANDA,2025,500,620,1120,53
IGANGA,2015,570,760,1330,53
IGANGA,2016,590,760,1350,53
IGANGA,2017,600,750,1350,53
IGANGA,2018,590,710,1300,53
IGANGA,2019,600,690,1290,53
IGANGA,2020,620,710,1330,53
IGANGA,2021,660,750,1410,53
IGANGA,2022,710,820,1530,53
IGANGA,2023,750,880,1630,53
IGANGA,2024,810,960,1770,53
IGANGA,2025,850,1000,1850,53
ISINGIRO,2015,780,940,1720,53
ISINGIRO,2016,810,980,1790,53
ISINGIRO,2017,840,1010,1850,53
ISINGIRO,2018,870,1050,1920,53
ISINGIRO,2019,900,1080,1980,53
ISINGIRO,2020,940,1120,2060,53
ISINGIRO,2021,970,1150,2120,53
ISINGIRO,2022,1000,1190,2190,53
ISINGIRO,2023,1040,1230,2270,53
ISINGIRO,2024,1070,1270,2340,53
ISINGIRO,2025,1100,1310,2410,53
JINJA,2015,570,680,1250,53
JINJA,2016,580,690,1270,53
JINJA,2017,590,700,1290,53
JINJA,2018,600,710,1310,53
JINJA,2019,610,720,1330,53
JINJA,2020,620,730,1350,53
JINJA,2021,630,740,1370,53
JINJA,2022,640,750,1390,53
JINJA,2023,650,760,1410,53
JINJA,2024,650,770,1420,53
JINJA,2025,660,780,1440,53
KAABONG,2015,130,220,350,53
KAABONG,2016,130,220,350,53
KAABONG,2017,140,230,370,53
KAABONG,2018,140,230,370,53
KAABONG,2019,140,240,380,53
KAABONG,2020,150,240,390,53
KAABONG,2021,150,250,400,53
KAABONG,2022,150,250,400,53
KAABONG,2023,160,260,420,53
KAABONG,2024,160,260,420,53
KAABONG,2025,170,270,440,53
KABALE,2015,400,670,1070,53
KABALE,2016,400,680,1080,53
KABALE,2017,410,680,1090,53
KABALE,2018,420,690,1110,53
KABALE,2019,420,700,1120,53
KABALE,2020,430,710,1140,53
KABALE,2021,430,710,1140,53
KABALE,2022,440,720,1160,53
KABALE,2023,440,730,1170,53
KABALE,2024,450,730,1180,53
KABALE,2025,450,740,1190,53
KABAROLE,2015,450,540,990,53
KABAROLE,2016,460,550,1010,53
KABAROLE,2017,480,560,1040,53
KABAROLE,2018,490,580,1070,53
KABAROLE,2019,500,590,1090,53
KABAROLE,2020,510,600,1110,53
KABAROLE,2021,520,610,1130,53
KABAROLE,2022,530,620,1150,53
KABAROLE,2023,540,640,1180,53
KABAROLE,2024,540,650,1190,53
KABAROLE,2025,550,660,1210,53
KABERAMAIDO,2015,220,290,510,53
KABERAMAIDO,2016,230,300,530,53
KABERAMAIDO,2017,230,300,530,53
KABERAMAIDO,2018,240,280,520,53
KABERAMAIDO,2019,250,280,530,53
KABERAMAIDO,2020,250,290,540,53
KABERAMAIDO,2021,270,310,580,53
KABERAMAIDO,2022,300,340,640,53
KABERAMAIDO,2023,310,370,680,53
KABERAMAIDO,2024,340,400,740,53
KABERAMAIDO,2025,360,430,790,53
KAGADI,2015,420,610,1030,53
KAGADI,2016,440,630,1070,53
KAGADI,2017,460,660,1120,53
KAGADI,2018,470,680,1150,53
KAGADI,2019,490,700,1190,53
KAGADI,2020,510,730,1240,53
KAGADI,2021,530,750,1280,53
KAGADI,2022,540,770,1310,53
KAGADI,2023,560,800,1360,53
KAGADI,2024,580,820,1400,53
KAGADI,2025,600,850,1450,53
KAKUMIRO,2015,460,520,980,53
KAKUMIRO,2016,500,560,1060,53
KAKUMIRO,2017,540,610,1150,53
KAKUMIRO,2018,590,660,1250,53
KAKUMIRO,2019,640,720,1360,53
KAKUMIRO,2020,700,780,1480,53
KAKUMIRO,2021,760,840,1600,53
KAKUMIRO,2022,820,910,1730,53
KAKUMIRO,2023,890,980,1870,53
KAKUMIRO,2024,960,1060,2020,53
KAKUMIRO,2025,1040,1150,2190,53
KALAKI,2015,180,180,360,53
KALAKI,2016,190,180,370,53
KALAKI,2017,190,190,380,53
KALAKI,2018,200,200,400,53
KALAKI,2019,210,210,420,53
KALAKI,2020,220,210,430,53
KALAKI,2021,230,220,450,53
KALAKI,2022,240,230,470,53
KALAKI,2023,250,240,490,53
KALAKI,2024,260,250,510,53
KALAKI,2025,270,260,530,53
KALANGALA,2015,100,60,160,53
KALANGALA,2016,110,60,170,53
KALANGALA,2017,110,60,170,53
KALANGALA,2018,120,70,190,53
KALANGALA,2019,120,70,190,53
KALANGALA,2020,120,70,190,53
KALANGALA,2021,130,70,200,53
KALANGALA,2022,130,80,210,53
KALANGALA,2023,140,80,220,53
KALANGALA,2024,140,80,220,53
KALANGALA,2025,140,90,230,53
KALIRO,2015,570,580,1150,53
KALIRO,2016,590,590,1180,53
KALIRO,2017,600,570,1170,53
KALIRO,2018,590,560,1150,53
KALIRO,2019,610,550,1160,53
KALIRO,2020,630,570,1200,53
KALIRO,2021,680,600,1280,53
KALIRO,2022,720,650,1370,53
KALIRO,2023,790,720,1510,53
KALIRO,2024,830,770,1600,53
KALIRO,2025,880,820,1700,53
KALUNGU,2015,470,530,1000,53
KALUNGU,2016,470,540,1010,53
KALUNGU,2017,470,510,980,53
KALUNGU,2018,460,480,940,53
KALUNGU,2019,450,450,900,53
KALUNGU,2020,470,460,930,53
KALUNGU,2021,480,470,950,53
KALUNGU,2022,500,500,1000,53
KALUNGU,2023,520,530,1050,53
KALUNGU,2024,560,570,1130,53
KALUNGU,2025,570,590,1160,53
KAMPALA,2015,1650,1680,3330,53
KAMPALA,2016,1680,1710,3390,53
KAMPALA,2017,1720,1740,3460,53
KAMPALA,2018,1750,1780,3530,53
KAMPALA,2019,1780,1810,3590,53
KAMPALA,2020,1810,1840,3650,53
KAMPALA,2021,1850,1870,3720,53
KAMPALA,2022,1880,1900,3780,53
KAMPALA,2023,1910,1930,3840,53
KAMPALA,2024,1940,1960,3900,53
KAMPALA,2025,1960,1990,3950,53
KAMULI,2015,1040,1190,2230,53
KAMULI,2016,1060,1200,2260,53
KAMULI,2017,1050,1150,2200,53
KAMULI,2018,1050,1110,2160,53
KAMULI,2019,1070,1080,2150,53
KAMULI,2020,1100,1080,2180,53
KAMULI,2021,1160,1140,2300,53
KAMULI,2022,1240,1230,2470,53
KAMULI,2023,1310,1320,2630,53
KAMULI,2024,1390,1420,2810,53
KAMULI,2025,1450,1490,2940,53
KAMWENGE,2015,400,450,850,53
KAMWENGE,2016,410,460,870,53
KAMWENGE,2017,430,480,910,53
KAMWENGE,2018,450,490,940,53
KAMWENGE,2019,460,510,970,53
KAMWENGE,2020,480,530,1010,53
KAMWENGE,2021,500,550,1050,53
KAMWENGE,2022,520,560,1080,53
KAMWENGE,2023,540,580,1120,53
KAMWENGE,2024,560,600,1160,53
KAMWENGE,2025,580,620,1200,53
KANUNGU,2015,450,580,1030,53
KANUNGU,2016,460,590,1050,53
KANUNGU,2017,470,600,1070,53
KANUNGU,2018,470,610,1080,53
KANUNGU,2019,480,620,1100,53
KANUNGU,2020,490,620,1110,53
KANUNGU,2021,500,630,1130,53
KANUNGU,2022,510,640,1150,53
KANUNGU,2023,510,650,1160,53
KANUNGU,2024,520,660,1180,53
KANUNGU,2025,530,670,1200,53
KAPCHORWA,2015,150,180,330,53
KAPCHORWA,2016,160,180,340,53
KAPCHORWA,2017,160,190,350,53
KAPCHORWA,2018,170,190,360,53
KAPCHORWA,2019,170,200,370,53
KAPCHORWA,2020,180,210,390,53
KAPCHORWA,2021,180,210,390,53
KAPCHORWA,2022,190,220,410,53
KAPCHORWA,2023,190,220,410,53
KAPCHORWA,2024,200,230,430,53
KAPCHORWA,2025,200,230,430,53
KAPELEBYONG,2015,190,270,460,53
KAPELEBYONG,2016,190,270,460,53
KAPELEBYONG,2017,180,270,450,53
KAPELEBYONG,2018,190,250,440,53
KAPELEBYONG,2019,190,250,440,53
KAPELEBYONG,2020,210,250,460,53
KAPELEBYONG,2021,210,270,480,53
KAPELEBYONG,2022,220,290,510,53
KAPELEBYONG,2023,250,320,570,53
KAPELEBYONG,2024,250,330,580,53
KAPELEBYONG,2025,280,360,640,53
KASESE,2015,1380,1690,3070,53
KASESE,2016,1410,1710,3120,53
KASESE,2017,1410,1650,3060,53
KASESE,2018,1410,1570,2980,53
KASESE,2019,1420,1540,2960,53
KASESE,2020,1450,1540,2990,53
KASESE,2021,1530,1630,3160,53
KASESE,2022,1630,1750,3380,53
KASESE,2023,1740,1890,3630,53
KASESE,2024,1830,2010,3840,53
KASESE,2025,1920,2120,4040,53
KASSANDA,2015,420,450,870,53
KASSANDA,2016,430,460,890,53
KASSANDA,2017,450,470,920,53
KASSANDA,2018,460,480,940,53
KASSANDA,2019,470,490,960,53
KASSANDA,2020,480,500,980,53
KASSANDA,2021,500,510,1010,53
KASSANDA,2022,510,520,1030,53
KASSANDA,2023,520,530,1050,53
KASSANDA,2024,530,540,1070,53
KASSANDA,2025,550,550,1100,53
KATAKWI,2015,300,350,650,53
KATAKWI,2016,310,360,670,53
KATAKWI,2017,310,360,670,53
KATAKWI,2018,310,340,650,53
KATAKWI,2019,310,330,640,53
KATAKWI,2020,320,330,650,53
KATAKWI,2021,350,350,700,53
KATAKWI,2022,360,390,750,53
KATAKWI,2023,390,410,800,53
KATAKWI,2024,420,450,870,53
KATAKWI,2025,430,460,890,53
KAYUNGA,2015,740,870,1610,53
KAYUNGA,2016,750,870,1620,53
KAYUNGA,2017,750,840,1590,53
KAYUNGA,2018,740,800,1540,53
KAYUNGA,2019,740,770,1510,53
KAYUNGA,2020,760,780,1540,53
KAYUNGA,2021,800,810,1610,53
KAYUNGA,2022,850,860,1710,53
KAYUNGA,2023,900,930,1830,53
KAYUNGA,2024,930,990,1920,53
KAYUNGA,2025,970,1030,2000,53
KAZO,2015,320,350,670,53
KAZO,2016,330,360,690,53
KAZO,2017,350,380,730,53
KAZO,2018,360,390,750,53
KAZO,2019,370,400,770,53
KAZO,2020,380,420,800,53
KAZO,2021,400,430,830,53
KAZO,2022,410,440,850,53
KAZO,2023,430,460,890,53
KAZO,2024,440,470,910,53
KAZO,2025,460,490,950,53
KIBAALE,2015,230,240,470,53
KIBAALE,2016,250,250,500,53
KIBAALE,2017,260,260,520,53
KIBAALE,2018,280,280,560,53
KIBAALE,2019,300,290,590,53
KIBAALE,2020,320,310,630,53
KIBAALE,2021,340,330,670,53
KIBAALE,2022,360,350,710,53
KIBAALE,2023,380,370,750,53
KIBAALE,2024,400,390,790,53
KIBAALE,2025,420,410,830,53
KIBOGA,2015,360,340,700,53
KIBOGA,2016,390,360,750,53
KIBOGA,2017,400,360,760,53
KIBOGA,2018,400,350,750,53
KIBOGA,2019,400,340,740,53
KIBOGA,2020,400,330,730,53
KIBOGA,2021,410,330,740,53
KIBOGA,2022,430,350,780,53
KIBOGA,2023,460,380,840,53
KIBOGA,2024,490,410,900,53
KIBOGA,2025,520,430,950,53
KIBUKU,2015,440,550,990,53
KIBUKU,2016,470,550,1020,53
KIBUKU,2017,470,550,1020,53
KIBUKU,2018,480,530,1010,53
KIBUKU,2019,480,520,1000,53
KIBUKU,2020,510,540,1050,53
KIBUKU,2021,540,570,1110,53
KIBUKU,2022,580,630,1210,53
KIBUKU,2023,620,690,1310,53
KIBUKU,2024,680,750,1430,53
KIBUKU,2025,710,790,1500,53
KIKUUBE,2015,400,430,830,53
KIKUUBE,2016,420,450,870,53
KIKUUBE,2017,440,480,920,53
KIKUUBE,2018,460,500,960,53
KIKUUBE,2019,490,520,1010,53
KIKUUBE,2020,510,550,1060,53
KIKUUBE,2021,540,580,1120,53
KIKUUBE,2022,570,610,1180,53
KIKUUBE,2023,600,630,1230,53
KIKUUBE,2024,630,660,1290,53
KIKUUBE,2025,660,690,1350,53
KIRUHURA,2015,300,260,560,53
KIRUHURA,2016,320,270,590,53
KIRUHURA,2017,330,280,610,53
KIRUHURA,2018,340,290,630,53
KIRUHURA,2019,350,300,650,53
KIRUHURA,2020,370,310,680,53
KIRUHURA,2021,380,320,700,53
KIRUHURA,2022,390,330,720,53
KIRUHURA,2023,410,340,750,53
KIRUHURA,2024,420,350,770,53
KIRUHURA,2025,430,360,790,53
KIRYANDONGO,2015,570,600,1170,53
KIRYANDONGO,2016,580,600,1180,53
KIRYANDONGO,2017,580,580,1160,53
KIRYANDONGO,2018,580,560,1140,53
KIRYANDONGO,2019,580,550,1130,53
KIRYANDONGO,2020,620,550,1170,53
KIRYANDONGO,2021,650,580,1230,53
KIRYANDONGO,2022,690,630,1320,53
KIRYANDONGO,2023,740,690,1430,53
KIRYANDONGO,2024,800,730,1530,53
KIRYANDONGO,2025,830,770,1600,53
KISORO,2015,680,1270,1950,53
KISORO,2016,690,1260,1950,53
KISORO,2017,690,1230,1920,53
KISORO,2018,680,1160,1840,53
KISORO,2019,690,1140,1830,53
KISORO,2020,690,1130,1820,53
KISORO,2021,720,1190,1910,53
KISORO,2022,770,1280,2050,53
KISORO,2023,820,1390,2210,53
KISORO,2024,860,1470,2330,53
KISORO,2025,900,1540,2440,53
KITAGWENDA,2015,240,290,530,53
KITAGWENDA,2016,250,300,550,53
KITAGWENDA,2017,260,310,570,53
KITAGWENDA,2018,270,320,590,53
KITAGWENDA,2019,280,340,620,53
KITAGWENDA,2020,290,350,640,53
KITAGWENDA,2021,300,360,660,53
KITAGWENDA,2022,310,370,680,53
KITAGWENDA,2023,330,380,710,53
KITAGWENDA,2024,340,390,730,53
KITAGWENDA,2025,350,410,760,53
KITGUM,2015,460,560,1020,53
KITGUM,2016,450,550,1000,53
KITGUM,2017,460,540,1000,53
KITGUM,2018,460,500,960,53
KITGUM,2019,450,490,940,53
KITGUM,2020,450,500,950,53
KITGUM,2021,480,520,1000,53
KITGUM,2022,500,560,1060,53
KITGUM,2023,540,590,1130,53
KITGUM,2024,560,620,1180,53
KITGUM,2025,590,660,1250,53
KOBOKO,2015,360,350,710,53
KOBOKO,2016,380,350,730,53
KOBOKO,2017,380,340,720,53
KOBOKO,2018,390,340,730,53
KOBOKO,2019,390,330,720,53
KOBOKO,2020,410,340,750,53
KOBOKO,2021,440,370,810,53
KOBOKO,2022,470,400,870,53
KOBOKO,2023,510,440,950,53
KOBOKO,2024,540,480,1020,53
KOBOKO,2025,570,510,1080,53
KOLE,2015,240,300,540,53
KOLE,2016,250,310,560,53
KOLE,2017,260,320,580,53
KOLE,2018,270,330,600,53
KOLE,2019,270,340,610,53
KOLE,2020,280,350,630,53
KOLE,2021,290,360,650,53
KOLE,2022,300,370,670,53
KOLE,2023,310,370,680,53
KOLE,2024,320,380,700,53
KOLE,2025,330,390,720,53
KOTIDO,2015,360,440,800,53
KOTIDO,2016,360,440,800,53
KOTIDO,2017,370,420,790,53
KOTIDO,2018,360,410,770,53
KOTIDO,2019,370,390,760,53
KOTIDO,2020,370,390,760,53
KOTIDO,2021,390,420,810,53
KOTIDO,2022,420,450,870,53
KOTIDO,2023,440,490,930,53
KOTIDO,2024,470,510,980,53
KOTIDO,2025,480,540,1020,53
KUMI,2015,550,790,1340,53
KUMI,2016,560,790,1350,53
KUMI,2017,580,780,1360,53
KUMI,2018,580,740,1320,53
KUMI,2019,580,730,1310,53
KUMI,2020,600,740,1340,53
KUMI,2021,650,790,1440,53
KUMI,2022,690,850,1540,53
KUMI,2023,740,930,1670,53
KUMI,2024,800,990,1790,53
KUMI,2025,830,1050,1880,53
KWANIA,2015,230,230,460,53
KWANIA,2016,230,230,460,53
KWANIA,2017,240,240,480,53
KWANIA,2018,250,250,500,53
KWANIA,2019,260,250,510,53
KWANIA,2020,260,260,520,53
KWANIA,2021,270,270,540,53
KWANIA,2022,280,270,550,53
KWANIA,2023,290,280,570,53
KWANIA,2024,290,290,580,53
KWANIA,2025,300,300,600,53
KWEEN,2015,130,110,240,53
KWEEN,2016,140,110,250,53
KWEEN,2017,140,110,250,53
KWEEN,2018,140,120,260,53
KWEEN,2019,150,120,270,53
KWEEN,2020,150,120,270,53
KWEEN,2021,160,130,290,53
KWEEN,2022,160,130,290,53
KWEEN,2023,170,130,300,53
KWEEN,2024,170,130,300,53
KWEEN,2025,170,140,310,53
KYANKWANZI,2015,330,310,640,53
KYANKWANZI,2016,350,330,680,53
KYANKWANZI,2017,370,340,710,53
KYANKWANZI,2018,390,360,750,53
KYANKWANZI,2019,410,370,780,53
KYANKWANZI,2020,430,390,820,53
KYANKWANZI,2021,450,410,860,53
KYANKWANZI,2022,470,420,890,53
KYANKWANZI,2023,490,440,930,53
KYANKWANZI,2024,510,460,970,53
KYANKWANZI,2025,540,480,1020,53
KYEGEGWA,2015,490,410,900,53
KYEGEGWA,2016,530,450,980,53
KYEGEGWA,2017,570,480,1050,53
KYEGEGWA,2018,620,520,1140,53
KYEGEGWA,2019,670,560,1230,53
KYEGEGWA,2020,720,600,1320,53
KYEGEGWA,2021,780,650,1430,53
KYEGEGWA,2022,840,700,1540,53
KYEGEGWA,2023,910,750,1660,53
KYEGEGWA,2024,980,810,1790,53
KYEGEGWA,2025,1050,870,1920,53
KYENJOJO,2015,630,750,1380,53
KYENJOJO,2016,660,780,1440,53
KYENJOJO,2017,690,810,1500,53
KYENJOJO,2018,720,840,1560,53
KYENJOJO,2019,740,870,1610,53
KYENJOJO,2020,770,900,1670,53
KYENJOJO,2021,800,930,1730,53
KYENJOJO,2022,830,960,1790,53
KYENJOJO,2023,860,1000,1860,53
KYENJOJO,2024,900,1030,1930,53
KYENJOJO,2025,930,1060,1990,53
KYOTERA,2015,530,710,1240,53
KYOTERA,2016,530,710,1240,53
KYOTERA,2017,540,670,1210,53
KYOTERA,2018,520,640,1160,53
KYOTERA,2019,530,610,1140,53
KYOTERA,2020,530,620,1150,53
KYOTERA,2021,560,640,1200,53
KYOTERA,2022,600,690,1290,53
KYOTERA,2023,620,730,1350,53
KYOTERA,2024,660,780,1440,53
KYOTERA,2025,670,800,1470,53
KARENGA,2015,120,120,240,53
KARENGA,2016,120,120,240,53
KARENGA,2017,120,120,240,53
KARENGA,2018,130,120,250,53
KARENGA,2019,130,130,260,53
KARENGA,2020,130,130,260,53
KARENGA,2021,140,130,270,53
KARENGA,2022,140,130,270,53
KARENGA,2023,140,140,280,53
KARENGA,2024,150,140,290,53
KARENGA,2025,150,140,290,53
LAMWO,2015,250,270,520,53
LAMWO,2016,250,280,530,53
LAMWO,2017,260,270,530,53
LAMWO,2018,250,250,500,53
LAMWO,2019,250,240,490,53
LAMWO,2020,250,250,500,53
LAMWO,2021,260,260,520,53
LAMWO,2022,270,270,540,53
LAMWO,2023,280,290,570,53
LAMWO,2024,310,320,630,53
LAMWO,2025,310,330,640,53
LIRA,2015,430,590,1020,53
LIRA,2016,450,610,1060,53
LIRA,2017,460,620,1080,53
LIRA,2018,470,640,1110,53
LIRA,2019,480,660,1140,53
LIRA,2020,500,680,1180,53
LIRA,2021,510,700,1210,53
LIRA,2022,520,710,1230,53
LIRA,2023,540,730,1270,53
LIRA,2024,550,750,1300,53
LIRA,2025,560,770,1330,53
LUUKA,2015,410,600,1010,53
LUUKA,2016,420,600,1020,53
LUUKA,2017,430,580,1010,53
LUUKA,2018,420,560,980,53
LUUKA,2019,420,530,950,53
LUUKA,2020,420,540,960,53
LUUKA,2021,450,570,1020,53
LUUKA,2022,470,620,1090,53
LUUKA,2023,510,650,1160,53
LUUKA,2024,540,700,1240,53
LUUKA,2025,550,740,1290,53
LUWERO,2015,940,1230,2170,53
LUWERO,2016,970,1220,2190,53
LUWERO,2017,960,1180,2140,53
LUWERO,2018,970,1130,2100,53
LUWERO,2019,960,1090,2050,53
LUWERO,2020,1000,1100,2100,53
LUWERO,2021,1050,1170,2220,53
LUWERO,2022,1110,1260,2370,53
LUWERO,2023,1200,1350,2550,53
LUWERO,2024,1270,1450,2720,53
LUWERO,2025,1310,1530,2840,53
LWENGO,2015,600,940,1540,53
LWENGO,2016,590,920,1510,53
LWENGO,2017,600,880,1480,53
LWENGO,2018,580,840,1420,53
LWENGO,2019,580,800,1380,53
LWENGO,2020,590,790,1380,53
LWENGO,2021,600,830,1430,53
LWENGO,2022,640,880,1520,53
LWENGO,2023,670,940,1610,53
LWENGO,2024,690,990,1680,53
LWENGO,2025,720,1020,1740,53
LYANTONDE,2015,220,270,490,53
LYANTONDE,2016,230,270,500,53
LYANTONDE,2017,230,270,500,53
LYANTONDE,2018,240,250,490,53
LYANTONDE,2019,230,250,480,53
LYANTONDE,2020,230,250,480,53
LYANTONDE,2021,260,270,530,53
LYANTONDE,2022,270,290,560,53
LYANTONDE,2023,300,320,620,53
LYANTONDE,2024,310,330,640,53
LYANTONDE,2025,330,360,690,53
MANAFWA,2015,270,290,560,53
MANAFWA,2016,280,300,580,53
MANAFWA,2017,280,300,580,53
MANAFWA,2018,290,310,600,53
MANAFWA,2019,300,320,620,53
MANAFWA,2020,300,320,620,53
MANAFWA,2021,310,330,640,53
MANAFWA,2022,320,340,660,53
MANAFWA,2023,320,340,660,53
MANAFWA,2024,330,350,680,53
MANAFWA,2025,340,350,690,53
MARACHA,2015,250,380,630,53
MARACHA,2016,260,390,650,53
MARACHA,2017,270,400,670,53
MARACHA,2018,270,410,680,53
MARACHA,2019,280,410,690,53
MARACHA,2020,280,420,700,53
MARACHA,2021,290,430,720,53
MARACHA,2022,290,440,730,53
MARACHA,2023,300,440,740,53
MARACHA,2024,300,450,750,53
MARACHA,2025,310,460,770,53
MASAKA,2015,540,680,1220,53
MASAKA,2016,590,760,1350,53
MASAKA,2017,640,800,1440,53
MASAKA,2018,650,810,1460,53
MASAKA,2019,650,780,1430,53
MASAKA,2020,640,740,1380,53
MASAKA,2021,640,720,1360,53
MASAKA,2022,660,720,1380,53
MASAKA,2023,700,750,1450,53
MASAKA,2024,740,820,1560,53
MASAKA,2025,790,880,1670,53
MASINDI,2015,460,430,890,53
MASINDI,2016,470,440,910,53
MASINDI,2017,480,450,930,53
MASINDI,2018,500,460,960,53
MASINDI,2019,510,470,980,53
MASINDI,2020,530,490,1020,53
MASINDI,2021,540,500,1040,53
MASINDI,2022,550,510,1060,53
MASINDI,2023,570,520,1090,53
MASINDI,2024,580,530,1110,53
MASINDI,2025,600,550,1150,53
MAYUGE,2015,800,1080,1880,53
MAYUGE,2016,830,1090,1920,53
MAYUGE,2017,830,1060,1890,53
MAYUGE,2018,830,1020,1850,53
MAYUGE,2019,850,1000,1850,53
MAYUGE,2020,880,1010,1890,53
MAYUGE,2021,930,1080,2010,53
MAYUGE,2022,990,1180,2170,53
MAYUGE,2023,1070,1280,2350,53
MAYUGE,2024,1140,1370,2510,53
MAYUGE,2025,1190,1460,2650,53
MBALE,2015,1120,1180,2300,53
MBALE,2016,1140,1190,2330,53
MBALE,2017,1150,1150,2300,53
MBALE,2018,1160,1120,2280,53
MBALE,2019,1170,1110,2280,53
MBALE,2020,1200,1120,2320,53
MBALE,2021,1280,1190,2470,53
MBALE,2022,1370,1290,2660,53
MBALE,2023,1480,1420,2900,53
MBALE,2024,1560,1530,3090,53
MBALE,2025,1640,1630,3270,53
MBARARA,2015,520,590,1110,53
MBARARA,2016,540,600,1140,53
MBARARA,2017,550,610,1160,53
MBARARA,2018,560,630,1190,53
MBARARA,2019,570,640,1210,53
MBARARA,2020,580,650,1230,53
MBARARA,2021,600,660,1260,53
MBARARA,2022,610,680,1290,53
MBARARA,2023,620,690,1310,53
MBARARA,2024,630,700,1330,53
MBARARA,2025,640,710,1350,53
MITOOMA,2015,290,450,740,53
MITOOMA,2016,290,450,740,53
MITOOMA,2017,300,460,760,53
MITOOMA,2018,300,460,760,53
MITOOMA,2019,300,460,760,53
MITOOMA,2020,310,470,780,53
MITOOMA,2021,310,470,780,53
MITOOMA,2022,310,470,780,53
MITOOMA,2023,310,480,790,53
MITOOMA,2024,320,480,800,53
MITOOMA,2025,320,480,800,53
MITYANA,2015,770,1050,1820,53
MITYANA,2016,780,1040,1820,53
MITYANA,2017,780,1000,1780,53
MITYANA,2018,760,950,1710,53
MITYANA,2019,760,920,1680,53
MITYANA,2020,780,920,1700,53
MITYANA,2021,810,960,1770,53
MITYANA,2022,860,1030,1890,53
MITYANA,2023,920,1100,2020,53
MITYANA,2024,970,1160,2130,53
MITYANA,2025,1000,1220,2220,53
MOROTO,2015,170,290,460,53
MOROTO,2016,170,300,470,53
MOROTO,2017,180,280,460,53
MOROTO,2018,180,280,460,53
MOROTO,2019,180,270,450,53
MOROTO,2020,190,280,470,53
MOROTO,2021,200,280,480,53
MOROTO,2022,200,320,520,53
MOROTO,2023,210,330,540,53
MOROTO,2024,240,350,590,53
MOROTO,2025,240,380,620,53
MOYO,2015,160,150,310,53
MOYO,2016,160,150,310,53
MOYO,2017,160,150,310,53
MOYO,2018,170,160,330,53
MOYO,2019,170,160,330,53
MOYO,2020,180,160,340,53
MOYO,2021,180,170,350,53
MOYO,2022,180,170,350,53
MOYO,2023,190,170,360,53
MOYO,2024,190,180,370,53
MOYO,2025,190,180,370,53
MPIGI,2015,630,760,1390,53
MPIGI,2016,640,760,1400,53
MPIGI,2017,640,730,1370,53
MPIGI,2018,640,700,1340,53
MPIGI,2019,640,680,1320,53
MPIGI,2020,660,680,1340,53
MPIGI,2021,690,720,1410,53
MPIGI,2022,740,780,1520,53
MPIGI,2023,790,850,1640,53
MPIGI,2024,830,910,1740,53
MPIGI,2025,860,950,1810,53
MUBENDE,2015,680,630,1310,53
MUBENDE,2016,790,770,1560,53
MUBENDE,2017,900,870,1770,53
MUBENDE,2018,970,950,1920,53
MUBENDE,2019,1020,980,2000,53
MUBENDE,2020,1060,980,2040,53
MUBENDE,2021,1090,960,2050,53
MUBENDE,2022,1120,960,2080,53
MUBENDE,2023,1190,1000,2190,53
MUBENDE,2024,1280,1070,2350,53
MUBENDE,2025,1410,1190,2600,53
MUKONO,2015,1210,1530,2740,53
MUKONO,2016,1240,1550,2790,53
MUKONO,2017,1250,1510,2760,53
MUKONO,2018,1250,1460,2710,53
MUKONO,2019,1260,1430,2690,53
MUKONO,2020,1290,1450,2740,53
MUKONO,2021,1370,1530,2900,53
MUKONO,2022,1460,1670,3130,53
MUKONO,2023,1560,1810,3370,53
MUKONO,2024,1660,1940,3600,53
MUKONO,2025,1730,2040,3770,53
MADI OKOLLO,2015,210,230,440,53
MADI OKOLLO,2016,210,230,440,53
MADI OKOLLO,2017,220,240,460,53
MADI OKOLLO,2018,230,240,470,53
MADI OKOLLO,2019,230,250,480,53
MADI OKOLLO,2020,240,260,500,53
MADI OKOLLO,2021,240,260,500,53
MADI OKOLLO,2022,250,270,520,53
MADI OKOLLO,2023,260,280,540,53
MADI OKOLLO,2024,260,280,540,53
MADI OKOLLO,2025,270,290,560,53
NABILATUK,2015,130,150,280,53
NABILATUK,2016,140,160,300,53
NABILATUK,2017,140,150,290,53
NABILATUK,2018,130,140,270,53
NABILATUK,2019,150,150,300,53
NABILATUK,2020,150,140,290,53
NABILATUK,2021,170,160,330,53
NABILATUK,2022,190,170,360,53
NABILATUK,2023,200,200,400,53
NABILATUK,2024,220,210,430,53
NABILATUK,2025,220,230,450,53
NAKAPIRIPIRIT,2015,190,210,400,53
NAKAPIRIPIRIT,2016,190,220,410,53
NAKAPIRIPIRIT,2017,200,210,410,53
NAKAPIRIPIRIT,2018,190,210,400,53
NAKAPIRIPIRIT,2019,200,200,400,53
NAKAPIRIPIRIT,2020,220,210,430,53
NAKAPIRIPIRIT,2021,230,230,460,53
NAKAPIRIPIRIT,2022,250,240,490,53
NAKAPIRIPIRIT,2023,280,270,550,53
NAKAPIRIPIRIT,2024,290,300,590,53
NAKAPIRIPIRIT,2025,310,330,640,53
NAKASEKE,2015,300,300,600,53
NAKASEKE,2016,310,310,620,53
NAKASEKE,2017,320,310,630,53
NAKASEKE,2018,330,320,650,53
NAKASEKE,2019,350,330,680,53
NAKASEKE,2020,360,330,690,53
NAKASEKE,2021,370,340,710,53
NAKASEKE,2022,380,350,730,53
NAKASEKE,2023,400,360,760,53
NAKASEKE,2024,410,360,770,53
NAKASEKE,2025,420,370,790,53
NAKASONGOLA,2015,380,420,800,53
NAKASONGOLA,2016,390,410,800,53
NAKASONGOLA,2017,400,400,800,53
NAKASONGOLA,2018,390,390,780,53
NAKASONGOLA,2019,390,370,760,53
NAKASONGOLA,2020,410,380,790,53
NAKASONGOLA,2021,440,410,850,53
NAKASONGOLA,2022,470,430,900,53
NAKASONGOLA,2023,510,470,980,53
NAKASONGOLA,2024,540,510,1050,53
NAKASONGOLA,2025,550,540,1090,53
NAMAYINGO,2015,440,440,880,53
NAMAYINGO,2016,450,430,880,53
NAMAYINGO,2017,440,420,860,53
NAMAYINGO,2018,450,390,840,53
NAMAYINGO,2019,440,370,810,53
NAMAYINGO,2020,450,380,830,53
NAMAYINGO,2021,470,390,860,53
NAMAYINGO,2022,500,430,930,53
NAMAYINGO,2023,520,460,980,53
NAMAYINGO,2024,560,480,1040,53
NAMAYINGO,2025,570,510,1080,53
NAMISINDWA,2015,320,330,650,53
NAMISINDWA,2016,320,340,660,53
NAMISINDWA,2017,330,350,680,53
NAMISINDWA,2018,340,360,700,53
NAMISINDWA,2019,350,370,720,53
NAMISINDWA,2020,360,370,730,53
NAMISINDWA,2021,370,380,750,53
NAMISINDWA,2022,380,390,770,53
NAMISINDWA,2023,390,400,790,53
NAMISINDWA,2024,400,410,810,53
NAMISINDWA,2025,410,410,820,53
NAMUTUMBA,2015,580,640,1220,53
NAMUTUMBA,2016,590,660,1250,53
NAMUTUMBA,2017,600,640,1240,53
NAMUTUMBA,2018,610,620,1230,53
NAMUTUMBA,2019,610,610,1220,53
NAMUTUMBA,2020,640,620,1260,53
NAMUTUMBA,2021,680,660,1340,53
NAMUTUMBA,2022,740,720,1460,53
NAMUTUMBA,2023,790,790,1580,53
NAMUTUMBA,2024,850,840,1690,53
NAMUTUMBA,2025,880,890,1770,53
NAPAK,2015,300,560,860,53
NAPAK,2016,300,570,870,53
NAPAK,2017,290,550,840,53
NAPAK,2018,300,530,830,53
NAPAK,2019,290,510,800,53
NAPAK,2020,290,510,800,53
NAPAK,2021,300,540,840,53
NAPAK,2022,330,570,900,53
NAPAK,2023,340,620,960,53
NAPAK,2024,360,670,1030,53
NAPAK,2025,380,710,1090,53
NEBBI,2015,380,410,790,53
NEBBI,2016,400,420,820,53
NEBBI,2017,410,430,840,53
NEBBI,2018,420,450,870,53
NEBBI,2019,430,460,890,53
NEBBI,2020,450,470,920,53
NEBBI,2021,460,480,940,53
NEBBI,2022,470,500,970,53
NEBBI,2023,490,510,1000,53
NEBBI,2024,500,520,1020,53
NEBBI,2025,510,530,1040,53
NGORA,2015,270,350,620,53
NGORA,2016,270,360,630,53
NGORA,2017,280,360,640,53
NGORA,2018,270,340,610,53
NGORA,2019,280,330,610,53
NGORA,2020,280,330,610,53
NGORA,2021,300,350,650,53
NGORA,2022,310,390,700,53
NGORA,2023,340,410,750,53
NGORA,2024,360,450,810,53
NGORA,2025,380,460,840,53
NTOROKO,2015,160,150,310,53
NTOROKO,2016,160,140,300,53
NTOROKO,2017,170,130,300,53
NTOROKO,2018,160,140,300,53
NTOROKO,2019,160,130,290,53
NTOROKO,2020,160,130,290,53
NTOROKO,2021,180,140,320,53
NTOROKO,2022,190,140,330,53
NTOROKO,2023,200,170,370,53
NTOROKO,2024,200,180,380,53
NTOROKO,2025,220,180,400,53
NTUNGAMO,2015,790,1070,1860,53
NTUNGAMO,2016,810,1090,1900,53
NTUNGAMO,2017,820,1110,1930,53
NTUNGAMO,2018,840,1130,1970,53
NTUNGAMO,2019,860,1150,2010,53
NTUNGAMO,2020,880,1170,2050,53
NTUNGAMO,2021,890,1190,2080,53
NTUNGAMO,2022,910,1210,2120,53
NTUNGAMO,2023,920,1230,2150,53
NTUNGAMO,2024,940,1240,2180,53
NTUNGAMO,2025,960,1260,2220,53
NWOYA,2015,210,230,440,53
NWOYA,2016,230,260,490,53
NWOYA,2017,250,290,540,53
NWOYA,2018,280,310,590,53
NWOYA,2019,310,350,660,53
NWOYA,2020,340,380,720,53
NWOYA,2021,370,420,790,53
NWOYA,2022,410,460,870,53
NWOYA,2023,450,510,960,53
NWOYA,2024,500,550,1050,53
NWOYA,2025,550,610,1160,53
OBONGI,2015,90,100,190,53
OBONGI,2016,110,90,200,53
OBONGI,2017,110,90,200,53
OBONGI,2018,100,80,180,53
OBONGI,2019,100,80,180,53
OBONGI,2020,100,80,180,53
OBONGI,2021,120,80,200,53
OBONGI,2022,130,90,220,53
OBONGI,2023,130,110,240,53
OBONGI,2024,140,110,250,53
OBONGI,2025,140,110,250,53
OMORO,2015,350,440,790,53
OMORO,2016,360,440,800,53
OMORO,2017,370,430,800,53
OMORO,2018,360,420,780,53
OMORO,2019,370,410,780,53
OMORO,2020,380,420,800,53
OMORO,2021,410,450,860,53
OMORO,2022,440,490,930,53
OMORO,2023,480,530,1010,53
OMORO,2024,510,570,1080,53
OMORO,2025,530,610,1140,53
OTUKE,2015,120,200,320,53
OTUKE,2016,130,210,340,53
OTUKE,2017,140,220,360,53
OTUKE,2018,140,230,370,53
OTUKE,2019,150,240,390,53
OTUKE,2020,150,250,400,53
OTUKE,2021,160,260,420,53
OTUKE,2022,170,270,440,53
OTUKE,2023,170,280,450,53
OTUKE,2024,180,290,470,53
OTUKE,2025,190,300,490,53
OYAM,2015,440,550,990,53
OYAM,2016,460,560,1020,53
OYAM,2017,470,580,1050,53
OYAM,2018,490,600,1090,53
OYAM,2019,500,610,1110,53
OYAM,2020,520,630,1150,53
OYAM,2021,530,650,1180,53
OYAM,2022,540,660,1200,53
OYAM,2023,560,680,1240,53
OYAM,2024,570,700,1270,53
OYAM,2025,590,710,1300,53
PADER,2015,420,440,860,53
PADER,2016,420,430,850,53
PADER,2017,430,420,850,53
PADER,2018,420,390,810,53
PADER,2019,420,390,810,53
PADER,2020,420,380,800,53
PADER,2021,450,410,860,53
PADER,2022,470,430,900,53
PADER,2023,510,470,980,53
PADER,2024,530,490,1020,53
PADER,2025,530,530,1060,53
PAKWACH,2015,220,260,480,53
PAKWACH,2016,230,270,500,53
PAKWACH,2017,240,280,520,53
PAKWACH,2018,250,290,540,53
PAKWACH,2019,260,300,560,53
PAKWACH,2020,270,310,580,53
PAKWACH,2021,280,320,600,53
PAKWACH,2022,300,330,630,53
PAKWACH,2023,310,340,650,53
PAKWACH,2024,320,350,670,53
PAKWACH,2025,330,360,690,53
PALLISA,2015,580,710,1290,53
PALLISA,2016,610,730,1340,53
PALLISA,2017,630,720,1350,53
PALLISA,2018,620,700,1320,53
PALLISA,2019,640,710,1350,53
PALLISA,2020,670,720,1390,53
PALLISA,2021,720,770,1490,53
PALLISA,2022,790,850,1640,53
PALLISA,2023,870,940,1810,53
PALLISA,2024,930,1020,1950,53
PALLISA,2025,980,1100,2080,53
RAKAI,2015,500,760,1260,53
RAKAI,2016,520,760,1280,53
RAKAI,2017,520,730,1250,53
RAKAI,2018,520,700,1220,53
RAKAI,2019,530,680,1210,53
RAKAI,2020,540,700,1240,53
RAKAI,2021,570,730,1300,53
RAKAI,2022,600,790,1390,53
RAKAI,2023,640,850,1490,53
RAKAI,2024,680,910,1590,53
RAKAI,2025,710,950,1660,53
RUBANDA,2015,330,510,840,53
RUBANDA,2016,340,520,860,53
RUBANDA,2017,340,520,860,53
RUBANDA,2018,340,530,870,53
RUBANDA,2019,350,530,880,53
RUBANDA,2020,350,530,880,53
RUBANDA,2021,360,540,900,53
RUBANDA,2022,360,540,900,53
RUBANDA,2023,360,540,900,53
RUBANDA,2024,370,550,920,53
RUBANDA,2025,370,550,920,53
RUBIRIZI,2015,200,240,440,53
RUBIRIZI,2016,200,250,450,53
RUBIRIZI,2017,200,250,450,53
RUBIRIZI,2018,210,260,470,53
RUBIRIZI,2019,210,260,470,53
RUBIRIZI,2020,220,270,490,53
RUBIRIZI,2021,220,270,490,53
RUBIRIZI,2022,220,270,490,53
RUBIRIZI,2023,230,280,510,53
RUBIRIZI,2024,230,280,510,53
RUBIRIZI,2025,230,290,520,53
RUKIGA,2015,190,290,480,53
RUKIGA,2016,190,290,480,53
RUKIGA,2017,190,300,490,53
RUKIGA,2018,190,300,490,53
RUKIGA,2019,190,300,490,53
RUKIGA,2020,190,300,490,53
RUKIGA,2021,200,300,500,53
RUKIGA,2022,200,300,500,53
RUKIGA,2023,200,310,510,53
RUKIGA,2024,200,310,510,53
RUKIGA,2025,200,310,510,53
RUKUNGIRI,2015,520,740,1260,53
RUKUNGIRI,2016,530,750,1280,53
RUKUNGIRI,2017,540,760,1300,53
RUKUNGIRI,2018,540,770,1310,53
RUKUNGIRI,2019,550,770,1320,53
RUKUNGIRI,2020,550,780,1330,53
RUKUNGIRI,2021,560,780,1340,53
RUKUNGIRI,2022,560,790,1350,53
RUKUNGIRI,2023,570,800,1370,53
RUKUNGIRI,2024,570,800,1370,53
RUKUNGIRI,2025,580,800,1380,53
RWAMPARA,2015,210,280,490,53
RWAMPARA,2016,220,280,500,53
RWAMPARA,2017,220,290,510,53
RWAMPARA,2018,230,300,530,53
RWAMPARA,2019,230,300,530,53
RWAMPARA,2020,240,310,550,53
RWAMPARA,2021,240,310,550,53
RWAMPARA,2022,250,320,570,53
RWAMPARA,2023,250,330,580,53
RWAMPARA,2024,260,330,590,53
RWAMPARA,2025,260,340,600,53
SERERE,2015,640,770,1410,53
SERERE,2016,670,770,1440,53
SERERE,2017,690,760,1450,53
SERERE,2018,700,740,1440,53
SERERE,2019,720,730,1450,53
SERERE,2020,750,760,1510,53
SERERE,2021,800,810,1610,53
SERERE,2022,860,890,1750,53
SERERE,2023,930,970,1900,53
SERERE,2024,1000,1050,2050,53
SERERE,2025,1050,1130,2180,53
SHEEMA,2015,350,470,820,53
SHEEMA,2016,360,480,840,53
SHEEMA,2017,360,480,840,53
SHEEMA,2018,360,490,850,53
SHEEMA,2019,370,490,860,53
SHEEMA,2020,370,500,870,53
SHEEMA,2021,380,500,880,53
SHEEMA,2022,380,510,890,53
SHEEMA,2023,380,510,890,53
SHEEMA,2024,390,510,900,53
SHEEMA,2025,390,520,910,53
SIRONKO,2015,460,450,910,53
SIRONKO,2016,470,450,920,53
SIRONKO,2017,480,460,940,53
SIRONKO,2018,490,470,960,53
SIRONKO,2019,500,480,980,53
SIRONKO,2020,510,490,1000,53
SIRONKO,2021,520,500,1020,53
SIRONKO,2022,540,510,1050,53
SIRONKO,2023,550,520,1070,53
SIRONKO,2024,560,530,1090,53
SIRONKO,2025,570,530,1100,53
SOROTI,2015,690,690,1380,53
SOROTI,2016,700,710,1410,53
SOROTI,2017,720,690,1410,53
SOROTI,2018,730,670,1400,53
SOROTI,2019,740,650,1390,53
SOROTI,2020,760,670,1430,53
SOROTI,2021,810,720,1530,53
SOROTI,2022,880,780,1660,53
SOROTI,2023,950,850,1800,53
SOROTI,2024,1020,920,1940,53
SOROTI,2025,1070,970,2040,53
SSEMBABULE,2015,660,660,1320,53
SSEMBABULE,2016,670,660,1330,53
SSEMBABULE,2017,670,660,1330,53
SSEMBABULE,2018,680,630,1310,53
SSEMBABULE,2019,690,610,1300,53
SSEMBABULE,2020,700,620,1320,53
SSEMBABULE,2021,750,650,1400,53
SSEMBABULE,2022,800,700,1500,53
SSEMBABULE,2023,850,760,1610,53
SSEMBABULE,2024,920,830,1750,53
SSEMBABULE,2025,950,870,1820,53
TORORO,2015,880,1030,1910,53
TORORO,2016,900,1060,1960,53
TORORO,2017,930,1090,2020,53
TORORO,2018,950,1110,2060,53
TORORO,2019,970,1140,2110,53
TORORO,2020,1000,1170,2170,53
TORORO,2021,1020,1190,2210,53
TORORO,2022,1050,1220,2270,53
TORORO,2023,1070,1250,2320,53
TORORO,2024,1100,1270,2370,53
TORORO,2025,1120,1300,2420,53
WAKISO,2015,2200,2350,4550,53
WAKISO,2016,2340,2510,4850,53
WAKISO,2017,2500,2680,5180,53
WAKISO,2018,2670,2860,5530,53
WAKISO,2019,2840,3060,5900,53
WAKISO,2020,3030,3260,6290,53
WAKISO,2021,3220,3480,6700,53
WAKISO,2022,3430,3700,7130,53
WAKISO,2023,3650,3940,7590,53
WAKISO,2024,3870,4190,8060,53
WAKISO,2025,4110,4460,8570,53
YUMBE,2015,790,660,1450,53
YUMBE,2016,830,700,1530,53
YUMBE,2017,860,690,1550,53
YUMBE,2018,880,690,1570,53
YUMBE,2019,910,690,1600,53
YUMBE,2020,950,720,1670,53
YUMBE,2021,1020,790,1810,53
YUMBE,2022,1130,880,2010,53
YUMBE,2023,1230,990,2220,53
YUMBE,2024,1340,1080,2420,53
YUMBE,2025,1410,1180,2590,53
ZOMBO,2015,360,450,810,53
ZOMBO,2016,370,460,830,53
ZOMBO,2017,380,480,860,53
ZOMBO,2018,390,490,880,53
ZOMBO,2019,400,500,900,53
ZOMBO,2020,410,520,930,53
ZOMBO,2021,420,530,950,53
ZOMBO,2022,440,540,980,53
ZOMBO,2023,450,560,1010,53
ZOMBO,2024,460,570,1030,53
ZOMBO,2025,470,580,1050,53
ABIM,2015,180,200,380,54
ABIM,2016,190,220,410,54
ABIM,2017,200,240,440,54
ABIM,2018,210,230,440,54
ABIM,2019,210,230,440,54
ABIM,2020,230,230,460,54
ABIM,2021,240,240,480,54
ABIM,2022,270,270,540,54
ABIM,2023,290,300,590,54
ABIM,2024,330,330,660,54
ABIM,2025,360,370,730,54
ADJUMANI,2015,340,410,750,54
ADJUMANI,2016,340,420,760,54
ADJUMANI,2017,340,420,760,54
ADJUMANI,2018,340,420,760,54
ADJUMANI,2019,350,430,780,54
ADJUMANI,2020,350,430,780,54
ADJUMANI,2021,350,440,790,54
ADJUMANI,2022,350,440,790,54
ADJUMANI,2023,350,440,790,54
ADJUMANI,2024,350,440,790,54
ADJUMANI,2025,350,450,800,54
AGAGO,2015,370,600,970,54
AGAGO,2016,370,610,980,54
AGAGO,2017,380,620,1000,54
AGAGO,2018,390,630,1020,54
AGAGO,2019,390,640,1030,54
AGAGO,2020,400,650,1050,54
AGAGO,2021,410,660,1070,54
AGAGO,2022,410,680,1090,54
AGAGO,2023,420,680,1100,54
AGAGO,2024,420,690,1110,54
AGAGO,2025,430,700,1130,54
ALEBTONG,2015,430,580,1010,54
ALEBTONG,2016,470,620,1090,54
ALEBTONG,2017,480,620,1100,54
ALEBTONG,2018,480,610,1090,54
ALEBTONG,2019,490,580,1070,54
ALEBTONG,2020,490,570,1060,54
ALEBTONG,2021,500,570,1070,54
ALEBTONG,2022,530,610,1140,54
ALEBTONG,2023,570,660,1230,54
ALEBTONG,2024,610,710,1320,54
ALEBTONG,2025,640,770,1410,54
AMOLATAR,2015,280,310,590,54
AMOLATAR,2016,300,340,640,54
AMOLATAR,2017,300,340,640,54
AMOLATAR,2018,300,320,620,54
AMOLATAR,2019,300,310,610,54
AMOLATAR,2020,310,310,620,54
AMOLATAR,2021,320,310,630,54
AMOLATAR,2022,330,320,650,54
AMOLATAR,2023,350,350,700,54
AMOLATAR,2024,380,380,760,54
AMOLATAR,2025,410,400,810,54
AMUDAT,2015,170,160,330,54
AMUDAT,2016,180,170,350,54
AMUDAT,2017,190,170,360,54
AMUDAT,2018,190,170,360,54
AMUDAT,2019,190,170,360,54
AMUDAT,2020,200,170,370,54
AMUDAT,2021,200,180,380,54
AMUDAT,2022,220,180,400,54
AMUDAT,2023,240,200,440,54
AMUDAT,2024,260,230,490,54
AMUDAT,2025,280,250,530,54
AMURIA,2015,320,370,690,54
AMURIA,2016,340,390,730,54
AMURIA,2017,360,410,770,54
AMURIA,2018,370,390,760,54
AMURIA,2019,370,380,750,54
AMURIA,2020,380,380,760,54
AMURIA,2021,390,380,770,54
AMURIA,2022,410,400,810,54
AMURIA,2023,450,450,900,54
AMURIA,2024,480,490,970,54
AMURIA,2025,520,530,1050,54
AMURU,2015,280,400,680,54
AMURU,2016,290,420,710,54
AMURU,2017,300,430,730,54
AMURU,2018,300,420,720,54
AMURU,2019,300,400,700,54
AMURU,2020,310,390,700,54
AMURU,2021,310,390,700,54
AMURU,2022,330,410,740,54
AMURU,2023,350,450,800,54
AMURU,2024,370,490,860,54
AMURU,2025,400,520,920,54
APAC,2015,320,360,680,54
APAC,2016,330,370,700,54
APAC,2017,340,380,720,54
APAC,2018,350,390,740,54
APAC,2019,360,410,770,54
APAC,2020,380,420,800,54
APAC,2021,390,430,820,54
APAC,2022,400,450,850,54
APAC,2023,420,460,880,54
APAC,2024,430,480,910,54
APAC,2025,440,490,930,54
ARUA,2015,1240,1600,2840,54
ARUA,2016,1270,1640,2910,54
ARUA,2017,1310,1680,2990,54
ARUA,2018,1350,1730,3080,54
ARUA,2019,1390,1770,3160,54
ARUA,2020,1420,1820,3240,54
ARUA,2021,1460,1860,3320,54
ARUA,2022,1500,1910,3410,54
ARUA,2023,1540,1960,3500,54
ARUA,2024,1570,2000,3570,54
ARUA,2025,1610,2050,3660,54
BUDAKA,2015,470,650,1120,54
BUDAKA,2016,500,700,1200,54
BUDAKA,2017,510,710,1220,54
BUDAKA,2018,520,690,1210,54
BUDAKA,2019,530,670,1200,54
BUDAKA,2020,540,660,1200,54
BUDAKA,2021,560,670,1230,54
BUDAKA,2022,600,720,1320,54
BUDAKA,2023,640,780,1420,54
BUDAKA,2024,700,850,1550,54
BUDAKA,2025,730,920,1650,54
BUDUDA,2015,580,470,1050,54
BUDUDA,2016,620,510,1130,54
BUDUDA,2017,650,520,1170,54
BUDUDA,2018,670,520,1190,54
BUDUDA,2019,670,500,1170,54
BUDUDA,2020,690,500,1190,54
BUDUDA,2021,720,520,1240,54
BUDUDA,2022,780,550,1330,54
BUDUDA,2023,850,610,1460,54
BUDUDA,2024,920,670,1590,54
BUDUDA,2025,990,730,1720,54
BUGIRI,2015,790,960,1750,54
BUGIRI,2016,850,1040,1890,54
BUGIRI,2017,880,1060,1940,54
BUGIRI,2018,900,1040,1940,54
BUGIRI,2019,900,1010,1910,54
BUGIRI,2020,930,1000,1930,54
BUGIRI,2021,960,1020,1980,54
BUGIRI,2022,1030,1090,2120,54
BUGIRI,2023,1120,1200,2320,54
BUGIRI,2024,1210,1320,2530,54
BUGIRI,2025,1300,1430,2730,54
BUGWERI,2015,300,380,680,54
BUGWERI,2016,320,400,720,54
BUGWERI,2017,330,410,740,54
BUGWERI,2018,330,390,720,54
BUGWERI,2019,330,380,710,54
BUGWERI,2020,340,370,710,54
BUGWERI,2021,340,370,710,54
BUGWERI,2022,360,390,750,54
BUGWERI,2023,390,430,820,54
BUGWERI,2024,420,460,880,54
BUGWERI,2025,440,500,940,54
BUHWEJU,2015,260,300,560,54
BUHWEJU,2016,270,310,580,54
BUHWEJU,2017,280,320,600,54
BUHWEJU,2018,290,330,620,54
BUHWEJU,2019,300,340,640,54
BUHWEJU,2020,310,350,660,54
BUHWEJU,2021,320,360,680,54
BUHWEJU,2022,330,370,700,54
BUHWEJU,2023,340,380,720,54
BUHWEJU,2024,350,390,740,54
BUHWEJU,2025,350,400,750,54
BUIKWE,2015,820,990,1810,54
BUIKWE,2016,870,1040,1910,54
BUIKWE,2017,890,1050,1940,54
BUIKWE,2018,880,1010,1890,54
BUIKWE,2019,870,970,1840,54
BUIKWE,2020,880,940,1820,54
BUIKWE,2021,890,940,1830,54
BUIKWE,2022,940,990,1930,54
BUIKWE,2023,1000,1070,2070,54
BUIKWE,2024,1060,1150,2210,54
BUIKWE,2025,1120,1220,2340,54
BUKEDEA,2015,430,520,950,54
BUKEDEA,2016,460,570,1030,54
BUKEDEA,2017,480,580,1060,54
BUKEDEA,2018,490,570,1060,54
BUKEDEA,2019,510,550,1060,54
BUKEDEA,2020,520,550,1070,54
BUKEDEA,2021,540,560,1100,54
BUKEDEA,2022,580,600,1180,54
BUKEDEA,2023,630,660,1290,54
BUKEDEA,2024,690,720,1410,54
BUKEDEA,2025,730,790,1520,54
BUKOMANSIMBI,2015,380,480,860,54
BUKOMANSIMBI,2016,400,510,910,54
BUKOMANSIMBI,2017,400,500,900,54
BUKOMANSIMBI,2018,400,480,880,54
BUKOMANSIMBI,2019,390,450,840,54
BUKOMANSIMBI,2020,380,420,800,54
BUKOMANSIMBI,2021,380,420,800,54
BUKOMANSIMBI,2022,400,430,830,54
BUKOMANSIMBI,2023,420,460,880,54
BUKOMANSIMBI,2024,440,490,930,54
BUKOMANSIMBI,2025,450,510,960,54
BUKWO,2015,180,250,430,54
BUKWO,2016,190,260,450,54
BUKWO,2017,200,270,470,54
BUKWO,2018,210,290,500,54
BUKWO,2019,230,300,530,54
BUKWO,2020,240,310,550,54
BUKWO,2021,250,330,580,54
BUKWO,2022,260,340,600,54
BUKWO,2023,280,360,640,54
BUKWO,2024,290,370,660,54
BUKWO,2025,300,390,690,54
BULAMBULI,2015,550,600,1150,54
BULAMBULI,2016,590,650,1240,54
BULAMBULI,2017,620,670,1290,54
BULAMBULI,2018,640,670,1310,54
BULAMBULI,2019,650,650,1300,54
BULAMBULI,2020,670,660,1330,54
BULAMBULI,2021,700,680,1380,54
BULAMBULI,2022,760,730,1490,54
BULAMBULI,2023,830,810,1640,54
BULAMBULI,2024,910,900,1810,54
BULAMBULI,2025,980,980,1960,54
BULIISA,2015,190,230,420,54
BULIISA,2016,200,240,440,54
BULIISA,2017,210,260,470,54
BULIISA,2018,230,270,500,54
BULIISA,2019,240,280,520,54
BULIISA,2020,250,290,540,54
BULIISA,2021,260,300,560,54
BULIISA,2022,280,310,590,54
BULIISA,2023,290,330,620,54
BULIISA,2024,300,340,640,54
BULIISA,2025,320,350,670,54
BUNDIBUGYO,2015,460,610,1070,54
BUNDIBUGYO,2016,480,640,1120,54
BUNDIBUGYO,2017,490,650,1140,54
BUNDIBUGYO,2018,500,640,1140,54
BUNDIBUGYO,2019,500,610,1110,54
BUNDIBUGYO,2020,510,600,1110,54
BUNDIBUGYO,2021,520,600,1120,54
BUNDIBUGYO,2022,550,630,1180,54
BUNDIBUGYO,2023,590,690,1280,54
BUNDIBUGYO,2024,630,740,1370,54
BUNDIBUGYO,2025,670,800,1470,54
BUNYANGABU,2015,320,460,780,54
BUNYANGABU,2016,340,490,830,54
BUNYANGABU,2017,350,490,840,54
BUNYANGABU,2018,360,480,840,54
BUNYANGABU,2019,360,450,810,54
BUNYANGABU,2020,360,440,800,54
BUNYANGABU,2021,360,450,810,54
BUNYANGABU,2022,380,470,850,54
BUNYANGABU,2023,410,510,920,54
BUNYANGABU,2024,440,550,990,54
BUNYANGABU,2025,470,570,1040,54
BUSHENYI,2015,510,630,1140,54
BUSHENYI,2016,520,630,1150,54
BUSHENYI,2017,530,640,1170,54
BUSHENYI,2018,530,650,1180,54
BUSHENYI,2019,540,650,1190,54
BUSHENYI,2020,550,660,1210,54
BUSHENYI,2021,550,660,1210,54
BUSHENYI,2022,560,660,1220,54
BUSHENYI,2023,560,670,1230,54
BUSHENYI,2024,570,670,1240,54
BUSHENYI,2025,570,670,1240,54
BUSIA,2015,590,750,1340,54
BUSIA,2016,630,810,1440,54
BUSIA,2017,650,810,1460,54
BUSIA,2018,660,790,1450,54
BUSIA,2019,660,770,1430,54
BUSIA,2020,670,750,1420,54
BUSIA,2021,690,760,1450,54
BUSIA,2022,730,800,1530,54
BUSIA,2023,780,870,1650,54
BUSIA,2024,840,950,1790,54
BUSIA,2025,900,1020,1920,54
BUTALEJA,2015,550,580,1130,54
BUTALEJA,2016,590,620,1210,54
BUTALEJA,2017,610,630,1240,54
BUTALEJA,2018,620,620,1240,54
BUTALEJA,2019,630,610,1240,54
BUTALEJA,2020,640,600,1240,54
BUTALEJA,2021,660,610,1270,54
BUTALEJA,2022,710,640,1350,54
BUTALEJA,2023,760,700,1460,54
BUTALEJA,2024,820,770,1590,54
BUTALEJA,2025,880,830,1710,54
BUTAMBALA,2015,180,230,410,54
BUTAMBALA,2016,180,250,430,54
BUTAMBALA,2017,180,250,430,54
BUTAMBALA,2018,190,230,420,54
BUTAMBALA,2019,180,220,400,54
BUTAMBALA,2020,180,210,390,54
BUTAMBALA,2021,180,210,390,54
BUTAMBALA,2022,200,220,420,54
BUTAMBALA,2023,200,230,430,54
BUTAMBALA,2024,210,250,460,54
BUTAMBALA,2025,220,260,480,54
BUTEBO,2015,240,300,540,54
BUTEBO,2016,250,320,570,54
BUTEBO,2017,260,310,570,54
BUTEBO,2018,250,300,550,54
BUTEBO,2019,250,280,530,54
BUTEBO,2020,250,280,530,54
BUTEBO,2021,250,280,530,54
BUTEBO,2022,270,280,550,54
BUTEBO,2023,280,310,590,54
BUTEBO,2024,290,330,620,54
BUTEBO,2025,310,350,660,54
BUVUMA,2015,220,150,370,54
BUVUMA,2016,230,160,390,54
BUVUMA,2017,250,170,420,54
BUVUMA,2018,260,180,440,54
BUVUMA,2019,280,190,470,54
BUVUMA,2020,290,200,490,54
BUVUMA,2021,310,220,530,54
BUVUMA,2022,330,230,560,54
BUVUMA,2023,350,250,600,54
BUVUMA,2024,370,260,630,54
BUVUMA,2025,390,280,670,54
BUYENDE,2015,590,650,1240,54
BUYENDE,2016,640,710,1350,54
BUYENDE,2017,660,720,1380,54
BUYENDE,2018,680,710,1390,54
BUYENDE,2019,690,690,1380,54
BUYENDE,2020,710,690,1400,54
BUYENDE,2021,740,700,1440,54
BUYENDE,2022,790,760,1550,54
BUYENDE,2023,870,840,1710,54
BUYENDE,2024,940,920,1860,54
BUYENDE,2025,1010,1000,2010,54
DOKOLO,2015,340,400,740,54
DOKOLO,2016,350,410,760,54
DOKOLO,2017,360,430,790,54
DOKOLO,2018,370,440,810,54
DOKOLO,2019,380,450,830,54
DOKOLO,2020,390,460,850,54
DOKOLO,2021,400,470,870,54
DOKOLO,2022,420,480,900,54
DOKOLO,2023,430,500,930,54
DOKOLO,2024,440,510,950,54
DOKOLO,2025,450,520,970,54
GOMBA,2015,380,380,760,54
GOMBA,2016,410,400,810,54
GOMBA,2017,410,400,810,54
GOMBA,2018,410,370,780,54
GOMBA,2019,410,360,770,54
GOMBA,2020,400,340,740,54
GOMBA,2021,410,350,760,54
GOMBA,2022,430,360,790,54
GOMBA,2023,450,380,830,54
GOMBA,2024,480,410,890,54
GOMBA,2025,500,430,930,54
GULU,2015,500,580,1080,54
GULU,2016,520,600,1120,54
GULU,2017,530,620,1150,54
GULU,2018,550,630,1180,54
GULU,2019,570,650,1220,54
GULU,2020,580,670,1250,54
GULU,2021,600,690,1290,54
GULU,2022,610,710,1320,54
GULU,2023,630,720,1350,54
GULU,2024,650,740,1390,54
GULU,2025,660,760,1420,54
HOIMA,2015,620,630,1250,54
HOIMA,2016,640,660,1300,54
HOIMA,2017,660,680,1340,54
HOIMA,2018,690,700,1390,54
HOIMA,2019,710,730,1440,54
HOIMA,2020,740,750,1490,54
HOIMA,2021,760,780,1540,54
HOIMA,2022,790,800,1590,54
HOIMA,2023,820,830,1650,54
HOIMA,2024,840,850,1690,54
HOIMA,2025,870,880,1750,54
IBANDA,2015,570,730,1300,54
IBANDA,2016,580,740,1320,54
IBANDA,2017,590,760,1350,54
IBANDA,2018,600,770,1370,54
IBANDA,2019,610,780,1390,54
IBANDA,2020,620,800,1420,54
IBANDA,2021,630,810,1440,54
IBANDA,2022,640,820,1460,54
IBANDA,2023,650,830,1480,54
IBANDA,2024,660,840,1500,54
IBANDA,2025,670,860,1530,54
IGANGA,2015,640,750,1390,54
IGANGA,2016,690,810,1500,54
IGANGA,2017,710,810,1520,54
IGANGA,2018,710,790,1500,54
IGANGA,2019,710,760,1470,54
IGANGA,2020,720,740,1460,54
IGANGA,2021,740,750,1490,54
IGANGA,2022,790,800,1590,54
IGANGA,2023,850,870,1720,54
IGANGA,2024,910,940,1850,54
IGANGA,2025,970,1000,1970,54
ISINGIRO,2015,1150,1370,2520,54
ISINGIRO,2016,1190,1420,2610,54
ISINGIRO,2017,1230,1470,2700,54
ISINGIRO,2018,1280,1520,2800,54
ISINGIRO,2019,1330,1570,2900,54
ISINGIRO,2020,1370,1620,2990,54
ISINGIRO,2021,1420,1670,3090,54
ISINGIRO,2022,1470,1730,3200,54
ISINGIRO,2023,1520,1780,3300,54
ISINGIRO,2024,1570,1840,3410,54
ISINGIRO,2025,1620,1900,3520,54
JINJA,2015,860,940,1800,54
JINJA,2016,870,950,1820,54
JINJA,2017,890,970,1860,54
JINJA,2018,900,980,1880,54
JINJA,2019,920,990,1910,54
JINJA,2020,930,1010,1940,54
JINJA,2021,940,1020,1960,54
JINJA,2022,960,1030,1990,54
JINJA,2023,970,1050,2020,54
JINJA,2024,980,1060,2040,54
JINJA,2025,990,1070,2060,54
KAABONG,2015,130,350,480,54
KAABONG,2016,130,360,490,54
KAABONG,2017,140,370,510,54
KAABONG,2018,140,370,510,54
KAABONG,2019,150,380,530,54
KAABONG,2020,150,390,540,54
KAABONG,2021,150,400,550,54
KAABONG,2022,160,410,570,54
KAABONG,2023,160,420,580,54
KAABONG,2024,160,430,590,54
KAABONG,2025,170,440,610,54
KABALE,2015,530,820,1350,54
KABALE,2016,540,830,1370,54
KABALE,2017,550,840,1390,54
KABALE,2018,560,850,1410,54
KABALE,2019,570,860,1430,54
KABALE,2020,570,870,1440,54
KABALE,2021,580,880,1460,54
KABALE,2022,590,890,1480,54
KABALE,2023,600,890,1490,54
KABALE,2024,600,900,1500,54
KABALE,2025,610,910,1520,54
KABAROLE,2015,630,810,1440,54
KABAROLE,2016,650,820,1470,54
KABAROLE,2017,660,840,1500,54
KABAROLE,2018,670,860,1530,54
KABAROLE,2019,690,880,1570,54
KABAROLE,2020,700,900,1600,54
KABAROLE,2021,720,910,1630,54
KABAROLE,2022,730,930,1660,54
KABAROLE,2023,740,950,1690,54
KABAROLE,2024,760,960,1720,54
KABAROLE,2025,770,980,1750,54
KABERAMAIDO,2015,190,210,400,54
KABERAMAIDO,2016,200,220,420,54
KABERAMAIDO,2017,210,220,430,54
KABERAMAIDO,2018,220,220,440,54
KABERAMAIDO,2019,220,220,440,54
KABERAMAIDO,2020,230,220,450,54
KABERAMAIDO,2021,240,210,450,54
KABERAMAIDO,2022,260,230,490,54
KABERAMAIDO,2023,280,250,530,54
KABERAMAIDO,2024,300,280,580,54
KABERAMAIDO,2025,330,300,630,54
KAGADI,2015,620,800,1420,54
KAGADI,2016,640,830,1470,54
KAGADI,2017,660,860,1520,54
KAGADI,2018,690,890,1580,54
KAGADI,2019,710,920,1630,54
KAGADI,2020,740,950,1690,54
KAGADI,2021,760,990,1750,54
KAGADI,2022,790,1020,1810,54
KAGADI,2023,820,1050,1870,54
KAGADI,2024,840,1080,1920,54
KAGADI,2025,870,1120,1990,54
KAKUMIRO,2015,660,580,1240,54
KAKUMIRO,2016,720,630,1350,54
KAKUMIRO,2017,780,680,1460,54
KAKUMIRO,2018,850,740,1590,54
KAKUMIRO,2019,920,800,1720,54
KAKUMIRO,2020,1000,870,1870,54
KAKUMIRO,2021,1090,940,2030,54
KAKUMIRO,2022,1180,1020,2200,54
KAKUMIRO,2023,1280,1100,2380,54
KAKUMIRO,2024,1390,1190,2580,54
KAKUMIRO,2025,1500,1280,2780,54
KALAKI,2015,190,220,410,54
KALAKI,2016,200,230,430,54
KALAKI,2017,210,240,450,54
KALAKI,2018,220,250,470,54
KALAKI,2019,230,260,490,54
KALAKI,2020,240,270,510,54
KALAKI,2021,250,280,530,54
KALAKI,2022,260,290,550,54
KALAKI,2023,270,300,570,54
KALAKI,2024,280,310,590,54
KALAKI,2025,290,320,610,54
KALANGALA,2015,140,70,210,54
KALANGALA,2016,140,80,220,54
KALANGALA,2017,150,80,230,54
KALANGALA,2018,150,80,230,54
KALANGALA,2019,160,80,240,54
KALANGALA,2020,160,90,250,54
KALANGALA,2021,170,90,260,54
KALANGALA,2022,170,100,270,54
KALANGALA,2023,180,100,280,54
KALANGALA,2024,190,100,290,54
KALANGALA,2025,190,110,300,54
KALIRO,2015,490,480,970,54
KALIRO,2016,510,520,1030,54
KALIRO,2017,530,520,1050,54
KALIRO,2018,540,520,1060,54
KALIRO,2019,550,500,1050,54
KALIRO,2020,560,500,1060,54
KALIRO,2021,580,500,1080,54
KALIRO,2022,620,530,1150,54
KALIRO,2023,670,580,1250,54
KALIRO,2024,720,640,1360,54
KALIRO,2025,770,690,1460,54
KALUNGU,2015,400,510,910,54
KALUNGU,2016,420,540,960,54
KALUNGU,2017,430,530,960,54
KALUNGU,2018,420,520,940,54
KALUNGU,2019,410,480,890,54
KALUNGU,2020,410,470,880,54
KALUNGU,2021,410,460,870,54
KALUNGU,2022,430,480,910,54
KALUNGU,2023,450,520,970,54
KALUNGU,2024,470,550,1020,54
KALUNGU,2025,500,570,1070,54
KAMPALA,2015,2140,2440,4580,54
KAMPALA,2016,2180,2480,4660,54
KAMPALA,2017,2230,2530,4760,54
KAMPALA,2018,2270,2580,4850,54
KAMPALA,2019,2310,2630,4940,54
KAMPALA,2020,2350,2680,5030,54
KAMPALA,2021,2390,2720,5110,54
KAMPALA,2022,2430,2770,5200,54
KAMPALA,2023,2470,2810,5280,54
KAMPALA,2024,2510,2850,5360,54
KAMPALA,2025,2550,2900,5450,54
KAMULI,2015,940,1030,1970,54
KAMULI,2016,1000,1090,2090,54
KAMULI,2017,1030,1090,2120,54
KAMULI,2018,1020,1060,2080,54
KAMULI,2019,1020,1010,2030,54
KAMULI,2020,1030,990,2020,54
KAMULI,2021,1060,990,2050,54
KAMULI,2022,1110,1050,2160,54
KAMULI,2023,1190,1130,2320,54
KAMULI,2024,1270,1220,2490,54
KAMULI,2025,1350,1300,2650,54
KAMWENGE,2015,570,670,1240,54
KAMWENGE,2016,600,690,1290,54
KAMWENGE,2017,620,720,1340,54
KAMWENGE,2018,650,740,1390,54
KAMWENGE,2019,670,770,1440,54
KAMWENGE,2020,700,790,1490,54
KAMWENGE,2021,730,820,1550,54
KAMWENGE,2022,750,850,1600,54
KAMWENGE,2023,780,870,1650,54
KAMWENGE,2024,810,900,1710,54
KAMWENGE,2025,840,930,1770,54
KANUNGU,2015,550,770,1320,54
KANUNGU,2016,560,780,1340,54
KANUNGU,2017,570,800,1370,54
KANUNGU,2018,580,810,1390,54
KANUNGU,2019,590,820,1410,54
KANUNGU,2020,600,830,1430,54
KANUNGU,2021,610,840,1450,54
KANUNGU,2022,620,860,1480,54
KANUNGU,2023,630,870,1500,54
KANUNGU,2024,640,880,1520,54
KANUNGU,2025,650,890,1540,54
KAPCHORWA,2015,270,270,540,54
KAPCHORWA,2016,280,280,560,54
KAPCHORWA,2017,290,290,580,54
KAPCHORWA,2018,300,290,590,54
KAPCHORWA,2019,310,300,610,54
KAPCHORWA,2020,310,310,620,54
KAPCHORWA,2021,320,320,640,54
KAPCHORWA,2022,330,330,660,54
KAPCHORWA,2023,340,330,670,54
KAPCHORWA,2024,350,340,690,54
KAPCHORWA,2025,360,350,710,54
KAPELEBYONG,2015,160,170,330,54
KAPELEBYONG,2016,170,180,350,54
KAPELEBYONG,2017,170,180,350,54
KAPELEBYONG,2018,180,180,360,54
KAPELEBYONG,2019,180,170,350,54
KAPELEBYONG,2020,180,170,350,54
KAPELEBYONG,2021,190,170,360,54
KAPELEBYONG,2022,200,180,380,54
KAPELEBYONG,2023,210,190,400,54
KAPELEBYONG,2024,220,220,440,54
KAPELEBYONG,2025,240,230,470,54
KASESE,2015,1330,1730,3060,54
KASESE,2016,1410,1830,3240,54
KASESE,2017,1440,1840,3280,54
KASESE,2018,1450,1780,3230,54
KASESE,2019,1440,1710,3150,54
KASESE,2020,1450,1650,3100,54
KASESE,2021,1490,1670,3160,54
KASESE,2022,1570,1740,3310,54
KASESE,2023,1660,1890,3550,54
KASESE,2024,1790,2040,3830,54
KASESE,2025,1880,2170,4050,54
KASSANDA,2015,600,670,1270,54
KASSANDA,2016,610,680,1290,54
KASSANDA,2017,630,690,1320,54
KASSANDA,2018,650,710,1360,54
KASSANDA,2019,670,720,1390,54
KASSANDA,2020,690,740,1430,54
KASSANDA,2021,700,750,1450,54
KASSANDA,2022,720,770,1490,54
KASSANDA,2023,740,780,1520,54
KASSANDA,2024,760,790,1550,54
KASSANDA,2025,780,810,1590,54
KATAKWI,2015,280,360,640,54
KATAKWI,2016,300,380,680,54
KATAKWI,2017,310,370,680,54
KATAKWI,2018,310,360,670,54
KATAKWI,2019,310,350,660,54
KATAKWI,2020,320,340,660,54
KATAKWI,2021,320,350,670,54
KATAKWI,2022,340,370,710,54
KATAKWI,2023,370,400,770,54
KATAKWI,2024,390,430,820,54
KATAKWI,2025,420,460,880,54
KAYUNGA,2015,690,870,1560,54
KAYUNGA,2016,730,910,1640,54
KAYUNGA,2017,750,920,1670,54
KAYUNGA,2018,740,880,1620,54
KAYUNGA,2019,730,830,1560,54
KAYUNGA,2020,740,810,1550,54
KAYUNGA,2021,750,810,1560,54
KAYUNGA,2022,780,840,1620,54
KAYUNGA,2023,840,900,1740,54
KAYUNGA,2024,890,980,1870,54
KAYUNGA,2025,930,1040,1970,54
KAZO,2015,510,520,1030,54
KAZO,2016,530,540,1070,54
KAZO,2017,550,560,1110,54
KAZO,2018,570,580,1150,54
KAZO,2019,590,600,1190,54
KAZO,2020,610,620,1230,54
KAZO,2021,630,640,1270,54
KAZO,2022,660,660,1320,54
KAZO,2023,680,680,1360,54
KAZO,2024,700,700,1400,54
KAZO,2025,730,730,1460,54
KIBAALE,2015,280,280,560,54
KIBAALE,2016,300,300,600,54
KIBAALE,2017,320,320,640,54
KIBAALE,2018,340,340,680,54
KIBAALE,2019,360,360,720,54
KIBAALE,2020,380,370,750,54
KIBAALE,2021,400,400,800,54
KIBAALE,2022,430,420,850,54
KIBAALE,2023,450,440,890,54
KIBAALE,2024,480,460,940,54
KIBAALE,2025,510,490,1000,54
KIBOGA,2015,320,310,630,54
KIBOGA,2016,350,340,690,54
KIBOGA,2017,380,360,740,54
KIBOGA,2018,380,370,750,54
KIBOGA,2019,380,350,730,54
KIBOGA,2020,380,340,720,54
KIBOGA,2021,390,330,720,54
KIBOGA,2022,400,340,740,54
KIBOGA,2023,430,350,780,54
KIBOGA,2024,450,380,830,54
KIBOGA,2025,480,410,890,54
KIBUKU,2015,520,610,1130,54
KIBUKU,2016,560,650,1210,54
KIBUKU,2017,580,660,1240,54
KIBUKU,2018,580,650,1230,54
KIBUKU,2019,590,630,1220,54
KIBUKU,2020,610,620,1230,54
KIBUKU,2021,630,640,1270,54
KIBUKU,2022,670,680,1350,54
KIBUKU,2023,730,740,1470,54
KIBUKU,2024,790,820,1610,54
KIBUKU,2025,840,890,1730,54
KIKUUBE,2015,610,550,1160,54
KIKUUBE,2016,650,580,1230,54
KIKUUBE,2017,680,610,1290,54
KIKUUBE,2018,720,640,1360,54
KIKUUBE,2019,750,670,1420,54
KIKUUBE,2020,790,710,1500,54
KIKUUBE,2021,830,740,1570,54
KIKUUBE,2022,880,780,1660,54
KIKUUBE,2023,920,810,1730,54
KIKUUBE,2024,970,850,1820,54
KIKUUBE,2025,1010,890,1900,54
KIRUHURA,2015,410,370,780,54
KIRUHURA,2016,420,380,800,54
KIRUHURA,2017,440,400,840,54
KIRUHURA,2018,460,410,870,54
KIRUHURA,2019,470,430,900,54
KIRUHURA,2020,490,440,930,54
KIRUHURA,2021,510,460,970,54
KIRUHURA,2022,530,470,1000,54
KIRUHURA,2023,540,490,1030,54
KIRUHURA,2024,560,500,1060,54
KIRUHURA,2025,580,510,1090,54
KIRYANDONGO,2015,480,490,970,54
KIRYANDONGO,2016,500,520,1020,54
KIRYANDONGO,2017,520,520,1040,54
KIRYANDONGO,2018,520,520,1040,54
KIRYANDONGO,2019,530,490,1020,54
KIRYANDONGO,2020,530,480,1010,54
KIRYANDONGO,2021,550,490,1040,54
KIRYANDONGO,2022,580,510,1090,54
KIRYANDONGO,2023,620,550,1170,54
KIRYANDONGO,2024,670,610,1280,54
KIRYANDONGO,2025,710,650,1360,54
KISORO,2015,490,900,1390,54
KISORO,2016,510,960,1470,54
KISORO,2017,520,960,1480,54
KISORO,2018,520,930,1450,54
KISORO,2019,520,880,1400,54
KISORO,2020,520,860,1380,54
KISORO,2021,530,860,1390,54
KISORO,2022,550,900,1450,54
KISORO,2023,580,970,1550,54
KISORO,2024,620,1050,1670,54
KISORO,2025,650,1110,1760,54
KITAGWENDA,2015,330,420,750,54
KITAGWENDA,2016,350,430,780,54
KITAGWENDA,2017,360,450,810,54
KITAGWENDA,2018,380,460,840,54
KITAGWENDA,2019,390,480,870,54
KITAGWENDA,2020,410,500,910,54
KITAGWENDA,2021,420,510,930,54
KITAGWENDA,2022,440,530,970,54
KITAGWENDA,2023,450,550,1000,54
KITAGWENDA,2024,470,560,1030,54
KITAGWENDA,2025,490,580,1070,54
KITGUM,2015,310,490,800,54
KITGUM,2016,330,520,850,54
KITGUM,2017,330,520,850,54
KITGUM,2018,330,500,830,54
KITGUM,2019,320,470,790,54
KITGUM,2020,330,460,790,54
KITGUM,2021,330,450,780,54
KITGUM,2022,350,480,830,54
KITGUM,2023,370,520,890,54
KITGUM,2024,390,550,940,54
KITGUM,2025,410,580,990,54
KOBOKO,2015,340,380,720,54
KOBOKO,2016,360,410,770,54
KOBOKO,2017,370,420,790,54
KOBOKO,2018,390,420,810,54
KOBOKO,2019,390,400,790,54
KOBOKO,2020,400,400,800,54
KOBOKO,2021,410,400,810,54
KOBOKO,2022,440,430,870,54
KOBOKO,2023,470,470,940,54
KOBOKO,2024,520,520,1040,54
KOBOKO,2025,560,560,1120,54
KOLE,2015,400,460,860,54
KOLE,2016,410,470,880,54
KOLE,2017,420,490,910,54
KOLE,2018,440,500,940,54
KOLE,2019,450,510,960,54
KOLE,2020,460,530,990,54
KOLE,2021,480,540,1020,54
KOLE,2022,490,560,1050,54
KOLE,2023,510,570,1080,54
KOLE,2024,520,580,1100,54
KOLE,2025,540,600,1140,54
KOTIDO,2015,350,430,780,54
KOTIDO,2016,370,460,830,54
KOTIDO,2017,380,460,840,54
KOTIDO,2018,380,450,830,54
KOTIDO,2019,380,430,810,54
KOTIDO,2020,380,420,800,54
KOTIDO,2021,390,420,810,54
KOTIDO,2022,410,440,850,54
KOTIDO,2023,440,470,910,54
KOTIDO,2024,470,510,980,54
KOTIDO,2025,500,540,1040,54
KUMI,2015,470,600,1070,54
KUMI,2016,500,630,1130,54
KUMI,2017,510,640,1150,54
KUMI,2018,520,630,1150,54
KUMI,2019,520,600,1120,54
KUMI,2020,530,590,1120,54
KUMI,2021,550,600,1150,54
KUMI,2022,580,630,1210,54
KUMI,2023,620,680,1300,54
KUMI,2024,670,740,1410,54
KUMI,2025,710,800,1510,54
KWANIA,2015,270,310,580,54
KWANIA,2016,280,320,600,54
KWANIA,2017,290,330,620,54
KWANIA,2018,300,340,640,54
KWANIA,2019,310,350,660,54
KWANIA,2020,310,360,670,54
KWANIA,2021,320,370,690,54
KWANIA,2022,330,380,710,54
KWANIA,2023,340,390,730,54
KWANIA,2024,350,390,740,54
KWANIA,2025,360,400,760,54
KWEEN,2015,220,200,420,54
KWEEN,2016,230,200,430,54
KWEEN,2017,230,210,440,54
KWEEN,2018,240,210,450,54
KWEEN,2019,250,220,470,54
KWEEN,2020,250,220,470,54
KWEEN,2021,260,230,490,54
KWEEN,2022,270,230,500,54
KWEEN,2023,280,240,520,54
KWEEN,2024,280,240,520,54
KWEEN,2025,290,240,530,54
KYANKWANZI,2015,460,430,890,54
KYANKWANZI,2016,480,450,930,54
KYANKWANZI,2017,500,470,970,54
KYANKWANZI,2018,530,500,1030,54
KYANKWANZI,2019,560,520,1080,54
KYANKWANZI,2020,580,540,1120,54
KYANKWANZI,2021,610,570,1180,54
KYANKWANZI,2022,640,590,1230,54
KYANKWANZI,2023,670,620,1290,54
KYANKWANZI,2024,700,640,1340,54
KYANKWANZI,2025,740,670,1410,54
KYEGEGWA,2015,620,600,1220,54
KYEGEGWA,2016,670,650,1320,54
KYEGEGWA,2017,720,700,1420,54
KYEGEGWA,2018,780,760,1540,54
KYEGEGWA,2019,840,820,1660,54
KYEGEGWA,2020,910,880,1790,54
KYEGEGWA,2021,980,950,1930,54
KYEGEGWA,2022,1060,1020,2080,54
KYEGEGWA,2023,1150,1100,2250,54
KYEGEGWA,2024,1230,1180,2410,54
KYEGEGWA,2025,1330,1270,2600,54
KYENJOJO,2015,820,970,1790,54
KYENJOJO,2016,850,1000,1850,54
KYENJOJO,2017,890,1040,1930,54
KYENJOJO,2018,920,1080,2000,54
KYENJOJO,2019,960,1120,2080,54
KYENJOJO,2020,1000,1160,2160,54
KYENJOJO,2021,1040,1200,2240,54
KYENJOJO,2022,1080,1240,2320,54
KYENJOJO,2023,1120,1280,2400,54
KYENJOJO,2024,1160,1320,2480,54
KYENJOJO,2025,1200,1360,2560,54
KYOTERA,2015,470,650,1120,54
KYOTERA,2016,490,690,1180,54
KYOTERA,2017,490,670,1160,54
KYOTERA,2018,490,650,1140,54
KYOTERA,2019,490,620,1110,54
KYOTERA,2020,490,600,1090,54
KYOTERA,2021,490,600,1090,54
KYOTERA,2022,520,610,1130,54
KYOTERA,2023,550,660,1210,54
KYOTERA,2024,580,710,1290,54
KYOTERA,2025,600,750,1350,54
KARENGA,2015,220,190,410,54
KARENGA,2016,220,190,410,54
KARENGA,2017,230,190,420,54
KARENGA,2018,240,200,440,54
KARENGA,2019,240,210,450,54
KARENGA,2020,250,210,460,54
KARENGA,2021,250,210,460,54
KARENGA,2022,260,220,480,54
KARENGA,2023,270,220,490,54
KARENGA,2024,270,230,500,54
KARENGA,2025,280,230,510,54
LAMWO,2015,230,350,580,54
LAMWO,2016,240,360,600,54
LAMWO,2017,240,360,600,54
LAMWO,2018,230,340,570,54
LAMWO,2019,230,330,560,54
LAMWO,2020,230,320,550,54
LAMWO,2021,230,320,550,54
LAMWO,2022,240,330,570,54
LAMWO,2023,250,360,610,54
LAMWO,2024,260,380,640,54
LAMWO,2025,280,400,680,54
LIRA,2015,630,830,1460,54
LIRA,2016,640,850,1490,54
LIRA,2017,660,870,1530,54
LIRA,2018,680,900,1580,54
LIRA,2019,700,920,1620,54
LIRA,2020,720,950,1670,54
LIRA,2021,740,970,1710,54
LIRA,2022,760,1000,1760,54
LIRA,2023,770,1020,1790,54
LIRA,2024,790,1050,1840,54
LIRA,2025,810,1070,1880,54
LUUKA,2015,410,580,990,54
LUUKA,2016,440,610,1050,54
LUUKA,2017,450,610,1060,54
LUUKA,2018,440,600,1040,54
LUUKA,2019,440,570,1010,54
LUUKA,2020,440,550,990,54
LUUKA,2021,450,550,1000,54
LUUKA,2022,470,580,1050,54
LUUKA,2023,500,620,1120,54
LUUKA,2024,540,670,1210,54
LUUKA,2025,560,710,1270,54
LUWERO,2015,910,1050,1960,54
LUWERO,2016,960,1120,2080,54
LUWERO,2017,980,1120,2100,54
LUWERO,2018,990,1080,2070,54
LUWERO,2019,980,1040,2020,54
LUWERO,2020,990,1010,2000,54
LUWERO,2021,1020,1020,2040,54
LUWERO,2022,1070,1060,2130,54
LUWERO,2023,1150,1160,2310,54
LUWERO,2024,1230,1250,2480,54
LUWERO,2025,1290,1330,2620,54
LWENGO,2015,510,790,1300,54
LWENGO,2016,520,820,1340,54
LWENGO,2017,530,810,1340,54
LWENGO,2018,520,780,1300,54
LWENGO,2019,520,730,1250,54
LWENGO,2020,510,700,1210,54
LWENGO,2021,520,690,1210,54
LWENGO,2022,540,720,1260,54
LWENGO,2023,570,770,1340,54
LWENGO,2024,600,830,1430,54
LWENGO,2025,630,860,1490,54
LYANTONDE,2015,220,230,450,54
LYANTONDE,2016,240,250,490,54
LYANTONDE,2017,250,260,510,54
LYANTONDE,2018,240,240,480,54
LYANTONDE,2019,240,240,480,54
LYANTONDE,2020,250,230,480,54
LYANTONDE,2021,260,230,490,54
LYANTONDE,2022,270,250,520,54
LYANTONDE,2023,290,270,560,54
LYANTONDE,2024,310,290,600,54
LYANTONDE,2025,330,310,640,54
MANAFWA,2015,410,430,840,54
MANAFWA,2016,420,440,860,54
MANAFWA,2017,440,450,890,54
MANAFWA,2018,450,460,910,54
MANAFWA,2019,460,470,930,54
MANAFWA,2020,470,480,950,54
MANAFWA,2021,480,490,970,54
MANAFWA,2022,490,500,990,54
MANAFWA,2023,500,510,1010,54
MANAFWA,2024,510,520,1030,54
MANAFWA,2025,520,530,1050,54
MARACHA,2015,370,500,870,54
MARACHA,2016,380,510,890,54
MARACHA,2017,390,520,910,54
MARACHA,2018,390,530,920,54
MARACHA,2019,400,540,940,54
MARACHA,2020,410,550,960,54
MARACHA,2021,420,560,980,54
MARACHA,2022,420,570,990,54
MARACHA,2023,430,580,1010,54
MARACHA,2024,440,590,1030,54
MARACHA,2025,450,600,1050,54
MASAKA,2015,420,510,930,54
MASAKA,2016,490,590,1080,54
MASAKA,2017,530,660,1190,54
MASAKA,2018,560,700,1260,54
MASAKA,2019,580,700,1280,54
MASAKA,2020,580,670,1250,54
MASAKA,2021,570,640,1210,54
MASAKA,2022,570,620,1190,54
MASAKA,2023,590,630,1220,54
MASAKA,2024,620,660,1280,54
MASAKA,2025,660,710,1370,54
MASINDI,2015,590,540,1130,54
MASINDI,2016,610,560,1170,54
MASINDI,2017,630,570,1200,54
MASINDI,2018,650,590,1240,54
MASINDI,2019,660,600,1260,54
MASINDI,2020,680,620,1300,54
MASINDI,2021,700,630,1330,54
MASINDI,2022,720,650,1370,54
MASINDI,2023,740,660,1400,54
MASINDI,2024,760,680,1440,54
MASINDI,2025,770,690,1460,54
MAYUGE,2015,770,1020,1790,54
MAYUGE,2016,820,1090,1910,54
MAYUGE,2017,840,1100,1940,54
MAYUGE,2018,860,1070,1930,54
MAYUGE,2019,860,1030,1890,54
MAYUGE,2020,870,1010,1880,54
MAYUGE,2021,900,1020,1920,54
MAYUGE,2022,960,1090,2050,54
MAYUGE,2023,1020,1190,2210,54
MAYUGE,2024,1100,1290,2390,54
MAYUGE,2025,1170,1380,2550,54
MBALE,2015,1070,1130,2200,54
MBALE,2016,1090,1140,2230,54
MBALE,2017,1100,1100,2200,54
MBALE,2018,1110,1070,2180,54
MBALE,2019,1120,1060,2180,54
MBALE,2020,1150,1070,2220,54
MBALE,2021,1230,1140,2370,54
MBALE,2022,1320,1240,2560,54
MBALE,2023,1430,1370,2800,54
MBALE,2024,1510,1480,2990,54
MBALE,2025,1590,1580,3170,54
MBARARA,2015,750,810,1560,54
MBARARA,2016,770,820,1590,54
MBARARA,2017,790,840,1630,54
MBARARA,2018,810,860,1670,54
MBARARA,2019,820,880,1700,54
MBARARA,2020,840,890,1730,54
MBARARA,2021,860,910,1770,54
MBARARA,2022,880,930,1810,54
MBARARA,2023,890,950,1840,54
MBARARA,2024,910,960,1870,54
MBARARA,2025,930,980,1910,54
MITOOMA,2015,370,600,970,54
MITOOMA,2016,380,610,990,54
MITOOMA,2017,380,610,990,54
MITOOMA,2018,390,620,1010,54
MITOOMA,2019,390,620,1010,54
MITOOMA,2020,390,630,1020,54
MITOOMA,2021,400,630,1030,54
MITOOMA,2022,400,640,1040,54
MITOOMA,2023,410,640,1050,54
MITOOMA,2024,410,650,1060,54
MITOOMA,2025,410,650,1060,54
MITYANA,2015,810,900,1710,54
MITYANA,2016,860,950,1810,54
MITYANA,2017,870,950,1820,54
MITYANA,2018,870,910,1780,54
MITYANA,2019,850,860,1710,54
MITYANA,2020,860,830,1690,54
MITYANA,2021,870,840,1710,54
MITYANA,2022,920,870,1790,54
MITYANA,2023,970,930,1900,54
MITYANA,2024,1020,1000,2020,54
MITYANA,2025,1080,1060,2140,54
MOROTO,2015,180,280,460,54
MOROTO,2016,180,300,480,54
MOROTO,2017,190,310,500,54
MOROTO,2018,190,290,480,54
MOROTO,2019,180,280,460,54
MOROTO,2020,190,280,470,54
MOROTO,2021,190,280,470,54
MOROTO,2022,210,290,500,54
MOROTO,2023,210,320,530,54
MOROTO,2024,220,340,560,54
MOROTO,2025,240,370,610,54
MOYO,2015,250,290,540,54
MOYO,2016,260,290,550,54
MOYO,2017,260,300,560,54
MOYO,2018,270,310,580,54
MOYO,2019,280,310,590,54
MOYO,2020,280,320,600,54
MOYO,2021,290,320,610,54
MOYO,2022,300,330,630,54
MOYO,2023,300,340,640,54
MOYO,2024,310,340,650,54
MOYO,2025,320,350,670,54
MPIGI,2015,550,690,1240,54
MPIGI,2016,590,740,1330,54
MPIGI,2017,600,740,1340,54
MPIGI,2018,600,720,1320,54
MPIGI,2019,600,680,1280,54
MPIGI,2020,600,670,1270,54
MPIGI,2021,620,680,1300,54
MPIGI,2022,650,710,1360,54
MPIGI,2023,690,770,1460,54
MPIGI,2024,740,830,1570,54
MPIGI,2025,780,890,1670,54
MUBENDE,2015,600,530,1130,54
MUBENDE,2016,700,630,1330,54
MUBENDE,2017,810,770,1580,54
MUBENDE,2018,910,870,1780,54
MUBENDE,2019,990,950,1940,54
MUBENDE,2020,1050,990,2040,54
MUBENDE,2021,1080,970,2050,54
MUBENDE,2022,1110,960,2070,54
MUBENDE,2023,1150,960,2110,54
MUBENDE,2024,1200,1000,2200,54
MUBENDE,2025,1300,1080,2380,54
MUKONO,2015,1190,1410,2600,54
MUKONO,2016,1260,1500,2760,54
MUKONO,2017,1300,1520,2820,54
MUKONO,2018,1310,1480,2790,54
MUKONO,2019,1300,1420,2720,54
MUKONO,2020,1320,1390,2710,54
MUKONO,2021,1350,1410,2760,54
MUKONO,2022,1430,1500,2930,54
MUKONO,2023,1520,1620,3140,54
MUKONO,2024,1630,1770,3400,54
MUKONO,2025,1730,1890,3620,54
MADI OKOLLO,2015,330,350,680,54
MADI OKOLLO,2016,340,360,700,54
MADI OKOLLO,2017,350,370,720,54
MADI OKOLLO,2018,360,380,740,54
MADI OKOLLO,2019,370,390,760,54
MADI OKOLLO,2020,380,400,780,54
MADI OKOLLO,2021,390,410,800,54
MADI OKOLLO,2022,400,420,820,54
MADI OKOLLO,2023,410,430,840,54
MADI OKOLLO,2024,420,440,860,54
MADI OKOLLO,2025,430,450,880,54
NABILATUK,2015,100,150,250,54
NABILATUK,2016,120,160,280,54
NABILATUK,2017,120,160,280,54
NABILATUK,2018,130,160,290,54
NABILATUK,2019,120,160,280,54
NABILATUK,2020,130,150,280,54
NABILATUK,2021,130,160,290,54
NABILATUK,2022,140,170,310,54
NABILATUK,2023,160,190,350,54
NABILATUK,2024,180,220,400,54
NABILATUK,2025,190,230,420,54
NAKAPIRIPIRIT,2015,170,200,370,54
NAKAPIRIPIRIT,2016,180,220,400,54
NAKAPIRIPIRIT,2017,180,220,400,54
NAKAPIRIPIRIT,2018,190,220,410,54
NAKAPIRIPIRIT,2019,190,220,410,54
NAKAPIRIPIRIT,2020,200,220,420,54
NAKAPIRIPIRIT,2021,210,220,430,54
NAKAPIRIPIRIT,2022,220,240,460,54
NAKAPIRIPIRIT,2023,240,260,500,54
NAKAPIRIPIRIT,2024,260,290,550,54
NAKAPIRIPIRIT,2025,280,310,590,54
NAKASEKE,2015,430,500,930,54
NAKASEKE,2016,450,510,960,54
NAKASEKE,2017,470,520,990,54
NAKASEKE,2018,480,530,1010,54
NAKASEKE,2019,500,550,1050,54
NAKASEKE,2020,520,560,1080,54
NAKASEKE,2021,540,570,1110,54
NAKASEKE,2022,550,580,1130,54
NAKASEKE,2023,570,600,1170,54
NAKASEKE,2024,590,610,1200,54
NAKASEKE,2025,610,620,1230,54
NAKASONGOLA,2015,360,380,740,54
NAKASONGOLA,2016,390,400,790,54
NAKASONGOLA,2017,410,410,820,54
NAKASONGOLA,2018,410,390,800,54
NAKASONGOLA,2019,410,380,790,54
NAKASONGOLA,2020,410,370,780,54
NAKASONGOLA,2021,430,370,800,54
NAKASONGOLA,2022,450,390,840,54
NAKASONGOLA,2023,480,430,910,54
NAKASONGOLA,2024,530,460,990,54
NAKASONGOLA,2025,560,500,1060,54
NAMAYINGO,2015,370,480,850,54
NAMAYINGO,2016,400,510,910,54
NAMAYINGO,2017,410,510,920,54
NAMAYINGO,2018,400,490,890,54
NAMAYINGO,2019,400,460,860,54
NAMAYINGO,2020,400,450,850,54
NAMAYINGO,2021,410,450,860,54
NAMAYINGO,2022,420,470,890,54
NAMAYINGO,2023,450,500,950,54
NAMAYINGO,2024,480,540,1020,54
NAMAYINGO,2025,500,570,1070,54
NAMISINDWA,2015,510,550,1060,54
NAMISINDWA,2016,520,570,1090,54
NAMISINDWA,2017,540,580,1120,54
NAMISINDWA,2018,550,590,1140,54
NAMISINDWA,2019,570,610,1180,54
NAMISINDWA,2020,580,620,1200,54
NAMISINDWA,2021,600,630,1230,54
NAMISINDWA,2022,610,650,1260,54
NAMISINDWA,2023,630,660,1290,54
NAMISINDWA,2024,640,670,1310,54
NAMISINDWA,2025,660,690,1350,54
NAMUTUMBA,2015,530,580,1110,54
NAMUTUMBA,2016,560,620,1180,54
NAMUTUMBA,2017,580,630,1210,54
NAMUTUMBA,2018,580,620,1200,54
NAMUTUMBA,2019,590,600,1190,54
NAMUTUMBA,2020,600,590,1190,54
NAMUTUMBA,2021,620,600,1220,54
NAMUTUMBA,2022,660,630,1290,54
NAMUTUMBA,2023,710,690,1400,54
NAMUTUMBA,2024,780,750,1530,54
NAMUTUMBA,2025,830,810,1640,54
NAPAK,2015,280,510,790,54
NAPAK,2016,290,540,830,54
NAPAK,2017,300,560,860,54
NAPAK,2018,290,540,830,54
NAPAK,2019,290,510,800,54
NAPAK,2020,290,500,790,54
NAPAK,2021,300,500,800,54
NAPAK,2022,310,520,830,54
NAPAK,2023,330,560,890,54
NAPAK,2024,350,610,960,54
NAPAK,2025,360,650,1010,54
NEBBI,2015,450,550,1000,54
NEBBI,2016,460,560,1020,54
NEBBI,2017,480,580,1060,54
NEBBI,2018,490,600,1090,54
NEBBI,2019,510,610,1120,54
NEBBI,2020,520,630,1150,54
NEBBI,2021,540,640,1180,54
NEBBI,2022,550,660,1210,54
NEBBI,2023,570,680,1250,54
NEBBI,2024,580,690,1270,54
NEBBI,2025,600,710,1310,54
NGORA,2015,310,280,590,54
NGORA,2016,330,300,630,54
NGORA,2017,340,310,650,54
NGORA,2018,340,290,630,54
NGORA,2019,350,280,630,54
NGORA,2020,350,280,630,54
NGORA,2021,360,290,650,54
NGORA,2022,380,290,670,54
NGORA,2023,410,320,730,54
NGORA,2024,440,350,790,54
NGORA,2025,470,380,850,54
NTOROKO,2015,180,170,350,54
NTOROKO,2016,190,170,360,54
NTOROKO,2017,190,170,360,54
NTOROKO,2018,190,170,360,54
NTOROKO,2019,190,160,350,54
NTOROKO,2020,190,150,340,54
NTOROKO,2021,200,160,360,54
NTOROKO,2022,210,170,380,54
NTOROKO,2023,230,170,400,54
NTOROKO,2024,240,190,430,54
NTOROKO,2025,260,210,470,54
NTUNGAMO,2015,1170,1520,2690,54
NTUNGAMO,2016,1200,1550,2750,54
NTUNGAMO,2017,1220,1580,2800,54
NTUNGAMO,2018,1250,1610,2860,54
NTUNGAMO,2019,1280,1640,2920,54
NTUNGAMO,2020,1300,1660,2960,54
NTUNGAMO,2021,1330,1690,3020,54
NTUNGAMO,2022,1350,1720,3070,54
NTUNGAMO,2023,1370,1740,3110,54
NTUNGAMO,2024,1400,1770,3170,54
NTUNGAMO,2025,1420,1790,3210,54
NWOYA,2015,230,320,550,54
NWOYA,2016,250,350,600,54
NWOYA,2017,280,380,660,54
NWOYA,2018,310,420,730,54
NWOYA,2019,340,470,810,54
NWOYA,2020,380,510,890,54
NWOYA,2021,410,560,970,54
NWOYA,2022,460,620,1080,54
NWOYA,2023,500,680,1180,54
NWOYA,2024,550,750,1300,54
NWOYA,2025,610,820,1430,54
OBONGI,2015,70,70,140,54
OBONGI,2016,90,80,170,54
OBONGI,2017,90,70,160,54
OBONGI,2018,80,70,150,54
OBONGI,2019,80,70,150,54
OBONGI,2020,80,60,140,54
OBONGI,2021,90,70,160,54
OBONGI,2022,90,70,160,54
OBONGI,2023,100,80,180,54
OBONGI,2024,100,80,180,54
OBONGI,2025,100,90,190,54
OMORO,2015,260,360,620,54
OMORO,2016,280,380,660,54
OMORO,2017,290,400,690,54
OMORO,2018,290,380,670,54
OMORO,2019,290,370,660,54
OMORO,2020,300,360,660,54
OMORO,2021,310,370,680,54
OMORO,2022,330,390,720,54
OMORO,2023,370,430,800,54
OMORO,2024,390,470,860,54
OMORO,2025,420,510,930,54
OTUKE,2015,200,270,470,54
OTUKE,2016,210,280,490,54
OTUKE,2017,210,300,510,54
OTUKE,2018,220,310,530,54
OTUKE,2019,230,320,550,54
OTUKE,2020,240,340,580,54
OTUKE,2021,260,350,610,54
OTUKE,2022,270,360,630,54
OTUKE,2023,280,380,660,54
OTUKE,2024,290,390,680,54
OTUKE,2025,300,410,710,54
OYAM,2015,610,790,1400,54
OYAM,2016,630,820,1450,54
OYAM,2017,650,840,1490,54
OYAM,2018,670,860,1530,54
OYAM,2019,690,890,1580,54
OYAM,2020,710,910,1620,54
OYAM,2021,730,940,1670,54
OYAM,2022,750,960,1710,54
OYAM,2023,770,990,1760,54
OYAM,2024,790,1010,1800,54
OYAM,2025,810,1040,1850,54
PADER,2015,250,410,660,54
PADER,2016,260,440,700,54
PADER,2017,260,440,700,54
PADER,2018,260,430,690,54
PADER,2019,250,400,650,54
PADER,2020,260,390,650,54
PADER,2021,260,390,650,54
PADER,2022,280,410,690,54
PADER,2023,290,440,730,54
PADER,2024,300,470,770,54
PADER,2025,330,510,840,54
PAKWACH,2015,300,360,660,54
PAKWACH,2016,310,370,680,54
PAKWACH,2017,330,390,720,54
PAKWACH,2018,340,400,740,54
PAKWACH,2019,350,410,760,54
PAKWACH,2020,370,430,800,54
PAKWACH,2021,380,440,820,54
PAKWACH,2022,400,460,860,54
PAKWACH,2023,410,470,880,54
PAKWACH,2024,430,490,920,54
PAKWACH,2025,440,510,950,54
PALLISA,2015,670,810,1480,54
PALLISA,2016,720,880,1600,54
PALLISA,2017,760,900,1660,54
PALLISA,2018,770,890,1660,54
PALLISA,2019,780,860,1640,54
PALLISA,2020,810,860,1670,54
PALLISA,2021,840,880,1720,54
PALLISA,2022,910,940,1850,54
PALLISA,2023,980,1040,2020,54
PALLISA,2024,1070,1150,2220,54
PALLISA,2025,1150,1250,2400,54
RAKAI,2015,610,750,1360,54
RAKAI,2016,640,790,1430,54
RAKAI,2017,660,800,1460,54
RAKAI,2018,670,780,1450,54
RAKAI,2019,660,740,1400,54
RAKAI,2020,670,720,1390,54
RAKAI,2021,690,730,1420,54
RAKAI,2022,720,760,1480,54
RAKAI,2023,770,830,1600,54
RAKAI,2024,820,900,1720,54
RAKAI,2025,870,950,1820,54
RUBANDA,2015,450,700,1150,54
RUBANDA,2016,450,710,1160,54
RUBANDA,2017,460,710,1170,54
RUBANDA,2018,460,720,1180,54
RUBANDA,2019,470,720,1190,54
RUBANDA,2020,480,730,1210,54
RUBANDA,2021,480,730,1210,54
RUBANDA,2022,490,740,1230,54
RUBANDA,2023,490,740,1230,54
RUBANDA,2024,500,740,1240,54
RUBANDA,2025,500,750,1250,54
RUBIRIZI,2015,230,340,570,54
RUBIRIZI,2016,230,350,580,54
RUBIRIZI,2017,240,360,600,54
RUBIRIZI,2018,240,360,600,54
RUBIRIZI,2019,250,370,620,54
RUBIRIZI,2020,250,380,630,54
RUBIRIZI,2021,260,380,640,54
RUBIRIZI,2022,260,390,650,54
RUBIRIZI,2023,260,390,650,54
RUBIRIZI,2024,270,400,670,54
RUBIRIZI,2025,270,410,680,54
RUKIGA,2015,290,400,690,54
RUKIGA,2016,290,400,690,54
RUKIGA,2017,290,410,700,54
RUKIGA,2018,300,410,710,54
RUKIGA,2019,300,410,710,54
RUKIGA,2020,300,410,710,54
RUKIGA,2021,300,420,720,54
RUKIGA,2022,310,420,730,54
RUKIGA,2023,310,420,730,54
RUKIGA,2024,310,420,730,54
RUKIGA,2025,310,420,730,54
RUKUNGIRI,2015,710,1010,1720,54
RUKUNGIRI,2016,710,1020,1730,54
RUKUNGIRI,2017,720,1030,1750,54
RUKUNGIRI,2018,730,1040,1770,54
RUKUNGIRI,2019,740,1050,1790,54
RUKUNGIRI,2020,750,1050,1800,54
RUKUNGIRI,2021,750,1060,1810,54
RUKUNGIRI,2022,760,1070,1830,54
RUKUNGIRI,2023,770,1080,1850,54
RUKUNGIRI,2024,770,1080,1850,54
RUKUNGIRI,2025,780,1090,1870,54
RWAMPARA,2015,300,420,720,54
RWAMPARA,2016,300,430,730,54
RWAMPARA,2017,310,440,750,54
RWAMPARA,2018,320,450,770,54
RWAMPARA,2019,330,460,790,54
RWAMPARA,2020,330,470,800,54
RWAMPARA,2021,340,480,820,54
RWAMPARA,2022,350,490,840,54
RWAMPARA,2023,350,500,850,54
RWAMPARA,2024,360,510,870,54
RWAMPARA,2025,370,520,890,54
SERERE,2015,520,550,1070,54
SERERE,2016,560,590,1150,54
SERERE,2017,590,610,1200,54
SERERE,2018,600,600,1200,54
SERERE,2019,600,580,1180,54
SERERE,2020,620,570,1190,54
SERERE,2021,640,590,1230,54
SERERE,2022,690,620,1310,54
SERERE,2023,740,690,1430,54
SERERE,2024,810,750,1560,54
SERERE,2025,860,820,1680,54
SHEEMA,2015,450,690,1140,54
SHEEMA,2016,460,690,1150,54
SHEEMA,2017,470,700,1170,54
SHEEMA,2018,470,710,1180,54
SHEEMA,2019,480,720,1200,54
SHEEMA,2020,480,720,1200,54
SHEEMA,2021,490,730,1220,54
SHEEMA,2022,490,730,1220,54
SHEEMA,2023,490,740,1230,54
SHEEMA,2024,500,740,1240,54
SHEEMA,2025,500,750,1250,54
SIRONKO,2015,730,740,1470,54
SIRONKO,2016,750,760,1510,54
SIRONKO,2017,760,770,1530,54
SIRONKO,2018,780,790,1570,54
SIRONKO,2019,800,800,1600,54
SIRONKO,2020,820,820,1640,54
SIRONKO,2021,830,830,1660,54
SIRONKO,2022,850,850,1700,54
SIRONKO,2023,870,860,1730,54
SIRONKO,2024,890,880,1770,54
SIRONKO,2025,900,890,1790,54
SOROTI,2015,530,600,1130,54
SOROTI,2016,570,640,1210,54
SOROTI,2017,590,650,1240,54
SOROTI,2018,600,640,1240,54
SOROTI,2019,600,620,1220,54
SOROTI,2020,610,610,1220,54
SOROTI,2021,630,610,1240,54
SOROTI,2022,670,660,1330,54
SOROTI,2023,730,720,1450,54
SOROTI,2024,790,780,1570,54
SOROTI,2025,840,840,1680,54
SSEMBABULE,2015,590,620,1210,54
SSEMBABULE,2016,620,650,1270,54
SSEMBABULE,2017,640,660,1300,54
SSEMBABULE,2018,650,640,1290,54
SSEMBABULE,2019,650,620,1270,54
SSEMBABULE,2020,650,610,1260,54
SSEMBABULE,2021,670,610,1280,54
SSEMBABULE,2022,710,640,1350,54
SSEMBABULE,2023,760,700,1460,54
SSEMBABULE,2024,820,750,1570,54
SSEMBABULE,2025,860,810,1670,54
TORORO,2015,1060,1390,2450,54
TORORO,2016,1090,1430,2520,54
TORORO,2017,1120,1460,2580,54
TORORO,2018,1150,1500,2650,54
TORORO,2019,1180,1540,2720,54
TORORO,2020,1210,1570,2780,54
TORORO,2021,1240,1610,2850,54
TORORO,2022,1270,1650,2920,54
TORORO,2023,1290,1680,2970,54
TORORO,2024,1320,1720,3040,54
TORORO,2025,1350,1750,3100,54
WAKISO,2015,2940,3420,6360,54
WAKISO,2016,3140,3650,6790,54
WAKISO,2017,3350,3900,7250,54
WAKISO,2018,3570,4160,7730,54
WAKISO,2019,3810,4440,8250,54
WAKISO,2020,4050,4740,8790,54
WAKISO,2021,4310,5050,9360,54
WAKISO,2022,4590,5390,9980,54
WAKISO,2023,4880,5730,10610,54
WAKISO,2024,5190,6100,11290,54
WAKISO,2025,5510,6490,12000,54
YUMBE,2015,670,590,1260,54
YUMBE,2016,730,650,1380,54
YUMBE,2017,770,670,1440,54
YUMBE,2018,790,680,1470,54
YUMBE,2019,810,670,1480,54
YUMBE,2020,840,680,1520,54
YUMBE,2021,880,700,1580,54
YUMBE,2022,950,770,1720,54
YUMBE,2023,1040,860,1900,54
YUMBE,2024,1140,960,2100,54
YUMBE,2025,1230,1060,2290,54
ZOMBO,2015,460,550,1010,54
ZOMBO,2016,480,570,1050,54
ZOMBO,2017,490,580,1070,54
ZOMBO,2018,510,600,1110,54
ZOMBO,2019,520,610,1130,54
ZOMBO,2020,540,630,1170,54
ZOMBO,2021,550,650,1200,54
ZOMBO,2022,570,660,1230,54
ZOMBO,2023,580,680,1260,54
ZOMBO,2024,600,700,1300,54
ZOMBO,2025,610,710,1320,54
ABIM,2015,150,190,340,55
ABIM,2016,180,210,390,55
ABIM,2017,200,250,450,55
ABIM,2018,210,250,460,55
ABIM,2019,220,250,470,55
ABIM,2020,220,250,470,55
ABIM,2021,230,250,480,55
ABIM,2022,240,260,500,55
ABIM,2023,270,290,560,55
ABIM,2024,300,330,630,55
ABIM,2025,320,360,680,55
ADJUMANI,2015,260,430,690,55
ADJUMANI,2016,260,440,700,55
ADJUMANI,2017,260,440,700,55
ADJUMANI,2018,270,450,720,55
ADJUMANI,2019,270,450,720,55
ADJUMANI,2020,270,450,720,55
ADJUMANI,2021,270,460,730,55
ADJUMANI,2022,270,460,730,55
ADJUMANI,2023,270,460,730,55
ADJUMANI,2024,270,470,740,55
ADJUMANI,2025,270,470,740,55
AGAGO,2015,350,460,810,55
AGAGO,2016,350,470,820,55
AGAGO,2017,360,480,840,55
AGAGO,2018,370,490,860,55
AGAGO,2019,370,490,860,55
AGAGO,2020,380,500,880,55
AGAGO,2021,380,510,890,55
AGAGO,2022,390,520,910,55
AGAGO,2023,400,520,920,55
AGAGO,2024,400,530,930,55
AGAGO,2025,410,540,950,55
ALEBTONG,2015,450,510,960,55
ALEBTONG,2016,500,580,1080,55
ALEBTONG,2017,530,610,1140,55
ALEBTONG,2018,550,620,1170,55
ALEBTONG,2019,550,600,1150,55
ALEBTONG,2020,550,570,1120,55
ALEBTONG,2021,550,570,1120,55
ALEBTONG,2022,580,570,1150,55
ALEBTONG,2023,610,600,1210,55
ALEBTONG,2024,640,650,1290,55
ALEBTONG,2025,690,700,1390,55
AMOLATAR,2015,270,250,520,55
AMOLATAR,2016,280,280,560,55
AMOLATAR,2017,310,290,600,55
AMOLATAR,2018,320,300,620,55
AMOLATAR,2019,310,300,610,55
AMOLATAR,2020,310,280,590,55
AMOLATAR,2021,320,270,590,55
AMOLATAR,2022,320,270,590,55
AMOLATAR,2023,340,290,630,55
AMOLATAR,2024,370,320,690,55
AMOLATAR,2025,390,330,720,55
AMUDAT,2015,220,170,390,55
AMUDAT,2016,250,190,440,55
AMUDAT,2017,270,210,480,55
AMUDAT,2018,270,210,480,55
AMUDAT,2019,280,210,490,55
AMUDAT,2020,280,200,480,55
AMUDAT,2021,290,200,490,55
AMUDAT,2022,300,210,510,55
AMUDAT,2023,320,230,550,55
AMUDAT,2024,350,250,600,55
AMUDAT,2025,380,280,660,55
AMURIA,2015,350,420,770,55
AMURIA,2016,400,490,890,55
AMURIA,2017,430,520,950,55
AMURIA,2018,440,530,970,55
AMURIA,2019,460,510,970,55
AMURIA,2020,450,500,950,55
AMURIA,2021,470,500,970,55
AMURIA,2022,480,500,980,55
AMURIA,2023,510,540,1050,55
AMURIA,2024,560,580,1140,55
AMURIA,2025,600,640,1240,55
AMURU,2015,290,380,670,55
AMURU,2016,320,430,750,55
AMURU,2017,340,460,800,55
AMURU,2018,360,460,820,55
AMURU,2019,350,450,800,55
AMURU,2020,350,430,780,55
AMURU,2021,360,420,780,55
AMURU,2022,370,420,790,55
AMURU,2023,380,450,830,55
AMURU,2024,410,480,890,55
AMURU,2025,440,520,960,55
APAC,2015,230,300,530,55
APAC,2016,240,310,550,55
APAC,2017,250,320,570,55
APAC,2018,260,330,590,55
APAC,2019,260,340,600,55
APAC,2020,270,350,620,55
APAC,2021,280,370,650,55
APAC,2022,290,380,670,55
APAC,2023,300,390,690,55
APAC,2024,310,400,710,55
APAC,2025,320,410,730,55
ARUA,2015,1130,1620,2750,55
ARUA,2016,1160,1660,2820,55
ARUA,2017,1200,1710,2910,55
ARUA,2018,1230,1760,2990,55
ARUA,2019,1260,1800,3060,55
ARUA,2020,1300,1850,3150,55
ARUA,2021,1330,1890,3220,55
ARUA,2022,1370,1940,3310,55
ARUA,2023,1400,1990,3390,55
ARUA,2024,1440,2030,3470,55
ARUA,2025,1470,2080,3550,55
BUDAKA,2015,390,490,880,55
BUDAKA,2016,430,540,970,55
BUDAKA,2017,450,590,1040,55
BUDAKA,2018,480,590,1070,55
BUDAKA,2019,480,580,1060,55
BUDAKA,2020,480,560,1040,55
BUDAKA,2021,490,560,1050,55
BUDAKA,2022,510,560,1070,55
BUDAKA,2023,550,600,1150,55
BUDAKA,2024,580,650,1230,55
BUDAKA,2025,630,710,1340,55
BUDUDA,2015,390,380,770,55
BUDUDA,2016,440,440,880,55
BUDUDA,2017,480,480,960,55
BUDUDA,2018,490,490,980,55
BUDUDA,2019,500,480,980,55
BUDUDA,2020,510,470,980,55
BUDUDA,2021,530,470,1000,55
BUDUDA,2022,550,480,1030,55
BUDUDA,2023,590,520,1110,55
BUDUDA,2024,640,570,1210,55
BUDUDA,2025,700,640,1340,55
BUGIRI,2015,640,740,1380,55
BUGIRI,2016,720,850,1570,55
BUGIRI,2017,770,910,1680,55
BUGIRI,2018,810,920,1730,55
BUGIRI,2019,820,920,1740,55
BUGIRI,2020,830,890,1720,55
BUGIRI,2021,850,880,1730,55
BUGIRI,2022,890,890,1780,55
BUGIRI,2023,950,950,1900,55
BUGIRI,2024,1030,1050,2080,55
BUGIRI,2025,1110,1150,2260,55
BUGWERI,2015,240,320,560,55
BUGWERI,2016,270,360,630,55
BUGWERI,2017,290,390,680,55
BUGWERI,2018,290,390,680,55
BUGWERI,2019,300,380,680,55
BUGWERI,2020,300,370,670,55
BUGWERI,2021,300,350,650,55
BUGWERI,2022,310,360,670,55
BUGWERI,2023,330,380,710,55
BUGWERI,2024,350,410,760,55
BUGWERI,2025,380,450,830,55
BUHWEJU,2015,220,290,510,55
BUHWEJU,2016,230,300,530,55
BUHWEJU,2017,240,310,550,55
BUHWEJU,2018,250,320,570,55
BUHWEJU,2019,260,330,590,55
BUHWEJU,2020,260,340,600,55
BUHWEJU,2021,270,350,620,55
BUHWEJU,2022,280,360,640,55
BUHWEJU,2023,290,370,660,55
BUHWEJU,2024,300,380,680,55
BUHWEJU,2025,300,390,690,55
BUIKWE,2015,740,880,1620,55
BUIKWE,2016,820,980,1800,55
BUIKWE,2017,860,1040,1900,55
BUIKWE,2018,880,1050,1930,55
BUIKWE,2019,880,1010,1890,55
BUIKWE,2020,860,960,1820,55
BUIKWE,2021,870,940,1810,55
BUIKWE,2022,890,930,1820,55
BUIKWE,2023,930,980,1910,55
BUIKWE,2024,990,1060,2050,55
BUIKWE,2025,1050,1140,2190,55
BUKEDEA,2015,370,540,910,55
BUKEDEA,2016,400,620,1020,55
BUKEDEA,2017,440,670,1110,55
BUKEDEA,2018,450,680,1130,55
BUKEDEA,2019,470,670,1140,55
BUKEDEA,2020,480,650,1130,55
BUKEDEA,2021,480,640,1120,55
BUKEDEA,2022,510,660,1170,55
BUKEDEA,2023,550,700,1250,55
BUKEDEA,2024,590,780,1370,55
BUKEDEA,2025,650,860,1510,55
BUKOMANSIMBI,2015,330,440,770,55
BUKOMANSIMBI,2016,350,490,840,55
BUKOMANSIMBI,2017,380,500,880,55
BUKOMANSIMBI,2018,380,490,870,55
BUKOMANSIMBI,2019,370,470,840,55
BUKOMANSIMBI,2020,360,440,800,55
BUKOMANSIMBI,2021,370,430,800,55
BUKOMANSIMBI,2022,370,420,790,55
BUKOMANSIMBI,2023,380,440,820,55
BUKOMANSIMBI,2024,400,460,860,55
BUKOMANSIMBI,2025,410,490,900,55
BUKWO,2015,120,130,250,55
BUKWO,2016,130,130,260,55
BUKWO,2017,130,140,270,55
BUKWO,2018,140,150,290,55
BUKWO,2019,150,150,300,55
BUKWO,2020,150,160,310,55
BUKWO,2021,160,170,330,55
BUKWO,2022,170,180,350,55
BUKWO,2023,180,180,360,55
BUKWO,2024,190,190,380,55
BUKWO,2025,200,200,400,55
BULAMBULI,2015,290,340,630,55
BULAMBULI,2016,330,390,720,55
BULAMBULI,2017,360,430,790,55
BULAMBULI,2018,370,450,820,55
BULAMBULI,2019,380,440,820,55
BULAMBULI,2020,380,430,810,55
BULAMBULI,2021,400,430,830,55
BULAMBULI,2022,430,440,870,55
BULAMBULI,2023,450,490,940,55
BULAMBULI,2024,500,540,1040,55
BULAMBULI,2025,540,590,1130,55
BULIISA,2015,180,190,370,55
BULIISA,2016,190,200,390,55
BULIISA,2017,200,210,410,55
BULIISA,2018,210,220,430,55
BULIISA,2019,220,230,450,55
BULIISA,2020,230,240,470,55
BULIISA,2021,250,250,500,55
BULIISA,2022,260,260,520,55
BULIISA,2023,270,270,540,55
BULIISA,2024,280,280,560,55
BULIISA,2025,300,290,590,55
BUNDIBUGYO,2015,440,500,940,55
BUNDIBUGYO,2016,490,560,1050,55
BUNDIBUGYO,2017,520,600,1120,55
BUNDIBUGYO,2018,540,610,1150,55
BUNDIBUGYO,2019,540,590,1130,55
BUNDIBUGYO,2020,540,560,1100,55
BUNDIBUGYO,2021,550,560,1110,55
BUNDIBUGYO,2022,560,560,1120,55
BUNDIBUGYO,2023,590,590,1180,55
BUNDIBUGYO,2024,640,640,1280,55
BUNDIBUGYO,2025,690,690,1380,55
BUNYANGABU,2015,320,430,750,55
BUNYANGABU,2016,350,490,840,55
BUNYANGABU,2017,380,520,900,55
BUNYANGABU,2018,390,520,910,55
BUNYANGABU,2019,400,500,900,55
BUNYANGABU,2020,380,480,860,55
BUNYANGABU,2021,390,470,860,55
BUNYANGABU,2022,400,470,870,55
BUNYANGABU,2023,430,500,930,55
BUNYANGABU,2024,460,540,1000,55
BUNYANGABU,2025,480,580,1060,55
BUSHENYI,2015,420,550,970,55
BUSHENYI,2016,430,550,980,55
BUSHENYI,2017,430,560,990,55
BUSHENYI,2018,440,560,1000,55
BUSHENYI,2019,440,570,1010,55
BUSHENYI,2020,450,570,1020,55
BUSHENYI,2021,450,580,1030,55
BUSHENYI,2022,460,580,1040,55
BUSHENYI,2023,460,580,1040,55
BUSHENYI,2024,460,590,1050,55
BUSHENYI,2025,470,590,1060,55
BUSIA,2015,560,720,1280,55
BUSIA,2016,620,810,1430,55
BUSIA,2017,660,870,1530,55
BUSIA,2018,690,870,1560,55
BUSIA,2019,700,860,1560,55
BUSIA,2020,690,830,1520,55
BUSIA,2021,700,810,1510,55
BUSIA,2022,730,820,1550,55
BUSIA,2023,770,860,1630,55
BUSIA,2024,830,940,1770,55
BUSIA,2025,880,1020,1900,55
BUTALEJA,2015,380,520,900,55
BUTALEJA,2016,430,590,1020,55
BUTALEJA,2017,450,630,1080,55
BUTALEJA,2018,470,640,1110,55
BUTALEJA,2019,480,620,1100,55
BUTALEJA,2020,480,600,1080,55
BUTALEJA,2021,490,590,1080,55
BUTALEJA,2022,510,610,1120,55
BUTALEJA,2023,550,640,1190,55
BUTALEJA,2024,590,700,1290,55
BUTALEJA,2025,630,770,1400,55
BUTAMBALA,2015,210,270,480,55
BUTAMBALA,2016,240,300,540,55
BUTAMBALA,2017,250,320,570,55
BUTAMBALA,2018,240,310,550,55
BUTAMBALA,2019,250,300,550,55
BUTAMBALA,2020,240,290,530,55
BUTAMBALA,2021,240,270,510,55
BUTAMBALA,2022,240,270,510,55
BUTAMBALA,2023,260,280,540,55
BUTAMBALA,2024,270,290,560,55
BUTAMBALA,2025,290,320,610,55
BUTEBO,2015,180,190,370,55
BUTEBO,2016,200,200,400,55
BUTEBO,2017,210,220,430,55
BUTEBO,2018,210,220,430,55
BUTEBO,2019,220,210,430,55
BUTEBO,2020,210,190,400,55
BUTEBO,2021,210,190,400,55
BUTEBO,2022,210,190,400,55
BUTEBO,2023,230,200,430,55
BUTEBO,2024,240,210,450,55
BUTEBO,2025,250,220,470,55
BUVUMA,2015,180,100,280,55
BUVUMA,2016,190,110,300,55
BUVUMA,2017,210,120,330,55
BUVUMA,2018,220,130,350,55
BUVUMA,2019,230,130,360,55
BUVUMA,2020,250,140,390,55
BUVUMA,2021,260,150,410,55
BUVUMA,2022,280,160,440,55
BUVUMA,2023,290,170,460,55
BUVUMA,2024,310,180,490,55
BUVUMA,2025,330,190,520,55
BUYENDE,2015,490,550,1040,55
BUYENDE,2016,540,630,1170,55
BUYENDE,2017,590,680,1270,55
BUYENDE,2018,610,700,1310,55
BUYENDE,2019,640,690,1330,55
BUYENDE,2020,640,670,1310,55
BUYENDE,2021,650,660,1310,55
BUYENDE,2022,690,680,1370,55
BUYENDE,2023,740,730,1470,55
BUYENDE,2024,810,810,1620,55
BUYENDE,2025,880,890,1770,55
DOKOLO,2015,340,360,700,55
DOKOLO,2016,350,370,720,55
DOKOLO,2017,360,380,740,55
DOKOLO,2018,370,390,760,55
DOKOLO,2019,380,400,780,55
DOKOLO,2020,390,410,800,55
DOKOLO,2021,400,430,830,55
DOKOLO,2022,410,440,850,55
DOKOLO,2023,420,450,870,55
DOKOLO,2024,430,460,890,55
DOKOLO,2025,440,470,910,55
GOMBA,2015,370,490,860,55
GOMBA,2016,400,540,940,55
GOMBA,2017,430,560,990,55
GOMBA,2018,430,560,990,55
GOMBA,2019,430,540,970,55
GOMBA,2020,430,510,940,55
GOMBA,2021,420,490,910,55
GOMBA,2022,440,490,930,55
GOMBA,2023,450,510,960,55
GOMBA,2024,480,550,1030,55
GOMBA,2025,510,580,1090,55
GULU,2015,420,540,960,55
GULU,2016,430,560,990,55
GULU,2017,440,580,1020,55
GULU,2018,460,590,1050,55
GULU,2019,470,610,1080,55
GULU,2020,480,630,1110,55
GULU,2021,500,640,1140,55
GULU,2022,510,660,1170,55
GULU,2023,520,680,1200,55
GULU,2024,540,690,1230,55
GULU,2025,550,710,1260,55
HOIMA,2015,460,560,1020,55
HOIMA,2016,480,580,1060,55
HOIMA,2017,490,600,1090,55
HOIMA,2018,510,620,1130,55
HOIMA,2019,530,650,1180,55
HOIMA,2020,550,670,1220,55
HOIMA,2021,570,690,1260,55
HOIMA,2022,590,710,1300,55
HOIMA,2023,610,730,1340,55
HOIMA,2024,630,760,1390,55
HOIMA,2025,650,780,1430,55
IBANDA,2015,450,550,1000,55
IBANDA,2016,460,560,1020,55
IBANDA,2017,470,570,1040,55
IBANDA,2018,480,580,1060,55
IBANDA,2019,490,590,1080,55
IBANDA,2020,490,600,1090,55
IBANDA,2021,500,610,1110,55
IBANDA,2022,510,620,1130,55
IBANDA,2023,520,630,1150,55
IBANDA,2024,530,630,1160,55
IBANDA,2025,540,640,1180,55
IGANGA,2015,530,580,1110,55
IGANGA,2016,580,640,1220,55
IGANGA,2017,630,690,1320,55
IGANGA,2018,640,690,1330,55
IGANGA,2019,650,680,1330,55
IGANGA,2020,650,650,1300,55
IGANGA,2021,650,640,1290,55
IGANGA,2022,680,640,1320,55
IGANGA,2023,720,680,1400,55
IGANGA,2024,770,750,1520,55
IGANGA,2025,830,800,1630,55
ISINGIRO,2015,830,1070,1900,55
ISINGIRO,2016,860,1100,1960,55
ISINGIRO,2017,890,1140,2030,55
ISINGIRO,2018,930,1180,2110,55
ISINGIRO,2019,960,1220,2180,55
ISINGIRO,2020,1000,1270,2270,55
ISINGIRO,2021,1030,1310,2340,55
ISINGIRO,2022,1070,1350,2420,55
ISINGIRO,2023,1100,1390,2490,55
ISINGIRO,2024,1140,1440,2580,55
ISINGIRO,2025,1170,1480,2650,55
JINJA,2015,710,890,1600,55
JINJA,2016,720,910,1630,55
JINJA,2017,730,920,1650,55
JINJA,2018,750,940,1690,55
JINJA,2019,760,950,1710,55
JINJA,2020,770,960,1730,55
JINJA,2021,780,980,1760,55
JINJA,2022,790,990,1780,55
JINJA,2023,800,1000,1800,55
JINJA,2024,810,1010,1820,55
JINJA,2025,820,1020,1840,55
KAABONG,2015,120,380,500,55
KAABONG,2016,120,390,510,55
KAABONG,2017,120,400,520,55
KAABONG,2018,130,410,540,55
KAABONG,2019,130,420,550,55
KAABONG,2020,130,430,560,55
KAABONG,2021,140,440,580,55
KAABONG,2022,140,450,590,55
KAABONG,2023,140,460,600,55
KAABONG,2024,140,470,610,55
KAABONG,2025,150,480,630,55
KABALE,2015,490,590,1080,55
KABALE,2016,500,600,1100,55
KABALE,2017,510,610,1120,55
KABALE,2018,510,620,1130,55
KABALE,2019,520,620,1140,55
KABALE,2020,530,630,1160,55
KABALE,2021,540,640,1180,55
KABALE,2022,540,640,1180,55
KABALE,2023,550,650,1200,55
KABALE,2024,560,650,1210,55
KABALE,2025,560,660,1220,55
KABAROLE,2015,510,660,1170,55
KABAROLE,2016,530,680,1210,55
KABAROLE,2017,540,690,1230,55
KABAROLE,2018,550,710,1260,55
KABAROLE,2019,560,720,1280,55
KABAROLE,2020,570,740,1310,55
KABAROLE,2021,580,750,1330,55
KABAROLE,2022,590,760,1350,55
KABAROLE,2023,600,780,1380,55
KABAROLE,2024,610,790,1400,55
KABAROLE,2025,630,810,1440,55
KABERAMAIDO,2015,190,180,370,55
KABERAMAIDO,2016,210,200,410,55
KABERAMAIDO,2017,230,220,450,55
KABERAMAIDO,2018,240,220,460,55
KABERAMAIDO,2019,250,220,470,55
KABERAMAIDO,2020,240,210,450,55
KABERAMAIDO,2021,250,210,460,55
KABERAMAIDO,2022,270,220,490,55
KABERAMAIDO,2023,280,230,510,55
KABERAMAIDO,2024,310,250,560,55
KABERAMAIDO,2025,340,280,620,55
KAGADI,2015,500,660,1160,55
KAGADI,2016,520,690,1210,55
KAGADI,2017,540,710,1250,55
KAGADI,2018,560,740,1300,55
KAGADI,2019,580,760,1340,55
KAGADI,2020,600,790,1390,55
KAGADI,2021,620,820,1440,55
KAGADI,2022,640,840,1480,55
KAGADI,2023,670,870,1540,55
KAGADI,2024,690,900,1590,55
KAGADI,2025,710,920,1630,55
KAKUMIRO,2015,530,540,1070,55
KAKUMIRO,2016,570,580,1150,55
KAKUMIRO,2017,620,630,1250,55
KAKUMIRO,2018,680,690,1370,55
KAKUMIRO,2019,740,740,1480,55
KAKUMIRO,2020,800,810,1610,55
KAKUMIRO,2021,870,870,1740,55
KAKUMIRO,2022,940,940,1880,55
KAKUMIRO,2023,1020,1020,2040,55
KAKUMIRO,2024,1110,1100,2210,55
KAKUMIRO,2025,1200,1190,2390,55
KALAKI,2015,190,200,390,55
KALAKI,2016,200,210,410,55
KALAKI,2017,200,220,420,55
KALAKI,2018,210,220,430,55
KALAKI,2019,220,230,450,55
KALAKI,2020,230,240,470,55
KALAKI,2021,240,250,490,55
KALAKI,2022,250,260,510,55
KALAKI,2023,260,270,530,55
KALAKI,2024,270,280,550,55
KALAKI,2025,280,290,570,55
KALANGALA,2015,90,60,150,55
KALANGALA,2016,90,60,150,55
KALANGALA,2017,90,60,150,55
KALANGALA,2018,100,60,160,55
KALANGALA,2019,100,70,170,55
KALANGALA,2020,110,70,180,55
KALANGALA,2021,110,70,180,55
KALANGALA,2022,110,70,180,55
KALANGALA,2023,120,80,200,55
KALANGALA,2024,120,80,200,55
KALANGALA,2025,120,80,200,55
KALIRO,2015,420,550,970,55
KALIRO,2016,470,620,1090,55
KALIRO,2017,500,670,1170,55
KALIRO,2018,530,670,1200,55
KALIRO,2019,530,660,1190,55
KALIRO,2020,540,630,1170,55
KALIRO,2021,540,620,1160,55
KALIRO,2022,560,640,1200,55
KALIRO,2023,590,680,1270,55
KALIRO,2024,640,750,1390,55
KALIRO,2025,700,810,1510,55
KALUNGU,2015,350,550,900,55
KALUNGU,2016,390,610,1000,55
KALUNGU,2017,400,630,1030,55
KALUNGU,2018,400,630,1030,55
KALUNGU,2019,410,600,1010,55
KALUNGU,2020,400,570,970,55
KALUNGU,2021,390,550,940,55
KALUNGU,2022,400,540,940,55
KALUNGU,2023,420,570,990,55
KALUNGU,2024,430,600,1030,55
KALUNGU,2025,470,640,1110,55
KAMPALA,2015,1810,1900,3710,55
KAMPALA,2016,1840,1940,3780,55
KAMPALA,2017,1880,1980,3860,55
KAMPALA,2018,1920,2020,3940,55
KAMPALA,2019,1950,2050,4000,55
KAMPALA,2020,1990,2090,4080,55
KAMPALA,2021,2020,2130,4150,55
KAMPALA,2022,2060,2160,4220,55
KAMPALA,2023,2090,2200,4290,55
KAMPALA,2024,2120,2230,4350,55
KAMPALA,2025,2150,2260,4410,55
KAMULI,2015,820,1020,1840,55
KAMULI,2016,900,1140,2040,55
KAMULI,2017,960,1220,2180,55
KAMULI,2018,980,1220,2200,55
KAMULI,2019,980,1180,2160,55
KAMULI,2020,980,1130,2110,55
KAMULI,2021,990,1100,2090,55
KAMULI,2022,1030,1110,2140,55
KAMULI,2023,1080,1160,2240,55
KAMULI,2024,1150,1250,2400,55
KAMULI,2025,1230,1360,2590,55
KAMWENGE,2015,440,650,1090,55
KAMWENGE,2016,460,680,1140,55
KAMWENGE,2017,480,700,1180,55
KAMWENGE,2018,500,730,1230,55
KAMWENGE,2019,520,750,1270,55
KAMWENGE,2020,540,780,1320,55
KAMWENGE,2021,560,800,1360,55
KAMWENGE,2022,580,830,1410,55
KAMWENGE,2023,600,860,1460,55
KAMWENGE,2024,630,880,1510,55
KAMWENGE,2025,650,910,1560,55
KANUNGU,2015,470,650,1120,55
KANUNGU,2016,470,660,1130,55
KANUNGU,2017,480,670,1150,55
KANUNGU,2018,490,680,1170,55
KANUNGU,2019,500,690,1190,55
KANUNGU,2020,510,700,1210,55
KANUNGU,2021,520,710,1230,55
KANUNGU,2022,520,720,1240,55
KANUNGU,2023,530,730,1260,55
KANUNGU,2024,540,740,1280,55
KANUNGU,2025,550,750,1300,55
KAPCHORWA,2015,190,190,380,55
KAPCHORWA,2016,190,190,380,55
KAPCHORWA,2017,200,200,400,55
KAPCHORWA,2018,210,200,410,55
KAPCHORWA,2019,210,210,420,55
KAPCHORWA,2020,220,220,440,55
KAPCHORWA,2021,220,220,440,55
KAPCHORWA,2022,230,230,460,55
KAPCHORWA,2023,240,230,470,55
KAPCHORWA,2024,240,240,480,55
KAPCHORWA,2025,250,240,490,55
KAPELEBYONG,2015,140,210,350,55
KAPELEBYONG,2016,150,240,390,55
KAPELEBYONG,2017,170,250,420,55
KAPELEBYONG,2018,170,250,420,55
KAPELEBYONG,2019,170,250,420,55
KAPELEBYONG,2020,170,230,400,55
KAPELEBYONG,2021,170,230,400,55
KAPELEBYONG,2022,180,230,410,55
KAPELEBYONG,2023,190,250,440,55
KAPELEBYONG,2024,210,260,470,55
KAPELEBYONG,2025,220,290,510,55
KASESE,2015,1440,1690,3130,55
KASESE,2016,1570,1880,3450,55
KASESE,2017,1670,1990,3660,55
KASESE,2018,1710,2000,3710,55
KASESE,2019,1720,1940,3660,55
KASESE,2020,1710,1850,3560,55
KASESE,2021,1720,1800,3520,55
KASESE,2022,1760,1820,3580,55
KASESE,2023,1860,1900,3760,55
KASESE,2024,1980,2060,4040,55
KASESE,2025,2110,2220,4330,55
KASSANDA,2015,450,470,920,55
KASSANDA,2016,470,480,950,55
KASSANDA,2017,480,490,970,55
KASSANDA,2018,490,500,990,55
KASSANDA,2019,510,510,1020,55
KASSANDA,2020,520,520,1040,55
KASSANDA,2021,530,530,1060,55
KASSANDA,2022,550,540,1090,55
KASSANDA,2023,560,550,1110,55
KASSANDA,2024,570,560,1130,55
KASSANDA,2025,590,570,1160,55
KATAKWI,2015,300,390,690,55
KATAKWI,2016,330,440,770,55
KATAKWI,2017,360,470,830,55
KATAKWI,2018,360,470,830,55
KATAKWI,2019,360,460,820,55
KATAKWI,2020,360,440,800,55
KATAKWI,2021,370,430,800,55
KATAKWI,2022,380,430,810,55
KATAKWI,2023,400,460,860,55
KATAKWI,2024,430,490,920,55
KATAKWI,2025,470,540,1010,55
KAYUNGA,2015,640,830,1470,55
KAYUNGA,2016,700,910,1610,55
KAYUNGA,2017,740,970,1710,55
KAYUNGA,2018,750,970,1720,55
KAYUNGA,2019,760,930,1690,55
KAYUNGA,2020,750,890,1640,55
KAYUNGA,2021,750,860,1610,55
KAYUNGA,2022,760,860,1620,55
KAYUNGA,2023,790,890,1680,55
KAYUNGA,2024,840,960,1800,55
KAYUNGA,2025,890,1030,1920,55
KAZO,2015,370,410,780,55
KAZO,2016,380,430,810,55
KAZO,2017,400,440,840,55
KAZO,2018,410,460,870,55
KAZO,2019,430,470,900,55
KAZO,2020,440,490,930,55
KAZO,2021,460,510,970,55
KAZO,2022,470,520,990,55
KAZO,2023,490,540,1030,55
KAZO,2024,510,560,1070,55
KAZO,2025,520,570,1090,55
KIBAALE,2015,220,230,450,55
KIBAALE,2016,230,240,470,55
KIBAALE,2017,250,250,500,55
KIBAALE,2018,260,270,530,55
KIBAALE,2019,280,280,560,55
KIBAALE,2020,300,300,600,55
KIBAALE,2021,320,320,640,55
KIBAALE,2022,330,330,660,55
KIBAALE,2023,350,350,700,55
KIBAALE,2024,380,370,750,55
KIBAALE,2025,400,390,790,55
KIBOGA,2015,260,240,500,55
KIBOGA,2016,290,290,580,55
KIBOGA,2017,320,320,640,55
KIBOGA,2018,340,340,680,55
KIBOGA,2019,350,350,700,55
KIBOGA,2020,350,330,680,55
KIBOGA,2021,350,320,670,55
KIBOGA,2022,350,310,660,55
KIBOGA,2023,370,310,680,55
KIBOGA,2024,380,320,700,55
KIBOGA,2025,410,350,760,55
KIBUKU,2015,330,440,770,55
KIBUKU,2016,370,500,870,55
KIBUKU,2017,390,540,930,55
KIBUKU,2018,400,540,940,55
KIBUKU,2019,420,540,960,55
KIBUKU,2020,420,520,940,55
KIBUKU,2021,420,520,940,55
KIBUKU,2022,450,520,970,55
KIBUKU,2023,470,560,1030,55
KIBUKU,2024,510,610,1120,55
KIBUKU,2025,560,670,1230,55
KIKUUBE,2015,470,410,880,55
KIKUUBE,2016,490,430,920,55
KIKUUBE,2017,520,450,970,55
KIKUUBE,2018,550,480,1030,55
KIKUUBE,2019,570,500,1070,55
KIKUUBE,2020,600,530,1130,55
KIKUUBE,2021,630,550,1180,55
KIKUUBE,2022,670,580,1250,55
KIKUUBE,2023,700,610,1310,55
KIKUUBE,2024,730,630,1360,55
KIKUUBE,2025,770,660,1430,55
KIRUHURA,2015,350,310,660,55
KIRUHURA,2016,370,330,700,55
KIRUHURA,2017,380,340,720,55
KIRUHURA,2018,400,350,750,55
KIRUHURA,2019,410,360,770,55
KIRUHURA,2020,430,370,800,55
KIRUHURA,2021,440,390,830,55
KIRUHURA,2022,460,400,860,55
KIRUHURA,2023,470,410,880,55
KIRUHURA,2024,490,420,910,55
KIRUHURA,2025,500,440,940,55
KIRYANDONGO,2015,450,480,930,55
KIRYANDONGO,2016,500,540,1040,55
KIRYANDONGO,2017,530,570,1100,55
KIRYANDONGO,2018,550,580,1130,55
KIRYANDONGO,2019,550,560,1110,55
KIRYANDONGO,2020,550,540,1090,55
KIRYANDONGO,2021,560,530,1090,55
KIRYANDONGO,2022,580,530,1110,55
KIRYANDONGO,2023,620,570,1190,55
KIRYANDONGO,2024,660,610,1270,55
KIRYANDONGO,2025,700,660,1360,55
KISORO,2015,640,1000,1640,55
KISORO,2016,700,1120,1820,55
KISORO,2017,750,1180,1930,55
KISORO,2018,760,1190,1950,55
KISORO,2019,760,1150,1910,55
KISORO,2020,750,1090,1840,55
KISORO,2021,750,1060,1810,55
KISORO,2022,770,1070,1840,55
KISORO,2023,810,1120,1930,55
KISORO,2024,850,1200,2050,55
KISORO,2025,910,1290,2200,55
KITAGWENDA,2015,270,350,620,55
KITAGWENDA,2016,280,360,640,55
KITAGWENDA,2017,290,370,660,55
KITAGWENDA,2018,300,390,690,55
KITAGWENDA,2019,310,400,710,55
KITAGWENDA,2020,330,410,740,55
KITAGWENDA,2021,340,430,770,55
KITAGWENDA,2022,350,440,790,55
KITAGWENDA,2023,370,460,830,55
KITAGWENDA,2024,380,470,850,55
KITAGWENDA,2025,390,490,880,55
KITGUM,2015,350,490,840,55
KITGUM,2016,380,540,920,55
KITGUM,2017,400,570,970,55
KITGUM,2018,400,560,960,55
KITGUM,2019,410,550,960,55
KITGUM,2020,400,520,920,55
KITGUM,2021,400,500,900,55
KITGUM,2022,400,500,900,55
KITGUM,2023,430,530,960,55
KITGUM,2024,450,560,1010,55
KITGUM,2025,480,600,1080,55
KOBOKO,2015,400,540,940,55
KOBOKO,2016,440,610,1050,55
KOBOKO,2017,480,660,1140,55
KOBOKO,2018,490,670,1160,55
KOBOKO,2019,500,660,1160,55
KOBOKO,2020,510,630,1140,55
KOBOKO,2021,520,620,1140,55
KOBOKO,2022,540,640,1180,55
KOBOKO,2023,580,680,1260,55
KOBOKO,2024,630,750,1380,55
KOBOKO,2025,670,830,1500,55
KOLE,2015,360,380,740,55
KOLE,2016,370,390,760,55
KOLE,2017,380,400,780,55
KOLE,2018,390,410,800,55
KOLE,2019,410,420,830,55
KOLE,2020,420,430,850,55
KOLE,2021,430,450,880,55
KOLE,2022,450,460,910,55
KOLE,2023,460,470,930,55
KOLE,2024,470,480,950,55
KOLE,2025,480,490,970,55
KOTIDO,2015,280,370,650,55
KOTIDO,2016,310,420,730,55
KOTIDO,2017,320,450,770,55
KOTIDO,2018,330,450,780,55
KOTIDO,2019,320,430,750,55
KOTIDO,2020,330,410,740,55
KOTIDO,2021,330,400,730,55
KOTIDO,2022,330,400,730,55
KOTIDO,2023,360,430,790,55
KOTIDO,2024,380,450,830,55
KOTIDO,2025,400,490,890,55
KUMI,2015,400,600,1000,55
KUMI,2016,440,680,1120,55
KUMI,2017,470,720,1190,55
KUMI,2018,480,720,1200,55
KUMI,2019,490,710,1200,55
KUMI,2020,490,680,1170,55
KUMI,2021,490,660,1150,55
KUMI,2022,520,670,1190,55
KUMI,2023,550,710,1260,55
KUMI,2024,580,780,1360,55
KUMI,2025,620,850,1470,55
KWANIA,2015,230,280,510,55
KWANIA,2016,230,280,510,55
KWANIA,2017,240,290,530,55
KWANIA,2018,250,300,550,55
KWANIA,2019,250,310,560,55
KWANIA,2020,260,320,580,55
KWANIA,2021,270,330,600,55
KWANIA,2022,280,330,610,55
KWANIA,2023,280,340,620,55
KWANIA,2024,290,350,640,55
KWANIA,2025,300,360,660,55
KWEEN,2015,130,190,320,55
KWEEN,2016,130,200,330,55
KWEEN,2017,130,200,330,55
KWEEN,2018,140,210,350,55
KWEEN,2019,140,210,350,55
KWEEN,2020,150,220,370,55
KWEEN,2021,150,220,370,55
KWEEN,2022,150,230,380,55
KWEEN,2023,160,230,390,55
KWEEN,2024,160,240,400,55
KWEEN,2025,170,240,410,55
KYANKWANZI,2015,370,330,700,55
KYANKWANZI,2016,390,350,740,55
KYANKWANZI,2017,410,370,780,55
KYANKWANZI,2018,430,380,810,55
KYANKWANZI,2019,460,400,860,55
KYANKWANZI,2020,480,420,900,55
KYANKWANZI,2021,500,440,940,55
KYANKWANZI,2022,530,460,990,55
KYANKWANZI,2023,550,480,1030,55
KYANKWANZI,2024,580,500,1080,55
KYANKWANZI,2025,600,520,1120,55
KYEGEGWA,2015,450,460,910,55
KYEGEGWA,2016,490,500,990,55
KYEGEGWA,2017,530,540,1070,55
KYEGEGWA,2018,570,580,1150,55
KYEGEGWA,2019,620,630,1250,55
KYEGEGWA,2020,670,680,1350,55
KYEGEGWA,2021,720,730,1450,55
KYEGEGWA,2022,780,780,1560,55
KYEGEGWA,2023,840,840,1680,55
KYEGEGWA,2024,900,900,1800,55
KYEGEGWA,2025,970,970,1940,55
KYENJOJO,2015,630,720,1350,55
KYENJOJO,2016,650,740,1390,55
KYENJOJO,2017,680,770,1450,55
KYENJOJO,2018,710,800,1510,55
KYENJOJO,2019,740,830,1570,55
KYENJOJO,2020,770,860,1630,55
KYENJOJO,2021,800,890,1690,55
KYENJOJO,2022,830,920,1750,55
KYENJOJO,2023,860,950,1810,55
KYENJOJO,2024,890,980,1870,55
KYENJOJO,2025,920,1010,1930,55
KYOTERA,2015,370,550,920,55
KYOTERA,2016,400,600,1000,55
KYOTERA,2017,420,630,1050,55
KYOTERA,2018,430,630,1060,55
KYOTERA,2019,430,600,1030,55
KYOTERA,2020,420,570,990,55
KYOTERA,2021,420,560,980,55
KYOTERA,2022,430,550,980,55
KYOTERA,2023,450,580,1030,55
KYOTERA,2024,470,620,1090,55
KYOTERA,2025,510,660,1170,55
KARENGA,2015,130,120,250,55
KARENGA,2016,140,120,260,55
KARENGA,2017,140,120,260,55
KARENGA,2018,150,130,280,55
KARENGA,2019,150,130,280,55
KARENGA,2020,150,130,280,55
KARENGA,2021,160,140,300,55
KARENGA,2022,160,140,300,55
KARENGA,2023,160,140,300,55
KARENGA,2024,170,150,320,55
KARENGA,2025,170,150,320,55
LAMWO,2015,240,350,590,55
LAMWO,2016,260,390,650,55
LAMWO,2017,270,410,680,55
LAMWO,2018,270,410,680,55
LAMWO,2019,260,390,650,55
LAMWO,2020,270,380,650,55
LAMWO,2021,260,360,620,55
LAMWO,2022,270,370,640,55
LAMWO,2023,270,380,650,55
LAMWO,2024,280,400,680,55
LAMWO,2025,300,440,740,55
LIRA,2015,570,800,1370,55
LIRA,2016,590,820,1410,55
LIRA,2017,610,850,1460,55
LIRA,2018,620,870,1490,55
LIRA,2019,640,890,1530,55
LIRA,2020,660,920,1580,55
LIRA,2021,680,940,1620,55
LIRA,2022,690,970,1660,55
LIRA,2023,710,990,1700,55
LIRA,2024,730,1020,1750,55
LIRA,2025,740,1040,1780,55
LUUKA,2015,370,510,880,55
LUUKA,2016,390,560,950,55
LUUKA,2017,420,600,1020,55
LUUKA,2018,430,600,1030,55
LUUKA,2019,430,580,1010,55
LUUKA,2020,420,550,970,55
LUUKA,2021,420,540,960,55
LUUKA,2022,440,540,980,55
LUUKA,2023,450,570,1020,55
LUUKA,2024,480,610,1090,55
LUUKA,2025,520,650,1170,55
LUWERO,2015,810,950,1760,55
LUWERO,2016,890,1060,1950,55
LUWERO,2017,940,1130,2070,55
LUWERO,2018,970,1130,2100,55
LUWERO,2019,970,1090,2060,55
LUWERO,2020,970,1050,2020,55
LUWERO,2021,980,1020,2000,55
LUWERO,2022,1000,1030,2030,55
LUWERO,2023,1060,1080,2140,55
LUWERO,2024,1130,1170,2300,55
LUWERO,2025,1210,1260,2470,55
LWENGO,2015,490,740,1230,55
LWENGO,2016,520,820,1340,55
LWENGO,2017,550,870,1420,55
LWENGO,2018,550,850,1400,55
LWENGO,2019,550,820,1370,55
LWENGO,2020,540,780,1320,55
LWENGO,2021,540,740,1280,55
LWENGO,2022,540,740,1280,55
LWENGO,2023,560,760,1320,55
LWENGO,2024,590,810,1400,55
LWENGO,2025,620,870,1490,55
LYANTONDE,2015,170,210,380,55
LYANTONDE,2016,190,240,430,55
LYANTONDE,2017,200,250,450,55
LYANTONDE,2018,210,250,460,55
LYANTONDE,2019,200,250,450,55
LYANTONDE,2020,200,230,430,55
LYANTONDE,2021,210,230,440,55
LYANTONDE,2022,220,230,450,55
LYANTONDE,2023,230,250,480,55
LYANTONDE,2024,250,270,520,55
LYANTONDE,2025,260,290,550,55
MANAFWA,2015,260,290,550,55
MANAFWA,2016,270,290,560,55
MANAFWA,2017,270,300,570,55
MANAFWA,2018,280,310,590,55
MANAFWA,2019,290,310,600,55
MANAFWA,2020,300,320,620,55
MANAFWA,2021,300,330,630,55
MANAFWA,2022,310,330,640,55
MANAFWA,2023,310,340,650,55
MANAFWA,2024,320,350,670,55
MANAFWA,2025,330,350,680,55
MARACHA,2015,370,640,1010,55
MARACHA,2016,380,650,1030,55
MARACHA,2017,380,660,1040,55
MARACHA,2018,390,680,1070,55
MARACHA,2019,400,690,1090,55
MARACHA,2020,410,700,1110,55
MARACHA,2021,420,710,1130,55
MARACHA,2022,420,730,1150,55
MARACHA,2023,430,740,1170,55
MARACHA,2024,440,750,1190,55
MARACHA,2025,450,760,1210,55
MASAKA,2015,450,490,940,55
MASAKA,2016,510,570,1080,55
MASAKA,2017,570,670,1240,55
MASAKA,2018,630,750,1380,55
MASAKA,2019,670,790,1460,55
MASAKA,2020,670,780,1450,55
MASAKA,2021,670,760,1430,55
MASAKA,2022,670,730,1400,55
MASAKA,2023,670,710,1380,55
MASAKA,2024,690,700,1390,55
MASAKA,2025,720,740,1460,55
MASINDI,2015,510,580,1090,55
MASINDI,2016,530,590,1120,55
MASINDI,2017,540,610,1150,55
MASINDI,2018,560,630,1190,55
MASINDI,2019,570,640,1210,55
MASINDI,2020,590,660,1250,55
MASINDI,2021,610,670,1280,55
MASINDI,2022,620,690,1310,55
MASINDI,2023,640,710,1350,55
MASINDI,2024,650,720,1370,55
MASINDI,2025,670,740,1410,55
MAYUGE,2015,730,860,1590,55
MAYUGE,2016,800,970,1770,55
MAYUGE,2017,870,1040,1910,55
MAYUGE,2018,890,1050,1940,55
MAYUGE,2019,900,1030,1930,55
MAYUGE,2020,910,990,1900,55
MAYUGE,2021,920,960,1880,55
MAYUGE,2022,940,980,1920,55
MAYUGE,2023,1010,1040,2050,55
MAYUGE,2024,1080,1130,2210,55
MAYUGE,2025,1150,1230,2380,55
MBALE,2015,870,1010,1880,55
MBALE,2016,960,1150,2110,55
MBALE,2017,1030,1230,2260,55
MBALE,2018,1050,1250,2300,55
MBALE,2019,1070,1220,2290,55
MBALE,2020,1070,1180,2250,55
MBALE,2021,1080,1160,2240,55
MBALE,2022,1120,1180,2300,55
MBALE,2023,1190,1250,2440,55
MBALE,2024,1260,1370,2630,55
MBALE,2025,1360,1500,2860,55
MBARARA,2015,620,670,1290,55
MBARARA,2016,630,680,1310,55
MBARARA,2017,650,700,1350,55
MBARARA,2018,660,710,1370,55
MBARARA,2019,670,730,1400,55
MBARARA,2020,690,740,1430,55
MBARARA,2021,700,750,1450,55
MBARARA,2022,720,770,1490,55
MBARARA,2023,730,780,1510,55
MBARARA,2024,740,800,1540,55
MBARARA,2025,760,810,1570,55
MITOOMA,2015,350,470,820,55
MITOOMA,2016,350,480,830,55
MITOOMA,2017,360,480,840,55
MITOOMA,2018,360,490,850,55
MITOOMA,2019,360,490,850,55
MITOOMA,2020,370,490,860,55
MITOOMA,2021,370,500,870,55
MITOOMA,2022,370,500,870,55
MITOOMA,2023,380,500,880,55
MITOOMA,2024,380,510,890,55
MITOOMA,2025,380,510,890,55
MITYANA,2015,620,850,1470,55
MITYANA,2016,670,950,1620,55
MITYANA,2017,710,1000,1710,55
MITYANA,2018,720,990,1710,55
MITYANA,2019,730,950,1680,55
MITYANA,2020,720,910,1630,55
MITYANA,2021,720,880,1600,55
MITYANA,2022,740,880,1620,55
MITYANA,2023,770,910,1680,55
MITYANA,2024,820,980,1800,55
MITYANA,2025,870,1050,1920,55
MOROTO,2015,190,210,400,55
MOROTO,2016,200,230,430,55
MOROTO,2017,210,250,460,55
MOROTO,2018,220,240,460,55
MOROTO,2019,220,240,460,55
MOROTO,2020,220,220,440,55
MOROTO,2021,220,220,440,55
MOROTO,2022,220,220,440,55
MOROTO,2023,240,240,480,55
MOROTO,2024,250,250,500,55
MOROTO,2025,270,280,550,55
MOYO,2015,200,250,450,55
MOYO,2016,210,260,470,55
MOYO,2017,210,260,470,55
MOYO,2018,220,270,490,55
MOYO,2019,230,280,510,55
MOYO,2020,230,280,510,55
MOYO,2021,240,290,530,55
MOYO,2022,240,290,530,55
MOYO,2023,250,300,550,55
MOYO,2024,250,300,550,55
MOYO,2025,260,310,570,55
MPIGI,2015,480,580,1060,55
MPIGI,2016,520,640,1160,55
MPIGI,2017,550,680,1230,55
MPIGI,2018,560,690,1250,55
MPIGI,2019,560,670,1230,55
MPIGI,2020,560,630,1190,55
MPIGI,2021,570,620,1190,55
MPIGI,2022,590,630,1220,55
MPIGI,2023,620,650,1270,55
MPIGI,2024,660,700,1360,55
MPIGI,2025,700,770,1470,55
MUBENDE,2015,570,500,1070,55
MUBENDE,2016,640,580,1220,55
MUBENDE,2017,740,690,1430,55
MUBENDE,2018,870,830,1700,55
MUBENDE,2019,970,960,1930,55
MUBENDE,2020,1060,1040,2100,55
MUBENDE,2021,1110,1070,2180,55
MUBENDE,2022,1160,1070,2230,55
MUBENDE,2023,1180,1050,2230,55
MUBENDE,2024,1230,1060,2290,55
MUBENDE,2025,1290,1090,2380,55
MUKONO,2015,1050,1230,2280,55
MUKONO,2016,1160,1380,2540,55
MUKONO,2017,1230,1480,2710,55
MUKONO,2018,1260,1500,2760,55
MUKONO,2019,1270,1450,2720,55
MUKONO,2020,1270,1400,2670,55
MUKONO,2021,1290,1370,2660,55
MUKONO,2022,1330,1380,2710,55
MUKONO,2023,1390,1470,2860,55
MUKONO,2024,1490,1600,3090,55
MUKONO,2025,1590,1740,3330,55
MADI OKOLLO,2015,320,380,700,55
MADI OKOLLO,2016,320,390,710,55
MADI OKOLLO,2017,340,400,740,55
MADI OKOLLO,2018,340,410,750,55
MADI OKOLLO,2019,350,420,770,55
MADI OKOLLO,2020,360,430,790,55
MADI OKOLLO,2021,370,440,810,55
MADI OKOLLO,2022,380,460,840,55
MADI OKOLLO,2023,390,470,860,55
MADI OKOLLO,2024,400,480,880,55
MADI OKOLLO,2025,410,490,900,55
NABILATUK,2015,100,170,270,55
NABILATUK,2016,110,190,300,55
NABILATUK,2017,110,210,320,55
NABILATUK,2018,120,220,340,55
NABILATUK,2019,120,220,340,55
NABILATUK,2020,130,200,330,55
NABILATUK,2021,140,200,340,55
NABILATUK,2022,140,210,350,55
NABILATUK,2023,150,230,380,55
NABILATUK,2024,160,250,410,55
NABILATUK,2025,180,280,460,55
NAKAPIRIPIRIT,2015,170,190,360,55
NAKAPIRIPIRIT,2016,190,200,390,55
NAKAPIRIPIRIT,2017,210,220,430,55
NAKAPIRIPIRIT,2018,220,230,450,55
NAKAPIRIPIRIT,2019,220,230,450,55
NAKAPIRIPIRIT,2020,220,220,440,55
NAKAPIRIPIRIT,2021,230,220,450,55
NAKAPIRIPIRIT,2022,240,230,470,55
NAKAPIRIPIRIT,2023,260,250,510,55
NAKAPIRIPIRIT,2024,280,260,540,55
NAKAPIRIPIRIT,2025,310,290,600,55
NAKASEKE,2015,420,370,790,55
NAKASEKE,2016,440,380,820,55
NAKASEKE,2017,450,390,840,55
NAKASEKE,2018,470,400,870,55
NAKASEKE,2019,490,410,900,55
NAKASEKE,2020,500,420,920,55
NAKASEKE,2021,520,430,950,55
NAKASEKE,2022,540,440,980,55
NAKASEKE,2023,560,440,1000,55
NAKASEKE,2024,570,450,1020,55
NAKASEKE,2025,590,460,1050,55
NAKASONGOLA,2015,300,320,620,55
NAKASONGOLA,2016,330,360,690,55
NAKASONGOLA,2017,360,390,750,55
NAKASONGOLA,2018,370,390,760,55
NAKASONGOLA,2019,370,370,740,55
NAKASONGOLA,2020,370,360,730,55
NAKASONGOLA,2021,380,350,730,55
NAKASONGOLA,2022,390,360,750,55
NAKASONGOLA,2023,420,380,800,55
NAKASONGOLA,2024,450,410,860,55
NAKASONGOLA,2025,480,450,930,55
NAMAYINGO,2015,330,380,710,55
NAMAYINGO,2016,370,420,790,55
NAMAYINGO,2017,380,450,830,55
NAMAYINGO,2018,390,440,830,55
NAMAYINGO,2019,380,430,810,55
NAMAYINGO,2020,380,400,780,55
NAMAYINGO,2021,390,390,780,55
NAMAYINGO,2022,390,380,770,55
NAMAYINGO,2023,420,410,830,55
NAMAYINGO,2024,430,430,860,55
NAMAYINGO,2025,470,470,940,55
NAMISINDWA,2015,310,340,650,55
NAMISINDWA,2016,320,340,660,55
NAMISINDWA,2017,330,350,680,55
NAMISINDWA,2018,340,360,700,55
NAMISINDWA,2019,350,370,720,55
NAMISINDWA,2020,350,380,730,55
NAMISINDWA,2021,360,380,740,55
NAMISINDWA,2022,370,390,760,55
NAMISINDWA,2023,380,400,780,55
NAMISINDWA,2024,390,410,800,55
NAMISINDWA,2025,400,420,820,55
NAMUTUMBA,2015,450,530,980,55
NAMUTUMBA,2016,500,590,1090,55
NAMUTUMBA,2017,540,630,1170,55
NAMUTUMBA,2018,550,640,1190,55
NAMUTUMBA,2019,560,620,1180,55
NAMUTUMBA,2020,570,600,1170,55
NAMUTUMBA,2021,570,590,1160,55
NAMUTUMBA,2022,600,610,1210,55
NAMUTUMBA,2023,640,640,1280,55
NAMUTUMBA,2024,680,690,1370,55
NAMUTUMBA,2025,740,760,1500,55
NAPAK,2015,190,330,520,55
NAPAK,2016,200,370,570,55
NAPAK,2017,220,400,620,55
NAPAK,2018,220,390,610,55
NAPAK,2019,220,380,600,55
NAPAK,2020,220,370,590,55
NAPAK,2021,220,350,570,55
NAPAK,2022,220,360,580,55
NAPAK,2023,230,380,610,55
NAPAK,2024,250,400,650,55
NAPAK,2025,260,440,700,55
NEBBI,2015,390,520,910,55
NEBBI,2016,400,540,940,55
NEBBI,2017,410,550,960,55
NEBBI,2018,420,570,990,55
NEBBI,2019,440,580,1020,55
NEBBI,2020,450,600,1050,55
NEBBI,2021,460,610,1070,55
NEBBI,2022,480,630,1110,55
NEBBI,2023,490,650,1140,55
NEBBI,2024,500,660,1160,55
NEBBI,2025,520,680,1200,55
NGORA,2015,290,430,720,55
NGORA,2016,320,490,810,55
NGORA,2017,340,520,860,55
NGORA,2018,360,530,890,55
NGORA,2019,360,510,870,55
NGORA,2020,350,490,840,55
NGORA,2021,360,480,840,55
NGORA,2022,370,480,850,55
NGORA,2023,390,510,900,55
NGORA,2024,420,550,970,55
NGORA,2025,450,600,1050,55
NTOROKO,2015,130,120,250,55
NTOROKO,2016,140,150,290,55
NTOROKO,2017,150,150,300,55
NTOROKO,2018,160,150,310,55
NTOROKO,2019,160,140,300,55
NTOROKO,2020,150,130,280,55
NTOROKO,2021,160,140,300,55
NTOROKO,2022,160,130,290,55
NTOROKO,2023,170,140,310,55
NTOROKO,2024,170,150,320,55
NTOROKO,2025,190,170,360,55
NTUNGAMO,2015,880,1240,2120,55
NTUNGAMO,2016,900,1270,2170,55
NTUNGAMO,2017,920,1290,2210,55
NTUNGAMO,2018,940,1310,2250,55
NTUNGAMO,2019,960,1340,2300,55
NTUNGAMO,2020,970,1360,2330,55
NTUNGAMO,2021,990,1380,2370,55
NTUNGAMO,2022,1010,1400,2410,55
NTUNGAMO,2023,1030,1430,2460,55
NTUNGAMO,2024,1050,1450,2500,55
NTUNGAMO,2025,1060,1470,2530,55
NWOYA,2015,270,330,600,55
NWOYA,2016,300,370,670,55
NWOYA,2017,330,400,730,55
NWOYA,2018,360,450,810,55
NWOYA,2019,400,490,890,55
NWOYA,2020,440,540,980,55
NWOYA,2021,480,590,1070,55
NWOYA,2022,530,650,1180,55
NWOYA,2023,590,720,1310,55
NWOYA,2024,650,790,1440,55
NWOYA,2025,710,860,1570,55
OBONGI,2015,100,90,190,55
OBONGI,2016,110,100,210,55
OBONGI,2017,110,110,220,55
OBONGI,2018,120,100,220,55
OBONGI,2019,120,100,220,55
OBONGI,2020,120,100,220,55
OBONGI,2021,110,100,210,55
OBONGI,2022,130,100,230,55
OBONGI,2023,130,100,230,55
OBONGI,2024,140,110,250,55
OBONGI,2025,140,110,250,55
OMORO,2015,330,410,740,55
OMORO,2016,370,460,830,55
OMORO,2017,390,500,890,55
OMORO,2018,400,510,910,55
OMORO,2019,410,490,900,55
OMORO,2020,420,480,900,55
OMORO,2021,420,480,900,55
OMORO,2022,440,480,920,55
OMORO,2023,460,520,980,55
OMORO,2024,510,560,1070,55
OMORO,2025,540,610,1150,55
OTUKE,2015,200,290,490,55
OTUKE,2016,210,300,510,55
OTUKE,2017,220,320,540,55
OTUKE,2018,230,330,560,55
OTUKE,2019,240,340,580,55
OTUKE,2020,250,360,610,55
OTUKE,2021,260,370,630,55
OTUKE,2022,270,390,660,55
OTUKE,2023,280,400,680,55
OTUKE,2024,300,420,720,55
OTUKE,2025,310,440,750,55
OYAM,2015,580,690,1270,55
OYAM,2016,600,710,1310,55
OYAM,2017,620,730,1350,55
OYAM,2018,640,750,1390,55
OYAM,2019,660,770,1430,55
OYAM,2020,670,800,1470,55
OYAM,2021,690,820,1510,55
OYAM,2022,710,840,1550,55
OYAM,2023,730,860,1590,55
OYAM,2024,750,880,1630,55
OYAM,2025,770,900,1670,55
PADER,2015,310,400,710,55
PADER,2016,330,450,780,55
PADER,2017,360,470,830,55
PADER,2018,370,470,840,55
PADER,2019,360,460,820,55
PADER,2020,360,440,800,55
PADER,2021,360,420,780,55
PADER,2022,360,420,780,55
PADER,2023,380,450,830,55
PADER,2024,400,470,870,55
PADER,2025,430,510,940,55
PAKWACH,2015,250,350,600,55
PAKWACH,2016,260,370,630,55
PAKWACH,2017,270,380,650,55
PAKWACH,2018,280,390,670,55
PAKWACH,2019,290,410,700,55
PAKWACH,2020,310,420,730,55
PAKWACH,2021,320,440,760,55
PAKWACH,2022,330,450,780,55
PAKWACH,2023,340,470,810,55
PAKWACH,2024,360,480,840,55
PAKWACH,2025,370,500,870,55
PALLISA,2015,480,510,990,55
PALLISA,2016,530,580,1110,55
PALLISA,2017,580,620,1200,55
PALLISA,2018,600,640,1240,55
PALLISA,2019,610,630,1240,55
PALLISA,2020,620,610,1230,55
PALLISA,2021,640,610,1250,55
PALLISA,2022,670,630,1300,55
PALLISA,2023,710,670,1380,55
PALLISA,2024,780,750,1530,55
PALLISA,2025,860,810,1670,55
RAKAI,2015,500,630,1130,55
RAKAI,2016,540,700,1240,55
RAKAI,2017,580,740,1320,55
RAKAI,2018,590,750,1340,55
RAKAI,2019,600,720,1320,55
RAKAI,2020,590,690,1280,55
RAKAI,2021,600,670,1270,55
RAKAI,2022,610,670,1280,55
RAKAI,2023,650,710,1360,55
RAKAI,2024,690,770,1460,55
RAKAI,2025,740,830,1570,55
RUBANDA,2015,380,660,1040,55
RUBANDA,2016,380,660,1040,55
RUBANDA,2017,390,670,1060,55
RUBANDA,2018,390,670,1060,55
RUBANDA,2019,400,680,1080,55
RUBANDA,2020,400,680,1080,55
RUBANDA,2021,410,690,1100,55
RUBANDA,2022,410,690,1100,55
RUBANDA,2023,420,690,1110,55
RUBANDA,2024,420,700,1120,55
RUBANDA,2025,420,700,1120,55
RUBIRIZI,2015,210,360,570,55
RUBIRIZI,2016,210,360,570,55
RUBIRIZI,2017,220,370,590,55
RUBIRIZI,2018,220,380,600,55
RUBIRIZI,2019,230,380,610,55
RUBIRIZI,2020,230,390,620,55
RUBIRIZI,2021,230,400,630,55
RUBIRIZI,2022,240,400,640,55
RUBIRIZI,2023,240,410,650,55
RUBIRIZI,2024,250,420,670,55
RUBIRIZI,2025,250,420,670,55
RUKIGA,2015,230,300,530,55
RUKIGA,2016,240,300,540,55
RUKIGA,2017,240,300,540,55
RUKIGA,2018,240,300,540,55
RUKIGA,2019,240,300,540,55
RUKIGA,2020,250,310,560,55
RUKIGA,2021,250,310,560,55
RUKIGA,2022,250,310,560,55
RUKIGA,2023,250,310,560,55
RUKIGA,2024,250,310,560,55
RUKIGA,2025,250,310,560,55
RUKUNGIRI,2015,540,850,1390,55
RUKUNGIRI,2016,540,860,1400,55
RUKUNGIRI,2017,550,870,1420,55
RUKUNGIRI,2018,560,880,1440,55
RUKUNGIRI,2019,560,890,1450,55
RUKUNGIRI,2020,570,890,1460,55
RUKUNGIRI,2021,580,900,1480,55
RUKUNGIRI,2022,580,910,1490,55
RUKUNGIRI,2023,590,910,1500,55
RUKUNGIRI,2024,590,920,1510,55
RUKUNGIRI,2025,590,920,1510,55
RWAMPARA,2015,240,280,520,55
RWAMPARA,2016,250,290,540,55
RWAMPARA,2017,250,290,540,55
RWAMPARA,2018,260,300,560,55
RWAMPARA,2019,260,310,570,55
RWAMPARA,2020,270,310,580,55
RWAMPARA,2021,270,320,590,55
RWAMPARA,2022,280,330,610,55
RWAMPARA,2023,280,330,610,55
RWAMPARA,2024,290,340,630,55
RWAMPARA,2025,300,340,640,55
SERERE,2015,450,700,1150,55
SERERE,2016,510,800,1310,55
SERERE,2017,550,870,1420,55
SERERE,2018,580,870,1450,55
SERERE,2019,580,860,1440,55
SERERE,2020,580,840,1420,55
SERERE,2021,600,830,1430,55
SERERE,2022,620,860,1480,55
SERERE,2023,680,910,1590,55
SERERE,2024,730,1000,1730,55
SERERE,2025,790,1090,1880,55
SHEEMA,2015,380,550,930,55
SHEEMA,2016,390,560,950,55
SHEEMA,2017,390,560,950,55
SHEEMA,2018,400,570,970,55
SHEEMA,2019,400,580,980,55
SHEEMA,2020,400,580,980,55
SHEEMA,2021,410,590,1000,55
SHEEMA,2022,410,590,1000,55
SHEEMA,2023,420,600,1020,55
SHEEMA,2024,420,600,1020,55
SHEEMA,2025,420,600,1020,55
SIRONKO,2015,590,580,1170,55
SIRONKO,2016,610,590,1200,55
SIRONKO,2017,620,610,1230,55
SIRONKO,2018,640,620,1260,55
SIRONKO,2019,650,630,1280,55
SIRONKO,2020,670,640,1310,55
SIRONKO,2021,680,650,1330,55
SIRONKO,2022,700,670,1370,55
SIRONKO,2023,710,680,1390,55
SIRONKO,2024,720,690,1410,55
SIRONKO,2025,740,700,1440,55
SOROTI,2015,540,710,1250,55
SOROTI,2016,600,800,1400,55
SOROTI,2017,650,870,1520,55
SOROTI,2018,670,870,1540,55
SOROTI,2019,680,860,1540,55
SOROTI,2020,690,830,1520,55
SOROTI,2021,700,820,1520,55
SOROTI,2022,730,840,1570,55
SOROTI,2023,770,890,1660,55
SOROTI,2024,830,970,1800,55
SOROTI,2025,910,1060,1970,55
SSEMBABULE,2015,550,640,1190,55
SSEMBABULE,2016,600,710,1310,55
SSEMBABULE,2017,650,760,1410,55
SSEMBABULE,2018,660,770,1430,55
SSEMBABULE,2019,670,750,1420,55
SSEMBABULE,2020,660,720,1380,55
SSEMBABULE,2021,680,700,1380,55
SSEMBABULE,2022,700,710,1410,55
SSEMBABULE,2023,740,740,1480,55
SSEMBABULE,2024,790,810,1600,55
SSEMBABULE,2025,840,880,1720,55
TORORO,2015,930,1090,2020,55
TORORO,2016,950,1120,2070,55
TORORO,2017,980,1140,2120,55
TORORO,2018,1010,1170,2180,55
TORORO,2019,1030,1200,2230,55
TORORO,2020,1060,1230,2290,55
TORORO,2021,1080,1260,2340,55
TORORO,2022,1110,1290,2400,55
TORORO,2023,1130,1310,2440,55
TORORO,2024,1160,1340,2500,55
TORORO,2025,1180,1370,2550,55
WAKISO,2015,2390,2750,5140,55
WAKISO,2016,2550,2940,5490,55
WAKISO,2017,2720,3140,5860,55
WAKISO,2018,2900,3350,6250,55
WAKISO,2019,3100,3570,6670,55
WAKISO,2020,3300,3810,7110,55
WAKISO,2021,3510,4070,7580,55
WAKISO,2022,3740,4330,8070,55
WAKISO,2023,3970,4610,8580,55
WAKISO,2024,4220,4910,9130,55
WAKISO,2025,4480,5220,9700,55
YUMBE,2015,800,1110,1910,55
YUMBE,2016,900,1290,2190,55
YUMBE,2017,980,1410,2390,55
YUMBE,2018,1030,1460,2490,55
YUMBE,2019,1070,1480,2550,55
YUMBE,2020,1080,1460,2540,55
YUMBE,2021,1130,1470,2600,55
YUMBE,2022,1190,1530,2720,55
YUMBE,2023,1280,1670,2950,55
YUMBE,2024,1400,1860,3260,55
YUMBE,2025,1530,2090,3620,55
ZOMBO,2015,390,530,920,55
ZOMBO,2016,400,550,950,55
ZOMBO,2017,420,560,980,55
ZOMBO,2018,430,580,1010,55
ZOMBO,2019,440,590,1030,55
ZOMBO,2020,450,610,1060,55
ZOMBO,2021,470,620,1090,55
ZOMBO,2022,480,640,1120,55
ZOMBO,2023,490,650,1140,55
ZOMBO,2024,510,670,1180,55
ZOMBO,2025,520,680,1200,55
ABIM,2015,140,190,330,56
ABIM,2016,160,240,400,56
ABIM,2017,180,280,460,56
ABIM,2018,200,300,500,56
ABIM,2019,220,320,540,56
ABIM,2020,230,320,550,56
ABIM,2021,240,320,560,56
ABIM,2022,240,320,560,56
ABIM,2023,270,340,610,56
ABIM,2024,290,370,660,56
ABIM,2025,320,400,720,56
ADJUMANI,2015,270,410,680,56
ADJUMANI,2016,280,410,690,56
ADJUMANI,2017,280,420,700,56
ADJUMANI,2018,280,420,700,56
ADJUMANI,2019,280,430,710,56
ADJUMANI,2020,280,430,710,56
ADJUMANI,2021,280,430,710,56
ADJUMANI,2022,290,440,730,56
ADJUMANI,2023,290,440,730,56
ADJUMANI,2024,290,440,730,56
ADJUMANI,2025,290,440,730,56
AGAGO,2015,350,420,770,56
AGAGO,2016,350,420,770,56
AGAGO,2017,360,430,790,56
AGAGO,2018,370,440,810,56
AGAGO,2019,370,450,820,56
AGAGO,2020,380,450,830,56
AGAGO,2021,380,460,840,56
AGAGO,2022,390,470,860,56
AGAGO,2023,390,470,860,56
AGAGO,2024,400,480,880,56
AGAGO,2025,400,490,890,56
ALEBTONG,2015,450,440,890,56
ALEBTONG,2016,520,510,1030,56
ALEBTONG,2017,570,570,1140,56
ALEBTONG,2018,610,620,1230,56
ALEBTONG,2019,620,620,1240,56
ALEBTONG,2020,630,600,1230,56
ALEBTONG,2021,630,570,1200,56
ALEBTONG,2022,630,560,1190,56
ALEBTONG,2023,650,570,1220,56
ALEBTONG,2024,680,600,1280,56
ALEBTONG,2025,740,650,1390,56
AMOLATAR,2015,280,240,520,56
AMOLATAR,2016,310,290,600,56
AMOLATAR,2017,340,320,660,56
AMOLATAR,2018,360,340,700,56
AMOLATAR,2019,380,350,730,56
AMOLATAR,2020,380,330,710,56
AMOLATAR,2021,370,320,690,56
AMOLATAR,2022,370,310,680,56
AMOLATAR,2023,390,310,700,56
AMOLATAR,2024,410,330,740,56
AMOLATAR,2025,440,350,790,56
AMUDAT,2015,90,100,190,56
AMUDAT,2016,110,130,240,56
AMUDAT,2017,110,140,250,56
AMUDAT,2018,120,160,280,56
AMUDAT,2019,130,160,290,56
AMUDAT,2020,130,160,290,56
AMUDAT,2021,130,150,280,56
AMUDAT,2022,130,150,280,56
AMUDAT,2023,140,150,290,56
AMUDAT,2024,150,170,320,56
AMUDAT,2025,170,190,360,56
AMURIA,2015,240,290,530,56
AMURIA,2016,280,340,620,56
AMURIA,2017,310,380,690,56
AMURIA,2018,330,410,740,56
AMURIA,2019,340,410,750,56
AMURIA,2020,350,400,750,56
AMURIA,2021,350,390,740,56
AMURIA,2022,350,380,730,56
AMURIA,2023,380,390,770,56
AMURIA,2024,400,410,810,56
AMURIA,2025,430,460,890,56
AMURU,2015,270,340,610,56
AMURU,2016,300,390,690,56
AMURU,2017,330,430,760,56
AMURU,2018,350,460,810,56
AMURU,2019,360,470,830,56
AMURU,2020,370,450,820,56
AMURU,2021,360,440,800,56
AMURU,2022,360,430,790,56
AMURU,2023,380,430,810,56
AMURU,2024,400,460,860,56
AMURU,2025,420,500,920,56
APAC,2015,310,290,600,56
APAC,2016,320,300,620,56
APAC,2017,340,310,650,56
APAC,2018,350,320,670,56
APAC,2019,360,330,690,56
APAC,2020,370,340,710,56
APAC,2021,390,350,740,56
APAC,2022,400,360,760,56
APAC,2023,410,380,790,56
APAC,2024,430,390,820,56
APAC,2025,440,400,840,56
ARUA,2015,1240,1360,2600,56
ARUA,2016,1270,1390,2660,56
ARUA,2017,1310,1430,2740,56
ARUA,2018,1350,1470,2820,56
ARUA,2019,1380,1510,2890,56
ARUA,2020,1420,1550,2970,56
ARUA,2021,1460,1590,3050,56
ARUA,2022,1500,1630,3130,56
ARUA,2023,1530,1660,3190,56
ARUA,2024,1570,1700,3270,56
ARUA,2025,1610,1740,3350,56
BUDAKA,2015,310,400,710,56
BUDAKA,2016,350,460,810,56
BUDAKA,2017,390,520,910,56
BUDAKA,2018,410,570,980,56
BUDAKA,2019,430,570,1000,56
BUDAKA,2020,440,560,1000,56
BUDAKA,2021,440,540,980,56
BUDAKA,2022,450,540,990,56
BUDAKA,2023,470,540,1010,56
BUDAKA,2024,490,580,1070,56
BUDAKA,2025,540,630,1170,56
BUDUDA,2015,450,420,870,56
BUDUDA,2016,520,500,1020,56
BUDUDA,2017,580,560,1140,56
BUDUDA,2018,630,600,1230,56
BUDUDA,2019,660,620,1280,56
BUDUDA,2020,680,610,1290,56
BUDUDA,2021,680,610,1290,56
BUDUDA,2022,710,600,1310,56
BUDUDA,2023,740,620,1360,56
BUDUDA,2024,790,660,1450,56
BUDUDA,2025,860,730,1590,56
BUGIRI,2015,590,660,1250,56
BUGIRI,2016,680,780,1460,56
BUGIRI,2017,750,890,1640,56
BUGIRI,2018,810,950,1760,56
BUGIRI,2019,850,970,1820,56
BUGIRI,2020,860,960,1820,56
BUGIRI,2021,870,930,1800,56
BUGIRI,2022,890,920,1810,56
BUGIRI,2023,930,940,1870,56
BUGIRI,2024,990,1000,1990,56
BUGIRI,2025,1070,1100,2170,56
BUGWERI,2015,210,240,450,56
BUGWERI,2016,240,290,530,56
BUGWERI,2017,270,320,590,56
BUGWERI,2018,280,340,620,56
BUGWERI,2019,290,350,640,56
BUGWERI,2020,300,330,630,56
BUGWERI,2021,290,320,610,56
BUGWERI,2022,300,320,620,56
BUGWERI,2023,310,310,620,56
BUGWERI,2024,320,330,650,56
BUGWERI,2025,350,350,700,56
BUHWEJU,2015,210,230,440,56
BUHWEJU,2016,210,240,450,56
BUHWEJU,2017,220,250,470,56
BUHWEJU,2018,230,260,490,56
BUHWEJU,2019,240,260,500,56
BUHWEJU,2020,240,270,510,56
BUHWEJU,2021,250,280,530,56
BUHWEJU,2022,260,290,550,56
BUHWEJU,2023,270,290,560,56
BUHWEJU,2024,270,300,570,56
BUHWEJU,2025,280,310,590,56
BUIKWE,2015,680,750,1430,56
BUIKWE,2016,760,880,1640,56
BUIKWE,2017,840,970,1810,56
BUIKWE,2018,880,1040,1920,56
BUIKWE,2019,900,1030,1930,56
BUIKWE,2020,900,1000,1900,56
BUIKWE,2021,900,950,1850,56
BUIKWE,2022,890,930,1820,56
BUIKWE,2023,920,930,1850,56
BUIKWE,2024,960,970,1930,56
BUIKWE,2025,1010,1050,2060,56
BUKEDEA,2015,300,380,680,56
BUKEDEA,2016,340,440,780,56
BUKEDEA,2017,390,510,900,56
BUKEDEA,2018,410,540,950,56
BUKEDEA,2019,430,560,990,56
BUKEDEA,2020,440,550,990,56
BUKEDEA,2021,450,530,980,56
BUKEDEA,2022,460,530,990,56
BUKEDEA,2023,480,540,1020,56
BUKEDEA,2024,510,580,1090,56
BUKEDEA,2025,560,640,1200,56
BUKOMANSIMBI,2015,280,390,670,56
BUKOMANSIMBI,2016,310,440,750,56
BUKOMANSIMBI,2017,330,490,820,56
BUKOMANSIMBI,2018,350,510,860,56
BUKOMANSIMBI,2019,350,500,850,56
BUKOMANSIMBI,2020,350,480,830,56
BUKOMANSIMBI,2021,340,450,790,56
BUKOMANSIMBI,2022,330,430,760,56
BUKOMANSIMBI,2023,340,420,760,56
BUKOMANSIMBI,2024,350,440,790,56
BUKOMANSIMBI,2025,370,460,830,56
BUKWO,2015,140,160,300,56
BUKWO,2016,150,170,320,56
BUKWO,2017,160,170,330,56
BUKWO,2018,160,180,340,56
BUKWO,2019,170,190,360,56
BUKWO,2020,180,200,380,56
BUKWO,2021,190,210,400,56
BUKWO,2022,200,220,420,56
BUKWO,2023,210,230,440,56
BUKWO,2024,220,240,460,56
BUKWO,2025,230,250,480,56
BULAMBULI,2015,370,420,790,56
BULAMBULI,2016,420,510,930,56
BULAMBULI,2017,480,580,1060,56
BULAMBULI,2018,520,630,1150,56
BULAMBULI,2019,540,650,1190,56
BULAMBULI,2020,550,640,1190,56
BULAMBULI,2021,570,630,1200,56
BULAMBULI,2022,580,620,1200,56
BULAMBULI,2023,610,650,1260,56
BULAMBULI,2024,660,700,1360,56
BULAMBULI,2025,720,780,1500,56
BULIISA,2015,200,180,380,56
BULIISA,2016,220,190,410,56
BULIISA,2017,230,190,420,56
BULIISA,2018,240,200,440,56
BULIISA,2019,250,210,460,56
BULIISA,2020,270,220,490,56
BULIISA,2021,280,230,510,56
BULIISA,2022,290,240,530,56
BULIISA,2023,310,250,560,56
BULIISA,2024,320,260,580,56
BULIISA,2025,340,270,610,56
BUNDIBUGYO,2015,300,280,580,56
BUNDIBUGYO,2016,340,320,660,56
BUNDIBUGYO,2017,370,370,740,56
BUNDIBUGYO,2018,400,380,780,56
BUNDIBUGYO,2019,410,390,800,56
BUNDIBUGYO,2020,410,380,790,56
BUNDIBUGYO,2021,410,370,780,56
BUNDIBUGYO,2022,420,350,770,56
BUNDIBUGYO,2023,430,360,790,56
BUNDIBUGYO,2024,460,380,840,56
BUNDIBUGYO,2025,490,410,900,56
BUNYANGABU,2015,280,360,640,56
BUNYANGABU,2016,320,420,740,56
BUNYANGABU,2017,340,460,800,56
BUNYANGABU,2018,360,490,850,56
BUNYANGABU,2019,380,490,870,56
BUNYANGABU,2020,380,480,860,56
BUNYANGABU,2021,380,460,840,56
BUNYANGABU,2022,370,440,810,56
BUNYANGABU,2023,390,440,830,56
BUNYANGABU,2024,410,470,880,56
BUNYANGABU,2025,440,510,950,56
BUSHENYI,2015,440,480,920,56
BUSHENYI,2016,440,480,920,56
BUSHENYI,2017,450,480,930,56
BUSHENYI,2018,450,490,940,56
BUSHENYI,2019,460,490,950,56
BUSHENYI,2020,460,500,960,56
BUSHENYI,2021,470,500,970,56
BUSHENYI,2022,470,500,970,56
BUSHENYI,2023,480,510,990,56
BUSHENYI,2024,480,510,990,56
BUSHENYI,2025,480,510,990,56
BUSIA,2015,520,640,1160,56
BUSIA,2016,580,750,1330,56
BUSIA,2017,650,850,1500,56
BUSIA,2018,690,910,1600,56
BUSIA,2019,720,920,1640,56
BUSIA,2020,730,890,1620,56
BUSIA,2021,730,850,1580,56
BUSIA,2022,740,830,1570,56
BUSIA,2023,760,840,1600,56
BUSIA,2024,810,890,1700,56
BUSIA,2025,860,970,1830,56
BUTALEJA,2015,370,450,820,56
BUTALEJA,2016,410,530,940,56
BUTALEJA,2017,450,610,1060,56
BUTALEJA,2018,490,640,1130,56
BUTALEJA,2019,520,660,1180,56
BUTALEJA,2020,520,650,1170,56
BUTALEJA,2021,530,620,1150,56
BUTALEJA,2022,540,610,1150,56
BUTALEJA,2023,550,630,1180,56
BUTALEJA,2024,590,670,1260,56
BUTALEJA,2025,640,730,1370,56
BUTAMBALA,2015,140,200,340,56
BUTAMBALA,2016,150,230,380,56
BUTAMBALA,2017,170,270,440,56
BUTAMBALA,2018,180,280,460,56
BUTAMBALA,2019,180,270,450,56
BUTAMBALA,2020,170,260,430,56
BUTAMBALA,2021,170,240,410,56
BUTAMBALA,2022,180,230,410,56
BUTAMBALA,2023,180,240,420,56
BUTAMBALA,2024,180,250,430,56
BUTAMBALA,2025,190,260,450,56
BUTEBO,2015,140,180,320,56
BUTEBO,2016,160,210,370,56
BUTEBO,2017,170,230,400,56
BUTEBO,2018,180,250,430,56
BUTEBO,2019,190,250,440,56
BUTEBO,2020,180,230,410,56
BUTEBO,2021,180,220,400,56
BUTEBO,2022,180,220,400,56
BUTEBO,2023,190,220,410,56
BUTEBO,2024,190,220,410,56
BUTEBO,2025,200,240,440,56
BUVUMA,2015,180,80,260,56
BUVUMA,2016,190,90,280,56
BUVUMA,2017,210,90,300,56
BUVUMA,2018,220,100,320,56
BUVUMA,2019,230,110,340,56
BUVUMA,2020,250,110,360,56
BUVUMA,2021,260,120,380,56
BUVUMA,2022,280,130,410,56
BUVUMA,2023,290,140,430,56
BUVUMA,2024,310,140,450,56
BUVUMA,2025,330,150,480,56
BUYENDE,2015,440,460,900,56
BUYENDE,2016,510,540,1050,56
BUYENDE,2017,570,620,1190,56
BUYENDE,2018,610,670,1280,56
BUYENDE,2019,650,690,1340,56
BUYENDE,2020,660,670,1330,56
BUYENDE,2021,660,670,1330,56
BUYENDE,2022,680,660,1340,56
BUYENDE,2023,720,670,1390,56
BUYENDE,2024,760,730,1490,56
BUYENDE,2025,840,790,1630,56
DOKOLO,2015,340,350,690,56
DOKOLO,2016,350,360,710,56
DOKOLO,2017,360,370,730,56
DOKOLO,2018,370,380,750,56
DOKOLO,2019,380,390,770,56
DOKOLO,2020,390,400,790,56
DOKOLO,2021,410,410,820,56
DOKOLO,2022,420,420,840,56
DOKOLO,2023,430,430,860,56
DOKOLO,2024,440,440,880,56
DOKOLO,2025,450,450,900,56
GOMBA,2015,280,300,580,56
GOMBA,2016,320,340,660,56
GOMBA,2017,340,380,720,56
GOMBA,2018,360,390,750,56
GOMBA,2019,380,390,770,56
GOMBA,2020,370,380,750,56
GOMBA,2021,370,360,730,56
GOMBA,2022,360,340,700,56
GOMBA,2023,380,350,730,56
GOMBA,2024,390,360,750,56
GOMBA,2025,410,380,790,56
GULU,2015,460,510,970,56
GULU,2016,470,520,990,56
GULU,2017,490,540,1030,56
GULU,2018,500,550,1050,56
GULU,2019,510,570,1080,56
GULU,2020,530,580,1110,56
GULU,2021,540,600,1140,56
GULU,2022,560,620,1180,56
GULU,2023,570,630,1200,56
GULU,2024,590,650,1240,56
GULU,2025,600,660,1260,56
HOIMA,2015,480,510,990,56
HOIMA,2016,500,530,1030,56
HOIMA,2017,520,540,1060,56
HOIMA,2018,540,560,1100,56
HOIMA,2019,560,580,1140,56
HOIMA,2020,580,600,1180,56
HOIMA,2021,600,620,1220,56
HOIMA,2022,620,640,1260,56
HOIMA,2023,640,660,1300,56
HOIMA,2024,660,680,1340,56
HOIMA,2025,680,700,1380,56
IBANDA,2015,460,570,1030,56
IBANDA,2016,470,580,1050,56
IBANDA,2017,480,590,1070,56
IBANDA,2018,490,600,1090,56
IBANDA,2019,500,620,1120,56
IBANDA,2020,510,630,1140,56
IBANDA,2021,520,640,1160,56
IBANDA,2022,530,650,1180,56
IBANDA,2023,530,650,1180,56
IBANDA,2024,540,660,1200,56
IBANDA,2025,550,670,1220,56
IGANGA,2015,410,510,920,56
IGANGA,2016,480,600,1080,56
IGANGA,2017,520,670,1190,56
IGANGA,2018,560,720,1280,56
IGANGA,2019,580,720,1300,56
IGANGA,2020,590,710,1300,56
IGANGA,2021,580,690,1270,56
IGANGA,2022,590,670,1260,56
IGANGA,2023,610,680,1290,56
IGANGA,2024,650,710,1360,56
IGANGA,2025,690,780,1470,56
ISINGIRO,2015,880,950,1830,56
ISINGIRO,2016,910,990,1900,56
ISINGIRO,2017,950,1020,1970,56
ISINGIRO,2018,980,1060,2040,56
ISINGIRO,2019,1020,1090,2110,56
ISINGIRO,2020,1060,1130,2190,56
ISINGIRO,2021,1090,1170,2260,56
ISINGIRO,2022,1130,1210,2340,56
ISINGIRO,2023,1170,1240,2410,56
ISINGIRO,2024,1210,1280,2490,56
ISINGIRO,2025,1240,1320,2560,56
JINJA,2015,680,740,1420,56
JINJA,2016,700,750,1450,56
JINJA,2017,710,760,1470,56
JINJA,2018,720,770,1490,56
JINJA,2019,730,780,1510,56
JINJA,2020,740,790,1530,56
JINJA,2021,750,800,1550,56
JINJA,2022,760,810,1570,56
JINJA,2023,770,820,1590,56
JINJA,2024,780,830,1610,56
JINJA,2025,790,840,1630,56
KAABONG,2015,90,280,370,56
KAABONG,2016,90,290,380,56
KAABONG,2017,100,300,400,56
KAABONG,2018,100,310,410,56
KAABONG,2019,100,310,410,56
KAABONG,2020,100,320,420,56
KAABONG,2021,110,330,440,56
KAABONG,2022,110,330,440,56
KAABONG,2023,110,340,450,56
KAABONG,2024,110,350,460,56
KAABONG,2025,120,350,470,56
KABALE,2015,410,500,910,56
KABALE,2016,420,510,930,56
KABALE,2017,430,520,950,56
KABALE,2018,430,520,950,56
KABALE,2019,440,530,970,56
KABALE,2020,450,530,980,56
KABALE,2021,450,540,990,56
KABALE,2022,460,540,1000,56
KABALE,2023,460,550,1010,56
KABALE,2024,470,550,1020,56
KABALE,2025,470,560,1030,56
KABAROLE,2015,500,580,1080,56
KABAROLE,2016,510,590,1100,56
KABAROLE,2017,520,600,1120,56
KABAROLE,2018,530,620,1150,56
KABAROLE,2019,540,630,1170,56
KABAROLE,2020,550,640,1190,56
KABAROLE,2021,560,650,1210,56
KABAROLE,2022,570,670,1240,56
KABAROLE,2023,590,680,1270,56
KABAROLE,2024,600,690,1290,56
KABAROLE,2025,610,700,1310,56
KABERAMAIDO,2015,150,150,300,56
KABERAMAIDO,2016,170,170,340,56
KABERAMAIDO,2017,190,200,390,56
KABERAMAIDO,2018,210,210,420,56
KABERAMAIDO,2019,220,220,440,56
KABERAMAIDO,2020,220,220,440,56
KABERAMAIDO,2021,220,210,430,56
KABERAMAIDO,2022,230,210,440,56
KABERAMAIDO,2023,240,220,460,56
KABERAMAIDO,2024,260,220,480,56
KABERAMAIDO,2025,270,250,520,56
KAGADI,2015,510,510,1020,56
KAGADI,2016,520,530,1050,56
KAGADI,2017,540,550,1090,56
KAGADI,2018,560,570,1130,56
KAGADI,2019,580,590,1170,56
KAGADI,2020,600,610,1210,56
KAGADI,2021,630,630,1260,56
KAGADI,2022,650,650,1300,56
KAGADI,2023,670,670,1340,56
KAGADI,2024,690,690,1380,56
KAGADI,2025,710,720,1430,56
KAKUMIRO,2015,490,470,960,56
KAKUMIRO,2016,540,510,1050,56
KAKUMIRO,2017,580,560,1140,56
KAKUMIRO,2018,640,600,1240,56
KAKUMIRO,2019,690,650,1340,56
KAKUMIRO,2020,750,710,1460,56
KAKUMIRO,2021,820,760,1580,56
KAKUMIRO,2022,890,830,1720,56
KAKUMIRO,2023,960,890,1850,56
KAKUMIRO,2024,1040,960,2000,56
KAKUMIRO,2025,1130,1040,2170,56
KALAKI,2015,160,140,300,56
KALAKI,2016,170,150,320,56
KALAKI,2017,170,150,320,56
KALAKI,2018,180,160,340,56
KALAKI,2019,190,170,360,56
KALAKI,2020,200,170,370,56
KALAKI,2021,200,180,380,56
KALAKI,2022,210,190,400,56
KALAKI,2023,220,190,410,56
KALAKI,2024,230,200,430,56
KALAKI,2025,240,210,450,56
KALANGALA,2015,110,50,160,56
KALANGALA,2016,120,50,170,56
KALANGALA,2017,120,50,170,56
KALANGALA,2018,130,50,180,56
KALANGALA,2019,130,50,180,56
KALANGALA,2020,130,60,190,56
KALANGALA,2021,140,60,200,56
KALANGALA,2022,140,60,200,56
KALANGALA,2023,150,60,210,56
KALANGALA,2024,150,60,210,56
KALANGALA,2025,160,70,230,56
KALIRO,2015,390,380,770,56
KALIRO,2016,430,440,870,56
KALIRO,2017,490,510,1000,56
KALIRO,2018,520,540,1060,56
KALIRO,2019,540,540,1080,56
KALIRO,2020,540,540,1080,56
KALIRO,2021,550,520,1070,56
KALIRO,2022,560,510,1070,56
KALIRO,2023,580,520,1100,56
KALIRO,2024,620,560,1180,56
KALIRO,2025,670,600,1270,56
KALUNGU,2015,340,470,810,56
KALUNGU,2016,370,530,900,56
KALUNGU,2017,410,590,1000,56
KALUNGU,2018,420,620,1040,56
KALUNGU,2019,430,620,1050,56
KALUNGU,2020,430,590,1020,56
KALUNGU,2021,410,550,960,56
KALUNGU,2022,420,540,960,56
KALUNGU,2023,420,530,950,56
KALUNGU,2024,430,550,980,56
KALUNGU,2025,470,590,1060,56
KAMPALA,2015,1740,1800,3540,56
KAMPALA,2016,1770,1830,3600,56
KAMPALA,2017,1810,1870,3680,56
KAMPALA,2018,1840,1910,3750,56
KAMPALA,2019,1880,1940,3820,56
KAMPALA,2020,1910,1980,3890,56
KAMPALA,2021,1940,2010,3950,56
KAMPALA,2022,1980,2040,4020,56
KAMPALA,2023,2010,2080,4090,56
KAMPALA,2024,2040,2110,4150,56
KAMPALA,2025,2070,2140,4210,56
KAMULI,2015,620,830,1450,56
KAMULI,2016,700,960,1660,56
KAMULI,2017,770,1080,1850,56
KAMULI,2018,820,1140,1960,56
KAMULI,2019,850,1150,2000,56
KAMULI,2020,840,1110,1950,56
KAMULI,2021,840,1070,1910,56
KAMULI,2022,850,1030,1880,56
KAMULI,2023,880,1040,1920,56
KAMULI,2024,920,1090,2010,56
KAMULI,2025,980,1180,2160,56
KAMWENGE,2015,460,490,950,56
KAMWENGE,2016,480,510,990,56
KAMWENGE,2017,500,520,1020,56
KAMWENGE,2018,520,540,1060,56
KAMWENGE,2019,540,560,1100,56
KAMWENGE,2020,560,580,1140,56
KAMWENGE,2021,590,600,1190,56
KAMWENGE,2022,610,620,1230,56
KAMWENGE,2023,630,640,1270,56
KAMWENGE,2024,650,660,1310,56
KAMWENGE,2025,680,680,1360,56
KANUNGU,2015,470,600,1070,56
KANUNGU,2016,480,610,1090,56
KANUNGU,2017,490,620,1110,56
KANUNGU,2018,500,630,1130,56
KANUNGU,2019,510,640,1150,56
KANUNGU,2020,520,650,1170,56
KANUNGU,2021,520,650,1170,56
KANUNGU,2022,530,660,1190,56
KANUNGU,2023,540,670,1210,56
KANUNGU,2024,550,680,1230,56
KANUNGU,2025,550,690,1240,56
KAPCHORWA,2015,220,210,430,56
KAPCHORWA,2016,230,220,450,56
KAPCHORWA,2017,240,220,460,56
KAPCHORWA,2018,250,230,480,56
KAPCHORWA,2019,250,230,480,56
KAPCHORWA,2020,260,240,500,56
KAPCHORWA,2021,270,250,520,56
KAPCHORWA,2022,270,250,520,56
KAPCHORWA,2023,280,260,540,56
KAPCHORWA,2024,290,270,560,56
KAPCHORWA,2025,300,270,570,56
KAPELEBYONG,2015,140,150,290,56
KAPELEBYONG,2016,160,170,330,56
KAPELEBYONG,2017,180,200,380,56
KAPELEBYONG,2018,200,210,410,56
KAPELEBYONG,2019,200,210,410,56
KAPELEBYONG,2020,210,210,420,56
KAPELEBYONG,2021,200,200,400,56
KAPELEBYONG,2022,210,200,410,56
KAPELEBYONG,2023,210,190,400,56
KAPELEBYONG,2024,230,210,440,56
KAPELEBYONG,2025,240,220,460,56
KASESE,2015,950,1050,2000,56
KASESE,2016,1060,1220,2280,56
KASESE,2017,1170,1350,2520,56
KASESE,2018,1230,1450,2680,56
KASESE,2019,1270,1450,2720,56
KASESE,2020,1280,1400,2680,56
KASESE,2021,1270,1340,2610,56
KASESE,2022,1280,1300,2580,56
KASESE,2023,1310,1310,2620,56
KASESE,2024,1380,1370,2750,56
KASESE,2025,1470,1480,2950,56
KASSANDA,2015,450,450,900,56
KASSANDA,2016,460,460,920,56
KASSANDA,2017,470,470,940,56
KASSANDA,2018,490,480,970,56
KASSANDA,2019,500,490,990,56
KASSANDA,2020,510,500,1010,56
KASSANDA,2021,530,510,1040,56
KASSANDA,2022,540,520,1060,56
KASSANDA,2023,550,530,1080,56
KASSANDA,2024,570,540,1110,56
KASSANDA,2025,580,550,1130,56
KATAKWI,2015,210,240,450,56
KATAKWI,2016,240,290,530,56
KATAKWI,2017,260,330,590,56
KATAKWI,2018,280,340,620,56
KATAKWI,2019,290,350,640,56
KATAKWI,2020,300,340,640,56
KATAKWI,2021,290,320,610,56
KATAKWI,2022,300,320,620,56
KATAKWI,2023,310,320,630,56
KATAKWI,2024,320,330,650,56
KATAKWI,2025,350,370,720,56
KAYUNGA,2015,550,710,1260,56
KAYUNGA,2016,610,820,1430,56
KAYUNGA,2017,670,920,1590,56
KAYUNGA,2018,720,970,1690,56
KAYUNGA,2019,730,970,1700,56
KAYUNGA,2020,730,930,1660,56
KAYUNGA,2021,720,880,1600,56
KAYUNGA,2022,720,850,1570,56
KAYUNGA,2023,730,850,1580,56
KAYUNGA,2024,760,890,1650,56
KAYUNGA,2025,810,960,1770,56
KAZO,2015,380,360,740,56
KAZO,2016,390,370,760,56
KAZO,2017,410,380,790,56
KAZO,2018,420,400,820,56
KAZO,2019,440,410,850,56
KAZO,2020,460,420,880,56
KAZO,2021,470,440,910,56
KAZO,2022,490,450,940,56
KAZO,2023,500,470,970,56
KAZO,2024,520,480,1000,56
KAZO,2025,540,500,1040,56
KIBAALE,2015,220,230,450,56
KIBAALE,2016,230,240,470,56
KIBAALE,2017,250,250,500,56
KIBAALE,2018,260,270,530,56
KIBAALE,2019,280,280,560,56
KIBAALE,2020,300,300,600,56
KIBAALE,2021,310,320,630,56
KIBAALE,2022,330,330,660,56
KIBAALE,2023,350,350,700,56
KIBAALE,2024,370,370,740,56
KIBAALE,2025,400,390,790,56
KIBOGA,2015,220,220,440,56
KIBOGA,2016,250,250,500,56
KIBOGA,2017,280,300,580,56
KIBOGA,2018,310,330,640,56
KIBOGA,2019,320,340,660,56
KIBOGA,2020,340,350,690,56
KIBOGA,2021,350,330,680,56
KIBOGA,2022,340,330,670,56
KIBOGA,2023,350,320,670,56
KIBOGA,2024,350,310,660,56
KIBOGA,2025,380,340,720,56
KIBUKU,2015,300,300,600,56
KIBUKU,2016,340,350,690,56
KIBUKU,2017,370,390,760,56
KIBUKU,2018,410,420,830,56
KIBUKU,2019,420,430,850,56
KIBUKU,2020,430,420,850,56
KIBUKU,2021,440,410,850,56
KIBUKU,2022,440,410,850,56
KIBUKU,2023,470,410,880,56
KIBUKU,2024,490,440,930,56
KIBUKU,2025,530,480,1010,56
KIKUUBE,2015,460,380,840,56
KIKUUBE,2016,490,400,890,56
KIKUUBE,2017,510,420,930,56
KIKUUBE,2018,540,440,980,56
KIKUUBE,2019,570,460,1030,56
KIKUUBE,2020,600,480,1080,56
KIKUUBE,2021,630,510,1140,56
KIKUUBE,2022,660,530,1190,56
KIKUUBE,2023,690,560,1250,56
KIKUUBE,2024,720,580,1300,56
KIKUUBE,2025,760,610,1370,56
KIRUHURA,2015,350,260,610,56
KIRUHURA,2016,360,270,630,56
KIRUHURA,2017,380,280,660,56
KIRUHURA,2018,390,290,680,56
KIRUHURA,2019,410,300,710,56
KIRUHURA,2020,420,310,730,56
KIRUHURA,2021,440,320,760,56
KIRUHURA,2022,450,330,780,56
KIRUHURA,2023,470,340,810,56
KIRUHURA,2024,480,350,830,56
KIRUHURA,2025,500,360,860,56
KIRYANDONGO,2015,410,430,840,56
KIRYANDONGO,2016,470,500,970,56
KIRYANDONGO,2017,510,560,1070,56
KIRYANDONGO,2018,540,590,1130,56
KIRYANDONGO,2019,560,590,1150,56
KIRYANDONGO,2020,560,590,1150,56
KIRYANDONGO,2021,570,560,1130,56
KIRYANDONGO,2022,570,550,1120,56
KIRYANDONGO,2023,600,550,1150,56
KIRYANDONGO,2024,630,580,1210,56
KIRYANDONGO,2025,670,630,1300,56
KISORO,2015,410,610,1020,56
KISORO,2016,460,710,1170,56
KISORO,2017,500,780,1280,56
KISORO,2018,520,840,1360,56
KISORO,2019,530,840,1370,56
KISORO,2020,530,810,1340,56
KISORO,2021,530,770,1300,56
KISORO,2022,530,740,1270,56
KISORO,2023,540,750,1290,56
KISORO,2024,560,790,1350,56
KISORO,2025,600,850,1450,56
KITAGWENDA,2015,280,310,590,56
KITAGWENDA,2016,290,330,620,56
KITAGWENDA,2017,300,340,640,56
KITAGWENDA,2018,310,350,660,56
KITAGWENDA,2019,330,360,690,56
KITAGWENDA,2020,340,370,710,56
KITAGWENDA,2021,350,390,740,56
KITAGWENDA,2022,370,400,770,56
KITAGWENDA,2023,380,410,790,56
KITAGWENDA,2024,390,420,810,56
KITAGWENDA,2025,410,440,850,56
KITGUM,2015,350,470,820,56
KITGUM,2016,380,530,910,56
KITGUM,2017,420,590,1010,56
KITGUM,2018,450,630,1080,56
KITGUM,2019,450,620,1070,56
KITGUM,2020,450,600,1050,56
KITGUM,2021,440,570,1010,56
KITGUM,2022,440,550,990,56
KITGUM,2023,440,550,990,56
KITGUM,2024,470,580,1050,56
KITGUM,2025,490,610,1100,56
KOBOKO,2015,330,370,700,56
KOBOKO,2016,370,430,800,56
KOBOKO,2017,420,480,900,56
KOBOKO,2018,450,530,980,56
KOBOKO,2019,470,530,1000,56
KOBOKO,2020,470,530,1000,56
KOBOKO,2021,480,510,990,56
KOBOKO,2022,500,500,1000,56
KOBOKO,2023,510,520,1030,56
KOBOKO,2024,550,550,1100,56
KOBOKO,2025,600,600,1200,56
KOLE,2015,400,320,720,56
KOLE,2016,410,330,740,56
KOLE,2017,430,340,770,56
KOLE,2018,440,350,790,56
KOLE,2019,450,360,810,56
KOLE,2020,470,370,840,56
KOLE,2021,480,380,860,56
KOLE,2022,500,390,890,56
KOLE,2023,510,400,910,56
KOLE,2024,530,410,940,56
KOLE,2025,540,420,960,56
KOTIDO,2015,220,360,580,56
KOTIDO,2016,240,420,660,56
KOTIDO,2017,270,470,740,56
KOTIDO,2018,290,490,780,56
KOTIDO,2019,290,490,780,56
KOTIDO,2020,300,480,780,56
KOTIDO,2021,290,460,750,56
KOTIDO,2022,300,440,740,56
KOTIDO,2023,310,440,750,56
KOTIDO,2024,320,470,790,56
KOTIDO,2025,350,510,860,56
KUMI,2015,330,450,780,56
KUMI,2016,370,520,890,56
KUMI,2017,410,580,990,56
KUMI,2018,430,630,1060,56
KUMI,2019,450,630,1080,56
KUMI,2020,450,610,1060,56
KUMI,2021,460,600,1060,56
KUMI,2022,460,580,1040,56
KUMI,2023,480,580,1060,56
KUMI,2024,500,620,1120,56
KUMI,2025,550,670,1220,56
KWANIA,2015,310,290,600,56
KWANIA,2016,320,300,620,56
KWANIA,2017,330,300,630,56
KWANIA,2018,340,310,650,56
KWANIA,2019,350,320,670,56
KWANIA,2020,360,330,690,56
KWANIA,2021,370,340,710,56
KWANIA,2022,380,350,730,56
KWANIA,2023,390,360,750,56
KWANIA,2024,400,370,770,56
KWANIA,2025,410,370,780,56
KWEEN,2015,170,180,350,56
KWEEN,2016,170,180,350,56
KWEEN,2017,180,190,370,56
KWEEN,2018,190,190,380,56
KWEEN,2019,190,190,380,56
KWEEN,2020,200,200,400,56
KWEEN,2021,200,200,400,56
KWEEN,2022,210,210,420,56
KWEEN,2023,210,210,420,56
KWEEN,2024,220,220,440,56
KWEEN,2025,220,220,440,56
KYANKWANZI,2015,370,290,660,56
KYANKWANZI,2016,390,300,690,56
KYANKWANZI,2017,410,320,730,56
KYANKWANZI,2018,430,330,760,56
KYANKWANZI,2019,460,350,810,56
KYANKWANZI,2020,480,360,840,56
KYANKWANZI,2021,500,380,880,56
KYANKWANZI,2022,530,390,920,56
KYANKWANZI,2023,550,410,960,56
KYANKWANZI,2024,580,430,1010,56
KYANKWANZI,2025,600,450,1050,56
KYEGEGWA,2015,450,420,870,56
KYEGEGWA,2016,490,450,940,56
KYEGEGWA,2017,530,490,1020,56
KYEGEGWA,2018,570,520,1090,56
KYEGEGWA,2019,610,560,1170,56
KYEGEGWA,2020,660,610,1270,56
KYEGEGWA,2021,720,660,1380,56
KYEGEGWA,2022,770,700,1470,56
KYEGEGWA,2023,830,760,1590,56
KYEGEGWA,2024,900,820,1720,56
KYEGEGWA,2025,970,880,1850,56
KYENJOJO,2015,620,620,1240,56
KYENJOJO,2016,650,640,1290,56
KYENJOJO,2017,680,670,1350,56
KYENJOJO,2018,700,690,1390,56
KYENJOJO,2019,730,710,1440,56
KYENJOJO,2020,760,740,1500,56
KYENJOJO,2021,790,770,1560,56
KYENJOJO,2022,820,790,1610,56
KYENJOJO,2023,850,820,1670,56
KYENJOJO,2024,880,850,1730,56
KYENJOJO,2025,910,870,1780,56
KYOTERA,2015,370,490,860,56
KYOTERA,2016,410,570,980,56
KYOTERA,2017,440,630,1070,56
KYOTERA,2018,470,660,1130,56
KYOTERA,2019,480,660,1140,56
KYOTERA,2020,470,640,1110,56
KYOTERA,2021,470,600,1070,56
KYOTERA,2022,460,580,1040,56
KYOTERA,2023,480,570,1050,56
KYOTERA,2024,500,600,1100,56
KYOTERA,2025,530,640,1170,56
KARENGA,2015,110,90,200,56
KARENGA,2016,110,100,210,56
KARENGA,2017,120,100,220,56
KARENGA,2018,120,100,220,56
KARENGA,2019,120,100,220,56
KARENGA,2020,130,110,240,56
KARENGA,2021,130,110,240,56
KARENGA,2022,130,110,240,56
KARENGA,2023,140,110,250,56
KARENGA,2024,140,110,250,56
KARENGA,2025,140,120,260,56
LAMWO,2015,230,320,550,56
LAMWO,2016,250,360,610,56
LAMWO,2017,280,390,670,56
LAMWO,2018,290,420,710,56
LAMWO,2019,290,410,700,56
LAMWO,2020,290,400,690,56
LAMWO,2021,290,380,670,56
LAMWO,2022,290,360,650,56
LAMWO,2023,290,370,660,56
LAMWO,2024,300,380,680,56
LAMWO,2025,310,410,720,56
LIRA,2015,630,720,1350,56
LIRA,2016,650,740,1390,56
LIRA,2017,670,760,1430,56
LIRA,2018,690,790,1480,56
LIRA,2019,710,810,1520,56
LIRA,2020,730,830,1560,56
LIRA,2021,750,850,1600,56
LIRA,2022,770,870,1640,56
LIRA,2023,780,900,1680,56
LIRA,2024,800,920,1720,56
LIRA,2025,820,940,1760,56
LUUKA,2015,310,380,690,56
LUUKA,2016,340,440,780,56
LUUKA,2017,370,480,850,56
LUUKA,2018,400,510,910,56
LUUKA,2019,410,520,930,56
LUUKA,2020,400,500,900,56
LUUKA,2021,400,470,870,56
LUUKA,2022,410,460,870,56
LUUKA,2023,410,470,880,56
LUUKA,2024,430,480,910,56
LUUKA,2025,450,520,970,56
LUWERO,2015,680,860,1540,56
LUWERO,2016,770,1000,1770,56
LUWERO,2017,850,1110,1960,56
LUWERO,2018,900,1180,2080,56
LUWERO,2019,930,1190,2120,56
LUWERO,2020,930,1150,2080,56
LUWERO,2021,930,1100,2030,56
LUWERO,2022,940,1060,2000,56
LUWERO,2023,960,1070,2030,56
LUWERO,2024,1000,1130,2130,56
LUWERO,2025,1070,1220,2290,56
LWENGO,2015,390,650,1040,56
LWENGO,2016,430,740,1170,56
LWENGO,2017,460,820,1280,56
LWENGO,2018,490,870,1360,56
LWENGO,2019,490,850,1340,56
LWENGO,2020,490,820,1310,56
LWENGO,2021,480,770,1250,56
LWENGO,2022,470,740,1210,56
LWENGO,2023,490,740,1230,56
LWENGO,2024,500,760,1260,56
LWENGO,2025,530,810,1340,56
LYANTONDE,2015,160,160,320,56
LYANTONDE,2016,190,190,380,56
LYANTONDE,2017,200,220,420,56
LYANTONDE,2018,220,220,440,56
LYANTONDE,2019,220,230,450,56
LYANTONDE,2020,230,220,450,56
LYANTONDE,2021,220,220,440,56
LYANTONDE,2022,230,210,440,56
LYANTONDE,2023,230,220,450,56
LYANTONDE,2024,250,220,470,56
LYANTONDE,2025,270,250,520,56
MANAFWA,2015,390,410,800,56
MANAFWA,2016,400,420,820,56
MANAFWA,2017,410,430,840,56
MANAFWA,2018,420,440,860,56
MANAFWA,2019,430,450,880,56
MANAFWA,2020,440,460,900,56
MANAFWA,2021,450,470,920,56
MANAFWA,2022,460,480,940,56
MANAFWA,2023,470,480,950,56
MANAFWA,2024,480,490,970,56
MANAFWA,2025,490,500,990,56
MARACHA,2015,350,480,830,56
MARACHA,2016,360,490,850,56
MARACHA,2017,360,500,860,56
MARACHA,2018,370,510,880,56
MARACHA,2019,380,520,900,56
MARACHA,2020,380,530,910,56
MARACHA,2021,390,540,930,56
MARACHA,2022,400,550,950,56
MARACHA,2023,410,560,970,56
MARACHA,2024,410,560,970,56
MARACHA,2025,420,570,990,56
MASAKA,2015,410,440,850,56
MASAKA,2016,450,490,940,56
MASAKA,2017,500,570,1070,56
MASAKA,2018,570,660,1230,56
MASAKA,2019,620,740,1360,56
MASAKA,2020,660,780,1440,56
MASAKA,2021,670,780,1450,56
MASAKA,2022,670,760,1430,56
MASAKA,2023,670,720,1390,56
MASAKA,2024,670,700,1370,56
MASAKA,2025,690,700,1390,56
MASINDI,2015,480,480,960,56
MASINDI,2016,500,500,1000,56
MASINDI,2017,510,510,1020,56
MASINDI,2018,530,520,1050,56
MASINDI,2019,540,540,1080,56
MASINDI,2020,550,550,1100,56
MASINDI,2021,570,560,1130,56
MASINDI,2022,580,580,1160,56
MASINDI,2023,600,590,1190,56
MASINDI,2024,610,600,1210,56
MASINDI,2025,630,620,1250,56
MAYUGE,2015,700,710,1410,56
MAYUGE,2016,790,830,1620,56
MAYUGE,2017,880,940,1820,56
MAYUGE,2018,940,1010,1950,56
MAYUGE,2019,970,1020,1990,56
MAYUGE,2020,980,990,1970,56
MAYUGE,2021,990,960,1950,56
MAYUGE,2022,1000,940,1940,56
MAYUGE,2023,1030,950,1980,56
MAYUGE,2024,1100,1020,2120,56
MAYUGE,2025,1170,1100,2270,56
MBALE,2015,970,1060,2030,56
MBALE,2016,1100,1240,2340,56
MBALE,2017,1220,1400,2620,56
MBALE,2018,1300,1500,2800,56
MBALE,2019,1340,1530,2870,56
MBALE,2020,1360,1490,2850,56
MBALE,2021,1360,1450,2810,56
MBALE,2022,1380,1410,2790,56
MBALE,2023,1420,1440,2860,56
MBALE,2024,1510,1530,3040,56
MBALE,2025,1610,1660,3270,56
MBARARA,2015,560,630,1190,56
MBARARA,2016,570,640,1210,56
MBARARA,2017,580,660,1240,56
MBARARA,2018,600,670,1270,56
MBARARA,2019,610,690,1300,56
MBARARA,2020,620,700,1320,56
MBARARA,2021,640,710,1350,56
MBARARA,2022,650,730,1380,56
MBARARA,2023,660,740,1400,56
MBARARA,2024,670,750,1420,56
MBARARA,2025,690,770,1460,56
MITOOMA,2015,320,440,760,56
MITOOMA,2016,320,450,770,56
MITOOMA,2017,320,450,770,56
MITOOMA,2018,330,460,790,56
MITOOMA,2019,330,460,790,56
MITOOMA,2020,340,460,800,56
MITOOMA,2021,340,470,810,56
MITOOMA,2022,340,470,810,56
MITOOMA,2023,340,470,810,56
MITOOMA,2024,350,480,830,56
MITOOMA,2025,350,480,830,56
MITYANA,2015,550,730,1280,56
MITYANA,2016,610,850,1460,56
MITYANA,2017,670,940,1610,56
MITYANA,2018,700,990,1690,56
MITYANA,2019,720,980,1700,56
MITYANA,2020,710,940,1650,56
MITYANA,2021,710,900,1610,56
MITYANA,2022,710,870,1580,56
MITYANA,2023,720,870,1590,56
MITYANA,2024,750,900,1650,56
MITYANA,2025,800,970,1770,56
MOROTO,2015,90,150,240,56
MOROTO,2016,100,170,270,56
MOROTO,2017,110,200,310,56
MOROTO,2018,120,210,330,56
MOROTO,2019,120,220,340,56
MOROTO,2020,120,210,330,56
MOROTO,2021,110,200,310,56
MOROTO,2022,120,200,320,56
MOROTO,2023,120,190,310,56
MOROTO,2024,130,200,330,56
MOROTO,2025,130,220,350,56
MOYO,2015,190,270,460,56
MOYO,2016,200,270,470,56
MOYO,2017,200,280,480,56
MOYO,2018,210,290,500,56
MOYO,2019,210,290,500,56
MOYO,2020,220,300,520,56
MOYO,2021,220,300,520,56
MOYO,2022,230,310,540,56
MOYO,2023,230,320,550,56
MOYO,2024,240,320,560,56
MOYO,2025,240,330,570,56
MPIGI,2015,410,530,940,56
MPIGI,2016,460,610,1070,56
MPIGI,2017,500,680,1180,56
MPIGI,2018,530,720,1250,56
MPIGI,2019,540,740,1280,56
MPIGI,2020,540,710,1250,56
MPIGI,2021,540,680,1220,56
MPIGI,2022,540,660,1200,56
MPIGI,2023,550,660,1210,56
MPIGI,2024,580,690,1270,56
MPIGI,2025,620,760,1380,56
MUBENDE,2015,490,470,960,56
MUBENDE,2016,520,500,1020,56
MUBENDE,2017,580,580,1160,56
MUBENDE,2018,680,690,1370,56
MUBENDE,2019,790,810,1600,56
MUBENDE,2020,880,940,1820,56
MUBENDE,2021,970,1020,1990,56
MUBENDE,2022,1020,1060,2080,56
MUBENDE,2023,1050,1060,2110,56
MUBENDE,2024,1070,1040,2110,56
MUBENDE,2025,1120,1030,2150,56
MUKONO,2015,900,1120,2020,56
MUKONO,2016,1010,1310,2320,56
MUKONO,2017,1110,1480,2590,56
MUKONO,2018,1190,1580,2770,56
MUKONO,2019,1220,1600,2820,56
MUKONO,2020,1220,1560,2780,56
MUKONO,2021,1220,1490,2710,56
MUKONO,2022,1230,1470,2700,56
MUKONO,2023,1270,1480,2750,56
MUKONO,2024,1340,1570,2910,56
MUKONO,2025,1430,1700,3130,56
MADI OKOLLO,2015,310,330,640,56
MADI OKOLLO,2016,320,340,660,56
MADI OKOLLO,2017,330,350,680,56
MADI OKOLLO,2018,340,360,700,56
MADI OKOLLO,2019,350,370,720,56
MADI OKOLLO,2020,360,380,740,56
MADI OKOLLO,2021,370,390,760,56
MADI OKOLLO,2022,380,400,780,56
MADI OKOLLO,2023,390,410,800,56
MADI OKOLLO,2024,400,420,820,56
MADI OKOLLO,2025,410,430,840,56
NABILATUK,2015,50,110,160,56
NABILATUK,2016,60,140,200,56
NABILATUK,2017,70,160,230,56
NABILATUK,2018,70,170,240,56
NABILATUK,2019,80,180,260,56
NABILATUK,2020,80,170,250,56
NABILATUK,2021,80,170,250,56
NABILATUK,2022,90,180,270,56
NABILATUK,2023,90,170,260,56
NABILATUK,2024,90,190,280,56
NABILATUK,2025,110,210,320,56
NAKAPIRIPIRIT,2015,100,130,230,56
NAKAPIRIPIRIT,2016,120,160,280,56
NAKAPIRIPIRIT,2017,120,180,300,56
NAKAPIRIPIRIT,2018,140,200,340,56
NAKAPIRIPIRIT,2019,140,210,350,56
NAKAPIRIPIRIT,2020,150,200,350,56
NAKAPIRIPIRIT,2021,160,200,360,56
NAKAPIRIPIRIT,2022,150,200,350,56
NAKAPIRIPIRIT,2023,170,190,360,56
NAKAPIRIPIRIT,2024,170,210,380,56
NAKAPIRIPIRIT,2025,190,240,430,56
NAKASEKE,2015,300,350,650,56
NAKASEKE,2016,310,350,660,56
NAKASEKE,2017,320,360,680,56
NAKASEKE,2018,330,370,700,56
NAKASEKE,2019,350,380,730,56
NAKASEKE,2020,360,390,750,56
NAKASEKE,2021,370,400,770,56
NAKASEKE,2022,380,410,790,56
NAKASEKE,2023,390,410,800,56
NAKASEKE,2024,410,420,830,56
NAKASEKE,2025,420,430,850,56
NAKASONGOLA,2015,250,310,560,56
NAKASONGOLA,2016,290,360,650,56
NAKASONGOLA,2017,320,400,720,56
NAKASONGOLA,2018,340,430,770,56
NAKASONGOLA,2019,350,440,790,56
NAKASONGOLA,2020,360,430,790,56
NAKASONGOLA,2021,360,410,770,56
NAKASONGOLA,2022,360,390,750,56
NAKASONGOLA,2023,380,400,780,56
NAKASONGOLA,2024,400,420,820,56
NAKASONGOLA,2025,430,460,890,56
NAMAYINGO,2015,350,340,690,56
NAMAYINGO,2016,390,380,770,56
NAMAYINGO,2017,430,430,860,56
NAMAYINGO,2018,450,450,900,56
NAMAYINGO,2019,460,450,910,56
NAMAYINGO,2020,460,430,890,56
NAMAYINGO,2021,460,410,870,56
NAMAYINGO,2022,450,390,840,56
NAMAYINGO,2023,470,400,870,56
NAMAYINGO,2024,490,410,900,56
NAMAYINGO,2025,510,440,950,56
NAMISINDWA,2015,420,480,900,56
NAMISINDWA,2016,430,490,920,56
NAMISINDWA,2017,440,500,940,56
NAMISINDWA,2018,460,510,970,56
NAMISINDWA,2019,470,530,1000,56
NAMISINDWA,2020,480,540,1020,56
NAMISINDWA,2021,490,550,1040,56
NAMISINDWA,2022,510,560,1070,56
NAMISINDWA,2023,520,570,1090,56
NAMISINDWA,2024,530,580,1110,56
NAMISINDWA,2025,540,600,1140,56
NAMUTUMBA,2015,350,430,780,56
NAMUTUMBA,2016,390,500,890,56
NAMUTUMBA,2017,440,560,1000,56
NAMUTUMBA,2018,470,600,1070,56
NAMUTUMBA,2019,490,610,1100,56
NAMUTUMBA,2020,490,600,1090,56
NAMUTUMBA,2021,500,570,1070,56
NAMUTUMBA,2022,510,570,1080,56
NAMUTUMBA,2023,530,570,1100,56
NAMUTUMBA,2024,560,610,1170,56
NAMUTUMBA,2025,610,660,1270,56
NAPAK,2015,130,210,340,56
NAPAK,2016,140,240,380,56
NAPAK,2017,150,280,430,56
NAPAK,2018,160,290,450,56
NAPAK,2019,160,300,460,56
NAPAK,2020,160,280,440,56
NAPAK,2021,160,280,440,56
NAPAK,2022,150,260,410,56
NAPAK,2023,170,270,440,56
NAPAK,2024,170,280,450,56
NAPAK,2025,180,300,480,56
NEBBI,2015,430,480,910,56
NEBBI,2016,450,490,940,56
NEBBI,2017,460,510,970,56
NEBBI,2018,480,520,1000,56
NEBBI,2019,490,530,1020,56
NEBBI,2020,510,550,1060,56
NEBBI,2021,520,560,1080,56
NEBBI,2022,540,580,1120,56
NEBBI,2023,550,590,1140,56
NEBBI,2024,570,610,1180,56
NEBBI,2025,580,620,1200,56
NGORA,2015,210,270,480,56
NGORA,2016,240,310,550,56
NGORA,2017,270,340,610,56
NGORA,2018,280,370,650,56
NGORA,2019,290,370,660,56
NGORA,2020,300,370,670,56
NGORA,2021,300,340,640,56
NGORA,2022,300,340,640,56
NGORA,2023,310,350,660,56
NGORA,2024,330,360,690,56
NGORA,2025,350,390,740,56
NTOROKO,2015,130,100,230,56
NTOROKO,2016,140,120,260,56
NTOROKO,2017,150,130,280,56
NTOROKO,2018,160,140,300,56
NTOROKO,2019,160,140,300,56
NTOROKO,2020,160,130,290,56
NTOROKO,2021,170,130,300,56
NTOROKO,2022,170,120,290,56
NTOROKO,2023,170,120,290,56
NTOROKO,2024,180,130,310,56
NTOROKO,2025,190,140,330,56
NTUNGAMO,2015,910,1010,1920,56
NTUNGAMO,2016,930,1030,1960,56
NTUNGAMO,2017,950,1050,2000,56
NTUNGAMO,2018,970,1070,2040,56
NTUNGAMO,2019,990,1090,2080,56
NTUNGAMO,2020,1010,1100,2110,56
NTUNGAMO,2021,1030,1120,2150,56
NTUNGAMO,2022,1050,1140,2190,56
NTUNGAMO,2023,1070,1160,2230,56
NTUNGAMO,2024,1090,1180,2270,56
NTUNGAMO,2025,1100,1190,2290,56
NWOYA,2015,250,270,520,56
NWOYA,2016,270,300,570,56
NWOYA,2017,300,330,630,56
NWOYA,2018,330,360,690,56
NWOYA,2019,370,400,770,56
NWOYA,2020,410,440,850,56
NWOYA,2021,450,480,930,56
NWOYA,2022,500,530,1030,56
NWOYA,2023,540,580,1120,56
NWOYA,2024,600,640,1240,56
NWOYA,2025,660,700,1360,56
OBONGI,2015,80,70,150,56
OBONGI,2016,100,80,180,56
OBONGI,2017,100,100,200,56
OBONGI,2018,110,110,220,56
OBONGI,2019,110,100,210,56
OBONGI,2020,100,100,200,56
OBONGI,2021,110,90,200,56
OBONGI,2022,110,90,200,56
OBONGI,2023,110,100,210,56
OBONGI,2024,110,100,210,56
OBONGI,2025,130,110,240,56
OMORO,2015,280,370,650,56
OMORO,2016,320,440,760,56
OMORO,2017,350,490,840,56
OMORO,2018,380,530,910,56
OMORO,2019,390,530,920,56
OMORO,2020,390,530,920,56
OMORO,2021,390,510,900,56
OMORO,2022,400,500,900,56
OMORO,2023,420,510,930,56
OMORO,2024,450,550,1000,56
OMORO,2025,480,590,1070,56
OTUKE,2015,210,200,410,56
OTUKE,2016,220,210,430,56
OTUKE,2017,230,220,450,56
OTUKE,2018,240,230,470,56
OTUKE,2019,250,240,490,56
OTUKE,2020,270,250,520,56
OTUKE,2021,280,260,540,56
OTUKE,2022,290,270,560,56
OTUKE,2023,300,280,580,56
OTUKE,2024,310,290,600,56
OTUKE,2025,320,300,620,56
OYAM,2015,730,700,1430,56
OYAM,2016,750,720,1470,56
OYAM,2017,770,740,1510,56
OYAM,2018,790,770,1560,56
OYAM,2019,820,790,1610,56
OYAM,2020,840,810,1650,56
OYAM,2021,870,830,1700,56
OYAM,2022,890,850,1740,56
OYAM,2023,910,880,1790,56
OYAM,2024,940,900,1840,56
OYAM,2025,960,920,1880,56
PADER,2015,310,340,650,56
PADER,2016,350,380,730,56
PADER,2017,370,430,800,56
PADER,2018,400,460,860,56
PADER,2019,400,450,850,56
PADER,2020,400,440,840,56
PADER,2021,390,420,810,56
PADER,2022,400,410,810,56
PADER,2023,400,410,810,56
PADER,2024,420,420,840,56
PADER,2025,440,460,900,56
PAKWACH,2015,280,310,590,56
PAKWACH,2016,290,320,610,56
PAKWACH,2017,300,330,630,56
PAKWACH,2018,320,340,660,56
PAKWACH,2019,330,350,680,56
PAKWACH,2020,340,370,710,56
PAKWACH,2021,360,380,740,56
PAKWACH,2022,370,390,760,56
PAKWACH,2023,380,410,790,56
PAKWACH,2024,400,420,820,56
PAKWACH,2025,410,430,840,56
PALLISA,2015,380,410,790,56
PALLISA,2016,430,490,920,56
PALLISA,2017,480,560,1040,56
PALLISA,2018,520,600,1120,56
PALLISA,2019,540,610,1150,56
PALLISA,2020,550,600,1150,56
PALLISA,2021,570,590,1160,56
PALLISA,2022,580,590,1170,56
PALLISA,2023,610,610,1220,56
PALLISA,2024,650,650,1300,56
PALLISA,2025,720,710,1430,56
RAKAI,2015,430,490,920,56
RAKAI,2016,500,570,1070,56
RAKAI,2017,540,630,1170,56
RAKAI,2018,580,670,1250,56
RAKAI,2019,590,670,1260,56
RAKAI,2020,600,650,1250,56
RAKAI,2021,590,620,1210,56
RAKAI,2022,590,610,1200,56
RAKAI,2023,610,620,1230,56
RAKAI,2024,640,650,1290,56
RAKAI,2025,690,700,1390,56
RUBANDA,2015,340,480,820,56
RUBANDA,2016,350,480,830,56
RUBANDA,2017,350,490,840,56
RUBANDA,2018,360,490,850,56
RUBANDA,2019,360,490,850,56
RUBANDA,2020,360,500,860,56
RUBANDA,2021,370,500,870,56
RUBANDA,2022,370,500,870,56
RUBANDA,2023,380,500,880,56
RUBANDA,2024,380,510,890,56
RUBANDA,2025,380,510,890,56
RUBIRIZI,2015,240,280,520,56
RUBIRIZI,2016,240,280,520,56
RUBIRIZI,2017,250,290,540,56
RUBIRIZI,2018,250,290,540,56
RUBIRIZI,2019,260,300,560,56
RUBIRIZI,2020,260,300,560,56
RUBIRIZI,2021,270,310,580,56
RUBIRIZI,2022,270,310,580,56
RUBIRIZI,2023,280,320,600,56
RUBIRIZI,2024,280,320,600,56
RUBIRIZI,2025,290,330,620,56
RUKIGA,2015,220,280,500,56
RUKIGA,2016,220,280,500,56
RUKIGA,2017,220,290,510,56
RUKIGA,2018,220,290,510,56
RUKIGA,2019,220,290,510,56
RUKIGA,2020,230,290,520,56
RUKIGA,2021,230,290,520,56
RUKIGA,2022,230,290,520,56
RUKIGA,2023,230,300,530,56
RUKIGA,2024,230,300,530,56
RUKIGA,2025,230,300,530,56
RUKUNGIRI,2015,620,770,1390,56
RUKUNGIRI,2016,630,780,1410,56
RUKUNGIRI,2017,640,790,1430,56
RUKUNGIRI,2018,650,800,1450,56
RUKUNGIRI,2019,650,800,1450,56
RUKUNGIRI,2020,660,810,1470,56
RUKUNGIRI,2021,670,820,1490,56
RUKUNGIRI,2022,670,820,1490,56
RUKUNGIRI,2023,680,830,1510,56
RUKUNGIRI,2024,680,830,1510,56
RUKUNGIRI,2025,690,840,1530,56
RWAMPARA,2015,220,260,480,56
RWAMPARA,2016,220,260,480,56
RWAMPARA,2017,230,270,500,56
RWAMPARA,2018,230,270,500,56
RWAMPARA,2019,240,280,520,56
RWAMPARA,2020,240,290,530,56
RWAMPARA,2021,250,290,540,56
RWAMPARA,2022,250,300,550,56
RWAMPARA,2023,260,300,560,56
RWAMPARA,2024,260,310,570,56
RWAMPARA,2025,270,310,580,56
SERERE,2015,380,440,820,56
SERERE,2016,420,520,940,56
SERERE,2017,480,590,1070,56
SERERE,2018,520,640,1160,56
SERERE,2019,540,650,1190,56
SERERE,2020,540,640,1180,56
SERERE,2021,550,620,1170,56
SERERE,2022,560,610,1170,56
SERERE,2023,590,630,1220,56
SERERE,2024,630,670,1300,56
SERERE,2025,680,730,1410,56
SHEEMA,2015,430,510,940,56
SHEEMA,2016,440,510,950,56
SHEEMA,2017,440,520,960,56
SHEEMA,2018,450,520,970,56
SHEEMA,2019,450,530,980,56
SHEEMA,2020,460,530,990,56
SHEEMA,2021,460,540,1000,56
SHEEMA,2022,470,540,1010,56
SHEEMA,2023,470,540,1010,56
SHEEMA,2024,470,550,1020,56
SHEEMA,2025,480,550,1030,56
SIRONKO,2015,650,630,1280,56
SIRONKO,2016,670,640,1310,56
SIRONKO,2017,680,660,1340,56
SIRONKO,2018,700,670,1370,56
SIRONKO,2019,720,680,1400,56
SIRONKO,2020,730,700,1430,56
SIRONKO,2021,750,710,1460,56
SIRONKO,2022,760,720,1480,56
SIRONKO,2023,780,730,1510,56
SIRONKO,2024,790,740,1530,56
SIRONKO,2025,810,760,1570,56
SOROTI,2015,410,450,860,56
SOROTI,2016,460,530,990,56
SOROTI,2017,510,590,1100,56
SOROTI,2018,540,640,1180,56
SOROTI,2019,560,660,1220,56
SOROTI,2020,580,640,1220,56
SOROTI,2021,580,620,1200,56
SOROTI,2022,580,610,1190,56
SOROTI,2023,610,630,1240,56
SOROTI,2024,650,660,1310,56
SOROTI,2025,700,720,1420,56
SSEMBABULE,2015,440,490,930,56
SSEMBABULE,2016,500,570,1070,56
SSEMBABULE,2017,560,650,1210,56
SSEMBABULE,2018,590,680,1270,56
SSEMBABULE,2019,600,690,1290,56
SSEMBABULE,2020,610,670,1280,56
SSEMBABULE,2021,600,640,1240,56
SSEMBABULE,2022,620,620,1240,56
SSEMBABULE,2023,630,640,1270,56
SSEMBABULE,2024,670,670,1340,56
SSEMBABULE,2025,720,720,1440,56
TORORO,2015,990,1060,2050,56
TORORO,2016,1010,1090,2100,56
TORORO,2017,1040,1120,2160,56
TORORO,2018,1070,1150,2220,56
TORORO,2019,1090,1170,2260,56
TORORO,2020,1120,1200,2320,56
TORORO,2021,1150,1230,2380,56
TORORO,2022,1180,1260,2440,56
TORORO,2023,1200,1280,2480,56
TORORO,2024,1230,1310,2540,56
TORORO,2025,1250,1340,2590,56
WAKISO,2015,2340,2540,4880,56
WAKISO,2016,2490,2720,5210,56
WAKISO,2017,2660,2910,5570,56
WAKISO,2018,2840,3100,5940,56
WAKISO,2019,3030,3310,6340,56
WAKISO,2020,3220,3530,6750,56
WAKISO,2021,3430,3760,7190,56
WAKISO,2022,3650,4010,7660,56
WAKISO,2023,3880,4270,8150,56
WAKISO,2024,4120,4540,8660,56
WAKISO,2025,4380,4830,9210,56
YUMBE,2015,560,720,1280,56
YUMBE,2016,650,870,1520,56
YUMBE,2017,730,1010,1740,56
YUMBE,2018,790,1100,1890,56
YUMBE,2019,830,1150,1980,56
YUMBE,2020,850,1150,2000,56
YUMBE,2021,870,1150,2020,56
YUMBE,2022,900,1150,2050,56
YUMBE,2023,950,1200,2150,56
YUMBE,2024,1030,1310,2340,56
YUMBE,2025,1120,1460,2580,56
ZOMBO,2015,400,420,820,56
ZOMBO,2016,410,430,840,56
ZOMBO,2017,430,440,870,56
ZOMBO,2018,440,460,900,56
ZOMBO,2019,450,470,920,56
ZOMBO,2020,470,480,950,56
ZOMBO,2021,480,490,970,56
ZOMBO,2022,490,510,1000,56
ZOMBO,2023,510,520,1030,56
ZOMBO,2024,520,530,1050,56
ZOMBO,2025,530,540,1070,56
ABIM,2015,130,140,270,57
ABIM,2016,150,180,330,57
ABIM,2017,180,200,380,57
ABIM,2018,190,240,430,57
ABIM,2019,220,260,480,57
ABIM,2020,230,280,510,57
ABIM,2021,240,260,500,57
ABIM,2022,250,260,510,57
ABIM,2023,260,270,530,57
ABIM,2024,280,280,560,57
ABIM,2025,300,310,610,57
ADJUMANI,2015,210,250,460,57
ADJUMANI,2016,220,250,470,57
ADJUMANI,2017,220,260,480,57
ADJUMANI,2018,220,260,480,57
ADJUMANI,2019,220,260,480,57
ADJUMANI,2020,220,260,480,57
ADJUMANI,2021,220,270,490,57
ADJUMANI,2022,220,270,490,57
ADJUMANI,2023,220,270,490,57
ADJUMANI,2024,230,270,500,57
ADJUMANI,2025,230,270,500,57
AGAGO,2015,250,260,510,57
AGAGO,2016,260,270,530,57
AGAGO,2017,260,270,530,57
AGAGO,2018,270,280,550,57
AGAGO,2019,270,280,550,57
AGAGO,2020,280,280,560,57
AGAGO,2021,280,290,570,57
AGAGO,2022,290,290,580,57
AGAGO,2023,290,300,590,57
AGAGO,2024,290,300,590,57
AGAGO,2025,300,310,610,57
ALEBTONG,2015,350,360,710,57
ALEBTONG,2016,390,430,820,57
ALEBTONG,2017,430,500,930,57
ALEBTONG,2018,480,560,1040,57
ALEBTONG,2019,510,590,1100,57
ALEBTONG,2020,530,590,1120,57
ALEBTONG,2021,530,580,1110,57
ALEBTONG,2022,530,560,1090,57
ALEBTONG,2023,540,550,1090,57
ALEBTONG,2024,560,550,1110,57
ALEBTONG,2025,590,580,1170,57
AMOLATAR,2015,220,230,450,57
AMOLATAR,2016,250,280,530,57
AMOLATAR,2017,280,320,600,57
AMOLATAR,2018,310,360,670,57
AMOLATAR,2019,340,380,720,57
AMOLATAR,2020,340,390,730,57
AMOLATAR,2021,350,370,720,57
AMOLATAR,2022,340,350,690,57
AMOLATAR,2023,350,350,700,57
AMOLATAR,2024,350,340,690,57
AMOLATAR,2025,380,370,750,57
AMUDAT,2015,80,90,170,57
AMUDAT,2016,100,100,200,57
AMUDAT,2017,110,120,230,57
AMUDAT,2018,120,130,250,57
AMUDAT,2019,140,150,290,57
AMUDAT,2020,140,150,290,57
AMUDAT,2021,140,160,300,57
AMUDAT,2022,150,150,300,57
AMUDAT,2023,150,140,290,57
AMUDAT,2024,150,160,310,57
AMUDAT,2025,170,160,330,57
AMURIA,2015,250,300,550,57
AMURIA,2016,280,340,620,57
AMURIA,2017,320,400,720,57
AMURIA,2018,360,450,810,57
AMURIA,2019,390,490,880,57
AMURIA,2020,400,500,900,57
AMURIA,2021,410,490,900,57
AMURIA,2022,410,460,870,57
AMURIA,2023,420,460,880,57
AMURIA,2024,440,470,910,57
AMURIA,2025,470,500,970,57
AMURU,2015,200,210,410,57
AMURU,2016,230,230,460,57
AMURU,2017,250,270,520,57
AMURU,2018,280,310,590,57
AMURU,2019,290,320,610,57
AMURU,2020,310,330,640,57
AMURU,2021,300,320,620,57
AMURU,2022,310,310,620,57
AMURU,2023,310,300,610,57
AMURU,2024,320,300,620,57
AMURU,2025,330,320,650,57
APAC,2015,220,200,420,57
APAC,2016,230,200,430,57
APAC,2017,240,210,450,57
APAC,2018,250,220,470,57
APAC,2019,260,230,490,57
APAC,2020,270,230,500,57
APAC,2021,270,240,510,57
APAC,2022,280,250,530,57
APAC,2023,290,260,550,57
APAC,2024,300,260,560,57
APAC,2025,310,270,580,57
ARUA,2015,840,900,1740,57
ARUA,2016,860,920,1780,57
ARUA,2017,890,950,1840,57
ARUA,2018,910,980,1890,57
ARUA,2019,940,1000,1940,57
ARUA,2020,960,1030,1990,57
ARUA,2021,990,1050,2040,57
ARUA,2022,1020,1080,2100,57
ARUA,2023,1040,1100,2140,57
ARUA,2024,1070,1130,2200,57
ARUA,2025,1090,1160,2250,57
BUDAKA,2015,250,280,530,57
BUDAKA,2016,290,340,630,57
BUDAKA,2017,330,400,730,57
BUDAKA,2018,370,440,810,57
BUDAKA,2019,400,470,870,57
BUDAKA,2020,420,480,900,57
BUDAKA,2021,430,480,910,57
BUDAKA,2022,430,460,890,57
BUDAKA,2023,440,440,880,57
BUDAKA,2024,440,450,890,57
BUDAKA,2025,470,480,950,57
BUDUDA,2015,300,320,620,57
BUDUDA,2016,350,380,730,57
BUDUDA,2017,400,450,850,57
BUDUDA,2018,450,530,980,57
BUDUDA,2019,490,570,1060,57
BUDUDA,2020,510,580,1090,57
BUDUDA,2021,530,580,1110,57
BUDUDA,2022,530,560,1090,57
BUDUDA,2023,550,550,1100,57
BUDUDA,2024,570,580,1150,57
BUDUDA,2025,620,610,1230,57
BUGIRI,2015,490,530,1020,57
BUGIRI,2016,540,630,1170,57
BUGIRI,2017,630,730,1360,57
BUGIRI,2018,700,840,1540,57
BUGIRI,2019,760,910,1670,57
BUGIRI,2020,790,910,1700,57
BUGIRI,2021,810,900,1710,57
BUGIRI,2022,810,880,1690,57
BUGIRI,2023,830,870,1700,57
BUGIRI,2024,870,890,1760,57
BUGIRI,2025,940,950,1890,57
BUGWERI,2015,190,230,420,57
BUGWERI,2016,220,280,500,57
BUGWERI,2017,240,320,560,57
BUGWERI,2018,270,360,630,57
BUGWERI,2019,280,380,660,57
BUGWERI,2020,290,390,680,57
BUGWERI,2021,290,370,660,57
BUGWERI,2022,300,350,650,57
BUGWERI,2023,290,350,640,57
BUGWERI,2024,310,340,650,57
BUGWERI,2025,320,370,690,57
BUHWEJU,2015,140,150,290,57
BUHWEJU,2016,150,160,310,57
BUHWEJU,2017,150,160,310,57
BUHWEJU,2018,160,170,330,57
BUHWEJU,2019,160,170,330,57
BUHWEJU,2020,170,180,350,57
BUHWEJU,2021,170,180,350,57
BUHWEJU,2022,180,190,370,57
BUHWEJU,2023,190,190,380,57
BUHWEJU,2024,190,200,390,57
BUHWEJU,2025,200,200,400,57
BUIKWE,2015,540,620,1160,57
BUIKWE,2016,610,720,1330,57
BUIKWE,2017,680,830,1510,57
BUIKWE,2018,750,930,1680,57
BUIKWE,2019,790,960,1750,57
BUIKWE,2020,810,970,1780,57
BUIKWE,2021,810,930,1740,57
BUIKWE,2022,800,890,1690,57
BUIKWE,2023,800,870,1670,57
BUIKWE,2024,820,870,1690,57
BUIKWE,2025,860,920,1780,57
BUKEDEA,2015,290,360,650,57
BUKEDEA,2016,340,430,770,57
BUKEDEA,2017,390,500,890,57
BUKEDEA,2018,430,560,990,57
BUKEDEA,2019,460,610,1070,57
BUKEDEA,2020,500,630,1130,57
BUKEDEA,2021,500,620,1120,57
BUKEDEA,2022,500,600,1100,57
BUKEDEA,2023,520,600,1120,57
BUKEDEA,2024,540,610,1150,57
BUKEDEA,2025,590,640,1230,57
BUKOMANSIMBI,2015,250,340,590,57
BUKOMANSIMBI,2016,280,380,660,57
BUKOMANSIMBI,2017,320,430,750,57
BUKOMANSIMBI,2018,340,470,810,57
BUKOMANSIMBI,2019,360,510,870,57
BUKOMANSIMBI,2020,360,500,860,57
BUKOMANSIMBI,2021,350,480,830,57
BUKOMANSIMBI,2022,340,450,790,57
BUKOMANSIMBI,2023,340,430,770,57
BUKOMANSIMBI,2024,350,420,770,57
BUKOMANSIMBI,2025,360,430,790,57
BUKWO,2015,120,120,240,57
BUKWO,2016,130,120,250,57
BUKWO,2017,130,130,260,57
BUKWO,2018,140,130,270,57
BUKWO,2019,150,140,290,57
BUKWO,2020,160,150,310,57
BUKWO,2021,160,150,310,57
BUKWO,2022,170,160,330,57
BUKWO,2023,180,170,350,57
BUKWO,2024,190,170,360,57
BUKWO,2025,200,180,380,57
BULAMBULI,2015,310,320,630,57
BULAMBULI,2016,370,400,770,57
BULAMBULI,2017,420,470,890,57
BULAMBULI,2018,480,530,1010,57
BULAMBULI,2019,510,590,1100,57
BULAMBULI,2020,540,590,1130,57
BULAMBULI,2021,560,600,1160,57
BULAMBULI,2022,560,580,1140,57
BULAMBULI,2023,580,580,1160,57
BULAMBULI,2024,620,590,1210,57
BULAMBULI,2025,660,640,1300,57
BULIISA,2015,130,120,250,57
BULIISA,2016,140,120,260,57
BULIISA,2017,150,130,280,57
BULIISA,2018,150,130,280,57
BULIISA,2019,160,140,300,57
BULIISA,2020,170,140,310,57
BULIISA,2021,180,150,330,57
BULIISA,2022,190,160,350,57
BULIISA,2023,200,160,360,57
BULIISA,2024,210,170,380,57
BULIISA,2025,220,180,400,57
BUNDIBUGYO,2015,250,260,510,57
BUNDIBUGYO,2016,290,290,580,57
BUNDIBUGYO,2017,330,350,680,57
BUNDIBUGYO,2018,370,380,750,57
BUNDIBUGYO,2019,390,420,810,57
BUNDIBUGYO,2020,400,410,810,57
BUNDIBUGYO,2021,410,410,820,57
BUNDIBUGYO,2022,410,380,790,57
BUNDIBUGYO,2023,410,380,790,57
BUNDIBUGYO,2024,430,390,820,57
BUNDIBUGYO,2025,450,400,850,57
BUNYANGABU,2015,190,310,500,57
BUNYANGABU,2016,200,370,570,57
BUNYANGABU,2017,240,420,660,57
BUNYANGABU,2018,250,470,720,57
BUNYANGABU,2019,260,490,750,57
BUNYANGABU,2020,280,500,780,57
BUNYANGABU,2021,270,480,750,57
BUNYANGABU,2022,280,460,740,57
BUNYANGABU,2023,280,440,720,57
BUNYANGABU,2024,290,450,740,57
BUNYANGABU,2025,300,470,770,57
BUSHENYI,2015,310,320,630,57
BUSHENYI,2016,320,320,640,57
BUSHENYI,2017,320,320,640,57
BUSHENYI,2018,330,320,650,57
BUSHENYI,2019,330,330,660,57
BUSHENYI,2020,330,330,660,57
BUSHENYI,2021,340,330,670,57
BUSHENYI,2022,340,330,670,57
BUSHENYI,2023,340,340,680,57
BUSHENYI,2024,350,340,690,57
BUSHENYI,2025,350,340,690,57
BUSIA,2015,430,530,960,57
BUSIA,2016,480,620,1100,57
BUSIA,2017,540,720,1260,57
BUSIA,2018,600,800,1400,57
BUSIA,2019,650,850,1500,57
BUSIA,2020,670,870,1540,57
BUSIA,2021,670,850,1520,57
BUSIA,2022,680,810,1490,57
BUSIA,2023,680,790,1470,57
BUSIA,2024,700,810,1510,57
BUSIA,2025,740,850,1590,57
BUTALEJA,2015,370,390,760,57
BUTALEJA,2016,420,450,870,57
BUTALEJA,2017,470,530,1000,57
BUTALEJA,2018,520,600,1120,57
BUTALEJA,2019,570,640,1210,57
BUTALEJA,2020,590,650,1240,57
BUTALEJA,2021,590,650,1240,57
BUTALEJA,2022,610,630,1240,57
BUTALEJA,2023,610,620,1230,57
BUTALEJA,2024,650,620,1270,57
BUTALEJA,2025,680,660,1340,57
BUTAMBALA,2015,150,130,280,57
BUTAMBALA,2016,160,150,310,57
BUTAMBALA,2017,180,170,350,57
BUTAMBALA,2018,190,180,370,57
BUTAMBALA,2019,220,190,410,57
BUTAMBALA,2020,220,200,420,57
BUTAMBALA,2021,210,190,400,57
BUTAMBALA,2022,210,180,390,57
BUTAMBALA,2023,200,170,370,57
BUTAMBALA,2024,210,170,380,57
BUTAMBALA,2025,230,180,410,57
BUTEBO,2015,130,150,280,57
BUTEBO,2016,140,180,320,57
BUTEBO,2017,150,220,370,57
BUTEBO,2018,180,240,420,57
BUTEBO,2019,190,250,440,57
BUTEBO,2020,190,240,430,57
BUTEBO,2021,180,230,410,57
BUTEBO,2022,180,210,390,57
BUTEBO,2023,170,220,390,57
BUTEBO,2024,190,220,410,57
BUTEBO,2025,200,230,430,57
BUVUMA,2015,110,60,170,57
BUVUMA,2016,110,60,170,57
BUVUMA,2017,120,70,190,57
BUVUMA,2018,130,70,200,57
BUVUMA,2019,140,80,220,57
BUVUMA,2020,140,80,220,57
BUVUMA,2021,150,90,240,57
BUVUMA,2022,160,90,250,57
BUVUMA,2023,170,100,270,57
BUVUMA,2024,180,100,280,57
BUVUMA,2025,190,110,300,57
BUYENDE,2015,360,320,680,57
BUYENDE,2016,420,380,800,57
BUYENDE,2017,470,450,920,57
BUYENDE,2018,540,510,1050,57
BUYENDE,2019,570,550,1120,57
BUYENDE,2020,600,560,1160,57
BUYENDE,2021,610,560,1170,57
BUYENDE,2022,620,550,1170,57
BUYENDE,2023,640,540,1180,57
BUYENDE,2024,670,550,1220,57
BUYENDE,2025,720,590,1310,57
DOKOLO,2015,290,240,530,57
DOKOLO,2016,300,250,550,57
DOKOLO,2017,310,250,560,57
DOKOLO,2018,320,260,580,57
DOKOLO,2019,330,270,600,57
DOKOLO,2020,340,280,620,57
DOKOLO,2021,350,280,630,57
DOKOLO,2022,360,290,650,57
DOKOLO,2023,370,300,670,57
DOKOLO,2024,380,300,680,57
DOKOLO,2025,390,310,700,57
GOMBA,2015,250,280,530,57
GOMBA,2016,280,320,600,57
GOMBA,2017,320,380,700,57
GOMBA,2018,340,420,760,57
GOMBA,2019,370,430,800,57
GOMBA,2020,370,430,800,57
GOMBA,2021,370,420,790,57
GOMBA,2022,370,400,770,57
GOMBA,2023,360,380,740,57
GOMBA,2024,370,370,740,57
GOMBA,2025,390,390,780,57
GULU,2015,260,300,560,57
GULU,2016,270,310,580,57
GULU,2017,280,320,600,57
GULU,2018,290,330,620,57
GULU,2019,290,340,630,57
GULU,2020,300,350,650,57
GULU,2021,310,360,670,57
GULU,2022,320,370,690,57
GULU,2023,330,380,710,57
GULU,2024,340,390,730,57
GULU,2025,350,400,750,57
HOIMA,2015,350,350,700,57
HOIMA,2016,360,360,720,57
HOIMA,2017,380,370,750,57
HOIMA,2018,390,380,770,57
HOIMA,2019,410,400,810,57
HOIMA,2020,420,410,830,57
HOIMA,2021,440,420,860,57
HOIMA,2022,450,440,890,57
HOIMA,2023,470,450,920,57
HOIMA,2024,480,460,940,57
HOIMA,2025,500,480,980,57
IBANDA,2015,350,400,750,57
IBANDA,2016,360,400,760,57
IBANDA,2017,360,410,770,57
IBANDA,2018,370,420,790,57
IBANDA,2019,380,430,810,57
IBANDA,2020,380,430,810,57
IBANDA,2021,390,440,830,57
IBANDA,2022,400,450,850,57
IBANDA,2023,400,450,850,57
IBANDA,2024,410,460,870,57
IBANDA,2025,420,460,880,57
IGANGA,2015,360,390,750,57
IGANGA,2016,400,450,850,57
IGANGA,2017,460,530,990,57
IGANGA,2018,510,600,1110,57
IGANGA,2019,540,620,1160,57
IGANGA,2020,560,630,1190,57
IGANGA,2021,560,620,1180,57
IGANGA,2022,560,600,1160,57
IGANGA,2023,580,580,1160,57
IGANGA,2024,600,590,1190,57
IGANGA,2025,630,630,1260,57
ISINGIRO,2015,710,610,1320,57
ISINGIRO,2016,740,630,1370,57
ISINGIRO,2017,770,660,1430,57
ISINGIRO,2018,800,680,1480,57
ISINGIRO,2019,830,700,1530,57
ISINGIRO,2020,860,730,1590,57
ISINGIRO,2021,890,750,1640,57
ISINGIRO,2022,920,770,1690,57
ISINGIRO,2023,950,800,1750,57
ISINGIRO,2024,980,820,1800,57
ISINGIRO,2025,1010,850,1860,57
JINJA,2015,460,520,980,57
JINJA,2016,470,530,1000,57
JINJA,2017,470,540,1010,57
JINJA,2018,480,550,1030,57
JINJA,2019,490,550,1040,57
JINJA,2020,500,560,1060,57
JINJA,2021,500,570,1070,57
JINJA,2022,510,580,1090,57
JINJA,2023,520,580,1100,57
JINJA,2024,520,590,1110,57
JINJA,2025,530,600,1130,57
KAABONG,2015,110,130,240,57
KAABONG,2016,110,130,240,57
KAABONG,2017,110,140,250,57
KAABONG,2018,110,140,250,57
KAABONG,2019,120,140,260,57
KAABONG,2020,120,140,260,57
KAABONG,2021,120,150,270,57
KAABONG,2022,130,150,280,57
KAABONG,2023,130,150,280,57
KAABONG,2024,130,160,290,57
KAABONG,2025,140,160,300,57
KABALE,2015,360,320,680,57
KABALE,2016,370,330,700,57
KABALE,2017,380,330,710,57
KABALE,2018,380,340,720,57
KABALE,2019,390,340,730,57
KABALE,2020,390,340,730,57
KABALE,2021,400,350,750,57
KABALE,2022,400,350,750,57
KABALE,2023,410,350,760,57
KABALE,2024,410,360,770,57
KABALE,2025,420,360,780,57
KABAROLE,2015,380,380,760,57
KABAROLE,2016,390,390,780,57
KABAROLE,2017,400,400,800,57
KABAROLE,2018,410,410,820,57
KABAROLE,2019,420,420,840,57
KABAROLE,2020,430,420,850,57
KABAROLE,2021,430,430,860,57
KABAROLE,2022,440,440,880,57
KABAROLE,2023,450,450,900,57
KABAROLE,2024,460,460,920,57
KABAROLE,2025,470,460,930,57
KABERAMAIDO,2015,140,120,260,57
KABERAMAIDO,2016,160,150,310,57
KABERAMAIDO,2017,180,170,350,57
KABERAMAIDO,2018,210,180,390,57
KABERAMAIDO,2019,220,210,430,57
KABERAMAIDO,2020,230,200,430,57
KABERAMAIDO,2021,240,210,450,57
KABERAMAIDO,2022,240,200,440,57
KABERAMAIDO,2023,250,210,460,57
KABERAMAIDO,2024,260,200,460,57
KABERAMAIDO,2025,270,210,480,57
KAGADI,2015,410,400,810,57
KAGADI,2016,420,410,830,57
KAGADI,2017,440,430,870,57
KAGADI,2018,450,440,890,57
KAGADI,2019,470,460,930,57
KAGADI,2020,490,480,970,57
KAGADI,2021,500,490,990,57
KAGADI,2022,520,510,1030,57
KAGADI,2023,540,520,1060,57
KAGADI,2024,560,540,1100,57
KAGADI,2025,570,560,1130,57
KAKUMIRO,2015,400,320,720,57
KAKUMIRO,2016,440,350,790,57
KAKUMIRO,2017,480,380,860,57
KAKUMIRO,2018,520,410,930,57
KAKUMIRO,2019,570,440,1010,57
KAKUMIRO,2020,620,480,1100,57
KAKUMIRO,2021,670,520,1190,57
KAKUMIRO,2022,730,560,1290,57
KAKUMIRO,2023,790,600,1390,57
KAKUMIRO,2024,850,650,1500,57
KAKUMIRO,2025,920,700,1620,57
KALAKI,2015,140,130,270,57
KALAKI,2016,140,140,280,57
KALAKI,2017,150,140,290,57
KALAKI,2018,160,150,310,57
KALAKI,2019,160,160,320,57
KALAKI,2020,170,160,330,57
KALAKI,2021,180,170,350,57
KALAKI,2022,180,170,350,57
KALAKI,2023,190,180,370,57
KALAKI,2024,200,190,390,57
KALAKI,2025,210,190,400,57
KALANGALA,2015,70,30,100,57
KALANGALA,2016,70,30,100,57
KALANGALA,2017,80,30,110,57
KALANGALA,2018,80,40,120,57
KALANGALA,2019,80,40,120,57
KALANGALA,2020,80,40,120,57
KALANGALA,2021,90,40,130,57
KALANGALA,2022,90,40,130,57
KALANGALA,2023,90,40,130,57
KALANGALA,2024,100,50,150,57
KALANGALA,2025,100,50,150,57
KALIRO,2015,310,270,580,57
KALIRO,2016,350,320,670,57
KALIRO,2017,400,380,780,57
KALIRO,2018,450,440,890,57
KALIRO,2019,480,450,930,57
KALIRO,2020,500,460,960,57
KALIRO,2021,520,460,980,57
KALIRO,2022,520,450,970,57
KALIRO,2023,520,440,960,57
KALIRO,2024,540,440,980,57
KALIRO,2025,570,470,1040,57
KALUNGU,2015,290,410,700,57
KALUNGU,2016,320,470,790,57
KALUNGU,2017,350,550,900,57
KALUNGU,2018,370,600,970,57
KALUNGU,2019,400,620,1020,57
KALUNGU,2020,400,630,1030,57
KALUNGU,2021,400,600,1000,57
KALUNGU,2022,400,560,960,57
KALUNGU,2023,390,540,930,57
KALUNGU,2024,400,530,930,57
KALUNGU,2025,410,560,970,57
KAMPALA,2015,1370,1270,2640,57
KAMPALA,2016,1400,1300,2700,57
KAMPALA,2017,1430,1320,2750,57
KAMPALA,2018,1460,1350,2810,57
KAMPALA,2019,1480,1370,2850,57
KAMPALA,2020,1510,1400,2910,57
KAMPALA,2021,1540,1420,2960,57
KAMPALA,2022,1560,1440,3000,57
KAMPALA,2023,1590,1470,3060,57
KAMPALA,2024,1610,1490,3100,57
KAMPALA,2025,1630,1510,3140,57
KAMULI,2015,530,660,1190,57
KAMULI,2016,590,760,1350,57
KAMULI,2017,670,880,1550,57
KAMULI,2018,730,980,1710,57
KAMULI,2019,790,1040,1830,57
KAMULI,2020,810,1060,1870,57
KAMULI,2021,810,1020,1830,57
KAMULI,2022,810,980,1790,57
KAMULI,2023,820,950,1770,57
KAMULI,2024,840,950,1790,57
KAMULI,2025,880,1000,1880,57
KAMWENGE,2015,320,350,670,57
KAMWENGE,2016,330,360,690,57
KAMWENGE,2017,340,370,710,57
KAMWENGE,2018,350,380,730,57
KAMWENGE,2019,370,400,770,57
KAMWENGE,2020,380,410,790,57
KAMWENGE,2021,400,420,820,57
KAMWENGE,2022,410,440,850,57
KAMWENGE,2023,430,450,880,57
KAMWENGE,2024,440,470,910,57
KAMWENGE,2025,460,480,940,57
KANUNGU,2015,360,420,780,57
KANUNGU,2016,370,430,800,57
KANUNGU,2017,380,430,810,57
KANUNGU,2018,380,440,820,57
KANUNGU,2019,390,450,840,57
KANUNGU,2020,400,450,850,57
KANUNGU,2021,400,460,860,57
KANUNGU,2022,410,470,880,57
KANUNGU,2023,420,470,890,57
KANUNGU,2024,420,480,900,57
KANUNGU,2025,430,480,910,57
KAPCHORWA,2015,170,140,310,57
KAPCHORWA,2016,170,140,310,57
KAPCHORWA,2017,180,140,320,57
KAPCHORWA,2018,180,150,330,57
KAPCHORWA,2019,190,150,340,57
KAPCHORWA,2020,190,160,350,57
KAPCHORWA,2021,200,160,360,57
KAPCHORWA,2022,210,160,370,57
KAPCHORWA,2023,210,170,380,57
KAPCHORWA,2024,220,170,390,57
KAPCHORWA,2025,220,180,400,57
KAPELEBYONG,2015,80,90,170,57
KAPELEBYONG,2016,110,100,210,57
KAPELEBYONG,2017,130,130,260,57
KAPELEBYONG,2018,130,150,280,57
KAPELEBYONG,2019,150,150,300,57
KAPELEBYONG,2020,160,150,310,57
KAPELEBYONG,2021,150,140,290,57
KAPELEBYONG,2022,160,150,310,57
KAPELEBYONG,2023,160,140,300,57
KAPELEBYONG,2024,160,140,300,57
KAPELEBYONG,2025,180,140,320,57
KASESE,2015,820,850,1670,57
KASESE,2016,920,980,1900,57
KASESE,2017,1040,1150,2190,57
KASESE,2018,1150,1270,2420,57
KASESE,2019,1220,1360,2580,57
KASESE,2020,1260,1360,2620,57
KASESE,2021,1250,1320,2570,57
KASESE,2022,1240,1260,2500,57
KASESE,2023,1250,1230,2480,57
KASESE,2024,1290,1230,2520,57
KASESE,2025,1360,1290,2650,57
KASSANDA,2015,320,310,630,57
KASSANDA,2016,330,310,640,57
KASSANDA,2017,340,320,660,57
KASSANDA,2018,350,330,680,57
KASSANDA,2019,360,330,690,57
KASSANDA,2020,370,340,710,57
KASSANDA,2021,380,350,730,57
KASSANDA,2022,390,350,740,57
KASSANDA,2023,400,360,760,57
KASSANDA,2024,410,360,770,57
KASSANDA,2025,420,370,790,57
KATAKWI,2015,190,190,380,57
KATAKWI,2016,200,230,430,57
KATAKWI,2017,240,270,510,57
KATAKWI,2018,250,310,560,57
KATAKWI,2019,280,320,600,57
KATAKWI,2020,280,330,610,57
KATAKWI,2021,290,320,610,57
KATAKWI,2022,280,300,580,57
KATAKWI,2023,290,300,590,57
KATAKWI,2024,290,300,590,57
KATAKWI,2025,320,320,640,57
KAYUNGA,2015,460,590,1050,57
KAYUNGA,2016,520,670,1190,57
KAYUNGA,2017,580,780,1360,57
KAYUNGA,2018,640,870,1510,57
KAYUNGA,2019,680,930,1610,57
KAYUNGA,2020,700,910,1610,57
KAYUNGA,2021,680,880,1560,57
KAYUNGA,2022,680,840,1520,57
KAYUNGA,2023,680,810,1490,57
KAYUNGA,2024,700,810,1510,57
KAYUNGA,2025,720,850,1570,57
KAZO,2015,290,250,540,57
KAZO,2016,310,260,570,57
KAZO,2017,320,270,590,57
KAZO,2018,330,280,610,57
KAZO,2019,340,290,630,57
KAZO,2020,350,300,650,57
KAZO,2021,370,310,680,57
KAZO,2022,380,320,700,57
KAZO,2023,390,330,720,57
KAZO,2024,410,340,750,57
KAZO,2025,420,350,770,57
KIBAALE,2015,160,140,300,57
KIBAALE,2016,170,150,320,57
KIBAALE,2017,190,160,350,57
KIBAALE,2018,200,170,370,57
KIBAALE,2019,210,180,390,57
KIBAALE,2020,220,190,410,57
KIBAALE,2021,240,200,440,57
KIBAALE,2022,250,210,460,57
KIBAALE,2023,270,220,490,57
KIBAALE,2024,280,230,510,57
KIBAALE,2025,300,240,540,57
KIBOGA,2015,190,180,370,57
KIBOGA,2016,210,210,420,57
KIBOGA,2017,240,240,480,57
KIBOGA,2018,260,280,540,57
KIBOGA,2019,300,310,610,57
KIBOGA,2020,310,320,630,57
KIBOGA,2021,320,330,650,57
KIBOGA,2022,330,320,650,57
KIBOGA,2023,320,310,630,57
KIBOGA,2024,330,300,630,57
KIBOGA,2025,330,300,630,57
KIBUKU,2015,240,300,540,57
KIBUKU,2016,280,340,620,57
KIBUKU,2017,320,400,720,57
KIBUKU,2018,340,450,790,57
KIBUKU,2019,370,490,860,57
KIBUKU,2020,390,500,890,57
KIBUKU,2021,400,490,890,57
KIBUKU,2022,400,480,880,57
KIBUKU,2023,410,470,880,57
KIBUKU,2024,430,480,910,57
KIBUKU,2025,450,510,960,57
KIKUUBE,2015,320,310,630,57
KIKUUBE,2016,340,320,660,57
KIKUUBE,2017,360,340,700,57
KIKUUBE,2018,380,360,740,57
KIKUUBE,2019,400,380,780,57
KIKUUBE,2020,420,390,810,57
KIKUUBE,2021,440,410,850,57
KIKUUBE,2022,460,430,890,57
KIKUUBE,2023,480,450,930,57
KIKUUBE,2024,510,480,990,57
KIKUUBE,2025,530,500,1030,57
KIRUHURA,2015,220,210,430,57
KIRUHURA,2016,230,210,440,57
KIRUHURA,2017,240,220,460,57
KIRUHURA,2018,250,230,480,57
KIRUHURA,2019,260,240,500,57
KIRUHURA,2020,270,240,510,57
KIRUHURA,2021,270,250,520,57
KIRUHURA,2022,280,260,540,57
KIRUHURA,2023,290,270,560,57
KIRUHURA,2024,300,280,580,57
KIRUHURA,2025,310,290,600,57
KIRYANDONGO,2015,360,320,680,57
KIRYANDONGO,2016,400,380,780,57
KIRYANDONGO,2017,460,450,910,57
KIRYANDONGO,2018,490,490,980,57
KIRYANDONGO,2019,540,530,1070,57
KIRYANDONGO,2020,560,540,1100,57
KIRYANDONGO,2021,560,510,1070,57
KIRYANDONGO,2022,560,500,1060,57
KIRYANDONGO,2023,570,490,1060,57
KIRYANDONGO,2024,590,500,1090,57
KIRYANDONGO,2025,620,510,1130,57
KISORO,2015,350,480,830,57
KISORO,2016,390,540,930,57
KISORO,2017,450,630,1080,57
KISORO,2018,480,710,1190,57
KISORO,2019,510,760,1270,57
KISORO,2020,530,740,1270,57
KISORO,2021,520,720,1240,57
KISORO,2022,520,690,1210,57
KISORO,2023,510,680,1190,57
KISORO,2024,530,670,1200,57
KISORO,2025,560,710,1270,57
KITAGWENDA,2015,210,220,430,57
KITAGWENDA,2016,220,220,440,57
KITAGWENDA,2017,230,230,460,57
KITAGWENDA,2018,240,240,480,57
KITAGWENDA,2019,250,250,500,57
KITAGWENDA,2020,260,260,520,57
KITAGWENDA,2021,270,270,540,57
KITAGWENDA,2022,280,280,560,57
KITAGWENDA,2023,290,280,570,57
KITAGWENDA,2024,300,290,590,57
KITAGWENDA,2025,310,300,610,57
KITGUM,2015,240,340,580,57
KITGUM,2016,280,400,680,57
KITGUM,2017,310,450,760,57
KITGUM,2018,330,510,840,57
KITGUM,2019,360,530,890,57
KITGUM,2020,360,520,880,57
KITGUM,2021,350,510,860,57
KITGUM,2022,350,480,830,57
KITGUM,2023,350,460,810,57
KITGUM,2024,350,470,820,57
KITGUM,2025,380,480,860,57
KOBOKO,2015,230,260,490,57
KOBOKO,2016,270,290,560,57
KOBOKO,2017,310,350,660,57
KOBOKO,2018,340,400,740,57
KOBOKO,2019,370,430,800,57
KOBOKO,2020,370,450,820,57
KOBOKO,2021,380,420,800,57
KOBOKO,2022,380,410,790,57
KOBOKO,2023,390,410,800,57
KOBOKO,2024,410,420,830,57
KOBOKO,2025,440,450,890,57
KOLE,2015,260,230,490,57
KOLE,2016,270,230,500,57
KOLE,2017,280,240,520,57
KOLE,2018,290,250,540,57
KOLE,2019,300,260,560,57
KOLE,2020,310,260,570,57
KOLE,2021,320,270,590,57
KOLE,2022,330,280,610,57
KOLE,2023,340,280,620,57
KOLE,2024,350,290,640,57
KOLE,2025,360,300,660,57
KOTIDO,2015,170,260,430,57
KOTIDO,2016,190,310,500,57
KOTIDO,2017,220,350,570,57
KOTIDO,2018,240,400,640,57
KOTIDO,2019,260,420,680,57
KOTIDO,2020,260,430,690,57
KOTIDO,2021,260,410,670,57
KOTIDO,2022,270,400,670,57
KOTIDO,2023,260,380,640,57
KOTIDO,2024,280,370,650,57
KOTIDO,2025,290,400,690,57
KUMI,2015,370,440,810,57
KUMI,2016,420,510,930,57
KUMI,2017,470,580,1050,57
KUMI,2018,520,670,1190,57
KUMI,2019,560,720,1280,57
KUMI,2020,570,730,1300,57
KUMI,2021,580,710,1290,57
KUMI,2022,580,680,1260,57
KUMI,2023,580,660,1240,57
KUMI,2024,620,670,1290,57
KUMI,2025,650,710,1360,57
KWANIA,2015,230,190,420,57
KWANIA,2016,230,200,430,57
KWANIA,2017,240,200,440,57
KWANIA,2018,250,210,460,57
KWANIA,2019,260,220,480,57
KWANIA,2020,260,220,480,57
KWANIA,2021,270,230,500,57
KWANIA,2022,280,230,510,57
KWANIA,2023,290,240,530,57
KWANIA,2024,290,250,540,57
KWANIA,2025,300,250,550,57
KWEEN,2015,140,100,240,57
KWEEN,2016,140,100,240,57
KWEEN,2017,150,100,250,57
KWEEN,2018,150,110,260,57
KWEEN,2019,150,110,260,57
KWEEN,2020,160,110,270,57
KWEEN,2021,160,110,270,57
KWEEN,2022,170,120,290,57
KWEEN,2023,170,120,290,57
KWEEN,2024,180,120,300,57
KWEEN,2025,180,120,300,57
KYANKWANZI,2015,310,180,490,57
KYANKWANZI,2016,320,190,510,57
KYANKWANZI,2017,340,200,540,57
KYANKWANZI,2018,350,210,560,57
KYANKWANZI,2019,370,220,590,57
KYANKWANZI,2020,390,230,620,57
KYANKWANZI,2021,410,240,650,57
KYANKWANZI,2022,430,250,680,57
KYANKWANZI,2023,450,260,710,57
KYANKWANZI,2024,470,270,740,57
KYANKWANZI,2025,490,280,770,57
KYEGEGWA,2015,330,300,630,57
KYEGEGWA,2016,360,330,690,57
KYEGEGWA,2017,390,350,740,57
KYEGEGWA,2018,420,380,800,57
KYEGEGWA,2019,460,410,870,57
KYEGEGWA,2020,490,440,930,57
KYEGEGWA,2021,530,480,1010,57
KYEGEGWA,2022,580,510,1090,57
KYEGEGWA,2023,620,550,1170,57
KYEGEGWA,2024,670,590,1260,57
KYEGEGWA,2025,720,640,1360,57
KYENJOJO,2015,430,440,870,57
KYENJOJO,2016,450,460,910,57
KYENJOJO,2017,460,470,930,57
KYENJOJO,2018,480,490,970,57
KYENJOJO,2019,500,510,1010,57
KYENJOJO,2020,520,530,1050,57
KYENJOJO,2021,540,540,1080,57
KYENJOJO,2022,560,560,1120,57
KYENJOJO,2023,580,580,1160,57
KYENJOJO,2024,600,600,1200,57
KYENJOJO,2025,630,620,1250,57
KYOTERA,2015,350,480,830,57
KYOTERA,2016,380,540,920,57
KYOTERA,2017,430,630,1060,57
KYOTERA,2018,460,690,1150,57
KYOTERA,2019,490,740,1230,57
KYOTERA,2020,500,730,1230,57
KYOTERA,2021,500,710,1210,57
KYOTERA,2022,490,660,1150,57
KYOTERA,2023,500,650,1150,57
KYOTERA,2024,500,640,1140,57
KYOTERA,2025,530,680,1210,57
KARENGA,2015,50,60,110,57
KARENGA,2016,50,60,110,57
KARENGA,2017,60,70,130,57
KARENGA,2018,60,70,130,57
KARENGA,2019,60,70,130,57
KARENGA,2020,60,70,130,57
KARENGA,2021,60,70,130,57
KARENGA,2022,60,70,130,57
KARENGA,2023,60,80,140,57
KARENGA,2024,70,80,150,57
KARENGA,2025,70,80,150,57
LAMWO,2015,190,230,420,57
LAMWO,2016,200,260,460,57
LAMWO,2017,220,300,520,57
LAMWO,2018,240,330,570,57
LAMWO,2019,250,360,610,57
LAMWO,2020,250,350,600,57
LAMWO,2021,240,330,570,57
LAMWO,2022,250,310,560,57
LAMWO,2023,250,300,550,57
LAMWO,2024,250,310,560,57
LAMWO,2025,260,320,580,57
LIRA,2015,430,430,860,57
LIRA,2016,450,440,890,57
LIRA,2017,460,450,910,57
LIRA,2018,470,470,940,57
LIRA,2019,480,480,960,57
LIRA,2020,500,490,990,57
LIRA,2021,510,500,1010,57
LIRA,2022,520,520,1040,57
LIRA,2023,540,530,1070,57
LIRA,2024,550,540,1090,57
LIRA,2025,560,560,1120,57
LUUKA,2015,270,310,580,57
LUUKA,2016,290,370,660,57
LUUKA,2017,330,420,750,57
LUUKA,2018,360,470,830,57
LUUKA,2019,390,490,880,57
LUUKA,2020,390,500,890,57
LUUKA,2021,400,480,880,57
LUUKA,2022,380,460,840,57
LUUKA,2023,390,440,830,57
LUUKA,2024,400,440,840,57
LUUKA,2025,420,470,890,57
LUWERO,2015,650,720,1370,57
LUWERO,2016,720,840,1560,57
LUWERO,2017,810,970,1780,57
LUWERO,2018,900,1070,1970,57
LUWERO,2019,940,1150,2090,57
LUWERO,2020,980,1150,2130,57
LUWERO,2021,990,1110,2100,57
LUWERO,2022,980,1070,2050,57
LUWERO,2023,990,1040,2030,57
LUWERO,2024,1010,1040,2050,57
LUWERO,2025,1060,1090,2150,57
LWENGO,2015,390,550,940,57
LWENGO,2016,440,630,1070,57
LWENGO,2017,490,730,1220,57
LWENGO,2018,540,800,1340,57
LWENGO,2019,560,850,1410,57
LWENGO,2020,560,840,1400,57
LWENGO,2021,560,790,1350,57
LWENGO,2022,550,760,1310,57
LWENGO,2023,540,730,1270,57
LWENGO,2024,540,720,1260,57
LWENGO,2025,570,740,1310,57
LYANTONDE,2015,140,140,280,57
LYANTONDE,2016,160,160,320,57
LYANTONDE,2017,180,180,360,57
LYANTONDE,2018,190,220,410,57
LYANTONDE,2019,220,230,450,57
LYANTONDE,2020,220,220,440,57
LYANTONDE,2021,230,210,440,57
LYANTONDE,2022,220,210,430,57
LYANTONDE,2023,220,210,430,57
LYANTONDE,2024,230,200,430,57
LYANTONDE,2025,240,230,470,57
MANAFWA,2015,240,260,500,57
MANAFWA,2016,250,260,510,57
MANAFWA,2017,250,270,520,57
MANAFWA,2018,260,270,530,57
MANAFWA,2019,260,280,540,57
MANAFWA,2020,270,290,560,57
MANAFWA,2021,280,290,570,57
MANAFWA,2022,280,300,580,57
MANAFWA,2023,290,300,590,57
MANAFWA,2024,290,310,600,57
MANAFWA,2025,300,310,610,57
MARACHA,2015,250,290,540,57
MARACHA,2016,250,290,540,57
MARACHA,2017,260,300,560,57
MARACHA,2018,270,300,570,57
MARACHA,2019,270,310,580,57
MARACHA,2020,280,310,590,57
MARACHA,2021,280,320,600,57
MARACHA,2022,290,320,610,57
MARACHA,2023,290,330,620,57
MARACHA,2024,300,340,640,57
MARACHA,2025,300,340,640,57
MASAKA,2015,380,460,840,57
MASAKA,2016,380,460,840,57
MASAKA,2017,420,510,930,57
MASAKA,2018,470,600,1070,57
MASAKA,2019,540,700,1240,57
MASAKA,2020,580,780,1360,57
MASAKA,2021,620,810,1430,57
MASAKA,2022,630,820,1450,57
MASAKA,2023,640,800,1440,57
MASAKA,2024,640,760,1400,57
MASAKA,2025,630,730,1360,57
MASINDI,2015,360,330,690,57
MASINDI,2016,370,340,710,57
MASINDI,2017,380,350,730,57
MASINDI,2018,390,360,750,57
MASINDI,2019,400,370,770,57
MASINDI,2020,410,380,790,57
MASINDI,2021,420,390,810,57
MASINDI,2022,430,400,830,57
MASINDI,2023,440,410,850,57
MASINDI,2024,450,420,870,57
MASINDI,2025,460,430,890,57
MAYUGE,2015,520,610,1130,57
MAYUGE,2016,580,700,1280,57
MAYUGE,2017,670,830,1500,57
MAYUGE,2018,730,930,1660,57
MAYUGE,2019,790,1000,1790,57
MAYUGE,2020,820,1000,1820,57
MAYUGE,2021,820,990,1810,57
MAYUGE,2022,830,940,1770,57
MAYUGE,2023,830,930,1760,57
MAYUGE,2024,870,940,1810,57
MAYUGE,2025,920,1000,1920,57
MBALE,2015,730,880,1610,57
MBALE,2016,820,1030,1850,57
MBALE,2017,930,1200,2130,57
MBALE,2018,1030,1360,2390,57
MBALE,2019,1100,1460,2560,57
MBALE,2020,1130,1470,2600,57
MBALE,2021,1160,1450,2610,57
MBALE,2022,1150,1390,2540,57
MBALE,2023,1170,1370,2540,57
MBALE,2024,1200,1390,2590,57
MBALE,2025,1270,1480,2750,57
MBARARA,2015,410,410,820,57
MBARARA,2016,420,420,840,57
MBARARA,2017,430,430,860,57
MBARARA,2018,440,440,880,57
MBARARA,2019,450,440,890,57
MBARARA,2020,460,450,910,57
MBARARA,2021,470,460,930,57
MBARARA,2022,480,470,950,57
MBARARA,2023,490,480,970,57
MBARARA,2024,500,490,990,57
MBARARA,2025,510,500,1010,57
MITOOMA,2015,250,290,540,57
MITOOMA,2016,250,290,540,57
MITOOMA,2017,260,300,560,57
MITOOMA,2018,260,300,560,57
MITOOMA,2019,260,300,560,57
MITOOMA,2020,260,300,560,57
MITOOMA,2021,270,310,580,57
MITOOMA,2022,270,310,580,57
MITOOMA,2023,270,310,580,57
MITOOMA,2024,270,310,580,57
MITOOMA,2025,280,310,590,57
MITYANA,2015,540,620,1160,57
MITYANA,2016,610,700,1310,57
MITYANA,2017,670,820,1490,57
MITYANA,2018,730,910,1640,57
MITYANA,2019,770,960,1730,57
MITYANA,2020,790,950,1740,57
MITYANA,2021,790,920,1710,57
MITYANA,2022,780,880,1660,57
MITYANA,2023,790,840,1630,57
MITYANA,2024,790,840,1630,57
MITYANA,2025,830,880,1710,57
MOROTO,2015,90,140,230,57
MOROTO,2016,100,160,260,57
MOROTO,2017,110,180,290,57
MOROTO,2018,120,220,340,57
MOROTO,2019,140,230,370,57
MOROTO,2020,140,220,360,57
MOROTO,2021,140,210,350,57
MOROTO,2022,130,210,340,57
MOROTO,2023,130,210,340,57
MOROTO,2024,150,200,350,57
MOROTO,2025,150,230,380,57
MOYO,2015,140,180,320,57
MOYO,2016,140,180,320,57
MOYO,2017,150,190,340,57
MOYO,2018,150,190,340,57
MOYO,2019,160,200,360,57
MOYO,2020,160,200,360,57
MOYO,2021,160,200,360,57
MOYO,2022,170,210,380,57
MOYO,2023,170,210,380,57
MOYO,2024,170,220,390,57
MOYO,2025,180,220,400,57
MPIGI,2015,360,480,840,57
MPIGI,2016,400,560,960,57
MPIGI,2017,450,630,1080,57
MPIGI,2018,490,710,1200,57
MPIGI,2019,530,760,1290,57
MPIGI,2020,540,760,1300,57
MPIGI,2021,550,740,1290,57
MPIGI,2022,530,710,1240,57
MPIGI,2023,540,690,1230,57
MPIGI,2024,560,690,1250,57
MPIGI,2025,590,720,1310,57
MUBENDE,2015,490,490,980,57
MUBENDE,2016,490,470,960,57
MUBENDE,2017,520,500,1020,57
MUBENDE,2018,590,570,1160,57
MUBENDE,2019,690,690,1380,57
MUBENDE,2020,790,820,1610,57
MUBENDE,2021,900,940,1840,57
MUBENDE,2022,980,1020,2000,57
MUBENDE,2023,1030,1060,2090,57
MUBENDE,2024,1070,1060,2130,57
MUBENDE,2025,1090,1030,2120,57
MUKONO,2015,840,980,1820,57
MUKONO,2016,950,1160,2110,57
MUKONO,2017,1070,1350,2420,57
MUKONO,2018,1180,1510,2690,57
MUKONO,2019,1270,1630,2900,57
MUKONO,2020,1300,1640,2940,57
MUKONO,2021,1310,1600,2910,57
MUKONO,2022,1300,1540,2840,57
MUKONO,2023,1310,1500,2810,57
MUKONO,2024,1350,1530,2880,57
MUKONO,2025,1420,1610,3030,57
MADI OKOLLO,2015,230,210,440,57
MADI OKOLLO,2016,240,220,460,57
MADI OKOLLO,2017,250,220,470,57
MADI OKOLLO,2018,250,230,480,57
MADI OKOLLO,2019,260,230,490,57
MADI OKOLLO,2020,270,240,510,57
MADI OKOLLO,2021,270,240,510,57
MADI OKOLLO,2022,280,250,530,57
MADI OKOLLO,2023,290,260,550,57
MADI OKOLLO,2024,290,260,550,57
MADI OKOLLO,2025,300,270,570,57
NABILATUK,2015,30,60,90,57
NABILATUK,2016,50,90,140,57
NABILATUK,2017,60,100,160,57
NABILATUK,2018,60,110,170,57
NABILATUK,2019,60,130,190,57
NABILATUK,2020,60,130,190,57
NABILATUK,2021,60,120,180,57
NABILATUK,2022,70,120,190,57
NABILATUK,2023,70,130,200,57
NABILATUK,2024,70,120,190,57
NABILATUK,2025,80,130,210,57
NAKAPIRIPIRIT,2015,80,80,160,57
NAKAPIRIPIRIT,2016,90,90,180,57
NAKAPIRIPIRIT,2017,110,120,230,57
NAKAPIRIPIRIT,2018,120,130,250,57
NAKAPIRIPIRIT,2019,140,130,270,57
NAKAPIRIPIRIT,2020,140,150,290,57
NAKAPIRIPIRIT,2021,140,140,280,57
NAKAPIRIPIRIT,2022,150,130,280,57
NAKAPIRIPIRIT,2023,150,140,290,57
NAKAPIRIPIRIT,2024,150,140,290,57
NAKAPIRIPIRIT,2025,170,140,310,57
NAKASEKE,2015,250,220,470,57
NAKASEKE,2016,260,220,480,57
NAKASEKE,2017,260,230,490,57
NAKASEKE,2018,270,230,500,57
NAKASEKE,2019,280,240,520,57
NAKASEKE,2020,290,240,530,57
NAKASEKE,2021,300,250,550,57
NAKASEKE,2022,310,250,560,57
NAKASEKE,2023,320,260,580,57
NAKASEKE,2024,330,260,590,57
NAKASEKE,2025,350,270,620,57
NAKASONGOLA,2015,220,230,450,57
NAKASONGOLA,2016,250,280,530,57
NAKASONGOLA,2017,280,320,600,57
NAKASONGOLA,2018,310,360,670,57
NAKASONGOLA,2019,340,400,740,57
NAKASONGOLA,2020,360,390,750,57
NAKASONGOLA,2021,350,390,740,57
NAKASONGOLA,2022,350,360,710,57
NAKASONGOLA,2023,360,360,720,57
NAKASONGOLA,2024,370,360,730,57
NAKASONGOLA,2025,390,390,780,57
NAMAYINGO,2015,270,260,530,57
NAMAYINGO,2016,300,290,590,57
NAMAYINGO,2017,330,350,680,57
NAMAYINGO,2018,370,380,750,57
NAMAYINGO,2019,390,400,790,57
NAMAYINGO,2020,390,410,800,57
NAMAYINGO,2021,400,390,790,57
NAMAYINGO,2022,380,360,740,57
NAMAYINGO,2023,390,350,740,57
NAMAYINGO,2024,400,360,760,57
NAMAYINGO,2025,420,370,790,57
NAMISINDWA,2015,280,300,580,57
NAMISINDWA,2016,290,310,600,57
NAMISINDWA,2017,290,320,610,57
NAMISINDWA,2018,300,320,620,57
NAMISINDWA,2019,310,330,640,57
NAMISINDWA,2020,320,340,660,57
NAMISINDWA,2021,330,350,680,57
NAMISINDWA,2022,340,350,690,57
NAMISINDWA,2023,340,360,700,57
NAMISINDWA,2024,350,370,720,57
NAMISINDWA,2025,360,370,730,57
NAMUTUMBA,2015,280,350,630,57
NAMUTUMBA,2016,320,410,730,57
NAMUTUMBA,2017,360,480,840,57
NAMUTUMBA,2018,400,550,950,57
NAMUTUMBA,2019,430,570,1000,57
NAMUTUMBA,2020,450,580,1030,57
NAMUTUMBA,2021,460,560,1020,57
NAMUTUMBA,2022,460,550,1010,57
NAMUTUMBA,2023,470,540,1010,57
NAMUTUMBA,2024,480,550,1030,57
NAMUTUMBA,2025,510,580,1090,57
NAPAK,2015,120,190,310,57
NAPAK,2016,140,230,370,57
NAPAK,2017,150,270,420,57
NAPAK,2018,160,290,450,57
NAPAK,2019,170,320,490,57
NAPAK,2020,170,320,490,57
NAPAK,2021,170,300,470,57
NAPAK,2022,180,300,480,57
NAPAK,2023,170,280,450,57
NAPAK,2024,180,280,460,57
NAPAK,2025,180,290,470,57
NEBBI,2015,330,370,700,57
NEBBI,2016,340,380,720,57
NEBBI,2017,350,390,740,57
NEBBI,2018,360,400,760,57
NEBBI,2019,370,410,780,57
NEBBI,2020,390,420,810,57
NEBBI,2021,400,440,840,57
NEBBI,2022,410,450,860,57
NEBBI,2023,420,460,880,57
NEBBI,2024,430,470,900,57
NEBBI,2025,440,480,920,57
NGORA,2015,170,270,440,57
NGORA,2016,200,310,510,57
NGORA,2017,220,370,590,57
NGORA,2018,250,420,670,57
NGORA,2019,260,430,690,57
NGORA,2020,280,450,730,57
NGORA,2021,270,420,690,57
NGORA,2022,280,410,690,57
NGORA,2023,280,390,670,57
NGORA,2024,280,410,690,57
NGORA,2025,300,430,730,57
NTOROKO,2015,90,60,150,57
NTOROKO,2016,100,90,190,57
NTOROKO,2017,130,100,230,57
NTOROKO,2018,130,110,240,57
NTOROKO,2019,140,110,250,57
NTOROKO,2020,140,110,250,57
NTOROKO,2021,140,110,250,57
NTOROKO,2022,150,100,250,57
NTOROKO,2023,150,90,240,57
NTOROKO,2024,150,90,240,57
NTOROKO,2025,150,100,250,57
NTUNGAMO,2015,680,750,1430,57
NTUNGAMO,2016,690,770,1460,57
NTUNGAMO,2017,710,780,1490,57
NTUNGAMO,2018,720,800,1520,57
NTUNGAMO,2019,740,810,1550,57
NTUNGAMO,2020,750,820,1570,57
NTUNGAMO,2021,770,840,1610,57
NTUNGAMO,2022,780,850,1630,57
NTUNGAMO,2023,800,860,1660,57
NTUNGAMO,2024,810,880,1690,57
NTUNGAMO,2025,820,890,1710,57
NWOYA,2015,160,160,320,57
NWOYA,2016,180,180,360,57
NWOYA,2017,200,190,390,57
NWOYA,2018,220,210,430,57
NWOYA,2019,240,240,480,57
NWOYA,2020,260,260,520,57
NWOYA,2021,290,290,580,57
NWOYA,2022,320,310,630,57
NWOYA,2023,350,340,690,57
NWOYA,2024,390,380,770,57
NWOYA,2025,430,420,850,57
OBONGI,2015,60,50,110,57
OBONGI,2016,80,60,140,57
OBONGI,2017,80,70,150,57
OBONGI,2018,90,70,160,57
OBONGI,2019,90,90,180,57
OBONGI,2020,90,90,180,57
OBONGI,2021,90,90,180,57
OBONGI,2022,90,80,170,57
OBONGI,2023,100,80,180,57
OBONGI,2024,100,80,180,57
OBONGI,2025,110,80,190,57
OMORO,2015,290,260,550,57
OMORO,2016,330,310,640,57
OMORO,2017,380,370,750,57
OMORO,2018,420,400,820,57
OMORO,2019,450,430,880,57
OMORO,2020,470,450,920,57
OMORO,2021,470,440,910,57
OMORO,2022,470,410,880,57
OMORO,2023,480,410,890,57
OMORO,2024,500,420,920,57
OMORO,2025,530,450,980,57
OTUKE,2015,140,140,280,57
OTUKE,2016,150,140,290,57
OTUKE,2017,150,150,300,57
OTUKE,2018,160,150,310,57
OTUKE,2019,170,160,330,57
OTUKE,2020,170,170,340,57
OTUKE,2021,180,170,350,57
OTUKE,2022,190,180,370,57
OTUKE,2023,200,190,390,57
OTUKE,2024,200,200,400,57
OTUKE,2025,210,200,410,57
OYAM,2015,450,480,930,57
OYAM,2016,470,490,960,57
OYAM,2017,480,500,980,57
OYAM,2018,490,520,1010,57
OYAM,2019,510,530,1040,57
OYAM,2020,520,550,1070,57
OYAM,2021,540,560,1100,57
OYAM,2022,550,580,1130,57
OYAM,2023,570,590,1160,57
OYAM,2024,580,610,1190,57
OYAM,2025,600,620,1220,57
PADER,2015,220,270,490,57
PADER,2016,250,320,570,57
PADER,2017,280,370,650,57
PADER,2018,300,400,700,57
PADER,2019,320,430,750,57
PADER,2020,330,430,760,57
PADER,2021,320,420,740,57
PADER,2022,330,400,730,57
PADER,2023,320,380,700,57
PADER,2024,320,390,710,57
PADER,2025,330,400,730,57
PAKWACH,2015,170,200,370,57
PAKWACH,2016,180,200,380,57
PAKWACH,2017,190,210,400,57
PAKWACH,2018,200,220,420,57
PAKWACH,2019,210,230,440,57
PAKWACH,2020,210,230,440,57
PAKWACH,2021,220,240,460,57
PAKWACH,2022,230,250,480,57
PAKWACH,2023,240,260,500,57
PAKWACH,2024,250,270,520,57
PAKWACH,2025,260,280,540,57
PALLISA,2015,300,350,650,57
PALLISA,2016,340,410,750,57
PALLISA,2017,390,480,870,57
PALLISA,2018,450,550,1000,57
PALLISA,2019,480,590,1070,57
PALLISA,2020,500,610,1110,57
PALLISA,2021,520,600,1120,57
PALLISA,2022,520,580,1100,57
PALLISA,2023,540,580,1120,57
PALLISA,2024,560,590,1150,57
PALLISA,2025,600,640,1240,57
RAKAI,2015,380,460,840,57
RAKAI,2016,430,530,960,57
RAKAI,2017,490,620,1110,57
RAKAI,2018,540,690,1230,57
RAKAI,2019,560,740,1300,57
RAKAI,2020,570,740,1310,57
RAKAI,2021,580,720,1300,57
RAKAI,2022,580,680,1260,57
RAKAI,2023,580,660,1240,57
RAKAI,2024,600,670,1270,57
RAKAI,2025,630,710,1340,57
RUBANDA,2015,270,280,550,57
RUBANDA,2016,270,280,550,57
RUBANDA,2017,270,280,550,57
RUBANDA,2018,280,290,570,57
RUBANDA,2019,280,290,570,57
RUBANDA,2020,280,290,570,57
RUBANDA,2021,290,290,580,57
RUBANDA,2022,290,290,580,57
RUBANDA,2023,290,290,580,57
RUBANDA,2024,290,300,590,57
RUBANDA,2025,300,300,600,57
RUBIRIZI,2015,180,190,370,57
RUBIRIZI,2016,180,190,370,57
RUBIRIZI,2017,190,200,390,57
RUBIRIZI,2018,190,200,390,57
RUBIRIZI,2019,200,200,400,57
RUBIRIZI,2020,200,210,410,57
RUBIRIZI,2021,200,210,410,57
RUBIRIZI,2022,210,220,430,57
RUBIRIZI,2023,210,220,430,57
RUBIRIZI,2024,210,220,430,57
RUBIRIZI,2025,220,220,440,57
RUKIGA,2015,180,190,370,57
RUKIGA,2016,190,200,390,57
RUKIGA,2017,190,200,390,57
RUKIGA,2018,190,200,390,57
RUKIGA,2019,190,200,390,57
RUKIGA,2020,190,200,390,57
RUKIGA,2021,190,200,390,57
RUKIGA,2022,200,200,400,57
RUKIGA,2023,200,200,400,57
RUKIGA,2024,200,200,400,57
RUKIGA,2025,200,200,400,57
RUKUNGIRI,2015,500,560,1060,57
RUKUNGIRI,2016,500,570,1070,57
RUKUNGIRI,2017,510,570,1080,57
RUKUNGIRI,2018,520,580,1100,57
RUKUNGIRI,2019,520,580,1100,57
RUKUNGIRI,2020,530,590,1120,57
RUKUNGIRI,2021,530,590,1120,57
RUKUNGIRI,2022,540,600,1140,57
RUKUNGIRI,2023,540,600,1140,57
RUKUNGIRI,2024,550,600,1150,57
RUKUNGIRI,2025,550,610,1160,57
RWAMPARA,2015,200,200,400,57
RWAMPARA,2016,200,210,410,57
RWAMPARA,2017,210,210,420,57
RWAMPARA,2018,210,220,430,57
RWAMPARA,2019,220,220,440,57
RWAMPARA,2020,220,220,440,57
RWAMPARA,2021,230,230,460,57
RWAMPARA,2022,230,230,460,57
RWAMPARA,2023,230,240,470,57
RWAMPARA,2024,240,240,480,57
RWAMPARA,2025,240,250,490,57
SERERE,2015,350,410,760,57
SERERE,2016,390,500,890,57
SERERE,2017,460,580,1040,57
SERERE,2018,510,650,1160,57
SERERE,2019,540,720,1260,57
SERERE,2020,570,730,1300,57
SERERE,2021,580,720,1300,57
SERERE,2022,590,690,1280,57
SERERE,2023,600,690,1290,57
SERERE,2024,630,700,1330,57
SERERE,2025,660,760,1420,57
SHEEMA,2015,320,320,640,57
SHEEMA,2016,320,320,640,57
SHEEMA,2017,330,330,660,57
SHEEMA,2018,330,330,660,57
SHEEMA,2019,340,330,670,57
SHEEMA,2020,340,340,680,57
SHEEMA,2021,340,340,680,57
SHEEMA,2022,350,340,690,57
SHEEMA,2023,350,350,700,57
SHEEMA,2024,350,350,700,57
SHEEMA,2025,350,350,700,57
SIRONKO,2015,470,430,900,57
SIRONKO,2016,480,440,920,57
SIRONKO,2017,490,450,940,57
SIRONKO,2018,500,450,950,57
SIRONKO,2019,510,460,970,57
SIRONKO,2020,520,470,990,57
SIRONKO,2021,530,480,1010,57
SIRONKO,2022,550,490,1040,57
SIRONKO,2023,560,500,1060,57
SIRONKO,2024,570,500,1070,57
SIRONKO,2025,580,510,1090,57
SOROTI,2015,390,400,790,57
SOROTI,2016,460,470,930,57
SOROTI,2017,510,550,1060,57
SOROTI,2018,570,620,1190,57
SOROTI,2019,620,680,1300,57
SOROTI,2020,640,690,1330,57
SOROTI,2021,650,670,1320,57
SOROTI,2022,650,640,1290,57
SOROTI,2023,670,630,1300,57
SOROTI,2024,690,650,1340,57
SOROTI,2025,740,690,1430,57
SSEMBABULE,2015,370,410,780,57
SSEMBABULE,2016,420,480,900,57
SSEMBABULE,2017,470,570,1040,57
SSEMBABULE,2018,520,640,1160,57
SSEMBABULE,2019,560,660,1220,57
SSEMBABULE,2020,570,670,1240,57
SSEMBABULE,2021,580,650,1230,57
SSEMBABULE,2022,580,630,1210,57
SSEMBABULE,2023,580,620,1200,57
SSEMBABULE,2024,600,620,1220,57
SSEMBABULE,2025,630,660,1290,57
TORORO,2015,760,760,1520,57
TORORO,2016,780,780,1560,57
TORORO,2017,800,790,1590,57
TORORO,2018,820,810,1630,57
TORORO,2019,840,830,1670,57
TORORO,2020,870,850,1720,57
TORORO,2021,890,870,1760,57
TORORO,2022,910,890,1800,57
TORORO,2023,930,910,1840,57
TORORO,2024,950,930,1880,57
TORORO,2025,970,950,1920,57
WAKISO,2015,1660,1830,3490,57
WAKISO,2016,1770,1960,3730,57
WAKISO,2017,1890,2090,3980,57
WAKISO,2018,2010,2230,4240,57
WAKISO,2019,2140,2380,4520,57
WAKISO,2020,2280,2540,4820,57
WAKISO,2021,2430,2710,5140,57
WAKISO,2022,2590,2890,5480,57
WAKISO,2023,2750,3070,5820,57
WAKISO,2024,2920,3270,6190,57
WAKISO,2025,3100,3480,6580,57
YUMBE,2015,400,520,920,57
YUMBE,2016,470,620,1090,57
YUMBE,2017,540,750,1290,57
YUMBE,2018,610,870,1480,57
YUMBE,2019,670,950,1620,57
YUMBE,2020,700,990,1690,57
YUMBE,2021,710,990,1700,57
YUMBE,2022,740,980,1720,57
YUMBE,2023,760,990,1750,57
YUMBE,2024,810,1030,1840,57
YUMBE,2025,860,1130,1990,57
ZOMBO,2015,310,300,610,57
ZOMBO,2016,320,310,630,57
ZOMBO,2017,330,320,650,57
ZOMBO,2018,340,330,670,57
ZOMBO,2019,350,340,690,57
ZOMBO,2020,360,350,710,57
ZOMBO,2021,370,360,730,57
ZOMBO,2022,380,370,750,57
ZOMBO,2023,390,380,770,57
ZOMBO,2024,400,380,780,57
ZOMBO,2025,410,390,800,57
ABIM,2015,120,130,250,58
ABIM,2016,130,150,280,58
ABIM,2017,150,180,330,58
ABIM,2018,180,220,400,58
ABIM,2019,210,250,460,58
ABIM,2020,230,280,510,58
ABIM,2021,240,290,530,58
ABIM,2022,250,290,540,58
ABIM,2023,270,280,550,58
ABIM,2024,280,280,560,58
ABIM,2025,290,290,580,58
ADJUMANI,2015,220,340,560,58
ADJUMANI,2016,220,340,560,58
ADJUMANI,2017,220,350,570,58
ADJUMANI,2018,230,350,580,58
ADJUMANI,2019,230,350,580,58
ADJUMANI,2020,230,360,590,58
ADJUMANI,2021,230,360,590,58
ADJUMANI,2022,230,360,590,58
ADJUMANI,2023,230,360,590,58
ADJUMANI,2024,230,370,600,58
ADJUMANI,2025,230,370,600,58
AGAGO,2015,290,370,660,58
AGAGO,2016,300,380,680,58
AGAGO,2017,310,380,690,58
AGAGO,2018,310,390,700,58
AGAGO,2019,320,400,720,58
AGAGO,2020,320,400,720,58
AGAGO,2021,330,410,740,58
AGAGO,2022,330,420,750,58
AGAGO,2023,340,420,760,58
AGAGO,2024,340,430,770,58
AGAGO,2025,340,430,770,58
ALEBTONG,2015,320,350,670,58
ALEBTONG,2016,350,390,740,58
ALEBTONG,2017,400,470,870,58
ALEBTONG,2018,460,540,1000,58
ALEBTONG,2019,500,610,1110,58
ALEBTONG,2020,540,650,1190,58
ALEBTONG,2021,550,650,1200,58
ALEBTONG,2022,550,630,1180,58
ALEBTONG,2023,550,600,1150,58
ALEBTONG,2024,560,590,1150,58
ALEBTONG,2025,570,590,1160,58
AMOLATAR,2015,200,180,380,58
AMOLATAR,2016,220,210,430,58
AMOLATAR,2017,240,240,480,58
AMOLATAR,2018,280,280,560,58
AMOLATAR,2019,300,310,610,58
AMOLATAR,2020,320,340,660,58
AMOLATAR,2021,340,330,670,58
AMOLATAR,2022,330,330,660,58
AMOLATAR,2023,330,310,640,58
AMOLATAR,2024,330,310,640,58
AMOLATAR,2025,340,300,640,58
AMUDAT,2015,110,80,190,58
AMUDAT,2016,120,100,220,58
AMUDAT,2017,140,110,250,58
AMUDAT,2018,160,140,300,58
AMUDAT,2019,180,160,340,58
AMUDAT,2020,190,180,370,58
AMUDAT,2021,200,170,370,58
AMUDAT,2022,200,180,380,58
AMUDAT,2023,210,170,380,58
AMUDAT,2024,220,170,390,58
AMUDAT,2025,220,170,390,58
AMURIA,2015,220,250,470,58
AMURIA,2016,250,280,530,58
AMURIA,2017,280,330,610,58
AMURIA,2018,320,390,710,58
AMURIA,2019,360,440,800,58
AMURIA,2020,390,470,860,58
AMURIA,2021,400,480,880,58
AMURIA,2022,410,470,880,58
AMURIA,2023,420,450,870,58
AMURIA,2024,430,440,870,58
AMURIA,2025,450,460,910,58
AMURU,2015,200,270,470,58
AMURU,2016,220,310,530,58
AMURU,2017,240,360,600,58
AMURU,2018,280,430,710,58
AMURU,2019,300,480,780,58
AMURU,2020,320,510,830,58
AMURU,2021,340,510,850,58
AMURU,2022,330,490,820,58
AMURU,2023,330,480,810,58
AMURU,2024,330,470,800,58
AMURU,2025,340,470,810,58
APAC,2015,230,200,430,58
APAC,2016,240,210,450,58
APAC,2017,250,220,470,58
APAC,2018,250,230,480,58
APAC,2019,260,230,490,58
APAC,2020,270,240,510,58
APAC,2021,280,250,530,58
APAC,2022,290,260,550,58
APAC,2023,300,270,570,58
APAC,2024,310,270,580,58
APAC,2025,320,280,600,58
ARUA,2015,940,1310,2250,58
ARUA,2016,960,1340,2300,58
ARUA,2017,990,1380,2370,58
ARUA,2018,1020,1420,2440,58
ARUA,2019,1050,1450,2500,58
ARUA,2020,1080,1490,2570,58
ARUA,2021,1100,1530,2630,58
ARUA,2022,1130,1560,2690,58
ARUA,2023,1160,1600,2760,58
ARUA,2024,1190,1640,2830,58
ARUA,2025,1220,1680,2900,58
BUDAKA,2015,250,290,540,58
BUDAKA,2016,280,330,610,58
BUDAKA,2017,320,390,710,58
BUDAKA,2018,360,450,810,58
BUDAKA,2019,400,510,910,58
BUDAKA,2020,430,540,970,58
BUDAKA,2021,440,550,990,58
BUDAKA,2022,460,550,1010,58
BUDAKA,2023,460,530,990,58
BUDAKA,2024,470,520,990,58
BUDAKA,2025,480,520,1000,58
BUDUDA,2015,380,270,650,58
BUDUDA,2016,430,320,750,58
BUDUDA,2017,490,380,870,58
BUDUDA,2018,570,450,1020,58
BUDUDA,2019,630,510,1140,58
BUDUDA,2020,700,560,1260,58
BUDUDA,2021,720,560,1280,58
BUDUDA,2022,740,560,1300,58
BUDUDA,2023,760,550,1310,58
BUDUDA,2024,770,540,1310,58
BUDUDA,2025,810,560,1370,58
BUGIRI,2015,450,460,910,58
BUGIRI,2016,500,520,1020,58
BUGIRI,2017,570,610,1180,58
BUGIRI,2018,650,720,1370,58
BUGIRI,2019,720,820,1540,58
BUGIRI,2020,790,900,1690,58
BUGIRI,2021,820,910,1730,58
BUGIRI,2022,830,890,1720,58
BUGIRI,2023,850,860,1710,58
BUGIRI,2024,860,860,1720,58
BUGIRI,2025,900,870,1770,58
BUGWERI,2015,170,190,360,58
BUGWERI,2016,180,220,400,58
BUGWERI,2017,210,250,460,58
BUGWERI,2018,230,300,530,58
BUGWERI,2019,260,330,590,58
BUGWERI,2020,270,350,620,58
BUGWERI,2021,280,350,630,58
BUGWERI,2022,280,340,620,58
BUGWERI,2023,280,330,610,58
BUGWERI,2024,280,320,600,58
BUGWERI,2025,290,330,620,58
BUHWEJU,2015,170,200,370,58
BUHWEJU,2016,180,200,380,58
BUHWEJU,2017,180,210,390,58
BUHWEJU,2018,190,220,410,58
BUHWEJU,2019,190,220,410,58
BUHWEJU,2020,200,230,430,58
BUHWEJU,2021,210,240,450,58
BUHWEJU,2022,210,240,450,58
BUHWEJU,2023,220,250,470,58
BUHWEJU,2024,230,260,490,58
BUHWEJU,2025,230,260,490,58
BUIKWE,2015,500,520,1020,58
BUIKWE,2016,550,580,1130,58
BUIKWE,2017,610,670,1280,58
BUIKWE,2018,700,770,1470,58
BUIKWE,2019,760,880,1640,58
BUIKWE,2020,800,930,1730,58
BUIKWE,2021,820,930,1750,58
BUIKWE,2022,820,890,1710,58
BUIKWE,2023,810,850,1660,58
BUIKWE,2024,810,820,1630,58
BUIKWE,2025,830,830,1660,58
BUKEDEA,2015,240,300,540,58
BUKEDEA,2016,270,340,610,58
BUKEDEA,2017,310,410,720,58
BUKEDEA,2018,360,480,840,58
BUKEDEA,2019,400,550,950,58
BUKEDEA,2020,430,590,1020,58
BUKEDEA,2021,460,610,1070,58
BUKEDEA,2022,460,590,1050,58
BUKEDEA,2023,470,580,1050,58
BUKEDEA,2024,480,580,1060,58
BUKEDEA,2025,510,580,1090,58
BUKOMANSIMBI,2015,210,320,530,58
BUKOMANSIMBI,2016,230,360,590,58
BUKOMANSIMBI,2017,250,410,660,58
BUKOMANSIMBI,2018,280,460,740,58
BUKOMANSIMBI,2019,300,510,810,58
BUKOMANSIMBI,2020,320,530,850,58
BUKOMANSIMBI,2021,320,520,840,58
BUKOMANSIMBI,2022,320,490,810,58
BUKOMANSIMBI,2023,310,460,770,58
BUKOMANSIMBI,2024,300,440,740,58
BUKOMANSIMBI,2025,310,440,750,58
BUKWO,2015,150,150,300,58
BUKWO,2016,150,160,310,58
BUKWO,2017,160,170,330,58
BUKWO,2018,170,180,350,58
BUKWO,2019,180,180,360,58
BUKWO,2020,190,190,380,58
BUKWO,2021,200,200,400,58
BUKWO,2022,210,210,420,58
BUKWO,2023,220,220,440,58
BUKWO,2024,230,230,460,58
BUKWO,2025,240,240,480,58
BULAMBULI,2015,310,330,640,58
BULAMBULI,2016,350,380,730,58
BULAMBULI,2017,390,440,830,58
BULAMBULI,2018,460,530,990,58
BULAMBULI,2019,520,610,1130,58
BULAMBULI,2020,560,660,1220,58
BULAMBULI,2021,590,680,1270,58
BULAMBULI,2022,610,690,1300,58
BULAMBULI,2023,620,670,1290,58
BULAMBULI,2024,650,660,1310,58
BULAMBULI,2025,670,690,1360,58
BULIISA,2015,150,150,300,58
BULIISA,2016,150,160,310,58
BULIISA,2017,160,170,330,58
BULIISA,2018,170,170,340,58
BULIISA,2019,180,180,360,58
BULIISA,2020,190,190,380,58
BULIISA,2021,200,200,400,58
BULIISA,2022,210,200,410,58
BULIISA,2023,220,210,430,58
BULIISA,2024,230,220,450,58
BULIISA,2025,240,230,470,58
BUNDIBUGYO,2015,270,230,500,58
BUNDIBUGYO,2016,300,260,560,58
BUNDIBUGYO,2017,340,310,650,58
BUNDIBUGYO,2018,380,360,740,58
BUNDIBUGYO,2019,430,400,830,58
BUNDIBUGYO,2020,460,430,890,58
BUNDIBUGYO,2021,470,430,900,58
BUNDIBUGYO,2022,470,410,880,58
BUNDIBUGYO,2023,470,400,870,58
BUNDIBUGYO,2024,480,390,870,58
BUNDIBUGYO,2025,480,400,880,58
BUNYANGABU,2015,220,270,490,58
BUNYANGABU,2016,240,290,530,58
BUNYANGABU,2017,270,340,610,58
BUNYANGABU,2018,310,400,710,58
BUNYANGABU,2019,340,440,780,58
BUNYANGABU,2020,360,470,830,58
BUNYANGABU,2021,380,460,840,58
BUNYANGABU,2022,370,450,820,58
BUNYANGABU,2023,370,440,810,58
BUNYANGABU,2024,370,420,790,58
BUNYANGABU,2025,380,420,800,58
BUSHENYI,2015,360,400,760,58
BUSHENYI,2016,360,400,760,58
BUSHENYI,2017,360,410,770,58
BUSHENYI,2018,370,410,780,58
BUSHENYI,2019,370,410,780,58
BUSHENYI,2020,380,420,800,58
BUSHENYI,2021,380,420,800,58
BUSHENYI,2022,380,420,800,58
BUSHENYI,2023,390,430,820,58
BUSHENYI,2024,390,430,820,58
BUSHENYI,2025,390,430,820,58
BUSIA,2015,380,460,840,58
BUSIA,2016,420,510,930,58
BUSIA,2017,470,590,1060,58
BUSIA,2018,540,700,1240,58
BUSIA,2019,590,780,1370,58
BUSIA,2020,640,840,1480,58
BUSIA,2021,660,840,1500,58
BUSIA,2022,670,820,1490,58
BUSIA,2023,670,780,1450,58
BUSIA,2024,670,770,1440,58
BUSIA,2025,700,780,1480,58
BUTALEJA,2015,290,360,650,58
BUTALEJA,2016,320,400,720,58
BUTALEJA,2017,360,480,840,58
BUTALEJA,2018,410,550,960,58
BUTALEJA,2019,460,640,1100,58
BUTALEJA,2020,500,680,1180,58
BUTALEJA,2021,510,690,1200,58
BUTALEJA,2022,530,670,1200,58
BUTALEJA,2023,530,660,1190,58
BUTALEJA,2024,530,640,1170,58
BUTALEJA,2025,560,660,1220,58
BUTAMBALA,2015,130,160,290,58
BUTAMBALA,2016,150,170,320,58
BUTAMBALA,2017,160,200,360,58
BUTAMBALA,2018,180,230,410,58
BUTAMBALA,2019,190,250,440,58
BUTAMBALA,2020,200,260,460,58
BUTAMBALA,2021,210,260,470,58
BUTAMBALA,2022,210,250,460,58
BUTAMBALA,2023,210,240,450,58
BUTAMBALA,2024,200,230,430,58
BUTAMBALA,2025,200,230,430,58
BUTEBO,2015,110,130,240,58
BUTEBO,2016,130,150,280,58
BUTEBO,2017,140,170,310,58
BUTEBO,2018,160,190,350,58
BUTEBO,2019,170,210,380,58
BUTEBO,2020,190,220,410,58
BUTEBO,2021,190,220,410,58
BUTEBO,2022,180,220,400,58
BUTEBO,2023,180,210,390,58
BUTEBO,2024,180,200,380,58
BUTEBO,2025,180,190,370,58
BUVUMA,2015,130,60,190,58
BUVUMA,2016,140,70,210,58
BUVUMA,2017,150,70,220,58
BUVUMA,2018,160,80,240,58
BUVUMA,2019,170,80,250,58
BUVUMA,2020,180,90,270,58
BUVUMA,2021,190,90,280,58
BUVUMA,2022,200,100,300,58
BUVUMA,2023,210,110,320,58
BUVUMA,2024,230,110,340,58
BUVUMA,2025,240,120,360,58
BUYENDE,2015,320,270,590,58
BUYENDE,2016,350,320,670,58
BUYENDE,2017,400,380,780,58
BUYENDE,2018,460,440,900,58
BUYENDE,2019,520,510,1030,58
BUYENDE,2020,560,540,1100,58
BUYENDE,2021,590,560,1150,58
BUYENDE,2022,610,550,1160,58
BUYENDE,2023,620,540,1160,58
BUYENDE,2024,620,540,1160,58
BUYENDE,2025,650,550,1200,58
DOKOLO,2015,320,300,620,58
DOKOLO,2016,330,310,640,58
DOKOLO,2017,340,320,660,58
DOKOLO,2018,350,330,680,58
DOKOLO,2019,360,340,700,58
DOKOLO,2020,370,350,720,58
DOKOLO,2021,380,360,740,58
DOKOLO,2022,390,360,750,58
DOKOLO,2023,400,370,770,58
DOKOLO,2024,410,380,790,58
DOKOLO,2025,420,390,810,58
GOMBA,2015,220,270,490,58
GOMBA,2016,240,300,540,58
GOMBA,2017,270,340,610,58
GOMBA,2018,300,400,700,58
GOMBA,2019,340,440,780,58
GOMBA,2020,350,460,810,58
GOMBA,2021,360,460,820,58
GOMBA,2022,360,440,800,58
GOMBA,2023,350,410,760,58
GOMBA,2024,350,390,740,58
GOMBA,2025,360,400,760,58
GULU,2015,310,400,710,58
GULU,2016,320,410,730,58
GULU,2017,330,430,760,58
GULU,2018,340,440,780,58
GULU,2019,350,450,800,58
GULU,2020,360,460,820,58
GULU,2021,370,480,850,58
GULU,2022,380,490,870,58
GULU,2023,390,500,890,58
GULU,2024,400,510,910,58
GULU,2025,410,530,940,58
HOIMA,2015,350,410,760,58
HOIMA,2016,360,420,780,58
HOIMA,2017,380,440,820,58
HOIMA,2018,390,450,840,58
HOIMA,2019,410,470,880,58
HOIMA,2020,420,480,900,58
HOIMA,2021,440,500,940,58
HOIMA,2022,450,520,970,58
HOIMA,2023,470,530,1000,58
HOIMA,2024,480,550,1030,58
HOIMA,2025,500,560,1060,58
IBANDA,2015,400,470,870,58
IBANDA,2016,410,480,890,58
IBANDA,2017,420,490,910,58
IBANDA,2018,420,500,920,58
IBANDA,2019,430,510,940,58
IBANDA,2020,440,520,960,58
IBANDA,2021,450,520,970,58
IBANDA,2022,460,530,990,58
IBANDA,2023,460,540,1000,58
IBANDA,2024,470,550,1020,58
IBANDA,2025,480,550,1030,58
IGANGA,2015,290,360,650,58
IGANGA,2016,320,400,720,58
IGANGA,2017,360,480,840,58
IGANGA,2018,410,550,960,58
IGANGA,2019,450,620,1070,58
IGANGA,2020,480,660,1140,58
IGANGA,2021,510,670,1180,58
IGANGA,2022,510,650,1160,58
IGANGA,2023,510,630,1140,58
IGANGA,2024,520,610,1130,58
IGANGA,2025,530,620,1150,58
ISINGIRO,2015,630,670,1300,58
ISINGIRO,2016,660,700,1360,58
ISINGIRO,2017,680,720,1400,58
ISINGIRO,2018,710,750,1460,58
ISINGIRO,2019,730,770,1500,58
ISINGIRO,2020,760,800,1560,58
ISINGIRO,2021,790,830,1620,58
ISINGIRO,2022,810,850,1660,58
ISINGIRO,2023,840,880,1720,58
ISINGIRO,2024,870,910,1780,58
ISINGIRO,2025,900,940,1840,58
JINJA,2015,490,580,1070,58
JINJA,2016,490,590,1080,58
JINJA,2017,500,600,1100,58
JINJA,2018,510,600,1110,58
JINJA,2019,520,610,1130,58
JINJA,2020,530,620,1150,58
JINJA,2021,530,630,1160,58
JINJA,2022,540,640,1180,58
JINJA,2023,550,650,1200,58
JINJA,2024,560,650,1210,58
JINJA,2025,560,660,1220,58
KAABONG,2015,80,230,310,58
KAABONG,2016,90,240,330,58
KAABONG,2017,90,240,330,58
KAABONG,2018,90,250,340,58
KAABONG,2019,90,250,340,58
KAABONG,2020,100,260,360,58
KAABONG,2021,100,260,360,58
KAABONG,2022,100,270,370,58
KAABONG,2023,100,280,380,58
KAABONG,2024,110,280,390,58
KAABONG,2025,110,290,400,58
KABALE,2015,370,430,800,58
KABALE,2016,380,440,820,58
KABALE,2017,390,440,830,58
KABALE,2018,390,450,840,58
KABALE,2019,400,450,850,58
KABALE,2020,400,460,860,58
KABALE,2021,410,460,870,58
KABALE,2022,410,470,880,58
KABALE,2023,420,470,890,58
KABALE,2024,420,470,890,58
KABALE,2025,430,480,910,58
KABAROLE,2015,410,440,850,58
KABAROLE,2016,420,450,870,58
KABAROLE,2017,430,460,890,58
KABAROLE,2018,440,460,900,58
KABAROLE,2019,450,470,920,58
KABAROLE,2020,460,480,940,58
KABAROLE,2021,470,490,960,58
KABAROLE,2022,480,500,980,58
KABAROLE,2023,490,510,1000,58
KABAROLE,2024,500,520,1020,58
KABAROLE,2025,500,530,1030,58
KABERAMAIDO,2015,110,120,230,58
KABERAMAIDO,2016,120,130,250,58
KABERAMAIDO,2017,140,160,300,58
KABERAMAIDO,2018,170,180,350,58
KABERAMAIDO,2019,180,210,390,58
KABERAMAIDO,2020,200,220,420,58
KABERAMAIDO,2021,200,230,430,58
KABERAMAIDO,2022,210,230,440,58
KABERAMAIDO,2023,220,220,440,58
KABERAMAIDO,2024,220,220,440,58
KABERAMAIDO,2025,230,220,450,58
KAGADI,2015,380,470,850,58
KAGADI,2016,400,490,890,58
KAGADI,2017,410,510,920,58
KAGADI,2018,430,530,960,58
KAGADI,2019,440,540,980,58
KAGADI,2020,460,560,1020,58
KAGADI,2021,470,580,1050,58
KAGADI,2022,490,600,1090,58
KAGADI,2023,510,620,1130,58
KAGADI,2024,520,640,1160,58
KAGADI,2025,540,660,1200,58
KAKUMIRO,2015,350,370,720,58
KAKUMIRO,2016,380,400,780,58
KAKUMIRO,2017,420,430,850,58
KAKUMIRO,2018,450,470,920,58
KAKUMIRO,2019,490,500,990,58
KAKUMIRO,2020,540,550,1090,58
KAKUMIRO,2021,580,590,1170,58
KAKUMIRO,2022,630,640,1270,58
KAKUMIRO,2023,690,690,1380,58
KAKUMIRO,2024,740,750,1490,58
KAKUMIRO,2025,800,800,1600,58
KALAKI,2015,130,110,240,58
KALAKI,2016,130,120,250,58
KALAKI,2017,140,120,260,58
KALAKI,2018,140,130,270,58
KALAKI,2019,150,130,280,58
KALAKI,2020,160,140,300,58
KALAKI,2021,160,140,300,58
KALAKI,2022,170,150,320,58
KALAKI,2023,180,150,330,58
KALAKI,2024,180,160,340,58
KALAKI,2025,190,160,350,58
KALANGALA,2015,80,30,110,58
KALANGALA,2016,90,30,120,58
KALANGALA,2017,90,40,130,58
KALANGALA,2018,90,40,130,58
KALANGALA,2019,100,40,140,58
KALANGALA,2020,100,40,140,58
KALANGALA,2021,100,40,140,58
KALANGALA,2022,110,40,150,58
KALANGALA,2023,110,50,160,58
KALANGALA,2024,110,50,160,58
KALANGALA,2025,120,50,170,58
KALIRO,2015,260,280,540,58
KALIRO,2016,290,320,610,58
KALIRO,2017,330,390,720,58
KALIRO,2018,370,450,820,58
KALIRO,2019,410,510,920,58
KALIRO,2020,460,540,1000,58
KALIRO,2021,470,550,1020,58
KALIRO,2022,470,540,1010,58
KALIRO,2023,470,530,1000,58
KALIRO,2024,480,520,1000,58
KALIRO,2025,500,520,1020,58
KALUNGU,2015,270,330,600,58
KALUNGU,2016,300,360,660,58
KALUNGU,2017,330,410,740,58
KALUNGU,2018,360,480,840,58
KALUNGU,2019,400,520,920,58
KALUNGU,2020,420,540,960,58
KALUNGU,2021,420,550,970,58
KALUNGU,2022,420,520,940,58
KALUNGU,2023,410,490,900,58
KALUNGU,2024,400,470,870,58
KALUNGU,2025,410,470,880,58
KAMPALA,2015,1400,1500,2900,58
KAMPALA,2016,1430,1530,2960,58
KAMPALA,2017,1450,1560,3010,58
KAMPALA,2018,1480,1590,3070,58
KAMPALA,2019,1510,1620,3130,58
KAMPALA,2020,1540,1650,3190,58
KAMPALA,2021,1560,1680,3240,58
KAMPALA,2022,1590,1700,3290,58
KAMPALA,2023,1620,1730,3350,58
KAMPALA,2024,1640,1760,3400,58
KAMPALA,2025,1660,1780,3440,58
KAMULI,2015,530,600,1130,58
KAMULI,2016,590,660,1250,58
KAMULI,2017,660,770,1430,58
KAMULI,2018,750,890,1640,58
KAMULI,2019,810,1000,1810,58
KAMULI,2020,870,1060,1930,58
KAMULI,2021,900,1070,1970,58
KAMULI,2022,900,1030,1930,58
KAMULI,2023,900,990,1890,58
KAMULI,2024,900,960,1860,58
KAMULI,2025,930,970,1900,58
KAMWENGE,2015,350,410,760,58
KAMWENGE,2016,360,420,780,58
KAMWENGE,2017,380,430,810,58
KAMWENGE,2018,390,450,840,58
KAMWENGE,2019,410,470,880,58
KAMWENGE,2020,420,480,900,58
KAMWENGE,2021,440,500,940,58
KAMWENGE,2022,460,510,970,58
KAMWENGE,2023,470,530,1000,58
KAMWENGE,2024,490,550,1040,58
KAMWENGE,2025,510,560,1070,58
KANUNGU,2015,390,490,880,58
KANUNGU,2016,400,490,890,58
KANUNGU,2017,410,500,910,58
KANUNGU,2018,410,510,920,58
KANUNGU,2019,420,520,940,58
KANUNGU,2020,430,530,960,58
KANUNGU,2021,430,530,960,58
KANUNGU,2022,440,540,980,58
KANUNGU,2023,450,550,1000,58
KANUNGU,2024,450,550,1000,58
KANUNGU,2025,460,560,1020,58
KAPCHORWA,2015,170,190,360,58
KAPCHORWA,2016,180,190,370,58
KAPCHORWA,2017,180,200,380,58
KAPCHORWA,2018,190,200,390,58
KAPCHORWA,2019,190,210,400,58
KAPCHORWA,2020,200,210,410,58
KAPCHORWA,2021,200,220,420,58
KAPCHORWA,2022,210,230,440,58
KAPCHORWA,2023,210,230,440,58
KAPCHORWA,2024,220,240,460,58
KAPCHORWA,2025,230,240,470,58
KAPELEBYONG,2015,90,100,190,58
KAPELEBYONG,2016,100,110,210,58
KAPELEBYONG,2017,110,140,250,58
KAPELEBYONG,2018,130,150,280,58
KAPELEBYONG,2019,140,170,310,58
KAPELEBYONG,2020,150,190,340,58
KAPELEBYONG,2021,160,190,350,58
KAPELEBYONG,2022,160,180,340,58
KAPELEBYONG,2023,150,180,330,58
KAPELEBYONG,2024,160,170,330,58
KAPELEBYONG,2025,170,170,340,58
KASESE,2015,740,780,1520,58
KASESE,2016,820,870,1690,58
KASESE,2017,920,1010,1930,58
KASESE,2018,1030,1170,2200,58
KASESE,2019,1140,1320,2460,58
KASESE,2020,1210,1400,2610,58
KASESE,2021,1230,1400,2630,58
KASESE,2022,1240,1360,2600,58
KASESE,2023,1230,1300,2530,58
KASESE,2024,1240,1250,2490,58
KASESE,2025,1270,1260,2530,58
KASSANDA,2015,330,350,680,58
KASSANDA,2016,340,360,700,58
KASSANDA,2017,350,360,710,58
KASSANDA,2018,360,370,730,58
KASSANDA,2019,370,380,750,58
KASSANDA,2020,380,390,770,58
KASSANDA,2021,390,390,780,58
KASSANDA,2022,400,400,800,58
KASSANDA,2023,410,410,820,58
KASSANDA,2024,420,420,840,58
KASSANDA,2025,430,420,850,58
KATAKWI,2015,180,230,410,58
KATAKWI,2016,200,250,450,58
KATAKWI,2017,220,300,520,58
KATAKWI,2018,250,350,600,58
KATAKWI,2019,270,380,650,58
KATAKWI,2020,290,410,700,58
KATAKWI,2021,310,420,730,58
KATAKWI,2022,300,400,700,58
KATAKWI,2023,310,390,700,58
KATAKWI,2024,320,370,690,58
KATAKWI,2025,320,380,700,58
KAYUNGA,2015,390,470,860,58
KAYUNGA,2016,430,520,950,58
KAYUNGA,2017,480,590,1070,58
KAYUNGA,2018,540,680,1220,58
KAYUNGA,2019,590,760,1350,58
KAYUNGA,2020,630,810,1440,58
KAYUNGA,2021,630,810,1440,58
KAYUNGA,2022,630,770,1400,58
KAYUNGA,2023,630,730,1360,58
KAYUNGA,2024,630,710,1340,58
KAYUNGA,2025,650,720,1370,58
KAZO,2015,290,250,540,58
KAZO,2016,300,260,560,58
KAZO,2017,310,270,580,58
KAZO,2018,320,280,600,58
KAZO,2019,330,290,620,58
KAZO,2020,350,300,650,58
KAZO,2021,360,310,670,58
KAZO,2022,370,320,690,58
KAZO,2023,380,330,710,58
KAZO,2024,400,340,740,58
KAZO,2025,410,350,760,58
KIBAALE,2015,180,140,320,58
KIBAALE,2016,190,150,340,58
KIBAALE,2017,200,160,360,58
KIBAALE,2018,220,170,390,58
KIBAALE,2019,230,180,410,58
KIBAALE,2020,240,190,430,58
KIBAALE,2021,260,200,460,58
KIBAALE,2022,280,210,490,58
KIBAALE,2023,290,220,510,58
KIBAALE,2024,310,240,550,58
KIBAALE,2025,330,250,580,58
KIBOGA,2015,180,210,390,58
KIBOGA,2016,200,210,410,58
KIBOGA,2017,210,230,440,58
KIBOGA,2018,240,280,520,58
KIBOGA,2019,270,320,590,58
KIBOGA,2020,300,360,660,58
KIBOGA,2021,320,380,700,58
KIBOGA,2022,330,390,720,58
KIBOGA,2023,330,370,700,58
KIBOGA,2024,330,350,680,58
KIBOGA,2025,330,350,680,58
KIBUKU,2015,200,270,470,58
KIBUKU,2016,230,310,540,58
KIBUKU,2017,260,360,620,58
KIBUKU,2018,300,430,730,58
KIBUKU,2019,340,480,820,58
KIBUKU,2020,360,510,870,58
KIBUKU,2021,380,540,920,58
KIBUKU,2022,380,520,900,58
KIBUKU,2023,380,500,880,58
KIBUKU,2024,390,490,880,58
KIBUKU,2025,410,510,920,58
KIKUUBE,2015,320,310,630,58
KIKUUBE,2016,340,320,660,58
KIKUUBE,2017,350,340,690,58
KIKUUBE,2018,370,360,730,58
KIKUUBE,2019,390,380,770,58
KIKUUBE,2020,410,390,800,58
KIKUUBE,2021,430,410,840,58
KIKUUBE,2022,460,430,890,58
KIKUUBE,2023,480,450,930,58
KIKUUBE,2024,500,480,980,58
KIKUUBE,2025,530,500,1030,58
KIRUHURA,2015,280,250,530,58
KIRUHURA,2016,290,250,540,58
KIRUHURA,2017,300,260,560,58
KIRUHURA,2018,310,270,580,58
KIRUHURA,2019,320,280,600,58
KIRUHURA,2020,330,290,620,58
KIRUHURA,2021,350,300,650,58
KIRUHURA,2022,360,310,670,58
KIRUHURA,2023,370,320,690,58
KIRUHURA,2024,380,330,710,58
KIRUHURA,2025,390,340,730,58
KIRYANDONGO,2015,270,330,600,58
KIRYANDONGO,2016,290,370,660,58
KIRYANDONGO,2017,330,430,760,58
KIRYANDONGO,2018,370,500,870,58
KIRYANDONGO,2019,410,570,980,58
KIRYANDONGO,2020,440,600,1040,58
KIRYANDONGO,2021,460,610,1070,58
KIRYANDONGO,2022,460,600,1060,58
KIRYANDONGO,2023,460,580,1040,58
KIRYANDONGO,2024,470,570,1040,58
KIRYANDONGO,2025,480,570,1050,58
KISORO,2015,330,480,810,58
KISORO,2016,360,530,890,58
KISORO,2017,390,610,1000,58
KISORO,2018,450,710,1160,58
KISORO,2019,490,790,1280,58
KISORO,2020,520,840,1360,58
KISORO,2021,520,840,1360,58
KISORO,2022,530,810,1340,58
KISORO,2023,530,770,1300,58
KISORO,2024,520,750,1270,58
KISORO,2025,530,750,1280,58
KITAGWENDA,2015,210,290,500,58
KITAGWENDA,2016,220,300,520,58
KITAGWENDA,2017,230,310,540,58
KITAGWENDA,2018,240,320,560,58
KITAGWENDA,2019,250,330,580,58
KITAGWENDA,2020,260,350,610,58
KITAGWENDA,2021,270,360,630,58
KITAGWENDA,2022,280,370,650,58
KITAGWENDA,2023,290,380,670,58
KITAGWENDA,2024,300,390,690,58
KITAGWENDA,2025,310,410,720,58
KITGUM,2015,240,310,550,58
KITGUM,2016,260,350,610,58
KITGUM,2017,280,410,690,58
KITGUM,2018,320,460,780,58
KITGUM,2019,350,520,870,58
KITGUM,2020,370,540,910,58
KITGUM,2021,380,550,930,58
KITGUM,2022,380,520,900,58
KITGUM,2023,370,500,870,58
KITGUM,2024,370,480,850,58
KITGUM,2025,380,490,870,58
KOBOKO,2015,240,300,540,58
KOBOKO,2016,270,340,610,58
KOBOKO,2017,310,400,710,58
KOBOKO,2018,350,480,830,58
KOBOKO,2019,400,540,940,58
KOBOKO,2020,430,570,1000,58
KOBOKO,2021,440,590,1030,58
KOBOKO,2022,450,580,1030,58
KOBOKO,2023,460,570,1030,58
KOBOKO,2024,470,550,1020,58
KOBOKO,2025,480,570,1050,58
KOLE,2015,270,250,520,58
KOLE,2016,280,260,540,58
KOLE,2017,290,270,560,58
KOLE,2018,300,280,580,58
KOLE,2019,310,280,590,58
KOLE,2020,320,290,610,58
KOLE,2021,330,300,630,58
KOLE,2022,340,310,650,58
KOLE,2023,350,310,660,58
KOLE,2024,360,320,680,58
KOLE,2025,370,330,700,58
KOTIDO,2015,210,260,470,58
KOTIDO,2016,240,280,520,58
KOTIDO,2017,260,330,590,58
KOTIDO,2018,300,390,690,58
KOTIDO,2019,340,420,760,58
KOTIDO,2020,350,460,810,58
KOTIDO,2021,360,460,820,58
KOTIDO,2022,370,440,810,58
KOTIDO,2023,360,420,780,58
KOTIDO,2024,370,410,780,58
KOTIDO,2025,370,410,780,58
KUMI,2015,300,380,680,58
KUMI,2016,330,420,750,58
KUMI,2017,370,490,860,58
KUMI,2018,420,580,1000,58
KUMI,2019,460,650,1110,58
KUMI,2020,500,690,1190,58
KUMI,2021,510,690,1200,58
KUMI,2022,530,690,1220,58
KUMI,2023,530,660,1190,58
KUMI,2024,530,640,1170,58
KUMI,2025,550,640,1190,58
KWANIA,2015,200,220,420,58
KWANIA,2016,210,230,440,58
KWANIA,2017,220,240,460,58
KWANIA,2018,220,240,460,58
KWANIA,2019,230,250,480,58
KWANIA,2020,240,260,500,58
KWANIA,2021,240,260,500,58
KWANIA,2022,250,270,520,58
KWANIA,2023,260,280,540,58
KWANIA,2024,260,280,540,58
KWANIA,2025,270,290,560,58
KWEEN,2015,160,130,290,58
KWEEN,2016,170,140,310,58
KWEEN,2017,170,140,310,58
KWEEN,2018,180,140,320,58
KWEEN,2019,180,150,330,58
KWEEN,2020,190,150,340,58
KWEEN,2021,190,150,340,58
KWEEN,2022,200,160,360,58
KWEEN,2023,200,160,360,58
KWEEN,2024,210,160,370,58
KWEEN,2025,210,170,380,58
KYANKWANZI,2015,290,210,500,58
KYANKWANZI,2016,300,220,520,58
KYANKWANZI,2017,320,230,550,58
KYANKWANZI,2018,330,240,570,58
KYANKWANZI,2019,350,250,600,58
KYANKWANZI,2020,370,260,630,58
KYANKWANZI,2021,380,270,650,58
KYANKWANZI,2022,400,280,680,58
KYANKWANZI,2023,420,300,720,58
KYANKWANZI,2024,440,310,750,58
KYANKWANZI,2025,460,320,780,58
KYEGEGWA,2015,320,320,640,58
KYEGEGWA,2016,340,340,680,58
KYEGEGWA,2017,370,370,740,58
KYEGEGWA,2018,400,400,800,58
KYEGEGWA,2019,430,430,860,58
KYEGEGWA,2020,470,470,940,58
KYEGEGWA,2021,510,500,1010,58
KYEGEGWA,2022,550,540,1090,58
KYEGEGWA,2023,590,580,1170,58
KYEGEGWA,2024,640,620,1260,58
KYEGEGWA,2025,680,670,1350,58
KYENJOJO,2015,480,550,1030,58
KYENJOJO,2016,500,570,1070,58
KYENJOJO,2017,520,590,1110,58
KYENJOJO,2018,540,610,1150,58
KYENJOJO,2019,570,630,1200,58
KYENJOJO,2020,590,650,1240,58
KYENJOJO,2021,610,670,1280,58
KYENJOJO,2022,630,700,1330,58
KYENJOJO,2023,660,720,1380,58
KYENJOJO,2024,680,740,1420,58
KYENJOJO,2025,710,770,1480,58
KYOTERA,2015,340,370,710,58
KYOTERA,2016,360,410,770,58
KYOTERA,2017,400,470,870,58
KYOTERA,2018,460,540,1000,58
KYOTERA,2019,490,590,1080,58
KYOTERA,2020,520,630,1150,58
KYOTERA,2021,520,620,1140,58
KYOTERA,2022,530,600,1130,58
KYOTERA,2023,510,570,1080,58
KYOTERA,2024,520,550,1070,58
KYOTERA,2025,530,550,1080,58
KARENGA,2015,100,80,180,58
KARENGA,2016,100,90,190,58
KARENGA,2017,100,90,190,58
KARENGA,2018,110,90,200,58
KARENGA,2019,110,90,200,58
KARENGA,2020,110,90,200,58
KARENGA,2021,120,100,220,58
KARENGA,2022,120,100,220,58
KARENGA,2023,120,100,220,58
KARENGA,2024,130,100,230,58
KARENGA,2025,130,100,230,58
LAMWO,2015,150,220,370,58
LAMWO,2016,160,240,400,58
LAMWO,2017,190,280,470,58
LAMWO,2018,200,320,520,58
LAMWO,2019,220,350,570,58
LAMWO,2020,230,380,610,58
LAMWO,2021,230,380,610,58
LAMWO,2022,220,360,580,58
LAMWO,2023,220,330,550,58
LAMWO,2024,230,330,560,58
LAMWO,2025,230,330,560,58
LIRA,2015,490,530,1020,58
LIRA,2016,500,550,1050,58
LIRA,2017,520,560,1080,58
LIRA,2018,530,580,1110,58
LIRA,2019,550,590,1140,58
LIRA,2020,560,610,1170,58
LIRA,2021,580,630,1210,58
LIRA,2022,590,640,1230,58
LIRA,2023,610,660,1270,58
LIRA,2024,620,680,1300,58
LIRA,2025,630,690,1320,58
LUUKA,2015,240,270,510,58
LUUKA,2016,260,310,570,58
LUUKA,2017,300,350,650,58
LUUKA,2018,340,410,750,58
LUUKA,2019,360,450,810,58
LUUKA,2020,390,490,880,58
LUUKA,2021,390,480,870,58
LUUKA,2022,400,470,870,58
LUUKA,2023,380,450,830,58
LUUKA,2024,390,430,820,58
LUUKA,2025,390,440,830,58
LUWERO,2015,520,600,1120,58
LUWERO,2016,580,680,1260,58
LUWERO,2017,650,790,1440,58
LUWERO,2018,730,920,1650,58
LUWERO,2019,800,1020,1820,58
LUWERO,2020,860,1090,1950,58
LUWERO,2021,870,1090,1960,58
LUWERO,2022,880,1060,1940,58
LUWERO,2023,870,1000,1870,58
LUWERO,2024,890,980,1870,58
LUWERO,2025,900,980,1880,58
LWENGO,2015,350,440,790,58
LWENGO,2016,390,490,880,58
LWENGO,2017,430,560,990,58
LWENGO,2018,480,630,1110,58
LWENGO,2019,520,710,1230,58
LWENGO,2020,540,740,1280,58
LWENGO,2021,550,740,1290,58
LWENGO,2022,540,700,1240,58
LWENGO,2023,530,660,1190,58
LWENGO,2024,530,640,1170,58
LWENGO,2025,530,630,1160,58
LYANTONDE,2015,140,110,250,58
LYANTONDE,2016,150,120,270,58
LYANTONDE,2017,180,150,330,58
LYANTONDE,2018,190,170,360,58
LYANTONDE,2019,220,200,420,58
LYANTONDE,2020,230,210,440,58
LYANTONDE,2021,240,200,440,58
LYANTONDE,2022,240,210,450,58
LYANTONDE,2023,240,190,430,58
LYANTONDE,2024,240,180,420,58
LYANTONDE,2025,250,190,440,58
MANAFWA,2015,330,390,720,58
MANAFWA,2016,340,400,740,58
MANAFWA,2017,340,410,750,58
MANAFWA,2018,350,420,770,58
MANAFWA,2019,360,420,780,58
MANAFWA,2020,370,430,800,58
MANAFWA,2021,380,440,820,58
MANAFWA,2022,390,450,840,58
MANAFWA,2023,390,460,850,58
MANAFWA,2024,400,470,870,58
MANAFWA,2025,410,480,890,58
MARACHA,2015,280,430,710,58
MARACHA,2016,280,440,720,58
MARACHA,2017,290,440,730,58
MARACHA,2018,300,450,750,58
MARACHA,2019,300,460,760,58
MARACHA,2020,310,470,780,58
MARACHA,2021,310,480,790,58
MARACHA,2022,320,490,810,58
MARACHA,2023,330,490,820,58
MARACHA,2024,330,500,830,58
MARACHA,2025,340,510,850,58
MASAKA,2015,350,420,770,58
MASAKA,2016,350,400,750,58
MASAKA,2017,350,410,760,58
MASAKA,2018,390,460,850,58
MASAKA,2019,440,530,970,58
MASAKA,2020,490,610,1100,58
MASAKA,2021,540,680,1220,58
MASAKA,2022,580,720,1300,58
MASAKA,2023,590,720,1310,58
MASAKA,2024,590,700,1290,58
MASAKA,2025,580,670,1250,58
MASINDI,2015,390,400,790,58
MASINDI,2016,400,410,810,58
MASINDI,2017,410,420,830,58
MASINDI,2018,430,430,860,58
MASINDI,2019,440,440,880,58
MASINDI,2020,450,450,900,58
MASINDI,2021,460,460,920,58
MASINDI,2022,470,480,950,58
MASINDI,2023,490,490,980,58
MASINDI,2024,500,500,1000,58
MASINDI,2025,510,510,1020,58
MAYUGE,2015,450,480,930,58
MAYUGE,2016,500,540,1040,58
MAYUGE,2017,560,630,1190,58
MAYUGE,2018,640,740,1380,58
MAYUGE,2019,710,830,1540,58
MAYUGE,2020,750,880,1630,58
MAYUGE,2021,780,900,1680,58
MAYUGE,2022,790,880,1670,58
MAYUGE,2023,790,850,1640,58
MAYUGE,2024,800,820,1620,58
MAYUGE,2025,830,840,1670,58
MBALE,2015,770,800,1570,58
MBALE,2016,860,900,1760,58
MBALE,2017,970,1060,2030,58
MBALE,2018,1110,1240,2350,58
MBALE,2019,1210,1400,2610,58
MBALE,2020,1300,1500,2800,58
MBALE,2021,1340,1520,2860,58
MBALE,2022,1360,1480,2840,58
MBALE,2023,1360,1430,2790,58
MBALE,2024,1380,1410,2790,58
MBALE,2025,1410,1430,2840,58
MBARARA,2015,470,510,980,58
MBARARA,2016,480,520,1000,58
MBARARA,2017,490,540,1030,58
MBARARA,2018,500,550,1050,58
MBARARA,2019,510,560,1070,58
MBARARA,2020,520,570,1090,58
MBARARA,2021,530,580,1110,58
MBARARA,2022,540,590,1130,58
MBARARA,2023,550,600,1150,58
MBARARA,2024,560,610,1170,58
MBARARA,2025,570,620,1190,58
MITOOMA,2015,260,350,610,58
MITOOMA,2016,260,350,610,58
MITOOMA,2017,260,360,620,58
MITOOMA,2018,270,360,630,58
MITOOMA,2019,270,360,630,58
MITOOMA,2020,270,370,640,58
MITOOMA,2021,280,370,650,58
MITOOMA,2022,280,370,650,58
MITOOMA,2023,280,370,650,58
MITOOMA,2024,280,380,660,58
MITOOMA,2025,290,380,670,58
MITYANA,2015,470,500,970,58
MITYANA,2016,520,560,1080,58
MITYANA,2017,580,650,1230,58
MITYANA,2018,650,750,1400,58
MITYANA,2019,710,830,1540,58
MITYANA,2020,750,870,1620,58
MITYANA,2021,760,870,1630,58
MITYANA,2022,760,840,1600,58
MITYANA,2023,760,800,1560,58
MITYANA,2024,750,770,1520,58
MITYANA,2025,760,760,1520,58
MOROTO,2015,100,130,230,58
MOROTO,2016,110,140,250,58
MOROTO,2017,120,160,280,58
MOROTO,2018,140,190,330,58
MOROTO,2019,150,210,360,58
MOROTO,2020,160,220,380,58
MOROTO,2021,160,230,390,58
MOROTO,2022,170,220,390,58
MOROTO,2023,170,210,380,58
MOROTO,2024,160,210,370,58
MOROTO,2025,170,210,380,58
MOYO,2015,160,200,360,58
MOYO,2016,170,210,380,58
MOYO,2017,170,210,380,58
MOYO,2018,180,220,400,58
MOYO,2019,180,220,400,58
MOYO,2020,190,230,420,58
MOYO,2021,190,230,420,58
MOYO,2022,190,240,430,58
MOYO,2023,200,240,440,58
MOYO,2024,200,250,450,58
MOYO,2025,210,250,460,58
MPIGI,2015,330,360,690,58
MPIGI,2016,360,400,760,58
MPIGI,2017,400,470,870,58
MPIGI,2018,460,540,1000,58
MPIGI,2019,500,610,1110,58
MPIGI,2020,540,650,1190,58
MPIGI,2021,550,650,1200,58
MPIGI,2022,550,630,1180,58
MPIGI,2023,540,600,1140,58
MPIGI,2024,540,590,1130,58
MPIGI,2025,560,580,1140,58
MUBENDE,2015,500,510,1010,58
MUBENDE,2016,500,470,970,58
MUBENDE,2017,500,460,960,58
MUBENDE,2018,540,490,1030,58
MUBENDE,2019,600,570,1170,58
MUBENDE,2020,700,680,1380,58
MUBENDE,2021,820,810,1630,58
MUBENDE,2022,910,930,1840,58
MUBENDE,2023,1000,1010,2010,58
MUBENDE,2024,1040,1030,2070,58
MUBENDE,2025,1080,1020,2100,58
MUKONO,2015,700,760,1460,58
MUKONO,2016,770,850,1620,58
MUKONO,2017,860,1000,1860,58
MUKONO,2018,970,1160,2130,58
MUKONO,2019,1070,1320,2390,58
MUKONO,2020,1140,1410,2550,58
MUKONO,2021,1180,1420,2600,58
MUKONO,2022,1190,1390,2580,58
MUKONO,2023,1180,1320,2500,58
MUKONO,2024,1190,1300,2490,58
MUKONO,2025,1220,1320,2540,58
MADI OKOLLO,2015,250,310,560,58
MADI OKOLLO,2016,250,320,570,58
MADI OKOLLO,2017,260,330,590,58
MADI OKOLLO,2018,270,340,610,58
MADI OKOLLO,2019,280,350,630,58
MADI OKOLLO,2020,290,360,650,58
MADI OKOLLO,2021,290,370,660,58
MADI OKOLLO,2022,300,370,670,58
MADI OKOLLO,2023,310,380,690,58
MADI OKOLLO,2024,310,390,700,58
MADI OKOLLO,2025,320,400,720,58
NABILATUK,2015,60,100,160,58
NABILATUK,2016,70,120,190,58
NABILATUK,2017,80,140,220,58
NABILATUK,2018,100,170,270,58
NABILATUK,2019,100,200,300,58
NABILATUK,2020,110,210,320,58
NABILATUK,2021,120,220,340,58
NABILATUK,2022,120,210,330,58
NABILATUK,2023,130,210,340,58
NABILATUK,2024,130,210,340,58
NABILATUK,2025,140,210,350,58
NAKAPIRIPIRIT,2015,80,100,180,58
NAKAPIRIPIRIT,2016,100,120,220,58
NAKAPIRIPIRIT,2017,110,140,250,58
NAKAPIRIPIRIT,2018,130,170,300,58
NAKAPIRIPIRIT,2019,140,180,320,58
NAKAPIRIPIRIT,2020,150,210,360,58
NAKAPIRIPIRIT,2021,160,200,360,58
NAKAPIRIPIRIT,2022,160,210,370,58
NAKAPIRIPIRIT,2023,170,210,380,58
NAKAPIRIPIRIT,2024,180,200,380,58
NAKAPIRIPIRIT,2025,180,210,390,58
NAKASEKE,2015,250,290,540,58
NAKASEKE,2016,260,300,560,58
NAKASEKE,2017,270,310,580,58
NAKASEKE,2018,280,310,590,58
NAKASEKE,2019,290,320,610,58
NAKASEKE,2020,300,330,630,58
NAKASEKE,2021,310,340,650,58
NAKASEKE,2022,320,340,660,58
NAKASEKE,2023,340,350,690,58
NAKASEKE,2024,350,360,710,58
NAKASEKE,2025,360,360,720,58
NAKASONGOLA,2015,200,170,370,58
NAKASONGOLA,2016,210,180,390,58
NAKASONGOLA,2017,210,180,390,58
NAKASONGOLA,2018,200,160,360,58
NAKASONGOLA,2019,200,160,360,58
NAKASONGOLA,2020,200,140,340,58
NAKASONGOLA,2021,200,150,350,58
NAKASONGOLA,2022,220,170,390,58
NAKASONGOLA,2023,260,200,460,58
NAKASONGOLA,2024,280,230,510,58
NAKASONGOLA,2025,320,250,570,58
NAMAYINGO,2015,230,250,480,58
NAMAYINGO,2016,250,280,530,58
NAMAYINGO,2017,280,320,600,58
NAMAYINGO,2018,310,370,680,58
NAMAYINGO,2019,350,410,760,58
NAMAYINGO,2020,360,440,800,58
NAMAYINGO,2021,380,430,810,58
NAMAYINGO,2022,370,410,780,58
NAMAYINGO,2023,370,400,770,58
NAMAYINGO,2024,370,380,750,58
NAMAYINGO,2025,380,380,760,58
NAMISINDWA,2015,390,400,790,58
NAMISINDWA,2016,400,410,810,58
NAMISINDWA,2017,410,420,830,58
NAMISINDWA,2018,430,430,860,58
NAMISINDWA,2019,440,440,880,58
NAMISINDWA,2020,450,450,900,58
NAMISINDWA,2021,460,460,920,58
NAMISINDWA,2022,470,470,940,58
NAMISINDWA,2023,480,480,960,58
NAMISINDWA,2024,490,490,980,58
NAMISINDWA,2025,510,500,1010,58
NAMUTUMBA,2015,280,270,550,58
NAMUTUMBA,2016,310,300,610,58
NAMUTUMBA,2017,350,350,700,58
NAMUTUMBA,2018,400,410,810,58
NAMUTUMBA,2019,450,470,920,58
NAMUTUMBA,2020,480,500,980,58
NAMUTUMBA,2021,500,510,1010,58
NAMUTUMBA,2022,500,490,990,58
NAMUTUMBA,2023,510,480,990,58
NAMUTUMBA,2024,520,470,990,58
NAMUTUMBA,2025,530,470,1000,58
NAPAK,2015,160,270,430,58
NAPAK,2016,180,290,470,58
NAPAK,2017,200,340,540,58
NAPAK,2018,220,390,610,58
NAPAK,2019,250,440,690,58
NAPAK,2020,250,470,720,58
NAPAK,2021,250,460,710,58
NAPAK,2022,250,450,700,58
NAPAK,2023,260,420,680,58
NAPAK,2024,250,420,670,58
NAPAK,2025,250,410,660,58
NEBBI,2015,300,380,680,58
NEBBI,2016,300,390,690,58
NEBBI,2017,310,400,710,58
NEBBI,2018,320,410,730,58
NEBBI,2019,330,420,750,58
NEBBI,2020,340,430,770,58
NEBBI,2021,350,440,790,58
NEBBI,2022,360,460,820,58
NEBBI,2023,380,470,850,58
NEBBI,2024,390,480,870,58
NEBBI,2025,400,490,890,58
NGORA,2015,180,240,420,58
NGORA,2016,190,260,450,58
NGORA,2017,220,310,530,58
NGORA,2018,240,360,600,58
NGORA,2019,270,400,670,58
NGORA,2020,280,430,710,58
NGORA,2021,300,430,730,58
NGORA,2022,300,410,710,58
NGORA,2023,290,400,690,58
NGORA,2024,300,390,690,58
NGORA,2025,310,390,700,58
NTOROKO,2015,80,80,160,58
NTOROKO,2016,90,90,180,58
NTOROKO,2017,110,100,210,58
NTOROKO,2018,120,130,250,58
NTOROKO,2019,130,140,270,58
NTOROKO,2020,130,150,280,58
NTOROKO,2021,150,140,290,58
NTOROKO,2022,140,140,280,58
NTOROKO,2023,140,140,280,58
NTOROKO,2024,140,140,280,58
NTOROKO,2025,150,130,280,58
NTUNGAMO,2015,720,870,1590,58
NTUNGAMO,2016,740,890,1630,58
NTUNGAMO,2017,760,910,1670,58
NTUNGAMO,2018,770,920,1690,58
NTUNGAMO,2019,790,940,1730,58
NTUNGAMO,2020,800,960,1760,58
NTUNGAMO,2021,820,970,1790,58
NTUNGAMO,2022,830,990,1820,58
NTUNGAMO,2023,850,1000,1850,58
NTUNGAMO,2024,860,1020,1880,58
NTUNGAMO,2025,880,1030,1910,58
NWOYA,2015,160,230,390,58
NWOYA,2016,170,250,420,58
NWOYA,2017,190,270,460,58
NWOYA,2018,210,300,510,58
NWOYA,2019,230,330,560,58
NWOYA,2020,260,370,630,58
NWOYA,2021,280,400,680,58
NWOYA,2022,310,440,750,58
NWOYA,2023,350,490,840,58
NWOYA,2024,380,530,910,58
NWOYA,2025,420,590,1010,58
OBONGI,2015,60,50,110,58
OBONGI,2016,60,60,120,58
OBONGI,2017,70,70,140,58
OBONGI,2018,70,80,150,58
OBONGI,2019,80,80,160,58
OBONGI,2020,90,90,180,58
OBONGI,2021,90,100,190,58
OBONGI,2022,90,100,190,58
OBONGI,2023,90,90,180,58
OBONGI,2024,90,90,180,58
OBONGI,2025,90,80,170,58
OMORO,2015,190,220,410,58
OMORO,2016,210,240,450,58
OMORO,2017,240,280,520,58
OMORO,2018,280,340,620,58
OMORO,2019,310,380,690,58
OMORO,2020,320,410,730,58
OMORO,2021,340,420,760,58
OMORO,2022,340,410,750,58
OMORO,2023,350,400,750,58
OMORO,2024,350,390,740,58
OMORO,2025,370,400,770,58
OTUKE,2015,150,170,320,58
OTUKE,2016,150,170,320,58
OTUKE,2017,160,180,340,58
OTUKE,2018,170,190,360,58
OTUKE,2019,180,200,380,58
OTUKE,2020,180,200,380,58
OTUKE,2021,190,210,400,58
OTUKE,2022,200,220,420,58
OTUKE,2023,210,230,440,58
OTUKE,2024,220,240,460,58
OTUKE,2025,230,250,480,58
OYAM,2015,480,570,1050,58
OYAM,2016,500,580,1080,58
OYAM,2017,510,600,1110,58
OYAM,2018,530,620,1150,58
OYAM,2019,540,640,1180,58
OYAM,2020,560,650,1210,58
OYAM,2021,570,670,1240,58
OYAM,2022,590,690,1280,58
OYAM,2023,600,710,1310,58
OYAM,2024,620,720,1340,58
OYAM,2025,640,740,1380,58
PADER,2015,200,240,440,58
PADER,2016,220,260,480,58
PADER,2017,240,310,550,58
PADER,2018,260,350,610,58
PADER,2019,300,400,700,58
PADER,2020,310,410,720,58
PADER,2021,320,420,740,58
PADER,2022,320,400,720,58
PADER,2023,310,390,700,58
PADER,2024,320,370,690,58
PADER,2025,320,380,700,58
PAKWACH,2015,190,240,430,58
PAKWACH,2016,200,250,450,58
PAKWACH,2017,210,260,470,58
PAKWACH,2018,220,260,480,58
PAKWACH,2019,230,270,500,58
PAKWACH,2020,240,280,520,58
PAKWACH,2021,250,290,540,58
PAKWACH,2022,260,300,560,58
PAKWACH,2023,270,310,580,58
PAKWACH,2024,280,320,600,58
PAKWACH,2025,290,330,620,58
PALLISA,2015,330,320,650,58
PALLISA,2016,370,360,730,58
PALLISA,2017,420,430,850,58
PALLISA,2018,480,520,1000,58
PALLISA,2019,540,580,1120,58
PALLISA,2020,590,630,1220,58
PALLISA,2021,620,650,1270,58
PALLISA,2022,630,630,1260,58
PALLISA,2023,640,620,1260,58
PALLISA,2024,660,610,1270,58
PALLISA,2025,690,630,1320,58
RAKAI,2015,350,410,760,58
RAKAI,2016,390,460,850,58
RAKAI,2017,440,530,970,58
RAKAI,2018,490,620,1110,58
RAKAI,2019,540,690,1230,58
RAKAI,2020,580,740,1320,58
RAKAI,2021,590,740,1330,58
RAKAI,2022,590,710,1300,58
RAKAI,2023,590,680,1270,58
RAKAI,2024,590,660,1250,58
RAKAI,2025,610,670,1280,58
RUBANDA,2015,310,390,700,58
RUBANDA,2016,320,390,710,58
RUBANDA,2017,320,400,720,58
RUBANDA,2018,320,400,720,58
RUBANDA,2019,330,400,730,58
RUBANDA,2020,330,400,730,58
RUBANDA,2021,340,410,750,58
RUBANDA,2022,340,410,750,58
RUBANDA,2023,340,410,750,58
RUBANDA,2024,350,410,760,58
RUBANDA,2025,350,410,760,58
RUBIRIZI,2015,190,250,440,58
RUBIRIZI,2016,190,260,450,58
RUBIRIZI,2017,190,260,450,58
RUBIRIZI,2018,200,270,470,58
RUBIRIZI,2019,200,270,470,58
RUBIRIZI,2020,210,280,490,58
RUBIRIZI,2021,210,280,490,58
RUBIRIZI,2022,210,290,500,58
RUBIRIZI,2023,220,290,510,58
RUBIRIZI,2024,220,300,520,58
RUBIRIZI,2025,220,300,520,58
RUKIGA,2015,210,220,430,58
RUKIGA,2016,210,220,430,58
RUKIGA,2017,210,220,430,58
RUKIGA,2018,210,230,440,58
RUKIGA,2019,210,230,440,58
RUKIGA,2020,220,230,450,58
RUKIGA,2021,220,230,450,58
RUKIGA,2022,220,230,450,58
RUKIGA,2023,220,230,450,58
RUKIGA,2024,220,230,450,58
RUKIGA,2025,220,230,450,58
RUKUNGIRI,2015,560,640,1200,58
RUKUNGIRI,2016,560,650,1210,58
RUKUNGIRI,2017,570,660,1230,58
RUKUNGIRI,2018,580,660,1240,58
RUKUNGIRI,2019,580,670,1250,58
RUKUNGIRI,2020,590,670,1260,58
RUKUNGIRI,2021,590,680,1270,58
RUKUNGIRI,2022,600,680,1280,58
RUKUNGIRI,2023,600,690,1290,58
RUKUNGIRI,2024,610,690,1300,58
RUKUNGIRI,2025,610,700,1310,58
RWAMPARA,2015,200,220,420,58
RWAMPARA,2016,200,220,420,58
RWAMPARA,2017,210,230,440,58
RWAMPARA,2018,210,230,440,58
RWAMPARA,2019,220,240,460,58
RWAMPARA,2020,220,240,460,58
RWAMPARA,2021,230,250,480,58
RWAMPARA,2022,230,250,480,58
RWAMPARA,2023,240,260,500,58
RWAMPARA,2024,240,260,500,58
RWAMPARA,2025,250,260,510,58
SERERE,2015,300,320,620,58
SERERE,2016,340,360,700,58
SERERE,2017,380,430,810,58
SERERE,2018,450,500,950,58
SERERE,2019,490,580,1070,58
SERERE,2020,540,620,1160,58
SERERE,2021,550,640,1190,58
SERERE,2022,570,620,1190,58
SERERE,2023,580,600,1180,58
SERERE,2024,580,600,1180,58
SERERE,2025,610,610,1220,58
SHEEMA,2015,310,390,700,58
SHEEMA,2016,310,390,700,58
SHEEMA,2017,320,400,720,58
SHEEMA,2018,320,400,720,58
SHEEMA,2019,320,410,730,58
SHEEMA,2020,330,410,740,58
SHEEMA,2021,330,410,740,58
SHEEMA,2022,330,420,750,58
SHEEMA,2023,340,420,760,58
SHEEMA,2024,340,420,760,58
SHEEMA,2025,340,420,760,58
SIRONKO,2015,550,560,1110,58
SIRONKO,2016,560,570,1130,58
SIRONKO,2017,580,580,1160,58
SIRONKO,2018,590,590,1180,58
SIRONKO,2019,610,610,1220,58
SIRONKO,2020,620,620,1240,58
SIRONKO,2021,630,630,1260,58
SIRONKO,2022,650,640,1290,58
SIRONKO,2023,660,650,1310,58
SIRONKO,2024,670,660,1330,58
SIRONKO,2025,680,670,1350,58
SOROTI,2015,340,370,710,58
SOROTI,2016,370,410,780,58
SOROTI,2017,430,490,920,58
SOROTI,2018,480,570,1050,58
SOROTI,2019,540,650,1190,58
SOROTI,2020,580,690,1270,58
SOROTI,2021,600,710,1310,58
SOROTI,2022,610,690,1300,58
SOROTI,2023,620,670,1290,58
SOROTI,2024,620,650,1270,58
SOROTI,2025,650,670,1320,58
SSEMBABULE,2015,340,350,690,58
SSEMBABULE,2016,380,390,770,58
SSEMBABULE,2017,430,460,890,58
SSEMBABULE,2018,480,530,1010,58
SSEMBABULE,2019,530,590,1120,58
SSEMBABULE,2020,580,630,1210,58
SSEMBABULE,2021,590,640,1230,58
SSEMBABULE,2022,590,620,1210,58
SSEMBABULE,2023,590,590,1180,58
SSEMBABULE,2024,590,580,1170,58
SSEMBABULE,2025,610,580,1190,58
TORORO,2015,770,900,1670,58
TORORO,2016,800,920,1720,58
TORORO,2017,820,940,1760,58
TORORO,2018,840,970,1810,58
TORORO,2019,860,990,1850,58
TORORO,2020,880,1010,1890,58
TORORO,2021,900,1040,1940,58
TORORO,2022,920,1060,1980,58
TORORO,2023,950,1080,2030,58
TORORO,2024,970,1110,2080,58
TORORO,2025,990,1130,2120,58
WAKISO,2015,1840,2130,3970,58
WAKISO,2016,1960,2280,4240,58
WAKISO,2017,2090,2430,4520,58
WAKISO,2018,2230,2600,4830,58
WAKISO,2019,2380,2770,5150,58
WAKISO,2020,2540,2960,5500,58
WAKISO,2021,2700,3150,5850,58
WAKISO,2022,2870,3360,6230,58
WAKISO,2023,3050,3580,6630,58
WAKISO,2024,3240,3800,7040,58
WAKISO,2025,3440,4050,7490,58
YUMBE,2015,500,510,1010,58
YUMBE,2016,570,590,1160,58
YUMBE,2017,660,720,1380,58
YUMBE,2018,760,850,1610,58
YUMBE,2019,850,990,1840,58
YUMBE,2020,940,1090,2030,58
YUMBE,2021,980,1140,2120,58
YUMBE,2022,1010,1140,2150,58
YUMBE,2023,1040,1130,2170,58
YUMBE,2024,1060,1130,2190,58
YUMBE,2025,1120,1180,2300,58
ZOMBO,2015,350,370,720,58
ZOMBO,2016,360,380,740,58
ZOMBO,2017,370,390,760,58
ZOMBO,2018,380,400,780,58
ZOMBO,2019,390,410,800,58
ZOMBO,2020,400,430,830,58
ZOMBO,2021,410,440,850,58
ZOMBO,2022,430,450,880,58
ZOMBO,2023,440,460,900,58
ZOMBO,2024,450,470,920,58
ZOMBO,2025,460,480,940,58
ABIM,2015,130,120,250,59
ABIM,2016,130,130,260,59
ABIM,2017,150,150,300,59
ABIM,2018,180,180,360,59
ABIM,2019,210,220,430,59
ABIM,2020,220,250,470,59
ABIM,2021,250,280,530,59
ABIM,2022,270,300,570,59
ABIM,2023,280,280,560,59
ABIM,2024,290,280,570,59
ABIM,2025,300,290,590,59
ADJUMANI,2015,180,270,450,59
ADJUMANI,2016,180,270,450,59
ADJUMANI,2017,180,270,450,59
ADJUMANI,2018,180,280,460,59
ADJUMANI,2019,190,280,470,59
ADJUMANI,2020,190,280,470,59
ADJUMANI,2021,190,280,470,59
ADJUMANI,2022,190,290,480,59
ADJUMANI,2023,190,290,480,59
ADJUMANI,2024,190,290,480,59
ADJUMANI,2025,190,290,480,59
AGAGO,2015,200,250,450,59
AGAGO,2016,200,260,460,59
AGAGO,2017,210,260,470,59
AGAGO,2018,210,260,470,59
AGAGO,2019,210,270,480,59
AGAGO,2020,220,270,490,59
AGAGO,2021,220,280,500,59
AGAGO,2022,220,280,500,59
AGAGO,2023,230,290,520,59
AGAGO,2024,230,290,520,59
AGAGO,2025,230,290,520,59
ALEBTONG,2015,290,320,610,59
ALEBTONG,2016,300,330,630,59
ALEBTONG,2017,320,370,690,59
ALEBTONG,2018,370,420,790,59
ALEBTONG,2019,420,500,920,59
ALEBTONG,2020,460,560,1020,59
ALEBTONG,2021,480,600,1080,59
ALEBTONG,2022,500,600,1100,59
ALEBTONG,2023,510,580,1090,59
ALEBTONG,2024,510,560,1070,59
ALEBTONG,2025,520,560,1080,59
AMOLATAR,2015,180,190,370,59
AMOLATAR,2016,180,190,370,59
AMOLATAR,2017,200,220,420,59
AMOLATAR,2018,230,250,480,59
AMOLATAR,2019,250,300,550,59
AMOLATAR,2020,290,330,620,59
AMOLATAR,2021,300,340,640,59
AMOLATAR,2022,320,350,670,59
AMOLATAR,2023,310,340,650,59
AMOLATAR,2024,320,330,650,59
AMOLATAR,2025,310,320,630,59
AMUDAT,2015,110,80,190,59
AMUDAT,2016,130,80,210,59
AMUDAT,2017,140,90,230,59
AMUDAT,2018,160,120,280,59
AMUDAT,2019,180,130,310,59
AMUDAT,2020,210,150,360,59
AMUDAT,2021,220,170,390,59
AMUDAT,2022,230,170,400,59
AMUDAT,2023,230,160,390,59
AMUDAT,2024,240,170,410,59
AMUDAT,2025,240,160,400,59
AMURIA,2015,200,210,410,59
AMURIA,2016,210,220,430,59
AMURIA,2017,230,240,470,59
AMURIA,2018,270,290,560,59
AMURIA,2019,300,350,650,59
AMURIA,2020,340,380,720,59
AMURIA,2021,370,420,790,59
AMURIA,2022,380,430,810,59
AMURIA,2023,380,410,790,59
AMURIA,2024,380,400,780,59
AMURIA,2025,390,400,790,59
AMURU,2015,170,210,380,59
AMURU,2016,180,210,390,59
AMURU,2017,200,240,440,59
AMURU,2018,230,280,510,59
AMURU,2019,250,330,580,59
AMURU,2020,270,360,630,59
AMURU,2021,300,400,700,59
AMURU,2022,300,390,690,59
AMURU,2023,310,390,700,59
AMURU,2024,300,360,660,59
AMURU,2025,310,360,670,59
APAC,2015,190,170,360,59
APAC,2016,200,180,380,59
APAC,2017,200,180,380,59
APAC,2018,210,190,400,59
APAC,2019,220,190,410,59
APAC,2020,230,200,430,59
APAC,2021,240,210,450,59
APAC,2022,240,210,450,59
APAC,2023,250,220,470,59
APAC,2024,260,230,490,59
APAC,2025,270,230,500,59
ARUA,2015,600,700,1300,59
ARUA,2016,620,720,1340,59
ARUA,2017,640,740,1380,59
ARUA,2018,650,760,1410,59
ARUA,2019,670,780,1450,59
ARUA,2020,690,790,1480,59
ARUA,2021,710,810,1520,59
ARUA,2022,730,830,1560,59
ARUA,2023,750,860,1610,59
ARUA,2024,760,870,1630,59
ARUA,2025,780,890,1670,59
BUDAKA,2015,240,260,500,59
BUDAKA,2016,250,260,510,59
BUDAKA,2017,280,300,580,59
BUDAKA,2018,330,350,680,59
BUDAKA,2019,360,410,770,59
BUDAKA,2020,400,470,870,59
BUDAKA,2021,430,490,920,59
BUDAKA,2022,450,500,950,59
BUDAKA,2023,460,490,950,59
BUDAKA,2024,460,480,940,59
BUDAKA,2025,470,480,950,59
BUDUDA,2015,310,310,620,59
BUDUDA,2016,330,320,650,59
BUDUDA,2017,370,360,730,59
BUDUDA,2018,420,420,840,59
BUDUDA,2019,490,500,990,59
BUDUDA,2020,540,580,1120,59
BUDUDA,2021,600,620,1220,59
BUDUDA,2022,620,630,1250,59
BUDUDA,2023,640,640,1280,59
BUDUDA,2024,640,610,1250,59
BUDUDA,2025,660,620,1280,59
BUGIRI,2015,410,460,870,59
BUGIRI,2016,430,470,900,59
BUGIRI,2017,480,540,1020,59
BUGIRI,2018,540,640,1180,59
BUGIRI,2019,630,750,1380,59
BUGIRI,2020,700,850,1550,59
BUGIRI,2021,770,930,1700,59
BUGIRI,2022,780,930,1710,59
BUGIRI,2023,800,920,1720,59
BUGIRI,2024,810,890,1700,59
BUGIRI,2025,830,890,1720,59
BUGWERI,2015,150,180,330,59
BUGWERI,2016,160,180,340,59
BUGWERI,2017,170,210,380,59
BUGWERI,2018,200,230,430,59
BUGWERI,2019,220,270,490,59
BUGWERI,2020,240,310,550,59
BUGWERI,2021,270,320,590,59
BUGWERI,2022,270,320,590,59
BUGWERI,2023,280,320,600,59
BUGWERI,2024,270,300,570,59
BUGWERI,2025,270,300,570,59
BUHWEJU,2015,150,150,300,59
BUHWEJU,2016,160,150,310,59
BUHWEJU,2017,160,160,320,59
BUHWEJU,2018,170,160,330,59
BUHWEJU,2019,170,170,340,59
BUHWEJU,2020,180,170,350,59
BUHWEJU,2021,180,180,360,59
BUHWEJU,2022,190,180,370,59
BUHWEJU,2023,200,190,390,59
BUHWEJU,2024,200,190,390,59
BUHWEJU,2025,210,200,410,59
BUIKWE,2015,440,510,950,59
BUIKWE,2016,440,520,960,59
BUIKWE,2017,480,580,1060,59
BUIKWE,2018,540,670,1210,59
BUIKWE,2019,610,780,1390,59
BUIKWE,2020,670,870,1540,59
BUIKWE,2021,700,910,1610,59
BUIKWE,2022,720,910,1630,59
BUIKWE,2023,720,880,1600,59
BUIKWE,2024,720,840,1560,59
BUIKWE,2025,710,820,1530,59
BUKEDEA,2015,240,260,500,59
BUKEDEA,2016,250,270,520,59
BUKEDEA,2017,280,310,590,59
BUKEDEA,2018,330,370,700,59
BUKEDEA,2019,370,430,800,59
BUKEDEA,2020,420,490,910,59
BUKEDEA,2021,470,530,1000,59
BUKEDEA,2022,480,540,1020,59
BUKEDEA,2023,490,530,1020,59
BUKEDEA,2024,490,510,1000,59
BUKEDEA,2025,500,510,1010,59
BUKOMANSIMBI,2015,240,280,520,59
BUKOMANSIMBI,2016,240,280,520,59
BUKOMANSIMBI,2017,260,310,570,59
BUKOMANSIMBI,2018,280,350,630,59
BUKOMANSIMBI,2019,330,400,730,59
BUKOMANSIMBI,2020,350,440,790,59
BUKOMANSIMBI,2021,370,450,820,59
BUKOMANSIMBI,2022,370,450,820,59
BUKOMANSIMBI,2023,360,420,780,59
BUKOMANSIMBI,2024,350,400,750,59
BUKOMANSIMBI,2025,350,380,730,59
BUKWO,2015,120,100,220,59
BUKWO,2016,120,110,230,59
BUKWO,2017,130,110,240,59
BUKWO,2018,140,120,260,59
BUKWO,2019,140,130,270,59
BUKWO,2020,150,130,280,59
BUKWO,2021,160,140,300,59
BUKWO,2022,170,140,310,59
BUKWO,2023,180,150,330,59
BUKWO,2024,190,160,350,59
BUKWO,2025,190,160,350,59
BULAMBULI,2015,280,260,540,59
BULAMBULI,2016,290,270,560,59
BULAMBULI,2017,320,320,640,59
BULAMBULI,2018,370,380,750,59
BULAMBULI,2019,430,450,880,59
BULAMBULI,2020,480,510,990,59
BULAMBULI,2021,530,570,1100,59
BULAMBULI,2022,550,580,1130,59
BULAMBULI,2023,570,570,1140,59
BULAMBULI,2024,570,560,1130,59
BULAMBULI,2025,600,560,1160,59
BULIISA,2015,120,100,220,59
BULIISA,2016,130,110,240,59
BULIISA,2017,130,110,240,59
BULIISA,2018,140,120,260,59
BULIISA,2019,150,120,270,59
BULIISA,2020,160,130,290,59
BULIISA,2021,160,130,290,59
BULIISA,2022,170,140,310,59
BULIISA,2023,180,140,320,59
BULIISA,2024,190,150,340,59
BULIISA,2025,200,160,360,59
BUNDIBUGYO,2015,180,260,440,59
BUNDIBUGYO,2016,180,270,450,59
BUNDIBUGYO,2017,210,300,510,59
BUNDIBUGYO,2018,240,350,590,59
BUNDIBUGYO,2019,270,410,680,59
BUNDIBUGYO,2020,300,450,750,59
BUNDIBUGYO,2021,320,490,810,59
BUNDIBUGYO,2022,330,500,830,59
BUNDIBUGYO,2023,330,480,810,59
BUNDIBUGYO,2024,330,460,790,59
BUNDIBUGYO,2025,330,460,790,59
BUNYANGABU,2015,210,220,430,59
BUNYANGABU,2016,220,220,440,59
BUNYANGABU,2017,230,240,470,59
BUNYANGABU,2018,270,290,560,59
BUNYANGABU,2019,300,330,630,59
BUNYANGABU,2020,340,380,720,59
BUNYANGABU,2021,350,400,750,59
BUNYANGABU,2022,370,410,780,59
BUNYANGABU,2023,360,390,750,59
BUNYANGABU,2024,370,360,730,59
BUNYANGABU,2025,360,360,720,59
BUSHENYI,2015,250,300,550,59
BUSHENYI,2016,250,300,550,59
BUSHENYI,2017,250,300,550,59
BUSHENYI,2018,260,300,560,59
BUSHENYI,2019,260,310,570,59
BUSHENYI,2020,260,310,570,59
BUSHENYI,2021,260,310,570,59
BUSHENYI,2022,270,310,580,59
BUSHENYI,2023,270,310,580,59
BUSHENYI,2024,270,320,590,59
BUSHENYI,2025,270,320,590,59
BUSIA,2015,400,480,880,59
BUSIA,2016,420,490,910,59
BUSIA,2017,460,550,1010,59
BUSIA,2018,520,660,1180,59
BUSIA,2019,580,760,1340,59
BUSIA,2020,640,850,1490,59
BUSIA,2021,700,910,1610,59
BUSIA,2022,720,930,1650,59
BUSIA,2023,720,900,1620,59
BUSIA,2024,720,860,1580,59
BUSIA,2025,740,840,1580,59
BUTALEJA,2015,310,340,650,59
BUTALEJA,2016,320,350,670,59
BUTALEJA,2017,360,400,760,59
BUTALEJA,2018,420,470,890,59
BUTALEJA,2019,480,560,1040,59
BUTALEJA,2020,530,640,1170,59
BUTALEJA,2021,570,680,1250,59
BUTALEJA,2022,580,690,1270,59
BUTALEJA,2023,600,670,1270,59
BUTALEJA,2024,610,650,1260,59
BUTALEJA,2025,610,650,1260,59
BUTAMBALA,2015,110,150,260,59
BUTAMBALA,2016,120,150,270,59
BUTAMBALA,2017,120,170,290,59
BUTAMBALA,2018,140,190,330,59
BUTAMBALA,2019,150,220,370,59
BUTAMBALA,2020,180,250,430,59
BUTAMBALA,2021,180,260,440,59
BUTAMBALA,2022,180,260,440,59
BUTAMBALA,2023,180,250,430,59
BUTAMBALA,2024,180,230,410,59
BUTAMBALA,2025,170,220,390,59
BUTEBO,2015,140,160,300,59
BUTEBO,2016,150,160,310,59
BUTEBO,2017,160,180,340,59
BUTEBO,2018,180,200,380,59
BUTEBO,2019,190,250,440,59
BUTEBO,2020,210,270,480,59
BUTEBO,2021,230,280,510,59
BUTEBO,2022,230,280,510,59
BUTEBO,2023,230,270,500,59
BUTEBO,2024,220,250,470,59
BUTEBO,2025,220,250,470,59
BUVUMA,2015,100,50,150,59
BUVUMA,2016,110,60,170,59
BUVUMA,2017,110,60,170,59
BUVUMA,2018,120,60,180,59
BUVUMA,2019,130,70,200,59
BUVUMA,2020,130,70,200,59
BUVUMA,2021,140,80,220,59
BUVUMA,2022,150,80,230,59
BUVUMA,2023,160,90,250,59
BUVUMA,2024,170,90,260,59
BUVUMA,2025,180,100,280,59
BUYENDE,2015,310,270,580,59
BUYENDE,2016,330,280,610,59
BUYENDE,2017,370,330,700,59
BUYENDE,2018,420,390,810,59
BUYENDE,2019,490,460,950,59
BUYENDE,2020,540,530,1070,59
BUYENDE,2021,580,570,1150,59
BUYENDE,2022,620,580,1200,59
BUYENDE,2023,640,580,1220,59
BUYENDE,2024,640,560,1200,59
BUYENDE,2025,660,560,1220,59
DOKOLO,2015,220,230,450,59
DOKOLO,2016,220,230,450,59
DOKOLO,2017,230,240,470,59
DOKOLO,2018,240,250,490,59
DOKOLO,2019,240,250,490,59
DOKOLO,2020,250,260,510,59
DOKOLO,2021,260,270,530,59
DOKOLO,2022,270,270,540,59
DOKOLO,2023,270,280,550,59
DOKOLO,2024,280,290,570,59
DOKOLO,2025,290,290,580,59
GOMBA,2015,250,260,510,59
GOMBA,2016,250,260,510,59
GOMBA,2017,270,300,570,59
GOMBA,2018,310,340,650,59
GOMBA,2019,340,380,720,59
GOMBA,2020,380,420,800,59
GOMBA,2021,400,450,850,59
GOMBA,2022,400,450,850,59
GOMBA,2023,410,420,830,59
GOMBA,2024,400,400,800,59
GOMBA,2025,390,380,770,59
GULU,2015,200,270,470,59
GULU,2016,210,270,480,59
GULU,2017,220,280,500,59
GULU,2018,220,290,510,59
GULU,2019,230,300,530,59
GULU,2020,230,310,540,59
GULU,2021,240,320,560,59
GULU,2022,250,320,570,59
GULU,2023,250,330,580,59
GULU,2024,260,340,600,59
GULU,2025,270,350,620,59
HOIMA,2015,330,360,690,59
HOIMA,2016,340,370,710,59
HOIMA,2017,360,380,740,59
HOIMA,2018,370,390,760,59
HOIMA,2019,380,410,790,59
HOIMA,2020,400,420,820,59
HOIMA,2021,410,430,840,59
HOIMA,2022,430,450,880,59
HOIMA,2023,440,460,900,59
HOIMA,2024,460,480,940,59
HOIMA,2025,470,490,960,59
IBANDA,2015,290,340,630,59
IBANDA,2016,300,350,650,59
IBANDA,2017,300,350,650,59
IBANDA,2018,310,360,670,59
IBANDA,2019,310,370,680,59
IBANDA,2020,320,370,690,59
IBANDA,2021,330,380,710,59
IBANDA,2022,330,380,710,59
IBANDA,2023,340,390,730,59
IBANDA,2024,340,390,730,59
IBANDA,2025,350,400,750,59
IGANGA,2015,310,340,650,59
IGANGA,2016,320,350,670,59
IGANGA,2017,360,400,760,59
IGANGA,2018,390,470,860,59
IGANGA,2019,450,530,980,59
IGANGA,2020,500,600,1100,59
IGANGA,2021,530,640,1170,59
IGANGA,2022,550,650,1200,59
IGANGA,2023,560,640,1200,59
IGANGA,2024,560,610,1170,59
IGANGA,2025,570,600,1170,59
ISINGIRO,2015,500,580,1080,59
ISINGIRO,2016,520,600,1120,59
ISINGIRO,2017,540,620,1160,59
ISINGIRO,2018,560,640,1200,59
ISINGIRO,2019,580,660,1240,59
ISINGIRO,2020,600,690,1290,59
ISINGIRO,2021,620,710,1330,59
ISINGIRO,2022,640,730,1370,59
ISINGIRO,2023,660,760,1420,59
ISINGIRO,2024,680,780,1460,59
ISINGIRO,2025,710,800,1510,59
JINJA,2015,400,410,810,59
JINJA,2016,400,420,820,59
JINJA,2017,410,430,840,59
JINJA,2018,420,430,850,59
JINJA,2019,420,440,860,59
JINJA,2020,430,450,880,59
JINJA,2021,440,450,890,59
JINJA,2022,440,460,900,59
JINJA,2023,450,460,910,59
JINJA,2024,450,470,920,59
JINJA,2025,460,470,930,59
KAABONG,2015,70,210,280,59
KAABONG,2016,70,210,280,59
KAABONG,2017,70,220,290,59
KAABONG,2018,80,220,300,59
KAABONG,2019,80,230,310,59
KAABONG,2020,80,240,320,59
KAABONG,2021,80,240,320,59
KAABONG,2022,80,250,330,59
KAABONG,2023,90,250,340,59
KAABONG,2024,90,260,350,59
KAABONG,2025,90,260,350,59
KABALE,2015,320,370,690,59
KABALE,2016,330,370,700,59
KABALE,2017,340,380,720,59
KABALE,2018,340,380,720,59
KABALE,2019,350,390,740,59
KABALE,2020,350,390,740,59
KABALE,2021,350,400,750,59
KABALE,2022,360,400,760,59
KABALE,2023,360,400,760,59
KABALE,2024,370,410,780,59
KABALE,2025,370,410,780,59
KABAROLE,2015,330,370,700,59
KABAROLE,2016,340,380,720,59
KABAROLE,2017,340,390,730,59
KABAROLE,2018,350,400,750,59
KABAROLE,2019,360,400,760,59
KABAROLE,2020,370,410,780,59
KABAROLE,2021,370,420,790,59
KABAROLE,2022,380,430,810,59
KABAROLE,2023,390,440,830,59
KABAROLE,2024,390,440,830,59
KABAROLE,2025,400,450,850,59
KABERAMAIDO,2015,110,110,220,59
KABERAMAIDO,2016,120,110,230,59
KABERAMAIDO,2017,140,120,260,59
KABERAMAIDO,2018,150,150,300,59
KABERAMAIDO,2019,180,170,350,59
KABERAMAIDO,2020,190,200,390,59
KABERAMAIDO,2021,200,210,410,59
KABERAMAIDO,2022,220,200,420,59
KABERAMAIDO,2023,230,210,440,59
KABERAMAIDO,2024,220,200,420,59
KABERAMAIDO,2025,240,210,450,59
KAGADI,2015,320,340,660,59
KAGADI,2016,340,350,690,59
KAGADI,2017,350,370,720,59
KAGADI,2018,360,380,740,59
KAGADI,2019,370,390,760,59
KAGADI,2020,390,410,800,59
KAGADI,2021,400,420,820,59
KAGADI,2022,420,430,850,59
KAGADI,2023,430,450,880,59
KAGADI,2024,440,460,900,59
KAGADI,2025,460,480,940,59
KAKUMIRO,2015,330,270,600,59
KAKUMIRO,2016,350,300,650,59
KAKUMIRO,2017,390,320,710,59
KAKUMIRO,2018,420,350,770,59
KAKUMIRO,2019,460,380,840,59
KAKUMIRO,2020,500,410,910,59
KAKUMIRO,2021,540,440,980,59
KAKUMIRO,2022,590,480,1070,59
KAKUMIRO,2023,640,520,1160,59
KAKUMIRO,2024,690,560,1250,59
KAKUMIRO,2025,750,600,1350,59
KALAKI,2015,110,110,220,59
KALAKI,2016,110,120,230,59
KALAKI,2017,120,120,240,59
KALAKI,2018,120,130,250,59
KALAKI,2019,130,130,260,59
KALAKI,2020,130,140,270,59
KALAKI,2021,140,140,280,59
KALAKI,2022,140,150,290,59
KALAKI,2023,150,150,300,59
KALAKI,2024,150,160,310,59
KALAKI,2025,160,160,320,59
KALANGALA,2015,60,30,90,59
KALANGALA,2016,70,30,100,59
KALANGALA,2017,70,30,100,59
KALANGALA,2018,70,30,100,59
KALANGALA,2019,70,30,100,59
KALANGALA,2020,80,40,120,59
KALANGALA,2021,80,40,120,59
KALANGALA,2022,80,40,120,59
KALANGALA,2023,80,40,120,59
KALANGALA,2024,90,40,130,59
KALANGALA,2025,90,40,130,59
KALIRO,2015,250,250,500,59
KALIRO,2016,270,260,530,59
KALIRO,2017,300,280,580,59
KALIRO,2018,340,340,680,59
KALIRO,2019,390,400,790,59
KALIRO,2020,430,450,880,59
KALIRO,2021,470,490,960,59
KALIRO,2022,480,480,960,59
KALIRO,2023,490,480,970,59
KALIRO,2024,490,460,950,59
KALIRO,2025,490,460,950,59
KALUNGU,2015,280,320,600,59
KALUNGU,2016,280,320,600,59
KALUNGU,2017,300,350,650,59
KALUNGU,2018,340,390,730,59
KALUNGU,2019,370,460,830,59
KALUNGU,2020,400,510,910,59
KALUNGU,2021,420,530,950,59
KALUNGU,2022,430,520,950,59
KALUNGU,2023,420,490,910,59
KALUNGU,2024,410,460,870,59
KALUNGU,2025,410,460,870,59
KAMPALA,2015,1080,1200,2280,59
KAMPALA,2016,1100,1230,2330,59
KAMPALA,2017,1130,1250,2380,59
KAMPALA,2018,1150,1270,2420,59
KAMPALA,2019,1170,1300,2470,59
KAMPALA,2020,1190,1320,2510,59
KAMPALA,2021,1210,1340,2550,59
KAMPALA,2022,1230,1370,2600,59
KAMPALA,2023,1250,1390,2640,59
KAMPALA,2024,1270,1410,2680,59
KAMPALA,2025,1290,1430,2720,59
KAMULI,2015,480,620,1100,59
KAMULI,2016,500,630,1130,59
KAMULI,2017,540,710,1250,59
KAMULI,2018,620,830,1450,59
KAMULI,2019,700,960,1660,59
KAMULI,2020,770,1070,1840,59
KAMULI,2021,820,1130,1950,59
KAMULI,2022,830,1140,1970,59
KAMULI,2023,850,1110,1960,59
KAMULI,2024,850,1060,1910,59
KAMULI,2025,850,1030,1880,59
KAMWENGE,2015,280,290,570,59
KAMWENGE,2016,290,300,590,59
KAMWENGE,2017,300,310,610,59
KAMWENGE,2018,310,320,630,59
KAMWENGE,2019,330,330,660,59
KAMWENGE,2020,340,350,690,59
KAMWENGE,2021,350,360,710,59
KAMWENGE,2022,360,370,730,59
KAMWENGE,2023,380,380,760,59
KAMWENGE,2024,390,390,780,59
KAMWENGE,2025,410,410,820,59
KANUNGU,2015,280,350,630,59
KANUNGU,2016,280,360,640,59
KANUNGU,2017,290,360,650,59
KANUNGU,2018,290,370,660,59
KANUNGU,2019,300,380,680,59
KANUNGU,2020,300,380,680,59
KANUNGU,2021,310,390,700,59
KANUNGU,2022,310,390,700,59
KANUNGU,2023,310,400,710,59
KANUNGU,2024,320,400,720,59
KANUNGU,2025,320,410,730,59
KAPCHORWA,2015,130,120,250,59
KAPCHORWA,2016,130,120,250,59
KAPCHORWA,2017,140,120,260,59
KAPCHORWA,2018,140,130,270,59
KAPCHORWA,2019,150,130,280,59
KAPCHORWA,2020,150,130,280,59
KAPCHORWA,2021,150,140,290,59
KAPCHORWA,2022,160,140,300,59
KAPCHORWA,2023,160,140,300,59
KAPCHORWA,2024,170,150,320,59
KAPCHORWA,2025,170,150,320,59
KAPELEBYONG,2015,80,110,190,59
KAPELEBYONG,2016,80,120,200,59
KAPELEBYONG,2017,90,130,220,59
KAPELEBYONG,2018,110,150,260,59
KAPELEBYONG,2019,120,170,290,59
KAPELEBYONG,2020,130,200,330,59
KAPELEBYONG,2021,130,210,340,59
KAPELEBYONG,2022,150,200,350,59
KAPELEBYONG,2023,150,210,360,59
KAPELEBYONG,2024,140,200,340,59
KAPELEBYONG,2025,140,190,330,59
KASESE,2015,650,550,1200,59
KASESE,2016,680,560,1240,59
KASESE,2017,740,630,1370,59
KASESE,2018,840,730,1570,59
KASESE,2019,940,850,1790,59
KASESE,2020,1040,940,1980,59
KASESE,2021,1100,1000,2100,59
KASESE,2022,1130,1010,2140,59
KASESE,2023,1130,970,2100,59
KASESE,2024,1130,930,2060,59
KASESE,2025,1130,900,2030,59
KASSANDA,2015,310,250,560,59
KASSANDA,2016,320,260,580,59
KASSANDA,2017,330,260,590,59
KASSANDA,2018,340,270,610,59
KASSANDA,2019,350,270,620,59
KASSANDA,2020,360,280,640,59
KASSANDA,2021,370,280,650,59
KASSANDA,2022,380,290,670,59
KASSANDA,2023,390,290,680,59
KASSANDA,2024,400,300,700,59
KASSANDA,2025,410,300,710,59
KATAKWI,2015,180,200,380,59
KATAKWI,2016,180,210,390,59
KATAKWI,2017,210,230,440,59
KATAKWI,2018,230,280,510,59
KATAKWI,2019,270,320,590,59
KATAKWI,2020,290,350,640,59
KATAKWI,2021,320,380,700,59
KATAKWI,2022,320,370,690,59
KATAKWI,2023,330,370,700,59
KATAKWI,2024,320,350,670,59
KATAKWI,2025,330,350,680,59
KAYUNGA,2015,410,470,880,59
KAYUNGA,2016,430,480,910,59
KAYUNGA,2017,460,540,1000,59
KAYUNGA,2018,520,610,1130,59
KAYUNGA,2019,580,710,1290,59
KAYUNGA,2020,640,780,1420,59
KAYUNGA,2021,670,830,1500,59
KAYUNGA,2022,680,840,1520,59
KAYUNGA,2023,690,800,1490,59
KAYUNGA,2024,670,760,1430,59
KAYUNGA,2025,680,730,1410,59
KAZO,2015,220,240,460,59
KAZO,2016,220,250,470,59
KAZO,2017,230,260,490,59
KAZO,2018,240,270,510,59
KAZO,2019,250,280,530,59
KAZO,2020,260,290,550,59
KAZO,2021,270,290,560,59
KAZO,2022,280,300,580,59
KAZO,2023,290,310,600,59
KAZO,2024,300,320,620,59
KAZO,2025,310,330,640,59
KIBAALE,2015,140,140,280,59
KIBAALE,2016,150,150,300,59
KIBAALE,2017,160,160,320,59
KIBAALE,2018,170,170,340,59
KIBAALE,2019,180,180,360,59
KIBAALE,2020,190,190,380,59
KIBAALE,2021,200,200,400,59
KIBAALE,2022,210,210,420,59
KIBAALE,2023,230,220,450,59
KIBAALE,2024,240,230,470,59
KIBAALE,2025,250,250,500,59
KIBOGA,2015,180,210,390,59
KIBOGA,2016,200,210,410,59
KIBOGA,2017,210,230,440,59
KIBOGA,2018,240,280,520,59
KIBOGA,2019,270,320,590,59
KIBOGA,2020,300,360,660,59
KIBOGA,2021,320,380,700,59
KIBOGA,2022,330,390,720,59
KIBOGA,2023,330,370,700,59
KIBOGA,2024,330,350,680,59
KIBOGA,2025,330,350,680,59
KIBUKU,2015,220,260,480,59
KIBUKU,2016,230,270,500,59
KIBUKU,2017,260,310,570,59
KIBUKU,2018,280,370,650,59
KIBUKU,2019,330,410,740,59
KIBUKU,2020,370,470,840,59
KIBUKU,2021,400,510,910,59
KIBUKU,2022,420,520,940,59
KIBUKU,2023,420,510,930,59
KIBUKU,2024,430,500,930,59
KIBUKU,2025,430,490,920,59
KIKUUBE,2015,280,240,520,59
KIKUUBE,2016,290,260,550,59
KIKUUBE,2017,310,270,580,59
KIKUUBE,2018,320,280,600,59
KIKUUBE,2019,340,300,640,59
KIKUUBE,2020,360,310,670,59
KIKUUBE,2021,370,330,700,59
KIKUUBE,2022,390,340,730,59
KIKUUBE,2023,410,360,770,59
KIKUUBE,2024,430,380,810,59
KIKUUBE,2025,450,390,840,59
KIRUHURA,2015,200,180,380,59
KIRUHURA,2016,200,190,390,59
KIRUHURA,2017,210,190,400,59
KIRUHURA,2018,220,200,420,59
KIRUHURA,2019,230,210,440,59
KIRUHURA,2020,240,210,450,59
KIRUHURA,2021,240,220,460,59
KIRUHURA,2022,250,230,480,59
KIRUHURA,2023,260,240,500,59
KIRUHURA,2024,270,240,510,59
KIRUHURA,2025,280,250,530,59
KIRYANDONGO,2015,280,280,560,59
KIRYANDONGO,2016,290,290,580,59
KIRYANDONGO,2017,320,320,640,59
KIRYANDONGO,2018,370,380,750,59
KIRYANDONGO,2019,400,450,850,59
KIRYANDONGO,2020,450,490,940,59
KIRYANDONGO,2021,480,530,1010,59
KIRYANDONGO,2022,500,540,1040,59
KIRYANDONGO,2023,510,510,1020,59
KIRYANDONGO,2024,510,500,1010,59
KIRYANDONGO,2025,500,490,990,59
KISORO,2015,320,400,720,59
KISORO,2016,330,410,740,59
KISORO,2017,360,450,810,59
KISORO,2018,410,530,940,59
KISORO,2019,460,610,1070,59
KISORO,2020,500,670,1170,59
KISORO,2021,530,720,1250,59
KISORO,2022,530,730,1260,59
KISORO,2023,540,690,1230,59
KISORO,2024,530,660,1190,59
KISORO,2025,540,630,1170,59
KITAGWENDA,2015,190,190,380,59
KITAGWENDA,2016,200,200,400,59
KITAGWENDA,2017,210,210,420,59
KITAGWENDA,2018,220,220,440,59
KITAGWENDA,2019,220,220,440,59
KITAGWENDA,2020,230,230,460,59
KITAGWENDA,2021,240,240,480,59
KITAGWENDA,2022,250,250,500,59
KITAGWENDA,2023,260,250,510,59
KITAGWENDA,2024,270,260,530,59
KITAGWENDA,2025,280,270,550,59
KITGUM,2015,220,260,480,59
KITGUM,2016,220,260,480,59
KITGUM,2017,230,280,510,59
KITGUM,2018,270,340,610,59
KITGUM,2019,300,380,680,59
KITGUM,2020,320,420,740,59
KITGUM,2021,350,450,800,59
KITGUM,2022,350,450,800,59
KITGUM,2023,340,420,760,59
KITGUM,2024,330,410,740,59
KITGUM,2025,350,400,750,59
KOBOKO,2015,200,190,390,59
KOBOKO,2016,200,200,400,59
KOBOKO,2017,220,220,440,59
KOBOKO,2018,260,260,520,59
KOBOKO,2019,300,320,620,59
KOBOKO,2020,320,350,670,59
KOBOKO,2021,350,380,730,59
KOBOKO,2022,370,390,760,59
KOBOKO,2023,380,370,750,59
KOBOKO,2024,380,360,740,59
KOBOKO,2025,380,360,740,59
KOLE,2015,200,220,420,59
KOLE,2016,210,230,440,59
KOLE,2017,210,230,440,59
KOLE,2018,220,240,460,59
KOLE,2019,230,250,480,59
KOLE,2020,230,250,480,59
KOLE,2021,240,260,500,59
KOLE,2022,250,270,520,59
KOLE,2023,250,270,520,59
KOLE,2024,260,280,540,59
KOLE,2025,270,290,560,59
KOTIDO,2015,180,220,400,59
KOTIDO,2016,180,220,400,59
KOTIDO,2017,200,260,460,59
KOTIDO,2018,230,290,520,59
KOTIDO,2019,250,330,580,59
KOTIDO,2020,290,380,670,59
KOTIDO,2021,300,400,700,59
KOTIDO,2022,300,410,710,59
KOTIDO,2023,310,390,700,59
KOTIDO,2024,300,380,680,59
KOTIDO,2025,310,360,670,59
KUMI,2015,310,410,720,59
KUMI,2016,320,420,740,59
KUMI,2017,360,480,840,59
KUMI,2018,410,560,970,59
KUMI,2019,460,650,1110,59
KUMI,2020,510,730,1240,59
KUMI,2021,550,770,1320,59
KUMI,2022,570,780,1350,59
KUMI,2023,570,760,1330,59
KUMI,2024,570,730,1300,59
KUMI,2025,580,710,1290,59
KWANIA,2015,190,170,360,59
KWANIA,2016,190,180,370,59
KWANIA,2017,200,180,380,59
KWANIA,2018,210,190,400,59
KWANIA,2019,210,200,410,59
KWANIA,2020,220,200,420,59
KWANIA,2021,220,210,430,59
KWANIA,2022,230,210,440,59
KWANIA,2023,240,220,460,59
KWANIA,2024,240,220,460,59
KWANIA,2025,250,230,480,59
KWEEN,2015,90,100,190,59
KWEEN,2016,90,100,190,59
KWEEN,2017,100,100,200,59
KWEEN,2018,100,100,200,59
KWEEN,2019,100,110,210,59
KWEEN,2020,110,110,220,59
KWEEN,2021,110,110,220,59
KWEEN,2022,110,110,220,59
KWEEN,2023,120,120,240,59
KWEEN,2024,120,120,240,59
KWEEN,2025,120,120,240,59
KYANKWANZI,2015,240,210,450,59
KYANKWANZI,2016,250,220,470,59
KYANKWANZI,2017,260,230,490,59
KYANKWANZI,2018,280,240,520,59
KYANKWANZI,2019,290,250,540,59
KYANKWANZI,2020,310,260,570,59
KYANKWANZI,2021,320,270,590,59
KYANKWANZI,2022,340,290,630,59
KYANKWANZI,2023,350,300,650,59
KYANKWANZI,2024,370,310,680,59
KYANKWANZI,2025,390,320,710,59
KYEGEGWA,2015,250,230,480,59
KYEGEGWA,2016,270,240,510,59
KYEGEGWA,2017,290,260,550,59
KYEGEGWA,2018,310,280,590,59
KYEGEGWA,2019,340,310,650,59
KYEGEGWA,2020,360,330,690,59
KYEGEGWA,2021,390,360,750,59
KYEGEGWA,2022,430,380,810,59
KYEGEGWA,2023,460,410,870,59
KYEGEGWA,2024,490,440,930,59
KYEGEGWA,2025,530,480,1010,59
KYENJOJO,2015,390,450,840,59
KYENJOJO,2016,410,470,880,59
KYENJOJO,2017,420,480,900,59
KYENJOJO,2018,440,500,940,59
KYENJOJO,2019,460,520,980,59
KYENJOJO,2020,470,540,1010,59
KYENJOJO,2021,490,560,1050,59
KYENJOJO,2022,510,580,1090,59
KYENJOJO,2023,530,590,1120,59
KYENJOJO,2024,550,610,1160,59
KYENJOJO,2025,570,630,1200,59
KYOTERA,2015,290,420,710,59
KYOTERA,2016,300,420,720,59
KYOTERA,2017,320,480,800,59
KYOTERA,2018,370,540,910,59
KYOTERA,2019,400,630,1030,59
KYOTERA,2020,430,690,1120,59
KYOTERA,2021,470,720,1190,59
KYOTERA,2022,470,730,1200,59
KYOTERA,2023,470,690,1160,59
KYOTERA,2024,460,660,1120,59
KYOTERA,2025,460,630,1090,59
KARENGA,2015,70,70,140,59
KARENGA,2016,70,70,140,59
KARENGA,2017,80,70,150,59
KARENGA,2018,80,70,150,59
KARENGA,2019,80,70,150,59
KARENGA,2020,80,70,150,59
KARENGA,2021,80,80,160,59
KARENGA,2022,90,80,170,59
KARENGA,2023,90,80,170,59
KARENGA,2024,90,80,170,59
KARENGA,2025,90,80,170,59
LAMWO,2015,140,200,340,59
LAMWO,2016,140,200,340,59
LAMWO,2017,150,220,370,59
LAMWO,2018,160,260,420,59
LAMWO,2019,190,300,490,59
LAMWO,2020,210,330,540,59
LAMWO,2021,220,340,560,59
LAMWO,2022,220,350,570,59
LAMWO,2023,210,340,550,59
LAMWO,2024,210,310,520,59
LAMWO,2025,200,300,500,59
LIRA,2015,350,360,710,59
LIRA,2016,360,370,730,59
LIRA,2017,370,380,750,59
LIRA,2018,380,390,770,59
LIRA,2019,390,400,790,59
LIRA,2020,400,410,810,59
LIRA,2021,410,420,830,59
LIRA,2022,420,430,850,59
LIRA,2023,430,440,870,59
LIRA,2024,440,450,890,59
LIRA,2025,450,470,920,59
LUUKA,2015,210,260,470,59
LUUKA,2016,220,260,480,59
LUUKA,2017,230,300,530,59
LUUKA,2018,270,340,610,59
LUUKA,2019,300,400,700,59
LUUKA,2020,320,440,760,59
LUUKA,2021,350,470,820,59
LUUKA,2022,350,470,820,59
LUUKA,2023,360,440,800,59
LUUKA,2024,350,430,780,59
LUUKA,2025,350,410,760,59
LUWERO,2015,520,620,1140,59
LUWERO,2016,530,630,1160,59
LUWERO,2017,590,710,1300,59
LUWERO,2018,660,830,1490,59
LUWERO,2019,750,960,1710,59
LUWERO,2020,820,1070,1890,59
LUWERO,2021,880,1130,2010,59
LUWERO,2022,900,1140,2040,59
LUWERO,2023,900,1100,2000,59
LUWERO,2024,890,1060,1950,59
LUWERO,2025,900,1030,1930,59
LWENGO,2015,380,450,830,59
LWENGO,2016,390,460,850,59
LWENGO,2017,420,500,920,59
LWENGO,2018,460,570,1030,59
LWENGO,2019,520,660,1180,59
LWENGO,2020,560,730,1290,59
LWENGO,2021,580,760,1340,59
LWENGO,2022,600,740,1340,59
LWENGO,2023,590,720,1310,59
LWENGO,2024,570,680,1250,59
LWENGO,2025,570,650,1220,59
LYANTONDE,2015,100,90,190,59
LYANTONDE,2016,100,110,210,59
LYANTONDE,2017,110,120,230,59
LYANTONDE,2018,140,130,270,59
LYANTONDE,2019,150,150,300,59
LYANTONDE,2020,160,180,340,59
LYANTONDE,2021,180,190,370,59
LYANTONDE,2022,180,190,370,59
LYANTONDE,2023,180,180,360,59
LYANTONDE,2024,180,180,360,59
LYANTONDE,2025,190,170,360,59
MANAFWA,2015,220,250,470,59
MANAFWA,2016,220,260,480,59
MANAFWA,2017,230,270,500,59
MANAFWA,2018,230,270,500,59
MANAFWA,2019,240,280,520,59
MANAFWA,2020,240,280,520,59
MANAFWA,2021,250,290,540,59
MANAFWA,2022,260,290,550,59
MANAFWA,2023,260,300,560,59
MANAFWA,2024,270,310,580,59
MANAFWA,2025,270,310,580,59
MARACHA,2015,200,240,440,59
MARACHA,2016,200,240,440,59
MARACHA,2017,210,250,460,59
MARACHA,2018,210,250,460,59
MARACHA,2019,220,260,480,59
MARACHA,2020,220,260,480,59
MARACHA,2021,230,270,500,59
MARACHA,2022,230,270,500,59
MARACHA,2023,230,280,510,59
MARACHA,2024,240,280,520,59
MARACHA,2025,240,280,520,59
MASAKA,2015,290,460,750,59
MASAKA,2016,270,420,690,59
MASAKA,2017,270,400,670,59
MASAKA,2018,280,400,680,59
MASAKA,2019,310,450,760,59
MASAKA,2020,340,530,870,59
MASAKA,2021,390,600,990,59
MASAKA,2022,420,680,1100,59
MASAKA,2023,460,710,1170,59
MASAKA,2024,460,720,1180,59
MASAKA,2025,470,680,1150,59
MASINDI,2015,290,290,580,59
MASINDI,2016,290,300,590,59
MASINDI,2017,300,310,610,59
MASINDI,2018,310,320,630,59
MASINDI,2019,320,320,640,59
MASINDI,2020,330,330,660,59
MASINDI,2021,340,340,680,59
MASINDI,2022,350,350,700,59
MASINDI,2023,360,360,720,59
MASINDI,2024,370,360,730,59
MASINDI,2025,370,370,740,59
MAYUGE,2015,440,530,970,59
MAYUGE,2016,450,540,990,59
MAYUGE,2017,510,600,1110,59
MAYUGE,2018,570,720,1290,59
MAYUGE,2019,640,830,1470,59
MAYUGE,2020,720,940,1660,59
MAYUGE,2021,770,1000,1770,59
MAYUGE,2022,780,1020,1800,59
MAYUGE,2023,800,990,1790,59
MAYUGE,2024,800,960,1760,59
MAYUGE,2025,800,940,1740,59
MBALE,2015,620,740,1360,59
MBALE,2016,650,770,1420,59
MBALE,2017,720,870,1590,59
MBALE,2018,810,1020,1830,59
MBALE,2019,910,1190,2100,59
MBALE,2020,1010,1360,2370,59
MBALE,2021,1080,1450,2530,59
MBALE,2022,1120,1470,2590,59
MBALE,2023,1130,1450,2580,59
MBALE,2024,1130,1390,2520,59
MBALE,2025,1150,1360,2510,59
MBARARA,2015,320,360,680,59
MBARARA,2016,330,360,690,59
MBARARA,2017,330,370,700,59
MBARARA,2018,340,380,720,59
MBARARA,2019,350,390,740,59
MBARARA,2020,360,400,760,59
MBARARA,2021,360,400,760,59
MBARARA,2022,370,410,780,59
MBARARA,2023,380,420,800,59
MBARARA,2024,390,430,820,59
MBARARA,2025,390,430,820,59
MITOOMA,2015,230,270,500,59
MITOOMA,2016,230,270,500,59
MITOOMA,2017,240,270,510,59
MITOOMA,2018,240,280,520,59
MITOOMA,2019,240,280,520,59
MITOOMA,2020,250,280,530,59
MITOOMA,2021,250,280,530,59
MITOOMA,2022,250,280,530,59
MITOOMA,2023,250,290,540,59
MITOOMA,2024,250,290,540,59
MITOOMA,2025,260,290,550,59
MITYANA,2015,440,550,990,59
MITYANA,2016,440,550,990,59
MITYANA,2017,480,620,1100,59
MITYANA,2018,540,720,1260,59
MITYANA,2019,610,830,1440,59
MITYANA,2020,660,910,1570,59
MITYANA,2021,700,960,1660,59
MITYANA,2022,720,970,1690,59
MITYANA,2023,700,920,1620,59
MITYANA,2024,700,880,1580,59
MITYANA,2025,710,860,1570,59
MOROTO,2015,130,150,280,59
MOROTO,2016,130,160,290,59
MOROTO,2017,150,180,330,59
MOROTO,2018,160,200,360,59
MOROTO,2019,180,250,430,59
MOROTO,2020,190,270,460,59
MOROTO,2021,220,300,520,59
MOROTO,2022,220,300,520,59
MOROTO,2023,210,280,490,59
MOROTO,2024,210,280,490,59
MOROTO,2025,220,270,490,59
MOYO,2015,140,180,320,59
MOYO,2016,150,180,330,59
MOYO,2017,150,190,340,59
MOYO,2018,150,190,340,59
MOYO,2019,160,190,350,59
MOYO,2020,160,200,360,59
MOYO,2021,170,200,370,59
MOYO,2022,170,210,380,59
MOYO,2023,170,210,380,59
MOYO,2024,180,210,390,59
MOYO,2025,180,220,400,59
MPIGI,2015,330,380,710,59
MPIGI,2016,350,390,740,59
MPIGI,2017,370,440,810,59
MPIGI,2018,420,510,930,59
MPIGI,2019,480,580,1060,59
MPIGI,2020,530,650,1180,59
MPIGI,2021,550,700,1250,59
MPIGI,2022,570,710,1280,59
MPIGI,2023,570,690,1260,59
MPIGI,2024,560,650,1210,59
MPIGI,2025,570,630,1200,59
MUBENDE,2015,530,500,1030,59
MUBENDE,2016,530,480,1010,59
MUBENDE,2017,520,450,970,59
MUBENDE,2018,520,440,960,59
MUBENDE,2019,550,470,1020,59
MUBENDE,2020,620,540,1160,59
MUBENDE,2021,720,640,1360,59
MUBENDE,2022,840,760,1600,59
MUBENDE,2023,950,880,1830,59
MUBENDE,2024,1030,960,1990,59
MUBENDE,2025,1100,990,2090,59
MUKONO,2015,680,840,1520,59
MUKONO,2016,700,860,1560,59
MUKONO,2017,780,960,1740,59
MUKONO,2018,880,1120,2000,59
MUKONO,2019,980,1310,2290,59
MUKONO,2020,1090,1470,2560,59
MUKONO,2021,1160,1590,2750,59
MUKONO,2022,1200,1600,2800,59
MUKONO,2023,1190,1560,2750,59
MUKONO,2024,1200,1490,2690,59
MUKONO,2025,1210,1460,2670,59
MADI OKOLLO,2015,140,140,280,59
MADI OKOLLO,2016,140,150,290,59
MADI OKOLLO,2017,150,150,300,59
MADI OKOLLO,2018,150,150,300,59
MADI OKOLLO,2019,160,160,320,59
MADI OKOLLO,2020,160,160,320,59
MADI OKOLLO,2021,170,170,340,59
MADI OKOLLO,2022,170,170,340,59
MADI OKOLLO,2023,180,180,360,59
MADI OKOLLO,2024,180,180,360,59
MADI OKOLLO,2025,180,180,360,59
NABILATUK,2015,70,110,180,59
NABILATUK,2016,70,120,190,59
NABILATUK,2017,90,130,220,59
NABILATUK,2018,90,160,250,59
NABILATUK,2019,120,180,300,59
NABILATUK,2020,130,200,330,59
NABILATUK,2021,130,230,360,59
NABILATUK,2022,150,220,370,59
NABILATUK,2023,150,230,380,59
NABILATUK,2024,160,220,380,59
NABILATUK,2025,160,220,380,59
NAKAPIRIPIRIT,2015,100,140,240,59
NAKAPIRIPIRIT,2016,100,140,240,59
NAKAPIRIPIRIT,2017,120,170,290,59
NAKAPIRIPIRIT,2018,140,190,330,59
NAKAPIRIPIRIT,2019,160,230,390,59
NAKAPIRIPIRIT,2020,180,250,430,59
NAKAPIRIPIRIT,2021,180,280,460,59
NAKAPIRIPIRIT,2022,200,300,500,59
NAKAPIRIPIRIT,2023,200,280,480,59
NAKAPIRIPIRIT,2024,210,280,490,59
NAKAPIRIPIRIT,2025,200,270,470,59
NAKASEKE,2015,220,220,440,59
NAKASEKE,2016,230,230,460,59
NAKASEKE,2017,230,230,460,59
NAKASEKE,2018,240,240,480,59
NAKASEKE,2019,250,240,490,59
NAKASEKE,2020,260,250,510,59
NAKASEKE,2021,270,250,520,59
NAKASEKE,2022,280,260,540,59
NAKASEKE,2023,290,270,560,59
NAKASEKE,2024,300,270,570,59
NAKASEKE,2025,300,280,580,59
NAKASONGOLA,2015,220,150,370,59
NAKASONGOLA,2016,230,160,390,59
NAKASONGOLA,2017,250,180,430,59
NAKASONGOLA,2018,280,220,500,59
NAKASONGOLA,2019,310,250,560,59
NAKASONGOLA,2020,350,270,620,59
NAKASONGOLA,2021,380,300,680,59
NAKASONGOLA,2022,400,300,700,59
NAKASONGOLA,2023,390,280,670,59
NAKASONGOLA,2024,400,280,680,59
NAKASONGOLA,2025,410,270,680,59
NAMAYINGO,2015,260,270,530,59
NAMAYINGO,2016,270,270,540,59
NAMAYINGO,2017,300,310,610,59
NAMAYINGO,2018,330,350,680,59
NAMAYINGO,2019,370,410,780,59
NAMAYINGO,2020,400,450,850,59
NAMAYINGO,2021,420,470,890,59
NAMAYINGO,2022,430,470,900,59
NAMAYINGO,2023,420,460,880,59
NAMAYINGO,2024,430,430,860,59
NAMAYINGO,2025,430,410,840,59
NAMISINDWA,2015,300,280,580,59
NAMISINDWA,2016,310,290,600,59
NAMISINDWA,2017,310,300,610,59
NAMISINDWA,2018,320,300,620,59
NAMISINDWA,2019,330,310,640,59
NAMISINDWA,2020,340,320,660,59
NAMISINDWA,2021,350,330,680,59
NAMISINDWA,2022,360,330,690,59
NAMISINDWA,2023,370,340,710,59
NAMISINDWA,2024,380,350,730,59
NAMISINDWA,2025,380,350,730,59
NAMUTUMBA,2015,290,320,610,59
NAMUTUMBA,2016,300,330,630,59
NAMUTUMBA,2017,330,370,700,59
NAMUTUMBA,2018,380,440,820,59
NAMUTUMBA,2019,430,500,930,59
NAMUTUMBA,2020,480,560,1040,59
NAMUTUMBA,2021,520,600,1120,59
NAMUTUMBA,2022,530,610,1140,59
NAMUTUMBA,2023,540,600,1140,59
NAMUTUMBA,2024,540,580,1120,59
NAMUTUMBA,2025,550,570,1120,59
NAPAK,2015,200,320,520,59
NAPAK,2016,210,320,530,59
NAPAK,2017,220,360,580,59
NAPAK,2018,240,420,660,59
NAPAK,2019,270,480,750,59
NAPAK,2020,300,540,840,59
NAPAK,2021,320,570,890,59
NAPAK,2022,320,580,900,59
NAPAK,2023,330,550,880,59
NAPAK,2024,320,530,850,59
NAPAK,2025,310,510,820,59
NEBBI,2015,230,280,510,59
NEBBI,2016,230,290,520,59
NEBBI,2017,240,290,530,59
NEBBI,2018,250,300,550,59
NEBBI,2019,260,310,570,59
NEBBI,2020,270,320,590,59
NEBBI,2021,270,330,600,59
NEBBI,2022,280,340,620,59
NEBBI,2023,290,350,640,59
NEBBI,2024,300,350,650,59
NEBBI,2025,300,360,660,59
NGORA,2015,160,180,340,59
NGORA,2016,160,180,340,59
NGORA,2017,170,190,360,59
NGORA,2018,200,230,430,59
NGORA,2019,220,270,490,59
NGORA,2020,260,310,570,59
NGORA,2021,270,320,590,59
NGORA,2022,280,320,600,59
NGORA,2023,280,320,600,59
NGORA,2024,270,300,570,59
NGORA,2025,280,300,580,59
NTOROKO,2015,80,60,140,59
NTOROKO,2016,80,60,140,59
NTOROKO,2017,90,60,150,59
NTOROKO,2018,90,70,160,59
NTOROKO,2019,100,80,180,59
NTOROKO,2020,130,90,220,59
NTOROKO,2021,130,90,220,59
NTOROKO,2022,130,90,220,59
NTOROKO,2023,130,90,220,59
NTOROKO,2024,130,100,230,59
NTOROKO,2025,130,100,230,59
NTUNGAMO,2015,530,610,1140,59
NTUNGAMO,2016,540,620,1160,59
NTUNGAMO,2017,550,630,1180,59
NTUNGAMO,2018,560,640,1200,59
NTUNGAMO,2019,580,660,1240,59
NTUNGAMO,2020,590,670,1260,59
NTUNGAMO,2021,600,680,1280,59
NTUNGAMO,2022,610,690,1300,59
NTUNGAMO,2023,620,700,1320,59
NTUNGAMO,2024,630,710,1340,59
NTUNGAMO,2025,640,720,1360,59
NWOYA,2015,130,150,280,59
NWOYA,2016,140,170,310,59
NWOYA,2017,160,190,350,59
NWOYA,2018,170,200,370,59
NWOYA,2019,190,220,410,59
NWOYA,2020,210,250,460,59
NWOYA,2021,230,270,500,59
NWOYA,2022,250,300,550,59
NWOYA,2023,280,330,610,59
NWOYA,2024,310,360,670,59
NWOYA,2025,340,400,740,59
OBONGI,2015,50,50,100,59
OBONGI,2016,50,50,100,59
OBONGI,2017,60,50,110,59
OBONGI,2018,70,60,130,59
OBONGI,2019,70,70,140,59
OBONGI,2020,80,70,150,59
OBONGI,2021,80,80,160,59
OBONGI,2022,80,70,150,59
OBONGI,2023,80,90,170,59
OBONGI,2024,80,80,160,59
OBONGI,2025,80,80,160,59
OMORO,2015,170,210,380,59
OMORO,2016,170,210,380,59
OMORO,2017,200,240,440,59
OMORO,2018,220,280,500,59
OMORO,2019,250,330,580,59
OMORO,2020,270,380,650,59
OMORO,2021,300,400,700,59
OMORO,2022,320,410,730,59
OMORO,2023,310,410,720,59
OMORO,2024,320,400,720,59
OMORO,2025,330,380,710,59
OTUKE,2015,120,100,220,59
OTUKE,2016,130,100,230,59
OTUKE,2017,140,110,250,59
OTUKE,2018,140,110,250,59
OTUKE,2019,150,120,270,59
OTUKE,2020,150,120,270,59
OTUKE,2021,160,130,290,59
OTUKE,2022,170,130,300,59
OTUKE,2023,170,140,310,59
OTUKE,2024,180,140,320,59
OTUKE,2025,190,150,340,59
OYAM,2015,350,450,800,59
OYAM,2016,360,460,820,59
OYAM,2017,370,470,840,59
OYAM,2018,380,490,870,59
OYAM,2019,400,500,900,59
OYAM,2020,410,510,920,59
OYAM,2021,420,530,950,59
OYAM,2022,430,540,970,59
OYAM,2023,440,560,1000,59
OYAM,2024,450,570,1020,59
OYAM,2025,470,580,1050,59
PADER,2015,150,190,340,59
PADER,2016,160,190,350,59
PADER,2017,170,220,390,59
PADER,2018,190,250,440,59
PADER,2019,210,280,490,59
PADER,2020,240,330,570,59
PADER,2021,250,340,590,59
PADER,2022,250,340,590,59
PADER,2023,250,340,590,59
PADER,2024,260,310,570,59
PADER,2025,250,300,550,59
PAKWACH,2015,140,170,310,59
PAKWACH,2016,140,170,310,59
PAKWACH,2017,150,180,330,59
PAKWACH,2018,150,190,340,59
PAKWACH,2019,160,190,350,59
PAKWACH,2020,170,200,370,59
PAKWACH,2021,170,210,380,59
PAKWACH,2022,180,210,390,59
PAKWACH,2023,190,220,410,59
PAKWACH,2024,190,230,420,59
PAKWACH,2025,200,240,440,59
PALLISA,2015,300,380,680,59
PALLISA,2016,320,400,720,59
PALLISA,2017,360,450,810,59
PALLISA,2018,410,540,950,59
PALLISA,2019,460,630,1090,59
PALLISA,2020,530,730,1260,59
PALLISA,2021,570,790,1360,59
PALLISA,2022,600,800,1400,59
PALLISA,2023,600,800,1400,59
PALLISA,2024,620,780,1400,59
PALLISA,2025,630,760,1390,59
RAKAI,2015,300,380,680,59
RAKAI,2016,310,390,700,59
RAKAI,2017,330,440,770,59
RAKAI,2018,380,500,880,59
RAKAI,2019,430,580,1010,59
RAKAI,2020,460,650,1110,59
RAKAI,2021,500,680,1180,59
RAKAI,2022,520,690,1210,59
RAKAI,2023,520,670,1190,59
RAKAI,2024,510,650,1160,59
RAKAI,2025,520,620,1140,59
RUBANDA,2015,200,270,470,59
RUBANDA,2016,210,270,480,59
RUBANDA,2017,210,270,480,59
RUBANDA,2018,210,270,480,59
RUBANDA,2019,210,280,490,59
RUBANDA,2020,220,280,500,59
RUBANDA,2021,220,280,500,59
RUBANDA,2022,220,280,500,59
RUBANDA,2023,220,280,500,59
RUBANDA,2024,230,280,510,59
RUBANDA,2025,230,280,510,59
RUBIRIZI,2015,130,190,320,59
RUBIRIZI,2016,130,190,320,59
RUBIRIZI,2017,140,200,340,59
RUBIRIZI,2018,140,200,340,59
RUBIRIZI,2019,140,200,340,59
RUBIRIZI,2020,140,210,350,59
RUBIRIZI,2021,150,210,360,59
RUBIRIZI,2022,150,210,360,59
RUBIRIZI,2023,150,220,370,59
RUBIRIZI,2024,150,220,370,59
RUBIRIZI,2025,160,220,380,59
RUKIGA,2015,160,190,350,59
RUKIGA,2016,160,190,350,59
RUKIGA,2017,160,190,350,59
RUKIGA,2018,160,190,350,59
RUKIGA,2019,160,190,350,59
RUKIGA,2020,160,190,350,59
RUKIGA,2021,160,190,350,59
RUKIGA,2022,170,190,360,59
RUKIGA,2023,170,190,360,59
RUKIGA,2024,170,200,370,59
RUKIGA,2025,170,200,370,59
RUKUNGIRI,2015,450,510,960,59
RUKUNGIRI,2016,450,520,970,59
RUKUNGIRI,2017,460,520,980,59
RUKUNGIRI,2018,460,520,980,59
RUKUNGIRI,2019,470,530,1000,59
RUKUNGIRI,2020,470,530,1000,59
RUKUNGIRI,2021,480,540,1020,59
RUKUNGIRI,2022,480,540,1020,59
RUKUNGIRI,2023,490,550,1040,59
RUKUNGIRI,2024,490,550,1040,59
RUKUNGIRI,2025,490,550,1040,59
RWAMPARA,2015,150,170,320,59
RWAMPARA,2016,150,180,330,59
RWAMPARA,2017,160,180,340,59
RWAMPARA,2018,160,180,340,59
RWAMPARA,2019,160,190,350,59
RWAMPARA,2020,170,190,360,59
RWAMPARA,2021,170,200,370,59
RWAMPARA,2022,170,200,370,59
RWAMPARA,2023,180,200,380,59
RWAMPARA,2024,180,210,390,59
RWAMPARA,2025,180,210,390,59
SERERE,2015,320,350,670,59
SERERE,2016,350,360,710,59
SERERE,2017,380,420,800,59
SERERE,2018,430,500,930,59
SERERE,2019,490,580,1070,59
SERERE,2020,560,650,1210,59
SERERE,2021,600,720,1320,59
SERERE,2022,630,730,1360,59
SERERE,2023,640,720,1360,59
SERERE,2024,640,700,1340,59
SERERE,2025,660,680,1340,59
SHEEMA,2015,250,270,520,59
SHEEMA,2016,250,270,520,59
SHEEMA,2017,260,270,530,59
SHEEMA,2018,260,280,540,59
SHEEMA,2019,260,280,540,59
SHEEMA,2020,270,280,550,59
SHEEMA,2021,270,280,550,59
SHEEMA,2022,270,290,560,59
SHEEMA,2023,270,290,560,59
SHEEMA,2024,280,290,570,59
SHEEMA,2025,280,290,570,59
SIRONKO,2015,380,350,730,59
SIRONKO,2016,390,360,750,59
SIRONKO,2017,400,360,760,59
SIRONKO,2018,410,370,780,59
SIRONKO,2019,420,380,800,59
SIRONKO,2020,430,380,810,59
SIRONKO,2021,440,390,830,59
SIRONKO,2022,450,400,850,59
SIRONKO,2023,450,400,850,59
SIRONKO,2024,460,410,870,59
SIRONKO,2025,470,420,890,59
SOROTI,2015,330,350,680,59
SOROTI,2016,350,360,710,59
SOROTI,2017,380,410,790,59
SOROTI,2018,450,500,950,59
SOROTI,2019,510,580,1090,59
SOROTI,2020,560,650,1210,59
SOROTI,2021,600,700,1300,59
SOROTI,2022,630,710,1340,59
SOROTI,2023,640,690,1330,59
SOROTI,2024,640,680,1320,59
SOROTI,2025,650,670,1320,59
SSEMBABULE,2015,340,390,730,59
SSEMBABULE,2016,360,400,760,59
SSEMBABULE,2017,390,450,840,59
SSEMBABULE,2018,450,530,980,59
SSEMBABULE,2019,510,610,1120,59
SSEMBABULE,2020,560,690,1250,59
SSEMBABULE,2021,600,740,1340,59
SSEMBABULE,2022,620,740,1360,59
SSEMBABULE,2023,620,720,1340,59
SSEMBABULE,2024,620,700,1320,59
SSEMBABULE,2025,630,680,1310,59
TORORO,2015,660,740,1400,59
TORORO,2016,680,760,1440,59
TORORO,2017,700,780,1480,59
TORORO,2018,720,800,1520,59
TORORO,2019,740,820,1560,59
TORORO,2020,750,840,1590,59
TORORO,2021,770,860,1630,59
TORORO,2022,790,880,1670,59
TORORO,2023,810,900,1710,59
TORORO,2024,830,910,1740,59
TORORO,2025,840,930,1770,59
WAKISO,2015,1440,1660,3100,59
WAKISO,2016,1540,1770,3310,59
WAKISO,2017,1640,1890,3530,59
WAKISO,2018,1750,2020,3770,59
WAKISO,2019,1870,2160,4030,59
WAKISO,2020,1990,2300,4290,59
WAKISO,2021,2120,2450,4570,59
WAKISO,2022,2250,2610,4860,59
WAKISO,2023,2390,2780,5170,59
WAKISO,2024,2540,2960,5500,59
WAKISO,2025,2700,3150,5850,59
YUMBE,2015,370,330,700,59
YUMBE,2016,390,350,740,59
YUMBE,2017,430,400,830,59
YUMBE,2018,500,480,980,59
YUMBE,2019,580,580,1160,59
YUMBE,2020,660,670,1330,59
YUMBE,2021,720,740,1460,59
YUMBE,2022,750,780,1530,59
YUMBE,2023,780,780,1560,59
YUMBE,2024,800,760,1560,59
YUMBE,2025,820,780,1600,59
ZOMBO,2015,210,240,450,59
ZOMBO,2016,210,250,460,59
ZOMBO,2017,220,250,470,59
ZOMBO,2018,230,260,490,59
ZOMBO,2019,230,270,500,59
ZOMBO,2020,240,280,520,59
ZOMBO,2021,250,280,530,59
ZOMBO,2022,260,290,550,59
ZOMBO,2023,260,300,560,59
ZOMBO,2024,270,300,570,59
ZOMBO,2025,280,310,590,59
ABIM,2015,2200,2170,4370,6
ABIM,2016,2290,2230,4520,6
ABIM,2017,2380,2320,4700,6
ABIM,2018,2480,2400,4880,6
ABIM,2019,2620,2530,5150,6
ABIM,2020,2850,2720,5570,6
ABIM,2021,2970,2990,5960,6
ABIM,2022,3130,3130,6260,6
ABIM,2023,3290,3290,6580,6
ABIM,2024,3450,3450,6900,6
ABIM,2025,3630,3610,7240,6
ADJUMANI,2015,4200,3920,8120,6
ADJUMANI,2016,4230,3960,8190,6
ADJUMANI,2017,4260,4000,8260,6
ADJUMANI,2018,4290,4040,8330,6
ADJUMANI,2019,4320,4070,8390,6
ADJUMANI,2020,4350,4110,8460,6
ADJUMANI,2021,4370,4140,8510,6
ADJUMANI,2022,4390,4170,8560,6
ADJUMANI,2023,4400,4190,8590,6
ADJUMANI,2024,4420,4220,8640,6
ADJUMANI,2025,4430,4240,8670,6
AGAGO,2015,4760,4380,9140,6
AGAGO,2016,4840,4450,9290,6
AGAGO,2017,4930,4530,9460,6
AGAGO,2018,5010,4610,9620,6
AGAGO,2019,5090,4690,9780,6
AGAGO,2020,5180,4760,9940,6
AGAGO,2021,5250,4840,10090,6
AGAGO,2022,5330,4910,10240,6
AGAGO,2023,5410,4980,10390,6
AGAGO,2024,5480,5050,10530,6
AGAGO,2025,5540,5110,10650,6
ALEBTONG,2015,4050,3830,7880,6
ALEBTONG,2016,4080,3810,7890,6
ALEBTONG,2017,4090,3820,7910,6
ALEBTONG,2018,4120,3850,7970,6
ALEBTONG,2019,4210,3910,8120,6
ALEBTONG,2020,4420,4080,8500,6
ALEBTONG,2021,4450,4330,8780,6
ALEBTONG,2022,4520,4400,8920,6
ALEBTONG,2023,4590,4470,9060,6
ALEBTONG,2024,4660,4530,9190,6
ALEBTONG,2025,4720,4590,9310,6
AMOLATAR,2015,2630,2550,5180,6
AMOLATAR,2016,2650,2530,5180,6
AMOLATAR,2017,2650,2540,5190,6
AMOLATAR,2018,2660,2550,5210,6
AMOLATAR,2019,2720,2580,5300,6
AMOLATAR,2020,2850,2690,5540,6
AMOLATAR,2021,2870,2850,5720,6
AMOLATAR,2022,2910,2890,5800,6
AMOLATAR,2023,2940,2920,5860,6
AMOLATAR,2024,2980,2960,5940,6
AMOLATAR,2025,3020,2990,6010,6
AMUDAT,2015,2480,2420,4900,6
AMUDAT,2016,2530,2450,4980,6
AMUDAT,2017,2570,2500,5070,6
AMUDAT,2018,2610,2570,5180,6
AMUDAT,2019,2690,2660,5350,6
AMUDAT,2020,2860,2830,5690,6
AMUDAT,2021,2920,3060,5980,6
AMUDAT,2022,3000,3170,6170,6
AMUDAT,2023,3070,3280,6350,6
AMUDAT,2024,3150,3400,6550,6
AMUDAT,2025,3230,3500,6730,6
AMURIA,2015,3360,3190,6550,6
AMURIA,2016,3420,3200,6620,6
AMURIA,2017,3450,3230,6680,6
AMURIA,2018,3510,3270,6780,6
AMURIA,2019,3620,3360,6980,6
AMURIA,2020,3830,3530,7360,6
AMURIA,2021,3900,3780,7680,6
AMURIA,2022,3990,3860,7850,6
AMURIA,2023,4100,3950,8050,6
AMURIA,2024,4190,4040,8230,6
AMURIA,2025,4290,4130,8420,6
AMURU,2015,3520,3310,6830,6
AMURU,2016,3540,3300,6840,6
AMURU,2017,3550,3300,6850,6
AMURU,2018,3560,3320,6880,6
AMURU,2019,3630,3380,7010,6
AMURU,2020,3800,3520,7320,6
AMURU,2021,3820,3740,7560,6
AMURU,2022,3880,3800,7680,6
AMURU,2023,3930,3850,7780,6
AMURU,2024,3980,3900,7880,6
AMURU,2025,4030,3960,7990,6
APAC,2015,3250,3110,6360,6
APAC,2016,3380,3220,6600,6
APAC,2017,3500,3340,6840,6
APAC,2018,3630,3450,7080,6
APAC,2019,3760,3570,7330,6
APAC,2020,3890,3680,7570,6
APAC,2021,4020,3800,7820,6
APAC,2022,4160,3930,8090,6
APAC,2023,4300,4050,8350,6
APAC,2024,4440,4180,8620,6
APAC,2025,4580,4300,8880,6
ARUA,2015,11130,11120,22250,6
ARUA,2016,11460,11420,22880,6
ARUA,2017,11780,11740,23520,6
ARUA,2018,12120,12040,24160,6
ARUA,2019,12460,12360,24820,6
ARUA,2020,12790,12680,25470,6
ARUA,2021,13140,12990,26130,6
ARUA,2022,13480,13310,26790,6
ARUA,2023,13820,13640,27460,6
ARUA,2024,14160,13950,28110,6
ARUA,2025,14490,14260,28750,6
BUDAKA,2015,3790,3450,7240,6
BUDAKA,2016,3840,3440,7280,6
BUDAKA,2017,3890,3480,7370,6
BUDAKA,2018,3940,3530,7470,6
BUDAKA,2019,4060,3610,7670,6
BUDAKA,2020,4290,3790,8080,6
BUDAKA,2021,4360,4050,8410,6
BUDAKA,2022,4470,4140,8610,6
BUDAKA,2023,4570,4240,8810,6
BUDAKA,2024,4680,4330,9010,6
BUDAKA,2025,4770,4420,9190,6
BUDUDA,2015,4040,3920,7960,6
BUDUDA,2016,4140,3960,8100,6
BUDUDA,2017,4220,4040,8260,6
BUDUDA,2018,4330,4130,8460,6
BUDUDA,2019,4490,4280,8770,6
BUDUDA,2020,4790,4540,9330,6
BUDUDA,2021,4910,4900,9810,6
BUDUDA,2022,5070,5060,10130,6
BUDUDA,2023,5230,5230,10460,6
BUDUDA,2024,5410,5400,10810,6
BUDUDA,2025,5570,5570,11140,6
BUGIRI,2015,7360,7000,14360,6
BUGIRI,2016,7510,7030,14540,6
BUGIRI,2017,7630,7140,14770,6
BUGIRI,2018,7780,7270,15050,6
BUGIRI,2019,8040,7490,15530,6
BUGIRI,2020,8540,7890,16430,6
BUGIRI,2021,8720,8480,17200,6
BUGIRI,2022,8980,8720,17700,6
BUGIRI,2023,9230,8960,18190,6
BUGIRI,2024,9490,9200,18690,6
BUGIRI,2025,9740,9430,19170,6
BUGWERI,2015,3030,2840,5870,6
BUGWERI,2016,3050,2820,5870,6
BUGWERI,2017,3060,2820,5880,6
BUGWERI,2018,3070,2840,5910,6
BUGWERI,2019,3140,2890,6030,6
BUGWERI,2020,3290,3000,6290,6
BUGWERI,2021,3320,3170,6490,6
BUGWERI,2022,3360,3220,6580,6
BUGWERI,2023,3420,3270,6690,6
BUGWERI,2024,3460,3320,6780,6
BUGWERI,2025,3510,3360,6870,6
BUHWEJU,2015,2280,2310,4590,6
BUHWEJU,2016,2360,2380,4740,6
BUHWEJU,2017,2430,2450,4880,6
BUHWEJU,2018,2510,2520,5030,6
BUHWEJU,2019,2590,2600,5190,6
BUHWEJU,2020,2670,2670,5340,6
BUHWEJU,2021,2750,2750,5500,6
BUHWEJU,2022,2840,2830,5670,6
BUHWEJU,2023,2920,2910,5830,6
BUHWEJU,2024,3000,2980,5980,6
BUHWEJU,2025,3080,3060,6140,6
BUIKWE,2015,7030,6640,13670,6
BUIKWE,2016,7030,6560,13590,6
BUIKWE,2017,7000,6530,13530,6
BUIKWE,2018,6990,6540,13530,6
BUIKWE,2019,7080,6610,13690,6
BUIKWE,2020,7380,6840,14220,6
BUIKWE,2021,7380,7210,14590,6
BUIKWE,2022,7440,7280,14720,6
BUIKWE,2023,7500,7360,14860,6
BUIKWE,2024,7550,7410,14960,6
BUIKWE,2025,7590,7470,15060,6
BUKEDEA,2015,3710,3660,7370,6
BUKEDEA,2016,3800,3690,7490,6
BUKEDEA,2017,3870,3750,7620,6
BUKEDEA,2018,3960,3830,7790,6
BUKEDEA,2019,4100,3960,8060,6
BUKEDEA,2020,4380,4180,8560,6
BUKEDEA,2021,4480,4490,8970,6
BUKEDEA,2022,4620,4630,9250,6
BUKEDEA,2023,4770,4770,9540,6
BUKEDEA,2024,4920,4910,9830,6
BUKEDEA,2025,5060,5040,10100,6
BUKOMANSIMBI,2015,2760,2410,5170,6
BUKOMANSIMBI,2016,2730,2340,5070,6
BUKOMANSIMBI,2017,2680,2300,4980,6
BUKOMANSIMBI,2018,2650,2260,4910,6
BUKOMANSIMBI,2019,2650,2260,4910,6
BUKOMANSIMBI,2020,2720,2300,5020,6
BUKOMANSIMBI,2021,2690,2390,5080,6
BUKOMANSIMBI,2022,2680,2370,5050,6
BUKOMANSIMBI,2023,2670,2360,5030,6
BUKOMANSIMBI,2024,2660,2340,5000,6
BUKOMANSIMBI,2025,2640,2320,4960,6
BUKWO,2015,1680,1650,3330,6
BUKWO,2016,1770,1730,3500,6
BUKWO,2017,1860,1820,3680,6
BUKWO,2018,1960,1910,3870,6
BUKWO,2019,2060,2000,4060,6
BUKWO,2020,2170,2090,4260,6
BUKWO,2021,2280,2190,4470,6
BUKWO,2022,2400,2290,4690,6
BUKWO,2023,2520,2400,4920,6
BUKWO,2024,2640,2500,5140,6
BUKWO,2025,2770,2610,5380,6
BULAMBULI,2015,3260,3210,6470,6
BULAMBULI,2016,3360,3270,6630,6
BULAMBULI,2017,3440,3350,6790,6
BULAMBULI,2018,3540,3440,6980,6
BULAMBULI,2019,3690,3580,7270,6
BULAMBULI,2020,3950,3810,7760,6
BULAMBULI,2021,4060,4130,8190,6
BULAMBULI,2022,4210,4290,8500,6
BULAMBULI,2023,4360,4450,8810,6
BULAMBULI,2024,4520,4610,9130,6
BULAMBULI,2025,4680,4780,9460,6
BULIISA,2015,2070,1820,3890,6
BULIISA,2016,2180,1910,4090,6
BULIISA,2017,2300,1990,4290,6
BULIISA,2018,2430,2080,4510,6
BULIISA,2019,2550,2170,4720,6
BULIISA,2020,2690,2260,4950,6
BULIISA,2021,2830,2360,5190,6
BULIISA,2022,2970,2460,5430,6
BULIISA,2023,3120,2560,5680,6
BULIISA,2024,3280,2660,5940,6
BULIISA,2025,3430,2760,6190,6
BUNDIBUGYO,2015,3890,3660,7550,6
BUNDIBUGYO,2016,3920,3640,7560,6
BUNDIBUGYO,2017,3940,3660,7600,6
BUNDIBUGYO,2018,3980,3680,7660,6
BUNDIBUGYO,2019,4070,3750,7820,6
BUNDIBUGYO,2020,4270,3910,8180,6
BUNDIBUGYO,2021,4320,4150,8470,6
BUNDIBUGYO,2022,4390,4220,8610,6
BUNDIBUGYO,2023,4470,4280,8750,6
BUNDIBUGYO,2024,4550,4350,8900,6
BUNDIBUGYO,2025,4610,4410,9020,6
BUNYANGABU,2015,3080,2810,5890,6
BUNYANGABU,2016,3100,2770,5870,6
BUNYANGABU,2017,3100,2770,5870,6
BUNYANGABU,2018,3120,2780,5900,6
BUNYANGABU,2019,3170,2820,5990,6
BUNYANGABU,2020,3320,2920,6240,6
BUNYANGABU,2021,3330,3080,6410,6
BUNYANGABU,2022,3380,3120,6500,6
BUNYANGABU,2023,3430,3150,6580,6
BUNYANGABU,2024,3470,3190,6660,6
BUNYANGABU,2025,3510,3220,6730,6
BUSHENYI,2015,3790,3570,7360,6
BUSHENYI,2016,3840,3610,7450,6
BUSHENYI,2017,3890,3640,7530,6
BUSHENYI,2018,3930,3670,7600,6
BUSHENYI,2019,3980,3700,7680,6
BUSHENYI,2020,4020,3730,7750,6
BUSHENYI,2021,4060,3750,7810,6
BUSHENYI,2022,4100,3780,7880,6
BUSHENYI,2023,4140,3800,7940,6
BUSHENYI,2024,4170,3820,7990,6
BUSHENYI,2025,4200,3830,8030,6
BUSIA,2015,5640,5330,10970,6
BUSIA,2016,5700,5300,11000,6
BUSIA,2017,5740,5330,11070,6
BUSIA,2018,5800,5380,11180,6
BUSIA,2019,5940,5490,11430,6
BUSIA,2020,6260,5720,11980,6
BUSIA,2021,6320,6090,12410,6
BUSIA,2022,6450,6200,12650,6
BUSIA,2023,6570,6310,12880,6
BUSIA,2024,6690,6410,13100,6
BUSIA,2025,6800,6510,13310,6
BUTALEJA,2015,4650,4380,9030,6
BUTALEJA,2016,4730,4380,9110,6
BUTALEJA,2017,4780,4430,9210,6
BUTALEJA,2018,4860,4500,9360,6
BUTALEJA,2019,5010,4610,9620,6
BUTALEJA,2020,5310,4860,10170,6
BUTALEJA,2021,5390,5190,10580,6
BUTALEJA,2022,5540,5320,10860,6
BUTALEJA,2023,5670,5450,11120,6
BUTALEJA,2024,5810,5570,11380,6
BUTALEJA,2025,5950,5690,11640,6
BUTAMBALA,2015,1860,1600,3460,6
BUTAMBALA,2016,1850,1560,3410,6
BUTAMBALA,2017,1830,1540,3370,6
BUTAMBALA,2018,1810,1520,3330,6
BUTAMBALA,2019,1830,1530,3360,6
BUTAMBALA,2020,1890,1560,3450,6
BUTAMBALA,2021,1870,1640,3510,6
BUTAMBALA,2022,1880,1630,3510,6
BUTAMBALA,2023,1880,1630,3510,6
BUTAMBALA,2024,1880,1640,3520,6
BUTAMBALA,2025,1880,1630,3510,6
BUTEBO,2015,1970,1910,3880,6
BUTEBO,2016,1960,1870,3830,6
BUTEBO,2017,1940,1850,3790,6
BUTEBO,2018,1930,1840,3770,6
BUTEBO,2019,1950,1850,3800,6
BUTEBO,2020,2020,1900,3920,6
BUTEBO,2021,2010,1990,4000,6
BUTEBO,2022,2010,1990,4000,6
BUTEBO,2023,2030,2000,4030,6
BUTEBO,2024,2030,2000,4030,6
BUTEBO,2025,2030,2000,4030,6
BUVUMA,2015,1490,1420,2910,6
BUVUMA,2016,1590,1520,3110,6
BUVUMA,2017,1680,1620,3300,6
BUVUMA,2018,1790,1730,3520,6
BUVUMA,2019,1890,1840,3730,6
BUVUMA,2020,2010,1960,3970,6
BUVUMA,2021,2130,2090,4220,6
BUVUMA,2022,2250,2230,4480,6
BUVUMA,2023,2380,2370,4750,6
BUVUMA,2024,2520,2520,5040,6
BUVUMA,2025,2660,2680,5340,6
BUYENDE,2015,6500,6100,12600,6
BUYENDE,2016,6650,6160,12810,6
BUYENDE,2017,6780,6270,13050,6
BUYENDE,2018,6940,6410,13350,6
BUYENDE,2019,7200,6640,13840,6
BUYENDE,2020,7680,7020,14700,6
BUYENDE,2021,7860,7580,15440,6
BUYENDE,2022,8120,7830,15950,6
BUYENDE,2023,8380,8070,16450,6
BUYENDE,2024,8650,8320,16970,6
BUYENDE,2025,8900,8570,17470,6
DOKOLO,2015,3400,3180,6580,6
DOKOLO,2016,3500,3270,6770,6
DOKOLO,2017,3610,3360,6970,6
DOKOLO,2018,3720,3450,7170,6
DOKOLO,2019,3830,3550,7380,6
DOKOLO,2020,3940,3640,7580,6
DOKOLO,2021,4050,3730,7780,6
DOKOLO,2022,4160,3820,7980,6
DOKOLO,2023,4270,3920,8190,6
DOKOLO,2024,4390,4010,8400,6
DOKOLO,2025,4500,4100,8600,6
GOMBA,2015,2730,2540,5270,6
GOMBA,2016,2720,2480,5200,6
GOMBA,2017,2700,2450,5150,6
GOMBA,2018,2690,2430,5120,6
GOMBA,2019,2720,2440,5160,6
GOMBA,2020,2820,2500,5320,6
GOMBA,2021,2810,2620,5430,6
GOMBA,2022,2830,2620,5450,6
GOMBA,2023,2850,2620,5470,6
GOMBA,2024,2850,2620,5470,6
GOMBA,2025,2870,2620,5490,6
GULU,2015,4480,4210,8690,6
GULU,2016,4620,4340,8960,6
GULU,2017,4760,4470,9230,6
GULU,2018,4900,4590,9490,6
GULU,2019,5040,4720,9760,6
GULU,2020,5190,4850,10040,6
GULU,2021,5330,4990,10320,6
GULU,2022,5480,5120,10600,6
GULU,2023,5620,5250,10870,6
GULU,2024,5770,5380,11150,6
GULU,2025,5910,5510,11420,6
HOIMA,2015,4990,4830,9820,6
HOIMA,2016,5180,4990,10170,6
HOIMA,2017,5370,5170,10540,6
HOIMA,2018,5570,5350,10920,6
HOIMA,2019,5770,5530,11300,6
HOIMA,2020,5990,5710,11700,6
HOIMA,2021,6200,5900,12100,6
HOIMA,2022,6410,6080,12490,6
HOIMA,2023,6630,6280,12910,6
HOIMA,2024,6850,6470,13320,6
HOIMA,2025,7070,6660,13730,6
IBANDA,2015,4230,4060,8290,6
IBANDA,2016,4320,4130,8450,6
IBANDA,2017,4400,4200,8600,6
IBANDA,2018,4490,4280,8770,6
IBANDA,2019,4570,4350,8920,6
IBANDA,2020,4660,4420,9080,6
IBANDA,2021,4740,4490,9230,6
IBANDA,2022,4820,4560,9380,6
IBANDA,2023,4900,4630,9530,6
IBANDA,2024,4970,4700,9670,6
IBANDA,2025,5040,4760,9800,6
IGANGA,2015,5840,5350,11190,6
IGANGA,2016,5900,5320,11220,6
IGANGA,2017,5940,5350,11290,6
IGANGA,2018,6000,5400,11400,6
IGANGA,2019,6150,5500,11650,6
IGANGA,2020,6470,5740,12210,6
IGANGA,2021,6540,6110,12650,6
IGANGA,2022,6670,6220,12890,6
IGANGA,2023,6800,6320,13120,6
IGANGA,2024,6920,6440,13360,6
IGANGA,2025,7040,6530,13570,6
ISINGIRO,2015,9240,9070,18310,6
ISINGIRO,2016,9580,9390,18970,6
ISINGIRO,2017,9940,9720,19660,6
ISINGIRO,2018,10310,10060,20370,6
ISINGIRO,2019,10680,10410,21090,6
ISINGIRO,2020,11070,10760,21830,6
ISINGIRO,2021,11450,11110,22560,6
ISINGIRO,2022,11850,11480,23330,6
ISINGIRO,2023,12250,11840,24090,6
ISINGIRO,2024,12650,12210,24860,6
ISINGIRO,2025,13050,12580,25630,6
JINJA,2015,7630,7290,14920,6
JINJA,2016,7760,7400,15160,6
JINJA,2017,7890,7520,15410,6
JINJA,2018,8020,7630,15650,6
JINJA,2019,8150,7740,15890,6
JINJA,2020,8270,7850,16120,6
JINJA,2021,8390,7950,16340,6
JINJA,2022,8510,8060,16570,6
JINJA,2023,8620,8150,16770,6
JINJA,2024,8730,8240,16970,6
JINJA,2025,8830,8330,17160,6
KAABONG,2015,2150,2240,4390,6
KAABONG,2016,2200,2300,4500,6
KAABONG,2017,2270,2350,4620,6
KAABONG,2018,2320,2410,4730,6
KAABONG,2019,2390,2460,4850,6
KAABONG,2020,2440,2520,4960,6
KAABONG,2021,2510,2580,5090,6
KAABONG,2022,2570,2640,5210,6
KAABONG,2023,2630,2690,5320,6
KAABONG,2024,2690,2740,5430,6
KAABONG,2025,2750,2790,5540,6
KABALE,2015,3410,3270,6680,6
KABALE,2016,3460,3310,6770,6
KABALE,2017,3520,3350,6870,6
KABALE,2018,3570,3390,6960,6
KABALE,2019,3620,3430,7050,6
KABALE,2020,3670,3460,7130,6
KABALE,2021,3720,3500,7220,6
KABALE,2022,3770,3530,7300,6
KABALE,2023,3820,3560,7380,6
KABALE,2024,3860,3590,7450,6
KABALE,2025,3900,3610,7510,6
KABAROLE,2015,4960,4690,9650,6
KABAROLE,2016,5070,4790,9860,6
KABAROLE,2017,5180,4900,10080,6
KABAROLE,2018,5290,5000,10290,6
KABAROLE,2019,5400,5100,10500,6
KABAROLE,2020,5510,5210,10720,6
KABAROLE,2021,5620,5310,10930,6
KABAROLE,2022,5730,5410,11140,6
KABAROLE,2023,5830,5510,11340,6
KABAROLE,2024,5930,5610,11540,6
KABAROLE,2025,6030,5700,11730,6
KABERAMAIDO,2015,1880,1780,3660,6
KABERAMAIDO,2016,1930,1790,3720,6
KABERAMAIDO,2017,1950,1820,3770,6
KABERAMAIDO,2018,2000,1860,3860,6
KABERAMAIDO,2019,2070,1920,3990,6
KABERAMAIDO,2020,2210,2020,4230,6
KABERAMAIDO,2021,2250,2170,4420,6
KABERAMAIDO,2022,2320,2240,4560,6
KABERAMAIDO,2023,2390,2290,4680,6
KABERAMAIDO,2024,2470,2360,4830,6
KABERAMAIDO,2025,2530,2420,4950,6
KAGADI,2015,6710,6590,13300,6
KAGADI,2016,6960,6830,13790,6
KAGADI,2017,7220,7070,14290,6
KAGADI,2018,7480,7320,14800,6
KAGADI,2019,7750,7570,15320,6
KAGADI,2020,8020,7830,15850,6
KAGADI,2021,8310,8090,16400,6
KAGADI,2022,8590,8350,16940,6
KAGADI,2023,8870,8620,17490,6
KAGADI,2024,9160,8890,18050,6
KAGADI,2025,9450,9160,18610,6
KAKUMIRO,2015,5590,5310,10900,6
KAKUMIRO,2016,6090,5750,11840,6
KAKUMIRO,2017,6630,6240,12870,6
KAKUMIRO,2018,7210,6760,13970,6
KAKUMIRO,2019,7850,7330,15180,6
KAKUMIRO,2020,8530,7930,16460,6
KAKUMIRO,2021,9260,8580,17840,6
KAKUMIRO,2022,10050,9280,19330,6
KAKUMIRO,2023,10900,10020,20920,6
KAKUMIRO,2024,11810,10820,22630,6
KAKUMIRO,2025,12790,11680,24470,6
KALAKI,2015,2140,1950,4090,6
KALAKI,2016,2240,2030,4270,6
KALAKI,2017,2340,2110,4450,6
KALAKI,2018,2440,2190,4630,6
KALAKI,2019,2540,2270,4810,6
KALAKI,2020,2640,2360,5000,6
KALAKI,2021,2750,2450,5200,6
KALAKI,2022,2860,2540,5400,6
KALAKI,2023,2970,2630,5600,6
KALAKI,2024,3090,2730,5820,6
KALAKI,2025,3210,2820,6030,6
KALANGALA,2015,580,550,1130,6
KALANGALA,2016,600,570,1170,6
KALANGALA,2017,620,590,1210,6
KALANGALA,2018,640,620,1260,6
KALANGALA,2019,660,640,1300,6
KALANGALA,2020,690,670,1360,6
KALANGALA,2021,710,690,1400,6
KALANGALA,2022,730,720,1450,6
KALANGALA,2023,760,750,1510,6
KALANGALA,2024,780,780,1560,6
KALANGALA,2025,800,800,1600,6
KALIRO,2015,4510,4240,8750,6
KALIRO,2016,4570,4240,8810,6
KALIRO,2017,4620,4290,8910,6
KALIRO,2018,4690,4340,9030,6
KALIRO,2019,4820,4460,9280,6
KALIRO,2020,5090,4680,9770,6
KALIRO,2021,5170,5010,10180,6
KALIRO,2022,5300,5130,10430,6
KALIRO,2023,5420,5250,10670,6
KALIRO,2024,5530,5370,10900,6
KALIRO,2025,5660,5480,11140,6
KALUNGU,2015,3210,2930,6140,6
KALUNGU,2016,3170,2860,6030,6
KALUNGU,2017,3130,2820,5950,6
KALUNGU,2018,3100,2790,5890,6
KALUNGU,2019,3110,2790,5900,6
KALUNGU,2020,3220,2860,6080,6
KALUNGU,2021,3180,2980,6160,6
KALUNGU,2022,3180,2980,6160,6
KALUNGU,2023,3180,2970,6150,6
KALUNGU,2024,3170,2970,6140,6
KALUNGU,2025,3170,2960,6130,6
KAMPALA,2015,18140,17260,35400,6
KAMPALA,2016,18500,17600,36100,6
KAMPALA,2017,18860,17940,36800,6
KAMPALA,2018,19230,18280,37510,6
KAMPALA,2019,19590,18620,38210,6
KAMPALA,2020,19950,18950,38900,6
KAMPALA,2021,20300,19280,39580,6
KAMPALA,2022,20640,19600,40240,6
KAMPALA,2023,20970,19920,40890,6
KAMPALA,2024,21290,20220,41510,6
KAMPALA,2025,21600,20520,42120,6
KAMULI,2015,8860,8340,17200,6
KAMULI,2016,8910,8250,17160,6
KAMULI,2017,8920,8240,17160,6
KAMULI,2018,8970,8260,17230,6
KAMULI,2019,9140,8380,17520,6
KAMULI,2020,9570,8690,18260,6
KAMULI,2021,9620,9200,18820,6
KAMULI,2022,9770,9310,19080,6
KAMULI,2023,9890,9420,19310,6
KAMULI,2024,10020,9510,19530,6
KAMULI,2025,10140,9600,19740,6
KAMWENGE,2015,5140,5110,10250,6
KAMWENGE,2016,5350,5300,10650,6
KAMWENGE,2017,5570,5480,11050,6
KAMWENGE,2018,5790,5680,11470,6
KAMWENGE,2019,6020,5880,11900,6
KAMWENGE,2020,6250,6070,12320,6
KAMWENGE,2021,6500,6280,12780,6
KAMWENGE,2022,6740,6480,13220,6
KAMWENGE,2023,6990,6700,13690,6
KAMWENGE,2024,7250,6910,14160,6
KAMWENGE,2025,7500,7120,14620,6
KANUNGU,2015,4420,4330,8750,6
KANUNGU,2016,4500,4400,8900,6
KANUNGU,2017,4590,4470,9060,6
KANUNGU,2018,4670,4540,9210,6
KANUNGU,2019,4740,4610,9350,6
KANUNGU,2020,4820,4680,9500,6
KANUNGU,2021,4900,4740,9640,6
KANUNGU,2022,4980,4810,9790,6
KANUNGU,2023,5050,4870,9920,6
KANUNGU,2024,5120,4930,10050,6
KANUNGU,2025,5180,4990,10170,6
KAPCHORWA,2015,1800,1720,3520,6
KAPCHORWA,2016,1850,1770,3620,6
KAPCHORWA,2017,1910,1820,3730,6
KAPCHORWA,2018,1970,1870,3840,6
KAPCHORWA,2019,2030,1920,3950,6
KAPCHORWA,2020,2080,1970,4050,6
KAPCHORWA,2021,2140,2020,4160,6
KAPCHORWA,2022,2200,2070,4270,6
KAPCHORWA,2023,2260,2120,4380,6
KAPCHORWA,2024,2320,2170,4490,6
KAPCHORWA,2025,2380,2220,4600,6
KAPELEBYONG,2015,1630,1580,3210,6
KAPELEBYONG,2016,1650,1570,3220,6
KAPELEBYONG,2017,1660,1570,3230,6
KAPELEBYONG,2018,1670,1580,3250,6
KAPELEBYONG,2019,1710,1620,3330,6
KAPELEBYONG,2020,1810,1690,3500,6
KAPELEBYONG,2021,1820,1790,3610,6
KAPELEBYONG,2022,1870,1810,3680,6
KAPELEBYONG,2023,1900,1850,3750,6
KAPELEBYONG,2024,1930,1880,3810,6
KAPELEBYONG,2025,1970,1900,3870,6
KASESE,2015,12010,11320,23330,6
KASESE,2016,12050,11190,23240,6
KASESE,2017,12050,11170,23220,6
KASESE,2018,12090,11190,23280,6
KASESE,2019,12300,11350,23650,6
KASESE,2020,12870,11770,24640,6
KASESE,2021,12920,12440,25360,6
KASESE,2022,13080,12570,25650,6
KASESE,2023,13240,12710,25950,6
KASESE,2024,13390,12840,26230,6
KASESE,2025,13520,12960,26480,6
KASSANDA,2015,4920,4550,9470,6
KASSANDA,2016,5060,4650,9710,6
KASSANDA,2017,5210,4750,9960,6
KASSANDA,2018,5350,4850,10200,6
KASSANDA,2019,5500,4950,10450,6
KASSANDA,2020,5650,5050,10700,6
KASSANDA,2021,5800,5150,10950,6
KASSANDA,2022,5950,5240,11190,6
KASSANDA,2023,6090,5340,11430,6
KASSANDA,2024,6240,5430,11670,6
KASSANDA,2025,6390,5520,11910,6
KATAKWI,2015,2950,2880,5830,6
KATAKWI,2016,2980,2860,5840,6
KATAKWI,2017,2990,2870,5860,6
KATAKWI,2018,3010,2880,5890,6
KATAKWI,2019,3080,2930,6010,6
KATAKWI,2020,3240,3050,6290,6
KATAKWI,2021,3270,3230,6500,6
KATAKWI,2022,3330,3280,6610,6
KATAKWI,2023,3390,3320,6710,6
KATAKWI,2024,3450,3370,6820,6
KATAKWI,2025,3500,3410,6910,6
KAYUNGA,2015,6900,6300,13200,6
KAYUNGA,2016,6900,6190,13090,6
KAYUNGA,2017,6860,6150,13010,6
KAYUNGA,2018,6850,6130,12980,6
KAYUNGA,2019,6930,6180,13110,6
KAYUNGA,2020,7220,6370,13590,6
KAYUNGA,2021,7210,6700,13910,6
KAYUNGA,2022,7260,6730,13990,6
KAYUNGA,2023,7310,6770,14080,6
KAYUNGA,2024,7370,6800,14170,6
KAYUNGA,2025,7400,6820,14220,6
KAZO,2015,3140,3060,6200,6
KAZO,2016,3260,3170,6430,6
KAZO,2017,3390,3280,6670,6
KAZO,2018,3510,3400,6910,6
KAZO,2019,3640,3520,7160,6
KAZO,2020,3770,3640,7410,6
KAZO,2021,3910,3750,7660,6
KAZO,2022,4040,3870,7910,6
KAZO,2023,4180,4000,8180,6
KAZO,2024,4320,4130,8450,6
KAZO,2025,4470,4260,8730,6
KIBAALE,2015,2700,2610,5310,6
KIBAALE,2016,2880,2760,5640,6
KIBAALE,2017,3060,2920,5980,6
KIBAALE,2018,3260,3090,6350,6
KIBAALE,2019,3460,3270,6730,6
KIBAALE,2020,3670,3450,7120,6
KIBAALE,2021,3900,3640,7540,6
KIBAALE,2022,4140,3840,7980,6
KIBAALE,2023,4390,4050,8440,6
KIBAALE,2024,4640,4270,8910,6
KIBAALE,2025,4910,4490,9400,6
KIBOGA,2015,2450,2330,4780,6
KIBOGA,2016,2470,2300,4770,6
KIBOGA,2017,2470,2300,4770,6
KIBOGA,2018,2490,2310,4800,6
KIBOGA,2019,2530,2340,4870,6
KIBOGA,2020,2660,2430,5090,6
KIBOGA,2021,2670,2580,5250,6
KIBOGA,2022,2720,2620,5340,6
KIBOGA,2023,2750,2650,5400,6
KIBOGA,2024,2780,2680,5460,6
KIBOGA,2025,2830,2710,5540,6
KIBUKU,2015,3790,3680,7470,6
KIBUKU,2016,3850,3700,7550,6
KIBUKU,2017,3910,3750,7660,6
KIBUKU,2018,3980,3800,7780,6
KIBUKU,2019,4100,3910,8010,6
KIBUKU,2020,4350,4120,8470,6
KIBUKU,2021,4430,4410,8840,6
KIBUKU,2022,4550,4530,9080,6
KIBUKU,2023,4670,4650,9320,6
KIBUKU,2024,4790,4760,9550,6
KIBUKU,2025,4900,4870,9770,6
KIKUUBE,2015,4920,4590,9510,6
KIKUUBE,2016,5180,4830,10010,6
KIKUUBE,2017,5460,5080,10540,6
KIKUUBE,2018,5750,5330,11080,6
KIKUUBE,2019,6050,5600,11650,6
KIKUUBE,2020,6370,5880,12250,6
KIKUUBE,2021,6690,6160,12850,6
KIKUUBE,2022,7030,6460,13490,6
KIKUUBE,2023,7380,6770,14150,6
KIKUUBE,2024,7740,7090,14830,6
KIKUUBE,2025,8110,7410,15520,6
KIRUHURA,2015,2410,2260,4670,6
KIRUHURA,2016,2510,2350,4860,6
KIRUHURA,2017,2600,2430,5030,6
KIRUHURA,2018,2700,2510,5210,6
KIRUHURA,2019,2800,2600,5400,6
KIRUHURA,2020,2900,2690,5590,6
KIRUHURA,2021,3010,2780,5790,6
KIRUHURA,2022,3110,2870,5980,6
KIRUHURA,2023,3220,2960,6180,6
KIRUHURA,2024,3320,3050,6370,6
KIRUHURA,2025,3430,3150,6580,6
KIRYANDONGO,2015,4770,4220,8990,6
KIRYANDONGO,2016,4820,4200,9020,6
KIRYANDONGO,2017,4850,4210,9060,6
KIRYANDONGO,2018,4890,4240,9130,6
KIRYANDONGO,2019,5010,4320,9330,6
KIRYANDONGO,2020,5270,4500,9770,6
KIRYANDONGO,2021,5320,4780,10100,6
KIRYANDONGO,2022,5420,4860,10280,6
KIRYANDONGO,2023,5520,4940,10460,6
KIRYANDONGO,2024,5610,5010,10620,6
KIRYANDONGO,2025,5700,5080,10780,6
KISORO,2015,4950,4820,9770,6
KISORO,2016,4940,4750,9690,6
KISORO,2017,4920,4740,9660,6
KISORO,2018,4910,4730,9640,6
KISORO,2019,4970,4790,9760,6
KISORO,2020,5180,4950,10130,6
KISORO,2021,5170,5230,10400,6
KISORO,2022,5220,5270,10490,6
KISORO,2023,5260,5320,10580,6
KISORO,2024,5290,5360,10650,6
KISORO,2025,5330,5400,10730,6
KITAGWENDA,2015,2740,2580,5320,6
KITAGWENDA,2016,2850,2670,5520,6
KITAGWENDA,2017,2970,2770,5740,6
KITAGWENDA,2018,3090,2870,5960,6
KITAGWENDA,2019,3210,2970,6180,6
KITAGWENDA,2020,3340,3070,6410,6
KITAGWENDA,2021,3460,3180,6640,6
KITAGWENDA,2022,3590,3280,6870,6
KITAGWENDA,2023,3730,3380,7110,6
KITAGWENDA,2024,3860,3490,7350,6
KITAGWENDA,2025,3990,3600,7590,6
KITGUM,2015,3780,3460,7240,6
KITGUM,2016,3760,3400,7160,6
KITGUM,2017,3730,3370,7100,6
KITGUM,2018,3710,3360,7070,6
KITGUM,2019,3750,3380,7130,6
KITGUM,2020,3880,3490,7370,6
KITGUM,2021,3870,3660,7530,6
KITGUM,2022,3890,3670,7560,6
KITGUM,2023,3900,3700,7600,6
KITGUM,2024,3920,3720,7640,6
KITGUM,2025,3920,3720,7640,6
KOBOKO,2015,3850,3520,7370,6
KOBOKO,2016,3930,3540,7470,6
KOBOKO,2017,3990,3590,7580,6
KOBOKO,2018,4070,3660,7730,6
KOBOKO,2019,4200,3760,7960,6
KOBOKO,2020,4460,3960,8420,6
KOBOKO,2021,4550,4260,8810,6
KOBOKO,2022,4670,4370,9040,6
KOBOKO,2023,4800,4490,9290,6
KOBOKO,2024,4920,4600,9520,6
KOBOKO,2025,5060,4730,9790,6
KOLE,2015,4230,4120,8350,6
KOLE,2016,4370,4230,8600,6
KOLE,2017,4510,4360,8870,6
KOLE,2018,4660,4480,9140,6
KOLE,2019,4800,4600,9400,6
KOLE,2020,4950,4730,9680,6
KOLE,2021,5100,4860,9960,6
KOLE,2022,5250,4980,10230,6
KOLE,2023,5410,5110,10520,6
KOLE,2024,5560,5240,10800,6
KOLE,2025,5710,5360,11070,6
KOTIDO,2015,3620,3850,7470,6
KOTIDO,2016,3640,3810,7450,6
KOTIDO,2017,3640,3800,7440,6
KOTIDO,2018,3650,3800,7450,6
KOTIDO,2019,3710,3860,7570,6
KOTIDO,2020,3880,4000,7880,6
KOTIDO,2021,3900,4220,8120,6
KOTIDO,2022,3950,4270,8220,6
KOTIDO,2023,4000,4320,8320,6
KOTIDO,2024,4040,4360,8400,6
KOTIDO,2025,4080,4400,8480,6
KUMI,2015,4340,4040,8380,6
KUMI,2016,4390,4020,8410,6
KUMI,2017,4420,4040,8460,6
KUMI,2018,4470,4070,8540,6
KUMI,2019,4590,4160,8750,6
KUMI,2020,4830,4350,9180,6
KUMI,2021,4890,4620,9510,6
KUMI,2022,4980,4700,9680,6
KUMI,2023,5080,4780,9860,6
KUMI,2024,5180,4860,10040,6
KUMI,2025,5280,4950,10230,6
KWANIA,2015,3240,3270,6510,6
KWANIA,2016,3340,3370,6710,6
KWANIA,2017,3440,3470,6910,6
KWANIA,2018,3550,3570,7120,6
KWANIA,2019,3650,3660,7310,6
KWANIA,2020,3760,3760,7520,6
KWANIA,2021,3870,3860,7730,6
KWANIA,2022,3980,3960,7940,6
KWANIA,2023,4090,4060,8150,6
KWANIA,2024,4190,4160,8350,6
KWANIA,2025,4300,4260,8560,6
KWEEN,2015,1770,1620,3390,6
KWEEN,2016,1830,1660,3490,6
KWEEN,2017,1880,1700,3580,6
KWEEN,2018,1940,1740,3680,6
KWEEN,2019,2000,1780,3780,6
KWEEN,2020,2050,1830,3880,6
KWEEN,2021,2110,1870,3980,6
KWEEN,2022,2170,1910,4080,6
KWEEN,2023,2230,1950,4180,6
KWEEN,2024,2290,1990,4280,6
KWEEN,2025,2350,2030,4380,6
KYANKWANZI,2015,3870,3700,7570,6
KYANKWANZI,2016,4070,3870,7940,6
KYANKWANZI,2017,4280,4050,8330,6
KYANKWANZI,2018,4500,4240,8740,6
KYANKWANZI,2019,4720,4430,9150,6
KYANKWANZI,2020,4960,4630,9590,6
KYANKWANZI,2021,5200,4840,10040,6
KYANKWANZI,2022,5450,5050,10500,6
KYANKWANZI,2023,5710,5270,10980,6
KYANKWANZI,2024,5980,5490,11470,6
KYANKWANZI,2025,6250,5720,11970,6
KYEGEGWA,2015,5380,5070,10450,6
KYEGEGWA,2016,5820,5470,11290,6
KYEGEGWA,2017,6300,5910,12210,6
KYEGEGWA,2018,6820,6370,13190,6
KYEGEGWA,2019,7370,6870,14240,6
KYEGEGWA,2020,7960,7400,15360,6
KYEGEGWA,2021,8600,7970,16570,6
KYEGEGWA,2022,9280,8570,17850,6
KYEGEGWA,2023,10000,9220,19220,6
KYEGEGWA,2024,10780,9910,20690,6
KYEGEGWA,2025,11600,10640,22240,6
KYENJOJO,2015,7840,7580,15420,6
KYENJOJO,2016,8160,7860,16020,6
KYENJOJO,2017,8500,8150,16650,6
KYENJOJO,2018,8840,8440,17280,6
KYENJOJO,2019,9190,8750,17940,6
KYENJOJO,2020,9560,9060,18620,6
KYENJOJO,2021,9930,9370,19300,6
KYENJOJO,2022,10300,9690,19990,6
KYENJOJO,2023,10690,10020,20710,6
KYENJOJO,2024,11080,10340,21420,6
KYENJOJO,2025,11470,10670,22140,6
KYOTERA,2015,4200,3680,7880,6
KYOTERA,2016,4180,3610,7790,6
KYOTERA,2017,4150,3570,7720,6
KYOTERA,2018,4130,3550,7680,6
KYOTERA,2019,4160,3570,7730,6
KYOTERA,2020,4330,3670,8000,6
KYOTERA,2021,4320,3850,8170,6
KYOTERA,2022,4340,3850,8190,6
KYOTERA,2023,4350,3870,8220,6
KYOTERA,2024,4370,3880,8250,6
KYOTERA,2025,4370,3880,8250,6
KARENGA,2015,1120,1210,2330,6
KARENGA,2016,1150,1230,2380,6
KARENGA,2017,1180,1260,2440,6
KARENGA,2018,1220,1290,2510,6
KARENGA,2019,1250,1330,2580,6
KARENGA,2020,1290,1360,2650,6
KARENGA,2021,1310,1390,2700,6
KARENGA,2022,1340,1410,2750,6
KARENGA,2023,1380,1450,2830,6
KARENGA,2024,1410,1480,2890,6
KARENGA,2025,1440,1500,2940,6
LAMWO,2015,2470,2360,4830,6
LAMWO,2016,2450,2320,4770,6
LAMWO,2017,2410,2290,4700,6
LAMWO,2018,2380,2280,4660,6
LAMWO,2019,2390,2290,4680,6
LAMWO,2020,2460,2360,4820,6
LAMWO,2021,2440,2470,4910,6
LAMWO,2022,2430,2480,4910,6
LAMWO,2023,2430,2490,4920,6
LAMWO,2024,2410,2500,4910,6
LAMWO,2025,2410,2500,4910,6
LIRA,2015,6610,6610,13220,6
LIRA,2016,6810,6800,13610,6
LIRA,2017,7000,7000,14000,6
LIRA,2018,7190,7200,14390,6
LIRA,2019,7380,7400,14780,6
LIRA,2020,7580,7600,15180,6
LIRA,2021,7780,7800,15580,6
LIRA,2022,7970,8000,15970,6
LIRA,2023,8170,8200,16370,6
LIRA,2024,8360,8400,16760,6
LIRA,2025,8550,8600,17150,6
LUUKA,2015,4330,4300,8630,6
LUUKA,2016,4330,4240,8570,6
LUUKA,2017,4310,4220,8530,6
LUUKA,2018,4310,4220,8530,6
LUUKA,2019,4370,4270,8640,6
LUUKA,2020,4550,4420,8970,6
LUUKA,2021,4550,4660,9210,6
LUUKA,2022,4600,4700,9300,6
LUUKA,2023,4630,4750,9380,6
LUUKA,2024,4670,4780,9450,6
LUUKA,2025,4700,4810,9510,6
LUWERO,2015,7660,6930,14590,6
LUWERO,2016,7700,6860,14560,6
LUWERO,2017,7690,6850,14540,6
LUWERO,2018,7730,6870,14600,6
LUWERO,2019,7870,6960,14830,6
LUWERO,2020,8240,7230,15470,6
LUWERO,2021,8280,7640,15920,6
LUWERO,2022,8390,7730,16120,6
LUWERO,2023,8490,7820,16310,6
LUWERO,2024,8590,7900,16490,6
LUWERO,2025,8690,7980,16670,6
LWENGO,2015,5170,4680,9850,6
LWENGO,2016,5130,4560,9690,6
LWENGO,2017,5050,4500,9550,6
LWENGO,2018,5000,4460,9460,6
LWENGO,2019,5020,4460,9480,6
LWENGO,2020,5170,4570,9740,6
LWENGO,2021,5120,4760,9880,6
LWENGO,2022,5120,4760,9880,6
LWENGO,2023,5110,4750,9860,6
LWENGO,2024,5100,4740,9840,6
LWENGO,2025,5080,4720,9800,6
LYANTONDE,2015,1600,1540,3140,6
LYANTONDE,2016,1610,1530,3140,6
LYANTONDE,2017,1620,1540,3160,6
LYANTONDE,2018,1630,1550,3180,6
LYANTONDE,2019,1670,1570,3240,6
LYANTONDE,2020,1760,1640,3400,6
LYANTONDE,2021,1780,1750,3530,6
LYANTONDE,2022,1800,1780,3580,6
LYANTONDE,2023,1840,1810,3650,6
LYANTONDE,2024,1870,1830,3700,6
LYANTONDE,2025,1900,1860,3760,6
MANAFWA,2015,2770,2740,5510,6
MANAFWA,2016,2840,2800,5640,6
MANAFWA,2017,2910,2860,5770,6
MANAFWA,2018,2980,2920,5900,6
MANAFWA,2019,3050,2990,6040,6
MANAFWA,2020,3120,3050,6170,6
MANAFWA,2021,3200,3110,6310,6
MANAFWA,2022,3260,3170,6430,6
MANAFWA,2023,3330,3230,6560,6
MANAFWA,2024,3400,3290,6690,6
MANAFWA,2025,3470,3350,6820,6
MARACHA,2015,3540,3410,6950,6
MARACHA,2016,3620,3480,7100,6
MARACHA,2017,3700,3540,7240,6
MARACHA,2018,3770,3610,7380,6
MARACHA,2019,3850,3680,7530,6
MARACHA,2020,3920,3740,7660,6
MARACHA,2021,4000,3810,7810,6
MARACHA,2022,4070,3870,7940,6
MARACHA,2023,4140,3940,8080,6
MARACHA,2024,4210,4000,8210,6
MARACHA,2025,4270,4050,8320,6
MASAKA,2015,4750,4500,9250,6
MASAKA,2016,4750,4440,9190,6
MASAKA,2017,4750,4430,9180,6
MASAKA,2018,4750,4430,9180,6
MASAKA,2019,4820,4480,9300,6
MASAKA,2020,5040,4640,9680,6
MASAKA,2021,5040,4890,9930,6
MASAKA,2022,5100,4950,10050,6
MASAKA,2023,5150,4990,10140,6
MASAKA,2024,5200,5030,10230,6
MASAKA,2025,5240,5070,10310,6
MASINDI,2015,4850,4750,9600,6
MASINDI,2016,5000,4880,9880,6
MASINDI,2017,5140,5010,10150,6
MASINDI,2018,5290,5140,10430,6
MASINDI,2019,5440,5270,10710,6
MASINDI,2020,5590,5400,10990,6
MASINDI,2021,5740,5540,11280,6
MASINDI,2022,5890,5670,11560,6
MASINDI,2023,6040,5800,11840,6
MASINDI,2024,6190,5930,12120,6
MASINDI,2025,6340,6060,12400,6
MAYUGE,2015,8910,8330,17240,6
MAYUGE,2016,9010,8310,17320,6
MAYUGE,2017,9070,8370,17440,6
MAYUGE,2018,9160,8450,17610,6
MAYUGE,2019,9390,8640,18030,6
MAYUGE,2020,9890,9040,18930,6
MAYUGE,2021,9990,9620,19610,6
MAYUGE,2022,10200,9820,20020,6
MAYUGE,2023,10390,10020,20410,6
MAYUGE,2024,10580,10200,20780,6
MAYUGE,2025,10770,10380,21150,6
MBALE,2015,7760,7730,15490,6
MBALE,2016,7840,7730,15570,6
MBALE,2017,7890,7800,15690,6
MBALE,2018,7950,7900,15850,6
MBALE,2019,8140,8100,16240,6
MBALE,2020,8560,8490,17050,6
MBALE,2021,8650,9070,17720,6
MBALE,2022,8810,9270,18080,6
MBALE,2023,8970,9470,18440,6
MBALE,2024,9130,9670,18800,6
MBALE,2025,9280,9860,19140,6
MBARARA,2015,4910,4930,9840,6
MBARARA,2016,5020,5040,10060,6
MBARARA,2017,5140,5150,10290,6
MBARARA,2018,5260,5260,10520,6
MBARARA,2019,5370,5370,10740,6
MBARARA,2020,5490,5480,10970,6
MBARARA,2021,5600,5580,11180,6
MBARARA,2022,5710,5690,11400,6
MBARARA,2023,5830,5790,11620,6
MBARARA,2024,5930,5890,11820,6
MBARARA,2025,6040,5990,12030,6
MITOOMA,2015,3260,3150,6410,6
MITOOMA,2016,3300,3180,6480,6
MITOOMA,2017,3340,3210,6550,6
MITOOMA,2018,3380,3240,6620,6
MITOOMA,2019,3420,3260,6680,6
MITOOMA,2020,3450,3290,6740,6
MITOOMA,2021,3480,3310,6790,6
MITOOMA,2022,3520,3330,6850,6
MITOOMA,2023,3550,3350,6900,6
MITOOMA,2024,3570,3370,6940,6
MITOOMA,2025,3600,3390,6990,6
MITYANA,2015,5440,4900,10340,6
MITYANA,2016,5430,4810,10240,6
MITYANA,2017,5390,4770,10160,6
MITYANA,2018,5370,4760,10130,6
MITYANA,2019,5430,4790,10220,6
MITYANA,2020,5650,4930,10580,6
MITYANA,2021,5640,5190,10830,6
MITYANA,2022,5680,5210,10890,6
MITYANA,2023,5720,5240,10960,6
MITYANA,2024,5740,5260,11000,6
MITYANA,2025,5770,5270,11040,6
MOROTO,2015,2130,2150,4280,6
MOROTO,2016,2130,2130,4260,6
MOROTO,2017,2120,2130,4250,6
MOROTO,2018,2120,2140,4260,6
MOROTO,2019,2160,2180,4340,6
MOROTO,2020,2250,2270,4520,6
MOROTO,2021,2260,2400,4660,6
MOROTO,2022,2290,2440,4730,6
MOROTO,2023,2310,2470,4780,6
MOROTO,2024,2330,2500,4830,6
MOROTO,2025,2350,2530,4880,6
MOYO,2015,1680,1590,3270,6
MOYO,2016,1720,1630,3350,6
MOYO,2017,1770,1660,3430,6
MOYO,2018,1810,1700,3510,6
MOYO,2019,1860,1730,3590,6
MOYO,2020,1900,1770,3670,6
MOYO,2021,1950,1800,3750,6
MOYO,2022,1990,1840,3830,6
MOYO,2023,2030,1870,3900,6
MOYO,2024,2080,1910,3990,6
MOYO,2025,2110,1940,4050,6
MPIGI,2015,4310,3950,8260,6
MPIGI,2016,4320,3910,8230,6
MPIGI,2017,4320,3910,8230,6
MPIGI,2018,4330,3930,8260,6
MPIGI,2019,4410,3980,8390,6
MPIGI,2020,4610,4140,8750,6
MPIGI,2021,4620,4380,9000,6
MPIGI,2022,4680,4430,9110,6
MPIGI,2023,4740,4480,9220,6
MPIGI,2024,4790,4520,9310,6
MPIGI,2025,4830,4580,9410,6
MUBENDE,2015,7120,6650,13770,6
MUBENDE,2016,7350,6770,14120,6
MUBENDE,2017,7550,6950,14500,6
MUBENDE,2018,7790,7160,14950,6
MUBENDE,2019,8150,7470,15620,6
MUBENDE,2020,8760,7960,16720,6
MUBENDE,2021,9050,8660,17710,6
MUBENDE,2022,9420,9010,18430,6
MUBENDE,2023,9800,9370,19170,6
MUBENDE,2024,10180,9730,19910,6
MUBENDE,2025,10570,10090,20660,6
MUKONO,2015,9610,8690,18300,6
MUKONO,2016,9670,8650,18320,6
MUKONO,2017,9700,8700,18400,6
MUKONO,2018,9750,8770,18520,6
MUKONO,2019,9950,8960,18910,6
MUKONO,2020,10440,9360,19800,6
MUKONO,2021,10510,9960,20470,6
MUKONO,2022,10680,10150,20830,6
MUKONO,2023,10840,10330,21170,6
MUKONO,2024,10980,10510,21490,6
MUKONO,2025,11120,10680,21800,6
MADI OKOLLO,2015,2450,2390,4840,6
MADI OKOLLO,2016,2520,2460,4980,6
MADI OKOLLO,2017,2610,2520,5130,6
MADI OKOLLO,2018,2680,2590,5270,6
MADI OKOLLO,2019,2750,2660,5410,6
MADI OKOLLO,2020,2830,2730,5560,6
MADI OKOLLO,2021,2900,2800,5700,6
MADI OKOLLO,2022,2980,2870,5850,6
MADI OKOLLO,2023,3050,2930,5980,6
MADI OKOLLO,2024,3130,3000,6130,6
MADI OKOLLO,2025,3200,3060,6260,6
NABILATUK,2015,1440,1480,2920,6
NABILATUK,2016,1480,1500,2980,6
NABILATUK,2017,1520,1530,3050,6
NABILATUK,2018,1560,1570,3130,6
NABILATUK,2019,1620,1620,3240,6
NABILATUK,2020,1750,1720,3470,6
NABILATUK,2021,1800,1860,3660,6
NABILATUK,2022,1870,1920,3790,6
NABILATUK,2023,1940,1990,3930,6
NABILATUK,2024,2020,2050,4070,6
NABILATUK,2025,2090,2120,4210,6
NAKAPIRIPIRIT,2015,1790,1770,3560,6
NAKAPIRIPIRIT,2016,1830,1780,3610,6
NAKAPIRIPIRIT,2017,1870,1820,3690,6
NAKAPIRIPIRIT,2018,1910,1860,3770,6
NAKAPIRIPIRIT,2019,1980,1930,3910,6
NAKAPIRIPIRIT,2020,2110,2040,4150,6
NAKAPIRIPIRIT,2021,2170,2200,4370,6
NAKAPIRIPIRIT,2022,2230,2270,4500,6
NAKAPIRIPIRIT,2023,2310,2350,4660,6
NAKAPIRIPIRIT,2024,2370,2420,4790,6
NAKAPIRIPIRIT,2025,2440,2490,4930,6
NAKASEKE,2015,3220,3020,6240,6
NAKASEKE,2016,3340,3090,6430,6
NAKASEKE,2017,3460,3160,6620,6
NAKASEKE,2018,3580,3240,6820,6
NAKASEKE,2019,3710,3310,7020,6
NAKASEKE,2020,3840,3390,7230,6
NAKASEKE,2021,3980,3460,7440,6
NAKASEKE,2022,4110,3540,7650,6
NAKASEKE,2023,4240,3610,7850,6
NAKASEKE,2024,4380,3680,8060,6
NAKASEKE,2025,4520,3750,8270,6
NAKASONGOLA,2015,3110,2980,6090,6
NAKASONGOLA,2016,3150,2950,6100,6
NAKASONGOLA,2017,3170,2960,6130,6
NAKASONGOLA,2018,3200,2990,6190,6
NAKASONGOLA,2019,3280,3040,6320,6
NAKASONGOLA,2020,3460,3170,6630,6
NAKASONGOLA,2021,3500,3370,6870,6
NAKASONGOLA,2022,3560,3410,6970,6
NAKASONGOLA,2023,3640,3480,7120,6
NAKASONGOLA,2024,3700,3520,7220,6
NAKASONGOLA,2025,3770,3570,7340,6
NAMAYINGO,2015,4120,3790,7910,6
NAMAYINGO,2016,4110,3720,7830,6
NAMAYINGO,2017,4080,3690,7770,6
NAMAYINGO,2018,4080,3670,7750,6
NAMAYINGO,2019,4130,3700,7830,6
NAMAYINGO,2020,4290,3810,8100,6
NAMAYINGO,2021,4280,3990,8270,6
NAMAYINGO,2022,4310,4020,8330,6
NAMAYINGO,2023,4340,4030,8370,6
NAMAYINGO,2024,4370,4040,8410,6
NAMAYINGO,2025,4380,4050,8430,6
NAMISINDWA,2015,4060,3910,7970,6
NAMISINDWA,2016,4170,4010,8180,6
NAMISINDWA,2017,4290,4100,8390,6
NAMISINDWA,2018,4410,4200,8610,6
NAMISINDWA,2019,4530,4300,8830,6
NAMISINDWA,2020,4640,4390,9030,6
NAMISINDWA,2021,4760,4480,9240,6
NAMISINDWA,2022,4880,4580,9460,6
NAMISINDWA,2023,5000,4670,9670,6
NAMISINDWA,2024,5120,4760,9880,6
NAMISINDWA,2025,5230,4850,10080,6
NAMUTUMBA,2015,4900,4490,9390,6
NAMUTUMBA,2016,4970,4490,9460,6
NAMUTUMBA,2017,5020,4530,9550,6
NAMUTUMBA,2018,5090,4580,9670,6
NAMUTUMBA,2019,5240,4690,9930,6
NAMUTUMBA,2020,5530,4920,10450,6
NAMUTUMBA,2021,5620,5250,10870,6
NAMUTUMBA,2022,5750,5360,11110,6
NAMUTUMBA,2023,5880,5470,11350,6
NAMUTUMBA,2024,6010,5590,11600,6
NAMUTUMBA,2025,6140,5690,11830,6
NAPAK,2015,2940,2900,5840,6
NAPAK,2016,2930,2860,5790,6
NAPAK,2017,2900,2860,5760,6
NAPAK,2018,2890,2850,5740,6
NAPAK,2019,2920,2890,5810,6
NAPAK,2020,3030,2990,6020,6
NAPAK,2021,3020,3170,6190,6
NAPAK,2022,3030,3200,6230,6
NAPAK,2023,3050,3230,6280,6
NAPAK,2024,3060,3250,6310,6
NAPAK,2025,3060,3280,6340,6
NEBBI,2015,4200,4020,8220,6
NEBBI,2016,4330,4130,8460,6
NEBBI,2017,4470,4250,8720,6
NEBBI,2018,4610,4370,8980,6
NEBBI,2019,4750,4490,9240,6
NEBBI,2020,4890,4610,9500,6
NEBBI,2021,5040,4730,9770,6
NEBBI,2022,5180,4850,10030,6
NEBBI,2023,5330,4970,10300,6
NEBBI,2024,5470,5090,10560,6
NEBBI,2025,5620,5210,10830,6
NGORA,2015,2590,2470,5060,6
NGORA,2016,2610,2450,5060,6
NGORA,2017,2610,2460,5070,6
NGORA,2018,2640,2470,5110,6
NGORA,2019,2690,2510,5200,6
NGORA,2020,2830,2620,5450,6
NGORA,2021,2850,2770,5620,6
NGORA,2022,2900,2830,5730,6
NGORA,2023,2940,2870,5810,6
NGORA,2024,2990,2910,5900,6
NGORA,2025,3030,2940,5970,6
NTOROKO,2015,1100,1060,2160,6
NTOROKO,2016,1120,1040,2160,6
NTOROKO,2017,1120,1040,2160,6
NTOROKO,2018,1120,1040,2160,6
NTOROKO,2019,1140,1050,2190,6
NTOROKO,2020,1190,1090,2280,6
NTOROKO,2021,1200,1150,2350,6
NTOROKO,2022,1220,1160,2380,6
NTOROKO,2023,1230,1160,2390,6
NTOROKO,2024,1250,1170,2420,6
NTOROKO,2025,1260,1180,2440,6
NTUNGAMO,2015,8460,8310,16770,6
NTUNGAMO,2016,8650,8460,17110,6
NTUNGAMO,2017,8830,8620,17450,6
NTUNGAMO,2018,9020,8780,17800,6
NTUNGAMO,2019,9200,8930,18130,6
NTUNGAMO,2020,9390,9080,18470,6
NTUNGAMO,2021,9570,9230,18800,6
NTUNGAMO,2022,9740,9380,19120,6
NTUNGAMO,2023,9920,9520,19440,6
NTUNGAMO,2024,10090,9660,19750,6
NTUNGAMO,2025,10250,9800,20050,6
NWOYA,2015,2780,2390,5170,6
NWOYA,2016,3070,2640,5710,6
NWOYA,2017,3390,2900,6290,6
NWOYA,2018,3740,3200,6940,6
NWOYA,2019,4130,3520,7650,6
NWOYA,2020,4560,3870,8430,6
NWOYA,2021,5030,4260,9290,6
NWOYA,2022,5530,4680,10210,6
NWOYA,2023,6090,5140,11230,6
NWOYA,2024,6700,5650,12350,6
NWOYA,2025,7360,6190,13550,6
OBONGI,2015,830,740,1570,6
OBONGI,2016,840,740,1580,6
OBONGI,2017,830,740,1570,6
OBONGI,2018,830,730,1560,6
OBONGI,2019,850,740,1590,6
OBONGI,2020,890,770,1660,6
OBONGI,2021,890,820,1710,6
OBONGI,2022,900,820,1720,6
OBONGI,2023,910,830,1740,6
OBONGI,2024,920,840,1760,6
OBONGI,2025,940,850,1790,6
OMORO,2015,2950,2640,5590,6
OMORO,2016,3000,2630,5630,6
OMORO,2017,3030,2660,5690,6
OMORO,2018,3060,2710,5770,6
OMORO,2019,3160,2770,5930,6
OMORO,2020,3340,2920,6260,6
OMORO,2021,3390,3120,6510,6
OMORO,2022,3470,3200,6670,6
OMORO,2023,3560,3270,6830,6
OMORO,2024,3640,3340,6980,6
OMORO,2025,3710,3410,7120,6
OTUKE,2015,1940,1840,3780,6
OTUKE,2016,2020,1920,3940,6
OTUKE,2017,2110,2000,4110,6
OTUKE,2018,2210,2090,4300,6
OTUKE,2019,2310,2180,4490,6
OTUKE,2020,2410,2270,4680,6
OTUKE,2021,2510,2360,4870,6
OTUKE,2022,2610,2450,5060,6
OTUKE,2023,2720,2550,5270,6
OTUKE,2024,2830,2650,5480,6
OTUKE,2025,2940,2750,5690,6
OYAM,2015,7130,6750,13880,6
OYAM,2016,7350,6950,14300,6
OYAM,2017,7570,7150,14720,6
OYAM,2018,7800,7360,15160,6
OYAM,2019,8030,7570,15600,6
OYAM,2020,8260,7780,16040,6
OYAM,2021,8500,7990,16490,6
OYAM,2022,8740,8200,16940,6
OYAM,2023,8970,8410,17380,6
OYAM,2024,9200,8620,17820,6
OYAM,2025,9440,8840,18280,6
PADER,2015,3210,3110,6320,6
PADER,2016,3200,3060,6260,6
PADER,2017,3180,3040,6220,6
PADER,2018,3160,3050,6210,6
PADER,2019,3190,3080,6270,6
PADER,2020,3320,3180,6500,6
PADER,2021,3310,3350,6660,6
PADER,2022,3330,3390,6720,6
PADER,2023,3340,3400,6740,6
PADER,2024,3350,3430,6780,6
PADER,2025,3360,3450,6810,6
PAKWACH,2015,2860,2760,5620,6
PAKWACH,2016,2980,2860,5840,6
PAKWACH,2017,3110,2960,6070,6
PAKWACH,2018,3240,3070,6310,6
PAKWACH,2019,3370,3180,6550,6
PAKWACH,2020,3500,3290,6790,6
PAKWACH,2021,3640,3400,7040,6
PAKWACH,2022,3790,3520,7310,6
PAKWACH,2023,3930,3640,7570,6
PAKWACH,2024,4080,3750,7830,6
PAKWACH,2025,4220,3870,8090,6
PALLISA,2015,5170,4900,10070,6
PALLISA,2016,5300,4950,10250,6
PALLISA,2017,5400,5040,10440,6
PALLISA,2018,5520,5150,10670,6
PALLISA,2019,5730,5340,11070,6
PALLISA,2020,6120,5650,11770,6
PALLISA,2021,6260,6090,12350,6
PALLISA,2022,6470,6290,12760,6
PALLISA,2023,6680,6500,13180,6
PALLISA,2024,6890,6690,13580,6
PALLISA,2025,7100,6890,13990,6
RAKAI,2015,5170,4850,10020,6
RAKAI,2016,5190,4810,10000,6
RAKAI,2017,5200,4800,10000,6
RAKAI,2018,5220,4810,10030,6
RAKAI,2019,5320,4880,10200,6
RAKAI,2020,5570,5070,10640,6
RAKAI,2021,5600,5360,10960,6
RAKAI,2022,5680,5430,11110,6
RAKAI,2023,5750,5480,11230,6
RAKAI,2024,5820,5540,11360,6
RAKAI,2025,5890,5600,11490,6
RUBANDA,2015,3260,3220,6480,6
RUBANDA,2016,3300,3240,6540,6
RUBANDA,2017,3350,3270,6620,6
RUBANDA,2018,3390,3290,6680,6
RUBANDA,2019,3430,3320,6750,6
RUBANDA,2020,3480,3340,6820,6
RUBANDA,2021,3510,3360,6870,6
RUBANDA,2022,3550,3380,6930,6
RUBANDA,2023,3580,3390,6970,6
RUBANDA,2024,3620,3410,7030,6
RUBANDA,2025,3650,3420,7070,6
RUBIRIZI,2015,2370,2310,4680,6
RUBIRIZI,2016,2420,2360,4780,6
RUBIRIZI,2017,2460,2400,4860,6
RUBIRIZI,2018,2510,2450,4960,6
RUBIRIZI,2019,2560,2490,5050,6
RUBIRIZI,2020,2610,2540,5150,6
RUBIRIZI,2021,2660,2580,5240,6
RUBIRIZI,2022,2700,2620,5320,6
RUBIRIZI,2023,2750,2660,5410,6
RUBIRIZI,2024,2790,2700,5490,6
RUBIRIZI,2025,2830,2740,5570,6
RUKIGA,2015,1660,1570,3230,6
RUKIGA,2016,1680,1580,3260,6
RUKIGA,2017,1700,1600,3300,6
RUKIGA,2018,1710,1600,3310,6
RUKIGA,2019,1730,1620,3350,6
RUKIGA,2020,1740,1630,3370,6
RUKIGA,2021,1760,1630,3390,6
RUKIGA,2022,1770,1640,3410,6
RUKIGA,2023,1780,1650,3430,6
RUKIGA,2024,1790,1650,3440,6
RUKIGA,2025,1800,1660,3460,6
RUKUNGIRI,2015,5240,5010,10250,6
RUKUNGIRI,2016,5300,5060,10360,6
RUKUNGIRI,2017,5360,5110,10470,6
RUKUNGIRI,2018,5430,5160,10590,6
RUKUNGIRI,2019,5490,5200,10690,6
RUKUNGIRI,2020,5540,5250,10790,6
RUKUNGIRI,2021,5600,5290,10890,6
RUKUNGIRI,2022,5650,5320,10970,6
RUKUNGIRI,2023,5700,5360,11060,6
RUKUNGIRI,2024,5740,5390,11130,6
RUKUNGIRI,2025,5780,5420,11200,6
RWAMPARA,2015,2180,2160,4340,6
RWAMPARA,2016,2230,2200,4430,6
RWAMPARA,2017,2280,2250,4530,6
RWAMPARA,2018,2330,2300,4630,6
RWAMPARA,2019,2380,2350,4730,6
RWAMPARA,2020,2430,2400,4830,6
RWAMPARA,2021,2480,2440,4920,6
RWAMPARA,2022,2540,2490,5030,6
RWAMPARA,2023,2580,2530,5110,6
RWAMPARA,2024,2630,2590,5220,6
RWAMPARA,2025,2680,2630,5310,6
SERERE,2015,5450,5180,10630,6
SERERE,2016,5570,5210,10780,6
SERERE,2017,5650,5300,10950,6
SERERE,2018,5760,5400,11160,6
SERERE,2019,5950,5560,11510,6
SERERE,2020,6340,5870,12210,6
SERERE,2021,6460,6300,12760,6
SERERE,2022,6650,6490,13140,6
SERERE,2023,6840,6670,13510,6
SERERE,2024,7030,6850,13880,6
SERERE,2025,7220,7030,14250,6
SHEEMA,2015,3220,3140,6360,6
SHEEMA,2016,3260,3170,6430,6
SHEEMA,2017,3300,3200,6500,6
SHEEMA,2018,3330,3240,6570,6
SHEEMA,2019,3370,3270,6640,6
SHEEMA,2020,3410,3300,6710,6
SHEEMA,2021,3440,3320,6760,6
SHEEMA,2022,3480,3350,6830,6
SHEEMA,2023,3510,3380,6890,6
SHEEMA,2024,3530,3400,6930,6
SHEEMA,2025,3560,3420,6980,6
SIRONKO,2015,4240,3830,8070,6
SIRONKO,2016,4340,3910,8250,6
SIRONKO,2017,4440,3990,8430,6
SIRONKO,2018,4550,4070,8620,6
SIRONKO,2019,4650,4150,8800,6
SIRONKO,2020,4760,4230,8990,6
SIRONKO,2021,4860,4300,9160,6
SIRONKO,2022,4960,4380,9340,6
SIRONKO,2023,5060,4460,9520,6
SIRONKO,2024,5150,4530,9680,6
SIRONKO,2025,5250,4600,9850,6
SOROTI,2015,5210,4850,10060,6
SOROTI,2016,5300,4860,10160,6
SOROTI,2017,5350,4920,10270,6
SOROTI,2018,5440,4990,10430,6
SOROTI,2019,5590,5120,10710,6
SOROTI,2020,5920,5370,11290,6
SOROTI,2021,6010,5750,11760,6
SOROTI,2022,6170,5890,12060,6
SOROTI,2023,6310,6030,12340,6
SOROTI,2024,6460,6170,12630,6
SOROTI,2025,6600,6290,12890,6
SSEMBABULE,2015,4550,4190,8740,6
SSEMBABULE,2016,4590,4160,8750,6
SSEMBABULE,2017,4600,4170,8770,6
SSEMBABULE,2018,4650,4200,8850,6
SSEMBABULE,2019,4750,4280,9030,6
SSEMBABULE,2020,4980,4450,9430,6
SSEMBABULE,2021,5030,4730,9760,6
SSEMBABULE,2022,5120,4800,9920,6
SSEMBABULE,2023,5200,4870,10070,6
SSEMBABULE,2024,5280,4940,10220,6
SSEMBABULE,2025,5360,5020,10380,6
TORORO,2015,9080,8740,17820,6
TORORO,2016,9330,8970,18300,6
TORORO,2017,9580,9190,18770,6
TORORO,2018,9830,9410,19240,6
TORORO,2019,10080,9640,19720,6
TORORO,2020,10330,9870,20200,6
TORORO,2021,10590,10090,20680,6
TORORO,2022,10840,10320,21160,6
TORORO,2023,11090,10550,21640,6
TORORO,2024,11330,10760,22090,6
TORORO,2025,11570,10980,22550,6
WAKISO,2015,30870,29880,60750,6
WAKISO,2016,32940,31920,64860,6
WAKISO,2017,35150,34110,69260,6
WAKISO,2018,37480,36420,73900,6
WAKISO,2019,39970,38860,78830,6
WAKISO,2020,42570,41440,84010,6
WAKISO,2021,45310,44190,89500,6
WAKISO,2022,48210,47110,95320,6
WAKISO,2023,51270,50140,101410,6
WAKISO,2024,54460,53330,107790,6
WAKISO,2025,57810,56720,114530,6
YUMBE,2015,10480,11200,21680,6
YUMBE,2016,10800,11480,22280,6
YUMBE,2017,11090,11880,22970,6
YUMBE,2018,11410,12330,23740,6
YUMBE,2019,11920,12960,24880,6
YUMBE,2020,12800,13930,26730,6
YUMBE,2021,13180,15250,28430,6
YUMBE,2022,13710,15990,29700,6
YUMBE,2023,14240,16750,30990,6
YUMBE,2024,14780,17540,32320,6
YUMBE,2025,15320,18330,33650,6
ZOMBO,2015,4670,4380,9050,6
ZOMBO,2016,4820,4500,9320,6
ZOMBO,2017,4970,4620,9590,6
ZOMBO,2018,5120,4750,9870,6
ZOMBO,2019,5270,4880,10150,6
ZOMBO,2020,5430,5010,10440,6
ZOMBO,2021,5580,5140,10720,6
ZOMBO,2022,5740,5270,11010,6
ZOMBO,2023,5890,5400,11290,6
ZOMBO,2024,6050,5530,11580,6
ZOMBO,2025,6200,5650,11850,6
ABIM,2015,140,130,270,60
ABIM,2016,140,130,270,60
ABIM,2017,150,140,290,60
ABIM,2018,160,160,320,60
ABIM,2019,190,190,380,60
ABIM,2020,230,230,460,60
ABIM,2021,260,270,530,60
ABIM,2022,280,300,580,60
ABIM,2023,310,310,620,60
ABIM,2024,320,310,630,60
ABIM,2025,330,310,640,60
ADJUMANI,2015,320,740,1060,60
ADJUMANI,2016,320,750,1070,60
ADJUMANI,2017,330,750,1080,60
ADJUMANI,2018,330,760,1090,60
ADJUMANI,2019,330,770,1100,60
ADJUMANI,2020,330,770,1100,60
ADJUMANI,2021,330,780,1110,60
ADJUMANI,2022,340,790,1130,60
ADJUMANI,2023,340,790,1130,60
ADJUMANI,2024,340,800,1140,60
ADJUMANI,2025,340,800,1140,60
AGAGO,2015,330,750,1080,60
AGAGO,2016,340,770,1110,60
AGAGO,2017,340,780,1120,60
AGAGO,2018,350,790,1140,60
AGAGO,2019,350,810,1160,60
AGAGO,2020,360,820,1180,60
AGAGO,2021,360,830,1190,60
AGAGO,2022,370,850,1220,60
AGAGO,2023,370,860,1230,60
AGAGO,2024,380,870,1250,60
AGAGO,2025,380,880,1260,60
ALEBTONG,2015,280,400,680,60
ALEBTONG,2016,280,380,660,60
ALEBTONG,2017,280,390,670,60
ALEBTONG,2018,320,430,750,60
ALEBTONG,2019,350,510,860,60
ALEBTONG,2020,400,590,990,60
ALEBTONG,2021,440,670,1110,60
ALEBTONG,2022,470,710,1180,60
ALEBTONG,2023,480,720,1200,60
ALEBTONG,2024,490,690,1180,60
ALEBTONG,2025,490,670,1160,60
AMOLATAR,2015,150,160,310,60
AMOLATAR,2016,150,160,310,60
AMOLATAR,2017,150,160,310,60
AMOLATAR,2018,160,180,340,60
AMOLATAR,2019,190,210,400,60
AMOLATAR,2020,210,240,450,60
AMOLATAR,2021,240,270,510,60
AMOLATAR,2022,240,280,520,60
AMOLATAR,2023,250,290,540,60
AMOLATAR,2024,260,280,540,60
AMOLATAR,2025,260,270,530,60
AMUDAT,2015,180,120,300,60
AMUDAT,2016,170,120,290,60
AMUDAT,2017,180,120,300,60
AMUDAT,2018,200,140,340,60
AMUDAT,2019,230,170,400,60
AMUDAT,2020,260,200,460,60
AMUDAT,2021,300,230,530,60
AMUDAT,2022,320,240,560,60
AMUDAT,2023,330,250,580,60
AMUDAT,2024,340,250,590,60
AMUDAT,2025,340,240,580,60
AMURIA,2015,210,320,530,60
AMURIA,2016,210,310,520,60
AMURIA,2017,220,320,540,60
AMURIA,2018,240,360,600,60
AMURIA,2019,280,420,700,60
AMURIA,2020,310,500,810,60
AMURIA,2021,350,560,910,60
AMURIA,2022,380,600,980,60
AMURIA,2023,390,610,1000,60
AMURIA,2024,400,600,1000,60
AMURIA,2025,400,580,980,60
AMURU,2015,160,270,430,60
AMURU,2016,160,260,420,60
AMURU,2017,170,270,440,60
AMURU,2018,190,300,490,60
AMURU,2019,210,350,560,60
AMURU,2020,230,410,640,60
AMURU,2021,260,460,720,60
AMURU,2022,280,490,770,60
AMURU,2023,290,490,780,60
AMURU,2024,290,480,770,60
AMURU,2025,280,460,740,60
APAC,2015,270,460,730,60
APAC,2016,280,480,760,60
APAC,2017,290,490,780,60
APAC,2018,300,510,810,60
APAC,2019,310,530,840,60
APAC,2020,320,540,860,60
APAC,2021,330,560,890,60
APAC,2022,340,580,920,60
APAC,2023,350,600,950,60
APAC,2024,370,620,990,60
APAC,2025,380,640,1020,60
ARUA,2015,1100,2080,3180,60
ARUA,2016,1130,2130,3260,60
ARUA,2017,1170,2190,3360,60
ARUA,2018,1200,2250,3450,60
ARUA,2019,1230,2310,3540,60
ARUA,2020,1270,2370,3640,60
ARUA,2021,1300,2430,3730,60
ARUA,2022,1330,2480,3810,60
ARUA,2023,1370,2550,3920,60
ARUA,2024,1400,2600,4000,60
ARUA,2025,1430,2660,4090,60
BUDAKA,2015,240,260,500,60
BUDAKA,2016,240,250,490,60
BUDAKA,2017,250,260,510,60
BUDAKA,2018,280,290,570,60
BUDAKA,2019,310,350,660,60
BUDAKA,2020,360,410,770,60
BUDAKA,2021,400,460,860,60
BUDAKA,2022,430,490,920,60
BUDAKA,2023,440,500,940,60
BUDAKA,2024,450,490,940,60
BUDAKA,2025,460,480,940,60
BUDUDA,2015,240,200,440,60
BUDUDA,2016,240,190,430,60
BUDUDA,2017,260,200,460,60
BUDUDA,2018,290,230,520,60
BUDUDA,2019,330,270,600,60
BUDUDA,2020,370,320,690,60
BUDUDA,2021,430,370,800,60
BUDUDA,2022,460,400,860,60
BUDUDA,2023,480,410,890,60
BUDUDA,2024,490,410,900,60
BUDUDA,2025,500,400,900,60
BUGIRI,2015,410,480,890,60
BUGIRI,2016,420,460,880,60
BUGIRI,2017,440,480,920,60
BUGIRI,2018,480,540,1020,60
BUGIRI,2019,560,640,1200,60
BUGIRI,2020,640,750,1390,60
BUGIRI,2021,710,860,1570,60
BUGIRI,2022,770,920,1690,60
BUGIRI,2023,800,940,1740,60
BUGIRI,2024,820,930,1750,60
BUGIRI,2025,830,900,1730,60
BUGWERI,2015,240,300,540,60
BUGWERI,2016,230,280,510,60
BUGWERI,2017,240,290,530,60
BUGWERI,2018,260,330,590,60
BUGWERI,2019,300,380,680,60
BUGWERI,2020,340,440,780,60
BUGWERI,2021,370,490,860,60
BUGWERI,2022,390,530,920,60
BUGWERI,2023,400,530,930,60
BUGWERI,2024,410,520,930,60
BUGWERI,2025,410,490,900,60
BUHWEJU,2015,220,320,540,60
BUHWEJU,2016,230,330,560,60
BUHWEJU,2017,240,340,580,60
BUHWEJU,2018,250,350,600,60
BUHWEJU,2019,250,360,610,60
BUHWEJU,2020,260,370,630,60
BUHWEJU,2021,270,380,650,60
BUHWEJU,2022,280,390,670,60
BUHWEJU,2023,280,400,680,60
BUHWEJU,2024,290,410,700,60
BUHWEJU,2025,300,420,720,60
BUIKWE,2015,570,670,1240,60
BUIKWE,2016,560,630,1190,60
BUIKWE,2017,570,640,1210,60
BUIKWE,2018,630,720,1350,60
BUIKWE,2019,710,830,1540,60
BUIKWE,2020,790,970,1760,60
BUIKWE,2021,870,1080,1950,60
BUIKWE,2022,920,1140,2060,60
BUIKWE,2023,940,1140,2080,60
BUIKWE,2024,940,1110,2050,60
BUIKWE,2025,930,1050,1980,60
BUKEDEA,2015,240,330,570,60
BUKEDEA,2016,240,310,550,60
BUKEDEA,2017,250,330,580,60
BUKEDEA,2018,280,370,650,60
BUKEDEA,2019,330,440,770,60
BUKEDEA,2020,370,520,890,60
BUKEDEA,2021,420,590,1010,60
BUKEDEA,2022,450,640,1090,60
BUKEDEA,2023,480,650,1130,60
BUKEDEA,2024,480,640,1120,60
BUKEDEA,2025,490,630,1120,60
BUKOMANSIMBI,2015,220,280,500,60
BUKOMANSIMBI,2016,210,270,480,60
BUKOMANSIMBI,2017,210,260,470,60
BUKOMANSIMBI,2018,230,290,520,60
BUKOMANSIMBI,2019,250,330,580,60
BUKOMANSIMBI,2020,280,380,660,60
BUKOMANSIMBI,2021,300,420,720,60
BUKOMANSIMBI,2022,320,440,760,60
BUKOMANSIMBI,2023,320,430,750,60
BUKOMANSIMBI,2024,320,410,730,60
BUKOMANSIMBI,2025,310,380,690,60
BUKWO,2015,150,150,300,60
BUKWO,2016,160,160,320,60
BUKWO,2017,170,160,330,60
BUKWO,2018,170,170,340,60
BUKWO,2019,180,180,360,60
BUKWO,2020,190,190,380,60
BUKWO,2021,200,200,400,60
BUKWO,2022,210,210,420,60
BUKWO,2023,220,220,440,60
BUKWO,2024,230,230,460,60
BUKWO,2025,250,240,490,60
BULAMBULI,2015,280,210,490,60
BULAMBULI,2016,290,200,490,60
BULAMBULI,2017,300,210,510,60
BULAMBULI,2018,340,240,580,60
BULAMBULI,2019,390,290,680,60
BULAMBULI,2020,450,350,800,60
BULAMBULI,2021,510,400,910,60
BULAMBULI,2022,550,430,980,60
BULAMBULI,2023,580,440,1020,60
BULAMBULI,2024,600,440,1040,60
BULAMBULI,2025,610,440,1050,60
BULIISA,2015,180,300,480,60
BULIISA,2016,190,310,500,60
BULIISA,2017,210,330,540,60
BULIISA,2018,220,340,560,60
BULIISA,2019,230,360,590,60
BULIISA,2020,240,370,610,60
BULIISA,2021,250,390,640,60
BULIISA,2022,270,400,670,60
BULIISA,2023,280,420,700,60
BULIISA,2024,290,440,730,60
BULIISA,2025,310,450,760,60
BUNDIBUGYO,2015,340,390,730,60
BUNDIBUGYO,2016,340,370,710,60
BUNDIBUGYO,2017,350,380,730,60
BUNDIBUGYO,2018,390,430,820,60
BUNDIBUGYO,2019,440,500,940,60
BUNDIBUGYO,2020,490,580,1070,60
BUNDIBUGYO,2021,550,650,1200,60
BUNDIBUGYO,2022,580,700,1280,60
BUNDIBUGYO,2023,600,700,1300,60
BUNDIBUGYO,2024,610,690,1300,60
BUNDIBUGYO,2025,610,660,1270,60
BUNYANGABU,2015,230,280,510,60
BUNYANGABU,2016,220,270,490,60
BUNYANGABU,2017,230,270,500,60
BUNYANGABU,2018,250,310,560,60
BUNYANGABU,2019,280,360,640,60
BUNYANGABU,2020,320,420,740,60
BUNYANGABU,2021,350,460,810,60
BUNYANGABU,2022,380,490,870,60
BUNYANGABU,2023,390,490,880,60
BUNYANGABU,2024,390,480,870,60
BUNYANGABU,2025,390,460,850,60
BUSHENYI,2015,510,820,1330,60
BUSHENYI,2016,520,820,1340,60
BUSHENYI,2017,520,830,1350,60
BUSHENYI,2018,530,840,1370,60
BUSHENYI,2019,530,850,1380,60
BUSHENYI,2020,540,850,1390,60
BUSHENYI,2021,550,860,1410,60
BUSHENYI,2022,550,860,1410,60
BUSHENYI,2023,560,870,1430,60
BUSHENYI,2024,560,870,1430,60
BUSHENYI,2025,560,880,1440,60
BUSIA,2015,310,370,680,60
BUSIA,2016,300,350,650,60
BUSIA,2017,320,350,670,60
BUSIA,2018,350,400,750,60
BUSIA,2019,400,470,870,60
BUSIA,2020,450,550,1000,60
BUSIA,2021,500,610,1110,60
BUSIA,2022,540,660,1200,60
BUSIA,2023,560,660,1220,60
BUSIA,2024,560,650,1210,60
BUSIA,2025,560,620,1180,60
BUTALEJA,2015,260,280,540,60
BUTALEJA,2016,250,270,520,60
BUTALEJA,2017,260,280,540,60
BUTALEJA,2018,290,320,610,60
BUTALEJA,2019,330,380,710,60
BUTALEJA,2020,380,440,820,60
BUTALEJA,2021,430,500,930,60
BUTALEJA,2022,460,530,990,60
BUTALEJA,2023,480,550,1030,60
BUTALEJA,2024,480,530,1010,60
BUTALEJA,2025,490,520,1010,60
BUTAMBALA,2015,170,200,370,60
BUTAMBALA,2016,160,190,350,60
BUTAMBALA,2017,170,190,360,60
BUTAMBALA,2018,180,210,390,60
BUTAMBALA,2019,210,240,450,60
BUTAMBALA,2020,230,280,510,60
BUTAMBALA,2021,240,310,550,60
BUTAMBALA,2022,260,320,580,60
BUTAMBALA,2023,260,320,580,60
BUTAMBALA,2024,260,310,570,60
BUTAMBALA,2025,260,290,550,60
BUTEBO,2015,120,140,260,60
BUTEBO,2016,120,130,250,60
BUTEBO,2017,120,130,250,60
BUTEBO,2018,130,140,270,60
BUTEBO,2019,150,160,310,60
BUTEBO,2020,160,190,350,60
BUTEBO,2021,180,210,390,60
BUTEBO,2022,190,220,410,60
BUTEBO,2023,190,220,410,60
BUTEBO,2024,190,210,400,60
BUTEBO,2025,190,200,390,60
BUVUMA,2015,210,150,360,60
BUVUMA,2016,220,170,390,60
BUVUMA,2017,240,180,420,60
BUVUMA,2018,250,190,440,60
BUVUMA,2019,270,200,470,60
BUVUMA,2020,280,210,490,60
BUVUMA,2021,300,230,530,60
BUVUMA,2022,320,240,560,60
BUVUMA,2023,340,260,600,60
BUVUMA,2024,350,280,630,60
BUVUMA,2025,370,290,660,60
BUYENDE,2015,410,490,900,60
BUYENDE,2016,410,480,890,60
BUYENDE,2017,430,500,930,60
BUYENDE,2018,480,570,1050,60
BUYENDE,2019,550,680,1230,60
BUYENDE,2020,640,800,1440,60
BUYENDE,2021,710,910,1620,60
BUYENDE,2022,770,990,1760,60
BUYENDE,2023,810,1010,1820,60
BUYENDE,2024,830,1000,1830,60
BUYENDE,2025,840,980,1820,60
DOKOLO,2015,370,580,950,60
DOKOLO,2016,380,600,980,60
DOKOLO,2017,390,620,1010,60
DOKOLO,2018,400,630,1030,60
DOKOLO,2019,420,650,1070,60
DOKOLO,2020,430,670,1100,60
DOKOLO,2021,440,680,1120,60
DOKOLO,2022,450,700,1150,60
DOKOLO,2023,460,720,1180,60
DOKOLO,2024,480,730,1210,60
DOKOLO,2025,490,750,1240,60
GOMBA,2015,260,290,550,60
GOMBA,2016,250,270,520,60
GOMBA,2017,260,270,530,60
GOMBA,2018,280,300,580,60
GOMBA,2019,310,350,660,60
GOMBA,2020,350,400,750,60
GOMBA,2021,390,440,830,60
GOMBA,2022,410,460,870,60
GOMBA,2023,410,460,870,60
GOMBA,2024,410,450,860,60
GOMBA,2025,410,420,830,60
GULU,2015,430,770,1200,60
GULU,2016,440,790,1230,60
GULU,2017,460,820,1280,60
GULU,2018,470,840,1310,60
GULU,2019,480,870,1350,60
GULU,2020,500,890,1390,60
GULU,2021,510,910,1420,60
GULU,2022,530,940,1470,60
GULU,2023,540,960,1500,60
GULU,2024,550,990,1540,60
GULU,2025,570,1010,1580,60
HOIMA,2015,480,680,1160,60
HOIMA,2016,500,700,1200,60
HOIMA,2017,520,730,1250,60
HOIMA,2018,540,750,1290,60
HOIMA,2019,560,780,1340,60
HOIMA,2020,580,800,1380,60
HOIMA,2021,600,830,1430,60
HOIMA,2022,620,850,1470,60
HOIMA,2023,640,880,1520,60
HOIMA,2024,660,910,1570,60
HOIMA,2025,680,940,1620,60
IBANDA,2015,540,830,1370,60
IBANDA,2016,550,850,1400,60
IBANDA,2017,560,860,1420,60
IBANDA,2018,570,880,1450,60
IBANDA,2019,590,890,1480,60
IBANDA,2020,600,910,1510,60
IBANDA,2021,610,920,1530,60
IBANDA,2022,620,940,1560,60
IBANDA,2023,630,950,1580,60
IBANDA,2024,640,960,1600,60
IBANDA,2025,650,980,1630,60
IGANGA,2015,450,490,940,60
IGANGA,2016,440,470,910,60
IGANGA,2017,460,480,940,60
IGANGA,2018,510,540,1050,60
IGANGA,2019,580,630,1210,60
IGANGA,2020,660,740,1400,60
IGANGA,2021,730,830,1560,60
IGANGA,2022,770,890,1660,60
IGANGA,2023,800,900,1700,60
IGANGA,2024,810,870,1680,60
IGANGA,2025,810,840,1650,60
ISINGIRO,2015,970,1480,2450,60
ISINGIRO,2016,1010,1530,2540,60
ISINGIRO,2017,1050,1590,2640,60
ISINGIRO,2018,1090,1640,2730,60
ISINGIRO,2019,1120,1700,2820,60
ISINGIRO,2020,1170,1760,2930,60
ISINGIRO,2021,1210,1810,3020,60
ISINGIRO,2022,1250,1870,3120,60
ISINGIRO,2023,1290,1930,3220,60
ISINGIRO,2024,1330,1990,3320,60
ISINGIRO,2025,1370,2050,3420,60
JINJA,2015,990,1410,2400,60
JINJA,2016,1010,1440,2450,60
JINJA,2017,1030,1460,2490,60
JINJA,2018,1040,1480,2520,60
JINJA,2019,1060,1500,2560,60
JINJA,2020,1080,1520,2600,60
JINJA,2021,1090,1540,2630,60
JINJA,2022,1110,1560,2670,60
JINJA,2023,1120,1580,2700,60
JINJA,2024,1140,1600,2740,60
JINJA,2025,1150,1620,2770,60
KAABONG,2015,270,330,600,60
KAABONG,2016,280,340,620,60
KAABONG,2017,280,350,630,60
KAABONG,2018,290,350,640,60
KAABONG,2019,300,360,660,60
KAABONG,2020,310,370,680,60
KAABONG,2021,310,380,690,60
KAABONG,2022,320,390,710,60
KAABONG,2023,330,390,720,60
KAABONG,2024,340,400,740,60
KAABONG,2025,340,410,750,60
KABALE,2015,540,860,1400,60
KABALE,2016,550,870,1420,60
KABALE,2017,560,880,1440,60
KABALE,2018,560,890,1450,60
KABALE,2019,570,900,1470,60
KABALE,2020,580,910,1490,60
KABALE,2021,590,920,1510,60
KABALE,2022,600,930,1530,60
KABALE,2023,600,930,1530,60
KABALE,2024,610,940,1550,60
KABALE,2025,620,950,1570,60
KABAROLE,2015,680,1000,1680,60
KABAROLE,2016,690,1030,1720,60
KABAROLE,2017,710,1050,1760,60
KABAROLE,2018,720,1070,1790,60
KABAROLE,2019,740,1090,1830,60
KABAROLE,2020,750,1120,1870,60
KABAROLE,2021,770,1140,1910,60
KABAROLE,2022,780,1160,1940,60
KABAROLE,2023,800,1180,1980,60
KABAROLE,2024,810,1200,2010,60
KABAROLE,2025,820,1220,2040,60
KABERAMAIDO,2015,90,100,190,60
KABERAMAIDO,2016,90,90,180,60
KABERAMAIDO,2017,90,100,190,60
KABERAMAIDO,2018,110,110,220,60
KABERAMAIDO,2019,120,130,250,60
KABERAMAIDO,2020,140,160,300,60
KABERAMAIDO,2021,150,180,330,60
KABERAMAIDO,2022,170,190,360,60
KABERAMAIDO,2023,170,200,370,60
KABERAMAIDO,2024,180,190,370,60
KABERAMAIDO,2025,180,190,370,60
KAGADI,2015,580,940,1520,60
KAGADI,2016,600,970,1570,60
KAGADI,2017,620,1010,1630,60
KAGADI,2018,640,1040,1680,60
KAGADI,2019,670,1080,1750,60
KAGADI,2020,690,1110,1800,60
KAGADI,2021,710,1150,1860,60
KAGADI,2022,740,1190,1930,60
KAGADI,2023,760,1230,1990,60
KAGADI,2024,790,1270,2060,60
KAGADI,2025,810,1300,2110,60
KAKUMIRO,2015,510,630,1140,60
KAKUMIRO,2016,550,690,1240,60
KAKUMIRO,2017,600,740,1340,60
KAKUMIRO,2018,650,810,1460,60
KAKUMIRO,2019,710,870,1580,60
KAKUMIRO,2020,770,940,1710,60
KAKUMIRO,2021,840,1020,1860,60
KAKUMIRO,2022,910,1110,2020,60
KAKUMIRO,2023,990,1190,2180,60
KAKUMIRO,2024,1070,1290,2360,60
KAKUMIRO,2025,1160,1390,2550,60
KALAKI,2015,200,240,440,60
KALAKI,2016,210,250,460,60
KALAKI,2017,210,260,470,60
KALAKI,2018,220,270,490,60
KALAKI,2019,230,280,510,60
KALAKI,2020,240,290,530,60
KALAKI,2021,250,300,550,60
KALAKI,2022,260,310,570,60
KALAKI,2023,270,320,590,60
KALAKI,2024,280,340,620,60
KALAKI,2025,290,350,640,60
KALANGALA,2015,100,70,170,60
KALANGALA,2016,100,70,170,60
KALANGALA,2017,110,70,180,60
KALANGALA,2018,110,70,180,60
KALANGALA,2019,110,80,190,60
KALANGALA,2020,120,80,200,60
KALANGALA,2021,120,80,200,60
KALANGALA,2022,120,90,210,60
KALANGALA,2023,130,90,220,60
KALANGALA,2024,130,90,220,60
KALANGALA,2025,140,100,240,60
KALIRO,2015,320,320,640,60
KALIRO,2016,320,310,630,60
KALIRO,2017,330,320,650,60
KALIRO,2018,370,360,730,60
KALIRO,2019,420,420,840,60
KALIRO,2020,480,500,980,60
KALIRO,2021,530,560,1090,60
KALIRO,2022,580,610,1190,60
KALIRO,2023,590,620,1210,60
KALIRO,2024,600,600,1200,60
KALIRO,2025,610,580,1190,60
KALUNGU,2015,280,350,630,60
KALUNGU,2016,270,330,600,60
KALUNGU,2017,270,330,600,60
KALUNGU,2018,300,370,670,60
KALUNGU,2019,330,420,750,60
KALUNGU,2020,370,490,860,60
KALUNGU,2021,390,540,930,60
KALUNGU,2022,420,560,980,60
KALUNGU,2023,420,560,980,60
KALUNGU,2024,420,530,950,60
KALUNGU,2025,410,510,920,60
KAMPALA,2015,1880,2150,4030,60
KAMPALA,2016,1920,2200,4120,60
KAMPALA,2017,1950,2240,4190,60
KAMPALA,2018,1990,2280,4270,60
KAMPALA,2019,2030,2320,4350,60
KAMPALA,2020,2070,2360,4430,60
KAMPALA,2021,2100,2410,4510,60
KAMPALA,2022,2140,2450,4590,60
KAMPALA,2023,2170,2490,4660,60
KAMPALA,2024,2210,2520,4730,60
KAMPALA,2025,2240,2560,4800,60
KAMULI,2015,700,810,1510,60
KAMULI,2016,690,770,1460,60
KAMULI,2017,710,780,1490,60
KAMULI,2018,790,880,1670,60
KAMULI,2019,890,1020,1910,60
KAMULI,2020,1000,1190,2190,60
KAMULI,2021,1100,1330,2430,60
KAMULI,2022,1180,1410,2590,60
KAMULI,2023,1210,1420,2630,60
KAMULI,2024,1210,1370,2580,60
KAMULI,2025,1210,1310,2520,60
KAMWENGE,2015,560,900,1460,60
KAMWENGE,2016,580,930,1510,60
KAMWENGE,2017,600,960,1560,60
KAMWENGE,2018,630,1000,1630,60
KAMWENGE,2019,650,1030,1680,60
KAMWENGE,2020,680,1070,1750,60
KAMWENGE,2021,710,1100,1810,60
KAMWENGE,2022,730,1140,1870,60
KAMWENGE,2023,760,1180,1940,60
KAMWENGE,2024,790,1220,2010,60
KAMWENGE,2025,820,1250,2070,60
KANUNGU,2015,570,850,1420,60
KANUNGU,2016,580,860,1440,60
KANUNGU,2017,590,870,1460,60
KANUNGU,2018,600,890,1490,60
KANUNGU,2019,610,900,1510,60
KANUNGU,2020,620,910,1530,60
KANUNGU,2021,630,930,1560,60
KANUNGU,2022,640,940,1580,60
KANUNGU,2023,650,950,1600,60
KANUNGU,2024,650,960,1610,60
KANUNGU,2025,660,980,1640,60
KAPCHORWA,2015,200,250,450,60
KAPCHORWA,2016,200,260,460,60
KAPCHORWA,2017,210,270,480,60
KAPCHORWA,2018,210,270,480,60
KAPCHORWA,2019,220,280,500,60
KAPCHORWA,2020,230,290,520,60
KAPCHORWA,2021,230,290,520,60
KAPCHORWA,2022,240,300,540,60
KAPCHORWA,2023,250,310,560,60
KAPCHORWA,2024,250,320,570,60
KAPCHORWA,2025,260,320,580,60
KAPELEBYONG,2015,80,150,230,60
KAPELEBYONG,2016,80,150,230,60
KAPELEBYONG,2017,100,150,250,60
KAPELEBYONG,2018,110,170,280,60
KAPELEBYONG,2019,130,200,330,60
KAPELEBYONG,2020,140,230,370,60
KAPELEBYONG,2021,160,260,420,60
KAPELEBYONG,2022,170,280,450,60
KAPELEBYONG,2023,170,280,450,60
KAPELEBYONG,2024,180,270,450,60
KAPELEBYONG,2025,180,260,440,60
KASESE,2015,1090,1250,2340,60
KASESE,2016,1070,1180,2250,60
KASESE,2017,1110,1210,2320,60
KASESE,2018,1220,1350,2570,60
KASESE,2019,1370,1570,2940,60
KASESE,2020,1550,1820,3370,60
KASESE,2021,1700,2030,3730,60
KASESE,2022,1810,2160,3970,60
KASESE,2023,1860,2170,4030,60
KASESE,2024,1850,2100,3950,60
KASESE,2025,1840,2000,3840,60
KASSANDA,2015,630,860,1490,60
KASSANDA,2016,650,880,1530,60
KASSANDA,2017,670,900,1570,60
KASSANDA,2018,690,920,1610,60
KASSANDA,2019,710,940,1650,60
KASSANDA,2020,730,960,1690,60
KASSANDA,2021,750,980,1730,60
KASSANDA,2022,770,990,1760,60
KASSANDA,2023,780,1010,1790,60
KASSANDA,2024,800,1030,1830,60
KASSANDA,2025,820,1050,1870,60
KATAKWI,2015,160,260,420,60
KATAKWI,2016,160,240,400,60
KATAKWI,2017,170,250,420,60
KATAKWI,2018,190,280,470,60
KATAKWI,2019,210,330,540,60
KATAKWI,2020,240,380,620,60
KATAKWI,2021,260,430,690,60
KATAKWI,2022,280,460,740,60
KATAKWI,2023,290,460,750,60
KATAKWI,2024,290,450,740,60
KATAKWI,2025,290,430,720,60
KAYUNGA,2015,540,710,1250,60
KAYUNGA,2016,530,670,1200,60
KAYUNGA,2017,540,680,1220,60
KAYUNGA,2018,600,760,1360,60
KAYUNGA,2019,670,870,1540,60
KAYUNGA,2020,750,1010,1760,60
KAYUNGA,2021,820,1120,1940,60
KAYUNGA,2022,870,1180,2050,60
KAYUNGA,2023,890,1180,2070,60
KAYUNGA,2024,890,1140,2030,60
KAYUNGA,2025,870,1080,1950,60
KAZO,2015,420,540,960,60
KAZO,2016,440,560,1000,60
KAZO,2017,450,580,1030,60
KAZO,2018,470,600,1070,60
KAZO,2019,490,620,1110,60
KAZO,2020,510,640,1150,60
KAZO,2021,520,660,1180,60
KAZO,2022,540,680,1220,60
KAZO,2023,560,710,1270,60
KAZO,2024,580,730,1310,60
KAZO,2025,600,750,1350,60
KIBAALE,2015,160,250,410,60
KIBAALE,2016,170,260,430,60
KIBAALE,2017,180,280,460,60
KIBAALE,2018,190,290,480,60
KIBAALE,2019,200,310,510,60
KIBAALE,2020,210,330,540,60
KIBAALE,2021,230,340,570,60
KIBAALE,2022,240,360,600,60
KIBAALE,2023,260,380,640,60
KIBAALE,2024,270,400,670,60
KIBAALE,2025,290,420,710,60
KIBOGA,2015,180,170,350,60
KIBOGA,2016,170,160,330,60
KIBOGA,2017,180,170,350,60
KIBOGA,2018,200,180,380,60
KIBOGA,2019,220,210,430,60
KIBOGA,2020,250,250,500,60
KIBOGA,2021,270,280,550,60
KIBOGA,2022,290,300,590,60
KIBOGA,2023,300,300,600,60
KIBOGA,2024,300,290,590,60
KIBOGA,2025,300,280,580,60
KIBUKU,2015,220,260,480,60
KIBUKU,2016,220,250,470,60
KIBUKU,2017,230,260,490,60
KIBUKU,2018,260,290,550,60
KIBUKU,2019,300,350,650,60
KIBUKU,2020,330,400,730,60
KIBUKU,2021,370,460,830,60
KIBUKU,2022,400,490,890,60
KIBUKU,2023,420,510,930,60
KIBUKU,2024,430,490,920,60
KIBUKU,2025,430,480,910,60
KIKUUBE,2015,490,570,1060,60
KIKUUBE,2016,520,600,1120,60
KIKUUBE,2017,550,630,1180,60
KIKUUBE,2018,570,660,1230,60
KIKUUBE,2019,600,690,1290,60
KIKUUBE,2020,640,720,1360,60
KIKUUBE,2021,670,760,1430,60
KIKUUBE,2022,700,800,1500,60
KIKUUBE,2023,740,830,1570,60
KIKUUBE,2024,770,870,1640,60
KIKUUBE,2025,810,910,1720,60
KIRUHURA,2015,370,450,820,60
KIRUHURA,2016,390,460,850,60
KIRUHURA,2017,400,480,880,60
KIRUHURA,2018,420,490,910,60
KIRUHURA,2019,430,510,940,60
KIRUHURA,2020,450,530,980,60
KIRUHURA,2021,460,550,1010,60
KIRUHURA,2022,480,570,1050,60
KIRUHURA,2023,500,580,1080,60
KIRUHURA,2024,510,600,1110,60
KIRUHURA,2025,530,620,1150,60
KIRYANDONGO,2015,240,300,540,60
KIRYANDONGO,2016,240,290,530,60
KIRYANDONGO,2017,250,290,540,60
KIRYANDONGO,2018,270,330,600,60
KIRYANDONGO,2019,310,390,700,60
KIRYANDONGO,2020,350,450,800,60
KIRYANDONGO,2021,390,510,900,60
KIRYANDONGO,2022,410,540,950,60
KIRYANDONGO,2023,420,540,960,60
KIRYANDONGO,2024,430,530,960,60
KIRYANDONGO,2025,430,510,940,60
KISORO,2015,400,620,1020,60
KISORO,2016,380,580,960,60
KISORO,2017,400,590,990,60
KISORO,2018,430,670,1100,60
KISORO,2019,490,770,1260,60
KISORO,2020,540,890,1430,60
KISORO,2021,600,1000,1600,60
KISORO,2022,630,1060,1690,60
KISORO,2023,640,1050,1690,60
KISORO,2024,650,1020,1670,60
KISORO,2025,640,970,1610,60
KITAGWENDA,2015,310,510,820,60
KITAGWENDA,2016,320,530,850,60
KITAGWENDA,2017,330,550,880,60
KITAGWENDA,2018,350,570,920,60
KITAGWENDA,2019,360,590,950,60
KITAGWENDA,2020,380,610,990,60
KITAGWENDA,2021,390,630,1020,60
KITAGWENDA,2022,400,650,1050,60
KITAGWENDA,2023,420,670,1090,60
KITAGWENDA,2024,430,690,1120,60
KITAGWENDA,2025,450,710,1160,60
KITGUM,2015,220,330,550,60
KITGUM,2016,210,310,520,60
KITGUM,2017,220,310,530,60
KITGUM,2018,230,350,580,60
KITGUM,2019,260,400,660,60
KITGUM,2020,300,460,760,60
KITGUM,2021,320,510,830,60
KITGUM,2022,340,540,880,60
KITGUM,2023,350,550,900,60
KITGUM,2024,340,530,870,60
KITGUM,2025,340,490,830,60
KOBOKO,2015,220,260,480,60
KOBOKO,2016,210,250,460,60
KOBOKO,2017,220,260,480,60
KOBOKO,2018,250,300,550,60
KOBOKO,2019,280,360,640,60
KOBOKO,2020,320,420,740,60
KOBOKO,2021,360,480,840,60
KOBOKO,2022,390,510,900,60
KOBOKO,2023,400,520,920,60
KOBOKO,2024,410,510,920,60
KOBOKO,2025,420,500,920,60
KOLE,2015,270,420,690,60
KOLE,2016,280,440,720,60
KOLE,2017,290,450,740,60
KOLE,2018,300,460,760,60
KOLE,2019,310,470,780,60
KOLE,2020,320,490,810,60
KOLE,2021,330,500,830,60
KOLE,2022,340,510,850,60
KOLE,2023,350,530,880,60
KOLE,2024,360,540,900,60
KOLE,2025,370,550,920,60
KOTIDO,2015,270,190,460,60
KOTIDO,2016,260,180,440,60
KOTIDO,2017,270,180,450,60
KOTIDO,2018,290,210,500,60
KOTIDO,2019,330,240,570,60
KOTIDO,2020,370,280,650,60
KOTIDO,2021,410,310,720,60
KOTIDO,2022,430,330,760,60
KOTIDO,2023,440,330,770,60
KOTIDO,2024,450,320,770,60
KOTIDO,2025,450,310,760,60
KUMI,2015,280,380,660,60
KUMI,2016,280,360,640,60
KUMI,2017,290,370,660,60
KUMI,2018,320,420,740,60
KUMI,2019,370,490,860,60
KUMI,2020,420,570,990,60
KUMI,2021,460,650,1110,60
KUMI,2022,490,690,1180,60
KUMI,2023,510,700,1210,60
KUMI,2024,510,680,1190,60
KUMI,2025,520,650,1170,60
KWANIA,2015,300,450,750,60
KWANIA,2016,310,460,770,60
KWANIA,2017,320,480,800,60
KWANIA,2018,330,490,820,60
KWANIA,2019,340,500,840,60
KWANIA,2020,350,520,870,60
KWANIA,2021,360,530,890,60
KWANIA,2022,370,550,920,60
KWANIA,2023,380,560,940,60
KWANIA,2024,390,570,960,60
KWANIA,2025,400,590,990,60
KWEEN,2015,150,180,330,60
KWEEN,2016,150,180,330,60
KWEEN,2017,160,190,350,60
KWEEN,2018,160,190,350,60
KWEEN,2019,170,200,370,60
KWEEN,2020,170,200,370,60
KWEEN,2021,170,210,380,60
KWEEN,2022,180,210,390,60
KWEEN,2023,180,220,400,60
KWEEN,2024,190,220,410,60
KWEEN,2025,190,220,410,60
KYANKWANZI,2015,380,400,780,60
KYANKWANZI,2016,400,410,810,60
KYANKWANZI,2017,420,430,850,60
KYANKWANZI,2018,440,450,890,60
KYANKWANZI,2019,460,470,930,60
KYANKWANZI,2020,480,500,980,60
KYANKWANZI,2021,510,520,1030,60
KYANKWANZI,2022,530,540,1070,60
KYANKWANZI,2023,550,560,1110,60
KYANKWANZI,2024,580,590,1170,60
KYANKWANZI,2025,610,610,1220,60
KYEGEGWA,2015,430,440,870,60
KYEGEGWA,2016,460,470,930,60
KYEGEGWA,2017,500,510,1010,60
KYEGEGWA,2018,540,550,1090,60
KYEGEGWA,2019,580,590,1170,60
KYEGEGWA,2020,630,640,1270,60
KYEGEGWA,2021,680,690,1370,60
KYEGEGWA,2022,740,740,1480,60
KYEGEGWA,2023,790,790,1580,60
KYEGEGWA,2024,860,850,1710,60
KYEGEGWA,2025,920,920,1840,60
KYENJOJO,2015,580,880,1460,60
KYENJOJO,2016,600,920,1520,60
KYENJOJO,2017,630,950,1580,60
KYENJOJO,2018,650,980,1630,60
KYENJOJO,2019,680,1020,1700,60
KYENJOJO,2020,700,1060,1760,60
KYENJOJO,2021,730,1090,1820,60
KYENJOJO,2022,760,1130,1890,60
KYENJOJO,2023,790,1170,1960,60
KYENJOJO,2024,820,1210,2030,60
KYENJOJO,2025,840,1240,2080,60
KYOTERA,2015,300,360,660,60
KYOTERA,2016,290,340,630,60
KYOTERA,2017,300,340,640,60
KYOTERA,2018,330,380,710,60
KYOTERA,2019,370,440,810,60
KYOTERA,2020,410,500,910,60
KYOTERA,2021,450,560,1010,60
KYOTERA,2022,470,590,1060,60
KYOTERA,2023,480,590,1070,60
KYOTERA,2024,480,560,1040,60
KYOTERA,2025,470,530,1000,60
KARENGA,2015,120,150,270,60
KARENGA,2016,120,150,270,60
KARENGA,2017,120,150,270,60
KARENGA,2018,130,160,290,60
KARENGA,2019,130,160,290,60
KARENGA,2020,130,170,300,60
KARENGA,2021,140,170,310,60
KARENGA,2022,140,170,310,60
KARENGA,2023,140,180,320,60
KARENGA,2024,150,180,330,60
KARENGA,2025,150,180,330,60
LAMWO,2015,130,220,350,60
LAMWO,2016,120,210,330,60
LAMWO,2017,130,210,340,60
LAMWO,2018,130,230,360,60
LAMWO,2019,150,270,420,60
LAMWO,2020,170,310,480,60
LAMWO,2021,180,340,520,60
LAMWO,2022,190,360,550,60
LAMWO,2023,190,360,550,60
LAMWO,2024,190,350,540,60
LAMWO,2025,190,330,520,60
LIRA,2015,690,1180,1870,60
LIRA,2016,710,1220,1930,60
LIRA,2017,730,1250,1980,60
LIRA,2018,750,1290,2040,60
LIRA,2019,770,1320,2090,60
LIRA,2020,790,1360,2150,60
LIRA,2021,810,1390,2200,60
LIRA,2022,830,1430,2260,60
LIRA,2023,850,1470,2320,60
LIRA,2024,870,1500,2370,60
LIRA,2025,890,1540,2430,60
LUUKA,2015,330,400,730,60
LUUKA,2016,320,380,700,60
LUUKA,2017,330,380,710,60
LUUKA,2018,360,420,780,60
LUUKA,2019,410,490,900,60
LUUKA,2020,460,570,1030,60
LUUKA,2021,500,630,1130,60
LUUKA,2022,540,670,1210,60
LUUKA,2023,550,680,1230,60
LUUKA,2024,550,660,1210,60
LUUKA,2025,540,620,1160,60
LUWERO,2015,580,680,1260,60
LUWERO,2016,570,650,1220,60
LUWERO,2017,590,660,1250,60
LUWERO,2018,640,740,1380,60
LUWERO,2019,730,860,1590,60
LUWERO,2020,820,1000,1820,60
LUWERO,2021,900,1120,2020,60
LUWERO,2022,960,1190,2150,60
LUWERO,2023,980,1200,2180,60
LUWERO,2024,990,1160,2150,60
LUWERO,2025,990,1100,2090,60
LWENGO,2015,330,440,770,60
LWENGO,2016,320,410,730,60
LWENGO,2017,330,410,740,60
LWENGO,2018,360,460,820,60
LWENGO,2019,390,520,910,60
LWENGO,2020,440,600,1040,60
LWENGO,2021,480,670,1150,60
LWENGO,2022,500,690,1190,60
LWENGO,2023,510,690,1200,60
LWENGO,2024,500,660,1160,60
LWENGO,2025,490,620,1110,60
LYANTONDE,2015,120,140,260,60
LYANTONDE,2016,120,130,250,60
LYANTONDE,2017,130,130,260,60
LYANTONDE,2018,140,150,290,60
LYANTONDE,2019,150,180,330,60
LYANTONDE,2020,180,200,380,60
LYANTONDE,2021,200,230,430,60
LYANTONDE,2022,210,240,450,60
LYANTONDE,2023,210,250,460,60
LYANTONDE,2024,220,240,460,60
LYANTONDE,2025,220,230,450,60
MANAFWA,2015,310,390,700,60
MANAFWA,2016,310,400,710,60
MANAFWA,2017,320,410,730,60
MANAFWA,2018,330,420,750,60
MANAFWA,2019,340,430,770,60
MANAFWA,2020,340,440,780,60
MANAFWA,2021,350,450,800,60
MANAFWA,2022,360,460,820,60
MANAFWA,2023,370,460,830,60
MANAFWA,2024,380,470,850,60
MANAFWA,2025,380,480,860,60
MARACHA,2015,360,670,1030,60
MARACHA,2016,370,680,1050,60
MARACHA,2017,380,690,1070,60
MARACHA,2018,380,710,1090,60
MARACHA,2019,390,720,1110,60
MARACHA,2020,400,730,1130,60
MARACHA,2021,410,750,1160,60
MARACHA,2022,410,760,1170,60
MARACHA,2023,420,770,1190,60
MARACHA,2024,430,780,1210,60
MARACHA,2025,440,790,1230,60
MASAKA,2015,340,420,760,60
MASAKA,2016,330,400,730,60
MASAKA,2017,320,370,690,60
MASAKA,2018,310,340,650,60
MASAKA,2019,310,350,660,60
MASAKA,2020,340,390,730,60
MASAKA,2021,390,460,850,60
MASAKA,2022,440,520,960,60
MASAKA,2023,480,580,1060,60
MASAKA,2024,520,620,1140,60
MASAKA,2025,520,620,1140,60
MASINDI,2015,550,720,1270,60
MASINDI,2016,570,740,1310,60
MASINDI,2017,590,760,1350,60
MASINDI,2018,600,780,1380,60
MASINDI,2019,620,800,1420,60
MASINDI,2020,640,820,1460,60
MASINDI,2021,660,840,1500,60
MASINDI,2022,670,860,1530,60
MASINDI,2023,690,880,1570,60
MASINDI,2024,710,900,1610,60
MASINDI,2025,720,920,1640,60
MAYUGE,2015,590,640,1230,60
MAYUGE,2016,580,610,1190,60
MAYUGE,2017,600,630,1230,60
MAYUGE,2018,670,710,1380,60
MAYUGE,2019,760,830,1590,60
MAYUGE,2020,860,970,1830,60
MAYUGE,2021,950,1100,2050,60
MAYUGE,2022,1020,1170,2190,60
MAYUGE,2023,1050,1180,2230,60
MAYUGE,2024,1070,1160,2230,60
MAYUGE,2025,1060,1110,2170,60
MBALE,2015,610,610,1220,60
MBALE,2016,610,590,1200,60
MBALE,2017,630,610,1240,60
MBALE,2018,700,690,1390,60
MBALE,2019,780,810,1590,60
MBALE,2020,890,950,1840,60
MBALE,2021,990,1070,2060,60
MBALE,2022,1060,1150,2210,60
MBALE,2023,1090,1160,2250,60
MBALE,2024,1100,1140,2240,60
MBALE,2025,1100,1100,2200,60
MBARARA,2015,620,900,1520,60
MBARARA,2016,630,920,1550,60
MBARARA,2017,650,940,1590,60
MBARARA,2018,660,960,1620,60
MBARARA,2019,680,980,1660,60
MBARARA,2020,690,1000,1690,60
MBARARA,2021,710,1020,1730,60
MBARARA,2022,720,1040,1760,60
MBARARA,2023,730,1060,1790,60
MBARARA,2024,750,1080,1830,60
MBARARA,2025,760,1100,1860,60
MITOOMA,2015,410,720,1130,60
MITOOMA,2016,420,730,1150,60
MITOOMA,2017,420,730,1150,60
MITOOMA,2018,430,740,1170,60
MITOOMA,2019,430,750,1180,60
MITOOMA,2020,440,750,1190,60
MITOOMA,2021,440,760,1200,60
MITOOMA,2022,450,760,1210,60
MITOOMA,2023,450,770,1220,60
MITOOMA,2024,450,770,1220,60
MITOOMA,2025,460,770,1230,60
MITYANA,2015,450,540,990,60
MITYANA,2016,440,510,950,60
MITYANA,2017,450,510,960,60
MITYANA,2018,490,570,1060,60
MITYANA,2019,550,660,1210,60
MITYANA,2020,610,760,1370,60
MITYANA,2021,680,850,1530,60
MITYANA,2022,710,890,1600,60
MITYANA,2023,730,890,1620,60
MITYANA,2024,720,860,1580,60
MITYANA,2025,710,810,1520,60
MOROTO,2015,160,200,360,60
MOROTO,2016,150,190,340,60
MOROTO,2017,160,200,360,60
MOROTO,2018,170,220,390,60
MOROTO,2019,190,250,440,60
MOROTO,2020,220,290,510,60
MOROTO,2021,240,330,570,60
MOROTO,2022,250,360,610,60
MOROTO,2023,260,360,620,60
MOROTO,2024,260,350,610,60
MOROTO,2025,260,330,590,60
MOYO,2015,170,230,400,60
MOYO,2016,180,240,420,60
MOYO,2017,180,240,420,60
MOYO,2018,180,250,430,60
MOYO,2019,190,250,440,60
MOYO,2020,190,260,450,60
MOYO,2021,200,260,460,60
MOYO,2022,200,270,470,60
MOYO,2023,210,270,480,60
MOYO,2024,210,280,490,60
MOYO,2025,220,280,500,60
MPIGI,2015,340,390,730,60
MPIGI,2016,340,370,710,60
MPIGI,2017,340,370,710,60
MPIGI,2018,380,420,800,60
MPIGI,2019,420,490,910,60
MPIGI,2020,480,570,1050,60
MPIGI,2021,520,630,1150,60
MPIGI,2022,560,670,1230,60
MPIGI,2023,570,680,1250,60
MPIGI,2024,580,660,1240,60
MPIGI,2025,570,630,1200,60
MUBENDE,2015,560,600,1160,60
MUBENDE,2016,570,590,1160,60
MUBENDE,2017,560,570,1130,60
MUBENDE,2018,550,540,1090,60
MUBENDE,2019,570,530,1100,60
MUBENDE,2020,600,560,1160,60
MUBENDE,2021,670,640,1310,60
MUBENDE,2022,780,760,1540,60
MUBENDE,2023,910,920,1830,60
MUBENDE,2024,1020,1050,2070,60
MUBENDE,2025,1120,1160,2280,60
MUKONO,2015,750,930,1680,60
MUKONO,2016,730,880,1610,60
MUKONO,2017,760,900,1660,60
MUKONO,2018,840,1020,1860,60
MUKONO,2019,940,1200,2140,60
MUKONO,2020,1070,1400,2470,60
MUKONO,2021,1180,1570,2750,60
MUKONO,2022,1260,1680,2940,60
MUKONO,2023,1290,1700,2990,60
MUKONO,2024,1290,1660,2950,60
MUKONO,2025,1290,1600,2890,60
NABILATUK,2015,100,120,220,60
NABILATUK,2016,100,110,210,60
NABILATUK,2017,100,120,220,60
NABILATUK,2018,120,140,260,60
NABILATUK,2019,130,160,290,60
NABILATUK,2020,160,200,360,60
NABILATUK,2021,180,220,400,60
NABILATUK,2022,200,240,440,60
NABILATUK,2023,210,250,460,60
NABILATUK,2024,210,250,460,60
NABILATUK,2025,210,240,450,60
NAKAPIRIPIRIT,2015,160,170,330,60
NAKAPIRIPIRIT,2016,160,170,330,60
NAKAPIRIPIRIT,2017,160,180,340,60
NAKAPIRIPIRIT,2018,190,200,390,60
NAKAPIRIPIRIT,2019,210,240,450,60
NAKAPIRIPIRIT,2020,250,280,530,60
NAKAPIRIPIRIT,2021,270,320,590,60
NAKAPIRIPIRIT,2022,300,350,650,60
NAKAPIRIPIRIT,2023,310,360,670,60
NAKAPIRIPIRIT,2024,320,350,670,60
NAKAPIRIPIRIT,2025,330,340,670,60
NAKASEKE,2015,480,730,1210,60
NAKASEKE,2016,500,750,1250,60
NAKASEKE,2017,510,760,1270,60
NAKASEKE,2018,530,780,1310,60
NAKASEKE,2019,550,800,1350,60
NAKASEKE,2020,570,820,1390,60
NAKASEKE,2021,590,840,1430,60
NAKASEKE,2022,610,850,1460,60
NAKASEKE,2023,630,870,1500,60
NAKASEKE,2024,650,890,1540,60
NAKASEKE,2025,670,910,1580,60
NAKASONGOLA,2015,220,190,410,60
NAKASONGOLA,2016,210,180,390,60
NAKASONGOLA,2017,220,190,410,60
NAKASONGOLA,2018,240,210,450,60
NAKASONGOLA,2019,280,250,530,60
NAKASONGOLA,2020,310,290,600,60
NAKASONGOLA,2021,340,320,660,60
NAKASONGOLA,2022,370,340,710,60
NAKASONGOLA,2023,380,350,730,60
NAKASONGOLA,2024,390,340,730,60
NAKASONGOLA,2025,390,330,720,60
NAMAYINGO,2015,200,210,410,60
NAMAYINGO,2016,200,200,400,60
NAMAYINGO,2017,200,200,400,60
NAMAYINGO,2018,220,220,440,60
NAMAYINGO,2019,250,260,510,60
NAMAYINGO,2020,280,300,580,60
NAMAYINGO,2021,300,330,630,60
NAMAYINGO,2022,320,350,670,60
NAMAYINGO,2023,330,350,680,60
NAMAYINGO,2024,330,330,660,60
NAMAYINGO,2025,330,320,650,60
NAMISINDWA,2015,380,460,840,60
NAMISINDWA,2016,390,470,860,60
NAMISINDWA,2017,400,480,880,60
NAMISINDWA,2018,410,490,900,60
NAMISINDWA,2019,420,500,920,60
NAMISINDWA,2020,430,510,940,60
NAMISINDWA,2021,440,520,960,60
NAMISINDWA,2022,450,530,980,60
NAMISINDWA,2023,460,550,1010,60
NAMISINDWA,2024,470,560,1030,60
NAMISINDWA,2025,490,570,1060,60
NAMUTUMBA,2015,360,380,740,60
NAMUTUMBA,2016,360,360,720,60
NAMUTUMBA,2017,380,370,750,60
NAMUTUMBA,2018,410,420,830,60
NAMUTUMBA,2019,470,500,970,60
NAMUTUMBA,2020,540,580,1120,60
NAMUTUMBA,2021,600,660,1260,60
NAMUTUMBA,2022,650,710,1360,60
NAMUTUMBA,2023,670,720,1390,60
NAMUTUMBA,2024,680,700,1380,60
NAMUTUMBA,2025,680,680,1360,60
NAPAK,2015,240,340,580,60
NAPAK,2016,230,320,550,60
NAPAK,2017,230,320,550,60
NAPAK,2018,260,360,620,60
NAPAK,2019,290,420,710,60
NAPAK,2020,320,490,810,60
NAPAK,2021,350,550,900,60
NAPAK,2022,370,570,940,60
NAPAK,2023,370,580,950,60
NAPAK,2024,370,560,930,60
NAPAK,2025,370,530,900,60
NEBBI,2015,370,560,930,60
NEBBI,2016,390,580,970,60
NEBBI,2017,400,590,990,60
NEBBI,2018,410,610,1020,60
NEBBI,2019,420,630,1050,60
NEBBI,2020,440,640,1080,60
NEBBI,2021,450,660,1110,60
NEBBI,2022,460,680,1140,60
NEBBI,2023,470,700,1170,60
NEBBI,2024,490,710,1200,60
NEBBI,2025,500,730,1230,60
NGORA,2015,200,310,510,60
NGORA,2016,190,300,490,60
NGORA,2017,210,310,520,60
NGORA,2018,230,340,570,60
NGORA,2019,260,400,660,60
NGORA,2020,290,460,750,60
NGORA,2021,320,520,840,60
NGORA,2022,340,550,890,60
NGORA,2023,350,560,910,60
NGORA,2024,350,540,890,60
NGORA,2025,350,520,870,60
NTOROKO,2015,110,80,190,60
NTOROKO,2016,100,80,180,60
NTOROKO,2017,110,80,190,60
NTOROKO,2018,120,90,210,60
NTOROKO,2019,130,100,230,60
NTOROKO,2020,150,120,270,60
NTOROKO,2021,170,130,300,60
NTOROKO,2022,170,140,310,60
NTOROKO,2023,180,140,320,60
NTOROKO,2024,180,140,320,60
NTOROKO,2025,180,130,310,60
NTUNGAMO,2015,1040,1760,2800,60
NTUNGAMO,2016,1060,1800,2860,60
NTUNGAMO,2017,1090,1830,2920,60
NTUNGAMO,2018,1110,1860,2970,60
NTUNGAMO,2019,1130,1900,3030,60
NTUNGAMO,2020,1160,1930,3090,60
NTUNGAMO,2021,1180,1960,3140,60
NTUNGAMO,2022,1200,1990,3190,60
NTUNGAMO,2023,1220,2020,3240,60
NTUNGAMO,2024,1240,2050,3290,60
NTUNGAMO,2025,1260,2080,3340,60
NWOYA,2015,270,480,750,60
NWOYA,2016,300,530,830,60
NWOYA,2017,330,590,920,60
NWOYA,2018,360,640,1000,60
NWOYA,2019,400,710,1110,60
NWOYA,2020,440,780,1220,60
NWOYA,2021,490,860,1350,60
NWOYA,2022,540,940,1480,60
NWOYA,2023,590,1040,1630,60
NWOYA,2024,650,1140,1790,60
NWOYA,2025,720,1250,1970,60
OBONGI,2015,60,50,110,60
OBONGI,2016,50,50,100,60
OBONGI,2017,60,50,110,60
OBONGI,2018,60,50,110,60
OBONGI,2019,70,70,140,60
OBONGI,2020,80,80,160,60
OBONGI,2021,90,80,170,60
OBONGI,2022,90,90,180,60
OBONGI,2023,100,90,190,60
OBONGI,2024,90,90,180,60
OBONGI,2025,100,80,180,60
OMORO,2015,180,230,410,60
OMORO,2016,180,220,400,60
OMORO,2017,190,230,420,60
OMORO,2018,210,260,470,60
OMORO,2019,240,310,550,60
OMORO,2020,280,360,640,60
OMORO,2021,300,410,710,60
OMORO,2022,320,440,760,60
OMORO,2023,340,450,790,60
OMORO,2024,340,440,780,60
OMORO,2025,340,420,760,60
OTUKE,2015,200,440,640,60
OTUKE,2016,210,450,660,60
OTUKE,2017,220,470,690,60
OTUKE,2018,230,490,720,60
OTUKE,2019,240,510,750,60
OTUKE,2020,250,540,790,60
OTUKE,2021,260,560,820,60
OTUKE,2022,270,580,850,60
OTUKE,2023,280,600,880,60
OTUKE,2024,290,630,920,60
OTUKE,2025,300,650,950,60
OYAM,2015,620,990,1610,60
OYAM,2016,640,1010,1650,60
OYAM,2017,660,1040,1700,60
OYAM,2018,680,1070,1750,60
OYAM,2019,700,1110,1810,60
OYAM,2020,720,1140,1860,60
OYAM,2021,740,1170,1910,60
OYAM,2022,760,1200,1960,60
OYAM,2023,780,1230,2010,60
OYAM,2024,800,1260,2060,60
OYAM,2025,820,1290,2110,60
PADER,2015,150,260,410,60
PADER,2016,150,240,390,60
PADER,2017,150,250,400,60
PADER,2018,170,280,450,60
PADER,2019,190,330,520,60
PADER,2020,210,380,590,60
PADER,2021,230,420,650,60
PADER,2022,240,440,680,60
PADER,2023,250,440,690,60
PADER,2024,240,430,670,60
PADER,2025,240,410,650,60
PAKWACH,2015,240,440,680,60
PAKWACH,2016,250,460,710,60
PAKWACH,2017,260,470,730,60
PAKWACH,2018,270,490,760,60
PAKWACH,2019,280,510,790,60
PAKWACH,2020,290,530,820,60
PAKWACH,2021,300,550,850,60
PAKWACH,2022,310,560,870,60
PAKWACH,2023,320,580,900,60
PAKWACH,2024,340,600,940,60
PAKWACH,2025,350,620,970,60
PALLISA,2015,310,390,700,60
PALLISA,2016,300,380,680,60
PALLISA,2017,320,400,720,60
PALLISA,2018,360,450,810,60
PALLISA,2019,410,530,940,60
PALLISA,2020,470,640,1110,60
PALLISA,2021,530,720,1250,60
PALLISA,2022,580,790,1370,60
PALLISA,2023,600,800,1400,60
PALLISA,2024,620,790,1410,60
PALLISA,2025,620,770,1390,60
RAKAI,2015,380,430,810,60
RAKAI,2016,370,400,770,60
RAKAI,2017,380,420,800,60
RAKAI,2018,420,460,880,60
RAKAI,2019,470,540,1010,60
RAKAI,2020,540,620,1160,60
RAKAI,2021,590,700,1290,60
RAKAI,2022,630,750,1380,60
RAKAI,2023,650,750,1400,60
RAKAI,2024,650,720,1370,60
RAKAI,2025,650,690,1340,60
RUBANDA,2015,460,700,1160,60
RUBANDA,2016,470,710,1180,60
RUBANDA,2017,470,710,1180,60
RUBANDA,2018,480,720,1200,60
RUBANDA,2019,490,720,1210,60
RUBANDA,2020,490,730,1220,60
RUBANDA,2021,500,730,1230,60
RUBANDA,2022,500,740,1240,60
RUBANDA,2023,510,740,1250,60
RUBANDA,2024,510,740,1250,60
RUBANDA,2025,520,740,1260,60
RUBIRIZI,2015,270,490,760,60
RUBIRIZI,2016,280,500,780,60
RUBIRIZI,2017,280,510,790,60
RUBIRIZI,2018,290,520,810,60
RUBIRIZI,2019,290,520,810,60
RUBIRIZI,2020,300,530,830,60
RUBIRIZI,2021,310,540,850,60
RUBIRIZI,2022,310,550,860,60
RUBIRIZI,2023,320,560,880,60
RUBIRIZI,2024,320,570,890,60
RUBIRIZI,2025,330,580,910,60
RUKIGA,2015,310,410,720,60
RUKIGA,2016,310,410,720,60
RUKIGA,2017,310,420,730,60
RUKIGA,2018,320,420,740,60
RUKIGA,2019,320,420,740,60
RUKIGA,2020,320,420,740,60
RUKIGA,2021,330,420,750,60
RUKIGA,2022,330,430,760,60
RUKIGA,2023,330,430,760,60
RUKIGA,2024,330,430,760,60
RUKIGA,2025,330,430,760,60
RUKUNGIRI,2015,680,1110,1790,60
RUKUNGIRI,2016,680,1120,1800,60
RUKUNGIRI,2017,690,1140,1830,60
RUKUNGIRI,2018,700,1150,1850,60
RUKUNGIRI,2019,710,1160,1870,60
RUKUNGIRI,2020,720,1170,1890,60
RUKUNGIRI,2021,720,1170,1890,60
RUKUNGIRI,2022,730,1180,1910,60
RUKUNGIRI,2023,740,1190,1930,60
RUKUNGIRI,2024,740,1200,1940,60
RUKUNGIRI,2025,750,1200,1950,60
RWAMPARA,2015,280,440,720,60
RWAMPARA,2016,280,450,730,60
RWAMPARA,2017,290,460,750,60
RWAMPARA,2018,290,470,760,60
RWAMPARA,2019,300,480,780,60
RWAMPARA,2020,310,490,800,60
RWAMPARA,2021,310,500,810,60
RWAMPARA,2022,320,510,830,60
RWAMPARA,2023,330,520,850,60
RWAMPARA,2024,330,530,860,60
RWAMPARA,2025,340,530,870,60
SERERE,2015,340,480,820,60
SERERE,2016,340,470,810,60
SERERE,2017,360,480,840,60
SERERE,2018,400,550,950,60
SERERE,2019,460,650,1110,60
SERERE,2020,520,760,1280,60
SERERE,2021,580,870,1450,60
SERERE,2022,630,940,1570,60
SERERE,2023,660,960,1620,60
SERERE,2024,670,950,1620,60
SERERE,2025,680,920,1600,60
SHEEMA,2015,510,820,1330,60
SHEEMA,2016,510,830,1340,60
SHEEMA,2017,520,840,1360,60
SHEEMA,2018,520,850,1370,60
SHEEMA,2019,530,860,1390,60
SHEEMA,2020,540,870,1410,60
SHEEMA,2021,540,870,1410,60
SHEEMA,2022,550,880,1430,60
SHEEMA,2023,550,890,1440,60
SHEEMA,2024,560,890,1450,60
SHEEMA,2025,560,900,1460,60
SIRONKO,2015,640,890,1530,60
SIRONKO,2016,660,910,1570,60
SIRONKO,2017,680,930,1610,60
SIRONKO,2018,690,940,1630,60
SIRONKO,2019,710,960,1670,60
SIRONKO,2020,720,980,1700,60
SIRONKO,2021,740,1000,1740,60
SIRONKO,2022,750,1020,1770,60
SIRONKO,2023,770,1030,1800,60
SIRONKO,2024,780,1050,1830,60
SIRONKO,2025,800,1070,1870,60
SOROTI,2015,310,460,770,60
SOROTI,2016,310,440,750,60
SOROTI,2017,320,450,770,60
SOROTI,2018,360,510,870,60
SOROTI,2019,410,610,1020,60
SOROTI,2020,470,710,1180,60
SOROTI,2021,520,800,1320,60
SOROTI,2022,560,860,1420,60
SOROTI,2023,580,880,1460,60
SOROTI,2024,580,860,1440,60
SOROTI,2025,590,830,1420,60
SSEMBABULE,2015,360,390,750,60
SSEMBABULE,2016,350,370,720,60
SSEMBABULE,2017,360,380,740,60
SSEMBABULE,2018,400,430,830,60
SSEMBABULE,2019,460,500,960,60
SSEMBABULE,2020,520,580,1100,60
SSEMBABULE,2021,570,650,1220,60
SSEMBABULE,2022,610,700,1310,60
SSEMBABULE,2023,630,700,1330,60
SSEMBABULE,2024,630,690,1320,60
SSEMBABULE,2025,630,660,1290,60
TORORO,2015,980,1420,2400,60
TORORO,2016,1010,1460,2470,60
TORORO,2017,1040,1500,2540,60
TORORO,2018,1060,1530,2590,60
TORORO,2019,1090,1570,2660,60
TORORO,2020,1120,1610,2730,60
TORORO,2021,1140,1640,2780,60
TORORO,2022,1170,1680,2850,60
TORORO,2023,1200,1720,2920,60
TORORO,2024,1220,1750,2970,60
TORORO,2025,1250,1790,3040,60
WAKISO,2015,2730,3810,6540,60
WAKISO,2016,2910,4070,6980,60
WAKISO,2017,3110,4350,7460,60
WAKISO,2018,3310,4640,7950,60
WAKISO,2019,3530,4960,8490,60
WAKISO,2020,3760,5290,9050,60
WAKISO,2021,4000,5640,9640,60
WAKISO,2022,4260,6010,10270,60
WAKISO,2023,4530,6390,10920,60
WAKISO,2024,4810,6800,11610,60
WAKISO,2025,5110,7230,12340,60
YUMBE,2015,430,430,860,60
YUMBE,2016,430,420,850,60
YUMBE,2017,460,440,900,60
YUMBE,2018,510,510,1020,60
YUMBE,2019,600,620,1220,60
YUMBE,2020,690,750,1440,60
YUMBE,2021,780,860,1640,60
YUMBE,2022,850,950,1800,60
YUMBE,2023,900,990,1890,60
YUMBE,2024,920,990,1910,60
YUMBE,2025,940,980,1920,60
ZOMBO,2015,310,440,750,60
ZOMBO,2016,320,450,770,60
ZOMBO,2017,330,460,790,60
ZOMBO,2018,340,480,820,60
ZOMBO,2019,350,490,840,60
ZOMBO,2020,360,500,860,60
ZOMBO,2021,370,520,890,60
ZOMBO,2022,380,530,910,60
ZOMBO,2023,390,540,930,60
ZOMBO,2024,400,550,950,60
ZOMBO,2025,410,570,980,60
MADI OKOLLO,2015,310,550,860,60
MADI OKOLLO,2016,320,560,880,60
MADI OKOLLO,2017,330,580,910,60
MADI OKOLLO,2018,340,590,930,60
MADI OKOLLO,2019,340,610,950,60
MADI OKOLLO,2020,350,620,970,60
MADI OKOLLO,2021,360,640,1000,60
MADI OKOLLO,2022,370,660,1030,60
MADI OKOLLO,2023,380,670,1050,60
MADI OKOLLO,2024,390,680,1070,60
MADI OKOLLO,2025,400,700,1100,60
ABIM,2015,110,110,220,61
ABIM,2016,100,100,200,61
ABIM,2017,110,90,200,61
ABIM,2018,110,110,220,61
ABIM,2019,130,120,250,61
ABIM,2020,160,150,310,61
ABIM,2021,180,170,350,61
ABIM,2022,210,210,420,61
ABIM,2023,240,210,450,61
ABIM,2024,260,230,490,61
ABIM,2025,250,240,490,61
ADJUMANI,2015,190,200,390,61
ADJUMANI,2016,190,200,390,61
ADJUMANI,2017,190,210,400,61
ADJUMANI,2018,190,210,400,61
ADJUMANI,2019,190,210,400,61
ADJUMANI,2020,190,210,400,61
ADJUMANI,2021,190,210,400,61
ADJUMANI,2022,200,210,410,61
ADJUMANI,2023,200,220,420,61
ADJUMANI,2024,200,220,420,61
ADJUMANI,2025,200,220,420,61
AGAGO,2015,180,200,380,61
AGAGO,2016,180,210,390,61
AGAGO,2017,190,210,400,61
AGAGO,2018,190,210,400,61
AGAGO,2019,190,220,410,61
AGAGO,2020,200,220,420,61
AGAGO,2021,200,220,420,61
AGAGO,2022,200,230,430,61
AGAGO,2023,210,230,440,61
AGAGO,2024,210,230,440,61
AGAGO,2025,210,240,450,61
ALEBTONG,2015,350,350,700,61
ALEBTONG,2016,330,320,650,61
ALEBTONG,2017,320,310,630,61
ALEBTONG,2018,340,320,660,61
ALEBTONG,2019,380,350,730,61
ALEBTONG,2020,410,410,820,61
ALEBTONG,2021,470,470,940,61
ALEBTONG,2022,530,530,1060,61
ALEBTONG,2023,560,580,1140,61
ALEBTONG,2024,570,570,1140,61
ALEBTONG,2025,580,560,1140,61
AMOLATAR,2015,180,220,400,61
AMOLATAR,2016,180,200,380,61
AMOLATAR,2017,170,190,360,61
AMOLATAR,2018,190,200,390,61
AMOLATAR,2019,200,220,420,61
AMOLATAR,2020,220,250,470,61
AMOLATAR,2021,260,300,560,61
AMOLATAR,2022,280,330,610,61
AMOLATAR,2023,310,340,650,61
AMOLATAR,2024,310,360,670,61
AMOLATAR,2025,310,340,650,61
AMUDAT,2015,110,190,300,61
AMUDAT,2016,120,190,310,61
AMUDAT,2017,110,170,280,61
AMUDAT,2018,110,190,300,61
AMUDAT,2019,130,200,330,61
AMUDAT,2020,150,250,400,61
AMUDAT,2021,180,300,480,61
AMUDAT,2022,190,330,520,61
AMUDAT,2023,200,360,560,61
AMUDAT,2024,220,380,600,61
AMUDAT,2025,220,380,600,61
AMURIA,2015,200,190,390,61
AMURIA,2016,200,190,390,61
AMURIA,2017,190,170,360,61
AMURIA,2018,200,190,390,61
AMURIA,2019,220,200,420,61
AMURIA,2020,250,250,500,61
AMURIA,2021,290,280,570,61
AMURIA,2022,320,330,650,61
AMURIA,2023,350,340,690,61
AMURIA,2024,370,340,710,61
AMURIA,2025,360,340,700,61
AMURU,2015,130,170,300,61
AMURU,2016,120,170,290,61
AMURU,2017,120,160,280,61
AMURU,2018,130,160,290,61
AMURU,2019,130,190,320,61
AMURU,2020,150,210,360,61
AMURU,2021,180,240,420,61
AMURU,2022,190,270,460,61
AMURU,2023,200,300,500,61
AMURU,2024,220,290,510,61
AMURU,2025,220,280,500,61
APAC,2015,150,150,300,61
APAC,2016,150,150,300,61
APAC,2017,160,160,320,61
APAC,2018,160,160,320,61
APAC,2019,170,170,340,61
APAC,2020,170,180,350,61
APAC,2021,180,180,360,61
APAC,2022,190,190,380,61
APAC,2023,190,190,380,61
APAC,2024,200,200,400,61
APAC,2025,200,200,400,61
ARUA,2015,560,590,1150,61
ARUA,2016,580,600,1180,61
ARUA,2017,590,620,1210,61
ARUA,2018,610,640,1250,61
ARUA,2019,630,650,1280,61
ARUA,2020,650,670,1320,61
ARUA,2021,660,690,1350,61
ARUA,2022,680,700,1380,61
ARUA,2023,700,720,1420,61
ARUA,2024,710,740,1450,61
ARUA,2025,730,750,1480,61
BUDAKA,2015,280,330,610,61
BUDAKA,2016,270,320,590,61
BUDAKA,2017,260,310,570,61
BUDAKA,2018,280,320,600,61
BUDAKA,2019,310,350,660,61
BUDAKA,2020,360,410,770,61
BUDAKA,2021,410,490,900,61
BUDAKA,2022,440,560,1000,61
BUDAKA,2023,470,600,1070,61
BUDAKA,2024,490,590,1080,61
BUDAKA,2025,500,580,1080,61
BUDUDA,2015,310,290,600,61
BUDUDA,2016,300,270,570,61
BUDUDA,2017,300,270,570,61
BUDUDA,2018,310,280,590,61
BUDUDA,2019,350,320,670,61
BUDUDA,2020,400,380,780,61
BUDUDA,2021,460,450,910,61
BUDUDA,2022,530,510,1040,61
BUDUDA,2023,560,560,1120,61
BUDUDA,2024,590,570,1160,61
BUDUDA,2025,610,560,1170,61
BUGIRI,2015,450,540,990,61
BUGIRI,2016,440,500,940,61
BUGIRI,2017,440,480,920,61
BUGIRI,2018,450,500,950,61
BUGIRI,2019,510,570,1080,61
BUGIRI,2020,590,680,1270,61
BUGIRI,2021,670,790,1460,61
BUGIRI,2022,750,910,1660,61
BUGIRI,2023,800,960,1760,61
BUGIRI,2024,840,990,1830,61
BUGIRI,2025,870,960,1830,61
BUGWERI,2015,140,190,330,61
BUGWERI,2016,140,170,310,61
BUGWERI,2017,140,160,300,61
BUGWERI,2018,140,170,310,61
BUGWERI,2019,160,190,350,61
BUGWERI,2020,180,210,390,61
BUGWERI,2021,200,260,460,61
BUGWERI,2022,230,290,520,61
BUGWERI,2023,240,300,540,61
BUGWERI,2024,240,320,560,61
BUGWERI,2025,230,300,530,61
BUHWEJU,2015,90,120,210,61
BUHWEJU,2016,90,120,210,61
BUHWEJU,2017,90,130,220,61
BUHWEJU,2018,100,130,230,61
BUHWEJU,2019,100,130,230,61
BUHWEJU,2020,100,140,240,61
BUHWEJU,2021,110,140,250,61
BUHWEJU,2022,110,150,260,61
BUHWEJU,2023,110,150,260,61
BUHWEJU,2024,110,150,260,61
BUHWEJU,2025,120,160,280,61
BUIKWE,2015,390,480,870,61
BUIKWE,2016,380,440,820,61
BUIKWE,2017,360,410,770,61
BUIKWE,2018,380,420,800,61
BUIKWE,2019,420,480,900,61
BUIKWE,2020,460,540,1000,61
BUIKWE,2021,520,640,1160,61
BUIKWE,2022,560,700,1260,61
BUIKWE,2023,600,750,1350,61
BUIKWE,2024,620,760,1380,61
BUIKWE,2025,610,720,1330,61
BUKEDEA,2015,220,300,520,61
BUKEDEA,2016,220,270,490,61
BUKEDEA,2017,220,270,490,61
BUKEDEA,2018,230,280,510,61
BUKEDEA,2019,260,320,580,61
BUKEDEA,2020,300,380,680,61
BUKEDEA,2021,340,450,790,61
BUKEDEA,2022,390,490,880,61
BUKEDEA,2023,420,530,950,61
BUKEDEA,2024,440,550,990,61
BUKEDEA,2025,450,540,990,61
BUKOMANSIMBI,2015,250,300,550,61
BUKOMANSIMBI,2016,230,270,500,61
BUKOMANSIMBI,2017,220,250,470,61
BUKOMANSIMBI,2018,230,250,480,61
BUKOMANSIMBI,2019,240,280,520,61
BUKOMANSIMBI,2020,270,310,580,61
BUKOMANSIMBI,2021,310,360,670,61
BUKOMANSIMBI,2022,330,390,720,61
BUKOMANSIMBI,2023,350,410,760,61
BUKOMANSIMBI,2024,350,400,750,61
BUKOMANSIMBI,2025,340,380,720,61
BUKWO,2015,90,70,160,61
BUKWO,2016,90,80,170,61
BUKWO,2017,100,80,180,61
BUKWO,2018,100,90,190,61
BUKWO,2019,110,90,200,61
BUKWO,2020,110,90,200,61
BUKWO,2021,120,100,220,61
BUKWO,2022,120,100,220,61
BUKWO,2023,130,110,240,61
BUKWO,2024,140,110,250,61
BUKWO,2025,140,120,260,61
BULAMBULI,2015,290,350,640,61
BULAMBULI,2016,290,330,620,61
BULAMBULI,2017,290,320,610,61
BULAMBULI,2018,300,330,630,61
BULAMBULI,2019,340,390,730,61
BULAMBULI,2020,400,460,860,61
BULAMBULI,2021,460,540,1000,61
BULAMBULI,2022,510,620,1130,61
BULAMBULI,2023,550,680,1230,61
BULAMBULI,2024,590,700,1290,61
BULAMBULI,2025,590,700,1290,61
BULIISA,2015,90,80,170,61
BULIISA,2016,100,80,180,61
BULIISA,2017,110,90,200,61
BULIISA,2018,110,90,200,61
BULIISA,2019,120,100,220,61
BULIISA,2020,120,100,220,61
BULIISA,2021,130,100,230,61
BULIISA,2022,140,110,250,61
BULIISA,2023,140,110,250,61
BULIISA,2024,150,120,270,61
BULIISA,2025,160,120,280,61
BUNDIBUGYO,2015,340,270,610,61
BUNDIBUGYO,2016,330,260,590,61
BUNDIBUGYO,2017,320,240,560,61
BUNDIBUGYO,2018,340,240,580,61
BUNDIBUGYO,2019,380,280,660,61
BUNDIBUGYO,2020,410,310,720,61
BUNDIBUGYO,2021,470,380,850,61
BUNDIBUGYO,2022,530,410,940,61
BUNDIBUGYO,2023,560,450,1010,61
BUNDIBUGYO,2024,590,440,1030,61
BUNDIBUGYO,2025,580,440,1020,61
BUNYANGABU,2015,200,240,440,61
BUNYANGABU,2016,180,220,400,61
BUNYANGABU,2017,190,210,400,61
BUNYANGABU,2018,190,210,400,61
BUNYANGABU,2019,220,230,450,61
BUNYANGABU,2020,240,280,520,61
BUNYANGABU,2021,260,320,580,61
BUNYANGABU,2022,300,350,650,61
BUNYANGABU,2023,310,380,690,61
BUNYANGABU,2024,330,380,710,61
BUNYANGABU,2025,320,360,680,61
BUSHENYI,2015,220,250,470,61
BUSHENYI,2016,220,250,470,61
BUSHENYI,2017,220,260,480,61
BUSHENYI,2018,230,260,490,61
BUSHENYI,2019,230,260,490,61
BUSHENYI,2020,230,260,490,61
BUSHENYI,2021,230,260,490,61
BUSHENYI,2022,240,270,510,61
BUSHENYI,2023,240,270,510,61
BUSHENYI,2024,240,270,510,61
BUSHENYI,2025,240,270,510,61
BUSIA,2015,430,510,940,61
BUSIA,2016,420,470,890,61
BUSIA,2017,410,450,860,61
BUSIA,2018,430,460,890,61
BUSIA,2019,470,520,990,61
BUSIA,2020,530,610,1140,61
BUSIA,2021,620,710,1330,61
BUSIA,2022,680,800,1480,61
BUSIA,2023,730,860,1590,61
BUSIA,2024,750,860,1610,61
BUSIA,2025,760,840,1600,61
BUTALEJA,2015,390,410,800,61
BUTALEJA,2016,380,390,770,61
BUTALEJA,2017,370,370,740,61
BUTALEJA,2018,390,380,770,61
BUTALEJA,2019,440,440,880,61
BUTALEJA,2020,500,510,1010,61
BUTALEJA,2021,570,600,1170,61
BUTALEJA,2022,630,680,1310,61
BUTALEJA,2023,690,730,1420,61
BUTALEJA,2024,710,740,1450,61
BUTALEJA,2025,720,740,1460,61
BUTAMBALA,2015,100,130,230,61
BUTAMBALA,2016,100,130,230,61
BUTAMBALA,2017,100,120,220,61
BUTAMBALA,2018,100,120,220,61
BUTAMBALA,2019,110,130,240,61
BUTAMBALA,2020,120,150,270,61
BUTAMBALA,2021,130,170,300,61
BUTAMBALA,2022,140,190,330,61
BUTAMBALA,2023,150,190,340,61
BUTAMBALA,2024,150,190,340,61
BUTAMBALA,2025,140,180,320,61
BUTEBO,2015,140,160,300,61
BUTEBO,2016,130,160,290,61
BUTEBO,2017,120,150,270,61
BUTEBO,2018,130,150,280,61
BUTEBO,2019,150,160,310,61
BUTEBO,2020,160,180,340,61
BUTEBO,2021,180,210,390,61
BUTEBO,2022,190,230,420,61
BUTEBO,2023,200,240,440,61
BUTEBO,2024,200,250,450,61
BUTEBO,2025,220,240,460,61
BUVUMA,2015,80,40,120,61
BUVUMA,2016,90,40,130,61
BUVUMA,2017,90,40,130,61
BUVUMA,2018,100,40,140,61
BUVUMA,2019,100,50,150,61
BUVUMA,2020,110,50,160,61
BUVUMA,2021,120,50,170,61
BUVUMA,2022,120,60,180,61
BUVUMA,2023,130,60,190,61
BUVUMA,2024,140,60,200,61
BUVUMA,2025,140,70,210,61
BUYENDE,2015,310,350,660,61
BUYENDE,2016,300,330,630,61
BUYENDE,2017,300,320,620,61
BUYENDE,2018,330,330,660,61
BUYENDE,2019,360,390,750,61
BUYENDE,2020,410,460,870,61
BUYENDE,2021,470,540,1010,61
BUYENDE,2022,530,620,1150,61
BUYENDE,2023,580,660,1240,61
BUYENDE,2024,600,670,1270,61
BUYENDE,2025,610,680,1290,61
DOKOLO,2015,210,210,420,61
DOKOLO,2016,210,210,420,61
DOKOLO,2017,220,220,440,61
DOKOLO,2018,230,230,460,61
DOKOLO,2019,230,230,460,61
DOKOLO,2020,240,240,480,61
DOKOLO,2021,250,240,490,61
DOKOLO,2022,250,250,500,61
DOKOLO,2023,260,260,520,61
DOKOLO,2024,270,260,530,61
DOKOLO,2025,270,270,540,61
GOMBA,2015,240,290,530,61
GOMBA,2016,230,260,490,61
GOMBA,2017,220,240,460,61
GOMBA,2018,230,240,470,61
GOMBA,2019,240,280,520,61
GOMBA,2020,280,310,590,61
GOMBA,2021,310,360,670,61
GOMBA,2022,330,390,720,61
GOMBA,2023,360,410,770,61
GOMBA,2024,370,400,770,61
GOMBA,2025,360,400,760,61
GULU,2015,180,220,400,61
GULU,2016,180,220,400,61
GULU,2017,190,230,420,61
GULU,2018,190,240,430,61
GULU,2019,200,240,440,61
GULU,2020,210,250,460,61
GULU,2021,210,260,470,61
GULU,2022,220,260,480,61
GULU,2023,220,270,490,61
GULU,2024,230,280,510,61
GULU,2025,230,280,510,61
HOIMA,2015,250,330,580,61
HOIMA,2016,260,340,600,61
HOIMA,2017,270,350,620,61
HOIMA,2018,280,360,640,61
HOIMA,2019,290,370,660,61
HOIMA,2020,300,390,690,61
HOIMA,2021,310,400,710,61
HOIMA,2022,320,410,730,61
HOIMA,2023,340,420,760,61
HOIMA,2024,350,440,790,61
HOIMA,2025,360,450,810,61
IBANDA,2015,260,280,540,61
IBANDA,2016,260,290,550,61
IBANDA,2017,270,290,560,61
IBANDA,2018,270,300,570,61
IBANDA,2019,280,300,580,61
IBANDA,2020,280,310,590,61
IBANDA,2021,290,310,600,61
IBANDA,2022,290,320,610,61
IBANDA,2023,300,320,620,61
IBANDA,2024,300,330,630,61
IBANDA,2025,310,330,640,61
IGANGA,2015,240,350,590,61
IGANGA,2016,230,320,550,61
IGANGA,2017,220,310,530,61
IGANGA,2018,240,320,560,61
IGANGA,2019,270,350,620,61
IGANGA,2020,300,410,710,61
IGANGA,2021,340,490,830,61
IGANGA,2022,390,530,920,61
IGANGA,2023,400,580,980,61
IGANGA,2024,420,590,1010,61
IGANGA,2025,410,560,970,61
ISINGIRO,2015,430,500,930,61
ISINGIRO,2016,440,520,960,61
ISINGIRO,2017,460,530,990,61
ISINGIRO,2018,480,550,1030,61
ISINGIRO,2019,490,570,1060,61
ISINGIRO,2020,510,590,1100,61
ISINGIRO,2021,530,610,1140,61
ISINGIRO,2022,550,630,1180,61
ISINGIRO,2023,570,650,1220,61
ISINGIRO,2024,590,670,1260,61
ISINGIRO,2025,600,690,1290,61
JINJA,2015,300,370,670,61
JINJA,2016,310,370,680,61
JINJA,2017,310,380,690,61
JINJA,2018,320,390,710,61
JINJA,2019,320,390,710,61
JINJA,2020,330,400,730,61
JINJA,2021,330,400,730,61
JINJA,2022,340,410,750,61
JINJA,2023,340,410,750,61
JINJA,2024,350,420,770,61
JINJA,2025,350,420,770,61
KAABONG,2015,130,250,380,61
KAABONG,2016,130,260,390,61
KAABONG,2017,130,260,390,61
KAABONG,2018,140,270,410,61
KAABONG,2019,140,280,420,61
KAABONG,2020,140,280,420,61
KAABONG,2021,150,290,440,61
KAABONG,2022,150,290,440,61
KAABONG,2023,150,300,450,61
KAABONG,2024,160,310,470,61
KAABONG,2025,160,310,470,61
KABALE,2015,260,310,570,61
KABALE,2016,260,310,570,61
KABALE,2017,260,310,570,61
KABALE,2018,270,320,590,61
KABALE,2019,270,320,590,61
KABALE,2020,280,320,600,61
KABALE,2021,280,330,610,61
KABALE,2022,280,330,610,61
KABALE,2023,290,330,620,61
KABALE,2024,290,340,630,61
KABALE,2025,290,340,630,61
KABAROLE,2015,230,290,520,61
KABAROLE,2016,240,300,540,61
KABAROLE,2017,240,300,540,61
KABAROLE,2018,250,310,560,61
KABAROLE,2019,260,320,580,61
KABAROLE,2020,260,320,580,61
KABAROLE,2021,270,330,600,61
KABAROLE,2022,270,330,600,61
KABAROLE,2023,280,340,620,61
KABAROLE,2024,280,350,630,61
KABAROLE,2025,280,350,630,61
KABERAMAIDO,2015,80,130,210,61
KABERAMAIDO,2016,90,130,220,61
KABERAMAIDO,2017,90,120,210,61
KABERAMAIDO,2018,90,120,210,61
KABERAMAIDO,2019,110,150,260,61
KABERAMAIDO,2020,120,160,280,61
KABERAMAIDO,2021,130,190,320,61
KABERAMAIDO,2022,160,230,390,61
KABERAMAIDO,2023,160,240,400,61
KABERAMAIDO,2024,160,250,410,61
KABERAMAIDO,2025,180,240,420,61
KAGADI,2015,270,270,540,61
KAGADI,2016,280,280,560,61
KAGADI,2017,290,290,580,61
KAGADI,2018,300,300,600,61
KAGADI,2019,310,310,620,61
KAGADI,2020,320,320,640,61
KAGADI,2021,340,330,670,61
KAGADI,2022,350,340,690,61
KAGADI,2023,360,360,720,61
KAGADI,2024,370,370,740,61
KAGADI,2025,380,380,760,61
KAKUMIRO,2015,270,250,520,61
KAKUMIRO,2016,290,270,560,61
KAKUMIRO,2017,320,300,620,61
KAKUMIRO,2018,340,320,660,61
KAKUMIRO,2019,370,350,720,61
KAKUMIRO,2020,410,380,790,61
KAKUMIRO,2021,440,410,850,61
KAKUMIRO,2022,480,440,920,61
KAKUMIRO,2023,520,480,1000,61
KAKUMIRO,2024,560,510,1070,61
KAKUMIRO,2025,610,550,1160,61
KALAKI,2015,80,70,150,61
KALAKI,2016,80,80,160,61
KALAKI,2017,80,80,160,61
KALAKI,2018,90,80,170,61
KALAKI,2019,90,90,180,61
KALAKI,2020,90,90,180,61
KALAKI,2021,100,90,190,61
KALAKI,2022,100,100,200,61
KALAKI,2023,100,100,200,61
KALAKI,2024,110,100,210,61
KALAKI,2025,110,110,220,61
KALANGALA,2015,50,20,70,61
KALANGALA,2016,60,20,80,61
KALANGALA,2017,60,30,90,61
KALANGALA,2018,60,30,90,61
KALANGALA,2019,60,30,90,61
KALANGALA,2020,60,30,90,61
KALANGALA,2021,70,30,100,61
KALANGALA,2022,70,30,100,61
KALANGALA,2023,70,30,100,61
KALANGALA,2024,70,30,100,61
KALANGALA,2025,70,30,100,61
KALIRO,2015,270,320,590,61
KALIRO,2016,260,300,560,61
KALIRO,2017,260,290,550,61
KALIRO,2018,280,290,570,61
KALIRO,2019,300,330,630,61
KALIRO,2020,340,400,740,61
KALIRO,2021,390,470,860,61
KALIRO,2022,440,510,950,61
KALIRO,2023,470,560,1030,61
KALIRO,2024,480,570,1050,61
KALIRO,2025,490,560,1050,61
KALUNGU,2015,240,330,570,61
KALUNGU,2016,220,300,520,61
KALUNGU,2017,210,280,490,61
KALUNGU,2018,210,280,490,61
KALUNGU,2019,230,300,530,61
KALUNGU,2020,270,350,620,61
KALUNGU,2021,290,410,700,61
KALUNGU,2022,320,450,770,61
KALUNGU,2023,330,470,800,61
KALUNGU,2024,330,460,790,61
KALUNGU,2025,320,440,760,61
KAMPALA,2015,780,750,1530,61
KAMPALA,2016,800,770,1570,61
KAMPALA,2017,820,780,1600,61
KAMPALA,2018,830,800,1630,61
KAMPALA,2019,850,810,1660,61
KAMPALA,2020,860,830,1690,61
KAMPALA,2021,880,840,1720,61
KAMPALA,2022,890,860,1750,61
KAMPALA,2023,910,870,1780,61
KAMPALA,2024,920,880,1800,61
KAMPALA,2025,930,900,1830,61
KAMULI,2015,480,570,1050,61
KAMULI,2016,460,530,990,61
KAMULI,2017,450,500,950,61
KAMULI,2018,460,520,980,61
KAMULI,2019,510,580,1090,61
KAMULI,2020,580,660,1240,61
KAMULI,2021,650,770,1420,61
KAMULI,2022,720,860,1580,61
KAMULI,2023,760,920,1680,61
KAMULI,2024,790,930,1720,61
KAMULI,2025,780,880,1660,61
KAMWENGE,2015,230,210,440,61
KAMWENGE,2016,240,220,460,61
KAMWENGE,2017,250,230,480,61
KAMWENGE,2018,260,240,500,61
KAMWENGE,2019,270,240,510,61
KAMWENGE,2020,280,250,530,61
KAMWENGE,2021,290,260,550,61
KAMWENGE,2022,300,270,570,61
KAMWENGE,2023,310,280,590,61
KAMWENGE,2024,320,290,610,61
KAMWENGE,2025,330,300,630,61
KANUNGU,2015,250,260,510,61
KANUNGU,2016,250,260,510,61
KANUNGU,2017,260,270,530,61
KANUNGU,2018,260,270,530,61
KANUNGU,2019,270,280,550,61
KANUNGU,2020,270,280,550,61
KANUNGU,2021,280,290,570,61
KANUNGU,2022,280,290,570,61
KANUNGU,2023,280,290,570,61
KANUNGU,2024,290,300,590,61
KANUNGU,2025,290,300,590,61
KAPCHORWA,2015,100,100,200,61
KAPCHORWA,2016,100,100,200,61
KAPCHORWA,2017,110,100,210,61
KAPCHORWA,2018,110,100,210,61
KAPCHORWA,2019,110,110,220,61
KAPCHORWA,2020,120,110,230,61
KAPCHORWA,2021,120,110,230,61
KAPCHORWA,2022,120,120,240,61
KAPCHORWA,2023,130,120,250,61
KAPCHORWA,2024,130,120,250,61
KAPCHORWA,2025,130,120,250,61
KAPELEBYONG,2015,80,80,160,61
KAPELEBYONG,2016,80,70,150,61
KAPELEBYONG,2017,70,70,140,61
KAPELEBYONG,2018,80,70,150,61
KAPELEBYONG,2019,80,90,170,61
KAPELEBYONG,2020,100,100,200,61
KAPELEBYONG,2021,110,110,220,61
KAPELEBYONG,2022,120,120,240,61
KAPELEBYONG,2023,130,130,260,61
KAPELEBYONG,2024,130,130,260,61
KAPELEBYONG,2025,140,120,260,61
KASESE,2015,700,600,1300,61
KASESE,2016,670,560,1230,61
KASESE,2017,650,530,1180,61
KASESE,2018,680,540,1220,61
KASESE,2019,740,590,1330,61
KASESE,2020,830,690,1520,61
KASESE,2021,930,810,1740,61
KASESE,2022,1030,910,1940,61
KASESE,2023,1090,960,2050,61
KASESE,2024,1120,970,2090,61
KASESE,2025,1140,920,2060,61
KASSANDA,2015,250,250,500,61
KASSANDA,2016,260,250,510,61
KASSANDA,2017,270,260,530,61
KASSANDA,2018,280,260,540,61
KASSANDA,2019,280,270,550,61
KASSANDA,2020,290,270,560,61
KASSANDA,2021,300,280,580,61
KASSANDA,2022,310,280,590,61
KASSANDA,2023,320,290,610,61
KASSANDA,2024,320,290,610,61
KASSANDA,2025,330,300,630,61
KATAKWI,2015,170,190,360,61
KATAKWI,2016,160,170,330,61
KATAKWI,2017,160,170,330,61
KATAKWI,2018,160,170,330,61
KATAKWI,2019,190,190,380,61
KATAKWI,2020,210,230,440,61
KATAKWI,2021,230,260,490,61
KATAKWI,2022,260,290,550,61
KATAKWI,2023,270,320,590,61
KATAKWI,2024,290,320,610,61
KATAKWI,2025,290,300,590,61
KAYUNGA,2015,360,480,840,61
KAYUNGA,2016,350,430,780,61
KAYUNGA,2017,340,410,750,61
KAYUNGA,2018,350,410,760,61
KAYUNGA,2019,380,460,840,61
KAYUNGA,2020,430,530,960,61
KAYUNGA,2021,470,620,1090,61
KAYUNGA,2022,530,680,1210,61
KAYUNGA,2023,550,730,1280,61
KAYUNGA,2024,570,720,1290,61
KAYUNGA,2025,560,680,1240,61
KAZO,2015,210,170,380,61
KAZO,2016,210,170,380,61
KAZO,2017,220,180,400,61
KAZO,2018,230,190,420,61
KAZO,2019,240,190,430,61
KAZO,2020,250,200,450,61
KAZO,2021,260,210,470,61
KAZO,2022,260,210,470,61
KAZO,2023,270,220,490,61
KAZO,2024,280,230,510,61
KAZO,2025,290,230,520,61
KIBAALE,2015,100,120,220,61
KIBAALE,2016,110,130,240,61
KIBAALE,2017,120,130,250,61
KIBAALE,2018,130,140,270,61
KIBAALE,2019,130,150,280,61
KIBAALE,2020,140,160,300,61
KIBAALE,2021,150,170,320,61
KIBAALE,2022,160,180,340,61
KIBAALE,2023,170,190,360,61
KIBAALE,2024,180,200,380,61
KIBAALE,2025,190,210,400,61
KIBOGA,2015,180,190,370,61
KIBOGA,2016,180,190,370,61
KIBOGA,2017,170,170,340,61
KIBOGA,2018,180,170,350,61
KIBOGA,2019,200,200,400,61
KIBOGA,2020,220,230,450,61
KIBOGA,2021,240,260,500,61
KIBOGA,2022,280,290,570,61
KIBOGA,2023,290,320,610,61
KIBOGA,2024,310,320,630,61
KIBOGA,2025,310,300,610,61
KIBUKU,2015,270,270,540,61
KIBUKU,2016,260,260,520,61
KIBUKU,2017,260,250,510,61
KIBUKU,2018,280,250,530,61
KIBUKU,2019,310,290,600,61
KIBUKU,2020,360,350,710,61
KIBUKU,2021,390,390,780,61
KIBUKU,2022,440,450,890,61
KIBUKU,2023,470,490,960,61
KIBUKU,2024,490,510,1000,61
KIBUKU,2025,500,480,980,61
KIKUUBE,2015,250,190,440,61
KIKUUBE,2016,270,200,470,61
KIKUUBE,2017,280,210,490,61
KIKUUBE,2018,300,220,520,61
KIKUUBE,2019,310,230,540,61
KIKUUBE,2020,330,240,570,61
KIKUUBE,2021,340,260,600,61
KIKUUBE,2022,360,270,630,61
KIKUUBE,2023,380,280,660,61
KIKUUBE,2024,400,290,690,61
KIKUUBE,2025,420,310,730,61
KIRUHURA,2015,190,150,340,61
KIRUHURA,2016,190,160,350,61
KIRUHURA,2017,200,160,360,61
KIRUHURA,2018,210,170,380,61
KIRUHURA,2019,210,170,380,61
KIRUHURA,2020,220,180,400,61
KIRUHURA,2021,230,190,420,61
KIRUHURA,2022,240,190,430,61
KIRUHURA,2023,250,200,450,61
KIRUHURA,2024,260,200,460,61
KIRUHURA,2025,260,210,470,61
KIRYANDONGO,2015,280,290,570,61
KIRYANDONGO,2016,270,270,540,61
KIRYANDONGO,2017,260,250,510,61
KIRYANDONGO,2018,280,260,540,61
KIRYANDONGO,2019,310,290,600,61
KIRYANDONGO,2020,340,350,690,61
KIRYANDONGO,2021,390,390,780,61
KIRYANDONGO,2022,440,450,890,61
KIRYANDONGO,2023,460,470,930,61
KIRYANDONGO,2024,480,480,960,61
KIRYANDONGO,2025,490,460,950,61
KISORO,2015,280,350,630,61
KISORO,2016,270,330,600,61
KISORO,2017,260,310,570,61
KISORO,2018,280,320,600,61
KISORO,2019,300,350,650,61
KISORO,2020,330,410,740,61
KISORO,2021,380,470,850,61
KISORO,2022,400,510,910,61
KISORO,2023,440,560,1000,61
KISORO,2024,440,550,990,61
KISORO,2025,430,540,970,61
KITAGWENDA,2015,140,170,310,61
KITAGWENDA,2016,150,170,320,61
KITAGWENDA,2017,160,180,340,61
KITAGWENDA,2018,160,190,350,61
KITAGWENDA,2019,170,190,360,61
KITAGWENDA,2020,180,200,380,61
KITAGWENDA,2021,180,210,390,61
KITAGWENDA,2022,190,210,400,61
KITAGWENDA,2023,200,220,420,61
KITAGWENDA,2024,200,230,430,61
KITAGWENDA,2025,210,230,440,61
KITGUM,2015,280,320,600,61
KITGUM,2016,270,290,560,61
KITGUM,2017,260,270,530,61
KITGUM,2018,260,280,540,61
KITGUM,2019,300,300,600,61
KITGUM,2020,330,350,680,61
KITGUM,2021,360,410,770,61
KITGUM,2022,400,450,850,61
KITGUM,2023,420,470,890,61
KITGUM,2024,420,460,880,61
KITGUM,2025,430,460,890,61
KOBOKO,2015,200,160,360,61
KOBOKO,2016,180,140,320,61
KOBOKO,2017,190,150,340,61
KOBOKO,2018,200,150,350,61
KOBOKO,2019,220,160,380,61
KOBOKO,2020,250,200,450,61
KOBOKO,2021,280,230,510,61
KOBOKO,2022,320,270,590,61
KOBOKO,2023,350,280,630,61
KOBOKO,2024,350,290,640,61
KOBOKO,2025,360,280,640,61
KOLE,2015,190,180,370,61
KOLE,2016,190,180,370,61
KOLE,2017,200,190,390,61
KOLE,2018,200,190,390,61
KOLE,2019,210,200,410,61
KOLE,2020,220,210,430,61
KOLE,2021,220,210,430,61
KOLE,2022,230,220,450,61
KOLE,2023,240,220,460,61
KOLE,2024,240,230,470,61
KOLE,2025,250,230,480,61
KOTIDO,2015,170,210,380,61
KOTIDO,2016,160,190,350,61
KOTIDO,2017,150,190,340,61
KOTIDO,2018,160,190,350,61
KOTIDO,2019,170,200,370,61
KOTIDO,2020,190,250,440,61
KOTIDO,2021,210,280,490,61
KOTIDO,2022,250,310,560,61
KOTIDO,2023,250,340,590,61
KOTIDO,2024,260,340,600,61
KOTIDO,2025,270,320,590,61
KUMI,2015,310,380,690,61
KUMI,2016,290,340,630,61
KUMI,2017,290,330,620,61
KUMI,2018,300,340,640,61
KUMI,2019,340,380,720,61
KUMI,2020,370,450,820,61
KUMI,2021,420,530,950,61
KUMI,2022,470,580,1050,61
KUMI,2023,510,620,1130,61
KUMI,2024,510,630,1140,61
KUMI,2025,520,620,1140,61
KWANIA,2015,150,170,320,61
KWANIA,2016,160,170,330,61
KWANIA,2017,160,180,340,61
KWANIA,2018,170,180,350,61
KWANIA,2019,170,190,360,61
KWANIA,2020,180,190,370,61
KWANIA,2021,180,200,380,61
KWANIA,2022,190,200,390,61
KWANIA,2023,200,210,410,61
KWANIA,2024,200,210,410,61
KWANIA,2025,210,220,430,61
KWEEN,2015,80,80,160,61
KWEEN,2016,80,80,160,61
KWEEN,2017,80,90,170,61
KWEEN,2018,90,90,180,61
KWEEN,2019,90,90,180,61
KWEEN,2020,90,90,180,61
KWEEN,2021,90,100,190,61
KWEEN,2022,100,100,200,61
KWEEN,2023,100,100,200,61
KWEEN,2024,100,100,200,61
KWEEN,2025,100,100,200,61
KYANKWANZI,2015,140,140,280,61
KYANKWANZI,2016,150,150,300,61
KYANKWANZI,2017,160,150,310,61
KYANKWANZI,2018,170,160,330,61
KYANKWANZI,2019,170,170,340,61
KYANKWANZI,2020,180,170,350,61
KYANKWANZI,2021,190,180,370,61
KYANKWANZI,2022,200,190,390,61
KYANKWANZI,2023,210,200,410,61
KYANKWANZI,2024,220,210,430,61
KYANKWANZI,2025,230,220,450,61
KYEGEGWA,2015,190,180,370,61
KYEGEGWA,2016,200,200,400,61
KYEGEGWA,2017,220,210,430,61
KYEGEGWA,2018,240,230,470,61
KYEGEGWA,2019,260,250,510,61
KYEGEGWA,2020,280,270,550,61
KYEGEGWA,2021,300,290,590,61
KYEGEGWA,2022,330,310,640,61
KYEGEGWA,2023,350,330,680,61
KYEGEGWA,2024,380,360,740,61
KYEGEGWA,2025,410,380,790,61
KYENJOJO,2015,280,280,560,61
KYENJOJO,2016,290,300,590,61
KYENJOJO,2017,310,310,620,61
KYENJOJO,2018,320,320,640,61
KYENJOJO,2019,330,330,660,61
KYENJOJO,2020,340,340,680,61
KYENJOJO,2021,360,350,710,61
KYENJOJO,2022,370,360,730,61
KYENJOJO,2023,380,380,760,61
KYENJOJO,2024,400,390,790,61
KYENJOJO,2025,410,400,810,61
KYOTERA,2015,310,380,690,61
KYOTERA,2016,290,360,650,61
KYOTERA,2017,290,330,620,61
KYOTERA,2018,290,330,620,61
KYOTERA,2019,310,380,690,61
KYOTERA,2020,360,430,790,61
KYOTERA,2021,390,490,880,61
KYOTERA,2022,440,530,970,61
KYOTERA,2023,460,580,1040,61
KYOTERA,2024,460,570,1030,61
KYOTERA,2025,450,540,990,61
KARENGA,2015,60,60,120,61
KARENGA,2016,60,60,120,61
KARENGA,2017,60,60,120,61
KARENGA,2018,70,60,130,61
KARENGA,2019,70,60,130,61
KARENGA,2020,70,60,130,61
KARENGA,2021,70,70,140,61
KARENGA,2022,70,70,140,61
KARENGA,2023,80,70,150,61
KARENGA,2024,80,70,150,61
KARENGA,2025,80,70,150,61
LAMWO,2015,140,210,350,61
LAMWO,2016,130,190,320,61
LAMWO,2017,120,170,290,61
LAMWO,2018,130,170,300,61
LAMWO,2019,130,190,320,61
LAMWO,2020,150,230,380,61
LAMWO,2021,180,260,440,61
LAMWO,2022,190,290,480,61
LAMWO,2023,200,300,500,61
LAMWO,2024,200,290,490,61
LAMWO,2025,200,280,480,61
LIRA,2015,370,390,760,61
LIRA,2016,380,400,780,61
LIRA,2017,390,410,800,61
LIRA,2018,400,420,820,61
LIRA,2019,410,430,840,61
LIRA,2020,420,450,870,61
LIRA,2021,430,460,890,61
LIRA,2022,440,470,910,61
LIRA,2023,450,480,930,61
LIRA,2024,460,490,950,61
LIRA,2025,470,500,970,61
LUUKA,2015,240,300,540,61
LUUKA,2016,220,290,510,61
LUUKA,2017,210,270,480,61
LUUKA,2018,230,260,490,61
LUUKA,2019,240,300,540,61
LUUKA,2020,280,350,630,61
LUUKA,2021,310,390,700,61
LUUKA,2022,330,450,780,61
LUUKA,2023,360,470,830,61
LUUKA,2024,370,480,850,61
LUUKA,2025,360,460,820,61
LUWERO,2015,420,630,1050,61
LUWERO,2016,400,590,990,61
LUWERO,2017,390,560,950,61
LUWERO,2018,400,570,970,61
LUWERO,2019,440,640,1080,61
LUWERO,2020,500,740,1240,61
LUWERO,2021,570,860,1430,61
LUWERO,2022,610,970,1580,61
LUWERO,2023,660,1030,1690,61
LUWERO,2024,680,1030,1710,61
LUWERO,2025,690,980,1670,61
LWENGO,2015,360,520,880,61
LWENGO,2016,340,470,810,61
LWENGO,2017,320,440,760,61
LWENGO,2018,340,450,790,61
LWENGO,2019,360,490,850,61
LWENGO,2020,400,560,960,61
LWENGO,2021,440,640,1080,61
LWENGO,2022,490,720,1210,61
LWENGO,2023,510,750,1260,61
LWENGO,2024,510,740,1250,61
LWENGO,2025,500,700,1200,61
LYANTONDE,2015,130,100,230,61
LYANTONDE,2016,120,90,210,61
LYANTONDE,2017,110,80,190,61
LYANTONDE,2018,110,90,200,61
LYANTONDE,2019,130,100,230,61
LYANTONDE,2020,150,120,270,61
LYANTONDE,2021,160,130,290,61
LYANTONDE,2022,180,140,320,61
LYANTONDE,2023,200,150,350,61
LYANTONDE,2024,200,170,370,61
LYANTONDE,2025,200,160,360,61
MANAFWA,2015,220,240,460,61
MANAFWA,2016,220,240,460,61
MANAFWA,2017,230,250,480,61
MANAFWA,2018,230,260,490,61
MANAFWA,2019,240,260,500,61
MANAFWA,2020,250,270,520,61
MANAFWA,2021,250,270,520,61
MANAFWA,2022,260,280,540,61
MANAFWA,2023,260,280,540,61
MANAFWA,2024,270,290,560,61
MANAFWA,2025,270,290,560,61
MARACHA,2015,180,210,390,61
MARACHA,2016,190,220,410,61
MARACHA,2017,190,220,410,61
MARACHA,2018,190,230,420,61
MARACHA,2019,200,230,430,61
MARACHA,2020,200,230,430,61
MARACHA,2021,210,240,450,61
MARACHA,2022,210,240,450,61
MARACHA,2023,210,250,460,61
MARACHA,2024,220,250,470,61
MARACHA,2025,220,250,470,61
MASAKA,2015,400,500,900,61
MASAKA,2016,400,470,870,61
MASAKA,2017,390,450,840,61
MASAKA,2018,370,410,780,61
MASAKA,2019,360,390,750,61
MASAKA,2020,370,400,770,61
MASAKA,2021,410,440,850,61
MASAKA,2022,460,520,980,61
MASAKA,2023,510,590,1100,61
MASAKA,2024,570,670,1240,61
MASAKA,2025,600,720,1320,61
MASINDI,2015,250,240,490,61
MASINDI,2016,260,250,510,61
MASINDI,2017,270,260,530,61
MASINDI,2018,280,270,550,61
MASINDI,2019,290,270,560,61
MASINDI,2020,290,280,570,61
MASINDI,2021,300,290,590,61
MASINDI,2022,310,290,600,61
MASINDI,2023,320,300,620,61
MASINDI,2024,320,310,630,61
MASINDI,2025,330,310,640,61
MAYUGE,2015,420,520,940,61
MAYUGE,2016,400,500,900,61
MAYUGE,2017,400,480,880,61
MAYUGE,2018,410,490,900,61
MAYUGE,2019,460,550,1010,61
MAYUGE,2020,520,640,1160,61
MAYUGE,2021,590,750,1340,61
MAYUGE,2022,650,840,1490,61
MAYUGE,2023,690,900,1590,61
MAYUGE,2024,710,910,1620,61
MAYUGE,2025,720,880,1600,61
MBALE,2015,620,900,1520,61
MBALE,2016,590,830,1420,61
MBALE,2017,590,800,1390,61
MBALE,2018,600,820,1420,61
MBALE,2019,660,930,1590,61
MBALE,2020,760,1090,1850,61
MBALE,2021,850,1280,2130,61
MBALE,2022,950,1440,2390,61
MBALE,2023,1000,1560,2560,61
MBALE,2024,1040,1580,2620,61
MBALE,2025,1050,1540,2590,61
MBARARA,2015,250,320,570,61
MBARARA,2016,260,330,590,61
MBARARA,2017,260,340,600,61
MBARARA,2018,270,340,610,61
MBARARA,2019,270,350,620,61
MBARARA,2020,280,360,640,61
MBARARA,2021,280,370,650,61
MBARARA,2022,290,370,660,61
MBARARA,2023,300,380,680,61
MBARARA,2024,300,390,690,61
MBARARA,2025,310,390,700,61
MITOOMA,2015,150,210,360,61
MITOOMA,2016,150,210,360,61
MITOOMA,2017,160,210,370,61
MITOOMA,2018,160,210,370,61
MITOOMA,2019,160,210,370,61
MITOOMA,2020,160,220,380,61
MITOOMA,2021,160,220,380,61
MITOOMA,2022,160,220,380,61
MITOOMA,2023,170,220,390,61
MITOOMA,2024,170,220,390,61
MITOOMA,2025,170,220,390,61
MITYANA,2015,480,560,1040,61
MITYANA,2016,460,520,980,61
MITYANA,2017,450,490,940,61
MITYANA,2018,450,490,940,61
MITYANA,2019,500,550,1050,61
MITYANA,2020,560,630,1190,61
MITYANA,2021,620,730,1350,61
MITYANA,2022,680,800,1480,61
MITYANA,2023,710,860,1570,61
MITYANA,2024,730,840,1570,61
MITYANA,2025,740,820,1560,61
MOROTO,2015,140,240,380,61
MOROTO,2016,130,220,350,61
MOROTO,2017,120,200,320,61
MOROTO,2018,130,210,340,61
MOROTO,2019,130,230,360,61
MOROTO,2020,160,260,420,61
MOROTO,2021,180,320,500,61
MOROTO,2022,190,350,540,61
MOROTO,2023,200,380,580,61
MOROTO,2024,220,380,600,61
MOROTO,2025,220,360,580,61
MOYO,2015,120,160,280,61
MOYO,2016,130,160,290,61
MOYO,2017,130,160,290,61
MOYO,2018,130,170,300,61
MOYO,2019,140,170,310,61
MOYO,2020,140,170,310,61
MOYO,2021,140,180,320,61
MOYO,2022,140,180,320,61
MOYO,2023,150,180,330,61
MOYO,2024,150,190,340,61
MOYO,2025,150,190,340,61
MPIGI,2015,290,380,670,61
MPIGI,2016,270,360,630,61
MPIGI,2017,270,330,600,61
MPIGI,2018,280,340,620,61
MPIGI,2019,310,390,700,61
MPIGI,2020,340,450,790,61
MPIGI,2021,390,530,920,61
MPIGI,2022,420,580,1000,61
MPIGI,2023,460,620,1080,61
MPIGI,2024,460,610,1070,61
MPIGI,2025,470,600,1070,61
MUBENDE,2015,500,510,1010,61
MUBENDE,2016,500,470,970,61
MUBENDE,2017,500,460,960,61
MUBENDE,2018,540,490,1030,61
MUBENDE,2019,600,570,1170,61
MUBENDE,2020,700,680,1380,61
MUBENDE,2021,820,810,1630,61
MUBENDE,2022,910,930,1840,61
MUBENDE,2023,1000,1010,2010,61
MUBENDE,2024,1040,1030,2070,61
MUBENDE,2025,1080,1020,2100,61
MUKONO,2015,620,750,1370,61
MUKONO,2016,600,690,1290,61
MUKONO,2017,590,660,1250,61
MUKONO,2018,600,680,1280,61
MUKONO,2019,660,770,1430,61
MUKONO,2020,760,890,1650,61
MUKONO,2021,850,1050,1900,61
MUKONO,2022,930,1170,2100,61
MUKONO,2023,1000,1260,2260,61
MUKONO,2024,1030,1260,2290,61
MUKONO,2025,1030,1240,2270,61
NABILATUK,2015,70,170,240,61
NABILATUK,2016,80,170,250,61
NABILATUK,2017,70,170,240,61
NABILATUK,2018,80,170,250,61
NABILATUK,2019,80,200,280,61
NABILATUK,2020,100,230,330,61
NABILATUK,2021,110,280,390,61
NABILATUK,2022,140,330,470,61
NABILATUK,2023,150,340,490,61
NABILATUK,2024,150,360,510,61
NABILATUK,2025,160,360,520,61
NAKAPIRIPIRIT,2015,200,330,530,61
NAKAPIRIPIRIT,2016,180,320,500,61
NAKAPIRIPIRIT,2017,190,310,500,61
NAKAPIRIPIRIT,2018,200,320,520,61
NAKAPIRIPIRIT,2019,220,360,580,61
NAKAPIRIPIRIT,2020,250,430,680,61
NAKAPIRIPIRIT,2021,290,510,800,61
NAKAPIRIPIRIT,2022,320,600,920,61
NAKAPIRIPIRIT,2023,350,640,990,61
NAKAPIRIPIRIT,2024,370,650,1020,61
NAKAPIRIPIRIT,2025,380,640,1020,61
NAKASEKE,2015,180,180,360,61
NAKASEKE,2016,190,180,370,61
NAKASEKE,2017,200,190,390,61
NAKASEKE,2018,210,190,400,61
NAKASEKE,2019,210,200,410,61
NAKASEKE,2020,220,200,420,61
NAKASEKE,2021,230,200,430,61
NAKASEKE,2022,240,210,450,61
NAKASEKE,2023,240,210,450,61
NAKASEKE,2024,250,220,470,61
NAKASEKE,2025,260,220,480,61
NAKASONGOLA,2015,180,240,420,61
NAKASONGOLA,2016,180,230,410,61
NAKASONGOLA,2017,170,210,380,61
NAKASONGOLA,2018,190,210,400,61
NAKASONGOLA,2019,200,250,450,61
NAKASONGOLA,2020,240,280,520,61
NAKASONGOLA,2021,260,340,600,61
NAKASONGOLA,2022,300,370,670,61
NAKASONGOLA,2023,310,380,690,61
NAKASONGOLA,2024,310,400,710,61
NAKASONGOLA,2025,320,380,700,61
NAMAYINGO,2015,200,250,450,61
NAMAYINGO,2016,200,240,440,61
NAMAYINGO,2017,190,230,420,61
NAMAYINGO,2018,190,230,420,61
NAMAYINGO,2019,200,250,450,61
NAMAYINGO,2020,240,300,540,61
NAMAYINGO,2021,260,340,600,61
NAMAYINGO,2022,280,370,650,61
NAMAYINGO,2023,310,380,690,61
NAMAYINGO,2024,310,400,710,61
NAMAYINGO,2025,310,380,690,61
NAMISINDWA,2015,240,270,510,61
NAMISINDWA,2016,250,280,530,61
NAMISINDWA,2017,250,280,530,61
NAMISINDWA,2018,260,290,550,61
NAMISINDWA,2019,270,300,570,61
NAMISINDWA,2020,270,300,570,61
NAMISINDWA,2021,280,310,590,61
NAMISINDWA,2022,290,320,610,61
NAMISINDWA,2023,290,320,610,61
NAMISINDWA,2024,300,330,630,61
NAMISINDWA,2025,310,340,650,61
NAMUTUMBA,2015,340,350,690,61
NAMUTUMBA,2016,310,330,640,61
NAMUTUMBA,2017,310,320,630,61
NAMUTUMBA,2018,330,330,660,61
NAMUTUMBA,2019,360,360,720,61
NAMUTUMBA,2020,410,430,840,61
NAMUTUMBA,2021,470,510,980,61
NAMUTUMBA,2022,530,580,1110,61
NAMUTUMBA,2023,560,620,1180,61
NAMUTUMBA,2024,590,630,1220,61
NAMUTUMBA,2025,590,600,1190,61
NAPAK,2015,240,520,760,61
NAPAK,2016,230,490,720,61
NAPAK,2017,220,450,670,61
NAPAK,2018,230,460,690,61
NAPAK,2019,260,520,780,61
NAPAK,2020,280,590,870,61
NAPAK,2021,310,690,1000,61
NAPAK,2022,350,780,1130,61
NAPAK,2023,360,810,1170,61
NAPAK,2024,370,820,1190,61
NAPAK,2025,360,800,1160,61
NEBBI,2015,200,280,480,61
NEBBI,2016,210,290,500,61
NEBBI,2017,220,300,520,61
NEBBI,2018,230,310,540,61
NEBBI,2019,230,320,550,61
NEBBI,2020,240,320,560,61
NEBBI,2021,250,330,580,61
NEBBI,2022,250,340,590,61
NEBBI,2023,260,350,610,61
NEBBI,2024,270,360,630,61
NEBBI,2025,270,370,640,61
NGORA,2015,180,210,390,61
NGORA,2016,170,190,360,61
NGORA,2017,160,190,350,61
NGORA,2018,180,190,370,61
NGORA,2019,190,220,410,61
NGORA,2020,220,250,470,61
NGORA,2021,240,280,520,61
NGORA,2022,260,330,590,61
NGORA,2023,290,340,630,61
NGORA,2024,290,340,630,61
NGORA,2025,310,340,650,61
NTOROKO,2015,80,80,160,61
NTOROKO,2016,80,70,150,61
NTOROKO,2017,70,70,140,61
NTOROKO,2018,80,70,150,61
NTOROKO,2019,90,70,160,61
NTOROKO,2020,100,80,180,61
NTOROKO,2021,110,90,200,61
NTOROKO,2022,120,100,220,61
NTOROKO,2023,130,110,240,61
NTOROKO,2024,130,110,240,61
NTOROKO,2025,130,120,250,61
NTUNGAMO,2015,460,490,950,61
NTUNGAMO,2016,470,500,970,61
NTUNGAMO,2017,480,510,990,61
NTUNGAMO,2018,490,520,1010,61
NTUNGAMO,2019,500,530,1030,61
NTUNGAMO,2020,510,530,1040,61
NTUNGAMO,2021,520,540,1060,61
NTUNGAMO,2022,530,550,1080,61
NTUNGAMO,2023,540,560,1100,61
NTUNGAMO,2024,550,570,1120,61
NTUNGAMO,2025,550,580,1130,61
NWOYA,2015,120,160,280,61
NWOYA,2016,130,170,300,61
NWOYA,2017,140,190,330,61
NWOYA,2018,160,210,370,61
NWOYA,2019,170,230,400,61
NWOYA,2020,190,250,440,61
NWOYA,2021,210,280,490,61
NWOYA,2022,230,310,540,61
NWOYA,2023,250,340,590,61
NWOYA,2024,280,370,650,61
NWOYA,2025,310,400,710,61
OBONGI,2015,60,50,110,61
OBONGI,2016,50,40,90,61
OBONGI,2017,50,40,90,61
OBONGI,2018,50,40,90,61
OBONGI,2019,50,40,90,61
OBONGI,2020,60,50,110,61
OBONGI,2021,70,60,130,61
OBONGI,2022,70,60,130,61
OBONGI,2023,90,60,150,61
OBONGI,2024,90,60,150,61
OBONGI,2025,90,60,150,61
OMORO,2015,150,240,390,61
OMORO,2016,140,230,370,61
OMORO,2017,150,210,360,61
OMORO,2018,150,230,380,61
OMORO,2019,170,250,420,61
OMORO,2020,190,300,490,61
OMORO,2021,230,340,570,61
OMORO,2022,250,390,640,61
OMORO,2023,270,410,680,61
OMORO,2024,270,420,690,61
OMORO,2025,270,420,690,61
OTUKE,2015,120,90,210,61
OTUKE,2016,120,90,210,61
OTUKE,2017,130,90,220,61
OTUKE,2018,130,100,230,61
OTUKE,2019,140,100,240,61
OTUKE,2020,140,110,250,61
OTUKE,2021,150,110,260,61
OTUKE,2022,160,110,270,61
OTUKE,2023,160,120,280,61
OTUKE,2024,170,120,290,61
OTUKE,2025,180,130,310,61
OYAM,2015,380,430,810,61
OYAM,2016,390,440,830,61
OYAM,2017,400,460,860,61
OYAM,2018,410,470,880,61
OYAM,2019,420,480,900,61
OYAM,2020,440,490,930,61
OYAM,2021,450,510,960,61
OYAM,2022,460,520,980,61
OYAM,2023,470,540,1010,61
OYAM,2024,490,550,1040,61
OYAM,2025,500,560,1060,61
PADER,2015,150,170,320,61
PADER,2016,140,170,310,61
PADER,2017,150,160,310,61
PADER,2018,150,160,310,61
PADER,2019,160,170,330,61
PADER,2020,180,200,380,61
PADER,2021,200,240,440,61
PADER,2022,230,270,500,61
PADER,2023,240,280,520,61
PADER,2024,240,270,510,61
PADER,2025,230,260,490,61
PAKWACH,2015,140,160,300,61
PAKWACH,2016,150,160,310,61
PAKWACH,2017,150,170,320,61
PAKWACH,2018,160,180,340,61
PAKWACH,2019,160,180,340,61
PAKWACH,2020,170,190,360,61
PAKWACH,2021,180,190,370,61
PAKWACH,2022,180,200,380,61
PAKWACH,2023,190,210,400,61
PAKWACH,2024,200,210,410,61
PAKWACH,2025,210,220,430,61
PALLISA,2015,350,360,710,61
PALLISA,2016,350,340,690,61
PALLISA,2017,350,330,680,61
PALLISA,2018,360,340,700,61
PALLISA,2019,400,390,790,61
PALLISA,2020,470,480,950,61
PALLISA,2021,540,560,1100,61
PALLISA,2022,600,640,1240,61
PALLISA,2023,660,680,1340,61
PALLISA,2024,680,700,1380,61
PALLISA,2025,700,700,1400,61
RAKAI,2015,320,400,720,61
RAKAI,2016,300,360,660,61
RAKAI,2017,300,340,640,61
RAKAI,2018,310,340,650,61
RAKAI,2019,340,390,730,61
RAKAI,2020,390,460,850,61
RAKAI,2021,440,530,970,61
RAKAI,2022,470,600,1070,61
RAKAI,2023,510,620,1130,61
RAKAI,2024,510,630,1140,61
RAKAI,2025,520,600,1120,61
RUBANDA,2015,170,210,380,61
RUBANDA,2016,180,210,390,61
RUBANDA,2017,180,210,390,61
RUBANDA,2018,180,210,390,61
RUBANDA,2019,180,210,390,61
RUBANDA,2020,180,210,390,61
RUBANDA,2021,190,210,400,61
RUBANDA,2022,190,220,410,61
RUBANDA,2023,190,220,410,61
RUBANDA,2024,190,220,410,61
RUBANDA,2025,190,220,410,61
RUBIRIZI,2015,110,140,250,61
RUBIRIZI,2016,110,140,250,61
RUBIRIZI,2017,120,150,270,61
RUBIRIZI,2018,120,150,270,61
RUBIRIZI,2019,120,150,270,61
RUBIRIZI,2020,120,150,270,61
RUBIRIZI,2021,120,160,280,61
RUBIRIZI,2022,130,160,290,61
RUBIRIZI,2023,130,160,290,61
RUBIRIZI,2024,130,160,290,61
RUBIRIZI,2025,130,170,300,61
RUKIGA,2015,160,150,310,61
RUKIGA,2016,160,150,310,61
RUKIGA,2017,160,150,310,61
RUKIGA,2018,160,150,310,61
RUKIGA,2019,160,150,310,61
RUKIGA,2020,160,160,320,61
RUKIGA,2021,160,160,320,61
RUKIGA,2022,170,160,330,61
RUKIGA,2023,170,160,330,61
RUKIGA,2024,170,160,330,61
RUKIGA,2025,170,160,330,61
RUKUNGIRI,2015,360,460,820,61
RUKUNGIRI,2016,370,460,830,61
RUKUNGIRI,2017,370,470,840,61
RUKUNGIRI,2018,370,470,840,61
RUKUNGIRI,2019,380,480,860,61
RUKUNGIRI,2020,380,480,860,61
RUKUNGIRI,2021,390,480,870,61
RUKUNGIRI,2022,390,490,880,61
RUKUNGIRI,2023,390,490,880,61
RUKUNGIRI,2024,400,490,890,61
RUKUNGIRI,2025,400,500,900,61
RWAMPARA,2015,110,130,240,61
RWAMPARA,2016,120,140,260,61
RWAMPARA,2017,120,140,260,61
RWAMPARA,2018,120,140,260,61
RWAMPARA,2019,120,150,270,61
RWAMPARA,2020,130,150,280,61
RWAMPARA,2021,130,150,280,61
RWAMPARA,2022,130,150,280,61
RWAMPARA,2023,130,160,290,61
RWAMPARA,2024,140,160,300,61
RWAMPARA,2025,140,160,300,61
SERERE,2015,320,350,670,61
SERERE,2016,310,330,640,61
SERERE,2017,310,320,630,61
SERERE,2018,330,330,660,61
SERERE,2019,360,380,740,61
SERERE,2020,410,450,860,61
SERERE,2021,470,530,1000,61
SERERE,2022,530,600,1130,61
SERERE,2023,580,640,1220,61
SERERE,2024,600,650,1250,61
SERERE,2025,610,640,1250,61
SHEEMA,2015,190,230,420,61
SHEEMA,2016,190,230,420,61
SHEEMA,2017,200,230,430,61
SHEEMA,2018,200,240,440,61
SHEEMA,2019,200,240,440,61
SHEEMA,2020,200,240,440,61
SHEEMA,2021,200,240,440,61
SHEEMA,2022,210,240,450,61
SHEEMA,2023,210,250,460,61
SHEEMA,2024,210,250,460,61
SHEEMA,2025,210,250,460,61
SIRONKO,2015,320,320,640,61
SIRONKO,2016,330,330,660,61
SIRONKO,2017,340,340,680,61
SIRONKO,2018,350,350,700,61
SIRONKO,2019,360,350,710,61
SIRONKO,2020,360,360,720,61
SIRONKO,2021,370,360,730,61
SIRONKO,2022,380,370,750,61
SIRONKO,2023,390,380,770,61
SIRONKO,2024,390,380,770,61
SIRONKO,2025,400,390,790,61
SOROTI,2015,320,320,640,61
SOROTI,2016,310,290,600,61
SOROTI,2017,310,280,590,61
SOROTI,2018,330,290,620,61
SOROTI,2019,360,320,680,61
SOROTI,2020,410,380,790,61
SOROTI,2021,470,450,920,61
SOROTI,2022,530,510,1040,61
SOROTI,2023,560,560,1120,61
SOROTI,2024,590,550,1140,61
SOROTI,2025,590,540,1130,61
SSEMBABULE,2015,360,410,770,61
SSEMBABULE,2016,350,390,740,61
SSEMBABULE,2017,340,370,710,61
SSEMBABULE,2018,350,370,720,61
SSEMBABULE,2019,390,420,810,61
SSEMBABULE,2020,440,490,930,61
SSEMBABULE,2021,510,580,1090,61
SSEMBABULE,2022,560,640,1200,61
SSEMBABULE,2023,580,680,1260,61
SSEMBABULE,2024,600,700,1300,61
SSEMBABULE,2025,610,660,1270,61
TORORO,2015,650,770,1420,61
TORORO,2016,660,780,1440,61
TORORO,2017,680,800,1480,61
TORORO,2018,700,820,1520,61
TORORO,2019,720,840,1560,61
TORORO,2020,730,860,1590,61
TORORO,2021,750,880,1630,61
TORORO,2022,770,900,1670,61
TORORO,2023,790,920,1710,61
TORORO,2024,800,940,1740,61
TORORO,2025,820,960,1780,61
WAKISO,2015,1020,1210,2230,61
WAKISO,2016,1090,1290,2380,61
WAKISO,2017,1160,1380,2540,61
WAKISO,2018,1240,1470,2710,61
WAKISO,2019,1320,1570,2890,61
WAKISO,2020,1410,1680,3090,61
WAKISO,2021,1500,1790,3290,61
WAKISO,2022,1590,1910,3500,61
WAKISO,2023,1690,2030,3720,61
WAKISO,2024,1800,2160,3960,61
WAKISO,2025,1910,2300,4210,61
YUMBE,2015,340,290,630,61
YUMBE,2016,340,270,610,61
YUMBE,2017,340,270,610,61
YUMBE,2018,350,280,630,61
YUMBE,2019,400,330,730,61
YUMBE,2020,460,400,860,61
YUMBE,2021,540,470,1010,61
YUMBE,2022,610,560,1170,61
YUMBE,2023,660,600,1260,61
YUMBE,2024,700,630,1330,61
YUMBE,2025,720,620,1340,61
ZOMBO,2015,150,170,320,61
ZOMBO,2016,160,180,340,61
ZOMBO,2017,160,180,340,61
ZOMBO,2018,170,190,360,61
ZOMBO,2019,170,190,360,61
ZOMBO,2020,180,200,380,61
ZOMBO,2021,180,200,380,61
ZOMBO,2022,190,210,400,61
ZOMBO,2023,190,210,400,61
ZOMBO,2024,200,220,420,61
ZOMBO,2025,200,220,420,61
MADI OKOLLO,2015,160,130,290,61
MADI OKOLLO,2016,160,130,290,61
MADI OKOLLO,2017,170,140,310,61
MADI OKOLLO,2018,170,140,310,61
MADI OKOLLO,2019,180,140,320,61
MADI OKOLLO,2020,180,150,330,61
MADI OKOLLO,2021,190,150,340,61
MADI OKOLLO,2022,190,150,340,61
MADI OKOLLO,2023,200,160,360,61
MADI OKOLLO,2024,200,160,360,61
MADI OKOLLO,2025,210,160,370,61
ABIM,2015,90,90,180,62
ABIM,2016,90,100,190,62
ABIM,2017,90,90,180,62
ABIM,2018,90,90,180,62
ABIM,2019,100,90,190,62
ABIM,2020,110,110,220,62
ABIM,2021,130,120,250,62
ABIM,2022,160,150,310,62
ABIM,2023,180,180,360,62
ABIM,2024,190,200,390,62
ABIM,2025,200,200,400,62
ADJUMANI,2015,260,290,550,62
ADJUMANI,2016,260,290,550,62
ADJUMANI,2017,260,290,550,62
ADJUMANI,2018,260,290,550,62
ADJUMANI,2019,260,300,560,62
ADJUMANI,2020,270,300,570,62
ADJUMANI,2021,270,300,570,62
ADJUMANI,2022,270,300,570,62
ADJUMANI,2023,270,310,580,62
ADJUMANI,2024,270,310,580,62
ADJUMANI,2025,270,310,580,62
AGAGO,2015,300,250,550,62
AGAGO,2016,310,260,570,62
AGAGO,2017,310,260,570,62
AGAGO,2018,320,270,590,62
AGAGO,2019,320,270,590,62
AGAGO,2020,330,270,600,62
AGAGO,2021,330,280,610,62
AGAGO,2022,340,280,620,62
AGAGO,2023,340,290,630,62
AGAGO,2024,350,290,640,62
AGAGO,2025,350,290,640,62
ALEBTONG,2015,370,420,790,62
ALEBTONG,2016,360,380,740,62
ALEBTONG,2017,340,360,700,62
ALEBTONG,2018,340,340,680,62
ALEBTONG,2019,350,350,700,62
ALEBTONG,2020,390,390,780,62
ALEBTONG,2021,440,460,900,62
ALEBTONG,2022,490,530,1020,62
ALEBTONG,2023,550,600,1150,62
ALEBTONG,2024,590,640,1230,62
ALEBTONG,2025,600,640,1240,62
AMOLATAR,2015,220,240,460,62
AMOLATAR,2016,210,230,440,62
AMOLATAR,2017,200,210,410,62
AMOLATAR,2018,200,210,410,62
AMOLATAR,2019,200,210,410,62
AMOLATAR,2020,220,230,450,62
AMOLATAR,2021,260,270,530,62
AMOLATAR,2022,280,320,600,62
AMOLATAR,2023,320,360,680,62
AMOLATAR,2024,330,380,710,62
AMOLATAR,2025,340,390,730,62
AMUDAT,2015,90,120,210,62
AMUDAT,2016,100,110,210,62
AMUDAT,2017,90,110,200,62
AMUDAT,2018,100,100,200,62
AMUDAT,2019,100,110,210,62
AMUDAT,2020,110,120,230,62
AMUDAT,2021,120,140,260,62
AMUDAT,2022,150,170,320,62
AMUDAT,2023,160,190,350,62
AMUDAT,2024,180,200,380,62
AMUDAT,2025,180,210,390,62
AMURIA,2015,170,240,410,62
AMURIA,2016,170,230,400,62
AMURIA,2017,170,220,390,62
AMURIA,2018,170,210,380,62
AMURIA,2019,170,210,380,62
AMURIA,2020,190,240,430,62
AMURIA,2021,220,290,510,62
AMURIA,2022,250,340,590,62
AMURIA,2023,280,390,670,62
AMURIA,2024,290,420,710,62
AMURIA,2025,310,420,730,62
AMURU,2015,230,300,530,62
AMURU,2016,220,280,500,62
AMURU,2017,210,260,470,62
AMURU,2018,210,250,460,62
AMURU,2019,220,250,470,62
AMURU,2020,230,280,510,62
AMURU,2021,270,330,600,62
AMURU,2022,300,380,680,62
AMURU,2023,330,430,760,62
AMURU,2024,350,460,810,62
AMURU,2025,370,470,840,62
APAC,2015,270,250,520,62
APAC,2016,280,260,540,62
APAC,2017,290,270,560,62
APAC,2018,300,270,570,62
APAC,2019,310,280,590,62
APAC,2020,320,290,610,62
APAC,2021,330,300,630,62
APAC,2022,340,310,650,62
APAC,2023,350,320,670,62
APAC,2024,360,330,690,62
APAC,2025,370,340,710,62
ARUA,2015,950,980,1930,62
ARUA,2016,970,1000,1970,62
ARUA,2017,1000,1030,2030,62
ARUA,2018,1030,1060,2090,62
ARUA,2019,1060,1090,2150,62
ARUA,2020,1090,1120,2210,62
ARUA,2021,1120,1140,2260,62
ARUA,2022,1140,1170,2310,62
ARUA,2023,1170,1200,2370,62
ARUA,2024,1200,1230,2430,62
ARUA,2025,1230,1250,2480,62
BUDAKA,2015,260,280,540,62
BUDAKA,2016,250,270,520,62
BUDAKA,2017,250,250,500,62
BUDAKA,2018,250,230,480,62
BUDAKA,2019,260,240,500,62
BUDAKA,2020,280,270,550,62
BUDAKA,2021,320,320,640,62
BUDAKA,2022,370,380,750,62
BUDAKA,2023,410,430,840,62
BUDAKA,2024,430,460,890,62
BUDAKA,2025,460,470,930,62
BUDUDA,2015,300,380,680,62
BUDUDA,2016,300,360,660,62
BUDUDA,2017,300,350,650,62
BUDUDA,2018,290,330,620,62
BUDUDA,2019,310,350,660,62
BUDUDA,2020,350,400,750,62
BUDUDA,2021,400,470,870,62
BUDUDA,2022,460,560,1020,62
BUDUDA,2023,520,640,1160,62
BUDUDA,2024,560,700,1260,62
BUDUDA,2025,590,720,1310,62
BUGIRI,2015,430,570,1000,62
BUGIRI,2016,420,540,960,62
BUGIRI,2017,410,510,920,62
BUGIRI,2018,410,490,900,62
BUGIRI,2019,430,510,940,62
BUGIRI,2020,470,580,1050,62
BUGIRI,2021,540,680,1220,62
BUGIRI,2022,620,800,1420,62
BUGIRI,2023,700,920,1620,62
BUGIRI,2024,750,990,1740,62
BUGIRI,2025,780,1000,1780,62
BUGWERI,2015,180,220,400,62
BUGWERI,2016,170,210,380,62
BUGWERI,2017,170,190,360,62
BUGWERI,2018,160,190,350,62
BUGWERI,2019,170,190,360,62
BUGWERI,2020,180,220,400,62
BUGWERI,2021,210,250,460,62
BUGWERI,2022,230,290,520,62
BUGWERI,2023,260,320,580,62
BUGWERI,2024,280,350,630,62
BUGWERI,2025,280,340,620,62
BUHWEJU,2015,160,150,310,62
BUHWEJU,2016,160,150,310,62
BUHWEJU,2017,170,160,330,62
BUHWEJU,2018,180,160,340,62
BUHWEJU,2019,180,170,350,62
BUHWEJU,2020,190,170,360,62
BUHWEJU,2021,190,180,370,62
BUHWEJU,2022,200,180,380,62
BUHWEJU,2023,200,190,390,62
BUHWEJU,2024,210,190,400,62
BUHWEJU,2025,210,200,410,62
BUIKWE,2015,500,590,1090,62
BUIKWE,2016,480,560,1040,62
BUIKWE,2017,470,510,980,62
BUIKWE,2018,450,480,930,62
BUIKWE,2019,470,490,960,62
BUIKWE,2020,510,550,1060,62
BUIKWE,2021,570,640,1210,62
BUIKWE,2022,640,740,1380,62
BUIKWE,2023,700,820,1520,62
BUIKWE,2024,740,870,1610,62
BUIKWE,2025,750,870,1620,62
BUKEDEA,2015,250,330,580,62
BUKEDEA,2016,240,310,550,62
BUKEDEA,2017,230,300,530,62
BUKEDEA,2018,230,290,520,62
BUKEDEA,2019,240,300,540,62
BUKEDEA,2020,280,330,610,62
BUKEDEA,2021,310,400,710,62
BUKEDEA,2022,370,470,840,62
BUKEDEA,2023,410,530,940,62
BUKEDEA,2024,430,580,1010,62
BUKEDEA,2025,460,590,1050,62
BUKOMANSIMBI,2015,240,310,550,62
BUKOMANSIMBI,2016,220,290,510,62
BUKOMANSIMBI,2017,210,260,470,62
BUKOMANSIMBI,2018,200,240,440,62
BUKOMANSIMBI,2019,210,240,450,62
BUKOMANSIMBI,2020,220,260,480,62
BUKOMANSIMBI,2021,250,300,550,62
BUKOMANSIMBI,2022,270,340,610,62
BUKOMANSIMBI,2023,290,380,670,62
BUKOMANSIMBI,2024,310,390,700,62
BUKOMANSIMBI,2025,310,390,700,62
BUKWO,2015,100,110,210,62
BUKWO,2016,110,110,220,62
BUKWO,2017,110,120,230,62
BUKWO,2018,120,130,250,62
BUKWO,2019,130,130,260,62
BUKWO,2020,130,140,270,62
BUKWO,2021,140,140,280,62
BUKWO,2022,150,150,300,62
BUKWO,2023,150,160,310,62
BUKWO,2024,160,170,330,62
BUKWO,2025,170,170,340,62
BULAMBULI,2015,300,430,730,62
BULAMBULI,2016,290,420,710,62
BULAMBULI,2017,290,400,690,62
BULAMBULI,2018,290,380,670,62
BULAMBULI,2019,310,400,710,62
BULAMBULI,2020,340,460,800,62
BULAMBULI,2021,400,550,950,62
BULAMBULI,2022,460,650,1110,62
BULAMBULI,2023,530,740,1270,62
BULAMBULI,2024,580,810,1390,62
BULAMBULI,2025,600,830,1430,62
BULIISA,2015,140,140,280,62
BULIISA,2016,150,150,300,62
BULIISA,2017,160,160,320,62
BULIISA,2018,170,160,330,62
BULIISA,2019,180,170,350,62
BULIISA,2020,180,180,360,62
BULIISA,2021,190,180,370,62
BULIISA,2022,200,190,390,62
BULIISA,2023,210,200,410,62
BULIISA,2024,220,210,430,62
BULIISA,2025,240,220,460,62
BUNDIBUGYO,2015,270,240,510,62
BUNDIBUGYO,2016,260,230,490,62
BUNDIBUGYO,2017,250,210,460,62
BUNDIBUGYO,2018,250,210,460,62
BUNDIBUGYO,2019,260,210,470,62
BUNDIBUGYO,2020,280,230,510,62
BUNDIBUGYO,2021,310,280,590,62
BUNDIBUGYO,2022,360,320,680,62
BUNDIBUGYO,2023,390,360,750,62
BUNDIBUGYO,2024,420,380,800,62
BUNDIBUGYO,2025,440,390,830,62
BUNYANGABU,2015,210,300,510,62
BUNYANGABU,2016,200,290,490,62
BUNYANGABU,2017,190,260,450,62
BUNYANGABU,2018,180,250,430,62
BUNYANGABU,2019,190,250,440,62
BUNYANGABU,2020,220,280,500,62
BUNYANGABU,2021,240,330,570,62
BUNYANGABU,2022,270,380,650,62
BUNYANGABU,2023,290,430,720,62
BUNYANGABU,2024,320,450,770,62
BUNYANGABU,2025,330,460,790,62
BUSHENYI,2015,300,300,600,62
BUSHENYI,2016,310,310,620,62
BUSHENYI,2017,310,310,620,62
BUSHENYI,2018,320,310,630,62
BUSHENYI,2019,320,320,640,62
BUSHENYI,2020,320,320,640,62
BUSHENYI,2021,330,320,650,62
BUSHENYI,2022,330,320,650,62
BUSHENYI,2023,330,320,650,62
BUSHENYI,2024,330,330,660,62
BUSHENYI,2025,340,330,670,62
BUSIA,2015,430,600,1030,62
BUSIA,2016,410,580,990,62
BUSIA,2017,400,530,930,62
BUSIA,2018,390,510,900,62
BUSIA,2019,410,520,930,62
BUSIA,2020,450,590,1040,62
BUSIA,2021,510,690,1200,62
BUSIA,2022,580,800,1380,62
BUSIA,2023,640,900,1540,62
BUSIA,2024,690,960,1650,62
BUSIA,2025,710,970,1680,62
BUTALEJA,2015,300,350,650,62
BUTALEJA,2016,300,330,630,62
BUTALEJA,2017,290,310,600,62
BUTALEJA,2018,290,300,590,62
BUTALEJA,2019,310,300,610,62
BUTALEJA,2020,340,340,680,62
BUTALEJA,2021,390,400,790,62
BUTALEJA,2022,440,470,910,62
BUTALEJA,2023,480,540,1020,62
BUTALEJA,2024,530,580,1110,62
BUTALEJA,2025,540,590,1130,62
BUTAMBALA,2015,90,130,220,62
BUTAMBALA,2016,90,120,210,62
BUTAMBALA,2017,80,110,190,62
BUTAMBALA,2018,80,100,180,62
BUTAMBALA,2019,90,100,190,62
BUTAMBALA,2020,90,110,200,62
BUTAMBALA,2021,100,120,220,62
BUTAMBALA,2022,120,140,260,62
BUTAMBALA,2023,120,170,290,62
BUTAMBALA,2024,130,170,300,62
BUTAMBALA,2025,130,170,300,62
BUTEBO,2015,110,150,260,62
BUTEBO,2016,110,140,250,62
BUTEBO,2017,100,130,230,62
BUTEBO,2018,100,120,220,62
BUTEBO,2019,100,120,220,62
BUTEBO,2020,110,130,240,62
BUTEBO,2021,120,160,280,62
BUTEBO,2022,140,180,320,62
BUTEBO,2023,160,190,350,62
BUTEBO,2024,160,200,360,62
BUTEBO,2025,160,200,360,62
BUVUMA,2015,140,60,200,62
BUVUMA,2016,150,70,220,62
BUVUMA,2017,160,70,230,62
BUVUMA,2018,170,80,250,62
BUVUMA,2019,180,80,260,62
BUVUMA,2020,190,90,280,62
BUVUMA,2021,210,90,300,62
BUVUMA,2022,220,100,320,62
BUVUMA,2023,230,110,340,62
BUVUMA,2024,240,110,350,62
BUVUMA,2025,260,120,380,62
BUYENDE,2015,350,340,690,62
BUYENDE,2016,350,320,670,62
BUYENDE,2017,340,300,640,62
BUYENDE,2018,330,300,630,62
BUYENDE,2019,350,300,650,62
BUYENDE,2020,400,340,740,62
BUYENDE,2021,460,410,870,62
BUYENDE,2022,520,480,1000,62
BUYENDE,2023,590,560,1150,62
BUYENDE,2024,650,590,1240,62
BUYENDE,2025,670,620,1290,62
DOKOLO,2015,260,270,530,62
DOKOLO,2016,270,280,550,62
DOKOLO,2017,280,280,560,62
DOKOLO,2018,280,290,570,62
DOKOLO,2019,290,300,590,62
DOKOLO,2020,300,310,610,62
DOKOLO,2021,310,310,620,62
DOKOLO,2022,320,320,640,62
DOKOLO,2023,330,330,660,62
DOKOLO,2024,330,340,670,62
DOKOLO,2025,340,340,680,62
GOMBA,2015,210,270,480,62
GOMBA,2016,210,250,460,62
GOMBA,2017,190,220,410,62
GOMBA,2018,180,210,390,62
GOMBA,2019,190,210,400,62
GOMBA,2020,210,230,440,62
GOMBA,2021,240,270,510,62
GOMBA,2022,260,320,580,62
GOMBA,2023,280,350,630,62
GOMBA,2024,310,360,670,62
GOMBA,2025,310,360,670,62
GULU,2015,340,330,670,62
GULU,2016,350,340,690,62
GULU,2017,360,350,710,62
GULU,2018,370,360,730,62
GULU,2019,390,370,760,62
GULU,2020,400,390,790,62
GULU,2021,410,400,810,62
GULU,2022,420,410,830,62
GULU,2023,430,420,850,62
GULU,2024,440,430,870,62
GULU,2025,450,440,890,62
HOIMA,2015,340,390,730,62
HOIMA,2016,350,400,750,62
HOIMA,2017,370,420,790,62
HOIMA,2018,380,430,810,62
HOIMA,2019,390,450,840,62
HOIMA,2020,410,460,870,62
HOIMA,2021,420,480,900,62
HOIMA,2022,440,490,930,62
HOIMA,2023,450,510,960,62
HOIMA,2024,470,520,990,62
HOIMA,2025,480,540,1020,62
IBANDA,2015,360,390,750,62
IBANDA,2016,360,400,760,62
IBANDA,2017,370,410,780,62
IBANDA,2018,380,410,790,62
IBANDA,2019,380,420,800,62
IBANDA,2020,390,430,820,62
IBANDA,2021,400,430,830,62
IBANDA,2022,400,440,840,62
IBANDA,2023,410,450,860,62
IBANDA,2024,420,450,870,62
IBANDA,2025,420,460,880,62
IGANGA,2015,300,370,670,62
IGANGA,2016,290,350,640,62
IGANGA,2017,290,330,620,62
IGANGA,2018,290,310,600,62
IGANGA,2019,300,320,620,62
IGANGA,2020,330,360,690,62
IGANGA,2021,370,420,790,62
IGANGA,2022,420,500,920,62
IGANGA,2023,460,560,1020,62
IGANGA,2024,500,590,1090,62
IGANGA,2025,520,600,1120,62
ISINGIRO,2015,660,690,1350,62
ISINGIRO,2016,680,720,1400,62
ISINGIRO,2017,710,740,1450,62
ISINGIRO,2018,730,770,1500,62
ISINGIRO,2019,760,800,1560,62
ISINGIRO,2020,790,820,1610,62
ISINGIRO,2021,820,850,1670,62
ISINGIRO,2022,840,880,1720,62
ISINGIRO,2023,870,910,1780,62
ISINGIRO,2024,900,930,1830,62
ISINGIRO,2025,930,960,1890,62
JINJA,2015,490,480,970,62
JINJA,2016,500,490,990,62
JINJA,2017,510,500,1010,62
JINJA,2018,520,500,1020,62
JINJA,2019,520,510,1030,62
JINJA,2020,530,520,1050,62
JINJA,2021,540,520,1060,62
JINJA,2022,550,530,1080,62
JINJA,2023,550,540,1090,62
JINJA,2024,560,540,1100,62
JINJA,2025,570,550,1120,62
KAABONG,2015,80,120,200,62
KAABONG,2016,80,130,210,62
KAABONG,2017,80,130,210,62
KAABONG,2018,80,130,210,62
KAABONG,2019,90,130,220,62
KAABONG,2020,90,140,230,62
KAABONG,2021,90,140,230,62
KAABONG,2022,90,140,230,62
KAABONG,2023,100,150,250,62
KAABONG,2024,100,150,250,62
KAABONG,2025,100,150,250,62
KABALE,2015,370,400,770,62
KABALE,2016,380,400,780,62
KABALE,2017,380,410,790,62
KABALE,2018,390,410,800,62
KABALE,2019,390,420,810,62
KABALE,2020,400,420,820,62
KABALE,2021,400,420,820,62
KABALE,2022,410,430,840,62
KABALE,2023,410,430,840,62
KABALE,2024,420,440,860,62
KABALE,2025,420,440,860,62
KABAROLE,2015,500,460,960,62
KABAROLE,2016,520,470,990,62
KABAROLE,2017,530,480,1010,62
KABAROLE,2018,540,490,1030,62
KABAROLE,2019,550,500,1050,62
KABAROLE,2020,560,510,1070,62
KABAROLE,2021,570,520,1090,62
KABAROLE,2022,580,530,1110,62
KABAROLE,2023,590,540,1130,62
KABAROLE,2024,600,550,1150,62
KABAROLE,2025,610,560,1170,62
KABERAMAIDO,2015,90,130,220,62
KABERAMAIDO,2016,90,120,210,62
KABERAMAIDO,2017,80,120,200,62
KABERAMAIDO,2018,80,110,190,62
KABERAMAIDO,2019,90,120,210,62
KABERAMAIDO,2020,90,130,220,62
KABERAMAIDO,2021,110,160,270,62
KABERAMAIDO,2022,130,180,310,62
KABERAMAIDO,2023,150,210,360,62
KABERAMAIDO,2024,150,220,370,62
KABERAMAIDO,2025,160,230,390,62
KAGADI,2015,410,420,830,62
KAGADI,2016,430,430,860,62
KAGADI,2017,440,450,890,62
KAGADI,2018,460,460,920,62
KAGADI,2019,470,480,950,62
KAGADI,2020,490,500,990,62
KAGADI,2021,510,510,1020,62
KAGADI,2022,530,530,1060,62
KAGADI,2023,540,550,1090,62
KAGADI,2024,560,560,1120,62
KAGADI,2025,580,580,1160,62
KAKUMIRO,2015,340,310,650,62
KAKUMIRO,2016,370,330,700,62
KAKUMIRO,2017,410,360,770,62
KAKUMIRO,2018,440,390,830,62
KAKUMIRO,2019,480,430,910,62
KAKUMIRO,2020,520,460,980,62
KAKUMIRO,2021,570,500,1070,62
KAKUMIRO,2022,620,540,1160,62
KAKUMIRO,2023,670,580,1250,62
KAKUMIRO,2024,730,630,1360,62
KAKUMIRO,2025,790,680,1470,62
KALAKI,2015,90,110,200,62
KALAKI,2016,90,120,210,62
KALAKI,2017,100,120,220,62
KALAKI,2018,100,130,230,62
KALAKI,2019,100,130,230,62
KALAKI,2020,110,140,250,62
KALAKI,2021,110,140,250,62
KALAKI,2022,120,150,270,62
KALAKI,2023,120,150,270,62
KALAKI,2024,130,160,290,62
KALAKI,2025,130,170,300,62
KALANGALA,2015,100,50,150,62
KALANGALA,2016,110,50,160,62
KALANGALA,2017,110,50,160,62
KALANGALA,2018,120,50,170,62
KALANGALA,2019,120,60,180,62
KALANGALA,2020,120,60,180,62
KALANGALA,2021,130,60,190,62
KALANGALA,2022,130,60,190,62
KALANGALA,2023,140,60,200,62
KALANGALA,2024,140,70,210,62
KALANGALA,2025,150,70,220,62
KALIRO,2015,220,260,480,62
KALIRO,2016,210,250,460,62
KALIRO,2017,210,220,430,62
KALIRO,2018,210,210,420,62
KALIRO,2019,220,220,440,62
KALIRO,2020,240,250,490,62
KALIRO,2021,280,300,580,62
KALIRO,2022,310,340,650,62
KALIRO,2023,350,390,740,62
KALIRO,2024,380,420,800,62
KALIRO,2025,380,430,810,62
KALUNGU,2015,240,340,580,62
KALUNGU,2016,230,320,550,62
KALUNGU,2017,220,290,510,62
KALUNGU,2018,210,270,480,62
KALUNGU,2019,220,270,490,62
KALUNGU,2020,230,300,530,62
KALUNGU,2021,260,350,610,62
KALUNGU,2022,280,390,670,62
KALUNGU,2023,320,430,750,62
KALUNGU,2024,330,450,780,62
KALUNGU,2025,330,460,790,62
KAMPALA,2015,1040,1050,2090,62
KAMPALA,2016,1060,1070,2130,62
KAMPALA,2017,1080,1090,2170,62
KAMPALA,2018,1100,1110,2210,62
KAMPALA,2019,1120,1130,2250,62
KAMPALA,2020,1140,1150,2290,62
KAMPALA,2021,1160,1170,2330,62
KAMPALA,2022,1180,1190,2370,62
KAMPALA,2023,1200,1210,2410,62
KAMPALA,2024,1220,1230,2450,62
KAMPALA,2025,1240,1250,2490,62
KAMULI,2015,480,570,1050,62
KAMULI,2016,470,530,1000,62
KAMULI,2017,450,490,940,62
KAMULI,2018,450,470,920,62
KAMULI,2019,460,470,930,62
KAMULI,2020,510,530,1040,62
KAMULI,2021,570,610,1180,62
KAMULI,2022,650,710,1360,62
KAMULI,2023,710,790,1500,62
KAMULI,2024,750,840,1590,62
KAMULI,2025,780,840,1620,62
KAMWENGE,2015,360,370,730,62
KAMWENGE,2016,370,380,750,62
KAMWENGE,2017,390,390,780,62
KAMWENGE,2018,400,410,810,62
KAMWENGE,2019,420,420,840,62
KAMWENGE,2020,440,440,880,62
KAMWENGE,2021,450,450,900,62
KAMWENGE,2022,470,470,940,62
KAMWENGE,2023,490,480,970,62
KAMWENGE,2024,510,500,1010,62
KAMWENGE,2025,520,510,1030,62
KANUNGU,2015,410,410,820,62
KANUNGU,2016,420,410,830,62
KANUNGU,2017,420,420,840,62
KANUNGU,2018,430,430,860,62
KANUNGU,2019,440,430,870,62
KANUNGU,2020,440,440,880,62
KANUNGU,2021,450,440,890,62
KANUNGU,2022,460,450,910,62
KANUNGU,2023,470,460,930,62
KANUNGU,2024,470,460,930,62
KANUNGU,2025,480,470,950,62
KAPCHORWA,2015,170,160,330,62
KAPCHORWA,2016,180,160,340,62
KAPCHORWA,2017,180,170,350,62
KAPCHORWA,2018,190,170,360,62
KAPCHORWA,2019,190,180,370,62
KAPCHORWA,2020,200,180,380,62
KAPCHORWA,2021,210,180,390,62
KAPCHORWA,2022,210,190,400,62
KAPCHORWA,2023,220,190,410,62
KAPCHORWA,2024,220,200,420,62
KAPCHORWA,2025,230,200,430,62
KAPELEBYONG,2015,90,130,220,62
KAPELEBYONG,2016,90,120,210,62
KAPELEBYONG,2017,90,110,200,62
KAPELEBYONG,2018,90,110,200,62
KAPELEBYONG,2019,90,110,200,62
KAPELEBYONG,2020,100,120,220,62
KAPELEBYONG,2021,110,140,250,62
KAPELEBYONG,2022,140,170,310,62
KAPELEBYONG,2023,150,180,330,62
KAPELEBYONG,2024,150,200,350,62
KAPELEBYONG,2025,160,200,360,62
KASESE,2015,780,860,1640,62
KASESE,2016,750,810,1560,62
KASESE,2017,720,750,1470,62
KASESE,2018,700,710,1410,62
KASESE,2019,720,720,1440,62
KASESE,2020,790,810,1600,62
KASESE,2021,900,940,1840,62
KASESE,2022,1020,1090,2110,62
KASESE,2023,1110,1210,2320,62
KASESE,2024,1190,1290,2480,62
KASESE,2025,1210,1300,2510,62
KASSANDA,2015,390,360,750,62
KASSANDA,2016,400,370,770,62
KASSANDA,2017,410,380,790,62
KASSANDA,2018,420,390,810,62
KASSANDA,2019,440,400,840,62
KASSANDA,2020,450,400,850,62
KASSANDA,2021,460,410,870,62
KASSANDA,2022,470,420,890,62
KASSANDA,2023,480,430,910,62
KASSANDA,2024,490,440,930,62
KASSANDA,2025,510,440,950,62
KATAKWI,2015,160,220,380,62
KATAKWI,2016,160,210,370,62
KATAKWI,2017,150,190,340,62
KATAKWI,2018,150,190,340,62
KATAKWI,2019,150,190,340,62
KATAKWI,2020,170,220,390,62
KATAKWI,2021,190,250,440,62
KATAKWI,2022,220,290,510,62
KATAKWI,2023,250,320,570,62
KATAKWI,2024,260,350,610,62
KATAKWI,2025,270,340,610,62
KAYUNGA,2015,400,520,920,62
KAYUNGA,2016,380,490,870,62
KAYUNGA,2017,370,440,810,62
KAYUNGA,2018,350,420,770,62
KAYUNGA,2019,360,430,790,62
KAYUNGA,2020,400,480,880,62
KAYUNGA,2021,450,550,1000,62
KAYUNGA,2022,500,640,1140,62
KAYUNGA,2023,550,710,1260,62
KAYUNGA,2024,580,740,1320,62
KAYUNGA,2025,590,740,1330,62
KAZO,2015,260,250,510,62
KAZO,2016,270,260,530,62
KAZO,2017,280,270,550,62
KAZO,2018,290,280,570,62
KAZO,2019,300,290,590,62
KAZO,2020,310,300,610,62
KAZO,2021,320,310,630,62
KAZO,2022,340,320,660,62
KAZO,2023,350,330,680,62
KAZO,2024,360,340,700,62
KAZO,2025,370,350,720,62
KIBAALE,2015,150,160,310,62
KIBAALE,2016,160,170,330,62
KIBAALE,2017,170,180,350,62
KIBAALE,2018,180,190,370,62
KIBAALE,2019,190,200,390,62
KIBAALE,2020,210,220,430,62
KIBAALE,2021,220,230,450,62
KIBAALE,2022,230,240,470,62
KIBAALE,2023,250,250,500,62
KIBAALE,2024,260,270,530,62
KIBAALE,2025,280,280,560,62
KIBOGA,2015,180,190,370,62
KIBOGA,2016,180,180,360,62
KIBOGA,2017,170,160,330,62
KIBOGA,2018,170,160,330,62
KIBOGA,2019,170,160,330,62
KIBOGA,2020,190,180,370,62
KIBOGA,2021,210,210,420,62
KIBOGA,2022,240,240,480,62
KIBOGA,2023,260,280,540,62
KIBOGA,2024,280,290,570,62
KIBOGA,2025,280,290,570,62
KIBUKU,2015,200,240,440,62
KIBUKU,2016,200,230,430,62
KIBUKU,2017,190,220,410,62
KIBUKU,2018,190,210,400,62
KIBUKU,2019,200,220,420,62
KIBUKU,2020,220,240,460,62
KIBUKU,2021,260,290,550,62
KIBUKU,2022,290,340,630,62
KIBUKU,2023,330,390,720,62
KIBUKU,2024,350,420,770,62
KIBUKU,2025,370,430,800,62
KIKUUBE,2015,360,280,640,62
KIKUUBE,2016,380,300,680,62
KIKUUBE,2017,400,310,710,62
KIKUUBE,2018,420,330,750,62
KIKUUBE,2019,440,340,780,62
KIKUUBE,2020,470,360,830,62
KIKUUBE,2021,490,380,870,62
KIKUUBE,2022,520,400,920,62
KIKUUBE,2023,540,420,960,62
KIKUUBE,2024,570,440,1010,62
KIKUUBE,2025,600,450,1050,62
KIRUHURA,2015,220,170,390,62
KIRUHURA,2016,230,180,410,62
KIRUHURA,2017,240,190,430,62
KIRUHURA,2018,250,190,440,62
KIRUHURA,2019,250,200,450,62
KIRUHURA,2020,260,210,470,62
KIRUHURA,2021,270,210,480,62
KIRUHURA,2022,280,220,500,62
KIRUHURA,2023,290,230,520,62
KIRUHURA,2024,300,230,530,62
KIRUHURA,2025,310,240,550,62
KIRYANDONGO,2015,350,330,680,62
KIRYANDONGO,2016,340,310,650,62
KIRYANDONGO,2017,330,290,620,62
KIRYANDONGO,2018,320,280,600,62
KIRYANDONGO,2019,340,280,620,62
KIRYANDONGO,2020,370,310,680,62
KIRYANDONGO,2021,420,370,790,62
KIRYANDONGO,2022,470,430,900,62
KIRYANDONGO,2023,530,490,1020,62
KIRYANDONGO,2024,560,510,1070,62
KIRYANDONGO,2025,580,520,1100,62
KISORO,2015,320,460,780,62
KISORO,2016,300,430,730,62
KISORO,2017,290,400,690,62
KISORO,2018,290,380,670,62
KISORO,2019,300,380,680,62
KISORO,2020,320,430,750,62
KISORO,2021,360,490,850,62
KISORO,2022,410,570,980,62
KISORO,2023,440,640,1080,62
KISORO,2024,470,680,1150,62
KISORO,2025,480,670,1150,62
KITAGWENDA,2015,210,210,420,62
KITAGWENDA,2016,220,220,440,62
KITAGWENDA,2017,230,220,450,62
KITAGWENDA,2018,240,230,470,62
KITAGWENDA,2019,240,240,480,62
KITAGWENDA,2020,250,250,500,62
KITAGWENDA,2021,260,260,520,62
KITAGWENDA,2022,270,270,540,62
KITAGWENDA,2023,280,270,550,62
KITAGWENDA,2024,290,280,570,62
KITAGWENDA,2025,300,290,590,62
KITGUM,2015,260,360,620,62
KITGUM,2016,240,330,570,62
KITGUM,2017,230,310,540,62
KITGUM,2018,220,290,510,62
KITGUM,2019,230,300,530,62
KITGUM,2020,250,320,570,62
KITGUM,2021,280,380,660,62
KITGUM,2022,310,430,740,62
KITGUM,2023,340,490,830,62
KITGUM,2024,360,510,870,62
KITGUM,2025,370,500,870,62
KOBOKO,2015,250,220,470,62
KOBOKO,2016,240,210,450,62
KOBOKO,2017,230,200,430,62
KOBOKO,2018,230,200,430,62
KOBOKO,2019,250,200,450,62
KOBOKO,2020,280,230,510,62
KOBOKO,2021,310,270,580,62
KOBOKO,2022,360,320,680,62
KOBOKO,2023,410,360,770,62
KOBOKO,2024,430,390,820,62
KOBOKO,2025,450,400,850,62
KOLE,2015,210,240,450,62
KOLE,2016,220,250,470,62
KOLE,2017,230,260,490,62
KOLE,2018,240,260,500,62
KOLE,2019,240,270,510,62
KOLE,2020,250,280,530,62
KOLE,2021,260,290,550,62
KOLE,2022,270,290,560,62
KOLE,2023,270,300,570,62
KOLE,2024,280,310,590,62
KOLE,2025,290,320,610,62
KOTIDO,2015,110,200,310,62
KOTIDO,2016,110,180,290,62
KOTIDO,2017,110,170,280,62
KOTIDO,2018,100,160,260,62
KOTIDO,2019,100,160,260,62
KOTIDO,2020,110,190,300,62
KOTIDO,2021,130,210,340,62
KOTIDO,2022,150,240,390,62
KOTIDO,2023,160,280,440,62
KOTIDO,2024,180,290,470,62
KOTIDO,2025,180,290,470,62
KUMI,2015,250,390,640,62
KUMI,2016,240,370,610,62
KUMI,2017,230,350,580,62
KUMI,2018,230,330,560,62
KUMI,2019,240,340,580,62
KUMI,2020,270,390,660,62
KUMI,2021,300,460,760,62
KUMI,2022,350,530,880,62
KUMI,2023,380,600,980,62
KUMI,2024,410,640,1050,62
KUMI,2025,420,640,1060,62
KWANIA,2015,220,260,480,62
KWANIA,2016,220,260,480,62
KWANIA,2017,230,270,500,62
KWANIA,2018,240,280,520,62
KWANIA,2019,240,290,530,62
KWANIA,2020,250,290,540,62
KWANIA,2021,260,300,560,62
KWANIA,2022,260,310,570,62
KWANIA,2023,270,320,590,62
KWANIA,2024,280,320,600,62
KWANIA,2025,290,330,620,62
KWEEN,2015,130,150,280,62
KWEEN,2016,130,160,290,62
KWEEN,2017,130,160,290,62
KWEEN,2018,140,170,310,62
KWEEN,2019,140,170,310,62
KWEEN,2020,150,170,320,62
KWEEN,2021,150,180,330,62
KWEEN,2022,160,180,340,62
KWEEN,2023,160,190,350,62
KWEEN,2024,160,190,350,62
KWEEN,2025,170,190,360,62
KYANKWANZI,2015,250,190,440,62
KYANKWANZI,2016,270,200,470,62
KYANKWANZI,2017,280,210,490,62
KYANKWANZI,2018,300,220,520,62
KYANKWANZI,2019,310,230,540,62
KYANKWANZI,2020,330,240,570,62
KYANKWANZI,2021,340,250,590,62
KYANKWANZI,2022,360,260,620,62
KYANKWANZI,2023,370,270,640,62
KYANKWANZI,2024,390,280,670,62
KYANKWANZI,2025,410,300,710,62
KYEGEGWA,2015,270,240,510,62
KYEGEGWA,2016,290,260,550,62
KYEGEGWA,2017,320,280,600,62
KYEGEGWA,2018,340,310,650,62
KYEGEGWA,2019,370,330,700,62
KYEGEGWA,2020,400,360,760,62
KYEGEGWA,2021,430,380,810,62
KYEGEGWA,2022,470,410,880,62
KYEGEGWA,2023,500,440,940,62
KYEGEGWA,2024,540,480,1020,62
KYEGEGWA,2025,580,510,1090,62
KYENJOJO,2015,470,490,960,62
KYENJOJO,2016,490,510,1000,62
KYENJOJO,2017,510,530,1040,62
KYENJOJO,2018,530,550,1080,62
KYENJOJO,2019,550,570,1120,62
KYENJOJO,2020,570,590,1160,62
KYENJOJO,2021,600,610,1210,62
KYENJOJO,2022,620,630,1250,62
KYENJOJO,2023,640,650,1290,62
KYENJOJO,2024,670,670,1340,62
KYENJOJO,2025,690,690,1380,62
KYOTERA,2015,340,450,790,62
KYOTERA,2016,320,420,740,62
KYOTERA,2017,310,390,700,62
KYOTERA,2018,300,360,660,62
KYOTERA,2019,310,370,680,62
KYOTERA,2020,340,400,740,62
KYOTERA,2021,370,470,840,62
KYOTERA,2022,420,530,950,62
KYOTERA,2023,450,600,1050,62
KYOTERA,2024,480,620,1100,62
KYOTERA,2025,490,620,1110,62
KARENGA,2015,70,60,130,62
KARENGA,2016,70,60,130,62
KARENGA,2017,70,70,140,62
KARENGA,2018,70,70,140,62
KARENGA,2019,80,70,150,62
KARENGA,2020,80,70,150,62
KARENGA,2021,80,70,150,62
KARENGA,2022,80,70,150,62
KARENGA,2023,80,80,160,62
KARENGA,2024,90,80,170,62
KARENGA,2025,90,80,170,62
LAMWO,2015,200,230,430,62
LAMWO,2016,190,220,410,62
LAMWO,2017,180,200,380,62
LAMWO,2018,170,190,360,62
LAMWO,2019,180,190,370,62
LAMWO,2020,190,220,410,62
LAMWO,2021,210,250,460,62
LAMWO,2022,230,280,510,62
LAMWO,2023,250,310,560,62
LAMWO,2024,260,330,590,62
LAMWO,2025,270,330,600,62
LIRA,2015,560,520,1080,62
LIRA,2016,570,530,1100,62
LIRA,2017,590,550,1140,62
LIRA,2018,600,560,1160,62
LIRA,2019,620,580,1200,62
LIRA,2020,640,600,1240,62
LIRA,2021,650,610,1260,62
LIRA,2022,670,630,1300,62
LIRA,2023,690,640,1330,62
LIRA,2024,700,660,1360,62
LIRA,2025,720,670,1390,62
LUUKA,2015,260,330,590,62
LUUKA,2016,250,310,560,62
LUUKA,2017,230,280,510,62
LUUKA,2018,230,270,500,62
LUUKA,2019,240,270,510,62
LUUKA,2020,260,300,560,62
LUUKA,2021,290,360,650,62
LUUKA,2022,320,410,730,62
LUUKA,2023,360,460,820,62
LUUKA,2024,390,480,870,62
LUUKA,2025,390,490,880,62
LUWERO,2015,470,650,1120,62
LUWERO,2016,460,620,1080,62
LUWERO,2017,440,570,1010,62
LUWERO,2018,430,540,970,62
LUWERO,2019,450,550,1000,62
LUWERO,2020,490,620,1110,62
LUWERO,2021,550,710,1260,62
LUWERO,2022,630,830,1460,62
LUWERO,2023,690,930,1620,62
LUWERO,2024,730,990,1720,62
LUWERO,2025,750,990,1740,62
LWENGO,2015,350,500,850,62
LWENGO,2016,330,460,790,62
LWENGO,2017,320,410,730,62
LWENGO,2018,300,390,690,62
LWENGO,2019,310,390,700,62
LWENGO,2020,340,440,780,62
LWENGO,2021,370,500,870,62
LWENGO,2022,420,570,990,62
LWENGO,2023,450,630,1080,62
LWENGO,2024,470,670,1140,62
LWENGO,2025,480,660,1140,62
LYANTONDE,2015,120,140,260,62
LYANTONDE,2016,130,140,270,62
LYANTONDE,2017,120,130,250,62
LYANTONDE,2018,120,120,240,62
LYANTONDE,2019,120,130,250,62
LYANTONDE,2020,130,140,270,62
LYANTONDE,2021,150,160,310,62
LYANTONDE,2022,170,190,360,62
LYANTONDE,2023,190,210,400,62
LYANTONDE,2024,200,230,430,62
LYANTONDE,2025,210,230,440,62
MANAFWA,2015,270,340,610,62
MANAFWA,2016,280,340,620,62
MANAFWA,2017,290,350,640,62
MANAFWA,2018,290,360,650,62
MANAFWA,2019,300,370,670,62
MANAFWA,2020,310,370,680,62
MANAFWA,2021,320,380,700,62
MANAFWA,2022,320,390,710,62
MANAFWA,2023,330,400,730,62
MANAFWA,2024,340,400,740,62
MANAFWA,2025,340,410,750,62
MARACHA,2015,250,300,550,62
MARACHA,2016,260,310,570,62
MARACHA,2017,260,320,580,62
MARACHA,2018,270,320,590,62
MARACHA,2019,270,330,600,62
MARACHA,2020,280,330,610,62
MARACHA,2021,280,340,620,62
MARACHA,2022,290,340,630,62
MARACHA,2023,290,350,640,62
MARACHA,2024,300,360,660,62
MARACHA,2025,300,360,660,62
MASAKA,2015,310,430,740,62
MASAKA,2016,310,450,760,62
MASAKA,2017,310,430,740,62
MASAKA,2018,300,400,700,62
MASAKA,2019,280,370,650,62
MASAKA,2020,280,360,640,62
MASAKA,2021,290,360,650,62
MASAKA,2022,310,400,710,62
MASAKA,2023,350,460,810,62
MASAKA,2024,400,540,940,62
MASAKA,2025,430,600,1030,62
MASINDI,2015,360,300,660,62
MASINDI,2016,370,310,680,62
MASINDI,2017,380,320,700,62
MASINDI,2018,400,320,720,62
MASINDI,2019,410,330,740,62
MASINDI,2020,420,340,760,62
MASINDI,2021,430,350,780,62
MASINDI,2022,440,360,800,62
MASINDI,2023,450,370,820,62
MASINDI,2024,460,370,830,62
MASINDI,2025,470,380,850,62
MAYUGE,2015,460,570,1030,62
MAYUGE,2016,450,540,990,62
MAYUGE,2017,430,500,930,62
MAYUGE,2018,420,480,900,62
MAYUGE,2019,440,500,940,62
MAYUGE,2020,490,560,1050,62
MAYUGE,2021,560,660,1220,62
MAYUGE,2022,630,760,1390,62
MAYUGE,2023,700,860,1560,62
MAYUGE,2024,750,930,1680,62
MAYUGE,2025,780,930,1710,62
MBALE,2015,650,980,1630,62
MBALE,2016,630,930,1560,62
MBALE,2017,620,860,1480,62
MBALE,2018,610,820,1430,62
MBALE,2019,630,850,1480,62
MBALE,2020,690,960,1650,62
MBALE,2021,790,1130,1920,62
MBALE,2022,890,1340,2230,62
MBALE,2023,990,1500,2490,62
MBALE,2024,1060,1610,2670,62
MBALE,2025,1080,1630,2710,62
MBARARA,2015,410,420,830,62
MBARARA,2016,420,430,850,62
MBARARA,2017,430,440,870,62
MBARARA,2018,440,450,890,62
MBARARA,2019,450,460,910,62
MBARARA,2020,460,470,930,62
MBARARA,2021,470,480,950,62
MBARARA,2022,480,490,970,62
MBARARA,2023,490,500,990,62
MBARARA,2024,500,500,1000,62
MBARARA,2025,510,510,1020,62
MITOOMA,2015,270,310,580,62
MITOOMA,2016,270,320,590,62
MITOOMA,2017,270,320,590,62
MITOOMA,2018,280,320,600,62
MITOOMA,2019,280,320,600,62
MITOOMA,2020,280,330,610,62
MITOOMA,2021,290,330,620,62
MITOOMA,2022,290,330,620,62
MITOOMA,2023,290,330,620,62
MITOOMA,2024,290,340,630,62
MITOOMA,2025,300,340,640,62
MITYANA,2015,440,560,1000,62
MITYANA,2016,420,520,940,62
MITYANA,2017,390,480,870,62
MITYANA,2018,380,460,840,62
MITYANA,2019,390,460,850,62
MITYANA,2020,430,510,940,62
MITYANA,2021,480,590,1070,62
MITYANA,2022,540,670,1210,62
MITYANA,2023,600,750,1350,62
MITYANA,2024,620,800,1420,62
MITYANA,2025,640,790,1430,62
MOROTO,2015,110,200,310,62
MOROTO,2016,110,180,290,62
MOROTO,2017,100,170,270,62
MOROTO,2018,100,160,260,62
MOROTO,2019,100,160,260,62
MOROTO,2020,110,190,300,62
MOROTO,2021,120,210,330,62
MOROTO,2022,140,250,390,62
MOROTO,2023,160,280,440,62
MOROTO,2024,160,300,460,62
MOROTO,2025,160,300,460,62
MOYO,2015,160,160,320,62
MOYO,2016,160,160,320,62
MOYO,2017,170,170,340,62
MOYO,2018,170,170,340,62
MOYO,2019,170,170,340,62
MOYO,2020,180,180,360,62
MOYO,2021,180,180,360,62
MOYO,2022,190,190,380,62
MOYO,2023,190,190,380,62
MOYO,2024,190,190,380,62
MOYO,2025,200,200,400,62
MPIGI,2015,300,360,660,62
MPIGI,2016,290,340,630,62
MPIGI,2017,280,320,600,62
MPIGI,2018,270,300,570,62
MPIGI,2019,280,300,580,62
MPIGI,2020,310,340,650,62
MPIGI,2021,340,400,740,62
MPIGI,2022,390,460,850,62
MPIGI,2023,430,510,940,62
MPIGI,2024,460,550,1010,62
MPIGI,2025,470,540,1010,62
MUBENDE,2015,530,500,1030,62
MUBENDE,2016,530,480,1010,62
MUBENDE,2017,520,450,970,62
MUBENDE,2018,520,440,960,62
MUBENDE,2019,550,470,1020,62
MUBENDE,2020,620,540,1160,62
MUBENDE,2021,720,640,1360,62
MUBENDE,2022,840,760,1600,62
MUBENDE,2023,950,880,1830,62
MUBENDE,2024,1030,960,1990,62
MUBENDE,2025,1100,990,2090,62
MUKONO,2015,680,790,1470,62
MUKONO,2016,660,750,1410,62
MUKONO,2017,630,690,1320,62
MUKONO,2018,630,670,1300,62
MUKONO,2019,650,690,1340,62
MUKONO,2020,710,770,1480,62
MUKONO,2021,810,900,1710,62
MUKONO,2022,910,1060,1970,62
MUKONO,2023,1000,1180,2180,62
MUKONO,2024,1070,1260,2330,62
MUKONO,2025,1110,1290,2400,62
MADI OKOLLO,2015,250,250,500,62
MADI OKOLLO,2016,250,250,500,62
MADI OKOLLO,2017,260,260,520,62
MADI OKOLLO,2018,270,270,540,62
MADI OKOLLO,2019,270,270,540,62
MADI OKOLLO,2020,280,280,560,62
MADI OKOLLO,2021,290,290,580,62
MADI OKOLLO,2022,300,300,600,62
MADI OKOLLO,2023,310,300,610,62
MADI OKOLLO,2024,310,310,620,62
MADI OKOLLO,2025,320,320,640,62
NABILATUK,2015,70,160,230,62
NABILATUK,2016,60,160,220,62
NABILATUK,2017,60,140,200,62
NABILATUK,2018,60,140,200,62
NABILATUK,2019,60,150,210,62
NABILATUK,2020,70,170,240,62
NABILATUK,2021,90,200,290,62
NABILATUK,2022,90,240,330,62
NABILATUK,2023,110,280,390,62
NABILATUK,2024,120,290,410,62
NABILATUK,2025,130,300,430,62
NAKAPIRIPIRIT,2015,200,230,430,62
NAKAPIRIPIRIT,2016,190,220,410,62
NAKAPIRIPIRIT,2017,180,210,390,62
NAKAPIRIPIRIT,2018,180,200,380,62
NAKAPIRIPIRIT,2019,190,210,400,62
NAKAPIRIPIRIT,2020,220,230,450,62
NAKAPIRIPIRIT,2021,260,280,540,62
NAKAPIRIPIRIT,2022,290,330,620,62
NAKAPIRIPIRIT,2023,330,390,720,62
NAKAPIRIPIRIT,2024,350,420,770,62
NAKAPIRIPIRIT,2025,370,430,800,62
NAKASEKE,2015,240,240,480,62
NAKASEKE,2016,250,250,500,62
NAKASEKE,2017,260,250,510,62
NAKASEKE,2018,270,260,530,62
NAKASEKE,2019,280,260,540,62
NAKASEKE,2020,290,270,560,62
NAKASEKE,2021,300,280,580,62
NAKASEKE,2022,310,280,590,62
NAKASEKE,2023,320,290,610,62
NAKASEKE,2024,330,290,620,62
NAKASEKE,2025,340,300,640,62
NAKASONGOLA,2015,220,220,440,62
NAKASONGOLA,2016,210,200,410,62
NAKASONGOLA,2017,210,190,400,62
NAKASONGOLA,2018,200,190,390,62
NAKASONGOLA,2019,210,190,400,62
NAKASONGOLA,2020,230,220,450,62
NAKASONGOLA,2021,270,250,520,62
NAKASONGOLA,2022,300,290,590,62
NAKASONGOLA,2023,330,320,650,62
NAKASONGOLA,2024,350,350,700,62
NAKASONGOLA,2025,370,340,710,62
NAMAYINGO,2015,310,350,660,62
NAMAYINGO,2016,290,330,620,62
NAMAYINGO,2017,280,300,580,62
NAMAYINGO,2018,280,290,570,62
NAMAYINGO,2019,280,290,570,62
NAMAYINGO,2020,310,320,630,62
NAMAYINGO,2021,340,370,710,62
NAMAYINGO,2022,390,420,810,62
NAMAYINGO,2023,430,470,900,62
NAMAYINGO,2024,450,490,940,62
NAMAYINGO,2025,460,490,950,62
NAMISINDWA,2015,310,460,770,62
NAMISINDWA,2016,320,470,790,62
NAMISINDWA,2017,330,480,810,62
NAMISINDWA,2018,340,490,830,62
NAMISINDWA,2019,350,510,860,62
NAMISINDWA,2020,360,520,880,62
NAMISINDWA,2021,370,530,900,62
NAMISINDWA,2022,380,540,920,62
NAMISINDWA,2023,390,550,940,62
NAMISINDWA,2024,400,560,960,62
NAMISINDWA,2025,410,570,980,62
NAMUTUMBA,2015,270,310,580,62
NAMUTUMBA,2016,270,300,570,62
NAMUTUMBA,2017,260,280,540,62
NAMUTUMBA,2018,250,260,510,62
NAMUTUMBA,2019,270,270,540,62
NAMUTUMBA,2020,290,300,590,62
NAMUTUMBA,2021,340,360,700,62
NAMUTUMBA,2022,390,420,810,62
NAMUTUMBA,2023,430,470,900,62
NAMUTUMBA,2024,460,510,970,62
NAMUTUMBA,2025,470,520,990,62
NAPAK,2015,210,490,700,62
NAPAK,2016,200,460,660,62
NAPAK,2017,190,420,610,62
NAPAK,2018,180,400,580,62
NAPAK,2019,180,410,590,62
NAPAK,2020,210,460,670,62
NAPAK,2021,230,540,770,62
NAPAK,2022,260,610,870,62
NAPAK,2023,280,680,960,62
NAPAK,2024,290,730,1020,62
NAPAK,2025,290,730,1020,62
NEBBI,2015,240,410,650,62
NEBBI,2016,240,420,660,62
NEBBI,2017,250,430,680,62
NEBBI,2018,260,440,700,62
NEBBI,2019,270,450,720,62
NEBBI,2020,280,470,750,62
NEBBI,2021,280,480,760,62
NEBBI,2022,290,490,780,62
NEBBI,2023,300,500,800,62
NEBBI,2024,310,510,820,62
NEBBI,2025,320,530,850,62
NGORA,2015,170,220,390,62
NGORA,2016,170,200,370,62
NGORA,2017,160,190,350,62
NGORA,2018,160,180,340,62
NGORA,2019,160,190,350,62
NGORA,2020,180,210,390,62
NGORA,2021,200,250,450,62
NGORA,2022,230,280,510,62
NGORA,2023,250,320,570,62
NGORA,2024,270,330,600,62
NGORA,2025,280,340,620,62
NTOROKO,2015,100,80,180,62
NTOROKO,2016,100,70,170,62
NTOROKO,2017,90,70,160,62
NTOROKO,2018,90,60,150,62
NTOROKO,2019,100,60,160,62
NTOROKO,2020,100,70,170,62
NTOROKO,2021,110,80,190,62
NTOROKO,2022,130,100,230,62
NTOROKO,2023,150,110,260,62
NTOROKO,2024,150,120,270,62
NTOROKO,2025,150,110,260,62
NTUNGAMO,2015,710,720,1430,62
NTUNGAMO,2016,730,740,1470,62
NTUNGAMO,2017,740,750,1490,62
NTUNGAMO,2018,760,760,1520,62
NTUNGAMO,2019,780,780,1560,62
NTUNGAMO,2020,790,790,1580,62
NTUNGAMO,2021,810,800,1610,62
NTUNGAMO,2022,820,820,1640,62
NTUNGAMO,2023,840,830,1670,62
NTUNGAMO,2024,850,840,1690,62
NTUNGAMO,2025,860,850,1710,62
NWOYA,2015,160,210,370,62
NWOYA,2016,170,230,400,62
NWOYA,2017,190,250,440,62
NWOYA,2018,210,280,490,62
NWOYA,2019,230,310,540,62
NWOYA,2020,260,340,600,62
NWOYA,2021,280,370,650,62
NWOYA,2022,310,410,720,62
NWOYA,2023,340,450,790,62
NWOYA,2024,380,490,870,62
NWOYA,2025,410,540,950,62
OBONGI,2015,50,50,100,62
OBONGI,2016,40,40,80,62
OBONGI,2017,40,50,90,62
OBONGI,2018,40,40,80,62
OBONGI,2019,40,40,80,62
OBONGI,2020,40,50,90,62
OBONGI,2021,50,60,110,62
OBONGI,2022,50,60,110,62
OBONGI,2023,70,70,140,62
OBONGI,2024,70,70,140,62
OBONGI,2025,70,70,140,62
OMORO,2015,200,300,500,62
OMORO,2016,200,290,490,62
OMORO,2017,190,270,460,62
OMORO,2018,190,260,450,62
OMORO,2019,200,270,470,62
OMORO,2020,220,300,520,62
OMORO,2021,250,360,610,62
OMORO,2022,280,420,700,62
OMORO,2023,320,470,790,62
OMORO,2024,340,510,850,62
OMORO,2025,350,520,870,62
OTUKE,2015,160,140,300,62
OTUKE,2016,170,150,320,62
OTUKE,2017,180,150,330,62
OTUKE,2018,190,160,350,62
OTUKE,2019,200,170,370,62
OTUKE,2020,200,170,370,62
OTUKE,2021,210,180,390,62
OTUKE,2022,220,190,410,62
OTUKE,2023,230,200,430,62
OTUKE,2024,240,200,440,62
OTUKE,2025,250,210,460,62
OYAM,2015,560,630,1190,62
OYAM,2016,570,650,1220,62
OYAM,2017,590,670,1260,62
OYAM,2018,610,690,1300,62
OYAM,2019,630,710,1340,62
OYAM,2020,650,730,1380,62
OYAM,2021,660,750,1410,62
OYAM,2022,680,770,1450,62
OYAM,2023,700,790,1490,62
OYAM,2024,720,810,1530,62
OYAM,2025,740,830,1570,62
PADER,2015,210,230,440,62
PADER,2016,210,210,420,62
PADER,2017,190,200,390,62
PADER,2018,190,190,380,62
PADER,2019,190,200,390,62
PADER,2020,220,220,440,62
PADER,2021,240,250,490,62
PADER,2022,260,290,550,62
PADER,2023,290,320,610,62
PADER,2024,310,330,640,62
PADER,2025,310,340,650,62
PAKWACH,2015,170,260,430,62
PAKWACH,2016,170,270,440,62
PAKWACH,2017,180,280,460,62
PAKWACH,2018,190,290,480,62
PAKWACH,2019,200,300,500,62
PAKWACH,2020,200,310,510,62
PAKWACH,2021,210,320,530,62
PAKWACH,2022,220,330,550,62
PAKWACH,2023,230,340,570,62
PAKWACH,2024,240,350,590,62
PAKWACH,2025,250,360,610,62
PALLISA,2015,270,330,600,62
PALLISA,2016,270,320,590,62
PALLISA,2017,270,300,570,62
PALLISA,2018,260,290,550,62
PALLISA,2019,280,300,580,62
PALLISA,2020,310,340,650,62
PALLISA,2021,360,410,770,62
PALLISA,2022,410,480,890,62
PALLISA,2023,460,560,1020,62
PALLISA,2024,500,590,1090,62
PALLISA,2025,530,620,1150,62
RAKAI,2015,370,410,780,62
RAKAI,2016,360,380,740,62
RAKAI,2017,350,360,710,62
RAKAI,2018,340,340,680,62
RAKAI,2019,350,340,690,62
RAKAI,2020,390,380,770,62
RAKAI,2021,440,450,890,62
RAKAI,2022,490,520,1010,62
RAKAI,2023,540,580,1120,62
RAKAI,2024,580,610,1190,62
RAKAI,2025,590,620,1210,62
RUBANDA,2015,250,280,530,62
RUBANDA,2016,250,290,540,62
RUBANDA,2017,260,290,550,62
RUBANDA,2018,260,290,550,62
RUBANDA,2019,260,290,550,62
RUBANDA,2020,270,300,570,62
RUBANDA,2021,270,300,570,62
RUBANDA,2022,270,300,570,62
RUBANDA,2023,280,300,580,62
RUBANDA,2024,280,300,580,62
RUBANDA,2025,280,300,580,62
RUBIRIZI,2015,160,200,360,62
RUBIRIZI,2016,160,200,360,62
RUBIRIZI,2017,160,210,370,62
RUBIRIZI,2018,160,210,370,62
RUBIRIZI,2019,170,210,380,62
RUBIRIZI,2020,170,220,390,62
RUBIRIZI,2021,170,220,390,62
RUBIRIZI,2022,180,220,400,62
RUBIRIZI,2023,180,230,410,62
RUBIRIZI,2024,180,230,410,62
RUBIRIZI,2025,190,230,420,62
RUKIGA,2015,210,210,420,62
RUKIGA,2016,210,210,420,62
RUKIGA,2017,220,210,430,62
RUKIGA,2018,220,220,440,62
RUKIGA,2019,220,220,440,62
RUKIGA,2020,220,220,440,62
RUKIGA,2021,220,220,440,62
RUKIGA,2022,230,220,450,62
RUKIGA,2023,230,220,450,62
RUKIGA,2024,230,220,450,62
RUKIGA,2025,230,220,450,62
RUKUNGIRI,2015,510,540,1050,62
RUKUNGIRI,2016,520,540,1060,62
RUKUNGIRI,2017,530,550,1080,62
RUKUNGIRI,2018,530,550,1080,62
RUKUNGIRI,2019,540,560,1100,62
RUKUNGIRI,2020,540,560,1100,62
RUKUNGIRI,2021,550,570,1120,62
RUKUNGIRI,2022,550,570,1120,62
RUKUNGIRI,2023,560,580,1140,62
RUKUNGIRI,2024,560,580,1140,62
RUKUNGIRI,2025,570,580,1150,62
RWAMPARA,2015,210,190,400,62
RWAMPARA,2016,220,190,410,62
RWAMPARA,2017,220,200,420,62
RWAMPARA,2018,230,200,430,62
RWAMPARA,2019,230,210,440,62
RWAMPARA,2020,240,210,450,62
RWAMPARA,2021,240,220,460,62
RWAMPARA,2022,250,220,470,62
RWAMPARA,2023,250,220,470,62
RWAMPARA,2024,250,230,480,62
RWAMPARA,2025,260,230,490,62
SERERE,2015,300,380,680,62
SERERE,2016,300,370,670,62
SERERE,2017,290,350,640,62
SERERE,2018,290,330,620,62
SERERE,2019,310,350,660,62
SERERE,2020,340,390,730,62
SERERE,2021,390,470,860,62
SERERE,2022,450,550,1000,62
SERERE,2023,500,630,1130,62
SERERE,2024,540,670,1210,62
SERERE,2025,570,690,1260,62
SHEEMA,2015,270,330,600,62
SHEEMA,2016,270,330,600,62
SHEEMA,2017,270,330,600,62
SHEEMA,2018,280,340,620,62
SHEEMA,2019,280,340,620,62
SHEEMA,2020,280,340,620,62
SHEEMA,2021,290,340,630,62
SHEEMA,2022,290,350,640,62
SHEEMA,2023,290,350,640,62
SHEEMA,2024,290,350,640,62
SHEEMA,2025,290,350,640,62
SIRONKO,2015,480,510,990,62
SIRONKO,2016,490,520,1010,62
SIRONKO,2017,500,530,1030,62
SIRONKO,2018,510,540,1050,62
SIRONKO,2019,520,550,1070,62
SIRONKO,2020,540,560,1100,62
SIRONKO,2021,550,570,1120,62
SIRONKO,2022,560,580,1140,62
SIRONKO,2023,570,590,1160,62
SIRONKO,2024,580,600,1180,62
SIRONKO,2025,590,610,1200,62
SOROTI,2015,290,360,650,62
SOROTI,2016,290,340,630,62
SOROTI,2017,280,320,600,62
SOROTI,2018,280,300,580,62
SOROTI,2019,290,310,600,62
SOROTI,2020,320,350,670,62
SOROTI,2021,370,410,780,62
SOROTI,2022,420,500,920,62
SOROTI,2023,460,560,1020,62
SOROTI,2024,500,590,1090,62
SOROTI,2025,520,600,1120,62
SSEMBABULE,2015,320,370,690,62
SSEMBABULE,2016,310,350,660,62
SSEMBABULE,2017,300,330,630,62
SSEMBABULE,2018,290,310,600,62
SSEMBABULE,2019,310,320,630,62
SSEMBABULE,2020,340,360,700,62
SSEMBABULE,2021,390,420,810,62
SSEMBABULE,2022,440,500,940,62
SSEMBABULE,2023,480,540,1020,62
SSEMBABULE,2024,520,580,1100,62
SSEMBABULE,2025,530,590,1120,62
TORORO,2015,830,870,1700,62
TORORO,2016,850,900,1750,62
TORORO,2017,870,920,1790,62
TORORO,2018,900,940,1840,62
TORORO,2019,920,960,1880,62
TORORO,2020,940,990,1930,62
TORORO,2021,970,1010,1980,62
TORORO,2022,990,1030,2020,62
TORORO,2023,1010,1050,2060,62
TORORO,2024,1030,1080,2110,62
TORORO,2025,1060,1100,2160,62
WAKISO,2015,1500,1580,3080,62
WAKISO,2016,1600,1690,3290,62
WAKISO,2017,1710,1800,3510,62
WAKISO,2018,1820,1920,3740,62
WAKISO,2019,1940,2050,3990,62
WAKISO,2020,2070,2190,4260,62
WAKISO,2021,2200,2330,4530,62
WAKISO,2022,2340,2490,4830,62
WAKISO,2023,2490,2650,5140,62
WAKISO,2024,2640,2820,5460,62
WAKISO,2025,2810,3000,5810,62
YUMBE,2015,310,370,680,62
YUMBE,2016,310,360,670,62
YUMBE,2017,310,350,660,62
YUMBE,2018,310,340,650,62
YUMBE,2019,330,360,690,62
YUMBE,2020,370,410,780,62
YUMBE,2021,430,500,930,62
YUMBE,2022,490,600,1090,62
YUMBE,2023,550,690,1240,62
YUMBE,2024,610,750,1360,62
YUMBE,2025,640,790,1430,62
ZOMBO,2015,230,240,470,62
ZOMBO,2016,230,250,480,62
ZOMBO,2017,240,260,500,62
ZOMBO,2018,250,260,510,62
ZOMBO,2019,260,270,530,62
ZOMBO,2020,260,280,540,62
ZOMBO,2021,270,290,560,62
ZOMBO,2022,280,290,570,62
ZOMBO,2023,290,300,590,62
ZOMBO,2024,290,310,600,62
ZOMBO,2025,300,310,610,62
ABIM,2015,110,120,230,63
ABIM,2016,100,130,230,63
ABIM,2017,110,120,230,63
ABIM,2018,110,120,230,63
ABIM,2019,110,110,220,63
ABIM,2020,110,120,230,63
ABIM,2021,140,130,270,63
ABIM,2022,150,170,320,63
ABIM,2023,180,210,390,63
ABIM,2024,210,230,440,63
ABIM,2025,220,260,480,63
ADJUMANI,2015,130,180,310,63
ADJUMANI,2016,130,180,310,63
ADJUMANI,2017,130,180,310,63
ADJUMANI,2018,130,180,310,63
ADJUMANI,2019,130,180,310,63
ADJUMANI,2020,130,180,310,63
ADJUMANI,2021,130,190,320,63
ADJUMANI,2022,130,190,320,63
ADJUMANI,2023,130,190,320,63
ADJUMANI,2024,130,190,320,63
ADJUMANI,2025,130,190,320,63
AGAGO,2015,160,230,390,63
AGAGO,2016,160,230,390,63
AGAGO,2017,160,240,400,63
AGAGO,2018,170,240,410,63
AGAGO,2019,170,250,420,63
AGAGO,2020,170,250,420,63
AGAGO,2021,170,250,420,63
AGAGO,2022,180,260,440,63
AGAGO,2023,180,260,440,63
AGAGO,2024,180,270,450,63
AGAGO,2025,180,270,450,63
ALEBTONG,2015,320,360,680,63
ALEBTONG,2016,310,360,670,63
ALEBTONG,2017,310,340,650,63
ALEBTONG,2018,300,320,620,63
ALEBTONG,2019,290,290,580,63
ALEBTONG,2020,310,310,620,63
ALEBTONG,2021,330,350,680,63
ALEBTONG,2022,370,400,770,63
ALEBTONG,2023,430,470,900,63
ALEBTONG,2024,460,530,990,63
ALEBTONG,2025,500,560,1060,63
AMOLATAR,2015,170,200,370,63
AMOLATAR,2016,180,190,370,63
AMOLATAR,2017,170,180,350,63
AMOLATAR,2018,160,170,330,63
AMOLATAR,2019,160,160,320,63
AMOLATAR,2020,170,160,330,63
AMOLATAR,2021,180,170,350,63
AMOLATAR,2022,210,210,420,63
AMOLATAR,2023,230,240,470,63
AMOLATAR,2024,250,270,520,63
AMOLATAR,2025,280,300,580,63
AMUDAT,2015,140,120,260,63
AMUDAT,2016,130,110,240,63
AMUDAT,2017,140,100,240,63
AMUDAT,2018,130,110,240,63
AMUDAT,2019,140,100,240,63
AMUDAT,2020,140,110,250,63
AMUDAT,2021,150,120,270,63
AMUDAT,2022,180,140,320,63
AMUDAT,2023,200,170,370,63
AMUDAT,2024,230,190,420,63
AMUDAT,2025,240,220,460,63
AMURIA,2015,160,150,310,63
AMURIA,2016,170,160,330,63
AMURIA,2017,190,180,370,63
AMURIA,2018,200,200,400,63
AMURIA,2019,210,200,410,63
AMURIA,2020,200,210,410,63
AMURIA,2021,200,190,390,63
AMURIA,2022,200,180,380,63
AMURIA,2023,200,170,370,63
AMURIA,2024,200,180,380,63
AMURIA,2025,230,200,430,63
AMURU,2015,190,230,420,63
AMURU,2016,180,240,420,63
AMURU,2017,170,220,390,63
AMURU,2018,170,210,380,63
AMURU,2019,160,200,360,63
AMURU,2020,170,200,370,63
AMURU,2021,190,230,420,63
AMURU,2022,210,260,470,63
AMURU,2023,230,310,540,63
AMURU,2024,270,340,610,63
AMURU,2025,280,360,640,63
APAC,2015,130,140,270,63
APAC,2016,130,150,280,63
APAC,2017,140,150,290,63
APAC,2018,140,160,300,63
APAC,2019,140,160,300,63
APAC,2020,150,170,320,63
APAC,2021,160,170,330,63
APAC,2022,160,180,340,63
APAC,2023,170,190,360,63
APAC,2024,170,190,360,63
APAC,2025,180,200,380,63
ARUA,2015,450,540,990,63
ARUA,2016,460,560,1020,63
ARUA,2017,470,570,1040,63
ARUA,2018,490,590,1080,63
ARUA,2019,500,600,1100,63
ARUA,2020,510,620,1130,63
ARUA,2021,530,630,1160,63
ARUA,2022,540,650,1190,63
ARUA,2023,550,660,1210,63
ARUA,2024,570,680,1250,63
ARUA,2025,580,690,1270,63
BUDAKA,2015,230,330,560,63
BUDAKA,2016,240,330,570,63
BUDAKA,2017,230,310,540,63
BUDAKA,2018,220,290,510,63
BUDAKA,2019,210,280,490,63
BUDAKA,2020,230,290,520,63
BUDAKA,2021,260,320,580,63
BUDAKA,2022,280,380,660,63
BUDAKA,2023,330,450,780,63
BUDAKA,2024,370,520,890,63
BUDAKA,2025,390,540,930,63
BUDUDA,2015,220,250,470,63
BUDUDA,2016,210,240,450,63
BUDUDA,2017,210,230,440,63
BUDUDA,2018,210,220,430,63
BUDUDA,2019,200,210,410,63
BUDUDA,2020,220,220,440,63
BUDUDA,2021,240,250,490,63
BUDUDA,2022,280,310,590,63
BUDUDA,2023,310,370,680,63
BUDUDA,2024,360,400,760,63
BUDUDA,2025,390,440,830,63
BUGIRI,2015,400,480,880,63
BUGIRI,2016,420,470,890,63
BUGIRI,2017,410,450,860,63
BUGIRI,2018,390,420,810,63
BUGIRI,2019,390,400,790,63
BUGIRI,2020,410,420,830,63
BUGIRI,2021,460,480,940,63
BUGIRI,2022,520,570,1090,63
BUGIRI,2023,600,660,1260,63
BUGIRI,2024,680,760,1440,63
BUGIRI,2025,730,820,1550,63
BUGWERI,2015,150,170,320,63
BUGWERI,2016,150,160,310,63
BUGWERI,2017,140,160,300,63
BUGWERI,2018,140,150,290,63
BUGWERI,2019,140,130,270,63
BUGWERI,2020,140,130,270,63
BUGWERI,2021,160,160,320,63
BUGWERI,2022,180,180,360,63
BUGWERI,2023,200,210,410,63
BUGWERI,2024,210,230,440,63
BUGWERI,2025,240,260,500,63
BUHWEJU,2015,100,110,210,63
BUHWEJU,2016,100,120,220,63
BUHWEJU,2017,110,120,230,63
BUHWEJU,2018,110,130,240,63
BUHWEJU,2019,110,130,240,63
BUHWEJU,2020,120,130,250,63
BUHWEJU,2021,120,140,260,63
BUHWEJU,2022,120,140,260,63
BUHWEJU,2023,130,140,270,63
BUHWEJU,2024,130,150,280,63
BUHWEJU,2025,130,150,280,63
BUIKWE,2015,430,460,890,63
BUIKWE,2016,420,460,880,63
BUIKWE,2017,410,420,830,63
BUIKWE,2018,390,400,790,63
BUIKWE,2019,380,370,750,63
BUIKWE,2020,390,380,770,63
BUIKWE,2021,420,430,850,63
BUIKWE,2022,480,490,970,63
BUIKWE,2023,530,570,1100,63
BUIKWE,2024,590,630,1220,63
BUIKWE,2025,610,680,1290,63
BUKEDEA,2015,250,330,580,63
BUKEDEA,2016,250,330,580,63
BUKEDEA,2017,250,320,570,63
BUKEDEA,2018,240,300,540,63
BUKEDEA,2019,240,290,530,63
BUKEDEA,2020,250,310,560,63
BUKEDEA,2021,290,350,640,63
BUKEDEA,2022,330,410,740,63
BUKEDEA,2023,380,490,870,63
BUKEDEA,2024,430,550,980,63
BUKEDEA,2025,470,600,1070,63
BUKOMANSIMBI,2015,200,300,500,63
BUKOMANSIMBI,2016,190,280,470,63
BUKOMANSIMBI,2017,180,260,440,63
BUKOMANSIMBI,2018,170,240,410,63
BUKOMANSIMBI,2019,180,220,400,63
BUKOMANSIMBI,2020,180,220,400,63
BUKOMANSIMBI,2021,190,250,440,63
BUKOMANSIMBI,2022,210,290,500,63
BUKOMANSIMBI,2023,230,330,560,63
BUKOMANSIMBI,2024,250,360,610,63
BUKOMANSIMBI,2025,260,380,640,63
BUKWO,2015,60,70,130,63
BUKWO,2016,60,70,130,63
BUKWO,2017,60,80,140,63
BUKWO,2018,60,80,140,63
BUKWO,2019,70,90,160,63
BUKWO,2020,70,90,160,63
BUKWO,2021,80,90,170,63
BUKWO,2022,80,100,180,63
BUKWO,2023,80,100,180,63
BUKWO,2024,90,110,200,63
BUKWO,2025,90,110,200,63
BULAMBULI,2015,230,280,510,63
BULAMBULI,2016,240,280,520,63
BULAMBULI,2017,230,280,510,63
BULAMBULI,2018,220,260,480,63
BULAMBULI,2019,230,260,490,63
BULAMBULI,2020,240,270,510,63
BULAMBULI,2021,270,310,580,63
BULAMBULI,2022,310,370,680,63
BULAMBULI,2023,360,440,800,63
BULAMBULI,2024,410,500,910,63
BULAMBULI,2025,450,540,990,63
BULIISA,2015,80,90,170,63
BULIISA,2016,80,90,170,63
BULIISA,2017,90,100,190,63
BULIISA,2018,90,100,190,63
BULIISA,2019,100,110,210,63
BULIISA,2020,100,110,210,63
BULIISA,2021,110,110,220,63
BULIISA,2022,110,120,230,63
BULIISA,2023,120,120,240,63
BULIISA,2024,130,130,260,63
BULIISA,2025,130,130,260,63
BUNDIBUGYO,2015,280,380,660,63
BUNDIBUGYO,2016,280,380,660,63
BUNDIBUGYO,2017,270,350,620,63
BUNDIBUGYO,2018,260,330,590,63
BUNDIBUGYO,2019,260,320,580,63
BUNDIBUGYO,2020,270,320,590,63
BUNDIBUGYO,2021,300,360,660,63
BUNDIBUGYO,2022,330,430,760,63
BUNDIBUGYO,2023,380,490,870,63
BUNDIBUGYO,2024,430,550,980,63
BUNDIBUGYO,2025,450,600,1050,63
BUNYANGABU,2015,200,260,460,63
BUNYANGABU,2016,210,250,460,63
BUNYANGABU,2017,200,250,450,63
BUNYANGABU,2018,180,220,400,63
BUNYANGABU,2019,190,210,400,63
BUNYANGABU,2020,190,220,410,63
BUNYANGABU,2021,220,240,460,63
BUNYANGABU,2022,240,280,520,63
BUNYANGABU,2023,260,330,590,63
BUNYANGABU,2024,300,360,660,63
BUNYANGABU,2025,320,380,700,63
BUSHENYI,2015,230,260,490,63
BUSHENYI,2016,230,260,490,63
BUSHENYI,2017,230,260,490,63
BUSHENYI,2018,240,270,510,63
BUSHENYI,2019,240,270,510,63
BUSHENYI,2020,240,270,510,63
BUSHENYI,2021,240,270,510,63
BUSHENYI,2022,250,270,520,63
BUSHENYI,2023,250,280,530,63
BUSHENYI,2024,250,280,530,63
BUSHENYI,2025,250,280,530,63
BUSIA,2015,320,410,730,63
BUSIA,2016,310,400,710,63
BUSIA,2017,310,380,690,63
BUSIA,2018,300,360,660,63
BUSIA,2019,300,330,630,63
BUSIA,2020,310,340,650,63
BUSIA,2021,340,390,730,63
BUSIA,2022,390,460,850,63
BUSIA,2023,430,520,950,63
BUSIA,2024,480,590,1070,63
BUSIA,2025,520,640,1160,63
BUTALEJA,2015,320,450,770,63
BUTALEJA,2016,330,430,760,63
BUTALEJA,2017,320,410,730,63
BUTALEJA,2018,320,380,700,63
BUTALEJA,2019,310,370,680,63
BUTALEJA,2020,330,380,710,63
BUTALEJA,2021,370,430,800,63
BUTALEJA,2022,420,520,940,63
BUTALEJA,2023,480,610,1090,63
BUTALEJA,2024,530,690,1220,63
BUTALEJA,2025,580,740,1320,63
BUTAMBALA,2015,90,170,260,63
BUTAMBALA,2016,100,160,260,63
BUTAMBALA,2017,100,150,250,63
BUTAMBALA,2018,90,130,220,63
BUTAMBALA,2019,90,120,210,63
BUTAMBALA,2020,90,120,210,63
BUTAMBALA,2021,100,130,230,63
BUTAMBALA,2022,100,150,250,63
BUTAMBALA,2023,120,170,290,63
BUTAMBALA,2024,120,190,310,63
BUTAMBALA,2025,130,200,330,63
BUTEBO,2015,140,150,290,63
BUTEBO,2016,130,140,270,63
BUTEBO,2017,130,150,280,63
BUTEBO,2018,120,130,250,63
BUTEBO,2019,110,120,230,63
BUTEBO,2020,130,120,250,63
BUTEBO,2021,140,130,270,63
BUTEBO,2022,150,150,300,63
BUTEBO,2023,170,170,340,63
BUTEBO,2024,180,190,370,63
BUTEBO,2025,190,200,390,63
BUVUMA,2015,70,30,100,63
BUVUMA,2016,70,30,100,63
BUVUMA,2017,80,40,120,63
BUVUMA,2018,80,40,120,63
BUVUMA,2019,90,40,130,63
BUVUMA,2020,90,50,140,63
BUVUMA,2021,100,50,150,63
BUVUMA,2022,100,50,150,63
BUVUMA,2023,110,50,160,63
BUVUMA,2024,110,60,170,63
BUVUMA,2025,120,60,180,63
BUYENDE,2015,310,330,640,63
BUYENDE,2016,310,330,640,63
BUYENDE,2017,310,320,630,63
BUYENDE,2018,300,300,600,63
BUYENDE,2019,300,290,590,63
BUYENDE,2020,320,310,630,63
BUYENDE,2021,350,350,700,63
BUYENDE,2022,400,410,810,63
BUYENDE,2023,460,490,950,63
BUYENDE,2024,520,550,1070,63
BUYENDE,2025,560,600,1160,63
DOKOLO,2015,150,170,320,63
DOKOLO,2016,150,170,320,63
DOKOLO,2017,160,180,340,63
DOKOLO,2018,160,180,340,63
DOKOLO,2019,170,190,360,63
DOKOLO,2020,170,190,360,63
DOKOLO,2021,180,200,380,63
DOKOLO,2022,180,200,380,63
DOKOLO,2023,190,210,400,63
DOKOLO,2024,190,210,400,63
DOKOLO,2025,200,220,420,63
GOMBA,2015,250,330,580,63
GOMBA,2016,240,320,560,63
GOMBA,2017,240,290,530,63
GOMBA,2018,220,280,500,63
GOMBA,2019,210,260,470,63
GOMBA,2020,220,260,480,63
GOMBA,2021,240,280,520,63
GOMBA,2022,270,320,590,63
GOMBA,2023,300,380,680,63
GOMBA,2024,320,420,740,63
GOMBA,2025,350,440,790,63
GULU,2015,180,220,400,63
GULU,2016,180,220,400,63
GULU,2017,190,230,420,63
GULU,2018,190,240,430,63
GULU,2019,200,240,440,63
GULU,2020,210,250,460,63
GULU,2021,210,260,470,63
GULU,2022,220,260,480,63
GULU,2023,220,270,490,63
GULU,2024,230,280,510,63
GULU,2025,230,280,510,63
HOIMA,2015,250,290,540,63
HOIMA,2016,250,310,560,63
HOIMA,2017,260,320,580,63
HOIMA,2018,270,330,600,63
HOIMA,2019,280,340,620,63
HOIMA,2020,290,350,640,63
HOIMA,2021,300,360,660,63
HOIMA,2022,320,370,690,63
HOIMA,2023,330,380,710,63
HOIMA,2024,340,400,740,63
HOIMA,2025,350,410,760,63
IBANDA,2015,220,300,520,63
IBANDA,2016,230,310,540,63
IBANDA,2017,230,310,540,63
IBANDA,2018,240,320,560,63
IBANDA,2019,240,320,560,63
IBANDA,2020,240,330,570,63
IBANDA,2021,250,330,580,63
IBANDA,2022,250,340,590,63
IBANDA,2023,260,340,600,63
IBANDA,2024,260,350,610,63
IBANDA,2025,260,350,610,63
IGANGA,2015,260,350,610,63
IGANGA,2016,270,330,600,63
IGANGA,2017,270,320,590,63
IGANGA,2018,250,290,540,63
IGANGA,2019,250,280,530,63
IGANGA,2020,250,290,540,63
IGANGA,2021,290,320,610,63
IGANGA,2022,330,380,710,63
IGANGA,2023,360,440,800,63
IGANGA,2024,410,500,910,63
IGANGA,2025,430,540,970,63
ISINGIRO,2015,370,520,890,63
ISINGIRO,2016,380,540,920,63
ISINGIRO,2017,400,560,960,63
ISINGIRO,2018,410,570,980,63
ISINGIRO,2019,430,590,1020,63
ISINGIRO,2020,440,610,1050,63
ISINGIRO,2021,460,630,1090,63
ISINGIRO,2022,470,660,1130,63
ISINGIRO,2023,490,680,1170,63
ISINGIRO,2024,510,700,1210,63
ISINGIRO,2025,520,720,1240,63
JINJA,2015,260,290,550,63
JINJA,2016,270,300,570,63
JINJA,2017,270,300,570,63
JINJA,2018,280,310,590,63
JINJA,2019,280,310,590,63
JINJA,2020,280,320,600,63
JINJA,2021,290,320,610,63
JINJA,2022,290,330,620,63
JINJA,2023,300,330,630,63
JINJA,2024,300,330,630,63
JINJA,2025,300,340,640,63
KAABONG,2015,90,60,150,63
KAABONG,2016,100,60,160,63
KAABONG,2017,100,60,160,63
KAABONG,2018,100,60,160,63
KAABONG,2019,100,70,170,63
KAABONG,2020,110,70,180,63
KAABONG,2021,110,70,180,63
KAABONG,2022,110,70,180,63
KAABONG,2023,120,70,190,63
KAABONG,2024,120,70,190,63
KAABONG,2025,120,80,200,63
KABALE,2015,250,370,620,63
KABALE,2016,250,370,620,63
KABALE,2017,260,380,640,63
KABALE,2018,260,380,640,63
KABALE,2019,270,390,660,63
KABALE,2020,270,390,660,63
KABALE,2021,270,390,660,63
KABALE,2022,280,400,680,63
KABALE,2023,280,400,680,63
KABALE,2024,280,400,680,63
KABALE,2025,290,410,700,63
KABAROLE,2015,250,300,550,63
KABAROLE,2016,250,310,560,63
KABAROLE,2017,260,320,580,63
KABAROLE,2018,260,330,590,63
KABAROLE,2019,270,330,600,63
KABAROLE,2020,270,340,610,63
KABAROLE,2021,280,350,630,63
KABAROLE,2022,280,350,630,63
KABAROLE,2023,290,360,650,63
KABAROLE,2024,290,360,650,63
KABAROLE,2025,300,370,670,63
KABERAMAIDO,2015,110,130,240,63
KABERAMAIDO,2016,120,130,250,63
KABERAMAIDO,2017,110,130,240,63
KABERAMAIDO,2018,110,120,230,63
KABERAMAIDO,2019,110,110,220,63
KABERAMAIDO,2020,110,120,230,63
KABERAMAIDO,2021,120,130,250,63
KABERAMAIDO,2022,150,150,300,63
KABERAMAIDO,2023,170,190,360,63
KABERAMAIDO,2024,180,210,390,63
KABERAMAIDO,2025,200,240,440,63
KAGADI,2015,260,350,610,63
KAGADI,2016,270,360,630,63
KAGADI,2017,280,370,650,63
KAGADI,2018,290,380,670,63
KAGADI,2019,300,400,700,63
KAGADI,2020,310,410,720,63
KAGADI,2021,320,420,740,63
KAGADI,2022,330,440,770,63
KAGADI,2023,340,450,790,63
KAGADI,2024,350,470,820,63
KAGADI,2025,370,480,850,63
KAKUMIRO,2015,240,230,470,63
KAKUMIRO,2016,260,250,510,63
KAKUMIRO,2017,280,270,550,63
KAKUMIRO,2018,310,300,610,63
KAKUMIRO,2019,330,320,650,63
KAKUMIRO,2020,360,350,710,63
KAKUMIRO,2021,390,380,770,63
KAKUMIRO,2022,430,410,840,63
KAKUMIRO,2023,460,440,900,63
KAKUMIRO,2024,500,470,970,63
KAKUMIRO,2025,540,510,1050,63
KALAKI,2015,90,100,190,63
KALAKI,2016,90,100,190,63
KALAKI,2017,90,110,200,63
KALAKI,2018,100,110,210,63
KALAKI,2019,100,110,210,63
KALAKI,2020,110,120,230,63
KALAKI,2021,110,120,230,63
KALAKI,2022,110,130,240,63
KALAKI,2023,120,130,250,63
KALAKI,2024,120,140,260,63
KALAKI,2025,130,140,270,63
KALANGALA,2015,50,20,70,63
KALANGALA,2016,50,20,70,63
KALANGALA,2017,50,20,70,63
KALANGALA,2018,50,20,70,63
KALANGALA,2019,60,20,80,63
KALANGALA,2020,60,20,80,63
KALANGALA,2021,60,20,80,63
KALANGALA,2022,60,20,80,63
KALANGALA,2023,60,30,90,63
KALANGALA,2024,70,30,100,63
KALANGALA,2025,70,30,100,63
KALIRO,2015,360,280,640,63
KALIRO,2016,360,270,630,63
KALIRO,2017,350,260,610,63
KALIRO,2018,340,240,580,63
KALIRO,2019,340,230,570,63
KALIRO,2020,360,240,600,63
KALIRO,2021,390,270,660,63
KALIRO,2022,450,320,770,63
KALIRO,2023,510,380,890,63
KALIRO,2024,570,420,990,63
KALIRO,2025,610,460,1070,63
KALUNGU,2015,280,360,640,63
KALUNGU,2016,280,350,630,63
KALUNGU,2017,270,340,610,63
KALUNGU,2018,250,300,550,63
KALUNGU,2019,240,280,520,63
KALUNGU,2020,240,280,520,63
KALUNGU,2021,270,310,580,63
KALUNGU,2022,300,370,670,63
KALUNGU,2023,330,420,750,63
KALUNGU,2024,360,460,820,63
KALUNGU,2025,370,480,850,63
KAMPALA,2015,630,670,1300,63
KAMPALA,2016,640,690,1330,63
KAMPALA,2017,660,700,1360,63
KAMPALA,2018,670,710,1380,63
KAMPALA,2019,680,730,1410,63
KAMPALA,2020,690,740,1430,63
KAMPALA,2021,710,750,1460,63
KAMPALA,2022,720,760,1480,63
KAMPALA,2023,730,780,1510,63
KAMPALA,2024,740,790,1530,63
KAMPALA,2025,750,800,1550,63
KAMULI,2015,460,600,1060,63
KAMULI,2016,460,590,1050,63
KAMULI,2017,450,540,990,63
KAMULI,2018,430,500,930,63
KAMULI,2019,430,480,910,63
KAMULI,2020,430,490,920,63
KAMULI,2021,480,550,1030,63
KAMULI,2022,540,640,1180,63
KAMULI,2023,610,730,1340,63
KAMULI,2024,680,820,1500,63
KAMULI,2025,730,880,1610,63
KAMWENGE,2015,230,280,510,63
KAMWENGE,2016,230,290,520,63
KAMWENGE,2017,240,300,540,63
KAMWENGE,2018,250,310,560,63
KAMWENGE,2019,260,320,580,63
KAMWENGE,2020,270,330,600,63
KAMWENGE,2021,280,340,620,63
KAMWENGE,2022,300,350,650,63
KAMWENGE,2023,310,360,670,63
KAMWENGE,2024,320,380,700,63
KAMWENGE,2025,330,390,720,63
KANUNGU,2015,260,330,590,63
KANUNGU,2016,260,340,600,63
KANUNGU,2017,270,350,620,63
KANUNGU,2018,270,350,620,63
KANUNGU,2019,280,360,640,63
KANUNGU,2020,280,360,640,63
KANUNGU,2021,280,370,650,63
KANUNGU,2022,290,370,660,63
KANUNGU,2023,290,380,670,63
KANUNGU,2024,300,380,680,63
KANUNGU,2025,300,390,690,63
KAPCHORWA,2015,100,100,200,63
KAPCHORWA,2016,100,100,200,63
KAPCHORWA,2017,100,110,210,63
KAPCHORWA,2018,110,110,220,63
KAPCHORWA,2019,110,110,220,63
KAPCHORWA,2020,110,120,230,63
KAPCHORWA,2021,120,120,240,63
KAPCHORWA,2022,120,120,240,63
KAPCHORWA,2023,120,130,250,63
KAPCHORWA,2024,130,130,260,63
KAPCHORWA,2025,130,130,260,63
KAPELEBYONG,2015,90,170,260,63
KAPELEBYONG,2016,80,160,240,63
KAPELEBYONG,2017,100,160,260,63
KAPELEBYONG,2018,90,150,240,63
KAPELEBYONG,2019,90,130,220,63
KAPELEBYONG,2020,90,130,220,63
KAPELEBYONG,2021,110,160,270,63
KAPELEBYONG,2022,120,180,300,63
KAPELEBYONG,2023,130,210,340,63
KAPELEBYONG,2024,140,250,390,63
KAPELEBYONG,2025,170,260,430,63
KASESE,2015,760,840,1600,63
KASESE,2016,750,820,1570,63
KASESE,2017,720,770,1490,63
KASESE,2018,700,710,1410,63
KASESE,2019,680,670,1350,63
KASESE,2020,700,700,1400,63
KASESE,2021,780,780,1560,63
KASESE,2022,870,900,1770,63
KASESE,2023,980,1040,2020,63
KASESE,2024,1070,1160,2230,63
KASESE,2025,1140,1240,2380,63
KASSANDA,2015,260,240,500,63
KASSANDA,2016,260,240,500,63
KASSANDA,2017,270,250,520,63
KASSANDA,2018,280,250,530,63
KASSANDA,2019,290,260,550,63
KASSANDA,2020,290,260,550,63
KASSANDA,2021,300,270,570,63
KASSANDA,2022,310,270,580,63
KASSANDA,2023,320,280,600,63
KASSANDA,2024,330,280,610,63
KASSANDA,2025,330,290,620,63
KATAKWI,2015,190,280,470,63
KATAKWI,2016,180,280,460,63
KATAKWI,2017,170,260,430,63
KATAKWI,2018,170,240,410,63
KATAKWI,2019,160,230,390,63
KATAKWI,2020,180,230,410,63
KATAKWI,2021,190,270,460,63
KATAKWI,2022,210,310,520,63
KATAKWI,2023,250,370,620,63
KATAKWI,2024,270,400,670,63
KATAKWI,2025,280,440,720,63
KAYUNGA,2015,360,460,820,63
KAYUNGA,2016,340,460,800,63
KAYUNGA,2017,320,420,740,63
KAYUNGA,2018,320,400,720,63
KAYUNGA,2019,300,370,670,63
KAYUNGA,2020,320,380,700,63
KAYUNGA,2021,340,420,760,63
KAYUNGA,2022,390,490,880,63
KAYUNGA,2023,430,560,990,63
KAYUNGA,2024,480,610,1090,63
KAYUNGA,2025,500,660,1160,63
KAZO,2015,160,160,320,63
KAZO,2016,160,170,330,63
KAZO,2017,170,180,350,63
KAZO,2018,180,180,360,63
KAZO,2019,180,190,370,63
KAZO,2020,190,200,390,63
KAZO,2021,200,200,400,63
KAZO,2022,200,210,410,63
KAZO,2023,210,220,430,63
KAZO,2024,220,220,440,63
KAZO,2025,230,230,460,63
KIBAALE,2015,80,110,190,63
KIBAALE,2016,90,120,210,63
KIBAALE,2017,100,120,220,63
KIBAALE,2018,100,130,230,63
KIBAALE,2019,110,140,250,63
KIBAALE,2020,110,150,260,63
KIBAALE,2021,120,150,270,63
KIBAALE,2022,130,160,290,63
KIBAALE,2023,140,170,310,63
KIBAALE,2024,140,180,320,63
KIBAALE,2025,150,190,340,63
KIBOGA,2015,200,200,400,63
KIBOGA,2016,210,190,400,63
KIBOGA,2017,200,180,380,63
KIBOGA,2018,200,170,370,63
KIBOGA,2019,190,160,350,63
KIBOGA,2020,190,160,350,63
KIBOGA,2021,220,190,410,63
KIBOGA,2022,240,210,450,63
KIBOGA,2023,260,240,500,63
KIBOGA,2024,300,290,590,63
KIBOGA,2025,320,300,620,63
KIBUKU,2015,220,280,500,63
KIBUKU,2016,220,280,500,63
KIBUKU,2017,230,280,510,63
KIBUKU,2018,210,250,460,63
KIBUKU,2019,210,250,460,63
KIBUKU,2020,220,260,480,63
KIBUKU,2021,240,280,520,63
KIBUKU,2022,280,340,620,63
KIBUKU,2023,310,400,710,63
KIBUKU,2024,360,460,820,63
KIBUKU,2025,390,480,870,63
KIKUUBE,2015,230,220,450,63
KIKUUBE,2016,240,230,470,63
KIKUUBE,2017,260,240,500,63
KIKUUBE,2018,270,250,520,63
KIKUUBE,2019,290,260,550,63
KIKUUBE,2020,300,280,580,63
KIKUUBE,2021,320,290,610,63
KIKUUBE,2022,330,300,630,63
KIKUUBE,2023,350,320,670,63
KIKUUBE,2024,360,330,690,63
KIKUUBE,2025,380,350,730,63
KIRUHURA,2015,130,110,240,63
KIRUHURA,2016,140,120,260,63
KIRUHURA,2017,150,120,270,63
KIRUHURA,2018,150,130,280,63
KIRUHURA,2019,160,130,290,63
KIRUHURA,2020,160,140,300,63
KIRUHURA,2021,170,140,310,63
KIRUHURA,2022,170,140,310,63
KIRUHURA,2023,180,150,330,63
KIRUHURA,2024,190,150,340,63
KIRUHURA,2025,190,160,350,63
KIRYANDONGO,2015,290,350,640,63
KIRYANDONGO,2016,280,330,610,63
KIRYANDONGO,2017,280,320,600,63
KIRYANDONGO,2018,260,290,550,63
KIRYANDONGO,2019,260,280,540,63
KIRYANDONGO,2020,280,290,570,63
KIRYANDONGO,2021,300,320,620,63
KIRYANDONGO,2022,340,380,720,63
KIRYANDONGO,2023,400,440,840,63
KIRYANDONGO,2024,430,500,930,63
KIRYANDONGO,2025,470,520,990,63
KISORO,2015,430,790,1220,63
KISORO,2016,430,780,1210,63
KISORO,2017,410,730,1140,63
KISORO,2018,390,670,1060,63
KISORO,2019,390,640,1030,63
KISORO,2020,390,650,1040,63
KISORO,2021,440,720,1160,63
KISORO,2022,480,840,1320,63
KISORO,2023,550,960,1510,63
KISORO,2024,590,1070,1660,63
KISORO,2025,630,1140,1770,63
KITAGWENDA,2015,150,200,350,63
KITAGWENDA,2016,150,210,360,63
KITAGWENDA,2017,160,210,370,63
KITAGWENDA,2018,170,220,390,63
KITAGWENDA,2019,170,230,400,63
KITAGWENDA,2020,180,240,420,63
KITAGWENDA,2021,190,250,440,63
KITAGWENDA,2022,200,250,450,63
KITAGWENDA,2023,200,260,460,63
KITAGWENDA,2024,210,270,480,63
KITAGWENDA,2025,220,280,500,63
KITGUM,2015,260,360,620,63
KITGUM,2016,250,360,610,63
KITGUM,2017,250,340,590,63
KITGUM,2018,240,300,540,63
KITGUM,2019,230,290,520,63
KITGUM,2020,230,290,520,63
KITGUM,2021,260,320,580,63
KITGUM,2022,280,380,660,63
KITGUM,2023,310,440,750,63
KITGUM,2024,340,480,820,63
KITGUM,2025,370,520,890,63
KOBOKO,2015,150,220,370,63
KOBOKO,2016,160,210,370,63
KOBOKO,2017,160,200,360,63
KOBOKO,2018,160,180,340,63
KOBOKO,2019,150,180,330,63
KOBOKO,2020,170,180,350,63
KOBOKO,2021,180,210,390,63
KOBOKO,2022,210,240,450,63
KOBOKO,2023,230,300,530,63
KOBOKO,2024,270,340,610,63
KOBOKO,2025,280,360,640,63
KOLE,2015,120,210,330,63
KOLE,2016,120,220,340,63
KOLE,2017,130,230,360,63
KOLE,2018,130,230,360,63
KOLE,2019,130,240,370,63
KOLE,2020,140,240,380,63
KOLE,2021,140,250,390,63
KOLE,2022,150,260,410,63
KOLE,2023,150,260,410,63
KOLE,2024,160,270,430,63
KOLE,2025,160,280,440,63
KOTIDO,2015,140,180,320,63
KOTIDO,2016,130,170,300,63
KOTIDO,2017,130,180,310,63
KOTIDO,2018,130,160,290,63
KOTIDO,2019,130,150,280,63
KOTIDO,2020,130,150,280,63
KOTIDO,2021,140,170,310,63
KOTIDO,2022,160,200,360,63
KOTIDO,2023,180,230,410,63
KOTIDO,2024,200,250,450,63
KOTIDO,2025,200,280,480,63
KUMI,2015,290,460,750,63
KUMI,2016,300,460,760,63
KUMI,2017,300,440,740,63
KUMI,2018,290,400,690,63
KUMI,2019,280,380,660,63
KUMI,2020,290,390,680,63
KUMI,2021,330,440,770,63
KUMI,2022,360,520,880,63
KUMI,2023,410,610,1020,63
KUMI,2024,460,690,1150,63
KUMI,2025,480,740,1220,63
KWANIA,2015,110,140,250,63
KWANIA,2016,120,150,270,63
KWANIA,2017,120,150,270,63
KWANIA,2018,120,160,280,63
KWANIA,2019,130,160,290,63
KWANIA,2020,130,160,290,63
KWANIA,2021,140,170,310,63
KWANIA,2022,140,170,310,63
KWANIA,2023,140,180,320,63
KWANIA,2024,150,180,330,63
KWANIA,2025,150,190,340,63
KWEEN,2015,70,70,140,63
KWEEN,2016,70,80,150,63
KWEEN,2017,70,80,150,63
KWEEN,2018,80,80,160,63
KWEEN,2019,80,80,160,63
KWEEN,2020,80,80,160,63
KWEEN,2021,80,90,170,63
KWEEN,2022,90,90,180,63
KWEEN,2023,90,90,180,63
KWEEN,2024,90,90,180,63
KWEEN,2025,90,90,180,63
KYANKWANZI,2015,160,150,310,63
KYANKWANZI,2016,160,150,310,63
KYANKWANZI,2017,170,160,330,63
KYANKWANZI,2018,180,170,350,63
KYANKWANZI,2019,190,180,370,63
KYANKWANZI,2020,200,180,380,63
KYANKWANZI,2021,210,190,400,63
KYANKWANZI,2022,220,200,420,63
KYANKWANZI,2023,230,210,440,63
KYANKWANZI,2024,240,220,460,63
KYANKWANZI,2025,250,230,480,63
KYEGEGWA,2015,200,190,390,63
KYEGEGWA,2016,210,210,420,63
KYEGEGWA,2017,230,220,450,63
KYEGEGWA,2018,250,240,490,63
KYEGEGWA,2019,270,260,530,63
KYEGEGWA,2020,290,280,570,63
KYEGEGWA,2021,310,300,610,63
KYEGEGWA,2022,340,320,660,63
KYEGEGWA,2023,370,350,720,63
KYEGEGWA,2024,390,370,760,63
KYEGEGWA,2025,420,400,820,63
KYENJOJO,2015,320,430,750,63
KYENJOJO,2016,330,440,770,63
KYENJOJO,2017,350,460,810,63
KYENJOJO,2018,360,470,830,63
KYENJOJO,2019,370,490,860,63
KYENJOJO,2020,390,510,900,63
KYENJOJO,2021,400,530,930,63
KYENJOJO,2022,420,540,960,63
KYENJOJO,2023,440,560,1000,63
KYENJOJO,2024,450,580,1030,63
KYENJOJO,2025,470,600,1070,63
KYOTERA,2015,360,480,840,63
KYOTERA,2016,340,470,810,63
KYOTERA,2017,340,440,780,63
KYOTERA,2018,320,400,720,63
KYOTERA,2019,310,380,690,63
KYOTERA,2020,320,380,700,63
KYOTERA,2021,340,430,770,63
KYOTERA,2022,390,490,880,63
KYOTERA,2023,430,560,990,63
KYOTERA,2024,460,630,1090,63
KYOTERA,2025,500,660,1160,63
KARENGA,2015,80,70,150,63
KARENGA,2016,80,80,160,63
KARENGA,2017,80,80,160,63
KARENGA,2018,80,80,160,63
KARENGA,2019,80,80,160,63
KARENGA,2020,90,80,170,63
KARENGA,2021,90,80,170,63
KARENGA,2022,90,90,180,63
KARENGA,2023,90,90,180,63
KARENGA,2024,100,90,190,63
KARENGA,2025,100,90,190,63
LAMWO,2015,120,200,320,63
LAMWO,2016,120,190,310,63
LAMWO,2017,110,190,300,63
LAMWO,2018,110,170,280,63
LAMWO,2019,100,160,260,63
LAMWO,2020,100,160,260,63
LAMWO,2021,120,170,290,63
LAMWO,2022,130,200,330,63
LAMWO,2023,150,240,390,63
LAMWO,2024,160,270,430,63
LAMWO,2025,170,280,450,63
LIRA,2015,280,360,640,63
LIRA,2016,290,370,660,63
LIRA,2017,300,380,680,63
LIRA,2018,300,390,690,63
LIRA,2019,310,400,710,63
LIRA,2020,320,410,730,63
LIRA,2021,330,420,750,63
LIRA,2022,340,430,770,63
LIRA,2023,340,440,780,63
LIRA,2024,350,460,810,63
LIRA,2025,360,470,830,63
LUUKA,2015,230,350,580,63
LUUKA,2016,240,350,590,63
LUUKA,2017,230,320,550,63
LUUKA,2018,210,300,510,63
LUUKA,2019,210,280,490,63
LUUKA,2020,220,280,500,63
LUUKA,2021,230,320,550,63
LUUKA,2022,270,370,640,63
LUUKA,2023,300,440,740,63
LUUKA,2024,320,480,800,63
LUUKA,2025,340,500,840,63
LUWERO,2015,510,630,1140,63
LUWERO,2016,490,600,1090,63
LUWERO,2017,480,570,1050,63
LUWERO,2018,460,530,990,63
LUWERO,2019,450,500,950,63
LUWERO,2020,470,510,980,63
LUWERO,2021,520,580,1100,63
LUWERO,2022,580,670,1250,63
LUWERO,2023,660,770,1430,63
LUWERO,2024,710,860,1570,63
LUWERO,2025,760,920,1680,63
LWENGO,2015,390,580,970,63
LWENGO,2016,370,550,920,63
LWENGO,2017,350,510,860,63
LWENGO,2018,340,480,820,63
LWENGO,2019,330,440,770,63
LWENGO,2020,330,440,770,63
LWENGO,2021,350,500,850,63
LWENGO,2022,400,570,970,63
LWENGO,2023,450,640,1090,63
LWENGO,2024,480,710,1190,63
LWENGO,2025,500,740,1240,63
LYANTONDE,2015,90,150,240,63
LYANTONDE,2016,90,140,230,63
LYANTONDE,2017,80,130,210,63
LYANTONDE,2018,90,120,210,63
LYANTONDE,2019,90,120,210,63
LYANTONDE,2020,90,120,210,63
LYANTONDE,2021,100,130,230,63
LYANTONDE,2022,100,150,250,63
LYANTONDE,2023,130,190,320,63
LYANTONDE,2024,140,210,350,63
LYANTONDE,2025,150,220,370,63
MANAFWA,2015,160,170,330,63
MANAFWA,2016,160,170,330,63
MANAFWA,2017,160,180,340,63
MANAFWA,2018,170,180,350,63
MANAFWA,2019,170,180,350,63
MANAFWA,2020,180,190,370,63
MANAFWA,2021,180,190,370,63
MANAFWA,2022,190,190,380,63
MANAFWA,2023,190,200,390,63
MANAFWA,2024,190,200,390,63
MANAFWA,2025,200,210,410,63
MARACHA,2015,140,200,340,63
MARACHA,2016,140,210,350,63
MARACHA,2017,140,210,350,63
MARACHA,2018,140,210,350,63
MARACHA,2019,150,220,370,63
MARACHA,2020,150,220,370,63
MARACHA,2021,150,230,380,63
MARACHA,2022,160,230,390,63
MARACHA,2023,160,230,390,63
MARACHA,2024,160,240,400,63
MARACHA,2025,160,240,400,63
MASAKA,2015,290,360,650,63
MASAKA,2016,310,390,700,63
MASAKA,2017,320,390,710,63
MASAKA,2018,320,380,700,63
MASAKA,2019,310,360,670,63
MASAKA,2020,290,330,620,63
MASAKA,2021,280,310,590,63
MASAKA,2022,290,320,610,63
MASAKA,2023,320,360,680,63
MASAKA,2024,360,410,770,63
MASAKA,2025,400,480,880,63
MASINDI,2015,200,210,410,63
MASINDI,2016,210,220,430,63
MASINDI,2017,210,230,440,63
MASINDI,2018,220,230,450,63
MASINDI,2019,230,240,470,63
MASINDI,2020,230,240,470,63
MASINDI,2021,240,250,490,63
MASINDI,2022,240,260,500,63
MASINDI,2023,250,260,510,63
MASINDI,2024,260,270,530,63
MASINDI,2025,260,270,530,63
MAYUGE,2015,450,500,950,63
MAYUGE,2016,450,490,940,63
MAYUGE,2017,440,470,910,63
MAYUGE,2018,420,440,860,63
MAYUGE,2019,410,420,830,63
MAYUGE,2020,430,430,860,63
MAYUGE,2021,480,480,960,63
MAYUGE,2022,540,570,1110,63
MAYUGE,2023,610,660,1270,63
MAYUGE,2024,680,740,1420,63
MAYUGE,2025,730,800,1530,63
MBALE,2015,590,730,1320,63
MBALE,2016,600,710,1310,63
MBALE,2017,580,690,1270,63
MBALE,2018,550,630,1180,63
MBALE,2019,540,610,1150,63
MBALE,2020,570,620,1190,63
MBALE,2021,630,710,1340,63
MBALE,2022,700,830,1530,63
MBALE,2023,810,970,1780,63
MBALE,2024,890,1110,2000,63
MBALE,2025,950,1180,2130,63
MBARARA,2015,270,270,540,63
MBARARA,2016,280,270,550,63
MBARARA,2017,280,280,560,63
MBARARA,2018,290,280,570,63
MBARARA,2019,300,290,590,63
MBARARA,2020,300,290,590,63
MBARARA,2021,310,300,610,63
MBARARA,2022,320,310,630,63
MBARARA,2023,320,310,630,63
MBARARA,2024,330,320,650,63
MBARARA,2025,330,320,650,63
MITOOMA,2015,180,230,410,63
MITOOMA,2016,180,230,410,63
MITOOMA,2017,180,240,420,63
MITOOMA,2018,180,240,420,63
MITOOMA,2019,180,240,420,63
MITOOMA,2020,190,240,430,63
MITOOMA,2021,190,240,430,63
MITOOMA,2022,190,250,440,63
MITOOMA,2023,190,250,440,63
MITOOMA,2024,190,250,440,63
MITOOMA,2025,190,250,440,63
MITYANA,2015,460,580,1040,63
MITYANA,2016,460,550,1010,63
MITYANA,2017,450,530,980,63
MITYANA,2018,420,490,910,63
MITYANA,2019,410,450,860,63
MITYANA,2020,420,460,880,63
MITYANA,2021,460,510,970,63
MITYANA,2022,520,600,1120,63
MITYANA,2023,580,680,1260,63
MITYANA,2024,640,760,1400,63
MITYANA,2025,670,800,1470,63
MOROTO,2015,150,220,370,63
MOROTO,2016,150,210,360,63
MOROTO,2017,140,190,330,63
MOROTO,2018,130,170,300,63
MOROTO,2019,140,170,310,63
MOROTO,2020,140,170,310,63
MOROTO,2021,150,190,340,63
MOROTO,2022,160,230,390,63
MOROTO,2023,200,260,460,63
MOROTO,2024,210,290,500,63
MOROTO,2025,220,320,540,63
MOYO,2015,70,90,160,63
MOYO,2016,70,90,160,63
MOYO,2017,70,90,160,63
MOYO,2018,70,90,160,63
MOYO,2019,70,90,160,63
MOYO,2020,70,100,170,63
MOYO,2021,80,100,180,63
MOYO,2022,80,100,180,63
MOYO,2023,80,100,180,63
MOYO,2024,80,100,180,63
MOYO,2025,80,110,190,63
MPIGI,2015,340,410,750,63
MPIGI,2016,340,410,750,63
MPIGI,2017,320,380,700,63
MPIGI,2018,320,360,680,63
MPIGI,2019,300,330,630,63
MPIGI,2020,320,340,660,63
MPIGI,2021,350,390,740,63
MPIGI,2022,390,440,830,63
MPIGI,2023,450,520,970,63
MPIGI,2024,480,570,1050,63
MPIGI,2025,520,620,1140,63
MUBENDE,2015,560,600,1160,63
MUBENDE,2016,570,590,1160,63
MUBENDE,2017,560,570,1130,63
MUBENDE,2018,550,540,1090,63
MUBENDE,2019,570,530,1100,63
MUBENDE,2020,600,560,1160,63
MUBENDE,2021,670,640,1310,63
MUBENDE,2022,780,760,1540,63
MUBENDE,2023,910,920,1830,63
MUBENDE,2024,1020,1050,2070,63
MUBENDE,2025,1120,1160,2280,63
MUKONO,2015,650,810,1460,63
MUKONO,2016,640,810,1450,63
MUKONO,2017,630,760,1390,63
MUKONO,2018,610,710,1320,63
MUKONO,2019,590,670,1260,63
MUKONO,2020,610,700,1310,63
MUKONO,2021,680,780,1460,63
MUKONO,2022,760,920,1680,63
MUKONO,2023,860,1060,1920,63
MUKONO,2024,940,1200,2140,63
MUKONO,2025,1020,1280,2300,63
MADI OKOLLO,2015,120,90,210,63
MADI OKOLLO,2016,120,90,210,63
MADI OKOLLO,2017,120,90,210,63
MADI OKOLLO,2018,130,100,230,63
MADI OKOLLO,2019,130,100,230,63
MADI OKOLLO,2020,130,100,230,63
MADI OKOLLO,2021,140,100,240,63
MADI OKOLLO,2022,140,110,250,63
MADI OKOLLO,2023,150,110,260,63
MADI OKOLLO,2024,150,110,260,63
MADI OKOLLO,2025,150,110,260,63
NABILATUK,2015,90,130,220,63
NABILATUK,2016,90,130,220,63
NABILATUK,2017,80,130,210,63
NABILATUK,2018,90,120,210,63
NABILATUK,2019,90,110,200,63
NABILATUK,2020,100,120,220,63
NABILATUK,2021,110,130,240,63
NABILATUK,2022,120,170,290,63
NABILATUK,2023,150,190,340,63
NABILATUK,2024,160,230,390,63
NABILATUK,2025,170,240,410,63
NAKAPIRIPIRIT,2015,170,230,400,63
NAKAPIRIPIRIT,2016,180,240,420,63
NAKAPIRIPIRIT,2017,170,220,390,63
NAKAPIRIPIRIT,2018,170,210,380,63
NAKAPIRIPIRIT,2019,180,210,390,63
NAKAPIRIPIRIT,2020,180,210,390,63
NAKAPIRIPIRIT,2021,200,240,440,63
NAKAPIRIPIRIT,2022,220,290,510,63
NAKAPIRIPIRIT,2023,260,330,590,63
NAKAPIRIPIRIT,2024,300,380,680,63
NAKAPIRIPIRIT,2025,320,420,740,63
NAKASEKE,2015,160,150,310,63
NAKASEKE,2016,170,150,320,63
NAKASEKE,2017,170,150,320,63
NAKASEKE,2018,180,160,340,63
NAKASEKE,2019,190,160,350,63
NAKASEKE,2020,190,160,350,63
NAKASEKE,2021,200,170,370,63
NAKASEKE,2022,210,170,380,63
NAKASEKE,2023,210,180,390,63
NAKASEKE,2024,220,180,400,63
NAKASEKE,2025,230,180,410,63
NAKASONGOLA,2015,220,200,420,63
NAKASONGOLA,2016,210,190,400,63
NAKASONGOLA,2017,210,180,390,63
NAKASONGOLA,2018,200,170,370,63
NAKASONGOLA,2019,200,160,360,63
NAKASONGOLA,2020,200,160,360,63
NAKASONGOLA,2021,230,190,420,63
NAKASONGOLA,2022,250,210,460,63
NAKASONGOLA,2023,300,240,540,63
NAKASONGOLA,2024,320,290,610,63
NAKASONGOLA,2025,350,300,650,63
NAMAYINGO,2015,190,230,420,63
NAMAYINGO,2016,190,220,410,63
NAMAYINGO,2017,180,200,380,63
NAMAYINGO,2018,170,180,350,63
NAMAYINGO,2019,160,170,330,63
NAMAYINGO,2020,170,180,350,63
NAMAYINGO,2021,190,200,390,63
NAMAYINGO,2022,210,230,440,63
NAMAYINGO,2023,230,260,490,63
NAMAYINGO,2024,250,290,540,63
NAMAYINGO,2025,280,300,580,63
NAMISINDWA,2015,170,200,370,63
NAMISINDWA,2016,170,210,380,63
NAMISINDWA,2017,180,210,390,63
NAMISINDWA,2018,180,220,400,63
NAMISINDWA,2019,190,220,410,63
NAMISINDWA,2020,190,230,420,63
NAMISINDWA,2021,200,230,430,63
NAMISINDWA,2022,200,240,440,63
NAMISINDWA,2023,210,240,450,63
NAMISINDWA,2024,210,250,460,63
NAMISINDWA,2025,220,250,470,63
NAMUTUMBA,2015,320,410,730,63
NAMUTUMBA,2016,310,400,710,63
NAMUTUMBA,2017,310,380,690,63
NAMUTUMBA,2018,300,360,660,63
NAMUTUMBA,2019,300,340,640,63
NAMUTUMBA,2020,320,350,670,63
NAMUTUMBA,2021,350,400,750,63
NAMUTUMBA,2022,390,470,860,63
NAMUTUMBA,2023,450,540,990,63
NAMUTUMBA,2024,500,610,1110,63
NAMUTUMBA,2025,540,660,1200,63
NAPAK,2015,200,330,530,63
NAPAK,2016,190,330,520,63
NAPAK,2017,180,310,490,63
NAPAK,2018,180,290,470,63
NAPAK,2019,180,270,450,63
NAPAK,2020,180,270,450,63
NAPAK,2021,190,310,500,63
NAPAK,2022,220,350,570,63
NAPAK,2023,250,420,670,63
NAPAK,2024,270,460,730,63
NAPAK,2025,280,480,760,63
NEBBI,2015,170,240,410,63
NEBBI,2016,180,250,430,63
NEBBI,2017,180,260,440,63
NEBBI,2018,190,260,450,63
NEBBI,2019,190,270,460,63
NEBBI,2020,200,280,480,63
NEBBI,2021,200,290,490,63
NEBBI,2022,210,290,500,63
NEBBI,2023,220,300,520,63
NEBBI,2024,220,310,530,63
NEBBI,2025,230,320,550,63
NGORA,2015,190,260,450,63
NGORA,2016,180,250,430,63
NGORA,2017,180,230,410,63
NGORA,2018,170,220,390,63
NGORA,2019,160,210,370,63
NGORA,2020,180,220,400,63
NGORA,2021,190,240,430,63
NGORA,2022,210,290,500,63
NGORA,2023,250,330,580,63
NGORA,2024,270,360,630,63
NGORA,2025,300,400,700,63
NTOROKO,2015,80,100,180,63
NTOROKO,2016,70,90,160,63
NTOROKO,2017,70,90,160,63
NTOROKO,2018,70,90,160,63
NTOROKO,2019,80,90,170,63
NTOROKO,2020,80,90,170,63
NTOROKO,2021,80,90,170,63
NTOROKO,2022,90,110,200,63
NTOROKO,2023,100,120,220,63
NTOROKO,2024,110,130,240,63
NTOROKO,2025,110,140,250,63
NTUNGAMO,2015,430,600,1030,63
NTUNGAMO,2016,440,610,1050,63
NTUNGAMO,2017,450,620,1070,63
NTUNGAMO,2018,460,630,1090,63
NTUNGAMO,2019,470,640,1110,63
NTUNGAMO,2020,470,650,1120,63
NTUNGAMO,2021,480,660,1140,63
NTUNGAMO,2022,490,670,1160,63
NTUNGAMO,2023,500,680,1180,63
NTUNGAMO,2024,510,690,1200,63
NTUNGAMO,2025,520,700,1220,63
NWOYA,2015,90,120,210,63
NWOYA,2016,100,140,240,63
NWOYA,2017,110,150,260,63
NWOYA,2018,120,170,290,63
NWOYA,2019,130,180,310,63
NWOYA,2020,140,200,340,63
NWOYA,2021,160,220,380,63
NWOYA,2022,170,240,410,63
NWOYA,2023,190,270,460,63
NWOYA,2024,210,290,500,63
NWOYA,2025,230,320,550,63
OBONGI,2015,30,30,60,63
OBONGI,2016,30,30,60,63
OBONGI,2017,30,40,70,63
OBONGI,2018,30,40,70,63
OBONGI,2019,30,40,70,63
OBONGI,2020,30,40,70,63
OBONGI,2021,30,40,70,63
OBONGI,2022,30,50,80,63
OBONGI,2023,30,50,80,63
OBONGI,2024,40,60,100,63
OBONGI,2025,40,60,100,63
OMORO,2015,190,280,470,63
OMORO,2016,190,280,470,63
OMORO,2017,180,260,440,63
OMORO,2018,180,250,430,63
OMORO,2019,180,250,430,63
OMORO,2020,190,240,430,63
OMORO,2021,200,280,480,63
OMORO,2022,240,340,580,63
OMORO,2023,260,380,640,63
OMORO,2024,300,440,740,63
OMORO,2025,320,480,800,63
OTUKE,2015,90,100,190,63
OTUKE,2016,90,100,190,63
OTUKE,2017,90,110,200,63
OTUKE,2018,100,110,210,63
OTUKE,2019,100,120,220,63
OTUKE,2020,110,120,230,63
OTUKE,2021,110,130,240,63
OTUKE,2022,120,130,250,63
OTUKE,2023,120,140,260,63
OTUKE,2024,130,140,270,63
OTUKE,2025,130,150,280,63
OYAM,2015,290,370,660,63
OYAM,2016,300,380,680,63
OYAM,2017,310,390,700,63
OYAM,2018,320,400,720,63
OYAM,2019,330,410,740,63
OYAM,2020,330,420,750,63
OYAM,2021,340,430,770,63
OYAM,2022,350,440,790,63
OYAM,2023,360,460,820,63
OYAM,2024,370,470,840,63
OYAM,2025,380,480,860,63
PADER,2015,190,250,440,63
PADER,2016,180,240,420,63
PADER,2017,170,220,390,63
PADER,2018,170,200,370,63
PADER,2019,160,200,360,63
PADER,2020,170,200,370,63
PADER,2021,180,210,390,63
PADER,2022,190,260,450,63
PADER,2023,230,300,530,63
PADER,2024,250,320,570,63
PADER,2025,260,340,600,63
PAKWACH,2015,120,140,260,63
PAKWACH,2016,120,150,270,63
PAKWACH,2017,130,150,280,63
PAKWACH,2018,130,160,290,63
PAKWACH,2019,140,160,300,63
PAKWACH,2020,140,170,310,63
PAKWACH,2021,150,180,330,63
PAKWACH,2022,160,180,340,63
PAKWACH,2023,160,190,350,63
PAKWACH,2024,170,190,360,63
PAKWACH,2025,170,200,370,63
PALLISA,2015,280,350,630,63
PALLISA,2016,270,350,620,63
PALLISA,2017,270,340,610,63
PALLISA,2018,260,320,580,63
PALLISA,2019,260,310,570,63
PALLISA,2020,280,320,600,63
PALLISA,2021,310,360,670,63
PALLISA,2022,360,440,800,63
PALLISA,2023,410,520,930,63
PALLISA,2024,460,590,1050,63
PALLISA,2025,500,640,1140,63
RAKAI,2015,360,430,790,63
RAKAI,2016,360,410,770,63
RAKAI,2017,340,390,730,63
RAKAI,2018,330,370,700,63
RAKAI,2019,330,340,670,63
RAKAI,2020,330,350,680,63
RAKAI,2021,370,390,760,63
RAKAI,2022,420,460,880,63
RAKAI,2023,460,520,980,63
RAKAI,2024,520,590,1110,63
RAKAI,2025,540,640,1180,63
RUBANDA,2015,200,300,500,63
RUBANDA,2016,200,300,500,63
RUBANDA,2017,200,310,510,63
RUBANDA,2018,210,310,520,63
RUBANDA,2019,210,310,520,63
RUBANDA,2020,210,310,520,63
RUBANDA,2021,210,310,520,63
RUBANDA,2022,220,320,540,63
RUBANDA,2023,220,320,540,63
RUBANDA,2024,220,320,540,63
RUBANDA,2025,220,320,540,63
RUBIRIZI,2015,100,170,270,63
RUBIRIZI,2016,100,170,270,63
RUBIRIZI,2017,110,180,290,63
RUBIRIZI,2018,110,180,290,63
RUBIRIZI,2019,110,180,290,63
RUBIRIZI,2020,110,190,300,63
RUBIRIZI,2021,120,190,310,63
RUBIRIZI,2022,120,190,310,63
RUBIRIZI,2023,120,200,320,63
RUBIRIZI,2024,120,200,320,63
RUBIRIZI,2025,120,200,320,63
RUKIGA,2015,120,160,280,63
RUKIGA,2016,130,160,290,63
RUKIGA,2017,130,170,300,63
RUKIGA,2018,130,170,300,63
RUKIGA,2019,130,170,300,63
RUKIGA,2020,130,170,300,63
RUKIGA,2021,130,170,300,63
RUKIGA,2022,130,170,300,63
RUKIGA,2023,130,170,300,63
RUKIGA,2024,130,170,300,63
RUKIGA,2025,130,170,300,63
RUKUNGIRI,2015,310,460,770,63
RUKUNGIRI,2016,310,460,770,63
RUKUNGIRI,2017,320,470,790,63
RUKUNGIRI,2018,320,470,790,63
RUKUNGIRI,2019,320,480,800,63
RUKUNGIRI,2020,330,480,810,63
RUKUNGIRI,2021,330,480,810,63
RUKUNGIRI,2022,330,490,820,63
RUKUNGIRI,2023,340,490,830,63
RUKUNGIRI,2024,340,490,830,63
RUKUNGIRI,2025,340,490,830,63
RWAMPARA,2015,90,150,240,63
RWAMPARA,2016,90,150,240,63
RWAMPARA,2017,100,150,250,63
RWAMPARA,2018,100,160,260,63
RWAMPARA,2019,100,160,260,63
RWAMPARA,2020,100,160,260,63
RWAMPARA,2021,100,170,270,63
RWAMPARA,2022,110,170,280,63
RWAMPARA,2023,110,170,280,63
RWAMPARA,2024,110,180,290,63
RWAMPARA,2025,110,180,290,63
SERERE,2015,310,380,690,63
SERERE,2016,310,380,690,63
SERERE,2017,310,370,680,63
SERERE,2018,300,340,640,63
SERERE,2019,300,330,630,63
SERERE,2020,320,340,660,63
SERERE,2021,350,390,740,63
SERERE,2022,400,460,860,63
SERERE,2023,460,540,1000,63
SERERE,2024,520,610,1130,63
SERERE,2025,560,680,1240,63
SHEEMA,2015,180,250,430,63
SHEEMA,2016,180,250,430,63
SHEEMA,2017,190,260,450,63
SHEEMA,2018,190,260,450,63
SHEEMA,2019,190,260,450,63
SHEEMA,2020,190,260,450,63
SHEEMA,2021,200,260,460,63
SHEEMA,2022,200,270,470,63
SHEEMA,2023,200,270,470,63
SHEEMA,2024,200,270,470,63
SHEEMA,2025,200,270,470,63
SIRONKO,2015,250,240,490,63
SIRONKO,2016,260,250,510,63
SIRONKO,2017,260,250,510,63
SIRONKO,2018,270,260,530,63
SIRONKO,2019,280,260,540,63
SIRONKO,2020,280,270,550,63
SIRONKO,2021,290,270,560,63
SIRONKO,2022,290,280,570,63
SIRONKO,2023,300,280,580,63
SIRONKO,2024,310,290,600,63
SIRONKO,2025,310,290,600,63
SOROTI,2015,310,400,710,63
SOROTI,2016,310,380,690,63
SOROTI,2017,310,370,680,63
SOROTI,2018,290,340,630,63
SOROTI,2019,290,330,620,63
SOROTI,2020,310,340,650,63
SOROTI,2021,340,390,730,63
SOROTI,2022,390,460,850,63
SOROTI,2023,450,540,990,63
SOROTI,2024,500,610,1110,63
SOROTI,2025,520,640,1160,63
SSEMBABULE,2015,370,380,750,63
SSEMBABULE,2016,370,360,730,63
SSEMBABULE,2017,370,350,720,63
SSEMBABULE,2018,360,320,680,63
SSEMBABULE,2019,340,310,650,63
SSEMBABULE,2020,360,320,680,63
SSEMBABULE,2021,390,350,740,63
SSEMBABULE,2022,450,410,860,63
SSEMBABULE,2023,510,490,1000,63
SSEMBABULE,2024,550,530,1080,63
SSEMBABULE,2025,600,580,1180,63
TORORO,2015,480,590,1070,63
TORORO,2016,490,600,1090,63
TORORO,2017,500,620,1120,63
TORORO,2018,520,630,1150,63
TORORO,2019,530,650,1180,63
TORORO,2020,540,660,1200,63
TORORO,2021,560,680,1240,63
TORORO,2022,570,690,1260,63
TORORO,2023,580,710,1290,63
TORORO,2024,600,720,1320,63
TORORO,2025,610,740,1350,63
WAKISO,2015,870,1080,1950,63
WAKISO,2016,920,1150,2070,63
WAKISO,2017,990,1230,2220,63
WAKISO,2018,1050,1310,2360,63
WAKISO,2019,1120,1400,2520,63
WAKISO,2020,1190,1490,2680,63
WAKISO,2021,1270,1590,2860,63
WAKISO,2022,1350,1700,3050,63
WAKISO,2023,1440,1800,3240,63
WAKISO,2024,1530,1920,3450,63
WAKISO,2025,1620,2040,3660,63
YUMBE,2015,370,400,770,63
YUMBE,2016,370,400,770,63
YUMBE,2017,370,390,760,63
YUMBE,2018,370,370,740,63
YUMBE,2019,360,370,730,63
YUMBE,2020,380,390,770,63
YUMBE,2021,440,440,880,63
YUMBE,2022,510,540,1050,63
YUMBE,2023,580,640,1220,63
YUMBE,2024,660,740,1400,63
YUMBE,2025,730,820,1550,63
ZOMBO,2015,130,230,360,63
ZOMBO,2016,130,230,360,63
ZOMBO,2017,140,240,380,63
ZOMBO,2018,140,250,390,63
ZOMBO,2019,150,250,400,63
ZOMBO,2020,150,260,410,63
ZOMBO,2021,150,270,420,63
ZOMBO,2022,160,270,430,63
ZOMBO,2023,160,280,440,63
ZOMBO,2024,170,290,460,63
ZOMBO,2025,170,290,460,63
ABIM,2015,60,140,200,64
ABIM,2016,60,140,200,64
ABIM,2017,70,140,210,64
ABIM,2018,70,140,210,64
ABIM,2019,70,140,210,64
ABIM,2020,70,130,200,64
ABIM,2021,80,140,220,64
ABIM,2022,80,160,240,64
ABIM,2023,100,190,290,64
ABIM,2024,110,230,340,64
ABIM,2025,130,260,390,64
ADJUMANI,2015,140,260,400,64
ADJUMANI,2016,140,270,410,64
ADJUMANI,2017,140,270,410,64
ADJUMANI,2018,140,270,410,64
ADJUMANI,2019,140,270,410,64
ADJUMANI,2020,140,280,420,64
ADJUMANI,2021,140,280,420,64
ADJUMANI,2022,140,280,420,64
ADJUMANI,2023,140,280,420,64
ADJUMANI,2024,140,280,420,64
ADJUMANI,2025,140,290,430,64
AGAGO,2015,180,320,500,64
AGAGO,2016,180,330,510,64
AGAGO,2017,180,330,510,64
AGAGO,2018,190,340,530,64
AGAGO,2019,190,340,530,64
AGAGO,2020,190,350,540,64
AGAGO,2021,200,350,550,64
AGAGO,2022,200,360,560,64
AGAGO,2023,200,370,570,64
AGAGO,2024,210,370,580,64
AGAGO,2025,210,380,590,64
ALEBTONG,2015,280,330,610,64
ALEBTONG,2016,290,340,630,64
ALEBTONG,2017,290,340,630,64
ALEBTONG,2018,280,320,600,64
ALEBTONG,2019,270,300,570,64
ALEBTONG,2020,260,290,550,64
ALEBTONG,2021,270,290,560,64
ALEBTONG,2022,300,330,630,64
ALEBTONG,2023,340,380,720,64
ALEBTONG,2024,390,450,840,64
ALEBTONG,2025,420,500,920,64
AMOLATAR,2015,150,200,350,64
AMOLATAR,2016,150,210,360,64
AMOLATAR,2017,150,210,360,64
AMOLATAR,2018,140,190,330,64
AMOLATAR,2019,140,180,320,64
AMOLATAR,2020,140,170,310,64
AMOLATAR,2021,140,180,320,64
AMOLATAR,2022,160,200,360,64
AMOLATAR,2023,180,230,410,64
AMOLATAR,2024,200,270,470,64
AMOLATAR,2025,220,290,510,64
AMUDAT,2015,130,100,230,64
AMUDAT,2016,130,100,230,64
AMUDAT,2017,130,110,240,64
AMUDAT,2018,130,100,230,64
AMUDAT,2019,130,100,230,64
AMUDAT,2020,120,90,210,64
AMUDAT,2021,130,90,220,64
AMUDAT,2022,140,110,250,64
AMUDAT,2023,160,140,300,64
AMUDAT,2024,180,160,340,64
AMUDAT,2025,210,190,400,64
AMURIA,2015,170,220,390,64
AMURIA,2016,170,230,400,64
AMURIA,2017,170,230,400,64
AMURIA,2018,170,210,380,64
AMURIA,2019,160,200,360,64
AMURIA,2020,160,190,350,64
AMURIA,2021,170,190,360,64
AMURIA,2022,200,220,420,64
AMURIA,2023,220,260,480,64
AMURIA,2024,250,310,560,64
AMURIA,2025,280,340,620,64
AMURU,2015,150,190,340,64
AMURU,2016,150,190,340,64
AMURU,2017,140,200,340,64
AMURU,2018,140,180,320,64
AMURU,2019,140,170,310,64
AMURU,2020,140,160,300,64
AMURU,2021,140,170,310,64
AMURU,2022,150,190,340,64
AMURU,2023,180,220,400,64
AMURU,2024,190,250,440,64
AMURU,2025,210,290,500,64
APAC,2015,210,230,440,64
APAC,2016,220,240,460,64
APAC,2017,230,250,480,64
APAC,2018,240,260,500,64
APAC,2019,250,270,520,64
APAC,2020,250,280,530,64
APAC,2021,260,280,540,64
APAC,2022,270,290,560,64
APAC,2023,280,300,580,64
APAC,2024,290,310,600,64
APAC,2025,300,320,620,64
ARUA,2015,580,770,1350,64
ARUA,2016,600,790,1390,64
ARUA,2017,610,820,1430,64
ARUA,2018,630,840,1470,64
ARUA,2019,650,860,1510,64
ARUA,2020,660,880,1540,64
ARUA,2021,680,900,1580,64
ARUA,2022,700,930,1630,64
ARUA,2023,720,950,1670,64
ARUA,2024,740,970,1710,64
ARUA,2025,750,990,1740,64
BUDAKA,2015,290,340,630,64
BUDAKA,2016,300,360,660,64
BUDAKA,2017,300,350,650,64
BUDAKA,2018,290,330,620,64
BUDAKA,2019,280,310,590,64
BUDAKA,2020,280,300,580,64
BUDAKA,2021,290,300,590,64
BUDAKA,2022,320,340,660,64
BUDAKA,2023,360,410,770,64
BUDAKA,2024,410,480,890,64
BUDAKA,2025,450,540,990,64
BUDUDA,2015,320,370,690,64
BUDUDA,2016,330,400,730,64
BUDUDA,2017,330,400,730,64
BUDUDA,2018,330,380,710,64
BUDUDA,2019,320,370,690,64
BUDUDA,2020,320,350,670,64
BUDUDA,2021,340,360,700,64
BUDUDA,2022,370,420,790,64
BUDUDA,2023,430,500,930,64
BUDUDA,2024,500,590,1090,64
BUDUDA,2025,560,680,1240,64
BUGIRI,2015,470,600,1070,64
BUGIRI,2016,490,630,1120,64
BUGIRI,2017,490,630,1120,64
BUGIRI,2018,480,610,1090,64
BUGIRI,2019,470,570,1040,64
BUGIRI,2020,470,540,1010,64
BUGIRI,2021,490,570,1060,64
BUGIRI,2022,540,640,1180,64
BUGIRI,2023,620,750,1370,64
BUGIRI,2024,720,890,1610,64
BUGIRI,2025,790,1010,1800,64
BUGWERI,2015,180,240,420,64
BUGWERI,2016,180,240,420,64
BUGWERI,2017,180,240,420,64
BUGWERI,2018,170,220,390,64
BUGWERI,2019,170,210,380,64
BUGWERI,2020,160,200,360,64
BUGWERI,2021,170,200,370,64
BUGWERI,2022,190,230,420,64
BUGWERI,2023,220,260,480,64
BUGWERI,2024,240,310,550,64
BUGWERI,2025,270,340,610,64
BUHWEJU,2015,160,160,320,64
BUHWEJU,2016,160,160,320,64
BUHWEJU,2017,170,170,340,64
BUHWEJU,2018,170,170,340,64
BUHWEJU,2019,180,180,360,64
BUHWEJU,2020,190,180,370,64
BUHWEJU,2021,190,190,380,64
BUHWEJU,2022,200,190,390,64
BUHWEJU,2023,200,200,400,64
BUHWEJU,2024,210,200,410,64
BUHWEJU,2025,210,210,420,64
BUIKWE,2015,420,470,890,64
BUIKWE,2016,430,480,910,64
BUIKWE,2017,430,460,890,64
BUIKWE,2018,420,430,850,64
BUIKWE,2019,400,400,800,64
BUIKWE,2020,390,380,770,64
BUIKWE,2021,400,390,790,64
BUIKWE,2022,430,440,870,64
BUIKWE,2023,480,500,980,64
BUIKWE,2024,550,580,1130,64
BUIKWE,2025,600,650,1250,64
BUKEDEA,2015,220,360,580,64
BUKEDEA,2016,230,380,610,64
BUKEDEA,2017,230,370,600,64
BUKEDEA,2018,230,360,590,64
BUKEDEA,2019,230,340,570,64
BUKEDEA,2020,220,330,550,64
BUKEDEA,2021,230,340,570,64
BUKEDEA,2022,260,390,650,64
BUKEDEA,2023,310,450,760,64
BUKEDEA,2024,350,540,890,64
BUKEDEA,2025,390,620,1010,64
BUKOMANSIMBI,2015,190,260,450,64
BUKOMANSIMBI,2016,190,260,450,64
BUKOMANSIMBI,2017,190,250,440,64
BUKOMANSIMBI,2018,180,230,410,64
BUKOMANSIMBI,2019,170,210,380,64
BUKOMANSIMBI,2020,160,190,350,64
BUKOMANSIMBI,2021,170,190,360,64
BUKOMANSIMBI,2022,180,210,390,64
BUKOMANSIMBI,2023,200,240,440,64
BUKOMANSIMBI,2024,220,280,500,64
BUKOMANSIMBI,2025,230,300,530,64
BUKWO,2015,120,120,240,64
BUKWO,2016,130,130,260,64
BUKWO,2017,130,140,270,64
BUKWO,2018,140,140,280,64
BUKWO,2019,150,150,300,64
BUKWO,2020,160,160,320,64
BUKWO,2021,160,170,330,64
BUKWO,2022,170,170,340,64
BUKWO,2023,180,180,360,64
BUKWO,2024,190,190,380,64
BUKWO,2025,200,200,400,64
BULAMBULI,2015,400,480,880,64
BULAMBULI,2016,420,500,920,64
BULAMBULI,2017,430,500,930,64
BULAMBULI,2018,420,500,920,64
BULAMBULI,2019,410,470,880,64
BULAMBULI,2020,420,450,870,64
BULAMBULI,2021,440,470,910,64
BULAMBULI,2022,490,550,1040,64
BULAMBULI,2023,580,640,1220,64
BULAMBULI,2024,660,770,1430,64
BULAMBULI,2025,750,890,1640,64
BULIISA,2015,110,120,230,64
BULIISA,2016,110,130,240,64
BULIISA,2017,120,130,250,64
BULIISA,2018,130,140,270,64
BULIISA,2019,130,140,270,64
BULIISA,2020,140,150,290,64
BULIISA,2021,150,160,310,64
BULIISA,2022,150,160,310,64
BULIISA,2023,160,170,330,64
BULIISA,2024,170,180,350,64
BULIISA,2025,180,180,360,64
BUNDIBUGYO,2015,210,310,520,64
BUNDIBUGYO,2016,220,320,540,64
BUNDIBUGYO,2017,220,320,540,64
BUNDIBUGYO,2018,210,290,500,64
BUNDIBUGYO,2019,210,270,480,64
BUNDIBUGYO,2020,210,260,470,64
BUNDIBUGYO,2021,210,270,480,64
BUNDIBUGYO,2022,230,300,530,64
BUNDIBUGYO,2023,270,350,620,64
BUNDIBUGYO,2024,310,410,720,64
BUNDIBUGYO,2025,330,460,790,64
BUNYANGABU,2015,210,250,460,64
BUNYANGABU,2016,220,250,470,64
BUNYANGABU,2017,210,250,460,64
BUNYANGABU,2018,210,230,440,64
BUNYANGABU,2019,200,220,420,64
BUNYANGABU,2020,200,200,400,64
BUNYANGABU,2021,200,210,410,64
BUNYANGABU,2022,220,230,450,64
BUNYANGABU,2023,250,270,520,64
BUNYANGABU,2024,280,310,590,64
BUNYANGABU,2025,310,360,670,64
BUSHENYI,2015,250,300,550,64
BUSHENYI,2016,250,300,550,64
BUSHENYI,2017,260,310,570,64
BUSHENYI,2018,260,310,570,64
BUSHENYI,2019,260,310,570,64
BUSHENYI,2020,260,310,570,64
BUSHENYI,2021,270,320,590,64
BUSHENYI,2022,270,320,590,64
BUSHENYI,2023,270,320,590,64
BUSHENYI,2024,270,320,590,64
BUSHENYI,2025,280,320,600,64
BUSIA,2015,350,490,840,64
BUSIA,2016,360,500,860,64
BUSIA,2017,360,490,850,64
BUSIA,2018,360,470,830,64
BUSIA,2019,340,440,780,64
BUSIA,2020,340,420,760,64
BUSIA,2021,350,420,770,64
BUSIA,2022,380,470,850,64
BUSIA,2023,430,560,990,64
BUSIA,2024,500,650,1150,64
BUSIA,2025,550,730,1280,64
BUTALEJA,2015,310,420,730,64
BUTALEJA,2016,330,450,780,64
BUTALEJA,2017,330,440,770,64
BUTALEJA,2018,320,420,740,64
BUTALEJA,2019,310,390,700,64
BUTALEJA,2020,310,370,680,64
BUTALEJA,2021,320,390,710,64
BUTALEJA,2022,350,440,790,64
BUTALEJA,2023,400,520,920,64
BUTALEJA,2024,470,600,1070,64
BUTALEJA,2025,510,690,1200,64
BUTAMBALA,2015,100,120,220,64
BUTAMBALA,2016,100,130,230,64
BUTAMBALA,2017,90,120,210,64
BUTAMBALA,2018,100,110,210,64
BUTAMBALA,2019,90,100,190,64
BUTAMBALA,2020,90,90,180,64
BUTAMBALA,2021,90,90,180,64
BUTAMBALA,2022,90,100,190,64
BUTAMBALA,2023,100,130,230,64
BUTAMBALA,2024,110,140,250,64
BUTAMBALA,2025,120,160,280,64
BUTEBO,2015,130,160,290,64
BUTEBO,2016,130,160,290,64
BUTEBO,2017,130,150,280,64
BUTEBO,2018,130,150,280,64
BUTEBO,2019,120,140,260,64
BUTEBO,2020,110,130,240,64
BUTEBO,2021,110,130,240,64
BUTEBO,2022,130,140,270,64
BUTEBO,2023,140,160,300,64
BUTEBO,2024,160,190,350,64
BUTEBO,2025,170,210,380,64
BUVUMA,2015,100,40,140,64
BUVUMA,2016,110,50,160,64
BUVUMA,2017,110,50,160,64
BUVUMA,2018,120,50,170,64
BUVUMA,2019,130,60,190,64
BUVUMA,2020,140,60,200,64
BUVUMA,2021,150,60,210,64
BUVUMA,2022,150,70,220,64
BUVUMA,2023,160,70,230,64
BUVUMA,2024,170,80,250,64
BUVUMA,2025,180,80,260,64
BUYENDE,2015,320,360,680,64
BUYENDE,2016,330,390,720,64
BUYENDE,2017,330,380,710,64
BUYENDE,2018,330,370,700,64
BUYENDE,2019,320,350,670,64
BUYENDE,2020,320,340,660,64
BUYENDE,2021,340,350,690,64
BUYENDE,2022,370,400,770,64
BUYENDE,2023,430,480,910,64
BUYENDE,2024,500,570,1070,64
BUYENDE,2025,550,640,1190,64
DOKOLO,2015,200,200,400,64
DOKOLO,2016,210,210,420,64
DOKOLO,2017,220,210,430,64
DOKOLO,2018,220,220,440,64
DOKOLO,2019,230,220,450,64
DOKOLO,2020,240,230,470,64
DOKOLO,2021,240,240,480,64
DOKOLO,2022,250,240,490,64
DOKOLO,2023,260,250,510,64
DOKOLO,2024,260,250,510,64
DOKOLO,2025,270,260,530,64
GOMBA,2015,210,230,440,64
GOMBA,2016,220,240,460,64
GOMBA,2017,210,230,440,64
GOMBA,2018,210,210,420,64
GOMBA,2019,200,190,390,64
GOMBA,2020,190,190,380,64
GOMBA,2021,200,190,390,64
GOMBA,2022,210,200,410,64
GOMBA,2023,240,230,470,64
GOMBA,2024,270,270,540,64
GOMBA,2025,290,290,580,64
GULU,2015,220,270,490,64
GULU,2016,220,280,500,64
GULU,2017,230,290,520,64
GULU,2018,240,300,540,64
GULU,2019,240,300,540,64
GULU,2020,250,310,560,64
GULU,2021,260,320,580,64
GULU,2022,270,330,600,64
GULU,2023,270,340,610,64
GULU,2024,280,350,630,64
GULU,2025,290,360,650,64
HOIMA,2015,290,340,630,64
HOIMA,2016,300,350,650,64
HOIMA,2017,310,360,670,64
HOIMA,2018,320,370,690,64
HOIMA,2019,340,390,730,64
HOIMA,2020,350,400,750,64
HOIMA,2021,360,410,770,64
HOIMA,2022,370,420,790,64
HOIMA,2023,390,440,830,64
HOIMA,2024,400,450,850,64
HOIMA,2025,410,460,870,64
IBANDA,2015,260,420,680,64
IBANDA,2016,270,430,700,64
IBANDA,2017,270,430,700,64
IBANDA,2018,280,440,720,64
IBANDA,2019,280,450,730,64
IBANDA,2020,290,460,750,64
IBANDA,2021,290,460,750,64
IBANDA,2022,300,470,770,64
IBANDA,2023,300,480,780,64
IBANDA,2024,310,490,800,64
IBANDA,2025,310,490,800,64
IGANGA,2015,310,390,700,64
IGANGA,2016,320,400,720,64
IGANGA,2017,320,400,720,64
IGANGA,2018,310,370,680,64
IGANGA,2019,300,350,650,64
IGANGA,2020,290,330,620,64
IGANGA,2021,300,340,640,64
IGANGA,2022,340,390,730,64
IGANGA,2023,380,450,830,64
IGANGA,2024,430,530,960,64
IGANGA,2025,480,600,1080,64
ISINGIRO,2015,550,660,1210,64
ISINGIRO,2016,570,680,1250,64
ISINGIRO,2017,590,700,1290,64
ISINGIRO,2018,610,730,1340,64
ISINGIRO,2019,630,750,1380,64
ISINGIRO,2020,650,780,1430,64
ISINGIRO,2021,680,800,1480,64
ISINGIRO,2022,700,830,1530,64
ISINGIRO,2023,720,860,1580,64
ISINGIRO,2024,750,880,1630,64
ISINGIRO,2025,770,910,1680,64
JINJA,2015,370,430,800,64
JINJA,2016,370,440,810,64
JINJA,2017,380,440,820,64
JINJA,2018,380,450,830,64
JINJA,2019,390,460,850,64
JINJA,2020,400,460,860,64
JINJA,2021,400,470,870,64
JINJA,2022,410,470,880,64
JINJA,2023,410,480,890,64
JINJA,2024,420,480,900,64
JINJA,2025,420,490,910,64
KAABONG,2015,130,180,310,64
KAABONG,2016,130,190,320,64
KAABONG,2017,130,190,320,64
KAABONG,2018,140,190,330,64
KAABONG,2019,140,200,340,64
KAABONG,2020,140,200,340,64
KAABONG,2021,150,210,360,64
KAABONG,2022,150,210,360,64
KAABONG,2023,160,220,380,64
KAABONG,2024,160,220,380,64
KAABONG,2025,160,230,390,64
KABALE,2015,250,430,680,64
KABALE,2016,260,440,700,64
KABALE,2017,260,440,700,64
KABALE,2018,260,450,710,64
KABALE,2019,270,450,720,64
KABALE,2020,270,460,730,64
KABALE,2021,280,460,740,64
KABALE,2022,280,470,750,64
KABALE,2023,280,470,750,64
KABALE,2024,290,480,770,64
KABALE,2025,290,480,770,64
KABAROLE,2015,340,380,720,64
KABAROLE,2016,350,390,740,64
KABAROLE,2017,360,400,760,64
KABAROLE,2018,370,400,770,64
KABAROLE,2019,370,410,780,64
KABAROLE,2020,380,420,800,64
KABAROLE,2021,390,430,820,64
KABAROLE,2022,400,440,840,64
KABAROLE,2023,400,450,850,64
KABAROLE,2024,410,450,860,64
KABAROLE,2025,420,460,880,64
KABERAMAIDO,2015,90,130,220,64
KABERAMAIDO,2016,80,140,220,64
KABERAMAIDO,2017,90,120,210,64
KABERAMAIDO,2018,80,110,190,64
KABERAMAIDO,2019,80,110,190,64
KABERAMAIDO,2020,90,110,200,64
KABERAMAIDO,2021,90,110,200,64
KABERAMAIDO,2022,90,130,220,64
KABERAMAIDO,2023,110,140,250,64
KABERAMAIDO,2024,120,150,270,64
KABERAMAIDO,2025,120,170,290,64
KAGADI,2015,320,400,720,64
KAGADI,2016,330,420,750,64
KAGADI,2017,340,430,770,64
KAGADI,2018,360,450,810,64
KAGADI,2019,370,460,830,64
KAGADI,2020,380,480,860,64
KAGADI,2021,400,490,890,64
KAGADI,2022,410,510,920,64
KAGADI,2023,420,530,950,64
KAGADI,2024,440,540,980,64
KAGADI,2025,450,560,1010,64
KAKUMIRO,2015,260,290,550,64
KAKUMIRO,2016,280,320,600,64
KAKUMIRO,2017,310,340,650,64
KAKUMIRO,2018,330,370,700,64
KAKUMIRO,2019,360,400,760,64
KAKUMIRO,2020,400,440,840,64
KAKUMIRO,2021,430,470,900,64
KAKUMIRO,2022,470,510,980,64
KAKUMIRO,2023,510,550,1060,64
KAKUMIRO,2024,550,600,1150,64
KAKUMIRO,2025,590,640,1230,64
KALAKI,2015,110,140,250,64
KALAKI,2016,120,150,270,64
KALAKI,2017,120,150,270,64
KALAKI,2018,130,160,290,64
KALAKI,2019,130,170,300,64
KALAKI,2020,140,170,310,64
KALAKI,2021,140,180,320,64
KALAKI,2022,150,190,340,64
KALAKI,2023,150,190,340,64
KALAKI,2024,160,200,360,64
KALAKI,2025,170,210,380,64
KALANGALA,2015,50,20,70,64
KALANGALA,2016,50,20,70,64
KALANGALA,2017,50,20,70,64
KALANGALA,2018,50,30,80,64
KALANGALA,2019,50,30,80,64
KALANGALA,2020,50,30,80,64
KALANGALA,2021,60,30,90,64
KALANGALA,2022,60,30,90,64
KALANGALA,2023,60,30,90,64
KALANGALA,2024,60,30,90,64
KALANGALA,2025,60,30,90,64
KALIRO,2015,290,280,570,64
KALIRO,2016,300,300,600,64
KALIRO,2017,300,300,600,64
KALIRO,2018,290,280,570,64
KALIRO,2019,280,260,540,64
KALIRO,2020,280,250,530,64
KALIRO,2021,290,260,550,64
KALIRO,2022,330,300,630,64
KALIRO,2023,370,350,720,64
KALIRO,2024,420,410,830,64
KALIRO,2025,460,460,920,64
KALUNGU,2015,240,300,540,64
KALUNGU,2016,240,300,540,64
KALUNGU,2017,230,290,520,64
KALUNGU,2018,230,270,500,64
KALUNGU,2019,220,250,470,64
KALUNGU,2020,210,230,440,64
KALUNGU,2021,210,230,440,64
KALUNGU,2022,230,250,480,64
KALUNGU,2023,260,300,560,64
KALUNGU,2024,280,340,620,64
KALUNGU,2025,310,370,680,64
KAMPALA,2015,810,880,1690,64
KAMPALA,2016,830,900,1730,64
KAMPALA,2017,840,920,1760,64
KAMPALA,2018,860,930,1790,64
KAMPALA,2019,880,950,1830,64
KAMPALA,2020,890,970,1860,64
KAMPALA,2021,910,980,1890,64
KAMPALA,2022,920,1000,1920,64
KAMPALA,2023,940,1020,1960,64
KAMPALA,2024,950,1030,1980,64
KAMPALA,2025,970,1050,2020,64
KAMULI,2015,510,610,1120,64
KAMULI,2016,530,630,1160,64
KAMULI,2017,520,610,1130,64
KAMULI,2018,500,590,1090,64
KAMULI,2019,490,540,1030,64
KAMULI,2020,470,510,980,64
KAMULI,2021,490,520,1010,64
KAMULI,2022,540,590,1130,64
KAMULI,2023,610,680,1290,64
KAMULI,2024,680,780,1460,64
KAMULI,2025,760,870,1630,64
KAMWENGE,2015,300,350,650,64
KAMWENGE,2016,320,360,680,64
KAMWENGE,2017,330,370,700,64
KAMWENGE,2018,340,390,730,64
KAMWENGE,2019,350,400,750,64
KAMWENGE,2020,370,410,780,64
KAMWENGE,2021,380,430,810,64
KAMWENGE,2022,400,440,840,64
KAMWENGE,2023,410,460,870,64
KAMWENGE,2024,430,470,900,64
KAMWENGE,2025,440,480,920,64
KANUNGU,2015,310,420,730,64
KANUNGU,2016,310,430,740,64
KANUNGU,2017,320,430,750,64
KANUNGU,2018,330,440,770,64
KANUNGU,2019,330,450,780,64
KANUNGU,2020,340,450,790,64
KANUNGU,2021,340,460,800,64
KANUNGU,2022,350,470,820,64
KANUNGU,2023,350,470,820,64
KANUNGU,2024,360,480,840,64
KANUNGU,2025,360,480,840,64
KAPCHORWA,2015,160,210,370,64
KAPCHORWA,2016,160,210,370,64
KAPCHORWA,2017,170,220,390,64
KAPCHORWA,2018,170,230,400,64
KAPCHORWA,2019,180,230,410,64
KAPCHORWA,2020,180,240,420,64
KAPCHORWA,2021,190,240,430,64
KAPCHORWA,2022,190,250,440,64
KAPCHORWA,2023,200,260,460,64
KAPCHORWA,2024,200,260,460,64
KAPCHORWA,2025,210,270,480,64
KAPELEBYONG,2015,70,150,220,64
KAPELEBYONG,2016,70,150,220,64
KAPELEBYONG,2017,70,140,210,64
KAPELEBYONG,2018,70,140,210,64
KAPELEBYONG,2019,70,130,200,64
KAPELEBYONG,2020,70,130,200,64
KAPELEBYONG,2021,70,130,200,64
KAPELEBYONG,2022,70,140,210,64
KAPELEBYONG,2023,90,170,260,64
KAPELEBYONG,2024,100,190,290,64
KAPELEBYONG,2025,110,210,320,64
KASESE,2015,580,670,1250,64
KASESE,2016,590,690,1280,64
KASESE,2017,590,680,1270,64
KASESE,2018,570,640,1210,64
KASESE,2019,550,580,1130,64
KASESE,2020,540,560,1100,64
KASESE,2021,560,570,1130,64
KASESE,2022,610,630,1240,64
KASESE,2023,690,740,1430,64
KASESE,2024,770,860,1630,64
KASESE,2025,840,950,1790,64
KASSANDA,2015,280,270,550,64
KASSANDA,2016,290,280,570,64
KASSANDA,2017,290,280,570,64
KASSANDA,2018,300,290,590,64
KASSANDA,2019,310,300,610,64
KASSANDA,2020,320,300,620,64
KASSANDA,2021,330,310,640,64
KASSANDA,2022,340,310,650,64
KASSANDA,2023,340,320,660,64
KASSANDA,2024,350,320,670,64
KASSANDA,2025,360,330,690,64
KATAKWI,2015,220,310,530,64
KATAKWI,2016,230,320,550,64
KATAKWI,2017,220,320,540,64
KATAKWI,2018,220,300,520,64
KATAKWI,2019,220,270,490,64
KATAKWI,2020,210,260,470,64
KATAKWI,2021,220,270,490,64
KATAKWI,2022,240,300,540,64
KATAKWI,2023,270,350,620,64
KATAKWI,2024,310,410,720,64
KATAKWI,2025,340,460,800,64
KAYUNGA,2015,400,490,890,64
KAYUNGA,2016,410,490,900,64
KAYUNGA,2017,410,480,890,64
KAYUNGA,2018,400,460,860,64
KAYUNGA,2019,370,410,780,64
KAYUNGA,2020,360,390,750,64
KAYUNGA,2021,370,400,770,64
KAYUNGA,2022,410,440,850,64
KAYUNGA,2023,460,510,970,64
KAYUNGA,2024,510,590,1100,64
KAYUNGA,2025,560,650,1210,64
KAZO,2015,250,220,470,64
KAZO,2016,260,230,490,64
KAZO,2017,270,240,510,64
KAZO,2018,280,250,530,64
KAZO,2019,290,260,550,64
KAZO,2020,300,270,570,64
KAZO,2021,310,270,580,64
KAZO,2022,320,280,600,64
KAZO,2023,330,290,620,64
KAZO,2024,340,300,640,64
KAZO,2025,350,310,660,64
KIBAALE,2015,130,120,250,64
KIBAALE,2016,140,130,270,64
KIBAALE,2017,150,140,290,64
KIBAALE,2018,160,140,300,64
KIBAALE,2019,170,150,320,64
KIBAALE,2020,180,160,340,64
KIBAALE,2021,190,170,360,64
KIBAALE,2022,200,180,380,64
KIBAALE,2023,210,190,400,64
KIBAALE,2024,220,200,420,64
KIBAALE,2025,240,210,450,64
KIBOGA,2015,180,220,400,64
KIBOGA,2016,180,220,400,64
KIBOGA,2017,180,220,400,64
KIBOGA,2018,170,200,370,64
KIBOGA,2019,170,190,360,64
KIBOGA,2020,160,180,340,64
KIBOGA,2021,170,190,360,64
KIBOGA,2022,190,200,390,64
KIBOGA,2023,220,240,460,64
KIBOGA,2024,240,280,520,64
KIBOGA,2025,270,320,590,64
KIBUKU,2015,240,390,630,64
KIBUKU,2016,250,400,650,64
KIBUKU,2017,260,400,660,64
KIBUKU,2018,250,380,630,64
KIBUKU,2019,240,360,600,64
KIBUKU,2020,240,340,580,64
KIBUKU,2021,250,360,610,64
KIBUKU,2022,290,400,690,64
KIBUKU,2023,330,480,810,64
KIBUKU,2024,380,550,930,64
KIBUKU,2025,420,640,1060,64
KIKUUBE,2015,260,260,520,64
KIKUUBE,2016,270,270,540,64
KIKUUBE,2017,280,290,570,64
KIKUUBE,2018,300,300,600,64
KIKUUBE,2019,310,320,630,64
KIKUUBE,2020,330,330,660,64
KIKUUBE,2021,350,350,700,64
KIKUUBE,2022,370,370,740,64
KIKUUBE,2023,380,380,760,64
KIKUUBE,2024,400,400,800,64
KIKUUBE,2025,420,420,840,64
KIRUHURA,2015,170,150,320,64
KIRUHURA,2016,180,160,340,64
KIRUHURA,2017,190,170,360,64
KIRUHURA,2018,190,170,360,64
KIRUHURA,2019,200,180,380,64
KIRUHURA,2020,210,180,390,64
KIRUHURA,2021,210,190,400,64
KIRUHURA,2022,220,200,420,64
KIRUHURA,2023,230,200,430,64
KIRUHURA,2024,240,210,450,64
KIRUHURA,2025,240,210,450,64
KIRYANDONGO,2015,260,260,520,64
KIRYANDONGO,2016,280,280,560,64
KIRYANDONGO,2017,280,270,550,64
KIRYANDONGO,2018,270,250,520,64
KIRYANDONGO,2019,260,240,500,64
KIRYANDONGO,2020,260,230,490,64
KIRYANDONGO,2021,260,230,490,64
KIRYANDONGO,2022,290,260,550,64
KIRYANDONGO,2023,330,310,640,64
KIRYANDONGO,2024,380,350,730,64
KIRYANDONGO,2025,420,400,820,64
KISORO,2015,340,520,860,64
KISORO,2016,350,540,890,64
KISORO,2017,350,530,880,64
KISORO,2018,330,500,830,64
KISORO,2019,320,460,780,64
KISORO,2020,310,430,740,64
KISORO,2021,310,440,750,64
KISORO,2022,350,490,840,64
KISORO,2023,390,570,960,64
KISORO,2024,430,650,1080,64
KISORO,2025,480,730,1210,64
KITAGWENDA,2015,190,220,410,64
KITAGWENDA,2016,200,220,420,64
KITAGWENDA,2017,210,230,440,64
KITAGWENDA,2018,220,240,460,64
KITAGWENDA,2019,220,250,470,64
KITAGWENDA,2020,230,260,490,64
KITAGWENDA,2021,240,270,510,64
KITAGWENDA,2022,250,280,530,64
KITAGWENDA,2023,260,280,540,64
KITAGWENDA,2024,270,290,560,64
KITAGWENDA,2025,280,300,580,64
KITGUM,2015,180,310,490,64
KITGUM,2016,190,310,500,64
KITGUM,2017,180,310,490,64
KITGUM,2018,170,280,450,64
KITGUM,2019,170,260,430,64
KITGUM,2020,160,250,410,64
KITGUM,2021,170,250,420,64
KITGUM,2022,180,280,460,64
KITGUM,2023,210,320,530,64
KITGUM,2024,230,370,600,64
KITGUM,2025,240,410,650,64
KOBOKO,2015,150,240,390,64
KOBOKO,2016,160,240,400,64
KOBOKO,2017,160,240,400,64
KOBOKO,2018,150,230,380,64
KOBOKO,2019,150,220,370,64
KOBOKO,2020,160,210,370,64
KOBOKO,2021,160,220,380,64
KOBOKO,2022,180,250,430,64
KOBOKO,2023,210,300,510,64
KOBOKO,2024,230,340,570,64
KOBOKO,2025,260,380,640,64
KOLE,2015,220,350,570,64
KOLE,2016,230,360,590,64
KOLE,2017,240,370,610,64
KOLE,2018,250,380,630,64
KOLE,2019,260,390,650,64
KOLE,2020,260,400,660,64
KOLE,2021,270,410,680,64
KOLE,2022,280,420,700,64
KOLE,2023,290,440,730,64
KOLE,2024,300,450,750,64
KOLE,2025,300,460,760,64
KOTIDO,2015,190,220,410,64
KOTIDO,2016,200,220,420,64
KOTIDO,2017,190,220,410,64
KOTIDO,2018,180,200,380,64
KOTIDO,2019,180,180,360,64
KOTIDO,2020,170,180,350,64
KOTIDO,2021,180,180,360,64
KOTIDO,2022,200,200,400,64
KOTIDO,2023,230,230,460,64
KOTIDO,2024,250,280,530,64
KOTIDO,2025,280,300,580,64
KUMI,2015,310,450,760,64
KUMI,2016,320,480,800,64
KUMI,2017,320,470,790,64
KUMI,2018,310,440,750,64
KUMI,2019,310,410,720,64
KUMI,2020,300,390,690,64
KUMI,2021,310,410,720,64
KUMI,2022,350,460,810,64
KUMI,2023,390,530,920,64
KUMI,2024,440,620,1060,64
KUMI,2025,490,700,1190,64
KWANIA,2015,220,240,460,64
KWANIA,2016,230,240,470,64
KWANIA,2017,230,250,480,64
KWANIA,2018,240,260,500,64
KWANIA,2019,250,260,510,64
KWANIA,2020,250,270,520,64
KWANIA,2021,260,280,540,64
KWANIA,2022,270,280,550,64
KWANIA,2023,280,290,570,64
KWANIA,2024,280,300,580,64
KWANIA,2025,290,310,600,64
KWEEN,2015,150,150,300,64
KWEEN,2016,160,150,310,64
KWEEN,2017,160,160,320,64
KWEEN,2018,170,160,330,64
KWEEN,2019,170,170,340,64
KWEEN,2020,180,170,350,64
KWEEN,2021,180,170,350,64
KWEEN,2022,190,180,370,64
KWEEN,2023,200,180,380,64
KWEEN,2024,200,190,390,64
KWEEN,2025,210,190,400,64
KYANKWANZI,2015,240,220,460,64
KYANKWANZI,2016,250,230,480,64
KYANKWANZI,2017,260,240,500,64
KYANKWANZI,2018,280,250,530,64
KYANKWANZI,2019,290,260,550,64
KYANKWANZI,2020,310,280,590,64
KYANKWANZI,2021,320,290,610,64
KYANKWANZI,2022,340,300,640,64
KYANKWANZI,2023,350,310,660,64
KYANKWANZI,2024,370,330,700,64
KYANKWANZI,2025,390,340,730,64
KYEGEGWA,2015,320,310,630,64
KYEGEGWA,2016,350,340,690,64
KYEGEGWA,2017,380,360,740,64
KYEGEGWA,2018,410,390,800,64
KYEGEGWA,2019,440,420,860,64
KYEGEGWA,2020,480,460,940,64
KYEGEGWA,2021,520,490,1010,64
KYEGEGWA,2022,560,530,1090,64
KYEGEGWA,2023,600,570,1170,64
KYEGEGWA,2024,650,610,1260,64
KYEGEGWA,2025,700,660,1360,64
KYENJOJO,2015,450,570,1020,64
KYENJOJO,2016,470,590,1060,64
KYENJOJO,2017,490,610,1100,64
KYENJOJO,2018,510,630,1140,64
KYENJOJO,2019,530,660,1190,64
KYENJOJO,2020,550,680,1230,64
KYENJOJO,2021,570,700,1270,64
KYENJOJO,2022,590,730,1320,64
KYENJOJO,2023,620,750,1370,64
KYENJOJO,2024,640,780,1420,64
KYENJOJO,2025,660,800,1460,64
KYOTERA,2015,320,420,740,64
KYOTERA,2016,330,440,770,64
KYOTERA,2017,320,420,740,64
KYOTERA,2018,310,390,700,64
KYOTERA,2019,290,360,650,64
KYOTERA,2020,280,340,620,64
KYOTERA,2021,290,340,630,64
KYOTERA,2022,320,380,700,64
KYOTERA,2023,350,430,780,64
KYOTERA,2024,400,490,890,64
KYOTERA,2025,430,560,990,64
KARENGA,2015,90,90,180,64
KARENGA,2016,90,90,180,64
KARENGA,2017,90,90,180,64
KARENGA,2018,90,90,180,64
KARENGA,2019,90,90,180,64
KARENGA,2020,100,100,200,64
KARENGA,2021,100,100,200,64
KARENGA,2022,100,100,200,64
KARENGA,2023,100,100,200,64
KARENGA,2024,110,110,220,64
KARENGA,2025,110,110,220,64
LAMWO,2015,130,190,320,64
LAMWO,2016,130,190,320,64
LAMWO,2017,120,190,310,64
LAMWO,2018,120,180,300,64
LAMWO,2019,110,160,270,64
LAMWO,2020,100,150,250,64
LAMWO,2021,110,150,260,64
LAMWO,2022,120,180,300,64
LAMWO,2023,130,200,330,64
LAMWO,2024,150,230,380,64
LAMWO,2025,160,250,410,64
LIRA,2015,330,440,770,64
LIRA,2016,340,460,800,64
LIRA,2017,350,470,820,64
LIRA,2018,360,480,840,64
LIRA,2019,370,500,870,64
LIRA,2020,380,510,890,64
LIRA,2021,390,520,910,64
LIRA,2022,400,540,940,64
LIRA,2023,410,550,960,64
LIRA,2024,420,560,980,64
LIRA,2025,430,580,1010,64
LUUKA,2015,230,350,580,64
LUUKA,2016,230,370,600,64
LUUKA,2017,230,350,580,64
LUUKA,2018,220,330,550,64
LUUKA,2019,220,300,520,64
LUUKA,2020,210,290,500,64
LUUKA,2021,220,300,520,64
LUUKA,2022,230,330,560,64
LUUKA,2023,270,380,650,64
LUUKA,2024,300,430,730,64
LUUKA,2025,330,490,820,64
LUWERO,2015,460,560,1020,64
LUWERO,2016,470,570,1040,64
LUWERO,2017,470,560,1030,64
LUWERO,2018,450,540,990,64
LUWERO,2019,430,490,920,64
LUWERO,2020,420,470,890,64
LUWERO,2021,440,470,910,64
LUWERO,2022,480,530,1010,64
LUWERO,2023,550,610,1160,64
LUWERO,2024,610,710,1320,64
LUWERO,2025,670,790,1460,64
LWENGO,2015,330,430,760,64
LWENGO,2016,330,440,770,64
LWENGO,2017,330,420,750,64
LWENGO,2018,310,390,700,64
LWENGO,2019,290,360,650,64
LWENGO,2020,280,330,610,64
LWENGO,2021,290,340,630,64
LWENGO,2022,310,370,680,64
LWENGO,2023,340,420,760,64
LWENGO,2024,390,480,870,64
LWENGO,2025,420,530,950,64
LYANTONDE,2015,100,120,220,64
LYANTONDE,2016,110,130,240,64
LYANTONDE,2017,100,120,220,64
LYANTONDE,2018,100,120,220,64
LYANTONDE,2019,100,110,210,64
LYANTONDE,2020,90,100,190,64
LYANTONDE,2021,100,110,210,64
LYANTONDE,2022,110,120,230,64
LYANTONDE,2023,120,140,260,64
LYANTONDE,2024,140,170,310,64
LYANTONDE,2025,160,190,350,64
MANAFWA,2015,260,290,550,64
MANAFWA,2016,270,300,570,64
MANAFWA,2017,280,300,580,64
MANAFWA,2018,280,310,590,64
MANAFWA,2019,290,320,610,64
MANAFWA,2020,300,320,620,64
MANAFWA,2021,300,330,630,64
MANAFWA,2022,310,340,650,64
MANAFWA,2023,320,340,660,64
MANAFWA,2024,320,350,670,64
MANAFWA,2025,330,350,680,64
MARACHA,2015,210,310,520,64
MARACHA,2016,220,320,540,64
MARACHA,2017,220,320,540,64
MARACHA,2018,230,330,560,64
MARACHA,2019,230,340,570,64
MARACHA,2020,230,340,570,64
MARACHA,2021,240,350,590,64
MARACHA,2022,240,350,590,64
MARACHA,2023,250,360,610,64
MARACHA,2024,250,370,620,64
MARACHA,2025,260,370,630,64
MASAKA,2015,230,270,500,64
MASAKA,2016,250,310,560,64
MASAKA,2017,260,330,590,64
MASAKA,2018,270,350,620,64
MASAKA,2019,260,330,590,64
MASAKA,2020,260,320,580,64
MASAKA,2021,240,290,530,64
MASAKA,2022,240,270,510,64
MASAKA,2023,240,280,520,64
MASAKA,2024,270,310,580,64
MASAKA,2025,300,360,660,64
MASINDI,2015,260,280,540,64
MASINDI,2016,270,280,550,64
MASINDI,2017,280,290,570,64
MASINDI,2018,280,300,580,64
MASINDI,2019,290,310,600,64
MASINDI,2020,300,310,610,64
MASINDI,2021,310,320,630,64
MASINDI,2022,320,330,650,64
MASINDI,2023,320,340,660,64
MASINDI,2024,330,340,670,64
MASINDI,2025,340,350,690,64
MAYUGE,2015,480,520,1000,64
MAYUGE,2016,500,540,1040,64
MAYUGE,2017,490,530,1020,64
MAYUGE,2018,480,510,990,64
MAYUGE,2019,470,470,940,64
MAYUGE,2020,460,450,910,64
MAYUGE,2021,480,460,940,64
MAYUGE,2022,520,520,1040,64
MAYUGE,2023,600,610,1210,64
MAYUGE,2024,680,710,1390,64
MAYUGE,2025,750,810,1560,64
MBALE,2015,680,820,1500,64
MBALE,2016,700,850,1550,64
MBALE,2017,690,830,1520,64
MBALE,2018,680,800,1480,64
MBALE,2019,650,740,1390,64
MBALE,2020,650,710,1360,64
MBALE,2021,670,740,1410,64
MBALE,2022,740,830,1570,64
MBALE,2023,830,970,1800,64
MBALE,2024,940,1150,2090,64
MBALE,2025,1050,1280,2330,64
MBARARA,2015,350,410,760,64
MBARARA,2016,360,420,780,64
MBARARA,2017,360,420,780,64
MBARARA,2018,370,430,800,64
MBARARA,2019,380,440,820,64
MBARARA,2020,390,450,840,64
MBARARA,2021,400,460,860,64
MBARARA,2022,400,470,870,64
MBARARA,2023,410,480,890,64
MBARARA,2024,420,490,910,64
MBARARA,2025,430,490,920,64
MITOOMA,2015,220,280,500,64
MITOOMA,2016,220,290,510,64
MITOOMA,2017,230,290,520,64
MITOOMA,2018,230,290,520,64
MITOOMA,2019,230,290,520,64
MITOOMA,2020,230,300,530,64
MITOOMA,2021,240,300,540,64
MITOOMA,2022,240,300,540,64
MITOOMA,2023,240,300,540,64
MITOOMA,2024,240,300,540,64
MITOOMA,2025,240,300,540,64
MITYANA,2015,420,520,940,64
MITYANA,2016,430,540,970,64
MITYANA,2017,430,530,960,64
MITYANA,2018,420,500,920,64
MITYANA,2019,390,450,840,64
MITYANA,2020,380,420,800,64
MITYANA,2021,390,430,820,64
MITYANA,2022,430,470,900,64
MITYANA,2023,470,550,1020,64
MITYANA,2024,530,640,1170,64
MITYANA,2025,590,700,1290,64
MOROTO,2015,150,240,390,64
MOROTO,2016,150,240,390,64
MOROTO,2017,140,240,380,64
MOROTO,2018,140,220,360,64
MOROTO,2019,140,210,350,64
MOROTO,2020,130,190,320,64
MOROTO,2021,140,200,340,64
MOROTO,2022,150,220,370,64
MOROTO,2023,160,260,420,64
MOROTO,2024,190,300,490,64
MOROTO,2025,210,340,550,64
MOYO,2015,120,130,250,64
MOYO,2016,120,140,260,64
MOYO,2017,120,140,260,64
MOYO,2018,130,140,270,64
MOYO,2019,130,140,270,64
MOYO,2020,130,150,280,64
MOYO,2021,130,150,280,64
MOYO,2022,140,150,290,64
MOYO,2023,140,160,300,64
MOYO,2024,140,160,300,64
MOYO,2025,150,160,310,64
MPIGI,2015,260,310,570,64
MPIGI,2016,280,310,590,64
MPIGI,2017,280,310,590,64
MPIGI,2018,260,290,550,64
MPIGI,2019,250,260,510,64
MPIGI,2020,250,250,500,64
MPIGI,2021,250,260,510,64
MPIGI,2022,280,290,570,64
MPIGI,2023,320,340,660,64
MPIGI,2024,350,390,740,64
MPIGI,2025,390,440,830,64
MUBENDE,2015,430,470,900,64
MUBENDE,2016,450,490,940,64
MUBENDE,2017,460,500,960,64
MUBENDE,2018,460,490,950,64
MUBENDE,2019,450,460,910,64
MUBENDE,2020,460,450,910,64
MUBENDE,2021,490,470,960,64
MUBENDE,2022,550,540,1090,64
MUBENDE,2023,640,640,1280,64
MUBENDE,2024,740,770,1510,64
MUBENDE,2025,830,890,1720,64
MUKONO,2015,540,730,1270,64
MUKONO,2016,560,760,1320,64
MUKONO,2017,550,750,1300,64
MUKONO,2018,540,700,1240,64
MUKONO,2019,510,650,1160,64
MUKONO,2020,510,620,1130,64
MUKONO,2021,520,640,1160,64
MUKONO,2022,580,720,1300,64
MUKONO,2023,650,830,1480,64
MUKONO,2024,740,980,1720,64
MUKONO,2025,810,1100,1910,64
MADI OKOLLO,2015,150,160,310,64
MADI OKOLLO,2016,160,170,330,64
MADI OKOLLO,2017,160,170,330,64
MADI OKOLLO,2018,170,180,350,64
MADI OKOLLO,2019,170,180,350,64
MADI OKOLLO,2020,180,190,370,64
MADI OKOLLO,2021,180,190,370,64
MADI OKOLLO,2022,190,190,380,64
MADI OKOLLO,2023,190,200,390,64
MADI OKOLLO,2024,200,200,400,64
MADI OKOLLO,2025,200,210,410,64
NABILATUK,2015,80,150,230,64
NABILATUK,2016,100,150,250,64
NABILATUK,2017,90,150,240,64
NABILATUK,2018,100,140,240,64
NABILATUK,2019,90,140,230,64
NABILATUK,2020,90,140,230,64
NABILATUK,2021,100,140,240,64
NABILATUK,2022,110,160,270,64
NABILATUK,2023,120,190,310,64
NABILATUK,2024,150,220,370,64
NABILATUK,2025,160,250,410,64
NAKAPIRIPIRIT,2015,150,250,400,64
NAKAPIRIPIRIT,2016,150,260,410,64
NAKAPIRIPIRIT,2017,150,260,410,64
NAKAPIRIPIRIT,2018,150,250,400,64
NAKAPIRIPIRIT,2019,140,240,380,64
NAKAPIRIPIRIT,2020,150,230,380,64
NAKAPIRIPIRIT,2021,160,240,400,64
NAKAPIRIPIRIT,2022,170,270,440,64
NAKAPIRIPIRIT,2023,200,320,520,64
NAKAPIRIPIRIT,2024,230,370,600,64
NAKAPIRIPIRIT,2025,260,440,700,64
NAKASEKE,2015,210,180,390,64
NAKASEKE,2016,220,190,410,64
NAKASEKE,2017,230,190,420,64
NAKASEKE,2018,230,200,430,64
NAKASEKE,2019,240,200,440,64
NAKASEKE,2020,250,210,460,64
NAKASEKE,2021,260,210,470,64
NAKASEKE,2022,270,210,480,64
NAKASEKE,2023,280,220,500,64
NAKASEKE,2024,290,220,510,64
NAKASEKE,2025,290,230,520,64
NAKASONGOLA,2015,200,170,370,64
NAKASONGOLA,2016,210,180,390,64
NAKASONGOLA,2017,210,180,390,64
NAKASONGOLA,2018,200,160,360,64
NAKASONGOLA,2019,200,160,360,64
NAKASONGOLA,2020,200,140,340,64
NAKASONGOLA,2021,200,150,350,64
NAKASONGOLA,2022,220,170,390,64
NAKASONGOLA,2023,260,200,460,64
NAKASONGOLA,2024,280,230,510,64
NAKASONGOLA,2025,320,250,570,64
NAMAYINGO,2015,240,280,520,64
NAMAYINGO,2016,250,290,540,64
NAMAYINGO,2017,250,290,540,64
NAMAYINGO,2018,240,260,500,64
NAMAYINGO,2019,230,240,470,64
NAMAYINGO,2020,220,230,450,64
NAMAYINGO,2021,230,230,460,64
NAMAYINGO,2022,240,250,490,64
NAMAYINGO,2023,280,300,580,64
NAMAYINGO,2024,310,340,650,64
NAMAYINGO,2025,340,370,710,64
NAMISINDWA,2015,310,400,710,64
NAMISINDWA,2016,320,410,730,64
NAMISINDWA,2017,330,420,750,64
NAMISINDWA,2018,340,430,770,64
NAMISINDWA,2019,340,440,780,64
NAMISINDWA,2020,350,450,800,64
NAMISINDWA,2021,360,460,820,64
NAMISINDWA,2022,370,470,840,64
NAMISINDWA,2023,380,480,860,64
NAMISINDWA,2024,390,490,880,64
NAMISINDWA,2025,400,500,900,64
NAMUTUMBA,2015,350,330,680,64
NAMUTUMBA,2016,360,340,700,64
NAMUTUMBA,2017,360,340,700,64
NAMUTUMBA,2018,350,320,670,64
NAMUTUMBA,2019,340,300,640,64
NAMUTUMBA,2020,340,290,630,64
NAMUTUMBA,2021,350,300,650,64
NAMUTUMBA,2022,390,330,720,64
NAMUTUMBA,2023,440,390,830,64
NAMUTUMBA,2024,500,470,970,64
NAMUTUMBA,2025,560,530,1090,64
NAPAK,2015,200,320,520,64
NAPAK,2016,200,330,530,64
NAPAK,2017,200,320,520,64
NAPAK,2018,190,300,490,64
NAPAK,2019,180,270,450,64
NAPAK,2020,180,260,440,64
NAPAK,2021,180,270,450,64
NAPAK,2022,200,300,500,64
NAPAK,2023,230,350,580,64
NAPAK,2024,250,400,650,64
NAPAK,2025,270,450,720,64
NEBBI,2015,260,340,600,64
NEBBI,2016,270,350,620,64
NEBBI,2017,280,360,640,64
NEBBI,2018,290,370,660,64
NEBBI,2019,300,380,680,64
NEBBI,2020,310,390,700,64
NEBBI,2021,320,400,720,64
NEBBI,2022,330,410,740,64
NEBBI,2023,330,420,750,64
NEBBI,2024,340,430,770,64
NEBBI,2025,350,440,790,64
NGORA,2015,160,190,350,64
NGORA,2016,160,190,350,64
NGORA,2017,160,190,350,64
NGORA,2018,150,180,330,64
NGORA,2019,150,160,310,64
NGORA,2020,150,160,310,64
NGORA,2021,150,160,310,64
NGORA,2022,170,190,360,64
NGORA,2023,190,210,400,64
NGORA,2024,220,250,470,64
NGORA,2025,230,280,510,64
NTOROKO,2015,70,60,130,64
NTOROKO,2016,70,60,130,64
NTOROKO,2017,80,50,130,64
NTOROKO,2018,80,50,130,64
NTOROKO,2019,70,50,120,64
NTOROKO,2020,70,40,110,64
NTOROKO,2021,70,50,120,64
NTOROKO,2022,70,60,130,64
NTOROKO,2023,90,60,150,64
NTOROKO,2024,100,70,170,64
NTOROKO,2025,110,80,190,64
NTUNGAMO,2015,540,690,1230,64
NTUNGAMO,2016,550,700,1250,64
NTUNGAMO,2017,560,710,1270,64
NTUNGAMO,2018,570,720,1290,64
NTUNGAMO,2019,590,740,1330,64
NTUNGAMO,2020,600,750,1350,64
NTUNGAMO,2021,610,760,1370,64
NTUNGAMO,2022,620,770,1390,64
NTUNGAMO,2023,630,790,1420,64
NTUNGAMO,2024,640,800,1440,64
NTUNGAMO,2025,650,810,1460,64
NWOYA,2015,120,120,240,64
NWOYA,2016,130,140,270,64
NWOYA,2017,150,150,300,64
NWOYA,2018,160,170,330,64
NWOYA,2019,180,180,360,64
NWOYA,2020,200,200,400,64
NWOYA,2021,220,220,440,64
NWOYA,2022,240,240,480,64
NWOYA,2023,260,270,530,64
NWOYA,2024,290,290,580,64
NWOYA,2025,320,320,640,64
OBONGI,2015,40,50,90,64
OBONGI,2016,40,60,100,64
OBONGI,2017,50,50,100,64
OBONGI,2018,50,50,100,64
OBONGI,2019,50,50,100,64
OBONGI,2020,40,40,80,64
OBONGI,2021,40,40,80,64
OBONGI,2022,50,50,100,64
OBONGI,2023,50,50,100,64
OBONGI,2024,60,60,120,64
OBONGI,2025,60,70,130,64
OMORO,2015,150,200,350,64
OMORO,2016,160,220,380,64
OMORO,2017,150,220,370,64
OMORO,2018,150,200,350,64
OMORO,2019,140,190,330,64
OMORO,2020,150,190,340,64
OMORO,2021,150,190,340,64
OMORO,2022,170,210,380,64
OMORO,2023,190,250,440,64
OMORO,2024,220,300,520,64
OMORO,2025,240,330,570,64
OTUKE,2015,130,150,280,64
OTUKE,2016,140,160,300,64
OTUKE,2017,140,160,300,64
OTUKE,2018,150,170,320,64
OTUKE,2019,150,180,330,64
OTUKE,2020,160,190,350,64
OTUKE,2021,170,190,360,64
OTUKE,2022,170,200,370,64
OTUKE,2023,180,210,390,64
OTUKE,2024,190,220,410,64
OTUKE,2025,200,230,430,64
OYAM,2015,470,520,990,64
OYAM,2016,480,540,1020,64
OYAM,2017,500,550,1050,64
OYAM,2018,510,570,1080,64
OYAM,2019,530,590,1120,64
OYAM,2020,540,600,1140,64
OYAM,2021,560,620,1180,64
OYAM,2022,570,640,1210,64
OYAM,2023,590,650,1240,64
OYAM,2024,600,670,1270,64
OYAM,2025,620,690,1310,64
PADER,2015,130,180,310,64
PADER,2016,140,180,320,64
PADER,2017,130,190,320,64
PADER,2018,130,170,300,64
PADER,2019,120,160,280,64
PADER,2020,120,150,270,64
PADER,2021,120,150,270,64
PADER,2022,130,170,300,64
PADER,2023,140,190,330,64
PADER,2024,160,230,390,64
PADER,2025,180,250,430,64
PAKWACH,2015,150,230,380,64
PAKWACH,2016,160,240,400,64
PAKWACH,2017,160,250,410,64
PAKWACH,2018,170,260,430,64
PAKWACH,2019,180,270,450,64
PAKWACH,2020,180,270,450,64
PAKWACH,2021,190,280,470,64
PAKWACH,2022,200,290,490,64
PAKWACH,2023,210,300,510,64
PAKWACH,2024,210,310,520,64
PAKWACH,2025,220,320,540,64
PALLISA,2015,320,390,710,64
PALLISA,2016,330,410,740,64
PALLISA,2017,340,410,750,64
PALLISA,2018,330,390,720,64
PALLISA,2019,320,370,690,64
PALLISA,2020,320,360,680,64
PALLISA,2021,340,370,710,64
PALLISA,2022,370,430,800,64
PALLISA,2023,430,510,940,64
PALLISA,2024,500,600,1100,64
PALLISA,2025,560,680,1240,64
RAKAI,2015,350,430,780,64
RAKAI,2016,360,440,800,64
RAKAI,2017,360,430,790,64
RAKAI,2018,350,400,750,64
RAKAI,2019,330,370,700,64
RAKAI,2020,330,360,690,64
RAKAI,2021,340,360,700,64
RAKAI,2022,370,410,780,64
RAKAI,2023,420,480,900,64
RAKAI,2024,480,540,1020,64
RAKAI,2025,530,610,1140,64
RUBANDA,2015,250,400,650,64
RUBANDA,2016,250,400,650,64
RUBANDA,2017,260,400,660,64
RUBANDA,2018,260,410,670,64
RUBANDA,2019,260,410,670,64
RUBANDA,2020,260,410,670,64
RUBANDA,2021,270,410,680,64
RUBANDA,2022,270,420,690,64
RUBANDA,2023,270,420,690,64
RUBANDA,2024,280,420,700,64
RUBANDA,2025,280,420,700,64
RUBIRIZI,2015,140,200,340,64
RUBIRIZI,2016,150,200,350,64
RUBIRIZI,2017,150,210,360,64
RUBIRIZI,2018,150,210,360,64
RUBIRIZI,2019,150,210,360,64
RUBIRIZI,2020,160,220,380,64
RUBIRIZI,2021,160,220,380,64
RUBIRIZI,2022,160,230,390,64
RUBIRIZI,2023,170,230,400,64
RUBIRIZI,2024,170,230,400,64
RUBIRIZI,2025,170,240,410,64
RUKIGA,2015,150,180,330,64
RUKIGA,2016,150,180,330,64
RUKIGA,2017,150,180,330,64
RUKIGA,2018,150,190,340,64
RUKIGA,2019,160,190,350,64
RUKIGA,2020,160,190,350,64
RUKIGA,2021,160,190,350,64
RUKIGA,2022,160,190,350,64
RUKIGA,2023,160,190,350,64
RUKIGA,2024,160,190,350,64
RUKIGA,2025,160,190,350,64
RUKUNGIRI,2015,390,550,940,64
RUKUNGIRI,2016,390,550,940,64
RUKUNGIRI,2017,400,560,960,64
RUKUNGIRI,2018,400,560,960,64
RUKUNGIRI,2019,410,570,980,64
RUKUNGIRI,2020,410,570,980,64
RUKUNGIRI,2021,420,580,1000,64
RUKUNGIRI,2022,420,580,1000,64
RUKUNGIRI,2023,420,590,1010,64
RUKUNGIRI,2024,430,590,1020,64
RUKUNGIRI,2025,430,590,1020,64
RWAMPARA,2015,140,170,310,64
RWAMPARA,2016,140,170,310,64
RWAMPARA,2017,150,170,320,64
RWAMPARA,2018,150,180,330,64
RWAMPARA,2019,150,180,330,64
RWAMPARA,2020,160,190,350,64
RWAMPARA,2021,160,190,350,64
RWAMPARA,2022,160,190,350,64
RWAMPARA,2023,170,200,370,64
RWAMPARA,2024,170,200,370,64
RWAMPARA,2025,170,200,370,64
SERERE,2015,310,370,680,64
SERERE,2016,320,400,720,64
SERERE,2017,320,400,720,64
SERERE,2018,310,370,680,64
SERERE,2019,310,360,670,64
SERERE,2020,300,340,640,64
SERERE,2021,310,360,670,64
SERERE,2022,350,400,750,64
SERERE,2023,400,480,880,64
SERERE,2024,470,550,1020,64
SERERE,2025,510,640,1150,64
SHEEMA,2015,250,350,600,64
SHEEMA,2016,260,360,620,64
SHEEMA,2017,260,360,620,64
SHEEMA,2018,260,370,630,64
SHEEMA,2019,270,370,640,64
SHEEMA,2020,270,370,640,64
SHEEMA,2021,270,380,650,64
SHEEMA,2022,270,380,650,64
SHEEMA,2023,280,380,660,64
SHEEMA,2024,280,380,660,64
SHEEMA,2025,280,390,670,64
SIRONKO,2015,430,470,900,64
SIRONKO,2016,440,480,920,64
SIRONKO,2017,450,490,940,64
SIRONKO,2018,460,500,960,64
SIRONKO,2019,470,510,980,64
SIRONKO,2020,480,520,1000,64
SIRONKO,2021,490,530,1020,64
SIRONKO,2022,500,540,1040,64
SIRONKO,2023,510,550,1060,64
SIRONKO,2024,520,560,1080,64
SIRONKO,2025,530,560,1090,64
SOROTI,2015,240,330,570,64
SOROTI,2016,250,340,590,64
SOROTI,2017,260,340,600,64
SOROTI,2018,250,330,580,64
SOROTI,2019,240,310,550,64
SOROTI,2020,240,300,540,64
SOROTI,2021,250,300,550,64
SOROTI,2022,280,340,620,64
SOROTI,2023,320,400,720,64
SOROTI,2024,360,470,830,64
SOROTI,2025,400,540,940,64
SSEMBABULE,2015,320,320,640,64
SSEMBABULE,2016,330,330,660,64
SSEMBABULE,2017,330,330,660,64
SSEMBABULE,2018,320,310,630,64
SSEMBABULE,2019,310,290,600,64
SSEMBABULE,2020,300,270,570,64
SSEMBABULE,2021,310,280,590,64
SSEMBABULE,2022,350,320,670,64
SSEMBABULE,2023,390,370,760,64
SSEMBABULE,2024,440,430,870,64
SSEMBABULE,2025,490,480,970,64
TORORO,2015,640,790,1430,64
TORORO,2016,650,810,1460,64
TORORO,2017,670,830,1500,64
TORORO,2018,690,850,1540,64
TORORO,2019,700,870,1570,64
TORORO,2020,720,890,1610,64
TORORO,2021,740,910,1650,64
TORORO,2022,760,930,1690,64
TORORO,2023,770,950,1720,64
TORORO,2024,790,970,1760,64
TORORO,2025,810,990,1800,64
WAKISO,2015,1160,1390,2550,64
WAKISO,2016,1230,1480,2710,64
WAKISO,2017,1320,1580,2900,64
WAKISO,2018,1410,1690,3100,64
WAKISO,2019,1500,1800,3300,64
WAKISO,2020,1600,1920,3520,64
WAKISO,2021,1700,2050,3750,64
WAKISO,2022,1810,2190,4000,64
WAKISO,2023,1920,2330,4250,64
WAKISO,2024,2040,2480,4520,64
WAKISO,2025,2170,2630,4800,64
YUMBE,2015,400,440,840,64
YUMBE,2016,420,470,890,64
YUMBE,2017,430,470,900,64
YUMBE,2018,430,470,900,64
YUMBE,2019,420,450,870,64
YUMBE,2020,420,430,850,64
YUMBE,2021,450,460,910,64
YUMBE,2022,500,530,1030,64
YUMBE,2023,590,640,1230,64
YUMBE,2024,680,770,1450,64
YUMBE,2025,760,890,1650,64
ZOMBO,2015,260,400,660,64
ZOMBO,2016,260,410,670,64
ZOMBO,2017,270,420,690,64
ZOMBO,2018,280,430,710,64
ZOMBO,2019,290,440,730,64
ZOMBO,2020,300,450,750,64
ZOMBO,2021,310,470,780,64
ZOMBO,2022,310,480,790,64
ZOMBO,2023,320,490,810,64
ZOMBO,2024,330,500,830,64
ZOMBO,2025,340,510,850,64
ABIM,2015,90,100,190,65
ABIM,2016,110,110,220,65
ABIM,2017,120,120,240,65
ABIM,2018,120,120,240,65
ABIM,2019,120,120,240,65
ABIM,2020,120,110,230,65
ABIM,2021,120,110,230,65
ABIM,2022,130,120,250,65
ABIM,2023,150,130,280,65
ABIM,2024,170,160,330,65
ABIM,2025,200,190,390,65
ADJUMANI,2015,170,320,490,65
ADJUMANI,2016,170,330,500,65
ADJUMANI,2017,170,330,500,65
ADJUMANI,2018,170,330,500,65
ADJUMANI,2019,170,330,500,65
ADJUMANI,2020,170,340,510,65
ADJUMANI,2021,170,340,510,65
ADJUMANI,2022,170,340,510,65
ADJUMANI,2023,170,340,510,65
ADJUMANI,2024,170,350,520,65
ADJUMANI,2025,170,350,520,65
AGAGO,2015,250,410,660,65
AGAGO,2016,260,420,680,65
AGAGO,2017,260,420,680,65
AGAGO,2018,270,430,700,65
AGAGO,2019,270,440,710,65
AGAGO,2020,280,440,720,65
AGAGO,2021,280,450,730,65
AGAGO,2022,290,460,750,65
AGAGO,2023,290,460,750,65
AGAGO,2024,290,470,760,65
AGAGO,2025,300,480,780,65
ALEBTONG,2015,250,370,620,65
ALEBTONG,2016,270,400,670,65
ALEBTONG,2017,270,420,690,65
ALEBTONG,2018,270,410,680,65
ALEBTONG,2019,270,390,660,65
ALEBTONG,2020,260,360,620,65
ALEBTONG,2021,250,340,590,65
ALEBTONG,2022,260,350,610,65
ALEBTONG,2023,290,390,680,65
ALEBTONG,2024,330,450,780,65
ALEBTONG,2025,360,530,890,65
AMOLATAR,2015,120,160,280,65
AMOLATAR,2016,130,160,290,65
AMOLATAR,2017,130,170,300,65
AMOLATAR,2018,130,170,300,65
AMOLATAR,2019,130,160,290,65
AMOLATAR,2020,120,150,270,65
AMOLATAR,2021,120,140,260,65
AMOLATAR,2022,120,140,260,65
AMOLATAR,2023,130,160,290,65
AMOLATAR,2024,160,180,340,65
AMOLATAR,2025,170,220,390,65
AMUDAT,2015,110,90,200,65
AMUDAT,2016,120,90,210,65
AMUDAT,2017,120,100,220,65
AMUDAT,2018,130,100,230,65
AMUDAT,2019,130,100,230,65
AMUDAT,2020,120,90,210,65
AMUDAT,2021,120,90,210,65
AMUDAT,2022,120,90,210,65
AMUDAT,2023,140,100,240,65
AMUDAT,2024,160,120,280,65
AMUDAT,2025,180,140,320,65
AMURIA,2015,170,270,440,65
AMURIA,2016,180,300,480,65
AMURIA,2017,190,320,510,65
AMURIA,2018,190,310,500,65
AMURIA,2019,190,290,480,65
AMURIA,2020,180,280,460,65
AMURIA,2021,180,260,440,65
AMURIA,2022,180,270,450,65
AMURIA,2023,200,310,510,65
AMURIA,2024,230,360,590,65
AMURIA,2025,270,430,700,65
AMURU,2015,150,270,420,65
AMURU,2016,150,300,450,65
AMURU,2017,150,310,460,65
AMURU,2018,150,300,450,65
AMURU,2019,150,290,440,65
AMURU,2020,140,260,400,65
AMURU,2021,140,250,390,65
AMURU,2022,150,260,410,65
AMURU,2023,160,290,450,65
AMURU,2024,180,340,520,65
AMURU,2025,200,390,590,65
APAC,2015,300,450,750,65
APAC,2016,310,470,780,65
APAC,2017,320,490,810,65
APAC,2018,340,500,840,65
APAC,2019,350,520,870,65
APAC,2020,360,540,900,65
APAC,2021,370,560,930,65
APAC,2022,390,570,960,65
APAC,2023,400,590,990,65
APAC,2024,410,610,1020,65
APAC,2025,420,630,1050,65
ARUA,2015,830,1210,2040,65
ARUA,2016,850,1240,2090,65
ARUA,2017,870,1270,2140,65
ARUA,2018,900,1310,2210,65
ARUA,2019,930,1340,2270,65
ARUA,2020,950,1380,2330,65
ARUA,2021,980,1410,2390,65
ARUA,2022,1000,1440,2440,65
ARUA,2023,1030,1480,2510,65
ARUA,2024,1050,1510,2560,65
ARUA,2025,1080,1550,2630,65
BUDAKA,2015,190,230,420,65
BUDAKA,2016,190,250,440,65
BUDAKA,2017,200,270,470,65
BUDAKA,2018,210,260,470,65
BUDAKA,2019,200,250,450,65
BUDAKA,2020,200,230,430,65
BUDAKA,2021,200,220,420,65
BUDAKA,2022,200,230,430,65
BUDAKA,2023,220,260,480,65
BUDAKA,2024,250,310,560,65
BUDAKA,2025,290,360,650,65
BUDUDA,2015,150,180,330,65
BUDUDA,2016,170,200,370,65
BUDUDA,2017,180,210,390,65
BUDUDA,2018,180,210,390,65
BUDUDA,2019,180,200,380,65
BUDUDA,2020,170,180,350,65
BUDUDA,2021,170,180,350,65
BUDUDA,2022,180,190,370,65
BUDUDA,2023,200,210,410,65
BUDUDA,2024,230,260,490,65
BUDUDA,2025,270,310,580,65
BUGIRI,2015,300,350,650,65
BUGIRI,2016,330,390,720,65
BUGIRI,2017,350,410,760,65
BUGIRI,2018,340,410,750,65
BUGIRI,2019,340,390,730,65
BUGIRI,2020,320,360,680,65
BUGIRI,2021,330,350,680,65
BUGIRI,2022,340,360,700,65
BUGIRI,2023,380,410,790,65
BUGIRI,2024,440,480,920,65
BUGIRI,2025,500,570,1070,65
BUGWERI,2015,170,160,330,65
BUGWERI,2016,180,170,350,65
BUGWERI,2017,190,180,370,65
BUGWERI,2018,190,170,360,65
BUGWERI,2019,180,170,350,65
BUGWERI,2020,170,150,320,65
BUGWERI,2021,170,150,320,65
BUGWERI,2022,180,150,330,65
BUGWERI,2023,190,170,360,65
BUGWERI,2024,220,190,410,65
BUGWERI,2025,250,230,480,65
BUHWEJU,2015,110,140,250,65
BUHWEJU,2016,110,150,260,65
BUHWEJU,2017,120,150,270,65
BUHWEJU,2018,120,150,270,65
BUHWEJU,2019,120,160,280,65
BUHWEJU,2020,130,160,290,65
BUHWEJU,2021,130,170,300,65
BUHWEJU,2022,140,170,310,65
BUHWEJU,2023,140,180,320,65
BUHWEJU,2024,140,180,320,65
BUHWEJU,2025,150,190,340,65
BUIKWE,2015,420,450,870,65
BUIKWE,2016,440,490,930,65
BUIKWE,2017,450,510,960,65
BUIKWE,2018,440,490,930,65
BUIKWE,2019,430,460,890,65
BUIKWE,2020,410,420,830,65
BUIKWE,2021,400,400,800,65
BUIKWE,2022,410,400,810,65
BUIKWE,2023,450,460,910,65
BUIKWE,2024,500,530,1030,65
BUIKWE,2025,560,610,1170,65
BUKEDEA,2015,210,300,510,65
BUKEDEA,2016,230,330,560,65
BUKEDEA,2017,240,340,580,65
BUKEDEA,2018,250,340,590,65
BUKEDEA,2019,240,330,570,65
BUKEDEA,2020,230,300,530,65
BUKEDEA,2021,240,290,530,65
BUKEDEA,2022,250,310,560,65
BUKEDEA,2023,270,350,620,65
BUKEDEA,2024,320,410,730,65
BUKEDEA,2025,360,490,850,65
BUKOMANSIMBI,2015,190,260,450,65
BUKOMANSIMBI,2016,190,280,470,65
BUKOMANSIMBI,2017,200,280,480,65
BUKOMANSIMBI,2018,200,270,470,65
BUKOMANSIMBI,2019,190,250,440,65
BUKOMANSIMBI,2020,170,220,390,65
BUKOMANSIMBI,2021,170,210,380,65
BUKOMANSIMBI,2022,170,210,380,65
BUKOMANSIMBI,2023,190,230,420,65
BUKOMANSIMBI,2024,210,260,470,65
BUKOMANSIMBI,2025,230,300,530,65
BUKWO,2015,70,60,130,65
BUKWO,2016,70,70,140,65
BUKWO,2017,70,70,140,65
BUKWO,2018,80,70,150,65
BUKWO,2019,80,80,160,65
BUKWO,2020,90,80,170,65
BUKWO,2021,90,80,170,65
BUKWO,2022,90,90,180,65
BUKWO,2023,100,90,190,65
BUKWO,2024,100,90,190,65
BUKWO,2025,110,100,210,65
BULAMBULI,2015,190,190,380,65
BULAMBULI,2016,200,210,410,65
BULAMBULI,2017,210,220,430,65
BULAMBULI,2018,220,220,440,65
BULAMBULI,2019,220,210,430,65
BULAMBULI,2020,210,200,410,65
BULAMBULI,2021,220,200,420,65
BULAMBULI,2022,230,200,430,65
BULAMBULI,2023,250,230,480,65
BULAMBULI,2024,290,280,570,65
BULAMBULI,2025,330,330,660,65
BULIISA,2015,100,120,220,65
BULIISA,2016,110,120,230,65
BULIISA,2017,120,130,250,65
BULIISA,2018,120,140,260,65
BULIISA,2019,130,140,270,65
BULIISA,2020,140,150,290,65
BULIISA,2021,140,150,290,65
BULIISA,2022,150,160,310,65
BULIISA,2023,160,170,330,65
BULIISA,2024,170,170,340,65
BULIISA,2025,170,180,350,65
BUNDIBUGYO,2015,230,280,510,65
BUNDIBUGYO,2016,250,300,550,65
BUNDIBUGYO,2017,260,310,570,65
BUNDIBUGYO,2018,260,300,560,65
BUNDIBUGYO,2019,240,290,530,65
BUNDIBUGYO,2020,230,260,490,65
BUNDIBUGYO,2021,230,250,480,65
BUNDIBUGYO,2022,240,260,500,65
BUNDIBUGYO,2023,270,300,570,65
BUNDIBUGYO,2024,300,340,640,65
BUNDIBUGYO,2025,340,390,730,65
BUNYANGABU,2015,210,260,470,65
BUNYANGABU,2016,220,280,500,65
BUNYANGABU,2017,220,290,510,65
BUNYANGABU,2018,220,290,510,65
BUNYANGABU,2019,220,260,480,65
BUNYANGABU,2020,200,240,440,65
BUNYANGABU,2021,200,230,430,65
BUNYANGABU,2022,210,240,450,65
BUNYANGABU,2023,230,260,490,65
BUNYANGABU,2024,260,310,570,65
BUNYANGABU,2025,300,360,660,65
BUSHENYI,2015,280,390,670,65
BUSHENYI,2016,290,400,690,65
BUSHENYI,2017,290,400,690,65
BUSHENYI,2018,300,400,700,65
BUSHENYI,2019,300,410,710,65
BUSHENYI,2020,300,410,710,65
BUSHENYI,2021,300,410,710,65
BUSHENYI,2022,310,420,730,65
BUSHENYI,2023,310,420,730,65
BUSHENYI,2024,310,420,730,65
BUSHENYI,2025,310,420,730,65
BUSIA,2015,260,330,590,65
BUSIA,2016,270,370,640,65
BUSIA,2017,270,380,650,65
BUSIA,2018,280,370,650,65
BUSIA,2019,270,350,620,65
BUSIA,2020,260,330,590,65
BUSIA,2021,260,310,570,65
BUSIA,2022,270,320,590,65
BUSIA,2023,300,360,660,65
BUSIA,2024,340,420,760,65
BUSIA,2025,380,490,870,65
BUTALEJA,2015,220,210,430,65
BUTALEJA,2016,240,220,460,65
BUTALEJA,2017,250,230,480,65
BUTALEJA,2018,250,230,480,65
BUTALEJA,2019,240,220,460,65
BUTALEJA,2020,230,200,430,65
BUTALEJA,2021,230,200,430,65
BUTALEJA,2022,240,210,450,65
BUTALEJA,2023,270,230,500,65
BUTALEJA,2024,310,280,590,65
BUTALEJA,2025,350,320,670,65
BUTAMBALA,2015,120,150,270,65
BUTAMBALA,2016,120,160,280,65
BUTAMBALA,2017,120,170,290,65
BUTAMBALA,2018,120,160,280,65
BUTAMBALA,2019,120,150,270,65
BUTAMBALA,2020,110,130,240,65
BUTAMBALA,2021,110,120,230,65
BUTAMBALA,2022,110,130,240,65
BUTAMBALA,2023,120,140,260,65
BUTAMBALA,2024,130,160,290,65
BUTAMBALA,2025,150,180,330,65
BUTEBO,2015,80,120,200,65
BUTEBO,2016,80,120,200,65
BUTEBO,2017,80,120,200,65
BUTEBO,2018,80,120,200,65
BUTEBO,2019,80,110,190,65
BUTEBO,2020,80,110,190,65
BUTEBO,2021,70,100,170,65
BUTEBO,2022,70,100,170,65
BUTEBO,2023,80,110,190,65
BUTEBO,2024,90,120,210,65
BUTEBO,2025,100,140,240,65
BUVUMA,2015,80,40,120,65
BUVUMA,2016,90,40,130,65
BUVUMA,2017,90,40,130,65
BUVUMA,2018,100,50,150,65
BUVUMA,2019,100,50,150,65
BUVUMA,2020,110,50,160,65
BUVUMA,2021,120,60,180,65
BUVUMA,2022,120,60,180,65
BUVUMA,2023,130,70,200,65
BUVUMA,2024,140,70,210,65
BUVUMA,2025,150,70,220,65
BUYENDE,2015,240,230,470,65
BUYENDE,2016,260,250,510,65
BUYENDE,2017,270,270,540,65
BUYENDE,2018,270,260,530,65
BUYENDE,2019,270,260,530,65
BUYENDE,2020,260,240,500,65
BUYENDE,2021,270,230,500,65
BUYENDE,2022,280,240,520,65
BUYENDE,2023,310,280,590,65
BUYENDE,2024,350,320,670,65
BUYENDE,2025,410,380,790,65
DOKOLO,2015,220,330,550,65
DOKOLO,2016,230,330,560,65
DOKOLO,2017,240,340,580,65
DOKOLO,2018,240,350,590,65
DOKOLO,2019,250,360,610,65
DOKOLO,2020,260,370,630,65
DOKOLO,2021,270,380,650,65
DOKOLO,2022,270,390,660,65
DOKOLO,2023,280,400,680,65
DOKOLO,2024,290,410,700,65
DOKOLO,2025,290,420,710,65
GOMBA,2015,250,220,470,65
GOMBA,2016,270,230,500,65
GOMBA,2017,270,230,500,65
GOMBA,2018,260,230,490,65
GOMBA,2019,260,210,470,65
GOMBA,2020,240,190,430,65
GOMBA,2021,240,180,420,65
GOMBA,2022,240,180,420,65
GOMBA,2023,270,200,470,65
GOMBA,2024,290,230,520,65
GOMBA,2025,320,260,580,65
GULU,2015,200,440,640,65
GULU,2016,210,450,660,65
GULU,2017,220,470,690,65
GULU,2018,220,480,700,65
GULU,2019,230,490,720,65
GULU,2020,240,510,750,65
GULU,2021,240,520,760,65
GULU,2022,250,540,790,65
GULU,2023,260,550,810,65
GULU,2024,260,560,820,65
GULU,2025,270,580,850,65
HOIMA,2015,300,380,680,65
HOIMA,2016,320,400,720,65
HOIMA,2017,330,410,740,65
HOIMA,2018,340,420,760,65
HOIMA,2019,350,440,790,65
HOIMA,2020,370,450,820,65
HOIMA,2021,380,470,850,65
HOIMA,2022,390,480,870,65
HOIMA,2023,410,500,910,65
HOIMA,2024,420,510,930,65
HOIMA,2025,430,530,960,65
IBANDA,2015,280,390,670,65
IBANDA,2016,280,390,670,65
IBANDA,2017,290,400,690,65
IBANDA,2018,290,410,700,65
IBANDA,2019,300,410,710,65
IBANDA,2020,300,420,720,65
IBANDA,2021,310,430,740,65
IBANDA,2022,320,430,750,65
IBANDA,2023,320,440,760,65
IBANDA,2024,330,450,780,65
IBANDA,2025,330,450,780,65
IGANGA,2015,260,290,550,65
IGANGA,2016,270,310,580,65
IGANGA,2017,280,320,600,65
IGANGA,2018,290,320,610,65
IGANGA,2019,280,300,580,65
IGANGA,2020,270,280,550,65
IGANGA,2021,270,270,540,65
IGANGA,2022,280,280,560,65
IGANGA,2023,310,310,620,65
IGANGA,2024,350,360,710,65
IGANGA,2025,390,420,810,65
ISINGIRO,2015,530,780,1310,65
ISINGIRO,2016,550,810,1360,65
ISINGIRO,2017,570,840,1410,65
ISINGIRO,2018,590,870,1460,65
ISINGIRO,2019,610,900,1510,65
ISINGIRO,2020,630,930,1560,65
ISINGIRO,2021,660,960,1620,65
ISINGIRO,2022,680,990,1670,65
ISINGIRO,2023,700,1020,1720,65
ISINGIRO,2024,720,1050,1770,65
ISINGIRO,2025,750,1090,1840,65
JINJA,2015,430,570,1000,65
JINJA,2016,440,580,1020,65
JINJA,2017,450,590,1040,65
JINJA,2018,460,600,1060,65
JINJA,2019,460,610,1070,65
JINJA,2020,470,610,1080,65
JINJA,2021,480,620,1100,65
JINJA,2022,480,630,1110,65
JINJA,2023,490,640,1130,65
JINJA,2024,500,640,1140,65
JINJA,2025,500,650,1150,65
KAABONG,2015,120,90,210,65
KAABONG,2016,130,100,230,65
KAABONG,2017,130,100,230,65
KAABONG,2018,130,100,230,65
KAABONG,2019,140,100,240,65
KAABONG,2020,140,110,250,65
KAABONG,2021,140,110,250,65
KAABONG,2022,150,110,260,65
KAABONG,2023,150,110,260,65
KAABONG,2024,150,110,260,65
KAABONG,2025,160,120,280,65
KABALE,2015,300,440,740,65
KABALE,2016,310,440,750,65
KABALE,2017,310,450,760,65
KABALE,2018,320,450,770,65
KABALE,2019,320,460,780,65
KABALE,2020,330,460,790,65
KABALE,2021,330,470,800,65
KABALE,2022,340,470,810,65
KABALE,2023,340,480,820,65
KABALE,2024,340,480,820,65
KABALE,2025,350,480,830,65
KABAROLE,2015,410,480,890,65
KABAROLE,2016,420,490,910,65
KABAROLE,2017,430,500,930,65
KABAROLE,2018,430,510,940,65
KABAROLE,2019,440,530,970,65
KABAROLE,2020,450,540,990,65
KABAROLE,2021,460,550,1010,65
KABAROLE,2022,470,560,1030,65
KABAROLE,2023,480,570,1050,65
KABAROLE,2024,490,580,1070,65
KABAROLE,2025,500,590,1090,65
KABERAMAIDO,2015,70,140,210,65
KABERAMAIDO,2016,70,140,210,65
KABERAMAIDO,2017,60,140,200,65
KABERAMAIDO,2018,60,130,190,65
KABERAMAIDO,2019,60,120,180,65
KABERAMAIDO,2020,60,110,170,65
KABERAMAIDO,2021,60,110,170,65
KABERAMAIDO,2022,70,120,190,65
KABERAMAIDO,2023,70,140,210,65
KABERAMAIDO,2024,70,160,230,65
KABERAMAIDO,2025,90,170,260,65
KAGADI,2015,280,380,660,65
KAGADI,2016,290,400,690,65
KAGADI,2017,300,410,710,65
KAGADI,2018,310,420,730,65
KAGADI,2019,320,440,760,65
KAGADI,2020,330,450,780,65
KAGADI,2021,340,470,810,65
KAGADI,2022,350,480,830,65
KAGADI,2023,370,500,870,65
KAGADI,2024,380,520,900,65
KAGADI,2025,390,530,920,65
KAKUMIRO,2015,250,320,570,65
KAKUMIRO,2016,270,350,620,65
KAKUMIRO,2017,300,370,670,65
KAKUMIRO,2018,320,410,730,65
KAKUMIRO,2019,350,440,790,65
KAKUMIRO,2020,380,480,860,65
KAKUMIRO,2021,410,510,920,65
KAKUMIRO,2022,450,560,1010,65
KAKUMIRO,2023,490,600,1090,65
KAKUMIRO,2024,530,650,1180,65
KAKUMIRO,2025,570,700,1270,65
KALAKI,2015,180,310,490,65
KALAKI,2016,180,320,500,65
KALAKI,2017,190,340,530,65
KALAKI,2018,200,350,550,65
KALAKI,2019,210,360,570,65
KALAKI,2020,220,380,600,65
KALAKI,2021,230,390,620,65
KALAKI,2022,240,410,650,65
KALAKI,2023,250,420,670,65
KALAKI,2024,260,430,690,65
KALAKI,2025,270,450,720,65
KALANGALA,2015,40,20,60,65
KALANGALA,2016,40,20,60,65
KALANGALA,2017,40,20,60,65
KALANGALA,2018,40,20,60,65
KALANGALA,2019,40,20,60,65
KALANGALA,2020,40,30,70,65
KALANGALA,2021,50,30,80,65
KALANGALA,2022,50,30,80,65
KALANGALA,2023,50,30,80,65
KALANGALA,2024,50,30,80,65
KALANGALA,2025,50,30,80,65
KALIRO,2015,240,250,490,65
KALIRO,2016,260,270,530,65
KALIRO,2017,270,280,550,65
KALIRO,2018,260,280,540,65
KALIRO,2019,260,260,520,65
KALIRO,2020,260,240,500,65
KALIRO,2021,250,240,490,65
KALIRO,2022,260,250,510,65
KALIRO,2023,290,280,570,65
KALIRO,2024,330,320,650,65
KALIRO,2025,370,380,750,65
KALUNGU,2015,230,300,530,65
KALUNGU,2016,250,310,560,65
KALUNGU,2017,250,320,570,65
KALUNGU,2018,240,310,550,65
KALUNGU,2019,230,290,520,65
KALUNGU,2020,220,260,480,65
KALUNGU,2021,210,240,450,65
KALUNGU,2022,220,250,470,65
KALUNGU,2023,230,270,500,65
KALUNGU,2024,260,310,570,65
KALUNGU,2025,290,360,650,65
KAMPALA,2015,900,1020,1920,65
KAMPALA,2016,920,1040,1960,65
KAMPALA,2017,940,1060,2000,65
KAMPALA,2018,950,1080,2030,65
KAMPALA,2019,970,1100,2070,65
KAMPALA,2020,990,1120,2110,65
KAMPALA,2021,1010,1140,2150,65
KAMPALA,2022,1020,1160,2180,65
KAMPALA,2023,1040,1170,2210,65
KAMPALA,2024,1060,1190,2250,65
KAMPALA,2025,1070,1210,2280,65
KAMULI,2015,430,480,910,65
KAMULI,2016,450,530,980,65
KAMULI,2017,460,540,1000,65
KAMULI,2018,460,530,990,65
KAMULI,2019,440,500,940,65
KAMULI,2020,430,460,890,65
KAMULI,2021,420,430,850,65
KAMULI,2022,430,440,870,65
KAMULI,2023,480,500,980,65
KAMULI,2024,540,570,1110,65
KAMULI,2025,600,670,1270,65
KAMWENGE,2015,300,350,650,65
KAMWENGE,2016,310,370,680,65
KAMWENGE,2017,320,380,700,65
KAMWENGE,2018,340,390,730,65
KAMWENGE,2019,350,410,760,65
KAMWENGE,2020,360,420,780,65
KAMWENGE,2021,380,440,820,65
KAMWENGE,2022,390,450,840,65
KAMWENGE,2023,400,460,860,65
KAMWENGE,2024,420,480,900,65
KAMWENGE,2025,430,490,920,65
KANUNGU,2015,340,450,790,65
KANUNGU,2016,340,460,800,65
KANUNGU,2017,350,460,810,65
KANUNGU,2018,360,470,830,65
KANUNGU,2019,360,480,840,65
KANUNGU,2020,370,480,850,65
KANUNGU,2021,370,490,860,65
KANUNGU,2022,380,500,880,65
KANUNGU,2023,380,500,880,65
KANUNGU,2024,390,510,900,65
KANUNGU,2025,390,520,910,65
KAPCHORWA,2015,100,120,220,65
KAPCHORWA,2016,110,120,230,65
KAPCHORWA,2017,110,130,240,65
KAPCHORWA,2018,110,130,240,65
KAPCHORWA,2019,120,140,260,65
KAPCHORWA,2020,120,140,260,65
KAPCHORWA,2021,120,140,260,65
KAPCHORWA,2022,130,150,280,65
KAPCHORWA,2023,130,150,280,65
KAPCHORWA,2024,130,150,280,65
KAPCHORWA,2025,140,160,300,65
KAPELEBYONG,2015,90,130,220,65
KAPELEBYONG,2016,90,140,230,65
KAPELEBYONG,2017,90,150,240,65
KAPELEBYONG,2018,90,140,230,65
KAPELEBYONG,2019,90,140,230,65
KAPELEBYONG,2020,80,130,210,65
KAPELEBYONG,2021,90,120,210,65
KAPELEBYONG,2022,90,120,210,65
KAPELEBYONG,2023,90,130,220,65
KAPELEBYONG,2024,110,160,270,65
KAPELEBYONG,2025,120,180,300,65
KASESE,2015,810,860,1670,65
KASESE,2016,850,930,1780,65
KASESE,2017,870,960,1830,65
KASESE,2018,860,940,1800,65
KASESE,2019,830,890,1720,65
KASESE,2020,800,810,1610,65
KASESE,2021,780,770,1550,65
KASESE,2022,810,780,1590,65
KASESE,2023,880,870,1750,65
KASESE,2024,990,1020,2010,65
KASESE,2025,1130,1180,2310,65
KASSANDA,2015,340,360,700,65
KASSANDA,2016,350,370,720,65
KASSANDA,2017,360,370,730,65
KASSANDA,2018,370,380,750,65
KASSANDA,2019,380,390,770,65
KASSANDA,2020,390,400,790,65
KASSANDA,2021,410,410,820,65
KASSANDA,2022,420,410,830,65
KASSANDA,2023,430,420,850,65
KASSANDA,2024,440,430,870,65
KASSANDA,2025,450,440,890,65
KATAKWI,2015,450,720,1170,65
KATAKWI,2016,480,780,1260,65
KATAKWI,2017,500,810,1310,65
KATAKWI,2018,490,790,1280,65
KATAKWI,2019,480,750,1230,65
KATAKWI,2020,460,690,1150,65
KATAKWI,2021,460,650,1110,65
KATAKWI,2022,470,670,1140,65
KATAKWI,2023,520,750,1270,65
KATAKWI,2024,590,870,1460,65
KATAKWI,2025,660,1010,1670,65
KAYUNGA,2015,380,450,830,65
KAYUNGA,2016,400,490,890,65
KAYUNGA,2017,410,500,910,65
KAYUNGA,2018,400,480,880,65
KAYUNGA,2019,390,450,840,65
KAYUNGA,2020,370,420,790,65
KAYUNGA,2021,360,390,750,65
KAYUNGA,2022,370,400,770,65
KAYUNGA,2023,400,440,840,65
KAYUNGA,2024,450,510,960,65
KAYUNGA,2025,510,580,1090,65
KAZO,2015,200,250,450,65
KAZO,2016,210,260,470,65
KAZO,2017,220,270,490,65
KAZO,2018,230,280,510,65
KAZO,2019,240,290,530,65
KAZO,2020,240,300,540,65
KAZO,2021,250,310,560,65
KAZO,2022,260,320,580,65
KAZO,2023,270,330,600,65
KAZO,2024,280,340,620,65
KAZO,2025,290,350,640,65
KIBAALE,2015,100,110,210,65
KIBAALE,2016,110,110,220,65
KIBAALE,2017,120,120,240,65
KIBAALE,2018,120,130,250,65
KIBAALE,2019,130,130,260,65
KIBAALE,2020,140,140,280,65
KIBAALE,2021,150,150,300,65
KIBAALE,2022,160,160,320,65
KIBAALE,2023,170,170,340,65
KIBAALE,2024,180,170,350,65
KIBAALE,2025,190,180,370,65
KIBOGA,2015,210,250,460,65
KIBOGA,2016,220,270,490,65
KIBOGA,2017,220,270,490,65
KIBOGA,2018,220,270,490,65
KIBOGA,2019,220,260,480,65
KIBOGA,2020,200,240,440,65
KIBOGA,2021,200,230,430,65
KIBOGA,2022,210,230,440,65
KIBOGA,2023,230,250,480,65
KIBOGA,2024,260,300,560,65
KIBOGA,2025,300,350,650,65
KIBUKU,2015,150,190,340,65
KIBUKU,2016,160,210,370,65
KIBUKU,2017,170,220,390,65
KIBUKU,2018,170,220,390,65
KIBUKU,2019,160,210,370,65
KIBUKU,2020,160,200,360,65
KIBUKU,2021,160,190,350,65
KIBUKU,2022,170,200,370,65
KIBUKU,2023,190,220,410,65
KIBUKU,2024,220,260,480,65
KIBUKU,2025,240,310,550,65
KIKUUBE,2015,270,290,560,65
KIKUUBE,2016,280,310,590,65
KIKUUBE,2017,300,320,620,65
KIKUUBE,2018,310,340,650,65
KIKUUBE,2019,330,360,690,65
KIKUUBE,2020,350,370,720,65
KIKUUBE,2021,370,390,760,65
KIKUUBE,2022,380,410,790,65
KIKUUBE,2023,400,430,830,65
KIKUUBE,2024,420,450,870,65
KIKUUBE,2025,440,470,910,65
KIRUHURA,2015,200,180,380,65
KIRUHURA,2016,210,180,390,65
KIRUHURA,2017,220,190,410,65
KIRUHURA,2018,230,190,420,65
KIRUHURA,2019,230,200,430,65
KIRUHURA,2020,240,210,450,65
KIRUHURA,2021,250,220,470,65
KIRUHURA,2022,260,220,480,65
KIRUHURA,2023,270,230,500,65
KIRUHURA,2024,280,240,520,65
KIRUHURA,2025,290,240,530,65
KIRYANDONGO,2015,210,230,440,65
KIRYANDONGO,2016,210,250,460,65
KIRYANDONGO,2017,220,270,490,65
KIRYANDONGO,2018,220,260,480,65
KIRYANDONGO,2019,220,240,460,65
KIRYANDONGO,2020,210,220,430,65
KIRYANDONGO,2021,200,210,410,65
KIRYANDONGO,2022,210,220,430,65
KIRYANDONGO,2023,230,250,480,65
KIRYANDONGO,2024,270,290,560,65
KIRYANDONGO,2025,310,330,640,65
KISORO,2015,360,510,870,65
KISORO,2016,380,550,930,65
KISORO,2017,390,560,950,65
KISORO,2018,380,550,930,65
KISORO,2019,370,520,890,65
KISORO,2020,350,480,830,65
KISORO,2021,340,450,790,65
KISORO,2022,350,450,800,65
KISORO,2023,380,510,890,65
KISORO,2024,430,590,1020,65
KISORO,2025,490,680,1170,65
KITAGWENDA,2015,190,230,420,65
KITAGWENDA,2016,200,240,440,65
KITAGWENDA,2017,210,250,460,65
KITAGWENDA,2018,220,250,470,65
KITAGWENDA,2019,220,260,480,65
KITAGWENDA,2020,230,270,500,65
KITAGWENDA,2021,240,280,520,65
KITAGWENDA,2022,250,290,540,65
KITAGWENDA,2023,260,300,560,65
KITAGWENDA,2024,270,310,580,65
KITAGWENDA,2025,280,320,600,65
KITGUM,2015,190,310,500,65
KITGUM,2016,190,330,520,65
KITGUM,2017,200,340,540,65
KITGUM,2018,200,330,530,65
KITGUM,2019,190,310,500,65
KITGUM,2020,180,280,460,65
KITGUM,2021,170,270,440,65
KITGUM,2022,180,270,450,65
KITGUM,2023,200,300,500,65
KITGUM,2024,220,340,560,65
KITGUM,2025,250,400,650,65
KOBOKO,2015,190,230,420,65
KOBOKO,2016,190,250,440,65
KOBOKO,2017,200,270,470,65
KOBOKO,2018,210,260,470,65
KOBOKO,2019,200,250,450,65
KOBOKO,2020,200,230,430,65
KOBOKO,2021,200,230,430,65
KOBOKO,2022,200,230,430,65
KOBOKO,2023,230,260,490,65
KOBOKO,2024,270,310,580,65
KOBOKO,2025,310,370,680,65
KOLE,2015,450,850,1300,65
KOLE,2016,470,880,1350,65
KOLE,2017,480,900,1380,65
KOLE,2018,500,930,1430,65
KOLE,2019,510,950,1460,65
KOLE,2020,530,980,1510,65
KOLE,2021,550,1010,1560,65
KOLE,2022,560,1030,1590,65
KOLE,2023,580,1060,1640,65
KOLE,2024,600,1090,1690,65
KOLE,2025,610,1110,1720,65
KOTIDO,2015,150,180,330,65
KOTIDO,2016,170,200,370,65
KOTIDO,2017,170,200,370,65
KOTIDO,2018,170,200,370,65
KOTIDO,2019,160,180,340,65
KOTIDO,2020,160,170,330,65
KOTIDO,2021,150,160,310,65
KOTIDO,2022,160,170,330,65
KOTIDO,2023,170,180,350,65
KOTIDO,2024,200,210,410,65
KOTIDO,2025,220,240,460,65
KUMI,2015,240,330,570,65
KUMI,2016,250,350,600,65
KUMI,2017,260,370,630,65
KUMI,2018,260,360,620,65
KUMI,2019,250,340,590,65
KUMI,2020,240,320,560,65
KUMI,2021,240,300,540,65
KUMI,2022,250,310,560,65
KUMI,2023,270,350,620,65
KUMI,2024,310,400,710,65
KUMI,2025,350,470,820,65
KWANIA,2015,330,570,900,65
KWANIA,2016,350,590,940,65
KWANIA,2017,360,610,970,65
KWANIA,2018,370,620,990,65
KWANIA,2019,380,640,1020,65
KWANIA,2020,390,660,1050,65
KWANIA,2021,400,680,1080,65
KWANIA,2022,410,690,1100,65
KWANIA,2023,420,710,1130,65
KWANIA,2024,430,730,1160,65
KWANIA,2025,450,750,1200,65
KWEEN,2015,90,80,170,65
KWEEN,2016,90,90,180,65
KWEEN,2017,90,90,180,65
KWEEN,2018,90,90,180,65
KWEEN,2019,100,90,190,65
KWEEN,2020,100,100,200,65
KWEEN,2021,100,100,200,65
KWEEN,2022,110,100,210,65
KWEEN,2023,110,100,210,65
KWEEN,2024,110,100,210,65
KWEEN,2025,110,110,220,65
KYANKWANZI,2015,410,520,930,65
KYANKWANZI,2016,430,540,970,65
KYANKWANZI,2017,450,570,1020,65
KYANKWANZI,2018,470,590,1060,65
KYANKWANZI,2019,490,620,1110,65
KYANKWANZI,2020,520,650,1170,65
KYANKWANZI,2021,540,680,1220,65
KYANKWANZI,2022,570,710,1280,65
KYANKWANZI,2023,600,740,1340,65
KYANKWANZI,2024,630,770,1400,65
KYANKWANZI,2025,650,800,1450,65
KYEGEGWA,2015,430,680,1110,65
KYEGEGWA,2016,470,730,1200,65
KYEGEGWA,2017,510,790,1300,65
KYEGEGWA,2018,550,850,1400,65
KYEGEGWA,2019,590,920,1510,65
KYEGEGWA,2020,640,990,1630,65
KYEGEGWA,2021,690,1070,1760,65
KYEGEGWA,2022,750,1150,1900,65
KYEGEGWA,2023,800,1240,2040,65
KYEGEGWA,2024,870,1330,2200,65
KYEGEGWA,2025,930,1430,2360,65
KYENJOJO,2015,680,1000,1680,65
KYENJOJO,2016,710,1040,1750,65
KYENJOJO,2017,740,1080,1820,65
KYENJOJO,2018,770,1120,1890,65
KYENJOJO,2019,800,1160,1960,65
KYENJOJO,2020,830,1200,2030,65
KYENJOJO,2021,860,1240,2100,65
KYENJOJO,2022,900,1280,2180,65
KYENJOJO,2023,930,1320,2250,65
KYENJOJO,2024,960,1370,2330,65
KYENJOJO,2025,1000,1410,2410,65
KYOTERA,2015,280,330,610,65
KYOTERA,2016,290,360,650,65
KYOTERA,2017,300,370,670,65
KYOTERA,2018,290,360,650,65
KYOTERA,2019,280,330,610,65
KYOTERA,2020,270,300,570,65
KYOTERA,2021,260,280,540,65
KYOTERA,2022,270,290,560,65
KYOTERA,2023,290,320,610,65
KYOTERA,2024,330,370,700,65
KYOTERA,2025,360,420,780,65
KARENGA,2015,50,70,120,65
KARENGA,2016,60,70,130,65
KARENGA,2017,60,70,130,65
KARENGA,2018,60,70,130,65
KARENGA,2019,60,70,130,65
KARENGA,2020,60,70,130,65
KARENGA,2021,60,80,140,65
KARENGA,2022,70,80,150,65
KARENGA,2023,70,80,150,65
KARENGA,2024,70,80,150,65
KARENGA,2025,70,80,150,65
LAMWO,2015,150,230,380,65
LAMWO,2016,160,250,410,65
LAMWO,2017,160,250,410,65
LAMWO,2018,160,250,410,65
LAMWO,2019,150,230,380,65
LAMWO,2020,140,210,350,65
LAMWO,2021,140,200,340,65
LAMWO,2022,140,200,340,65
LAMWO,2023,150,220,370,65
LAMWO,2024,160,250,410,65
LAMWO,2025,180,300,480,65
LIRA,2015,440,690,1130,65
LIRA,2016,450,710,1160,65
LIRA,2017,470,730,1200,65
LIRA,2018,480,750,1230,65
LIRA,2019,490,770,1260,65
LIRA,2020,510,790,1300,65
LIRA,2021,520,810,1330,65
LIRA,2022,530,830,1360,65
LIRA,2023,550,860,1410,65
LIRA,2024,560,880,1440,65
LIRA,2025,570,900,1470,65
LUUKA,2015,210,240,450,65
LUUKA,2016,220,260,480,65
LUUKA,2017,220,270,490,65
LUUKA,2018,220,260,480,65
LUUKA,2019,210,250,460,65
LUUKA,2020,200,220,420,65
LUUKA,2021,200,210,410,65
LUUKA,2022,200,210,410,65
LUUKA,2023,220,240,460,65
LUUKA,2024,250,280,530,65
LUUKA,2025,280,320,600,65
LUWERO,2015,400,490,890,65
LUWERO,2016,420,530,950,65
LUWERO,2017,430,550,980,65
LUWERO,2018,430,540,970,65
LUWERO,2019,420,510,930,65
LUWERO,2020,400,470,870,65
LUWERO,2021,390,440,830,65
LUWERO,2022,400,450,850,65
LUWERO,2023,450,500,950,65
LUWERO,2024,500,580,1080,65
LUWERO,2025,560,670,1230,65
LWENGO,2015,310,360,670,65
LWENGO,2016,330,390,720,65
LWENGO,2017,330,390,720,65
LWENGO,2018,320,380,700,65
LWENGO,2019,310,350,660,65
LWENGO,2020,290,320,610,65
LWENGO,2021,280,300,580,65
LWENGO,2022,280,300,580,65
LWENGO,2023,310,330,640,65
LWENGO,2024,340,380,720,65
LWENGO,2025,380,440,820,65
LYANTONDE,2015,90,90,180,65
LYANTONDE,2016,110,100,210,65
LYANTONDE,2017,110,100,210,65
LYANTONDE,2018,110,100,210,65
LYANTONDE,2019,110,100,210,65
LYANTONDE,2020,100,90,190,65
LYANTONDE,2021,100,80,180,65
LYANTONDE,2022,100,80,180,65
LYANTONDE,2023,120,90,210,65
LYANTONDE,2024,130,110,240,65
LYANTONDE,2025,140,120,260,65
MANAFWA,2015,140,170,310,65
MANAFWA,2016,150,180,330,65
MANAFWA,2017,150,180,330,65
MANAFWA,2018,160,180,340,65
MANAFWA,2019,160,190,350,65
MANAFWA,2020,160,190,350,65
MANAFWA,2021,170,200,370,65
MANAFWA,2022,170,200,370,65
MANAFWA,2023,170,200,370,65
MANAFWA,2024,180,210,390,65
MANAFWA,2025,180,210,390,65
MARACHA,2015,310,510,820,65
MARACHA,2016,310,520,830,65
MARACHA,2017,320,530,850,65
MARACHA,2018,330,540,870,65
MARACHA,2019,330,550,880,65
MARACHA,2020,340,560,900,65
MARACHA,2021,350,570,920,65
MARACHA,2022,350,580,930,65
MARACHA,2023,360,590,950,65
MARACHA,2024,360,600,960,65
MARACHA,2025,370,610,980,65
MASAKA,2015,250,280,530,65
MASAKA,2016,260,300,560,65
MASAKA,2017,280,340,620,65
MASAKA,2018,300,360,660,65
MASAKA,2019,310,380,690,65
MASAKA,2020,310,360,670,65
MASAKA,2021,290,340,630,65
MASAKA,2022,280,310,590,65
MASAKA,2023,270,300,570,65
MASAKA,2024,280,300,580,65
MASAKA,2025,300,340,640,65
MASINDI,2015,310,350,660,65
MASINDI,2016,310,360,670,65
MASINDI,2017,320,370,690,65
MASINDI,2018,330,380,710,65
MASINDI,2019,340,390,730,65
MASINDI,2020,350,400,750,65
MASINDI,2021,360,410,770,65
MASINDI,2022,370,420,790,65
MASINDI,2023,380,430,810,65
MASINDI,2024,390,440,830,65
MASINDI,2025,400,450,850,65
MAYUGE,2015,400,400,800,65
MAYUGE,2016,430,440,870,65
MAYUGE,2017,450,460,910,65
MAYUGE,2018,440,450,890,65
MAYUGE,2019,440,430,870,65
MAYUGE,2020,420,400,820,65
MAYUGE,2021,410,390,800,65
MAYUGE,2022,430,390,820,65
MAYUGE,2023,480,440,920,65
MAYUGE,2024,540,520,1060,65
MAYUGE,2025,610,610,1220,65
MBALE,2015,390,470,860,65
MBALE,2016,420,510,930,65
MBALE,2017,430,530,960,65
MBALE,2018,430,530,960,65
MBALE,2019,410,510,920,65
MBALE,2020,400,470,870,65
MBALE,2021,390,450,840,65
MBALE,2022,410,460,870,65
MBALE,2023,450,520,970,65
MBALE,2024,510,610,1120,65
MBALE,2025,570,710,1280,65
MBARARA,2015,330,490,820,65
MBARARA,2016,340,500,840,65
MBARARA,2017,350,510,860,65
MBARARA,2018,350,520,870,65
MBARARA,2019,360,530,890,65
MBARARA,2020,370,540,910,65
MBARARA,2021,380,550,930,65
MBARARA,2022,380,560,940,65
MBARARA,2023,390,570,960,65
MBARARA,2024,400,580,980,65
MBARARA,2025,410,590,1000,65
MITOOMA,2015,230,350,580,65
MITOOMA,2016,240,350,590,65
MITOOMA,2017,240,350,590,65
MITOOMA,2018,240,360,600,65
MITOOMA,2019,250,360,610,65
MITOOMA,2020,250,360,610,65
MITOOMA,2021,250,370,620,65
MITOOMA,2022,250,370,620,65
MITOOMA,2023,250,370,620,65
MITOOMA,2024,260,370,630,65
MITOOMA,2025,260,370,630,65
MITYANA,2015,380,400,780,65
MITYANA,2016,400,430,830,65
MITYANA,2017,410,440,850,65
MITYANA,2018,400,430,830,65
MITYANA,2019,390,400,790,65
MITYANA,2020,370,370,740,65
MITYANA,2021,350,340,690,65
MITYANA,2022,370,350,720,65
MITYANA,2023,400,390,790,65
MITYANA,2024,450,450,900,65
MITYANA,2025,510,510,1020,65
MOROTO,2015,110,170,280,65
MOROTO,2016,120,190,310,65
MOROTO,2017,120,190,310,65
MOROTO,2018,120,190,310,65
MOROTO,2019,120,180,300,65
MOROTO,2020,110,170,280,65
MOROTO,2021,110,160,270,65
MOROTO,2022,110,160,270,65
MOROTO,2023,130,180,310,65
MOROTO,2024,140,210,350,65
MOROTO,2025,150,240,390,65
MOYO,2015,110,170,280,65
MOYO,2016,120,180,300,65
MOYO,2017,120,180,300,65
MOYO,2018,120,190,310,65
MOYO,2019,130,190,320,65
MOYO,2020,130,190,320,65
MOYO,2021,130,200,330,65
MOYO,2022,140,200,340,65
MOYO,2023,140,200,340,65
MOYO,2024,140,210,350,65
MOYO,2025,140,210,350,65
MPIGI,2015,260,310,570,65
MPIGI,2016,270,340,610,65
MPIGI,2017,270,340,610,65
MPIGI,2018,270,330,600,65
MPIGI,2019,270,310,580,65
MPIGI,2020,260,290,550,65
MPIGI,2021,250,280,530,65
MPIGI,2022,260,280,540,65
MPIGI,2023,280,320,600,65
MPIGI,2024,320,370,690,65
MPIGI,2025,350,430,780,65
MUBENDE,2015,350,370,720,65
MUBENDE,2016,380,420,800,65
MUBENDE,2017,410,440,850,65
MUBENDE,2018,410,450,860,65
MUBENDE,2019,410,430,840,65
MUBENDE,2020,400,410,810,65
MUBENDE,2021,410,400,810,65
MUBENDE,2022,430,420,850,65
MUBENDE,2023,490,480,970,65
MUBENDE,2024,560,570,1130,65
MUBENDE,2025,650,680,1330,65
MUKONO,2015,520,640,1160,65
MUKONO,2016,550,700,1250,65
MUKONO,2017,570,720,1290,65
MUKONO,2018,560,720,1280,65
MUKONO,2019,540,670,1210,65
MUKONO,2020,520,630,1150,65
MUKONO,2021,510,590,1100,65
MUKONO,2022,530,610,1140,65
MUKONO,2023,580,680,1260,65
MUKONO,2024,660,800,1460,65
MUKONO,2025,750,940,1690,65
MADI OKOLLO,2015,220,270,490,65
MADI OKOLLO,2016,230,280,510,65
MADI OKOLLO,2017,230,280,510,65
MADI OKOLLO,2018,240,290,530,65
MADI OKOLLO,2019,250,300,550,65
MADI OKOLLO,2020,250,310,560,65
MADI OKOLLO,2021,260,320,580,65
MADI OKOLLO,2022,270,320,590,65
MADI OKOLLO,2023,270,330,600,65
MADI OKOLLO,2024,280,340,620,65
MADI OKOLLO,2025,290,350,640,65
NABILATUK,2015,80,110,190,65
NABILATUK,2016,90,120,210,65
NABILATUK,2017,90,130,220,65
NABILATUK,2018,90,130,220,65
NABILATUK,2019,90,120,210,65
NABILATUK,2020,90,120,210,65
NABILATUK,2021,90,120,210,65
NABILATUK,2022,90,120,210,65
NABILATUK,2023,110,130,240,65
NABILATUK,2024,130,160,290,65
NABILATUK,2025,140,190,330,65
NAKAPIRIPIRIT,2015,110,170,280,65
NAKAPIRIPIRIT,2016,120,190,310,65
NAKAPIRIPIRIT,2017,120,200,320,65
NAKAPIRIPIRIT,2018,130,200,330,65
NAKAPIRIPIRIT,2019,130,190,320,65
NAKAPIRIPIRIT,2020,120,180,300,65
NAKAPIRIPIRIT,2021,120,180,300,65
NAKAPIRIPIRIT,2022,130,180,310,65
NAKAPIRIPIRIT,2023,140,210,350,65
NAKAPIRIPIRIT,2024,160,240,400,65
NAKAPIRIPIRIT,2025,190,290,480,65
NAKASEKE,2015,210,290,500,65
NAKASEKE,2016,220,300,520,65
NAKASEKE,2017,230,310,540,65
NAKASEKE,2018,240,310,550,65
NAKASEKE,2019,240,320,560,65
NAKASEKE,2020,250,330,580,65
NAKASEKE,2021,260,340,600,65
NAKASEKE,2022,270,340,610,65
NAKASEKE,2023,280,350,630,65
NAKASEKE,2024,290,360,650,65
NAKASEKE,2025,300,360,660,65
NAKASONGOLA,2015,140,120,260,65
NAKASONGOLA,2016,150,130,280,65
NAKASONGOLA,2017,150,140,290,65
NAKASONGOLA,2018,150,140,290,65
NAKASONGOLA,2019,150,130,280,65
NAKASONGOLA,2020,140,120,260,65
NAKASONGOLA,2021,140,120,260,65
NAKASONGOLA,2022,150,120,270,65
NAKASONGOLA,2023,160,130,290,65
NAKASONGOLA,2024,180,150,330,65
NAKASONGOLA,2025,210,170,380,65
NAMAYINGO,2015,170,160,330,65
NAMAYINGO,2016,180,180,360,65
NAMAYINGO,2017,180,180,360,65
NAMAYINGO,2018,180,170,350,65
NAMAYINGO,2019,170,170,340,65
NAMAYINGO,2020,170,150,320,65
NAMAYINGO,2021,160,140,300,65
NAMAYINGO,2022,160,150,310,65
NAMAYINGO,2023,180,160,340,65
NAMAYINGO,2024,200,180,380,65
NAMAYINGO,2025,220,210,430,65
NAMISINDWA,2015,170,180,350,65
NAMISINDWA,2016,180,180,360,65
NAMISINDWA,2017,180,190,370,65
NAMISINDWA,2018,190,190,380,65
NAMISINDWA,2019,190,200,390,65
NAMISINDWA,2020,200,200,400,65
NAMISINDWA,2021,200,210,410,65
NAMISINDWA,2022,210,210,420,65
NAMISINDWA,2023,210,220,430,65
NAMISINDWA,2024,220,220,440,65
NAMISINDWA,2025,220,220,440,65
NAMUTUMBA,2015,270,250,520,65
NAMUTUMBA,2016,280,270,550,65
NAMUTUMBA,2017,300,290,590,65
NAMUTUMBA,2018,300,290,590,65
NAMUTUMBA,2019,290,270,560,65
NAMUTUMBA,2020,280,250,530,65
NAMUTUMBA,2021,270,240,510,65
NAMUTUMBA,2022,290,250,540,65
NAMUTUMBA,2023,320,280,600,65
NAMUTUMBA,2024,360,330,690,65
NAMUTUMBA,2025,420,380,800,65
NAPAK,2015,190,250,440,65
NAPAK,2016,190,260,450,65
NAPAK,2017,190,270,460,65
NAPAK,2018,200,270,470,65
NAPAK,2019,190,250,440,65
NAPAK,2020,170,230,400,65
NAPAK,2021,170,220,390,65
NAPAK,2022,180,220,400,65
NAPAK,2023,200,250,450,65
NAPAK,2024,220,280,500,65
NAPAK,2025,240,330,570,65
NEBBI,2015,470,890,1360,65
NEBBI,2016,490,910,1400,65
NEBBI,2017,500,940,1440,65
NEBBI,2018,520,970,1490,65
NEBBI,2019,530,990,1520,65
NEBBI,2020,550,1020,1570,65
NEBBI,2021,560,1050,1610,65
NEBBI,2022,580,1070,1650,65
NEBBI,2023,600,1100,1700,65
NEBBI,2024,610,1130,1740,65
NEBBI,2025,630,1150,1780,65
NGORA,2015,160,260,420,65
NGORA,2016,170,280,450,65
NGORA,2017,180,280,460,65
NGORA,2018,180,280,460,65
NGORA,2019,170,260,430,65
NGORA,2020,170,240,410,65
NGORA,2021,160,230,390,65
NGORA,2022,170,240,410,65
NGORA,2023,180,270,450,65
NGORA,2024,210,310,520,65
NGORA,2025,240,370,610,65
NTOROKO,2015,70,70,140,65
NTOROKO,2016,80,70,150,65
NTOROKO,2017,80,70,150,65
NTOROKO,2018,80,70,150,65
NTOROKO,2019,70,70,140,65
NTOROKO,2020,80,70,150,65
NTOROKO,2021,70,60,130,65
NTOROKO,2022,70,60,130,65
NTOROKO,2023,80,70,150,65
NTOROKO,2024,100,80,180,65
NTOROKO,2025,110,90,200,65
NTUNGAMO,2015,560,790,1350,65
NTUNGAMO,2016,570,800,1370,65
NTUNGAMO,2017,590,820,1410,65
NTUNGAMO,2018,600,830,1430,65
NTUNGAMO,2019,610,850,1460,65
NTUNGAMO,2020,620,860,1480,65
NTUNGAMO,2021,630,880,1510,65
NTUNGAMO,2022,650,890,1540,65
NTUNGAMO,2023,660,900,1560,65
NTUNGAMO,2024,670,920,1590,65
NTUNGAMO,2025,680,930,1610,65
NWOYA,2015,170,290,460,65
NWOYA,2016,190,320,510,65
NWOYA,2017,210,350,560,65
NWOYA,2018,230,380,610,65
NWOYA,2019,260,420,680,65
NWOYA,2020,280,460,740,65
NWOYA,2021,310,510,820,65
NWOYA,2022,350,560,910,65
NWOYA,2023,380,610,990,65
NWOYA,2024,420,680,1100,65
NWOYA,2025,460,740,1200,65
OBONGI,2015,40,50,90,65
OBONGI,2016,40,60,100,65
OBONGI,2017,40,60,100,65
OBONGI,2018,40,60,100,65
OBONGI,2019,40,50,90,65
OBONGI,2020,40,50,90,65
OBONGI,2021,40,40,80,65
OBONGI,2022,40,40,80,65
OBONGI,2023,50,50,100,65
OBONGI,2024,50,60,110,65
OBONGI,2025,60,70,130,65
OMORO,2015,180,250,430,65
OMORO,2016,190,270,460,65
OMORO,2017,190,280,470,65
OMORO,2018,200,280,480,65
OMORO,2019,190,260,450,65
OMORO,2020,190,240,430,65
OMORO,2021,190,230,420,65
OMORO,2022,200,250,450,65
OMORO,2023,210,280,490,65
OMORO,2024,240,320,560,65
OMORO,2025,280,370,650,65
OTUKE,2015,160,220,380,65
OTUKE,2016,170,230,400,65
OTUKE,2017,180,240,420,65
OTUKE,2018,180,250,430,65
OTUKE,2019,190,260,450,65
OTUKE,2020,200,270,470,65
OTUKE,2021,210,280,490,65
OTUKE,2022,220,290,510,65
OTUKE,2023,230,310,540,65
OTUKE,2024,230,320,550,65
OTUKE,2025,240,330,570,65
OYAM,2015,450,640,1090,65
OYAM,2016,460,660,1120,65
OYAM,2017,470,680,1150,65
OYAM,2018,490,700,1190,65
OYAM,2019,500,720,1220,65
OYAM,2020,520,740,1260,65
OYAM,2021,530,760,1290,65
OYAM,2022,550,780,1330,65
OYAM,2023,560,800,1360,65
OYAM,2024,580,820,1400,65
OYAM,2025,590,840,1430,65
PADER,2015,150,260,410,65
PADER,2016,160,290,450,65
PADER,2017,170,290,460,65
PADER,2018,160,290,450,65
PADER,2019,150,270,420,65
PADER,2020,150,240,390,65
PADER,2021,140,230,370,65
PADER,2022,150,240,390,65
PADER,2023,160,260,420,65
PADER,2024,180,310,490,65
PADER,2025,200,350,550,65
PAKWACH,2015,310,500,810,65
PAKWACH,2016,330,520,850,65
PAKWACH,2017,340,540,880,65
PAKWACH,2018,350,560,910,65
PAKWACH,2019,370,570,940,65
PAKWACH,2020,380,600,980,65
PAKWACH,2021,400,620,1020,65
PAKWACH,2022,410,640,1050,65
PAKWACH,2023,430,660,1090,65
PAKWACH,2024,450,680,1130,65
PAKWACH,2025,460,700,1160,65
PALLISA,2015,250,270,520,65
PALLISA,2016,270,300,570,65
PALLISA,2017,280,320,600,65
PALLISA,2018,280,320,600,65
PALLISA,2019,280,300,580,65
PALLISA,2020,270,280,550,65
PALLISA,2021,270,280,550,65
PALLISA,2022,280,290,570,65
PALLISA,2023,320,330,650,65
PALLISA,2024,370,390,760,65
PALLISA,2025,420,450,870,65
RAKAI,2015,290,330,620,65
RAKAI,2016,310,350,660,65
RAKAI,2017,320,370,690,65
RAKAI,2018,320,350,670,65
RAKAI,2019,310,330,640,65
RAKAI,2020,290,300,590,65
RAKAI,2021,290,290,580,65
RAKAI,2022,300,290,590,65
RAKAI,2023,320,330,650,65
RAKAI,2024,360,380,740,65
RAKAI,2025,410,440,850,65
RUBANDA,2015,250,310,560,65
RUBANDA,2016,260,310,570,65
RUBANDA,2017,260,310,570,65
RUBANDA,2018,260,320,580,65
RUBANDA,2019,270,320,590,65
RUBANDA,2020,270,320,590,65
RUBANDA,2021,270,320,590,65
RUBANDA,2022,280,320,600,65
RUBANDA,2023,280,330,610,65
RUBANDA,2024,280,330,610,65
RUBANDA,2025,280,330,610,65
RUBIRIZI,2015,120,220,340,65
RUBIRIZI,2016,120,220,340,65
RUBIRIZI,2017,130,230,360,65
RUBIRIZI,2018,130,230,360,65
RUBIRIZI,2019,130,230,360,65
RUBIRIZI,2020,130,240,370,65
RUBIRIZI,2021,140,240,380,65
RUBIRIZI,2022,140,250,390,65
RUBIRIZI,2023,140,250,390,65
RUBIRIZI,2024,140,250,390,65
RUBIRIZI,2025,150,260,410,65
RUKIGA,2015,140,210,350,65
RUKIGA,2016,140,220,360,65
RUKIGA,2017,140,220,360,65
RUKIGA,2018,150,220,370,65
RUKIGA,2019,150,220,370,65
RUKIGA,2020,150,220,370,65
RUKIGA,2021,150,220,370,65
RUKIGA,2022,150,220,370,65
RUKIGA,2023,150,220,370,65
RUKIGA,2024,150,230,380,65
RUKIGA,2025,150,230,380,65
RUKUNGIRI,2015,390,560,950,65
RUKUNGIRI,2016,390,560,950,65
RUKUNGIRI,2017,400,570,970,65
RUKUNGIRI,2018,400,570,970,65
RUKUNGIRI,2019,410,580,990,65
RUKUNGIRI,2020,410,580,990,65
RUKUNGIRI,2021,410,590,1000,65
RUKUNGIRI,2022,420,590,1010,65
RUKUNGIRI,2023,420,600,1020,65
RUKUNGIRI,2024,420,600,1020,65
RUKUNGIRI,2025,430,600,1030,65
RWAMPARA,2015,150,220,370,65
RWAMPARA,2016,150,220,370,65
RWAMPARA,2017,150,220,370,65
RWAMPARA,2018,160,230,390,65
RWAMPARA,2019,160,230,390,65
RWAMPARA,2020,160,240,400,65
RWAMPARA,2021,170,240,410,65
RWAMPARA,2022,170,250,420,65
RWAMPARA,2023,170,250,420,65
RWAMPARA,2024,180,260,440,65
RWAMPARA,2025,180,260,440,65
SERERE,2015,260,380,640,65
SERERE,2016,270,410,680,65
SERERE,2017,280,430,710,65
SERERE,2018,290,440,730,65
SERERE,2019,280,420,700,65
SERERE,2020,280,390,670,65
SERERE,2021,270,370,640,65
SERERE,2022,290,390,680,65
SERERE,2023,320,440,760,65
SERERE,2024,370,520,890,65
SERERE,2025,420,610,1030,65
SHEEMA,2015,270,380,650,65
SHEEMA,2016,270,380,650,65
SHEEMA,2017,280,390,670,65
SHEEMA,2018,280,390,670,65
SHEEMA,2019,280,390,670,65
SHEEMA,2020,290,400,690,65
SHEEMA,2021,290,400,690,65
SHEEMA,2022,290,400,690,65
SHEEMA,2023,290,410,700,65
SHEEMA,2024,300,410,710,65
SHEEMA,2025,300,410,710,65
SIRONKO,2015,290,430,720,65
SIRONKO,2016,300,430,730,65
SIRONKO,2017,300,440,740,65
SIRONKO,2018,310,450,760,65
SIRONKO,2019,320,460,780,65
SIRONKO,2020,320,470,790,65
SIRONKO,2021,330,480,810,65
SIRONKO,2022,340,490,830,65
SIRONKO,2023,340,490,830,65
SIRONKO,2024,350,500,850,65
SIRONKO,2025,360,510,870,65
SOROTI,2015,300,370,670,65
SOROTI,2016,320,400,720,65
SOROTI,2017,330,420,750,65
SOROTI,2018,330,410,740,65
SOROTI,2019,320,400,720,65
SOROTI,2020,310,370,680,65
SOROTI,2021,310,350,660,65
SOROTI,2022,320,370,690,65
SOROTI,2023,360,420,780,65
SOROTI,2024,410,490,900,65
SOROTI,2025,470,570,1040,65
SSEMBABULE,2015,250,260,510,65
SSEMBABULE,2016,270,290,560,65
SSEMBABULE,2017,270,300,570,65
SSEMBABULE,2018,270,290,560,65
SSEMBABULE,2019,270,280,550,65
SSEMBABULE,2020,260,260,520,65
SSEMBABULE,2021,250,240,490,65
SSEMBABULE,2022,260,250,510,65
SSEMBABULE,2023,290,280,570,65
SSEMBABULE,2024,330,330,660,65
SSEMBABULE,2025,370,380,750,65
TORORO,2015,570,720,1290,65
TORORO,2016,590,740,1330,65
TORORO,2017,600,750,1350,65
TORORO,2018,620,770,1390,65
TORORO,2019,630,790,1420,65
TORORO,2020,650,810,1460,65
TORORO,2021,670,830,1500,65
TORORO,2022,680,850,1530,65
TORORO,2023,700,870,1570,65
TORORO,2024,710,880,1590,65
TORORO,2025,730,900,1630,65
WAKISO,2015,1310,1780,3090,65
WAKISO,2016,1400,1900,3300,65
WAKISO,2017,1500,2030,3530,65
WAKISO,2018,1600,2160,3760,65
WAKISO,2019,1700,2310,4010,65
WAKISO,2020,1810,2460,4270,65
WAKISO,2021,1930,2630,4560,65
WAKISO,2022,2050,2800,4850,65
WAKISO,2023,2180,2980,5160,65
WAKISO,2024,2320,3170,5490,65
WAKISO,2025,2460,3370,5830,65
YUMBE,2015,820,1240,2060,65
YUMBE,2016,890,1400,2290,65
YUMBE,2017,940,1490,2430,65
YUMBE,2018,950,1510,2460,65
YUMBE,2019,950,1470,2420,65
YUMBE,2020,930,1410,2340,65
YUMBE,2021,930,1380,2310,65
YUMBE,2022,990,1460,2450,65
YUMBE,2023,1110,1680,2790,65
YUMBE,2024,1290,2020,3310,65
YUMBE,2025,1490,2430,3920,65
ZOMBO,2015,590,1250,1840,65
ZOMBO,2016,600,1290,1890,65
ZOMBO,2017,620,1330,1950,65
ZOMBO,2018,640,1360,2000,65
ZOMBO,2019,660,1400,2060,65
ZOMBO,2020,680,1440,2120,65
ZOMBO,2021,700,1470,2170,65
ZOMBO,2022,720,1510,2230,65
ZOMBO,2023,740,1550,2290,65
ZOMBO,2024,760,1580,2340,65
ZOMBO,2025,780,1620,2400,65
ABIM,2015,70,70,140,66
ABIM,2016,70,80,150,66
ABIM,2017,80,90,170,66
ABIM,2018,80,100,180,66
ABIM,2019,90,100,190,66
ABIM,2020,90,100,190,66
ABIM,2021,90,90,180,66
ABIM,2022,90,90,180,66
ABIM,2023,100,100,200,66
ABIM,2024,100,110,210,66
ABIM,2025,130,130,260,66
ADJUMANI,2015,110,150,260,66
ADJUMANI,2016,110,150,260,66
ADJUMANI,2017,110,150,260,66
ADJUMANI,2018,110,150,260,66
ADJUMANI,2019,110,160,270,66
ADJUMANI,2020,110,160,270,66
ADJUMANI,2021,110,160,270,66
ADJUMANI,2022,110,160,270,66
ADJUMANI,2023,110,160,270,66
ADJUMANI,2024,120,160,280,66
ADJUMANI,2025,120,160,280,66
AGAGO,2015,160,170,330,66
AGAGO,2016,160,180,340,66
AGAGO,2017,170,180,350,66
AGAGO,2018,170,180,350,66
AGAGO,2019,170,190,360,66
AGAGO,2020,180,190,370,66
AGAGO,2021,180,190,370,66
AGAGO,2022,180,200,380,66
AGAGO,2023,180,200,380,66
AGAGO,2024,190,200,390,66
AGAGO,2025,190,200,390,66
ALEBTONG,2015,260,290,550,66
ALEBTONG,2016,280,330,610,66
ALEBTONG,2017,310,360,670,66
ALEBTONG,2018,310,360,670,66
ALEBTONG,2019,310,360,670,66
ALEBTONG,2020,300,340,640,66
ALEBTONG,2021,290,310,600,66
ALEBTONG,2022,280,300,580,66
ALEBTONG,2023,290,310,600,66
ALEBTONG,2024,320,340,660,66
ALEBTONG,2025,370,400,770,66
AMOLATAR,2015,160,140,300,66
AMOLATAR,2016,180,150,330,66
AMOLATAR,2017,190,160,350,66
AMOLATAR,2018,190,160,350,66
AMOLATAR,2019,190,170,360,66
AMOLATAR,2020,180,150,330,66
AMOLATAR,2021,180,140,320,66
AMOLATAR,2022,170,140,310,66
AMOLATAR,2023,180,140,320,66
AMOLATAR,2024,200,150,350,66
AMOLATAR,2025,220,170,390,66
AMUDAT,2015,50,60,110,66
AMUDAT,2016,60,70,130,66
AMUDAT,2017,60,70,130,66
AMUDAT,2018,60,70,130,66
AMUDAT,2019,70,70,140,66
AMUDAT,2020,60,80,140,66
AMUDAT,2021,60,70,130,66
AMUDAT,2022,60,60,120,66
AMUDAT,2023,60,60,120,66
AMUDAT,2024,70,80,150,66
AMUDAT,2025,80,90,170,66
AMURIA,2015,140,140,280,66
AMURIA,2016,160,150,310,66
AMURIA,2017,160,160,320,66
AMURIA,2018,180,170,350,66
AMURIA,2019,170,170,340,66
AMURIA,2020,170,170,340,66
AMURIA,2021,170,150,320,66
AMURIA,2022,160,140,300,66
AMURIA,2023,170,150,320,66
AMURIA,2024,190,160,350,66
AMURIA,2025,220,200,420,66
AMURU,2015,120,140,260,66
AMURU,2016,130,160,290,66
AMURU,2017,140,170,310,66
AMURU,2018,140,170,310,66
AMURU,2019,140,170,310,66
AMURU,2020,140,170,310,66
AMURU,2021,130,150,280,66
AMURU,2022,130,140,270,66
AMURU,2023,140,150,290,66
AMURU,2024,150,160,310,66
AMURU,2025,160,190,350,66
APAC,2015,260,290,550,66
APAC,2016,270,300,570,66
APAC,2017,280,310,590,66
APAC,2018,290,320,610,66
APAC,2019,300,330,630,66
APAC,2020,310,340,650,66
APAC,2021,320,350,670,66
APAC,2022,330,360,690,66
APAC,2023,350,370,720,66
APAC,2024,360,380,740,66
APAC,2025,370,390,760,66
ARUA,2015,460,520,980,66
ARUA,2016,470,530,1000,66
ARUA,2017,490,550,1040,66
ARUA,2018,500,560,1060,66
ARUA,2019,510,580,1090,66
ARUA,2020,530,590,1120,66
ARUA,2021,540,610,1150,66
ARUA,2022,560,620,1180,66
ARUA,2023,570,640,1210,66
ARUA,2024,580,650,1230,66
ARUA,2025,600,670,1270,66
BUDAKA,2015,170,220,390,66
BUDAKA,2016,180,240,420,66
BUDAKA,2017,200,270,470,66
BUDAKA,2018,210,280,490,66
BUDAKA,2019,210,280,490,66
BUDAKA,2020,200,270,470,66
BUDAKA,2021,200,240,440,66
BUDAKA,2022,190,240,430,66
BUDAKA,2023,200,250,450,66
BUDAKA,2024,230,270,500,66
BUDAKA,2025,250,320,570,66
BUDUDA,2015,250,300,550,66
BUDUDA,2016,270,350,620,66
BUDUDA,2017,290,390,680,66
BUDUDA,2018,310,410,720,66
BUDUDA,2019,310,400,710,66
BUDUDA,2020,300,380,680,66
BUDUDA,2021,300,370,670,66
BUDUDA,2022,300,350,650,66
BUDUDA,2023,310,360,670,66
BUDUDA,2024,340,420,760,66
BUDUDA,2025,400,500,900,66
BUGIRI,2015,350,340,690,66
BUGIRI,2016,380,380,760,66
BUGIRI,2017,410,430,840,66
BUGIRI,2018,420,450,870,66
BUGIRI,2019,430,440,870,66
BUGIRI,2020,420,420,840,66
BUGIRI,2021,410,390,800,66
BUGIRI,2022,410,390,800,66
BUGIRI,2023,430,400,830,66
BUGIRI,2024,480,450,930,66
BUGIRI,2025,540,520,1060,66
BUGWERI,2015,120,140,260,66
BUGWERI,2016,130,150,280,66
BUGWERI,2017,140,170,310,66
BUGWERI,2018,140,170,310,66
BUGWERI,2019,140,170,310,66
BUGWERI,2020,140,150,290,66
BUGWERI,2021,130,150,280,66
BUGWERI,2022,130,140,270,66
BUGWERI,2023,140,140,280,66
BUGWERI,2024,150,160,310,66
BUGWERI,2025,160,190,350,66
BUHWEJU,2015,80,90,170,66
BUHWEJU,2016,90,100,190,66
BUHWEJU,2017,90,100,190,66
BUHWEJU,2018,90,100,190,66
BUHWEJU,2019,100,110,210,66
BUHWEJU,2020,100,110,210,66
BUHWEJU,2021,100,110,210,66
BUHWEJU,2022,100,120,220,66
BUHWEJU,2023,110,120,230,66
BUHWEJU,2024,110,120,230,66
BUHWEJU,2025,110,120,230,66
BUIKWE,2015,270,320,590,66
BUIKWE,2016,300,350,650,66
BUIKWE,2017,310,390,700,66
BUIKWE,2018,320,390,710,66
BUIKWE,2019,310,390,700,66
BUIKWE,2020,300,360,660,66
BUIKWE,2021,290,340,630,66
BUIKWE,2022,280,310,590,66
BUIKWE,2023,290,320,610,66
BUIKWE,2024,310,350,660,66
BUIKWE,2025,360,410,770,66
BUKEDEA,2015,180,220,400,66
BUKEDEA,2016,210,240,450,66
BUKEDEA,2017,210,270,480,66
BUKEDEA,2018,220,290,510,66
BUKEDEA,2019,230,290,520,66
BUKEDEA,2020,230,280,510,66
BUKEDEA,2021,220,250,470,66
BUKEDEA,2022,220,250,470,66
BUKEDEA,2023,230,260,490,66
BUKEDEA,2024,260,290,550,66
BUKEDEA,2025,300,350,650,66
BUKOMANSIMBI,2015,150,200,350,66
BUKOMANSIMBI,2016,160,220,380,66
BUKOMANSIMBI,2017,160,230,390,66
BUKOMANSIMBI,2018,170,230,400,66
BUKOMANSIMBI,2019,160,220,380,66
BUKOMANSIMBI,2020,150,200,350,66
BUKOMANSIMBI,2021,150,190,340,66
BUKOMANSIMBI,2022,140,170,310,66
BUKOMANSIMBI,2023,150,170,320,66
BUKOMANSIMBI,2024,160,190,350,66
BUKOMANSIMBI,2025,170,210,380,66
BUKWO,2015,60,70,130,66
BUKWO,2016,70,80,150,66
BUKWO,2017,70,80,150,66
BUKWO,2018,80,90,170,66
BUKWO,2019,80,90,170,66
BUKWO,2020,80,90,170,66
BUKWO,2021,90,100,190,66
BUKWO,2022,90,100,190,66
BUKWO,2023,100,110,210,66
BUKWO,2024,100,110,210,66
BUKWO,2025,110,120,230,66
BULAMBULI,2015,250,300,550,66
BULAMBULI,2016,270,340,610,66
BULAMBULI,2017,290,390,680,66
BULAMBULI,2018,310,410,720,66
BULAMBULI,2019,320,400,720,66
BULAMBULI,2020,310,400,710,66
BULAMBULI,2021,300,370,670,66
BULAMBULI,2022,310,360,670,66
BULAMBULI,2023,320,380,700,66
BULAMBULI,2024,360,440,800,66
BULAMBULI,2025,410,510,920,66
BULIISA,2015,80,70,150,66
BULIISA,2016,80,80,160,66
BULIISA,2017,80,80,160,66
BULIISA,2018,90,80,170,66
BULIISA,2019,90,90,180,66
BULIISA,2020,100,90,190,66
BULIISA,2021,100,100,200,66
BULIISA,2022,110,100,210,66
BULIISA,2023,110,100,210,66
BULIISA,2024,120,110,230,66
BULIISA,2025,120,110,230,66
BUNDIBUGYO,2015,180,140,320,66
BUNDIBUGYO,2016,210,150,360,66
BUNDIBUGYO,2017,210,170,380,66
BUNDIBUGYO,2018,220,170,390,66
BUNDIBUGYO,2019,230,170,400,66
BUNDIBUGYO,2020,210,150,360,66
BUNDIBUGYO,2021,210,150,360,66
BUNDIBUGYO,2022,200,140,340,66
BUNDIBUGYO,2023,210,140,350,66
BUNDIBUGYO,2024,230,160,390,66
BUNDIBUGYO,2025,260,190,450,66
BUNYANGABU,2015,130,170,300,66
BUNYANGABU,2016,140,200,340,66
BUNYANGABU,2017,140,220,360,66
BUNYANGABU,2018,150,220,370,66
BUNYANGABU,2019,150,220,370,66
BUNYANGABU,2020,140,200,340,66
BUNYANGABU,2021,140,190,330,66
BUNYANGABU,2022,140,170,310,66
BUNYANGABU,2023,140,180,320,66
BUNYANGABU,2024,160,200,360,66
BUNYANGABU,2025,170,230,400,66
BUSHENYI,2015,210,230,440,66
BUSHENYI,2016,220,230,450,66
BUSHENYI,2017,220,230,450,66
BUSHENYI,2018,220,240,460,66
BUSHENYI,2019,230,240,470,66
BUSHENYI,2020,230,240,470,66
BUSHENYI,2021,230,240,470,66
BUSHENYI,2022,230,240,470,66
BUSHENYI,2023,230,240,470,66
BUSHENYI,2024,240,250,490,66
BUSHENYI,2025,240,250,490,66
BUSIA,2015,330,320,650,66
BUSIA,2016,350,370,720,66
BUSIA,2017,380,400,780,66
BUSIA,2018,390,420,810,66
BUSIA,2019,390,400,790,66
BUSIA,2020,380,380,760,66
BUSIA,2021,360,360,720,66
BUSIA,2022,360,340,700,66
BUSIA,2023,370,350,720,66
BUSIA,2024,420,390,810,66
BUSIA,2025,470,460,930,66
BUTALEJA,2015,240,260,500,66
BUTALEJA,2016,260,280,540,66
BUTALEJA,2017,280,320,600,66
BUTALEJA,2018,290,330,620,66
BUTALEJA,2019,300,330,630,66
BUTALEJA,2020,290,310,600,66
BUTALEJA,2021,280,290,570,66
BUTALEJA,2022,280,280,560,66
BUTALEJA,2023,290,290,580,66
BUTALEJA,2024,320,330,650,66
BUTALEJA,2025,370,390,760,66
BUTAMBALA,2015,70,70,140,66
BUTAMBALA,2016,70,80,150,66
BUTAMBALA,2017,70,90,160,66
BUTAMBALA,2018,70,90,160,66
BUTAMBALA,2019,70,80,150,66
BUTAMBALA,2020,60,80,140,66
BUTAMBALA,2021,60,70,130,66
BUTAMBALA,2022,60,60,120,66
BUTAMBALA,2023,60,60,120,66
BUTAMBALA,2024,70,70,140,66
BUTAMBALA,2025,80,80,160,66
BUTEBO,2015,90,140,230,66
BUTEBO,2016,90,150,240,66
BUTEBO,2017,90,160,250,66
BUTEBO,2018,90,160,250,66
BUTEBO,2019,100,150,250,66
BUTEBO,2020,100,140,240,66
BUTEBO,2021,90,130,220,66
BUTEBO,2022,90,120,210,66
BUTEBO,2023,90,130,220,66
BUTEBO,2024,90,140,230,66
BUTEBO,2025,100,160,260,66
BUVUMA,2015,70,30,100,66
BUVUMA,2016,70,30,100,66
BUVUMA,2017,80,30,110,66
BUVUMA,2018,80,30,110,66
BUVUMA,2019,90,30,120,66
BUVUMA,2020,90,40,130,66
BUVUMA,2021,100,40,140,66
BUVUMA,2022,100,40,140,66
BUVUMA,2023,110,40,150,66
BUVUMA,2024,120,50,170,66
BUVUMA,2025,120,50,170,66
BUYENDE,2015,220,220,440,66
BUYENDE,2016,240,240,480,66
BUYENDE,2017,250,270,520,66
BUYENDE,2018,260,290,550,66
BUYENDE,2019,260,290,550,66
BUYENDE,2020,260,280,540,66
BUYENDE,2021,260,270,530,66
BUYENDE,2022,260,260,520,66
BUYENDE,2023,270,270,540,66
BUYENDE,2024,300,290,590,66
BUYENDE,2025,350,350,700,66
DOKOLO,2015,180,160,340,66
DOKOLO,2016,180,160,340,66
DOKOLO,2017,190,160,350,66
DOKOLO,2018,200,170,370,66
DOKOLO,2019,200,170,370,66
DOKOLO,2020,210,180,390,66
DOKOLO,2021,210,180,390,66
DOKOLO,2022,220,190,410,66
DOKOLO,2023,230,190,420,66
DOKOLO,2024,230,200,430,66
DOKOLO,2025,240,200,440,66
GOMBA,2015,140,120,260,66
GOMBA,2016,150,140,290,66
GOMBA,2017,150,140,290,66
GOMBA,2018,150,140,290,66
GOMBA,2019,160,140,300,66
GOMBA,2020,150,130,280,66
GOMBA,2021,140,120,260,66
GOMBA,2022,140,110,250,66
GOMBA,2023,140,110,250,66
GOMBA,2024,160,120,280,66
GOMBA,2025,170,150,320,66
GULU,2015,130,150,280,66
GULU,2016,140,150,290,66
GULU,2017,140,160,300,66
GULU,2018,140,160,300,66
GULU,2019,150,170,320,66
GULU,2020,150,170,320,66
GULU,2021,160,180,340,66
GULU,2022,160,180,340,66
GULU,2023,170,180,350,66
GULU,2024,170,190,360,66
GULU,2025,170,190,360,66
HOIMA,2015,210,230,440,66
HOIMA,2016,220,240,460,66
HOIMA,2017,230,250,480,66
HOIMA,2018,240,260,500,66
HOIMA,2019,250,270,520,66
HOIMA,2020,250,280,530,66
HOIMA,2021,260,280,540,66
HOIMA,2022,270,290,560,66
HOIMA,2023,280,300,580,66
HOIMA,2024,290,310,600,66
HOIMA,2025,300,320,620,66
IBANDA,2015,210,290,500,66
IBANDA,2016,210,290,500,66
IBANDA,2017,220,300,520,66
IBANDA,2018,220,300,520,66
IBANDA,2019,230,310,540,66
IBANDA,2020,230,310,540,66
IBANDA,2021,240,320,560,66
IBANDA,2022,240,320,560,66
IBANDA,2023,240,330,570,66
IBANDA,2024,250,330,580,66
IBANDA,2025,250,340,590,66
IGANGA,2015,200,260,460,66
IGANGA,2016,210,280,490,66
IGANGA,2017,220,320,540,66
IGANGA,2018,240,320,560,66
IGANGA,2019,230,320,550,66
IGANGA,2020,230,310,540,66
IGANGA,2021,210,280,490,66
IGANGA,2022,210,270,480,66
IGANGA,2023,220,280,500,66
IGANGA,2024,240,310,550,66
IGANGA,2025,280,360,640,66
ISINGIRO,2015,390,370,760,66
ISINGIRO,2016,410,380,790,66
ISINGIRO,2017,420,390,810,66
ISINGIRO,2018,440,410,850,66
ISINGIRO,2019,450,420,870,66
ISINGIRO,2020,470,440,910,66
ISINGIRO,2021,480,450,930,66
ISINGIRO,2022,500,470,970,66
ISINGIRO,2023,520,480,1000,66
ISINGIRO,2024,530,500,1030,66
ISINGIRO,2025,550,510,1060,66
JINJA,2015,260,280,540,66
JINJA,2016,270,280,550,66
JINJA,2017,270,280,550,66
JINJA,2018,270,290,560,66
JINJA,2019,280,290,570,66
JINJA,2020,280,300,580,66
JINJA,2021,290,300,590,66
JINJA,2022,290,300,590,66
JINJA,2023,300,310,610,66
JINJA,2024,300,310,610,66
JINJA,2025,300,320,620,66
KAABONG,2015,60,60,120,66
KAABONG,2016,60,60,120,66
KAABONG,2017,60,60,120,66
KAABONG,2018,70,60,130,66
KAABONG,2019,70,60,130,66
KAABONG,2020,70,60,130,66
KAABONG,2021,70,60,130,66
KAABONG,2022,70,70,140,66
KAABONG,2023,70,70,140,66
KAABONG,2024,80,70,150,66
KAABONG,2025,80,70,150,66
KABALE,2015,220,240,460,66
KABALE,2016,230,240,470,66
KABALE,2017,230,240,470,66
KABALE,2018,240,250,490,66
KABALE,2019,240,250,490,66
KABALE,2020,240,250,490,66
KABALE,2021,250,250,500,66
KABALE,2022,250,260,510,66
KABALE,2023,250,260,510,66
KABALE,2024,250,260,510,66
KABALE,2025,260,260,520,66
KABAROLE,2015,240,250,490,66
KABAROLE,2016,240,250,490,66
KABAROLE,2017,250,260,510,66
KABAROLE,2018,250,260,510,66
KABAROLE,2019,260,270,530,66
KABAROLE,2020,260,280,540,66
KABAROLE,2021,270,280,550,66
KABAROLE,2022,270,290,560,66
KABAROLE,2023,280,290,570,66
KABAROLE,2024,280,300,580,66
KABAROLE,2025,290,300,590,66
KABERAMAIDO,2015,60,90,150,66
KABERAMAIDO,2016,60,110,170,66
KABERAMAIDO,2017,60,110,170,66
KABERAMAIDO,2018,70,120,190,66
KABERAMAIDO,2019,60,100,160,66
KABERAMAIDO,2020,60,100,160,66
KABERAMAIDO,2021,60,90,150,66
KABERAMAIDO,2022,60,90,150,66
KABERAMAIDO,2023,60,100,160,66
KABERAMAIDO,2024,70,110,180,66
KABERAMAIDO,2025,80,130,210,66
KAGADI,2015,240,210,450,66
KAGADI,2016,250,210,460,66
KAGADI,2017,260,220,480,66
KAGADI,2018,270,230,500,66
KAGADI,2019,270,240,510,66
KAGADI,2020,280,250,530,66
KAGADI,2021,290,250,540,66
KAGADI,2022,300,260,560,66
KAGADI,2023,310,270,580,66
KAGADI,2024,320,280,600,66
KAGADI,2025,340,290,630,66
KAKUMIRO,2015,230,170,400,66
KAKUMIRO,2016,250,180,430,66
KAKUMIRO,2017,270,200,470,66
KAKUMIRO,2018,290,210,500,66
KAKUMIRO,2019,320,230,550,66
KAKUMIRO,2020,340,250,590,66
KAKUMIRO,2021,370,270,640,66
KAKUMIRO,2022,400,290,690,66
KAKUMIRO,2023,440,320,760,66
KAKUMIRO,2024,480,340,820,66
KAKUMIRO,2025,510,370,880,66
KALAKI,2015,130,180,310,66
KALAKI,2016,130,190,320,66
KALAKI,2017,140,190,330,66
KALAKI,2018,150,200,350,66
KALAKI,2019,150,210,360,66
KALAKI,2020,160,220,380,66
KALAKI,2021,170,220,390,66
KALAKI,2022,170,230,400,66
KALAKI,2023,180,240,420,66
KALAKI,2024,180,250,430,66
KALAKI,2025,190,260,450,66
KALANGALA,2015,20,20,40,66
KALANGALA,2016,20,20,40,66
KALANGALA,2017,20,20,40,66
KALANGALA,2018,20,20,40,66
KALANGALA,2019,20,20,40,66
KALANGALA,2020,20,20,40,66
KALANGALA,2021,20,20,40,66
KALANGALA,2022,20,20,40,66
KALANGALA,2023,30,20,50,66
KALANGALA,2024,30,20,50,66
KALANGALA,2025,30,30,60,66
KALIRO,2015,220,190,410,66
KALIRO,2016,240,200,440,66
KALIRO,2017,250,230,480,66
KALIRO,2018,260,230,490,66
KALIRO,2019,260,240,500,66
KALIRO,2020,260,230,490,66
KALIRO,2021,250,210,460,66
KALIRO,2022,240,200,440,66
KALIRO,2023,250,200,450,66
KALIRO,2024,280,240,520,66
KALIRO,2025,320,280,600,66
KALUNGU,2015,180,220,400,66
KALUNGU,2016,190,240,430,66
KALUNGU,2017,210,260,470,66
KALUNGU,2018,210,260,470,66
KALUNGU,2019,210,250,460,66
KALUNGU,2020,190,230,420,66
KALUNGU,2021,180,220,400,66
KALUNGU,2022,180,200,380,66
KALUNGU,2023,180,200,380,66
KALUNGU,2024,200,220,420,66
KALUNGU,2025,220,250,470,66
KAMPALA,2015,560,560,1120,66
KAMPALA,2016,570,570,1140,66
KAMPALA,2017,580,580,1160,66
KAMPALA,2018,590,600,1190,66
KAMPALA,2019,600,610,1210,66
KAMPALA,2020,620,620,1240,66
KAMPALA,2021,630,630,1260,66
KAMPALA,2022,640,640,1280,66
KAMPALA,2023,650,650,1300,66
KAMPALA,2024,660,660,1320,66
KAMPALA,2025,670,670,1340,66
KAMULI,2015,350,370,720,66
KAMULI,2016,380,420,800,66
KAMULI,2017,390,460,850,66
KAMULI,2018,400,480,880,66
KAMULI,2019,400,460,860,66
KAMULI,2020,390,430,820,66
KAMULI,2021,370,400,770,66
KAMULI,2022,370,380,750,66
KAMULI,2023,380,390,770,66
KAMULI,2024,420,440,860,66
KAMULI,2025,460,500,960,66
KAMWENGE,2015,210,170,380,66
KAMWENGE,2016,220,180,400,66
KAMWENGE,2017,230,190,420,66
KAMWENGE,2018,240,190,430,66
KAMWENGE,2019,250,200,450,66
KAMWENGE,2020,260,210,470,66
KAMWENGE,2021,270,210,480,66
KAMWENGE,2022,280,220,500,66
KAMWENGE,2023,290,230,520,66
KAMWENGE,2024,300,230,530,66
KAMWENGE,2025,310,240,550,66
KANUNGU,2015,230,270,500,66
KANUNGU,2016,240,270,510,66
KANUNGU,2017,240,280,520,66
KANUNGU,2018,250,280,530,66
KANUNGU,2019,250,280,530,66
KANUNGU,2020,260,290,550,66
KANUNGU,2021,260,290,550,66
KANUNGU,2022,260,300,560,66
KANUNGU,2023,270,300,570,66
KANUNGU,2024,270,300,570,66
KANUNGU,2025,270,310,580,66
KAPCHORWA,2015,150,130,280,66
KAPCHORWA,2016,150,140,290,66
KAPCHORWA,2017,150,140,290,66
KAPCHORWA,2018,160,140,300,66
KAPCHORWA,2019,160,150,310,66
KAPCHORWA,2020,170,150,320,66
KAPCHORWA,2021,170,150,320,66
KAPCHORWA,2022,180,160,340,66
KAPCHORWA,2023,180,160,340,66
KAPCHORWA,2024,190,170,360,66
KAPCHORWA,2025,190,170,360,66
KAPELEBYONG,2015,80,70,150,66
KAPELEBYONG,2016,80,80,160,66
KAPELEBYONG,2017,80,90,170,66
KAPELEBYONG,2018,80,90,170,66
KAPELEBYONG,2019,80,100,180,66
KAPELEBYONG,2020,90,90,180,66
KAPELEBYONG,2021,80,80,160,66
KAPELEBYONG,2022,80,80,160,66
KAPELEBYONG,2023,80,80,160,66
KAPELEBYONG,2024,90,80,170,66
KAPELEBYONG,2025,100,110,210,66
KASESE,2015,430,370,800,66
KASESE,2016,470,420,890,66
KASESE,2017,490,440,930,66
KASESE,2018,510,460,970,66
KASESE,2019,500,460,960,66
KASESE,2020,480,420,900,66
KASESE,2021,460,390,850,66
KASESE,2022,450,380,830,66
KASESE,2023,470,380,850,66
KASESE,2024,510,420,930,66
KASESE,2025,580,500,1080,66
KASSANDA,2015,220,190,410,66
KASSANDA,2016,220,200,420,66
KASSANDA,2017,230,200,430,66
KASSANDA,2018,240,200,440,66
KASSANDA,2019,240,210,450,66
KASSANDA,2020,250,210,460,66
KASSANDA,2021,260,220,480,66
KASSANDA,2022,260,220,480,66
KASSANDA,2023,270,220,490,66
KASSANDA,2024,280,230,510,66
KASSANDA,2025,280,230,510,66
KATAKWI,2015,360,570,930,66
KATAKWI,2016,390,640,1030,66
KATAKWI,2017,410,690,1100,66
KATAKWI,2018,440,710,1150,66
KATAKWI,2019,430,690,1120,66
KATAKWI,2020,420,660,1080,66
KATAKWI,2021,400,610,1010,66
KATAKWI,2022,400,580,980,66
KATAKWI,2023,410,590,1000,66
KATAKWI,2024,450,660,1110,66
KATAKWI,2025,510,760,1270,66
KAYUNGA,2015,270,320,590,66
KAYUNGA,2016,300,350,650,66
KAYUNGA,2017,310,390,700,66
KAYUNGA,2018,320,390,710,66
KAYUNGA,2019,310,370,680,66
KAYUNGA,2020,300,360,660,66
KAYUNGA,2021,280,320,600,66
KAYUNGA,2022,280,310,590,66
KAYUNGA,2023,280,310,590,66
KAYUNGA,2024,310,340,650,66
KAYUNGA,2025,350,400,750,66
KAZO,2015,160,130,290,66
KAZO,2016,160,130,290,66
KAZO,2017,170,140,310,66
KAZO,2018,180,140,320,66
KAZO,2019,180,150,330,66
KAZO,2020,190,150,340,66
KAZO,2021,200,160,360,66
KAZO,2022,200,160,360,66
KAZO,2023,210,170,380,66
KAZO,2024,220,170,390,66
KAZO,2025,220,180,400,66
KIBAALE,2015,90,80,170,66
KIBAALE,2016,90,80,170,66
KIBAALE,2017,100,90,190,66
KIBAALE,2018,100,90,190,66
KIBAALE,2019,110,100,210,66
KIBAALE,2020,120,110,230,66
KIBAALE,2021,120,110,230,66
KIBAALE,2022,130,120,250,66
KIBAALE,2023,140,120,260,66
KIBAALE,2024,150,130,280,66
KIBAALE,2025,160,140,300,66
KIBOGA,2015,170,250,420,66
KIBOGA,2016,190,280,470,66
KIBOGA,2017,200,300,500,66
KIBOGA,2018,210,320,530,66
KIBOGA,2019,210,300,510,66
KIBOGA,2020,200,290,490,66
KIBOGA,2021,190,270,460,66
KIBOGA,2022,190,260,450,66
KIBOGA,2023,190,260,450,66
KIBOGA,2024,220,290,510,66
KIBOGA,2025,240,330,570,66
KIBUKU,2015,150,200,350,66
KIBUKU,2016,160,230,390,66
KIBUKU,2017,180,240,420,66
KIBUKU,2018,180,260,440,66
KIBUKU,2019,180,260,440,66
KIBUKU,2020,170,240,410,66
KIBUKU,2021,170,230,400,66
KIBUKU,2022,170,230,400,66
KIBUKU,2023,170,240,410,66
KIBUKU,2024,200,260,460,66
KIBUKU,2025,230,310,540,66
KIKUUBE,2015,220,180,400,66
KIKUUBE,2016,230,190,420,66
KIKUUBE,2017,250,200,450,66
KIKUUBE,2018,260,210,470,66
KIKUUBE,2019,270,220,490,66
KIKUUBE,2020,290,230,520,66
KIKUUBE,2021,300,240,540,66
KIKUUBE,2022,320,250,570,66
KIKUUBE,2023,330,260,590,66
KIKUUBE,2024,350,280,630,66
KIKUUBE,2025,360,290,650,66
KIRUHURA,2015,110,90,200,66
KIRUHURA,2016,120,100,220,66
KIRUHURA,2017,120,100,220,66
KIRUHURA,2018,130,100,230,66
KIRUHURA,2019,130,110,240,66
KIRUHURA,2020,140,110,250,66
KIRUHURA,2021,140,110,250,66
KIRUHURA,2022,150,120,270,66
KIRUHURA,2023,150,120,270,66
KIRUHURA,2024,160,130,290,66
KIRUHURA,2025,160,130,290,66
KIRYANDONGO,2015,180,210,390,66
KIRYANDONGO,2016,190,240,430,66
KIRYANDONGO,2017,210,260,470,66
KIRYANDONGO,2018,210,280,490,66
KIRYANDONGO,2019,220,260,480,66
KIRYANDONGO,2020,200,260,460,66
KIRYANDONGO,2021,200,230,430,66
KIRYANDONGO,2022,190,230,420,66
KIRYANDONGO,2023,200,230,430,66
KIRYANDONGO,2024,230,260,490,66
KIRYANDONGO,2025,250,290,540,66
KISORO,2015,230,240,470,66
KISORO,2016,240,260,500,66
KISORO,2017,250,290,540,66
KISORO,2018,260,290,550,66
KISORO,2019,250,280,530,66
KISORO,2020,250,270,520,66
KISORO,2021,230,240,470,66
KISORO,2022,230,230,460,66
KISORO,2023,230,240,470,66
KISORO,2024,250,260,510,66
KISORO,2025,290,310,600,66
KITAGWENDA,2015,150,150,300,66
KITAGWENDA,2016,150,150,300,66
KITAGWENDA,2017,160,160,320,66
KITAGWENDA,2018,160,160,320,66
KITAGWENDA,2019,170,170,340,66
KITAGWENDA,2020,180,170,350,66
KITAGWENDA,2021,180,180,360,66
KITAGWENDA,2022,190,190,380,66
KITAGWENDA,2023,200,190,390,66
KITAGWENDA,2024,210,200,410,66
KITAGWENDA,2025,210,200,410,66
KITGUM,2015,170,210,380,66
KITGUM,2016,180,240,420,66
KITGUM,2017,190,260,450,66
KITGUM,2018,200,260,460,66
KITGUM,2019,190,250,440,66
KITGUM,2020,180,240,420,66
KITGUM,2021,180,220,400,66
KITGUM,2022,170,200,370,66
KITGUM,2023,170,200,370,66
KITGUM,2024,190,240,430,66
KITGUM,2025,210,270,480,66
KOBOKO,2015,140,140,280,66
KOBOKO,2016,160,160,320,66
KOBOKO,2017,160,170,330,66
KOBOKO,2018,180,190,370,66
KOBOKO,2019,180,180,360,66
KOBOKO,2020,170,180,350,66
KOBOKO,2021,170,160,330,66
KOBOKO,2022,170,160,330,66
KOBOKO,2023,170,160,330,66
KOBOKO,2024,200,190,390,66
KOBOKO,2025,230,210,440,66
KOLE,2015,520,680,1200,66
KOLE,2016,540,700,1240,66
KOLE,2017,560,720,1280,66
KOLE,2018,580,740,1320,66
KOLE,2019,590,760,1350,66
KOLE,2020,610,780,1390,66
KOLE,2021,630,800,1430,66
KOLE,2022,650,820,1470,66
KOLE,2023,670,840,1510,66
KOLE,2024,690,860,1550,66
KOLE,2025,710,890,1600,66
KOTIDO,2015,80,90,170,66
KOTIDO,2016,80,90,170,66
KOTIDO,2017,80,100,180,66
KOTIDO,2018,80,120,200,66
KOTIDO,2019,90,110,200,66
KOTIDO,2020,90,100,190,66
KOTIDO,2021,80,90,170,66
KOTIDO,2022,80,90,170,66
KOTIDO,2023,80,90,170,66
KOTIDO,2024,80,110,190,66
KOTIDO,2025,100,120,220,66
KUMI,2015,230,260,490,66
KUMI,2016,240,300,540,66
KUMI,2017,260,330,590,66
KUMI,2018,270,330,600,66
KUMI,2019,270,330,600,66
KUMI,2020,260,320,580,66
KUMI,2021,250,290,540,66
KUMI,2022,250,280,530,66
KUMI,2023,260,290,550,66
KUMI,2024,280,320,600,66
KUMI,2025,320,370,690,66
KWANIA,2015,260,370,630,66
KWANIA,2016,270,380,650,66
KWANIA,2017,270,390,660,66
KWANIA,2018,280,400,680,66
KWANIA,2019,290,420,710,66
KWANIA,2020,300,430,730,66
KWANIA,2021,310,440,750,66
KWANIA,2022,320,450,770,66
KWANIA,2023,330,460,790,66
KWANIA,2024,330,470,800,66
KWANIA,2025,340,480,820,66
KWEEN,2015,90,80,170,66
KWEEN,2016,100,80,180,66
KWEEN,2017,100,80,180,66
KWEEN,2018,100,80,180,66
KWEEN,2019,110,80,190,66
KWEEN,2020,110,80,190,66
KWEEN,2021,110,90,200,66
KWEEN,2022,120,90,210,66
KWEEN,2023,120,90,210,66
KWEEN,2024,120,90,210,66
KWEEN,2025,130,90,220,66
KYANKWANZI,2015,360,350,710,66
KYANKWANZI,2016,380,370,750,66
KYANKWANZI,2017,400,390,790,66
KYANKWANZI,2018,420,410,830,66
KYANKWANZI,2019,440,430,870,66
KYANKWANZI,2020,470,440,910,66
KYANKWANZI,2021,490,460,950,66
KYANKWANZI,2022,510,480,990,66
KYANKWANZI,2023,540,510,1050,66
KYANKWANZI,2024,560,530,1090,66
KYANKWANZI,2025,590,550,1140,66
KYEGEGWA,2015,370,450,820,66
KYEGEGWA,2016,400,490,890,66
KYEGEGWA,2017,440,530,970,66
KYEGEGWA,2018,470,570,1040,66
KYEGEGWA,2019,510,610,1120,66
KYEGEGWA,2020,550,660,1210,66
KYEGEGWA,2021,600,710,1310,66
KYEGEGWA,2022,640,770,1410,66
KYEGEGWA,2023,690,830,1520,66
KYEGEGWA,2024,750,890,1640,66
KYEGEGWA,2025,810,950,1760,66
KYENJOJO,2015,480,640,1120,66
KYENJOJO,2016,500,670,1170,66
KYENJOJO,2017,520,690,1210,66
KYENJOJO,2018,540,720,1260,66
KYENJOJO,2019,560,740,1300,66
KYENJOJO,2020,580,770,1350,66
KYENJOJO,2021,600,790,1390,66
KYENJOJO,2022,630,820,1450,66
KYENJOJO,2023,650,850,1500,66
KYENJOJO,2024,670,880,1550,66
KYENJOJO,2025,700,900,1600,66
KYOTERA,2015,210,310,520,66
KYOTERA,2016,220,350,570,66
KYOTERA,2017,240,370,610,66
KYOTERA,2018,240,380,620,66
KYOTERA,2019,230,370,600,66
KYOTERA,2020,230,340,570,66
KYOTERA,2021,210,310,520,66
KYOTERA,2022,200,300,500,66
KYOTERA,2023,210,300,510,66
KYOTERA,2024,230,330,560,66
KYOTERA,2025,250,370,620,66
KARENGA,2015,50,40,90,66
KARENGA,2016,50,40,90,66
KARENGA,2017,50,50,100,66
KARENGA,2018,50,50,100,66
KARENGA,2019,50,50,100,66
KARENGA,2020,50,50,100,66
KARENGA,2021,50,50,100,66
KARENGA,2022,50,50,100,66
KARENGA,2023,60,50,110,66
KARENGA,2024,60,50,110,66
KARENGA,2025,60,50,110,66
LAMWO,2015,110,140,250,66
LAMWO,2016,110,150,260,66
LAMWO,2017,120,160,280,66
LAMWO,2018,120,160,280,66
LAMWO,2019,110,150,260,66
LAMWO,2020,110,140,250,66
LAMWO,2021,100,140,240,66
LAMWO,2022,110,130,240,66
LAMWO,2023,110,130,240,66
LAMWO,2024,110,140,250,66
LAMWO,2025,130,160,290,66
LIRA,2015,340,320,660,66
LIRA,2016,350,330,680,66
LIRA,2017,360,340,700,66
LIRA,2018,370,350,720,66
LIRA,2019,380,360,740,66
LIRA,2020,390,370,760,66
LIRA,2021,400,370,770,66
LIRA,2022,410,380,790,66
LIRA,2023,420,390,810,66
LIRA,2024,430,400,830,66
LIRA,2025,440,410,850,66
LUUKA,2015,160,210,370,66
LUUKA,2016,170,230,400,66
LUUKA,2017,180,260,440,66
LUUKA,2018,190,260,450,66
LUUKA,2019,180,250,430,66
LUUKA,2020,170,240,410,66
LUUKA,2021,170,220,390,66
LUUKA,2022,160,200,360,66
LUUKA,2023,170,210,380,66
LUUKA,2024,190,240,430,66
LUUKA,2025,210,270,480,66
LUWERO,2015,300,390,690,66
LUWERO,2016,330,430,760,66
LUWERO,2017,350,460,810,66
LUWERO,2018,350,480,830,66
LUWERO,2019,350,470,820,66
LUWERO,2020,340,430,770,66
LUWERO,2021,330,400,730,66
LUWERO,2022,320,390,710,66
LUWERO,2023,330,400,730,66
LUWERO,2024,360,440,800,66
LUWERO,2025,410,510,920,66
LWENGO,2015,240,340,580,66
LWENGO,2016,260,370,630,66
LWENGO,2017,270,400,670,66
LWENGO,2018,270,410,680,66
LWENGO,2019,270,390,660,66
LWENGO,2020,260,360,620,66
LWENGO,2021,240,340,580,66
LWENGO,2022,230,310,540,66
LWENGO,2023,230,310,540,66
LWENGO,2024,260,340,600,66
LWENGO,2025,290,390,680,66
LYANTONDE,2015,90,70,160,66
LYANTONDE,2016,90,80,170,66
LYANTONDE,2017,90,90,180,66
LYANTONDE,2018,90,100,190,66
LYANTONDE,2019,100,100,200,66
LYANTONDE,2020,100,90,190,66
LYANTONDE,2021,90,80,170,66
LYANTONDE,2022,90,80,170,66
LYANTONDE,2023,100,80,180,66
LYANTONDE,2024,100,90,190,66
LYANTONDE,2025,120,110,230,66
MANAFWA,2015,220,270,490,66
MANAFWA,2016,220,280,500,66
MANAFWA,2017,230,280,510,66
MANAFWA,2018,230,290,520,66
MANAFWA,2019,240,290,530,66
MANAFWA,2020,250,300,550,66
MANAFWA,2021,250,310,560,66
MANAFWA,2022,260,310,570,66
MANAFWA,2023,260,320,580,66
MANAFWA,2024,270,320,590,66
MANAFWA,2025,270,330,600,66
MARACHA,2015,190,190,380,66
MARACHA,2016,190,200,390,66
MARACHA,2017,200,200,400,66
MARACHA,2018,200,200,400,66
MARACHA,2019,200,210,410,66
MARACHA,2020,210,210,420,66
MARACHA,2021,210,210,420,66
MARACHA,2022,210,220,430,66
MARACHA,2023,220,220,440,66
MARACHA,2024,220,220,440,66
MARACHA,2025,230,230,460,66
MASAKA,2015,220,250,470,66
MASAKA,2016,240,260,500,66
MASAKA,2017,250,290,540,66
MASAKA,2018,270,320,590,66
MASAKA,2019,280,340,620,66
MASAKA,2020,290,360,650,66
MASAKA,2021,280,340,620,66
MASAKA,2022,280,330,610,66
MASAKA,2023,260,300,560,66
MASAKA,2024,260,290,550,66
MASAKA,2025,260,290,550,66
MASINDI,2015,250,200,450,66
MASINDI,2016,260,210,470,66
MASINDI,2017,270,210,480,66
MASINDI,2018,270,220,490,66
MASINDI,2019,280,230,510,66
MASINDI,2020,290,230,520,66
MASINDI,2021,300,240,540,66
MASINDI,2022,300,240,540,66
MASINDI,2023,310,250,560,66
MASINDI,2024,320,250,570,66
MASINDI,2025,330,260,590,66
MAYUGE,2015,360,390,750,66
MAYUGE,2016,390,430,820,66
MAYUGE,2017,410,470,880,66
MAYUGE,2018,420,490,910,66
MAYUGE,2019,420,480,900,66
MAYUGE,2020,420,460,880,66
MAYUGE,2021,400,430,830,66
MAYUGE,2022,400,410,810,66
MAYUGE,2023,410,420,830,66
MAYUGE,2024,450,470,920,66
MAYUGE,2025,510,550,1060,66
MBALE,2015,510,720,1230,66
MBALE,2016,550,810,1360,66
MBALE,2017,590,890,1480,66
MBALE,2018,610,930,1540,66
MBALE,2019,600,910,1510,66
MBALE,2020,590,870,1460,66
MBALE,2021,560,810,1370,66
MBALE,2022,560,770,1330,66
MBALE,2023,570,790,1360,66
MBALE,2024,640,910,1550,66
MBALE,2025,730,1060,1790,66
MBARARA,2015,270,280,550,66
MBARARA,2016,270,280,550,66
MBARARA,2017,280,290,570,66
MBARARA,2018,290,300,590,66
MBARARA,2019,290,300,590,66
MBARARA,2020,300,310,610,66
MBARARA,2021,300,320,620,66
MBARARA,2022,310,320,630,66
MBARARA,2023,320,330,650,66
MBARARA,2024,320,330,650,66
MBARARA,2025,330,340,670,66
MITOOMA,2015,170,160,330,66
MITOOMA,2016,180,170,350,66
MITOOMA,2017,180,170,350,66
MITOOMA,2018,180,170,350,66
MITOOMA,2019,180,170,350,66
MITOOMA,2020,180,170,350,66
MITOOMA,2021,190,170,360,66
MITOOMA,2022,190,170,360,66
MITOOMA,2023,190,180,370,66
MITOOMA,2024,190,180,370,66
MITOOMA,2025,190,180,370,66
MITYANA,2015,260,350,610,66
MITYANA,2016,280,390,670,66
MITYANA,2017,290,420,710,66
MITYANA,2018,310,430,740,66
MITYANA,2019,300,410,710,66
MITYANA,2020,290,380,670,66
MITYANA,2021,270,360,630,66
MITYANA,2022,270,330,600,66
MITYANA,2023,270,340,610,66
MITYANA,2024,290,380,670,66
MITYANA,2025,330,430,760,66
MOROTO,2015,40,90,130,66
MOROTO,2016,50,110,160,66
MOROTO,2017,50,110,160,66
MOROTO,2018,50,120,170,66
MOROTO,2019,60,110,170,66
MOROTO,2020,50,100,150,66
MOROTO,2021,50,90,140,66
MOROTO,2022,50,100,150,66
MOROTO,2023,50,100,150,66
MOROTO,2024,50,110,160,66
MOROTO,2025,60,120,180,66
MOYO,2015,80,100,180,66
MOYO,2016,80,100,180,66
MOYO,2017,80,100,180,66
MOYO,2018,80,110,190,66
MOYO,2019,80,110,190,66
MOYO,2020,90,110,200,66
MOYO,2021,90,110,200,66
MOYO,2022,90,110,200,66
MOYO,2023,90,120,210,66
MOYO,2024,90,120,210,66
MOYO,2025,90,120,210,66
MPIGI,2015,200,240,440,66
MPIGI,2016,210,260,470,66
MPIGI,2017,220,290,510,66
MPIGI,2018,220,290,510,66
MPIGI,2019,230,290,520,66
MPIGI,2020,210,270,480,66
MPIGI,2021,210,250,460,66
MPIGI,2022,200,240,440,66
MPIGI,2023,210,250,460,66
MPIGI,2024,230,270,500,66
MPIGI,2025,260,310,570,66
MUBENDE,2015,310,270,580,66
MUBENDE,2016,340,330,670,66
MUBENDE,2017,380,360,740,66
MUBENDE,2018,400,380,780,66
MUBENDE,2019,410,370,780,66
MUBENDE,2020,410,370,780,66
MUBENDE,2021,390,350,740,66
MUBENDE,2022,400,340,740,66
MUBENDE,2023,430,350,780,66
MUBENDE,2024,480,410,890,66
MUBENDE,2025,550,480,1030,66
MUKONO,2015,410,450,860,66
MUKONO,2016,460,500,960,66
MUKONO,2017,480,540,1020,66
MUKONO,2018,500,560,1060,66
MUKONO,2019,490,550,1040,66
MUKONO,2020,470,520,990,66
MUKONO,2021,450,490,940,66
MUKONO,2022,440,460,900,66
MUKONO,2023,470,470,940,66
MUKONO,2024,510,540,1050,66
MUKONO,2025,580,630,1210,66
MADI OKOLLO,2015,130,120,250,66
MADI OKOLLO,2016,140,120,260,66
MADI OKOLLO,2017,140,120,260,66
MADI OKOLLO,2018,140,130,270,66
MADI OKOLLO,2019,150,130,280,66
MADI OKOLLO,2020,150,140,290,66
MADI OKOLLO,2021,160,140,300,66
MADI OKOLLO,2022,160,140,300,66
MADI OKOLLO,2023,160,150,310,66
MADI OKOLLO,2024,170,150,320,66
MADI OKOLLO,2025,170,150,320,66
NABILATUK,2015,40,100,140,66
NABILATUK,2016,50,110,160,66
NABILATUK,2017,50,130,180,66
NABILATUK,2018,50,130,180,66
NABILATUK,2019,50,140,190,66
NABILATUK,2020,50,130,180,66
NABILATUK,2021,50,120,170,66
NABILATUK,2022,50,120,170,66
NABILATUK,2023,50,120,170,66
NABILATUK,2024,60,140,200,66
NABILATUK,2025,70,160,230,66
NAKAPIRIPIRIT,2015,90,150,240,66
NAKAPIRIPIRIT,2016,90,160,250,66
NAKAPIRIPIRIT,2017,110,190,300,66
NAKAPIRIPIRIT,2018,110,200,310,66
NAKAPIRIPIRIT,2019,100,190,290,66
NAKAPIRIPIRIT,2020,110,190,300,66
NAKAPIRIPIRIT,2021,100,170,270,66
NAKAPIRIPIRIT,2022,110,170,280,66
NAKAPIRIPIRIT,2023,110,180,290,66
NAKAPIRIPIRIT,2024,130,200,330,66
NAKAPIRIPIRIT,2025,140,240,380,66
NAKASEKE,2015,120,110,230,66
NAKASEKE,2016,130,110,240,66
NAKASEKE,2017,130,120,250,66
NAKASEKE,2018,140,120,260,66
NAKASEKE,2019,140,120,260,66
NAKASEKE,2020,150,120,270,66
NAKASEKE,2021,150,130,280,66
NAKASEKE,2022,160,130,290,66
NAKASEKE,2023,160,130,290,66
NAKASEKE,2024,170,140,310,66
NAKASEKE,2025,170,140,310,66
NAKASONGOLA,2015,170,110,280,66
NAKASONGOLA,2016,180,140,320,66
NAKASONGOLA,2017,200,140,340,66
NAKASONGOLA,2018,200,140,340,66
NAKASONGOLA,2019,210,140,350,66
NAKASONGOLA,2020,190,140,330,66
NAKASONGOLA,2021,190,130,320,66
NAKASONGOLA,2022,180,120,300,66
NAKASONGOLA,2023,190,120,310,66
NAKASONGOLA,2024,220,140,360,66
NAKASONGOLA,2025,240,160,400,66
NAMAYINGO,2015,160,170,330,66
NAMAYINGO,2016,170,190,360,66
NAMAYINGO,2017,190,200,390,66
NAMAYINGO,2018,190,200,390,66
NAMAYINGO,2019,180,190,370,66
NAMAYINGO,2020,180,190,370,66
NAMAYINGO,2021,170,170,340,66
NAMAYINGO,2022,160,160,320,66
NAMAYINGO,2023,170,160,330,66
NAMAYINGO,2024,190,180,370,66
NAMAYINGO,2025,210,200,410,66
NAMISINDWA,2015,290,310,600,66
NAMISINDWA,2016,290,310,600,66
NAMISINDWA,2017,300,320,620,66
NAMISINDWA,2018,310,330,640,66
NAMISINDWA,2019,320,340,660,66
NAMISINDWA,2020,330,340,670,66
NAMISINDWA,2021,340,350,690,66
NAMISINDWA,2022,350,360,710,66
NAMISINDWA,2023,350,360,710,66
NAMISINDWA,2024,360,370,730,66
NAMISINDWA,2025,370,380,750,66
NAMUTUMBA,2015,240,220,460,66
NAMUTUMBA,2016,260,260,520,66
NAMUTUMBA,2017,270,290,560,66
NAMUTUMBA,2018,280,290,570,66
NAMUTUMBA,2019,280,290,570,66
NAMUTUMBA,2020,280,280,560,66
NAMUTUMBA,2021,270,250,520,66
NAMUTUMBA,2022,270,250,520,66
NAMUTUMBA,2023,280,260,540,66
NAMUTUMBA,2024,310,280,590,66
NAMUTUMBA,2025,360,330,690,66
NAPAK,2015,100,190,290,66
NAPAK,2016,100,220,320,66
NAPAK,2017,110,230,340,66
NAPAK,2018,110,230,340,66
NAPAK,2019,100,240,340,66
NAPAK,2020,110,220,330,66
NAPAK,2021,100,200,300,66
NAPAK,2022,100,190,290,66
NAPAK,2023,100,190,290,66
NAPAK,2024,100,210,310,66
NAPAK,2025,120,240,360,66
NEBBI,2015,370,610,980,66
NEBBI,2016,380,630,1010,66
NEBBI,2017,400,650,1050,66
NEBBI,2018,410,670,1080,66
NEBBI,2019,420,690,1110,66
NEBBI,2020,430,700,1130,66
NEBBI,2021,450,720,1170,66
NEBBI,2022,460,740,1200,66
NEBBI,2023,470,760,1230,66
NEBBI,2024,480,780,1260,66
NEBBI,2025,500,800,1300,66
NGORA,2015,130,140,270,66
NGORA,2016,140,150,290,66
NGORA,2017,140,160,300,66
NGORA,2018,150,170,320,66
NGORA,2019,150,170,320,66
NGORA,2020,150,150,300,66
NGORA,2021,140,150,290,66
NGORA,2022,140,140,280,66
NGORA,2023,150,140,290,66
NGORA,2024,160,160,320,66
NGORA,2025,170,190,360,66
NTOROKO,2015,40,40,80,66
NTOROKO,2016,60,40,100,66
NTOROKO,2017,60,40,100,66
NTOROKO,2018,60,40,100,66
NTOROKO,2019,60,40,100,66
NTOROKO,2020,50,40,90,66
NTOROKO,2021,50,30,80,66
NTOROKO,2022,50,30,80,66
NTOROKO,2023,50,30,80,66
NTOROKO,2024,50,40,90,66
NTOROKO,2025,70,40,110,66
NTUNGAMO,2015,420,480,900,66
NTUNGAMO,2016,430,490,920,66
NTUNGAMO,2017,440,500,940,66
NTUNGAMO,2018,450,510,960,66
NTUNGAMO,2019,460,520,980,66
NTUNGAMO,2020,460,530,990,66
NTUNGAMO,2021,470,530,1000,66
NTUNGAMO,2022,480,540,1020,66
NTUNGAMO,2023,490,550,1040,66
NTUNGAMO,2024,500,560,1060,66
NTUNGAMO,2025,510,570,1080,66
NWOYA,2015,120,110,230,66
NWOYA,2016,130,120,250,66
NWOYA,2017,140,130,270,66
NWOYA,2018,160,140,300,66
NWOYA,2019,170,160,330,66
NWOYA,2020,190,170,360,66
NWOYA,2021,210,190,400,66
NWOYA,2022,230,210,440,66
NWOYA,2023,250,230,480,66
NWOYA,2024,280,250,530,66
NWOYA,2025,300,270,570,66
OBONGI,2015,30,20,50,66
OBONGI,2016,30,30,60,66
OBONGI,2017,40,30,70,66
OBONGI,2018,40,30,70,66
OBONGI,2019,30,30,60,66
OBONGI,2020,40,30,70,66
OBONGI,2021,40,20,60,66
OBONGI,2022,40,20,60,66
OBONGI,2023,40,30,70,66
OBONGI,2024,40,40,80,66
OBONGI,2025,50,40,90,66
OMORO,2015,120,160,280,66
OMORO,2016,130,190,320,66
OMORO,2017,140,200,340,66
OMORO,2018,140,220,360,66
OMORO,2019,150,210,360,66
OMORO,2020,140,200,340,66
OMORO,2021,140,190,330,66
OMORO,2022,140,180,320,66
OMORO,2023,150,180,330,66
OMORO,2024,160,210,370,66
OMORO,2025,170,240,410,66
OTUKE,2015,100,110,210,66
OTUKE,2016,100,110,210,66
OTUKE,2017,110,120,230,66
OTUKE,2018,110,120,230,66
OTUKE,2019,120,130,250,66
OTUKE,2020,120,130,250,66
OTUKE,2021,130,140,270,66
OTUKE,2022,130,140,270,66
OTUKE,2023,140,150,290,66
OTUKE,2024,140,150,290,66
OTUKE,2025,150,160,310,66
OYAM,2015,390,400,790,66
OYAM,2016,400,410,810,66
OYAM,2017,410,420,830,66
OYAM,2018,430,440,870,66
OYAM,2019,440,450,890,66
OYAM,2020,450,460,910,66
OYAM,2021,460,470,930,66
OYAM,2022,480,490,970,66
OYAM,2023,490,500,990,66
OYAM,2024,500,510,1010,66
OYAM,2025,520,520,1040,66
PADER,2015,110,120,230,66
PADER,2016,110,150,260,66
PADER,2017,120,160,280,66
PADER,2018,120,160,280,66
PADER,2019,130,150,280,66
PADER,2020,120,140,260,66
PADER,2021,110,140,250,66
PADER,2022,110,130,240,66
PADER,2023,110,130,240,66
PADER,2024,110,140,250,66
PADER,2025,140,160,300,66
PAKWACH,2015,220,360,580,66
PAKWACH,2016,230,370,600,66
PAKWACH,2017,240,390,630,66
PAKWACH,2018,250,400,650,66
PAKWACH,2019,260,420,680,66
PAKWACH,2020,270,430,700,66
PAKWACH,2021,280,450,730,66
PAKWACH,2022,290,460,750,66
PAKWACH,2023,300,480,780,66
PAKWACH,2024,310,490,800,66
PAKWACH,2025,320,510,830,66
PALLISA,2015,260,250,510,66
PALLISA,2016,280,280,560,66
PALLISA,2017,310,320,630,66
PALLISA,2018,330,330,660,66
PALLISA,2019,330,330,660,66
PALLISA,2020,320,320,640,66
PALLISA,2021,310,300,610,66
PALLISA,2022,320,290,610,66
PALLISA,2023,330,300,630,66
PALLISA,2024,360,340,700,66
PALLISA,2025,430,400,830,66
RAKAI,2015,240,260,500,66
RAKAI,2016,260,280,540,66
RAKAI,2017,270,300,570,66
RAKAI,2018,280,320,600,66
RAKAI,2019,280,300,580,66
RAKAI,2020,270,290,560,66
RAKAI,2021,260,270,530,66
RAKAI,2022,260,260,520,66
RAKAI,2023,260,260,520,66
RAKAI,2024,290,290,580,66
RAKAI,2025,320,330,650,66
RUBANDA,2015,180,170,350,66
RUBANDA,2016,180,170,350,66
RUBANDA,2017,180,180,360,66
RUBANDA,2018,190,180,370,66
RUBANDA,2019,190,180,370,66
RUBANDA,2020,190,180,370,66
RUBANDA,2021,190,180,370,66
RUBANDA,2022,200,180,380,66
RUBANDA,2023,200,180,380,66
RUBANDA,2024,200,180,380,66
RUBANDA,2025,200,180,380,66
RUBIRIZI,2015,110,120,230,66
RUBIRIZI,2016,110,130,240,66
RUBIRIZI,2017,110,130,240,66
RUBIRIZI,2018,110,130,240,66
RUBIRIZI,2019,110,130,240,66
RUBIRIZI,2020,120,130,250,66
RUBIRIZI,2021,120,140,260,66
RUBIRIZI,2022,120,140,260,66
RUBIRIZI,2023,120,140,260,66
RUBIRIZI,2024,120,140,260,66
RUBIRIZI,2025,130,150,280,66
RUKIGA,2015,110,100,210,66
RUKIGA,2016,110,100,210,66
RUKIGA,2017,110,100,210,66
RUKIGA,2018,110,100,210,66
RUKIGA,2019,110,100,210,66
RUKIGA,2020,110,100,210,66
RUKIGA,2021,110,100,210,66
RUKIGA,2022,110,100,210,66
RUKIGA,2023,110,100,210,66
RUKIGA,2024,120,100,220,66
RUKIGA,2025,120,100,220,66
RUKUNGIRI,2015,320,330,650,66
RUKUNGIRI,2016,330,340,670,66
RUKUNGIRI,2017,330,340,670,66
RUKUNGIRI,2018,340,340,680,66
RUKUNGIRI,2019,340,350,690,66
RUKUNGIRI,2020,340,350,690,66
RUKUNGIRI,2021,350,350,700,66
RUKUNGIRI,2022,350,350,700,66
RUKUNGIRI,2023,350,360,710,66
RUKUNGIRI,2024,360,360,720,66
RUKUNGIRI,2025,360,360,720,66
RWAMPARA,2015,110,130,240,66
RWAMPARA,2016,110,130,240,66
RWAMPARA,2017,120,130,250,66
RWAMPARA,2018,120,140,260,66
RWAMPARA,2019,120,140,260,66
RWAMPARA,2020,130,140,270,66
RWAMPARA,2021,130,140,270,66
RWAMPARA,2022,130,150,280,66
RWAMPARA,2023,130,150,280,66
RWAMPARA,2024,140,150,290,66
RWAMPARA,2025,140,160,300,66
SERERE,2015,250,260,510,66
SERERE,2016,270,280,550,66
SERERE,2017,290,320,610,66
SERERE,2018,310,330,640,66
SERERE,2019,320,330,650,66
SERERE,2020,310,320,630,66
SERERE,2021,300,300,600,66
SERERE,2022,300,290,590,66
SERERE,2023,310,300,610,66
SERERE,2024,340,340,680,66
SERERE,2025,400,400,800,66
SHEEMA,2015,180,220,400,66
SHEEMA,2016,190,220,410,66
SHEEMA,2017,190,220,410,66
SHEEMA,2018,190,220,410,66
SHEEMA,2019,190,230,420,66
SHEEMA,2020,200,230,430,66
SHEEMA,2021,200,230,430,66
SHEEMA,2022,200,230,430,66
SHEEMA,2023,200,230,430,66
SHEEMA,2024,200,230,430,66
SHEEMA,2025,200,240,440,66
SIRONKO,2015,320,360,680,66
SIRONKO,2016,330,370,700,66
SIRONKO,2017,340,380,720,66
SIRONKO,2018,340,390,730,66
SIRONKO,2019,350,390,740,66
SIRONKO,2020,360,400,760,66
SIRONKO,2021,370,410,780,66
SIRONKO,2022,370,420,790,66
SIRONKO,2023,380,420,800,66
SIRONKO,2024,390,430,820,66
SIRONKO,2025,400,440,840,66
SOROTI,2015,240,260,500,66
SOROTI,2016,260,280,540,66
SOROTI,2017,280,320,600,66
SOROTI,2018,290,330,620,66
SOROTI,2019,300,330,630,66
SOROTI,2020,280,310,590,66
SOROTI,2021,270,290,560,66
SOROTI,2022,270,280,550,66
SOROTI,2023,280,290,570,66
SOROTI,2024,310,330,640,66
SOROTI,2025,360,390,750,66
SSEMBABULE,2015,230,240,470,66
SSEMBABULE,2016,250,260,510,66
SSEMBABULE,2017,260,290,550,66
SSEMBABULE,2018,270,290,560,66
SSEMBABULE,2019,270,290,560,66
SSEMBABULE,2020,260,270,530,66
SSEMBABULE,2021,250,250,500,66
SSEMBABULE,2022,250,240,490,66
SSEMBABULE,2023,250,250,500,66
SSEMBABULE,2024,280,270,550,66
SSEMBABULE,2025,320,320,640,66
TORORO,2015,510,540,1050,66
TORORO,2016,520,560,1080,66
TORORO,2017,540,570,1110,66
TORORO,2018,550,580,1130,66
TORORO,2019,560,600,1160,66
TORORO,2020,580,610,1190,66
TORORO,2021,590,630,1220,66
TORORO,2022,610,640,1250,66
TORORO,2023,620,660,1280,66
TORORO,2024,630,670,1300,66
TORORO,2025,650,680,1330,66
WAKISO,2015,700,880,1580,66
WAKISO,2016,740,940,1680,66
WAKISO,2017,790,1000,1790,66
WAKISO,2018,850,1070,1920,66
WAKISO,2019,900,1140,2040,66
WAKISO,2020,960,1220,2180,66
WAKISO,2021,1020,1300,2320,66
WAKISO,2022,1090,1380,2470,66
WAKISO,2023,1160,1470,2630,66
WAKISO,2024,1230,1560,2790,66
WAKISO,2025,1300,1660,2960,66
YUMBE,2015,610,740,1350,66
YUMBE,2016,670,850,1520,66
YUMBE,2017,730,950,1680,66
YUMBE,2018,770,1010,1780,66
YUMBE,2019,770,1020,1790,66
YUMBE,2020,770,1010,1780,66
YUMBE,2021,750,960,1710,66
YUMBE,2022,760,940,1700,66
YUMBE,2023,810,1000,1810,66
YUMBE,2024,910,1150,2060,66
YUMBE,2025,1050,1380,2430,66
ZOMBO,2015,590,920,1510,66
ZOMBO,2016,610,950,1560,66
ZOMBO,2017,630,970,1600,66
ZOMBO,2018,650,1000,1650,66
ZOMBO,2019,670,1030,1700,66
ZOMBO,2020,690,1050,1740,66
ZOMBO,2021,710,1080,1790,66
ZOMBO,2022,730,1110,1840,66
ZOMBO,2023,750,1130,1880,66
ZOMBO,2024,770,1160,1930,66
ZOMBO,2025,780,1190,1970,66
ABIM,2015,70,80,150,67
ABIM,2016,90,90,180,67
ABIM,2017,90,110,200,67
ABIM,2018,100,110,210,67
ABIM,2019,110,130,240,67
ABIM,2020,110,120,230,67
ABIM,2021,110,130,240,67
ABIM,2022,110,130,240,67
ABIM,2023,120,120,240,67
ABIM,2024,120,130,250,67
ABIM,2025,140,140,280,67
ADJUMANI,2015,130,150,280,67
ADJUMANI,2016,130,150,280,67
ADJUMANI,2017,130,150,280,67
ADJUMANI,2018,140,160,300,67
ADJUMANI,2019,140,160,300,67
ADJUMANI,2020,140,160,300,67
ADJUMANI,2021,140,160,300,67
ADJUMANI,2022,140,160,300,67
ADJUMANI,2023,140,160,300,67
ADJUMANI,2024,140,160,300,67
ADJUMANI,2025,140,160,300,67
AGAGO,2015,170,210,380,67
AGAGO,2016,180,220,400,67
AGAGO,2017,180,220,400,67
AGAGO,2018,180,230,410,67
AGAGO,2019,190,230,420,67
AGAGO,2020,190,230,420,67
AGAGO,2021,190,240,430,67
AGAGO,2022,190,240,430,67
AGAGO,2023,200,240,440,67
AGAGO,2024,200,250,450,67
AGAGO,2025,200,250,450,67
ALEBTONG,2015,250,220,470,67
ALEBTONG,2016,270,250,520,67
ALEBTONG,2017,290,270,560,67
ALEBTONG,2018,310,300,610,67
ALEBTONG,2019,320,300,620,67
ALEBTONG,2020,320,300,620,67
ALEBTONG,2021,310,280,590,67
ALEBTONG,2022,300,270,570,67
ALEBTONG,2023,290,260,550,67
ALEBTONG,2024,300,260,560,67
ALEBTONG,2025,330,290,620,67
AMOLATAR,2015,140,120,260,67
AMOLATAR,2016,140,140,280,67
AMOLATAR,2017,150,150,300,67
AMOLATAR,2018,160,160,320,67
AMOLATAR,2019,160,170,330,67
AMOLATAR,2020,160,170,330,67
AMOLATAR,2021,160,150,310,67
AMOLATAR,2022,150,140,290,67
AMOLATAR,2023,150,140,290,67
AMOLATAR,2024,160,140,300,67
AMOLATAR,2025,170,150,320,67
AMUDAT,2015,50,30,80,67
AMUDAT,2016,50,40,90,67
AMUDAT,2017,70,40,110,67
AMUDAT,2018,70,40,110,67
AMUDAT,2019,70,40,110,67
AMUDAT,2020,70,60,130,67
AMUDAT,2021,80,50,130,67
AMUDAT,2022,70,50,120,67
AMUDAT,2023,70,40,110,67
AMUDAT,2024,70,40,110,67
AMUDAT,2025,80,50,130,67
AMURIA,2015,130,190,320,67
AMURIA,2016,130,180,310,67
AMURIA,2017,120,160,280,67
AMURIA,2018,120,150,270,67
AMURIA,2019,120,150,270,67
AMURIA,2020,130,160,290,67
AMURIA,2021,140,170,310,67
AMURIA,2022,150,200,350,67
AMURIA,2023,160,220,380,67
AMURIA,2024,170,230,400,67
AMURIA,2025,170,230,400,67
AMURU,2015,140,220,360,67
AMURU,2016,150,240,390,67
AMURU,2017,160,270,430,67
AMURU,2018,160,290,450,67
AMURU,2019,180,300,480,67
AMURU,2020,170,290,460,67
AMURU,2021,160,280,440,67
AMURU,2022,160,250,410,67
AMURU,2023,150,250,400,67
AMURU,2024,160,250,410,67
AMURU,2025,180,280,460,67
APAC,2015,230,290,520,67
APAC,2016,240,300,540,67
APAC,2017,250,310,560,67
APAC,2018,260,320,580,67
APAC,2019,270,330,600,67
APAC,2020,280,340,620,67
APAC,2021,290,350,640,67
APAC,2022,300,370,670,67
APAC,2023,310,380,690,67
APAC,2024,320,390,710,67
APAC,2025,330,400,730,67
ARUA,2015,440,520,960,67
ARUA,2016,450,530,980,67
ARUA,2017,470,550,1020,67
ARUA,2018,480,560,1040,67
ARUA,2019,490,580,1070,67
ARUA,2020,510,590,1100,67
ARUA,2021,520,610,1130,67
ARUA,2022,530,620,1150,67
ARUA,2023,550,640,1190,67
ARUA,2024,560,650,1210,67
ARUA,2025,580,670,1250,67
BUDAKA,2015,150,190,340,67
BUDAKA,2016,150,210,360,67
BUDAKA,2017,170,230,400,67
BUDAKA,2018,170,260,430,67
BUDAKA,2019,190,260,450,67
BUDAKA,2020,190,260,450,67
BUDAKA,2021,180,260,440,67
BUDAKA,2022,180,230,410,67
BUDAKA,2023,170,230,400,67
BUDAKA,2024,180,230,410,67
BUDAKA,2025,210,260,470,67
BUDUDA,2015,170,150,320,67
BUDUDA,2016,170,160,330,67
BUDUDA,2017,190,190,380,67
BUDUDA,2018,210,220,430,67
BUDUDA,2019,220,220,440,67
BUDUDA,2020,220,220,440,67
BUDUDA,2021,210,220,430,67
BUDUDA,2022,210,200,410,67
BUDUDA,2023,210,190,400,67
BUDUDA,2024,220,200,420,67
BUDUDA,2025,250,220,470,67
BUGIRI,2015,230,260,490,67
BUGIRI,2016,250,270,520,67
BUGIRI,2017,270,310,580,67
BUGIRI,2018,290,340,630,67
BUGIRI,2019,310,360,670,67
BUGIRI,2020,310,360,670,67
BUGIRI,2021,300,340,640,67
BUGIRI,2022,290,320,610,67
BUGIRI,2023,290,310,600,67
BUGIRI,2024,310,320,630,67
BUGIRI,2025,340,370,710,67
BUGWERI,2015,110,130,240,67
BUGWERI,2016,120,140,260,67
BUGWERI,2017,140,160,300,67
BUGWERI,2018,140,170,310,67
BUGWERI,2019,140,170,310,67
BUGWERI,2020,150,180,330,67
BUGWERI,2021,140,170,310,67
BUGWERI,2022,130,150,280,67
BUGWERI,2023,130,140,270,67
BUGWERI,2024,140,150,290,67
BUGWERI,2025,150,160,310,67
BUHWEJU,2015,80,90,170,67
BUHWEJU,2016,80,90,170,67
BUHWEJU,2017,90,100,190,67
BUHWEJU,2018,90,100,190,67
BUHWEJU,2019,90,100,190,67
BUHWEJU,2020,90,110,200,67
BUHWEJU,2021,100,110,210,67
BUHWEJU,2022,100,110,210,67
BUHWEJU,2023,100,110,210,67
BUHWEJU,2024,110,120,230,67
BUHWEJU,2025,110,120,230,67
BUIKWE,2015,290,310,600,67
BUIKWE,2016,300,350,650,67
BUIKWE,2017,330,390,720,67
BUIKWE,2018,350,420,770,67
BUIKWE,2019,350,430,780,67
BUIKWE,2020,350,410,760,67
BUIKWE,2021,330,400,730,67
BUIKWE,2022,320,360,680,67
BUIKWE,2023,320,340,660,67
BUIKWE,2024,320,340,660,67
BUIKWE,2025,360,390,750,67
BUKEDEA,2015,170,210,380,67
BUKEDEA,2016,170,220,390,67
BUKEDEA,2017,190,260,450,67
BUKEDEA,2018,210,290,500,67
BUKEDEA,2019,220,300,520,67
BUKEDEA,2020,220,290,510,67
BUKEDEA,2021,210,280,490,67
BUKEDEA,2022,210,270,480,67
BUKEDEA,2023,210,260,470,67
BUKEDEA,2024,220,270,490,67
BUKEDEA,2025,250,310,560,67
BUKOMANSIMBI,2015,160,160,320,67
BUKOMANSIMBI,2016,160,170,330,67
BUKOMANSIMBI,2017,170,190,360,67
BUKOMANSIMBI,2018,170,200,370,67
BUKOMANSIMBI,2019,180,200,380,67
BUKOMANSIMBI,2020,170,190,360,67
BUKOMANSIMBI,2021,170,180,350,67
BUKOMANSIMBI,2022,160,160,320,67
BUKOMANSIMBI,2023,150,150,300,67
BUKOMANSIMBI,2024,160,150,310,67
BUKOMANSIMBI,2025,170,160,330,67
BUKWO,2015,50,40,90,67
BUKWO,2016,60,50,110,67
BUKWO,2017,60,50,110,67
BUKWO,2018,60,50,110,67
BUKWO,2019,70,50,120,67
BUKWO,2020,70,60,130,67
BUKWO,2021,70,60,130,67
BUKWO,2022,80,60,140,67
BUKWO,2023,80,60,140,67
BUKWO,2024,80,70,150,67
BUKWO,2025,90,70,160,67
BULAMBULI,2015,150,150,300,67
BULAMBULI,2016,150,170,320,67
BULAMBULI,2017,170,200,370,67
BULAMBULI,2018,190,220,410,67
BULAMBULI,2019,200,230,430,67
BULAMBULI,2020,200,240,440,67
BULAMBULI,2021,190,220,410,67
BULAMBULI,2022,190,210,400,67
BULAMBULI,2023,190,200,390,67
BULAMBULI,2024,200,210,410,67
BULAMBULI,2025,230,250,480,67
BULIISA,2015,70,70,140,67
BULIISA,2016,70,80,150,67
BULIISA,2017,80,80,160,67
BULIISA,2018,80,80,160,67
BULIISA,2019,90,90,180,67
BULIISA,2020,90,90,180,67
BULIISA,2021,100,100,200,67
BULIISA,2022,100,100,200,67
BULIISA,2023,110,100,210,67
BULIISA,2024,110,110,220,67
BULIISA,2025,120,110,230,67
BUNDIBUGYO,2015,190,150,340,67
BUNDIBUGYO,2016,200,170,370,67
BUNDIBUGYO,2017,220,190,410,67
BUNDIBUGYO,2018,230,200,430,67
BUNDIBUGYO,2019,250,220,470,67
BUNDIBUGYO,2020,240,210,450,67
BUNDIBUGYO,2021,240,190,430,67
BUNDIBUGYO,2022,220,180,400,67
BUNDIBUGYO,2023,220,170,390,67
BUNDIBUGYO,2024,230,180,410,67
BUNDIBUGYO,2025,250,200,450,67
BUNYANGABU,2015,150,160,310,67
BUNYANGABU,2016,150,170,320,67
BUNYANGABU,2017,160,200,360,67
BUNYANGABU,2018,170,220,390,67
BUNYANGABU,2019,180,220,400,67
BUNYANGABU,2020,180,220,400,67
BUNYANGABU,2021,170,200,370,67
BUNYANGABU,2022,160,180,340,67
BUNYANGABU,2023,160,180,340,67
BUNYANGABU,2024,170,180,350,67
BUNYANGABU,2025,180,200,380,67
BUSHENYI,2015,180,220,400,67
BUSHENYI,2016,180,220,400,67
BUSHENYI,2017,180,220,400,67
BUSHENYI,2018,180,220,400,67
BUSHENYI,2019,190,220,410,67
BUSHENYI,2020,190,230,420,67
BUSHENYI,2021,190,230,420,67
BUSHENYI,2022,190,230,420,67
BUSHENYI,2023,190,230,420,67
BUSHENYI,2024,200,230,430,67
BUSHENYI,2025,200,230,430,67
BUSIA,2015,230,300,530,67
BUSIA,2016,250,320,570,67
BUSIA,2017,260,370,630,67
BUSIA,2018,280,400,680,67
BUSIA,2019,290,420,710,67
BUSIA,2020,290,410,700,67
BUSIA,2021,280,380,660,67
BUSIA,2022,270,360,630,67
BUSIA,2023,270,340,610,67
BUSIA,2024,280,350,630,67
BUSIA,2025,310,400,710,67
BUTALEJA,2015,170,220,390,67
BUTALEJA,2016,180,240,420,67
BUTALEJA,2017,190,270,460,67
BUTALEJA,2018,210,300,510,67
BUTALEJA,2019,210,320,530,67
BUTALEJA,2020,220,300,520,67
BUTALEJA,2021,210,290,500,67
BUTALEJA,2022,210,280,490,67
BUTALEJA,2023,200,270,470,67
BUTALEJA,2024,210,270,480,67
BUTALEJA,2025,240,310,550,67
BUTAMBALA,2015,60,100,160,67
BUTAMBALA,2016,80,110,190,67
BUTAMBALA,2017,80,120,200,67
BUTAMBALA,2018,80,130,210,67
BUTAMBALA,2019,80,130,210,67
BUTAMBALA,2020,80,120,200,67
BUTAMBALA,2021,80,110,190,67
BUTAMBALA,2022,70,100,170,67
BUTAMBALA,2023,70,110,180,67
BUTAMBALA,2024,70,110,180,67
BUTAMBALA,2025,70,120,190,67
BUTEBO,2015,70,80,150,67
BUTEBO,2016,80,90,170,67
BUTEBO,2017,80,90,170,67
BUTEBO,2018,90,100,190,67
BUTEBO,2019,90,100,190,67
BUTEBO,2020,90,100,190,67
BUTEBO,2021,90,90,180,67
BUTEBO,2022,80,80,160,67
BUTEBO,2023,80,80,160,67
BUTEBO,2024,80,80,160,67
BUTEBO,2025,80,80,160,67
BUVUMA,2015,50,20,70,67
BUVUMA,2016,50,20,70,67
BUVUMA,2017,50,20,70,67
BUVUMA,2018,60,20,80,67
BUVUMA,2019,60,20,80,67
BUVUMA,2020,60,30,90,67
BUVUMA,2021,70,30,100,67
BUVUMA,2022,70,30,100,67
BUVUMA,2023,80,30,110,67
BUVUMA,2024,80,30,110,67
BUVUMA,2025,80,40,120,67
BUYENDE,2015,210,190,400,67
BUYENDE,2016,230,210,440,67
BUYENDE,2017,250,240,490,67
BUYENDE,2018,270,270,540,67
BUYENDE,2019,280,280,560,67
BUYENDE,2020,280,280,560,67
BUYENDE,2021,280,270,550,67
BUYENDE,2022,270,250,520,67
BUYENDE,2023,280,250,530,67
BUYENDE,2024,290,260,550,67
BUYENDE,2025,320,280,600,67
DOKOLO,2015,180,170,350,67
DOKOLO,2016,180,180,360,67
DOKOLO,2017,190,180,370,67
DOKOLO,2018,200,190,390,67
DOKOLO,2019,200,190,390,67
DOKOLO,2020,210,200,410,67
DOKOLO,2021,210,200,410,67
DOKOLO,2022,220,210,430,67
DOKOLO,2023,220,210,430,67
DOKOLO,2024,230,220,450,67
DOKOLO,2025,240,220,460,67
GOMBA,2015,140,150,290,67
GOMBA,2016,150,160,310,67
GOMBA,2017,160,180,340,67
GOMBA,2018,160,190,350,67
GOMBA,2019,160,190,350,67
GOMBA,2020,170,180,350,67
GOMBA,2021,160,170,330,67
GOMBA,2022,150,160,310,67
GOMBA,2023,140,150,290,67
GOMBA,2024,160,150,310,67
GOMBA,2025,170,160,330,67
GULU,2015,140,230,370,67
GULU,2016,140,240,380,67
GULU,2017,150,250,400,67
GULU,2018,150,250,400,67
GULU,2019,160,260,420,67
GULU,2020,160,270,430,67
GULU,2021,160,270,430,67
GULU,2022,170,280,450,67
GULU,2023,170,290,460,67
GULU,2024,180,300,480,67
GULU,2025,180,300,480,67
HOIMA,2015,190,240,430,67
HOIMA,2016,200,240,440,67
HOIMA,2017,210,250,460,67
HOIMA,2018,220,260,480,67
HOIMA,2019,230,270,500,67
HOIMA,2020,230,280,510,67
HOIMA,2021,240,290,530,67
HOIMA,2022,250,300,550,67
HOIMA,2023,260,310,570,67
HOIMA,2024,270,320,590,67
HOIMA,2025,280,320,600,67
IBANDA,2015,200,240,440,67
IBANDA,2016,200,240,440,67
IBANDA,2017,200,240,440,67
IBANDA,2018,210,250,460,67
IBANDA,2019,210,250,460,67
IBANDA,2020,220,260,480,67
IBANDA,2021,220,260,480,67
IBANDA,2022,220,260,480,67
IBANDA,2023,230,270,500,67
IBANDA,2024,230,270,500,67
IBANDA,2025,230,280,510,67
IGANGA,2015,180,190,370,67
IGANGA,2016,190,210,400,67
IGANGA,2017,220,230,450,67
IGANGA,2018,220,260,480,67
IGANGA,2019,230,260,490,67
IGANGA,2020,230,260,490,67
IGANGA,2021,230,240,470,67
IGANGA,2022,220,230,450,67
IGANGA,2023,210,210,420,67
IGANGA,2024,220,230,450,67
IGANGA,2025,240,250,490,67
ISINGIRO,2015,380,390,770,67
ISINGIRO,2016,400,400,800,67
ISINGIRO,2017,410,420,830,67
ISINGIRO,2018,430,430,860,67
ISINGIRO,2019,440,440,880,67
ISINGIRO,2020,460,460,920,67
ISINGIRO,2021,470,470,940,67
ISINGIRO,2022,490,490,980,67
ISINGIRO,2023,510,510,1020,67
ISINGIRO,2024,520,520,1040,67
ISINGIRO,2025,540,540,1080,67
JINJA,2015,240,250,490,67
JINJA,2016,250,250,500,67
JINJA,2017,250,260,510,67
JINJA,2018,260,260,520,67
JINJA,2019,260,270,530,67
JINJA,2020,260,270,530,67
JINJA,2021,270,270,540,67
JINJA,2022,270,280,550,67
JINJA,2023,270,280,550,67
JINJA,2024,280,280,560,67
JINJA,2025,280,290,570,67
KAABONG,2015,60,60,120,67
KAABONG,2016,60,60,120,67
KAABONG,2017,60,60,120,67
KAABONG,2018,60,60,120,67
KAABONG,2019,60,60,120,67
KAABONG,2020,70,60,130,67
KAABONG,2021,70,60,130,67
KAABONG,2022,70,70,140,67
KAABONG,2023,70,70,140,67
KAABONG,2024,70,70,140,67
KAABONG,2025,70,70,140,67
KABALE,2015,200,210,410,67
KABALE,2016,210,210,420,67
KABALE,2017,210,210,420,67
KABALE,2018,210,220,430,67
KABALE,2019,220,220,440,67
KABALE,2020,220,220,440,67
KABALE,2021,220,220,440,67
KABALE,2022,220,230,450,67
KABALE,2023,230,230,460,67
KABALE,2024,230,230,460,67
KABALE,2025,230,230,460,67
KABAROLE,2015,250,270,520,67
KABAROLE,2016,260,280,540,67
KABAROLE,2017,260,290,550,67
KABAROLE,2018,270,290,560,67
KABAROLE,2019,270,300,570,67
KABAROLE,2020,280,300,580,67
KABAROLE,2021,280,310,590,67
KABAROLE,2022,290,320,610,67
KABAROLE,2023,290,320,610,67
KABAROLE,2024,300,330,630,67
KABAROLE,2025,300,330,630,67
KABERAMAIDO,2015,90,130,220,67
KABERAMAIDO,2016,80,140,220,67
KABERAMAIDO,2017,90,120,210,67
KABERAMAIDO,2018,80,110,190,67
KABERAMAIDO,2019,80,110,190,67
KABERAMAIDO,2020,90,110,200,67
KABERAMAIDO,2021,90,110,200,67
KABERAMAIDO,2022,90,130,220,67
KABERAMAIDO,2023,110,140,250,67
KABERAMAIDO,2024,120,150,270,67
KABERAMAIDO,2025,120,170,290,67
KAGADI,2015,200,200,400,67
KAGADI,2016,210,210,420,67
KAGADI,2017,210,210,420,67
KAGADI,2018,220,220,440,67
KAGADI,2019,230,230,460,67
KAGADI,2020,240,240,480,67
KAGADI,2021,250,250,500,67
KAGADI,2022,250,250,500,67
KAGADI,2023,260,260,520,67
KAGADI,2024,270,270,540,67
KAGADI,2025,280,280,560,67
KAKUMIRO,2015,170,150,320,67
KAKUMIRO,2016,180,170,350,67
KAKUMIRO,2017,200,180,380,67
KAKUMIRO,2018,220,200,420,67
KAKUMIRO,2019,240,210,450,67
KAKUMIRO,2020,260,230,490,67
KAKUMIRO,2021,280,250,530,67
KAKUMIRO,2022,300,270,570,67
KAKUMIRO,2023,330,290,620,67
KAKUMIRO,2024,360,320,680,67
KAKUMIRO,2025,380,340,720,67
KALAKI,2015,170,220,390,67
KALAKI,2016,180,230,410,67
KALAKI,2017,190,240,430,67
KALAKI,2018,200,250,450,67
KALAKI,2019,210,260,470,67
KALAKI,2020,220,270,490,67
KALAKI,2021,220,280,500,67
KALAKI,2022,230,290,520,67
KALAKI,2023,240,300,540,67
KALAKI,2024,250,310,560,67
KALAKI,2025,260,320,580,67
KALANGALA,2015,30,20,50,67
KALANGALA,2016,30,20,50,67
KALANGALA,2017,30,20,50,67
KALANGALA,2018,30,20,50,67
KALANGALA,2019,30,20,50,67
KALANGALA,2020,30,20,50,67
KALANGALA,2021,30,20,50,67
KALANGALA,2022,30,20,50,67
KALANGALA,2023,30,20,50,67
KALANGALA,2024,30,20,50,67
KALANGALA,2025,40,20,60,67
KALIRO,2015,140,160,300,67
KALIRO,2016,150,190,340,67
KALIRO,2017,160,200,360,67
KALIRO,2018,170,230,400,67
KALIRO,2019,180,230,410,67
KALIRO,2020,180,240,420,67
KALIRO,2021,170,220,390,67
KALIRO,2022,170,210,380,67
KALIRO,2023,160,190,350,67
KALIRO,2024,170,200,370,67
KALIRO,2025,190,240,430,67
KALUNGU,2015,180,200,380,67
KALUNGU,2016,180,210,390,67
KALUNGU,2017,190,230,420,67
KALUNGU,2018,200,240,440,67
KALUNGU,2019,200,250,450,67
KALUNGU,2020,200,240,440,67
KALUNGU,2021,190,230,420,67
KALUNGU,2022,180,210,390,67
KALUNGU,2023,170,190,360,67
KALUNGU,2024,170,190,360,67
KALUNGU,2025,190,210,400,67
KAMPALA,2015,460,500,960,67
KAMPALA,2016,470,510,980,67
KAMPALA,2017,480,520,1000,67
KAMPALA,2018,490,530,1020,67
KAMPALA,2019,500,540,1040,67
KAMPALA,2020,510,550,1060,67
KAMPALA,2021,520,560,1080,67
KAMPALA,2022,530,570,1100,67
KAMPALA,2023,540,580,1120,67
KAMPALA,2024,540,590,1130,67
KAMPALA,2025,550,600,1150,67
KAMULI,2015,300,280,580,67
KAMULI,2016,320,310,630,67
KAMULI,2017,350,350,700,67
KAMULI,2018,360,370,730,67
KAMULI,2019,380,390,770,67
KAMULI,2020,370,370,740,67
KAMULI,2021,370,360,730,67
KAMULI,2022,350,320,670,67
KAMULI,2023,340,310,650,67
KAMULI,2024,350,310,660,67
KAMULI,2025,390,350,740,67
KAMWENGE,2015,180,180,360,67
KAMWENGE,2016,190,190,380,67
KAMWENGE,2017,190,200,390,67
KAMWENGE,2018,200,200,400,67
KAMWENGE,2019,210,210,420,67
KAMWENGE,2020,220,220,440,67
KAMWENGE,2021,230,230,460,67
KAMWENGE,2022,230,230,460,67
KAMWENGE,2023,240,240,480,67
KAMWENGE,2024,250,250,500,67
KAMWENGE,2025,260,260,520,67
KANUNGU,2015,210,230,440,67
KANUNGU,2016,210,240,450,67
KANUNGU,2017,220,240,460,67
KANUNGU,2018,220,240,460,67
KANUNGU,2019,230,250,480,67
KANUNGU,2020,230,250,480,67
KANUNGU,2021,230,250,480,67
KANUNGU,2022,240,260,500,67
KANUNGU,2023,240,260,500,67
KANUNGU,2024,240,260,500,67
KANUNGU,2025,250,270,520,67
KAPCHORWA,2015,90,80,170,67
KAPCHORWA,2016,90,80,170,67
KAPCHORWA,2017,90,80,170,67
KAPCHORWA,2018,100,90,190,67
KAPCHORWA,2019,100,90,190,67
KAPCHORWA,2020,100,90,190,67
KAPCHORWA,2021,100,90,190,67
KAPCHORWA,2022,110,100,210,67
KAPCHORWA,2023,110,100,210,67
KAPCHORWA,2024,110,100,210,67
KAPCHORWA,2025,120,100,220,67
KAPELEBYONG,2015,50,70,120,67
KAPELEBYONG,2016,60,70,130,67
KAPELEBYONG,2017,70,80,150,67
KAPELEBYONG,2018,70,90,160,67
KAPELEBYONG,2019,70,100,170,67
KAPELEBYONG,2020,70,100,170,67
KAPELEBYONG,2021,80,90,170,67
KAPELEBYONG,2022,70,80,150,67
KAPELEBYONG,2023,70,80,150,67
KAPELEBYONG,2024,70,80,150,67
KAPELEBYONG,2025,70,90,160,67
KASESE,2015,420,360,780,67
KASESE,2016,440,400,840,67
KASESE,2017,480,450,930,67
KASESE,2018,500,490,990,67
KASESE,2019,520,490,1010,67
KASESE,2020,510,480,990,67
KASESE,2021,490,460,950,67
KASESE,2022,480,420,900,67
KASESE,2023,470,400,870,67
KASESE,2024,490,410,900,67
KASESE,2025,530,450,980,67
KASSANDA,2015,230,220,450,67
KASSANDA,2016,240,220,460,67
KASSANDA,2017,240,230,470,67
KASSANDA,2018,250,230,480,67
KASSANDA,2019,260,240,500,67
KASSANDA,2020,260,240,500,67
KASSANDA,2021,270,250,520,67
KASSANDA,2022,280,250,530,67
KASSANDA,2023,290,260,550,67
KASSANDA,2024,290,260,550,67
KASSANDA,2025,300,260,560,67
KATAKWI,2015,420,570,990,67
KATAKWI,2016,440,640,1080,67
KATAKWI,2017,480,700,1180,67
KATAKWI,2018,510,760,1270,67
KATAKWI,2019,530,780,1310,67
KATAKWI,2020,520,770,1290,67
KATAKWI,2021,520,730,1250,67
KATAKWI,2022,490,670,1160,67
KATAKWI,2023,480,640,1120,67
KATAKWI,2024,510,660,1170,67
KATAKWI,2025,550,730,1280,67
KAYUNGA,2015,250,260,510,67
KAYUNGA,2016,260,270,530,67
KAYUNGA,2017,280,300,580,67
KAYUNGA,2018,290,330,620,67
KAYUNGA,2019,310,330,640,67
KAYUNGA,2020,290,320,610,67
KAYUNGA,2021,290,310,600,67
KAYUNGA,2022,270,280,550,67
KAYUNGA,2023,270,260,530,67
KAYUNGA,2024,270,270,540,67
KAYUNGA,2025,300,290,590,67
KAZO,2015,150,120,270,67
KAZO,2016,160,130,290,67
KAZO,2017,160,130,290,67
KAZO,2018,170,140,310,67
KAZO,2019,170,140,310,67
KAZO,2020,180,150,330,67
KAZO,2021,190,150,340,67
KAZO,2022,190,160,350,67
KAZO,2023,200,160,360,67
KAZO,2024,210,170,380,67
KAZO,2025,210,170,380,67
KIBAALE,2015,80,80,160,67
KIBAALE,2016,80,80,160,67
KIBAALE,2017,90,90,180,67
KIBAALE,2018,100,90,190,67
KIBAALE,2019,100,100,200,67
KIBAALE,2020,110,100,210,67
KIBAALE,2021,110,110,220,67
KIBAALE,2022,120,120,240,67
KIBAALE,2023,130,120,250,67
KIBAALE,2024,140,130,270,67
KIBAALE,2025,140,140,280,67
KIBOGA,2015,200,260,460,67
KIBOGA,2016,220,270,490,67
KIBOGA,2017,240,310,550,67
KIBOGA,2018,240,330,570,67
KIBOGA,2019,260,350,610,67
KIBOGA,2020,250,330,580,67
KIBOGA,2021,250,320,570,67
KIBOGA,2022,230,290,520,67
KIBOGA,2023,230,280,510,67
KIBOGA,2024,230,280,510,67
KIBOGA,2025,260,320,580,67
KIBUKU,2015,100,160,260,67
KIBUKU,2016,120,170,290,67
KIBUKU,2017,120,200,320,67
KIBUKU,2018,140,220,360,67
KIBUKU,2019,140,230,370,67
KIBUKU,2020,150,220,370,67
KIBUKU,2021,140,220,360,67
KIBUKU,2022,140,200,340,67
KIBUKU,2023,130,190,320,67
KIBUKU,2024,150,200,350,67
KIBUKU,2025,160,220,380,67
KIKUUBE,2015,200,140,340,67
KIKUUBE,2016,210,150,360,67
KIKUUBE,2017,220,160,380,67
KIKUUBE,2018,230,170,400,67
KIKUUBE,2019,240,180,420,67
KIKUUBE,2020,260,190,450,67
KIKUUBE,2021,270,190,460,67
KIKUUBE,2022,280,200,480,67
KIKUUBE,2023,300,210,510,67
KIKUUBE,2024,310,220,530,67
KIKUUBE,2025,330,230,560,67
KIRUHURA,2015,150,90,240,67
KIRUHURA,2016,160,90,250,67
KIRUHURA,2017,170,100,270,67
KIRUHURA,2018,170,100,270,67
KIRUHURA,2019,180,100,280,67
KIRUHURA,2020,180,110,290,67
KIRUHURA,2021,190,110,300,67
KIRUHURA,2022,200,110,310,67
KIRUHURA,2023,200,120,320,67
KIRUHURA,2024,210,120,330,67
KIRUHURA,2025,220,130,350,67
KIRYANDONGO,2015,180,160,340,67
KIRYANDONGO,2016,190,170,360,67
KIRYANDONGO,2017,200,200,400,67
KIRYANDONGO,2018,220,220,440,67
KIRYANDONGO,2019,220,220,440,67
KIRYANDONGO,2020,230,220,450,67
KIRYANDONGO,2021,210,200,410,67
KIRYANDONGO,2022,210,200,410,67
KIRYANDONGO,2023,210,180,390,67
KIRYANDONGO,2024,210,180,390,67
KIRYANDONGO,2025,240,210,450,67
KISORO,2015,250,260,510,67
KISORO,2016,260,290,550,67
KISORO,2017,280,310,590,67
KISORO,2018,290,340,630,67
KISORO,2019,310,350,660,67
KISORO,2020,290,350,640,67
KISORO,2021,290,320,610,67
KISORO,2022,270,290,560,67
KISORO,2023,260,280,540,67
KISORO,2024,270,280,550,67
KISORO,2025,290,320,610,67
KITAGWENDA,2015,140,130,270,67
KITAGWENDA,2016,140,130,270,67
KITAGWENDA,2017,150,140,290,67
KITAGWENDA,2018,160,140,300,67
KITAGWENDA,2019,160,150,310,67
KITAGWENDA,2020,170,150,320,67
KITAGWENDA,2021,170,160,330,67
KITAGWENDA,2022,180,160,340,67
KITAGWENDA,2023,190,170,360,67
KITAGWENDA,2024,190,170,360,67
KITAGWENDA,2025,200,180,380,67
KITGUM,2015,150,270,420,67
KITGUM,2016,160,290,450,67
KITGUM,2017,170,310,480,67
KITGUM,2018,170,340,510,67
KITGUM,2019,190,350,540,67
KITGUM,2020,180,330,510,67
KITGUM,2021,170,320,490,67
KITGUM,2022,160,290,450,67
KITGUM,2023,150,270,420,67
KITGUM,2024,170,280,450,67
KITGUM,2025,180,310,490,67
KOBOKO,2015,110,120,230,67
KOBOKO,2016,130,120,250,67
KOBOKO,2017,140,150,290,67
KOBOKO,2018,150,160,310,67
KOBOKO,2019,150,170,320,67
KOBOKO,2020,160,170,330,67
KOBOKO,2021,160,150,310,67
KOBOKO,2022,150,150,300,67
KOBOKO,2023,150,140,290,67
KOBOKO,2024,160,150,310,67
KOBOKO,2025,180,160,340,67
KOLE,2015,480,620,1100,67
KOLE,2016,500,630,1130,67
KOLE,2017,510,650,1160,67
KOLE,2018,530,670,1200,67
KOLE,2019,540,690,1230,67
KOLE,2020,560,710,1270,67
KOLE,2021,580,730,1310,67
KOLE,2022,600,750,1350,67
KOLE,2023,610,760,1370,67
KOLE,2024,630,780,1410,67
KOLE,2025,650,800,1450,67
KOTIDO,2015,80,120,200,67
KOTIDO,2016,90,120,210,67
KOTIDO,2017,90,150,240,67
KOTIDO,2018,90,160,250,67
KOTIDO,2019,90,160,250,67
KOTIDO,2020,100,150,250,67
KOTIDO,2021,100,150,250,67
KOTIDO,2022,90,140,230,67
KOTIDO,2023,90,130,220,67
KOTIDO,2024,90,130,220,67
KOTIDO,2025,100,140,240,67
KUMI,2015,190,240,430,67
KUMI,2016,200,270,470,67
KUMI,2017,220,300,520,67
KUMI,2018,230,330,560,67
KUMI,2019,230,330,560,67
KUMI,2020,240,330,570,67
KUMI,2021,240,320,560,67
KUMI,2022,220,290,510,67
KUMI,2023,220,280,500,67
KUMI,2024,230,290,520,67
KUMI,2025,250,320,570,67
KWANIA,2015,300,350,650,67
KWANIA,2016,310,360,670,67
KWANIA,2017,320,380,700,67
KWANIA,2018,330,390,720,67
KWANIA,2019,340,400,740,67
KWANIA,2020,350,410,760,67
KWANIA,2021,360,420,780,67
KWANIA,2022,370,430,800,67
KWANIA,2023,380,440,820,67
KWANIA,2024,390,450,840,67
KWANIA,2025,400,460,860,67
KWEEN,2015,60,70,130,67
KWEEN,2016,60,70,130,67
KWEEN,2017,60,80,140,67
KWEEN,2018,60,80,140,67
KWEEN,2019,60,80,140,67
KWEEN,2020,60,80,140,67
KWEEN,2021,70,80,150,67
KWEEN,2022,70,90,160,67
KWEEN,2023,70,90,160,67
KWEEN,2024,70,90,160,67
KWEEN,2025,70,90,160,67
KYANKWANZI,2015,350,300,650,67
KYANKWANZI,2016,360,310,670,67
KYANKWANZI,2017,380,320,700,67
KYANKWANZI,2018,400,340,740,67
KYANKWANZI,2019,420,350,770,67
KYANKWANZI,2020,440,370,810,67
KYANKWANZI,2021,470,390,860,67
KYANKWANZI,2022,490,400,890,67
KYANKWANZI,2023,510,420,930,67
KYANKWANZI,2024,540,440,980,67
KYANKWANZI,2025,560,460,1020,67
KYEGEGWA,2015,410,450,860,67
KYEGEGWA,2016,450,490,940,67
KYEGEGWA,2017,480,520,1000,67
KYEGEGWA,2018,520,570,1090,67
KYEGEGWA,2019,570,610,1180,67
KYEGEGWA,2020,610,660,1270,67
KYEGEGWA,2021,660,710,1370,67
KYEGEGWA,2022,710,760,1470,67
KYEGEGWA,2023,770,820,1590,67
KYEGEGWA,2024,830,880,1710,67
KYEGEGWA,2025,890,940,1830,67
KYENJOJO,2015,510,690,1200,67
KYENJOJO,2016,530,720,1250,67
KYENJOJO,2017,560,750,1310,67
KYENJOJO,2018,580,770,1350,67
KYENJOJO,2019,600,800,1400,67
KYENJOJO,2020,630,830,1460,67
KYENJOJO,2021,650,860,1510,67
KYENJOJO,2022,670,890,1560,67
KYENJOJO,2023,700,920,1620,67
KYENJOJO,2024,730,950,1680,67
KYENJOJO,2025,750,980,1730,67
KYOTERA,2015,190,280,470,67
KYOTERA,2016,190,300,490,67
KYOTERA,2017,200,340,540,67
KYOTERA,2018,220,360,580,67
KYOTERA,2019,220,360,580,67
KYOTERA,2020,220,360,580,67
KYOTERA,2021,210,330,540,67
KYOTERA,2022,200,300,500,67
KYOTERA,2023,190,280,470,67
KYOTERA,2024,190,290,480,67
KYOTERA,2025,220,320,540,67
KARENGA,2015,30,30,60,67
KARENGA,2016,30,30,60,67
KARENGA,2017,30,30,60,67
KARENGA,2018,30,30,60,67
KARENGA,2019,30,40,70,67
KARENGA,2020,40,40,80,67
KARENGA,2021,40,40,80,67
KARENGA,2022,40,40,80,67
KARENGA,2023,40,40,80,67
KARENGA,2024,40,40,80,67
KARENGA,2025,40,40,80,67
LAMWO,2015,110,190,300,67
LAMWO,2016,130,200,330,67
LAMWO,2017,140,220,360,67
LAMWO,2018,140,230,370,67
LAMWO,2019,140,250,390,67
LAMWO,2020,140,240,380,67
LAMWO,2021,130,220,350,67
LAMWO,2022,120,200,320,67
LAMWO,2023,120,180,300,67
LAMWO,2024,120,190,310,67
LAMWO,2025,130,210,340,67
LIRA,2015,290,310,600,67
LIRA,2016,300,320,620,67
LIRA,2017,310,330,640,67
LIRA,2018,320,330,650,67
LIRA,2019,320,340,660,67
LIRA,2020,330,350,680,67
LIRA,2021,340,360,700,67
LIRA,2022,350,370,720,67
LIRA,2023,360,380,740,67
LIRA,2024,370,390,760,67
LIRA,2025,380,400,780,67
LUUKA,2015,110,190,300,67
LUUKA,2016,120,200,320,67
LUUKA,2017,140,220,360,67
LUUKA,2018,140,240,380,67
LUUKA,2019,140,250,390,67
LUUKA,2020,140,240,380,67
LUUKA,2021,140,220,360,67
LUUKA,2022,130,210,340,67
LUUKA,2023,130,190,320,67
LUUKA,2024,130,190,320,67
LUUKA,2025,140,220,360,67
LUWERO,2015,290,370,660,67
LUWERO,2016,310,410,720,67
LUWERO,2017,340,460,800,67
LUWERO,2018,360,500,860,67
LUWERO,2019,360,510,870,67
LUWERO,2020,360,500,860,67
LUWERO,2021,350,470,820,67
LUWERO,2022,340,440,780,67
LUWERO,2023,330,410,740,67
LUWERO,2024,340,420,760,67
LUWERO,2025,380,470,850,67
LWENGO,2015,230,290,520,67
LWENGO,2016,240,310,550,67
LWENGO,2017,250,350,600,67
LWENGO,2018,270,370,640,67
LWENGO,2019,270,380,650,67
LWENGO,2020,260,360,620,67
LWENGO,2021,250,330,580,67
LWENGO,2022,230,310,540,67
LWENGO,2023,230,290,520,67
LWENGO,2024,230,290,520,67
LWENGO,2025,250,320,570,67
LYANTONDE,2015,60,60,120,67
LYANTONDE,2016,80,60,140,67
LYANTONDE,2017,80,70,150,67
LYANTONDE,2018,80,70,150,67
LYANTONDE,2019,80,90,170,67
LYANTONDE,2020,80,80,160,67
LYANTONDE,2021,90,80,170,67
LYANTONDE,2022,80,70,150,67
LYANTONDE,2023,80,60,140,67
LYANTONDE,2024,80,60,140,67
LYANTONDE,2025,80,70,150,67
MANAFWA,2015,140,150,290,67
MANAFWA,2016,150,150,300,67
MANAFWA,2017,150,160,310,67
MANAFWA,2018,150,160,310,67
MANAFWA,2019,160,160,320,67
MANAFWA,2020,160,170,330,67
MANAFWA,2021,170,170,340,67
MANAFWA,2022,170,170,340,67
MANAFWA,2023,170,180,350,67
MANAFWA,2024,180,180,360,67
MANAFWA,2025,180,180,360,67
MARACHA,2015,180,190,370,67
MARACHA,2016,190,200,390,67
MARACHA,2017,190,200,390,67
MARACHA,2018,200,200,400,67
MARACHA,2019,200,210,410,67
MARACHA,2020,200,210,410,67
MARACHA,2021,210,210,420,67
MARACHA,2022,210,220,430,67
MARACHA,2023,220,220,440,67
MARACHA,2024,220,220,440,67
MARACHA,2025,220,230,450,67
MASAKA,2015,170,260,430,67
MASAKA,2016,170,260,430,67
MASAKA,2017,170,270,440,67
MASAKA,2018,190,300,490,67
MASAKA,2019,200,330,530,67
MASAKA,2020,200,360,560,67
MASAKA,2021,220,370,590,67
MASAKA,2022,210,360,570,67
MASAKA,2023,200,340,540,67
MASAKA,2024,200,320,520,67
MASAKA,2025,190,290,480,67
MASINDI,2015,210,180,390,67
MASINDI,2016,220,190,410,67
MASINDI,2017,230,190,420,67
MASINDI,2018,230,200,430,67
MASINDI,2019,240,200,440,67
MASINDI,2020,250,210,460,67
MASINDI,2021,250,210,460,67
MASINDI,2022,260,220,480,67
MASINDI,2023,270,220,490,67
MASINDI,2024,270,230,500,67
MASINDI,2025,280,230,510,67
MAYUGE,2015,270,280,550,67
MAYUGE,2016,290,300,590,67
MAYUGE,2017,320,340,660,67
MAYUGE,2018,340,370,710,67
MAYUGE,2019,350,390,740,67
MAYUGE,2020,350,370,720,67
MAYUGE,2021,330,360,690,67
MAYUGE,2022,320,340,660,67
MAYUGE,2023,320,320,640,67
MAYUGE,2024,330,330,660,67
MAYUGE,2025,370,370,740,67
MBALE,2015,330,430,760,67
MBALE,2016,360,470,830,67
MBALE,2017,380,530,910,67
MBALE,2018,410,570,980,67
MBALE,2019,420,610,1030,67
MBALE,2020,420,590,1010,67
MBALE,2021,410,560,970,67
MBALE,2022,390,530,920,67
MBALE,2023,390,500,890,67
MBALE,2024,400,520,920,67
MBALE,2025,440,590,1030,67
MBARARA,2015,230,250,480,67
MBARARA,2016,240,250,490,67
MBARARA,2017,240,260,500,67
MBARARA,2018,250,260,510,67
MBARARA,2019,260,270,530,67
MBARARA,2020,260,270,530,67
MBARARA,2021,270,280,550,67
MBARARA,2022,270,280,550,67
MBARARA,2023,280,290,570,67
MBARARA,2024,280,290,570,67
MBARARA,2025,290,300,590,67
MITOOMA,2015,180,200,380,67
MITOOMA,2016,180,200,380,67
MITOOMA,2017,190,200,390,67
MITOOMA,2018,190,200,390,67
MITOOMA,2019,190,200,390,67
MITOOMA,2020,190,200,390,67
MITOOMA,2021,190,210,400,67
MITOOMA,2022,200,210,410,67
MITOOMA,2023,200,210,410,67
MITOOMA,2024,200,210,410,67
MITOOMA,2025,200,210,410,67
MITYANA,2015,300,350,650,67
MITYANA,2016,310,390,700,67
MITYANA,2017,340,420,760,67
MITYANA,2018,360,460,820,67
MITYANA,2019,360,460,820,67
MITYANA,2020,360,440,800,67
MITYANA,2021,340,420,760,67
MITYANA,2022,330,380,710,67
MITYANA,2023,320,360,680,67
MITYANA,2024,330,370,700,67
MITYANA,2025,360,410,770,67
MOROTO,2015,70,80,150,67
MOROTO,2016,80,90,170,67
MOROTO,2017,80,90,170,67
MOROTO,2018,80,100,180,67
MOROTO,2019,80,100,180,67
MOROTO,2020,80,100,180,67
MOROTO,2021,90,100,190,67
MOROTO,2022,80,90,170,67
MOROTO,2023,80,90,170,67
MOROTO,2024,80,90,170,67
MOROTO,2025,80,90,170,67
MOYO,2015,90,100,190,67
MOYO,2016,90,100,190,67
MOYO,2017,90,100,190,67
MOYO,2018,90,100,190,67
MOYO,2019,90,110,200,67
MOYO,2020,100,110,210,67
MOYO,2021,100,110,210,67
MOYO,2022,100,110,210,67
MOYO,2023,100,110,210,67
MOYO,2024,110,120,230,67
MOYO,2025,110,120,230,67
MPIGI,2015,220,230,450,67
MPIGI,2016,230,260,490,67
MPIGI,2017,250,280,530,67
MPIGI,2018,260,300,560,67
MPIGI,2019,270,320,590,67
MPIGI,2020,260,300,560,67
MPIGI,2021,260,290,550,67
MPIGI,2022,240,270,510,67
MPIGI,2023,240,260,500,67
MPIGI,2024,240,260,500,67
MPIGI,2025,270,290,560,67
MUBENDE,2015,260,230,490,67
MUBENDE,2016,290,260,550,67
MUBENDE,2017,320,300,620,67
MUBENDE,2018,350,330,680,67
MUBENDE,2019,360,360,720,67
MUBENDE,2020,370,360,730,67
MUBENDE,2021,380,340,720,67
MUBENDE,2022,360,320,680,67
MUBENDE,2023,370,320,690,67
MUBENDE,2024,390,330,720,67
MUBENDE,2025,440,390,830,67
MUKONO,2015,400,440,840,67
MUKONO,2016,420,490,910,67
MUKONO,2017,460,540,1000,67
MUKONO,2018,490,590,1080,67
MUKONO,2019,500,620,1120,67
MUKONO,2020,500,610,1110,67
MUKONO,2021,480,570,1050,67
MUKONO,2022,460,530,990,67
MUKONO,2023,450,500,950,67
MUKONO,2024,480,520,1000,67
MUKONO,2025,520,590,1110,67
MADI OKOLLO,2015,130,120,250,67
MADI OKOLLO,2016,130,130,260,67
MADI OKOLLO,2017,140,130,270,67
MADI OKOLLO,2018,140,130,270,67
MADI OKOLLO,2019,140,140,280,67
MADI OKOLLO,2020,150,140,290,67
MADI OKOLLO,2021,150,140,290,67
MADI OKOLLO,2022,160,150,310,67
MADI OKOLLO,2023,160,150,310,67
MADI OKOLLO,2024,160,150,310,67
MADI OKOLLO,2025,170,160,330,67
NABILATUK,2015,30,70,100,67
NABILATUK,2016,40,90,130,67
NABILATUK,2017,50,90,140,67
NABILATUK,2018,50,100,150,67
NABILATUK,2019,50,120,170,67
NABILATUK,2020,50,110,160,67
NABILATUK,2021,50,100,150,67
NABILATUK,2022,50,100,150,67
NABILATUK,2023,50,100,150,67
NABILATUK,2024,50,100,150,67
NABILATUK,2025,60,120,180,67
NAKAPIRIPIRIT,2015,60,90,150,67
NAKAPIRIPIRIT,2016,60,110,170,67
NAKAPIRIPIRIT,2017,80,120,200,67
NAKAPIRIPIRIT,2018,80,140,220,67
NAKAPIRIPIRIT,2019,80,140,220,67
NAKAPIRIPIRIT,2020,80,140,220,67
NAKAPIRIPIRIT,2021,90,140,230,67
NAKAPIRIPIRIT,2022,80,130,210,67
NAKAPIRIPIRIT,2023,80,130,210,67
NAKAPIRIPIRIT,2024,90,130,220,67
NAKAPIRIPIRIT,2025,90,150,240,67
NAKASEKE,2015,140,130,270,67
NAKASEKE,2016,140,140,280,67
NAKASEKE,2017,150,140,290,67
NAKASEKE,2018,150,140,290,67
NAKASEKE,2019,160,150,310,67
NAKASEKE,2020,160,150,310,67
NAKASEKE,2021,170,150,320,67
NAKASEKE,2022,170,160,330,67
NAKASEKE,2023,180,160,340,67
NAKASEKE,2024,190,160,350,67
NAKASEKE,2025,190,160,350,67
NAKASONGOLA,2015,130,90,220,67
NAKASONGOLA,2016,130,110,240,67
NAKASONGOLA,2017,150,120,270,67
NAKASONGOLA,2018,150,130,280,67
NAKASONGOLA,2019,160,130,290,67
NAKASONGOLA,2020,160,140,300,67
NAKASONGOLA,2021,150,130,280,67
NAKASONGOLA,2022,150,120,270,67
NAKASONGOLA,2023,140,110,250,67
NAKASONGOLA,2024,160,110,270,67
NAKASONGOLA,2025,170,130,300,67
NAMAYINGO,2015,130,120,250,67
NAMAYINGO,2016,140,120,260,67
NAMAYINGO,2017,150,140,290,67
NAMAYINGO,2018,150,140,290,67
NAMAYINGO,2019,150,140,290,67
NAMAYINGO,2020,150,150,300,67
NAMAYINGO,2021,150,140,290,67
NAMAYINGO,2022,140,130,270,67
NAMAYINGO,2023,130,120,250,67
NAMAYINGO,2024,140,120,260,67
NAMAYINGO,2025,160,130,290,67
NAMISINDWA,2015,140,170,310,67
NAMISINDWA,2016,140,170,310,67
NAMISINDWA,2017,150,170,320,67
NAMISINDWA,2018,150,180,330,67
NAMISINDWA,2019,150,180,330,67
NAMISINDWA,2020,160,190,350,67
NAMISINDWA,2021,160,190,350,67
NAMISINDWA,2022,170,190,360,67
NAMISINDWA,2023,170,200,370,67
NAMISINDWA,2024,170,200,370,67
NAMISINDWA,2025,180,210,390,67
NAMUTUMBA,2015,200,170,370,67
NAMUTUMBA,2016,220,200,420,67
NAMUTUMBA,2017,240,230,470,67
NAMUTUMBA,2018,260,240,500,67
NAMUTUMBA,2019,260,260,520,67
NAMUTUMBA,2020,260,250,510,67
NAMUTUMBA,2021,260,240,500,67
NAMUTUMBA,2022,250,220,470,67
NAMUTUMBA,2023,250,210,460,67
NAMUTUMBA,2024,250,210,460,67
NAMUTUMBA,2025,280,250,530,67
NAPAK,2015,110,130,240,67
NAPAK,2016,120,140,260,67
NAPAK,2017,140,160,300,67
NAPAK,2018,140,170,310,67
NAPAK,2019,140,170,310,67
NAPAK,2020,140,170,310,67
NAPAK,2021,130,170,300,67
NAPAK,2022,130,150,280,67
NAPAK,2023,130,140,270,67
NAPAK,2024,130,140,270,67
NAPAK,2025,140,150,290,67
NEBBI,2015,440,710,1150,67
NEBBI,2016,450,730,1180,67
NEBBI,2017,470,750,1220,67
NEBBI,2018,480,770,1250,67
NEBBI,2019,490,790,1280,67
NEBBI,2020,510,810,1320,67
NEBBI,2021,520,840,1360,67
NEBBI,2022,540,860,1400,67
NEBBI,2023,550,880,1430,67
NEBBI,2024,570,900,1470,67
NEBBI,2025,580,920,1500,67
NGORA,2015,110,120,230,67
NGORA,2016,120,120,240,67
NGORA,2017,120,150,270,67
NGORA,2018,140,160,300,67
NGORA,2019,140,160,300,67
NGORA,2020,140,170,310,67
NGORA,2021,130,150,280,67
NGORA,2022,130,140,270,67
NGORA,2023,130,130,260,67
NGORA,2024,130,140,270,67
NGORA,2025,150,150,300,67
NTOROKO,2015,50,50,100,67
NTOROKO,2016,50,50,100,67
NTOROKO,2017,60,50,110,67
NTOROKO,2018,60,60,120,67
NTOROKO,2019,70,60,130,67
NTOROKO,2020,70,60,130,67
NTOROKO,2021,60,50,110,67
NTOROKO,2022,60,50,110,67
NTOROKO,2023,60,40,100,67
NTOROKO,2024,60,40,100,67
NTOROKO,2025,60,50,110,67
NTUNGAMO,2015,410,380,790,67
NTUNGAMO,2016,420,390,810,67
NTUNGAMO,2017,430,390,820,67
NTUNGAMO,2018,440,400,840,67
NTUNGAMO,2019,450,410,860,67
NTUNGAMO,2020,460,410,870,67
NTUNGAMO,2021,460,420,880,67
NTUNGAMO,2022,470,430,900,67
NTUNGAMO,2023,480,430,910,67
NTUNGAMO,2024,490,440,930,67
NTUNGAMO,2025,500,450,950,67
NWOYA,2015,120,120,240,67
NWOYA,2016,140,140,280,67
NWOYA,2017,150,150,300,67
NWOYA,2018,170,170,340,67
NWOYA,2019,180,180,360,67
NWOYA,2020,200,200,400,67
NWOYA,2021,220,220,440,67
NWOYA,2022,250,240,490,67
NWOYA,2023,270,270,540,67
NWOYA,2024,300,290,590,67
NWOYA,2025,330,320,650,67
OBONGI,2015,20,20,40,67
OBONGI,2016,20,20,40,67
OBONGI,2017,20,30,50,67
OBONGI,2018,20,30,50,67
OBONGI,2019,20,30,50,67
OBONGI,2020,20,30,50,67
OBONGI,2021,20,30,50,67
OBONGI,2022,20,20,40,67
OBONGI,2023,20,20,40,67
OBONGI,2024,20,20,40,67
OBONGI,2025,20,20,40,67
OMORO,2015,150,190,340,67
OMORO,2016,150,210,360,67
OMORO,2017,170,230,400,67
OMORO,2018,170,260,430,67
OMORO,2019,190,280,470,67
OMORO,2020,180,260,440,67
OMORO,2021,180,260,440,67
OMORO,2022,170,230,400,67
OMORO,2023,170,230,400,67
OMORO,2024,180,240,420,67
OMORO,2025,200,260,460,67
OTUKE,2015,110,80,190,67
OTUKE,2016,110,90,200,67
OTUKE,2017,120,90,210,67
OTUKE,2018,130,90,220,67
OTUKE,2019,130,100,230,67
OTUKE,2020,140,100,240,67
OTUKE,2021,140,110,250,67
OTUKE,2022,150,110,260,67
OTUKE,2023,150,120,270,67
OTUKE,2024,160,120,280,67
OTUKE,2025,170,130,300,67
OYAM,2015,330,340,670,67
OYAM,2016,340,350,690,67
OYAM,2017,350,360,710,67
OYAM,2018,360,370,730,67
OYAM,2019,370,380,750,67
OYAM,2020,380,390,770,67
OYAM,2021,390,400,790,67
OYAM,2022,400,410,810,67
OYAM,2023,410,420,830,67
OYAM,2024,420,430,850,67
OYAM,2025,430,440,870,67
PADER,2015,150,210,360,67
PADER,2016,150,220,370,67
PADER,2017,160,240,400,67
PADER,2018,170,270,440,67
PADER,2019,180,280,460,67
PADER,2020,170,260,430,67
PADER,2021,160,260,420,67
PADER,2022,160,230,390,67
PADER,2023,150,210,360,67
PADER,2024,160,210,370,67
PADER,2025,170,250,420,67
PAKWACH,2015,260,330,590,67
PAKWACH,2016,270,350,620,67
PAKWACH,2017,280,360,640,67
PAKWACH,2018,290,370,660,67
PAKWACH,2019,300,390,690,67
PAKWACH,2020,310,400,710,67
PAKWACH,2021,330,410,740,67
PAKWACH,2022,340,430,770,67
PAKWACH,2023,350,440,790,67
PAKWACH,2024,370,450,820,67
PAKWACH,2025,380,470,850,67
PALLISA,2015,240,210,450,67
PALLISA,2016,260,240,500,67
PALLISA,2017,280,270,550,67
PALLISA,2018,300,300,600,67
PALLISA,2019,330,300,630,67
PALLISA,2020,330,300,630,67
PALLISA,2021,320,290,610,67
PALLISA,2022,310,280,590,67
PALLISA,2023,320,270,590,67
PALLISA,2024,330,280,610,67
PALLISA,2025,370,320,690,67
RAKAI,2015,250,240,490,67
RAKAI,2016,260,260,520,67
RAKAI,2017,280,300,580,67
RAKAI,2018,300,320,620,67
RAKAI,2019,310,330,640,67
RAKAI,2020,310,320,630,67
RAKAI,2021,300,310,610,67
RAKAI,2022,280,280,560,67
RAKAI,2023,280,270,550,67
RAKAI,2024,290,270,560,67
RAKAI,2025,310,310,620,67
RUBANDA,2015,150,150,300,67
RUBANDA,2016,150,150,300,67
RUBANDA,2017,150,150,300,67
RUBANDA,2018,150,160,310,67
RUBANDA,2019,160,160,320,67
RUBANDA,2020,160,160,320,67
RUBANDA,2021,160,160,320,67
RUBANDA,2022,160,160,320,67
RUBANDA,2023,160,160,320,67
RUBANDA,2024,160,160,320,67
RUBANDA,2025,170,160,330,67
RUBIRIZI,2015,120,120,240,67
RUBIRIZI,2016,120,130,250,67
RUBIRIZI,2017,120,130,250,67
RUBIRIZI,2018,130,130,260,67
RUBIRIZI,2019,130,130,260,67
RUBIRIZI,2020,130,140,270,67
RUBIRIZI,2021,130,140,270,67
RUBIRIZI,2022,140,140,280,67
RUBIRIZI,2023,140,140,280,67
RUBIRIZI,2024,140,150,290,67
RUBIRIZI,2025,140,150,290,67
RUKIGA,2015,90,100,190,67
RUKIGA,2016,90,100,190,67
RUKIGA,2017,100,100,200,67
RUKIGA,2018,100,100,200,67
RUKIGA,2019,100,110,210,67
RUKIGA,2020,100,110,210,67
RUKIGA,2021,100,110,210,67
RUKIGA,2022,100,110,210,67
RUKIGA,2023,100,110,210,67
RUKIGA,2024,100,110,210,67
RUKIGA,2025,100,110,210,67
RUKUNGIRI,2015,300,350,650,67
RUKUNGIRI,2016,300,350,650,67
RUKUNGIRI,2017,310,350,660,67
RUKUNGIRI,2018,310,360,670,67
RUKUNGIRI,2019,310,360,670,67
RUKUNGIRI,2020,320,360,680,67
RUKUNGIRI,2021,320,370,690,67
RUKUNGIRI,2022,320,370,690,67
RUKUNGIRI,2023,330,370,700,67
RUKUNGIRI,2024,330,370,700,67
RUKUNGIRI,2025,330,380,710,67
RWAMPARA,2015,100,110,210,67
RWAMPARA,2016,100,110,210,67
RWAMPARA,2017,110,120,230,67
RWAMPARA,2018,110,120,230,67
RWAMPARA,2019,110,120,230,67
RWAMPARA,2020,110,120,230,67
RWAMPARA,2021,110,130,240,67
RWAMPARA,2022,120,130,250,67
RWAMPARA,2023,120,130,250,67
RWAMPARA,2024,120,130,250,67
RWAMPARA,2025,120,130,250,67
SERERE,2015,240,230,470,67
SERERE,2016,260,260,520,67
SERERE,2017,280,300,580,67
SERERE,2018,300,330,630,67
SERERE,2019,320,350,670,67
SERERE,2020,320,350,670,67
SERERE,2021,310,330,640,67
SERERE,2022,300,310,610,67
SERERE,2023,300,300,600,67
SERERE,2024,320,300,620,67
SERERE,2025,360,340,700,67
SHEEMA,2015,210,240,450,67
SHEEMA,2016,210,240,450,67
SHEEMA,2017,220,240,460,67
SHEEMA,2018,220,240,460,67
SHEEMA,2019,220,250,470,67
SHEEMA,2020,220,250,470,67
SHEEMA,2021,220,250,470,67
SHEEMA,2022,230,250,480,67
SHEEMA,2023,230,250,480,67
SHEEMA,2024,230,260,490,67
SHEEMA,2025,230,260,490,67
SIRONKO,2015,240,250,490,67
SIRONKO,2016,250,250,500,67
SIRONKO,2017,250,260,510,67
SIRONKO,2018,260,260,520,67
SIRONKO,2019,270,270,540,67
SIRONKO,2020,270,270,540,67
SIRONKO,2021,280,280,560,67
SIRONKO,2022,280,280,560,67
SIRONKO,2023,290,290,580,67
SIRONKO,2024,290,290,580,67
SIRONKO,2025,300,290,590,67
SOROTI,2015,190,200,390,67
SOROTI,2016,190,220,410,67
SOROTI,2017,220,260,480,67
SOROTI,2018,230,270,500,67
SOROTI,2019,250,290,540,67
SOROTI,2020,240,290,530,67
SOROTI,2021,240,270,510,67
SOROTI,2022,230,250,480,67
SOROTI,2023,230,250,480,67
SOROTI,2024,230,250,480,67
SOROTI,2025,260,280,540,67
SSEMBABULE,2015,220,220,440,67
SSEMBABULE,2016,240,250,490,67
SSEMBABULE,2017,250,280,530,67
SSEMBABULE,2018,270,300,570,67
SSEMBABULE,2019,270,320,590,67
SSEMBABULE,2020,270,300,570,67
SSEMBABULE,2021,270,290,560,67
SSEMBABULE,2022,260,270,530,67
SSEMBABULE,2023,250,260,510,67
SSEMBABULE,2024,260,260,520,67
SSEMBABULE,2025,290,290,580,67
TORORO,2015,420,430,850,67
TORORO,2016,430,440,870,67
TORORO,2017,440,450,890,67
TORORO,2018,460,460,920,67
TORORO,2019,470,470,940,67
TORORO,2020,480,490,970,67
TORORO,2021,490,500,990,67
TORORO,2022,500,510,1010,67
TORORO,2023,510,520,1030,67
TORORO,2024,530,530,1060,67
TORORO,2025,540,540,1080,67
WAKISO,2015,720,870,1590,67
WAKISO,2016,770,930,1700,67
WAKISO,2017,830,990,1820,67
WAKISO,2018,880,1060,1940,67
WAKISO,2019,940,1130,2070,67
WAKISO,2020,1000,1200,2200,67
WAKISO,2021,1060,1280,2340,67
WAKISO,2022,1130,1370,2500,67
WAKISO,2023,1200,1460,2660,67
WAKISO,2024,1280,1550,2830,67
WAKISO,2025,1360,1650,3010,67
YUMBE,2015,540,620,1160,67
YUMBE,2016,590,700,1290,67
YUMBE,2017,660,800,1460,67
YUMBE,2018,710,890,1600,67
YUMBE,2019,750,960,1710,67
YUMBE,2020,760,970,1730,67
YUMBE,2021,750,940,1690,67
YUMBE,2022,740,900,1640,67
YUMBE,2023,740,880,1620,67
YUMBE,2024,790,930,1720,67
YUMBE,2025,890,1080,1970,67
ZOMBO,2015,500,940,1440,67
ZOMBO,2016,520,970,1490,67
ZOMBO,2017,540,1000,1540,67
ZOMBO,2018,550,1020,1570,67
ZOMBO,2019,570,1050,1620,67
ZOMBO,2020,590,1080,1670,67
ZOMBO,2021,600,1110,1710,67
ZOMBO,2022,620,1140,1760,67
ZOMBO,2023,640,1160,1800,67
ZOMBO,2024,650,1190,1840,67
ZOMBO,2025,670,1220,1890,67
ABIM,2015,70,100,170,68
ABIM,2016,70,110,180,68
ABIM,2017,90,120,210,68
ABIM,2018,90,140,230,68
ABIM,2019,110,160,270,68
ABIM,2020,110,170,280,68
ABIM,2021,110,170,280,68
ABIM,2022,120,170,290,68
ABIM,2023,110,160,270,68
ABIM,2024,120,160,280,68
ABIM,2025,130,170,300,68
ADJUMANI,2015,120,200,320,68
ADJUMANI,2016,120,200,320,68
ADJUMANI,2017,120,200,320,68
ADJUMANI,2018,120,210,330,68
ADJUMANI,2019,120,210,330,68
ADJUMANI,2020,120,210,330,68
ADJUMANI,2021,120,210,330,68
ADJUMANI,2022,120,210,330,68
ADJUMANI,2023,120,210,330,68
ADJUMANI,2024,120,210,330,68
ADJUMANI,2025,120,220,340,68
AGAGO,2015,170,230,400,68
AGAGO,2016,170,240,410,68
AGAGO,2017,170,240,410,68
AGAGO,2018,170,250,420,68
AGAGO,2019,180,250,430,68
AGAGO,2020,180,250,430,68
AGAGO,2021,180,260,440,68
AGAGO,2022,190,260,450,68
AGAGO,2023,190,270,460,68
AGAGO,2024,190,270,460,68
AGAGO,2025,190,270,460,68
ALEBTONG,2015,190,220,410,68
ALEBTONG,2016,210,230,440,68
ALEBTONG,2017,220,250,470,68
ALEBTONG,2018,240,290,530,68
ALEBTONG,2019,250,300,550,68
ALEBTONG,2020,260,320,580,68
ALEBTONG,2021,250,310,560,68
ALEBTONG,2022,250,290,540,68
ALEBTONG,2023,240,280,520,68
ALEBTONG,2024,230,260,490,68
ALEBTONG,2025,250,270,520,68
AMOLATAR,2015,80,120,200,68
AMOLATAR,2016,90,120,210,68
AMOLATAR,2017,100,130,230,68
AMOLATAR,2018,100,140,240,68
AMOLATAR,2019,110,160,270,68
AMOLATAR,2020,120,170,290,68
AMOLATAR,2021,110,160,270,68
AMOLATAR,2022,110,160,270,68
AMOLATAR,2023,100,140,240,68
AMOLATAR,2024,110,130,240,68
AMOLATAR,2025,110,130,240,68
AMUDAT,2015,60,50,110,68
AMUDAT,2016,70,60,130,68
AMUDAT,2017,80,70,150,68
AMUDAT,2018,80,70,150,68
AMUDAT,2019,80,90,170,68
AMUDAT,2020,90,90,180,68
AMUDAT,2021,90,90,180,68
AMUDAT,2022,90,80,170,68
AMUDAT,2023,90,80,170,68
AMUDAT,2024,90,80,170,68
AMUDAT,2025,90,80,170,68
AMURIA,2015,120,170,290,68
AMURIA,2016,140,170,310,68
AMURIA,2017,140,200,340,68
AMURIA,2018,160,220,380,68
AMURIA,2019,160,240,400,68
AMURIA,2020,180,260,440,68
AMURIA,2021,170,250,420,68
AMURIA,2022,170,240,410,68
AMURIA,2023,160,220,380,68
AMURIA,2024,170,210,380,68
AMURIA,2025,180,220,400,68
AMURU,2015,110,150,260,68
AMURU,2016,110,150,260,68
AMURU,2017,130,180,310,68
AMURU,2018,140,190,330,68
AMURU,2019,140,220,360,68
AMURU,2020,140,220,360,68
AMURU,2021,150,220,370,68
AMURU,2022,140,200,340,68
AMURU,2023,130,190,320,68
AMURU,2024,140,180,320,68
AMURU,2025,140,180,320,68
APAC,2015,190,220,410,68
APAC,2016,190,230,420,68
APAC,2017,200,240,440,68
APAC,2018,210,250,460,68
APAC,2019,210,250,460,68
APAC,2020,220,260,480,68
APAC,2021,230,270,500,68
APAC,2022,240,280,520,68
APAC,2023,240,290,530,68
APAC,2024,250,300,550,68
APAC,2025,260,310,570,68
ARUA,2015,470,750,1220,68
ARUA,2016,490,770,1260,68
ARUA,2017,500,790,1290,68
ARUA,2018,520,810,1330,68
ARUA,2019,530,830,1360,68
ARUA,2020,540,850,1390,68
ARUA,2021,560,870,1430,68
ARUA,2022,570,890,1460,68
ARUA,2023,590,910,1500,68
ARUA,2024,600,940,1540,68
ARUA,2025,620,960,1580,68
BUDAKA,2015,150,210,360,68
BUDAKA,2016,160,220,380,68
BUDAKA,2017,170,240,410,68
BUDAKA,2018,180,270,450,68
BUDAKA,2019,200,300,500,68
BUDAKA,2020,210,310,520,68
BUDAKA,2021,210,310,520,68
BUDAKA,2022,200,290,490,68
BUDAKA,2023,190,280,470,68
BUDAKA,2024,190,270,460,68
BUDAKA,2025,210,270,480,68
BUDUDA,2015,210,200,410,68
BUDUDA,2016,230,220,450,68
BUDUDA,2017,250,240,490,68
BUDUDA,2018,270,270,540,68
BUDUDA,2019,290,300,590,68
BUDUDA,2020,310,320,630,68
BUDUDA,2021,310,320,630,68
BUDUDA,2022,310,320,630,68
BUDUDA,2023,300,300,600,68
BUDUDA,2024,300,290,590,68
BUDUDA,2025,310,300,610,68
BUGIRI,2015,260,270,530,68
BUGIRI,2016,270,290,560,68
BUGIRI,2017,290,320,610,68
BUGIRI,2018,330,360,690,68
BUGIRI,2019,350,390,740,68
BUGIRI,2020,370,410,780,68
BUGIRI,2021,360,420,780,68
BUGIRI,2022,360,400,760,68
BUGIRI,2023,350,370,720,68
BUGIRI,2024,350,350,700,68
BUGIRI,2025,360,360,720,68
BUGWERI,2015,100,140,240,68
BUGWERI,2016,100,140,240,68
BUGWERI,2017,110,150,260,68
BUGWERI,2018,110,180,290,68
BUGWERI,2019,130,190,320,68
BUGWERI,2020,130,190,320,68
BUGWERI,2021,130,200,330,68
BUGWERI,2022,120,180,300,68
BUGWERI,2023,120,160,280,68
BUGWERI,2024,120,160,280,68
BUGWERI,2025,120,160,280,68
BUHWEJU,2015,80,90,170,68
BUHWEJU,2016,80,90,170,68
BUHWEJU,2017,80,90,170,68
BUHWEJU,2018,80,100,180,68
BUHWEJU,2019,90,100,190,68
BUHWEJU,2020,90,100,190,68
BUHWEJU,2021,90,110,200,68
BUHWEJU,2022,100,110,210,68
BUHWEJU,2023,100,110,210,68
BUHWEJU,2024,100,110,210,68
BUHWEJU,2025,100,120,220,68
BUIKWE,2015,270,250,520,68
BUIKWE,2016,270,260,530,68
BUIKWE,2017,290,290,580,68
BUIKWE,2018,310,310,620,68
BUIKWE,2019,330,340,670,68
BUIKWE,2020,330,350,680,68
BUIKWE,2021,330,340,670,68
BUIKWE,2022,310,320,630,68
BUIKWE,2023,300,300,600,68
BUIKWE,2024,290,280,570,68
BUIKWE,2025,300,290,590,68
BUKEDEA,2015,150,210,360,68
BUKEDEA,2016,170,230,400,68
BUKEDEA,2017,180,250,430,68
BUKEDEA,2018,190,290,480,68
BUKEDEA,2019,210,320,530,68
BUKEDEA,2020,220,330,550,68
BUKEDEA,2021,230,330,560,68
BUKEDEA,2022,220,320,540,68
BUKEDEA,2023,210,300,510,68
BUKEDEA,2024,210,290,500,68
BUKEDEA,2025,230,300,530,68
BUKOMANSIMBI,2015,130,170,300,68
BUKOMANSIMBI,2016,150,170,320,68
BUKOMANSIMBI,2017,150,190,340,68
BUKOMANSIMBI,2018,160,200,360,68
BUKOMANSIMBI,2019,160,220,380,68
BUKOMANSIMBI,2020,170,220,390,68
BUKOMANSIMBI,2021,160,210,370,68
BUKOMANSIMBI,2022,150,190,340,68
BUKOMANSIMBI,2023,140,180,320,68
BUKOMANSIMBI,2024,140,160,300,68
BUKOMANSIMBI,2025,140,160,300,68
BUKWO,2015,60,80,140,68
BUKWO,2016,60,90,150,68
BUKWO,2017,70,90,160,68
BUKWO,2018,70,100,170,68
BUKWO,2019,80,100,180,68
BUKWO,2020,80,110,190,68
BUKWO,2021,80,110,190,68
BUKWO,2022,90,120,210,68
BUKWO,2023,90,120,210,68
BUKWO,2024,100,130,230,68
BUKWO,2025,100,130,230,68
BULAMBULI,2015,170,170,340,68
BULAMBULI,2016,190,180,370,68
BULAMBULI,2017,200,210,410,68
BULAMBULI,2018,230,240,470,68
BULAMBULI,2019,250,270,520,68
BULAMBULI,2020,260,280,540,68
BULAMBULI,2021,260,280,540,68
BULAMBULI,2022,260,270,530,68
BULAMBULI,2023,250,260,510,68
BULAMBULI,2024,250,250,500,68
BULAMBULI,2025,260,260,520,68
BULIISA,2015,70,80,150,68
BULIISA,2016,70,80,150,68
BULIISA,2017,80,80,160,68
BULIISA,2018,80,90,170,68
BULIISA,2019,90,90,180,68
BULIISA,2020,90,90,180,68
BULIISA,2021,100,100,200,68
BULIISA,2022,100,100,200,68
BULIISA,2023,110,110,220,68
BULIISA,2024,110,110,220,68
BULIISA,2025,120,110,230,68
BUNDIBUGYO,2015,110,140,250,68
BUNDIBUGYO,2016,120,140,260,68
BUNDIBUGYO,2017,130,170,300,68
BUNDIBUGYO,2018,140,180,320,68
BUNDIBUGYO,2019,150,200,350,68
BUNDIBUGYO,2020,150,200,350,68
BUNDIBUGYO,2021,160,200,360,68
BUNDIBUGYO,2022,150,190,340,68
BUNDIBUGYO,2023,140,180,320,68
BUNDIBUGYO,2024,150,170,320,68
BUNDIBUGYO,2025,150,170,320,68
BUNYANGABU,2015,130,150,280,68
BUNYANGABU,2016,140,150,290,68
BUNYANGABU,2017,140,170,310,68
BUNYANGABU,2018,160,190,350,68
BUNYANGABU,2019,160,200,360,68
BUNYANGABU,2020,170,200,370,68
BUNYANGABU,2021,170,210,380,68
BUNYANGABU,2022,160,190,350,68
BUNYANGABU,2023,150,180,330,68
BUNYANGABU,2024,160,170,330,68
BUNYANGABU,2025,160,170,330,68
BUSHENYI,2015,190,240,430,68
BUSHENYI,2016,200,240,440,68
BUSHENYI,2017,200,250,450,68
BUSHENYI,2018,200,250,450,68
BUSHENYI,2019,200,250,450,68
BUSHENYI,2020,200,250,450,68
BUSHENYI,2021,210,250,460,68
BUSHENYI,2022,210,260,470,68
BUSHENYI,2023,210,260,470,68
BUSHENYI,2024,210,260,470,68
BUSHENYI,2025,210,260,470,68
BUSIA,2015,230,300,530,68
BUSIA,2016,250,320,570,68
BUSIA,2017,270,350,620,68
BUSIA,2018,280,390,670,68
BUSIA,2019,300,430,730,68
BUSIA,2020,320,450,770,68
BUSIA,2021,320,440,760,68
BUSIA,2022,310,420,730,68
BUSIA,2023,290,390,680,68
BUSIA,2024,290,360,650,68
BUSIA,2025,300,370,670,68
BUTALEJA,2015,200,210,410,68
BUTALEJA,2016,220,230,450,68
BUTALEJA,2017,240,250,490,68
BUTALEJA,2018,260,290,550,68
BUTALEJA,2019,280,320,600,68
BUTALEJA,2020,280,320,600,68
BUTALEJA,2021,280,320,600,68
BUTALEJA,2022,280,310,590,68
BUTALEJA,2023,270,290,560,68
BUTALEJA,2024,270,280,550,68
BUTALEJA,2025,280,290,570,68
BUTAMBALA,2015,70,90,160,68
BUTAMBALA,2016,70,90,160,68
BUTAMBALA,2017,80,100,180,68
BUTAMBALA,2018,80,110,190,68
BUTAMBALA,2019,80,110,190,68
BUTAMBALA,2020,80,120,200,68
BUTAMBALA,2021,80,110,190,68
BUTAMBALA,2022,80,100,180,68
BUTAMBALA,2023,70,90,160,68
BUTAMBALA,2024,70,90,160,68
BUTAMBALA,2025,70,90,160,68
BUTEBO,2015,60,90,150,68
BUTEBO,2016,60,90,150,68
BUTEBO,2017,60,100,160,68
BUTEBO,2018,80,110,190,68
BUTEBO,2019,80,110,190,68
BUTEBO,2020,80,120,200,68
BUTEBO,2021,80,120,200,68
BUTEBO,2022,80,110,190,68
BUTEBO,2023,70,100,170,68
BUTEBO,2024,70,100,170,68
BUTEBO,2025,70,100,170,68
BUVUMA,2015,50,20,70,68
BUVUMA,2016,50,20,70,68
BUVUMA,2017,50,20,70,68
BUVUMA,2018,60,20,80,68
BUVUMA,2019,60,30,90,68
BUVUMA,2020,60,30,90,68
BUVUMA,2021,70,30,100,68
BUVUMA,2022,70,30,100,68
BUVUMA,2023,80,30,110,68
BUVUMA,2024,80,40,120,68
BUVUMA,2025,80,40,120,68
BUYENDE,2015,190,210,400,68
BUYENDE,2016,210,230,440,68
BUYENDE,2017,230,250,480,68
BUYENDE,2018,250,290,540,68
BUYENDE,2019,270,320,590,68
BUYENDE,2020,280,330,610,68
BUYENDE,2021,280,330,610,68
BUYENDE,2022,280,320,600,68
BUYENDE,2023,270,300,570,68
BUYENDE,2024,270,290,560,68
BUYENDE,2025,280,300,580,68
DOKOLO,2015,150,160,310,68
DOKOLO,2016,150,170,320,68
DOKOLO,2017,160,170,330,68
DOKOLO,2018,160,180,340,68
DOKOLO,2019,170,180,350,68
DOKOLO,2020,170,190,360,68
DOKOLO,2021,180,190,370,68
DOKOLO,2022,180,200,380,68
DOKOLO,2023,190,200,390,68
DOKOLO,2024,190,210,400,68
DOKOLO,2025,200,210,410,68
GOMBA,2015,140,150,290,68
GOMBA,2016,150,150,300,68
GOMBA,2017,150,170,320,68
GOMBA,2018,160,180,340,68
GOMBA,2019,180,200,380,68
GOMBA,2020,180,200,380,68
GOMBA,2021,170,200,370,68
GOMBA,2022,160,180,340,68
GOMBA,2023,160,160,320,68
GOMBA,2024,160,150,310,68
GOMBA,2025,160,150,310,68
GULU,2015,140,210,350,68
GULU,2016,140,220,360,68
GULU,2017,150,230,380,68
GULU,2018,150,230,380,68
GULU,2019,150,240,390,68
GULU,2020,160,250,410,68
GULU,2021,160,250,410,68
GULU,2022,170,260,430,68
GULU,2023,170,270,440,68
GULU,2024,180,270,450,68
GULU,2025,180,280,460,68
HOIMA,2015,200,280,480,68
HOIMA,2016,210,290,500,68
HOIMA,2017,220,300,520,68
HOIMA,2018,220,310,530,68
HOIMA,2019,230,320,550,68
HOIMA,2020,240,330,570,68
HOIMA,2021,250,340,590,68
HOIMA,2022,260,350,610,68
HOIMA,2023,270,360,630,68
HOIMA,2024,280,370,650,68
HOIMA,2025,280,380,660,68
IBANDA,2015,220,260,480,68
IBANDA,2016,220,260,480,68
IBANDA,2017,230,270,500,68
IBANDA,2018,230,270,500,68
IBANDA,2019,230,280,510,68
IBANDA,2020,240,280,520,68
IBANDA,2021,240,290,530,68
IBANDA,2022,250,290,540,68
IBANDA,2023,250,290,540,68
IBANDA,2024,250,300,550,68
IBANDA,2025,260,300,560,68
IGANGA,2015,190,190,380,68
IGANGA,2016,210,190,400,68
IGANGA,2017,230,220,450,68
IGANGA,2018,240,240,480,68
IGANGA,2019,260,270,530,68
IGANGA,2020,270,270,540,68
IGANGA,2021,260,270,530,68
IGANGA,2022,260,260,520,68
IGANGA,2023,250,240,490,68
IGANGA,2024,240,230,470,68
IGANGA,2025,250,230,480,68
ISINGIRO,2015,310,390,700,68
ISINGIRO,2016,320,410,730,68
ISINGIRO,2017,330,420,750,68
ISINGIRO,2018,340,440,780,68
ISINGIRO,2019,360,450,810,68
ISINGIRO,2020,370,470,840,68
ISINGIRO,2021,380,480,860,68
ISINGIRO,2022,400,500,900,68
ISINGIRO,2023,410,510,920,68
ISINGIRO,2024,420,530,950,68
ISINGIRO,2025,440,540,980,68
JINJA,2015,250,310,560,68
JINJA,2016,250,320,570,68
JINJA,2017,250,320,570,68
JINJA,2018,260,320,580,68
JINJA,2019,260,330,590,68
JINJA,2020,270,330,600,68
JINJA,2021,270,340,610,68
JINJA,2022,270,340,610,68
JINJA,2023,280,350,630,68
JINJA,2024,280,350,630,68
JINJA,2025,280,350,630,68
KAABONG,2015,80,60,140,68
KAABONG,2016,80,60,140,68
KAABONG,2017,90,70,160,68
KAABONG,2018,90,70,160,68
KAABONG,2019,90,70,160,68
KAABONG,2020,90,70,160,68
KAABONG,2021,100,70,170,68
KAABONG,2022,100,70,170,68
KAABONG,2023,100,70,170,68
KAABONG,2024,100,80,180,68
KAABONG,2025,100,80,180,68
KABALE,2015,210,290,500,68
KABALE,2016,210,290,500,68
KABALE,2017,220,290,510,68
KABALE,2018,220,300,520,68
KABALE,2019,220,300,520,68
KABALE,2020,230,300,530,68
KABALE,2021,230,310,540,68
KABALE,2022,230,310,540,68
KABALE,2023,240,310,550,68
KABALE,2024,240,320,560,68
KABALE,2025,240,320,560,68
KABAROLE,2015,250,250,500,68
KABAROLE,2016,250,250,500,68
KABAROLE,2017,260,260,520,68
KABAROLE,2018,260,270,530,68
KABAROLE,2019,270,270,540,68
KABAROLE,2020,280,280,560,68
KABAROLE,2021,280,280,560,68
KABAROLE,2022,290,290,580,68
KABAROLE,2023,290,290,580,68
KABAROLE,2024,300,300,600,68
KABAROLE,2025,300,300,600,68
KABERAMAIDO,2015,70,140,210,68
KABERAMAIDO,2016,70,140,210,68
KABERAMAIDO,2017,60,140,200,68
KABERAMAIDO,2018,60,130,190,68
KABERAMAIDO,2019,60,120,180,68
KABERAMAIDO,2020,60,110,170,68
KABERAMAIDO,2021,60,110,170,68
KABERAMAIDO,2022,70,120,190,68
KABERAMAIDO,2023,70,140,210,68
KABERAMAIDO,2024,70,160,230,68
KABERAMAIDO,2025,90,170,260,68
KAGADI,2015,180,240,420,68
KAGADI,2016,190,250,440,68
KAGADI,2017,200,250,450,68
KAGADI,2018,210,260,470,68
KAGADI,2019,210,270,480,68
KAGADI,2020,220,280,500,68
KAGADI,2021,230,290,520,68
KAGADI,2022,240,300,540,68
KAGADI,2023,240,310,550,68
KAGADI,2024,250,320,570,68
KAGADI,2025,260,330,590,68
KAKUMIRO,2015,150,170,320,68
KAKUMIRO,2016,160,180,340,68
KAKUMIRO,2017,180,200,380,68
KAKUMIRO,2018,190,210,400,68
KAKUMIRO,2019,210,230,440,68
KAKUMIRO,2020,230,250,480,68
KAKUMIRO,2021,250,270,520,68
KAKUMIRO,2022,270,290,560,68
KAKUMIRO,2023,290,310,600,68
KAKUMIRO,2024,320,340,660,68
KAKUMIRO,2025,340,370,710,68
KALAKI,2015,130,200,330,68
KALAKI,2016,140,200,340,68
KALAKI,2017,150,210,360,68
KALAKI,2018,150,220,370,68
KALAKI,2019,160,230,390,68
KALAKI,2020,170,240,410,68
KALAKI,2021,170,250,420,68
KALAKI,2022,180,260,440,68
KALAKI,2023,190,270,460,68
KALAKI,2024,190,280,470,68
KALAKI,2025,200,280,480,68
KALANGALA,2015,20,10,30,68
KALANGALA,2016,20,20,40,68
KALANGALA,2017,20,20,40,68
KALANGALA,2018,20,20,40,68
KALANGALA,2019,20,20,40,68
KALANGALA,2020,30,20,50,68
KALANGALA,2021,30,20,50,68
KALANGALA,2022,30,20,50,68
KALANGALA,2023,30,20,50,68
KALANGALA,2024,30,20,50,68
KALANGALA,2025,30,20,50,68
KALIRO,2015,170,200,370,68
KALIRO,2016,190,220,410,68
KALIRO,2017,190,230,420,68
KALIRO,2018,220,260,480,68
KALIRO,2019,230,290,520,68
KALIRO,2020,240,310,550,68
KALIRO,2021,240,290,530,68
KALIRO,2022,240,280,520,68
KALIRO,2023,220,270,490,68
KALIRO,2024,220,260,480,68
KALIRO,2025,240,270,510,68
KALUNGU,2015,140,210,350,68
KALUNGU,2016,150,220,370,68
KALUNGU,2017,150,230,380,68
KALUNGU,2018,160,250,410,68
KALUNGU,2019,180,270,450,68
KALUNGU,2020,180,270,450,68
KALUNGU,2021,170,270,440,68
KALUNGU,2022,160,250,410,68
KALUNGU,2023,150,230,380,68
KALUNGU,2024,150,210,360,68
KALUNGU,2025,150,210,360,68
KAMPALA,2015,470,600,1070,68
KAMPALA,2016,480,610,1090,68
KAMPALA,2017,490,620,1110,68
KAMPALA,2018,500,630,1130,68
KAMPALA,2019,510,640,1150,68
KAMPALA,2020,510,650,1160,68
KAMPALA,2021,520,670,1190,68
KAMPALA,2022,530,680,1210,68
KAMPALA,2023,540,690,1230,68
KAMPALA,2024,550,700,1250,68
KAMPALA,2025,560,710,1270,68
KAMULI,2015,310,360,670,68
KAMULI,2016,320,380,700,68
KAMULI,2017,350,410,760,68
KAMULI,2018,370,450,820,68
KAMULI,2019,400,490,890,68
KAMULI,2020,410,510,920,68
KAMULI,2021,410,500,910,68
KAMULI,2022,390,480,870,68
KAMULI,2023,370,430,800,68
KAMULI,2024,370,410,780,68
KAMULI,2025,380,420,800,68
KAMWENGE,2015,180,160,340,68
KAMWENGE,2016,190,160,350,68
KAMWENGE,2017,190,170,360,68
KAMWENGE,2018,200,170,370,68
KAMWENGE,2019,210,180,390,68
KAMWENGE,2020,220,180,400,68
KAMWENGE,2021,230,190,420,68
KAMWENGE,2022,240,200,440,68
KAMWENGE,2023,240,200,440,68
KAMWENGE,2024,250,210,460,68
KAMWENGE,2025,260,220,480,68
KANUNGU,2015,220,280,500,68
KANUNGU,2016,220,280,500,68
KANUNGU,2017,230,290,520,68
KANUNGU,2018,230,290,520,68
KANUNGU,2019,240,300,540,68
KANUNGU,2020,240,300,540,68
KANUNGU,2021,240,300,540,68
KANUNGU,2022,250,310,560,68
KANUNGU,2023,250,310,560,68
KANUNGU,2024,250,320,570,68
KANUNGU,2025,260,320,580,68
KAPCHORWA,2015,80,80,160,68
KAPCHORWA,2016,80,80,160,68
KAPCHORWA,2017,90,80,170,68
KAPCHORWA,2018,90,80,170,68
KAPCHORWA,2019,90,90,180,68
KAPCHORWA,2020,90,90,180,68
KAPCHORWA,2021,100,90,190,68
KAPCHORWA,2022,100,90,190,68
KAPCHORWA,2023,100,100,200,68
KAPCHORWA,2024,100,100,200,68
KAPCHORWA,2025,110,100,210,68
KAPELEBYONG,2015,60,70,130,68
KAPELEBYONG,2016,60,70,130,68
KAPELEBYONG,2017,60,80,140,68
KAPELEBYONG,2018,80,80,160,68
KAPELEBYONG,2019,80,90,170,68
KAPELEBYONG,2020,80,100,180,68
KAPELEBYONG,2021,80,100,180,68
KAPELEBYONG,2022,90,90,180,68
KAPELEBYONG,2023,80,80,160,68
KAPELEBYONG,2024,80,80,160,68
KAPELEBYONG,2025,80,90,170,68
KASESE,2015,370,330,700,68
KASESE,2016,390,340,730,68
KASESE,2017,410,370,780,68
KASESE,2018,440,420,860,68
KASESE,2019,470,440,910,68
KASESE,2020,470,460,930,68
KASESE,2021,470,450,920,68
KASESE,2022,450,430,880,68
KASESE,2023,440,390,830,68
KASESE,2024,430,370,800,68
KASESE,2025,440,380,820,68
KASSANDA,2015,210,180,390,68
KASSANDA,2016,220,190,410,68
KASSANDA,2017,230,190,420,68
KASSANDA,2018,230,190,420,68
KASSANDA,2019,240,200,440,68
KASSANDA,2020,250,200,450,68
KASSANDA,2021,250,210,460,68
KASSANDA,2022,260,210,470,68
KASSANDA,2023,260,210,470,68
KASSANDA,2024,270,220,490,68
KASSANDA,2025,280,220,500,68
KATAKWI,2015,270,410,680,68
KATAKWI,2016,280,430,710,68
KATAKWI,2017,300,470,770,68
KATAKWI,2018,330,530,860,68
KATAKWI,2019,350,570,920,68
KATAKWI,2020,370,590,960,68
KATAKWI,2021,360,590,950,68
KATAKWI,2022,350,560,910,68
KATAKWI,2023,330,510,840,68
KATAKWI,2024,330,490,820,68
KATAKWI,2025,340,500,840,68
KAYUNGA,2015,270,300,570,68
KAYUNGA,2016,270,310,580,68
KAYUNGA,2017,290,340,630,68
KAYUNGA,2018,310,370,680,68
KAYUNGA,2019,330,410,740,68
KAYUNGA,2020,330,410,740,68
KAYUNGA,2021,330,400,730,68
KAYUNGA,2022,310,370,680,68
KAYUNGA,2023,300,350,650,68
KAYUNGA,2024,290,320,610,68
KAYUNGA,2025,300,330,630,68
KAZO,2015,140,140,280,68
KAZO,2016,140,150,290,68
KAZO,2017,150,150,300,68
KAZO,2018,150,160,310,68
KAZO,2019,160,160,320,68
KAZO,2020,160,170,330,68
KAZO,2021,170,170,340,68
KAZO,2022,170,180,350,68
KAZO,2023,180,180,360,68
KAZO,2024,190,190,380,68
KAZO,2025,190,200,390,68
KIBAALE,2015,70,70,140,68
KIBAALE,2016,80,80,160,68
KIBAALE,2017,80,80,160,68
KIBAALE,2018,90,90,180,68
KIBAALE,2019,90,90,180,68
KIBAALE,2020,100,100,200,68
KIBAALE,2021,110,100,210,68
KIBAALE,2022,110,110,220,68
KIBAALE,2023,120,110,230,68
KIBAALE,2024,130,120,250,68
KIBAALE,2025,130,130,260,68
KIBOGA,2015,160,150,310,68
KIBOGA,2016,170,160,330,68
KIBOGA,2017,180,180,360,68
KIBOGA,2018,190,190,380,68
KIBOGA,2019,210,220,430,68
KIBOGA,2020,210,220,430,68
KIBOGA,2021,220,210,430,68
KIBOGA,2022,200,200,400,68
KIBOGA,2023,200,190,390,68
KIBOGA,2024,190,180,370,68
KIBOGA,2025,210,180,390,68
KIBUKU,2015,140,190,330,68
KIBUKU,2016,160,200,360,68
KIBUKU,2017,170,220,390,68
KIBUKU,2018,180,250,430,68
KIBUKU,2019,200,280,480,68
KIBUKU,2020,210,290,500,68
KIBUKU,2021,210,290,500,68
KIBUKU,2022,200,270,470,68
KIBUKU,2023,200,260,460,68
KIBUKU,2024,190,250,440,68
KIBUKU,2025,210,260,470,68
KIKUUBE,2015,210,150,360,68
KIKUUBE,2016,220,150,370,68
KIKUUBE,2017,230,160,390,68
KIKUUBE,2018,240,170,410,68
KIKUUBE,2019,250,180,430,68
KIKUUBE,2020,270,190,460,68
KIKUUBE,2021,280,200,480,68
KIKUUBE,2022,290,210,500,68
KIKUUBE,2023,310,220,530,68
KIKUUBE,2024,320,230,550,68
KIKUUBE,2025,340,240,580,68
KIRUHURA,2015,120,110,230,68
KIRUHURA,2016,120,110,230,68
KIRUHURA,2017,130,120,250,68
KIRUHURA,2018,130,120,250,68
KIRUHURA,2019,140,120,260,68
KIRUHURA,2020,140,130,270,68
KIRUHURA,2021,150,130,280,68
KIRUHURA,2022,150,140,290,68
KIRUHURA,2023,160,140,300,68
KIRUHURA,2024,160,150,310,68
KIRUHURA,2025,170,150,320,68
KIRYANDONGO,2015,150,200,350,68
KIRYANDONGO,2016,160,200,360,68
KIRYANDONGO,2017,170,230,400,68
KIRYANDONGO,2018,180,260,440,68
KIRYANDONGO,2019,200,280,480,68
KIRYANDONGO,2020,200,290,490,68
KIRYANDONGO,2021,210,280,490,68
KIRYANDONGO,2022,190,270,460,68
KIRYANDONGO,2023,190,250,440,68
KIRYANDONGO,2024,180,240,420,68
KIRYANDONGO,2025,200,250,450,68
KISORO,2015,200,270,470,68
KISORO,2016,210,290,500,68
KISORO,2017,220,310,530,68
KISORO,2018,240,350,590,68
KISORO,2019,250,370,620,68
KISORO,2020,260,380,640,68
KISORO,2021,250,370,620,68
KISORO,2022,240,350,590,68
KISORO,2023,230,320,550,68
KISORO,2024,220,310,530,68
KISORO,2025,240,310,550,68
KITAGWENDA,2015,110,120,230,68
KITAGWENDA,2016,120,130,250,68
KITAGWENDA,2017,120,130,250,68
KITAGWENDA,2018,130,140,270,68
KITAGWENDA,2019,130,140,270,68
KITAGWENDA,2020,140,150,290,68
KITAGWENDA,2021,140,150,290,68
KITAGWENDA,2022,150,160,310,68
KITAGWENDA,2023,150,160,310,68
KITAGWENDA,2024,160,170,330,68
KITAGWENDA,2025,170,170,340,68
KITGUM,2015,140,200,340,68
KITGUM,2016,150,220,370,68
KITGUM,2017,150,230,380,68
KITGUM,2018,170,250,420,68
KITGUM,2019,180,280,460,68
KITGUM,2020,180,280,460,68
KITGUM,2021,170,270,440,68
KITGUM,2022,160,260,420,68
KITGUM,2023,160,240,400,68
KITGUM,2024,160,220,380,68
KITGUM,2025,160,220,380,68
KOBOKO,2015,130,160,290,68
KOBOKO,2016,150,160,310,68
KOBOKO,2017,160,190,350,68
KOBOKO,2018,170,200,370,68
KOBOKO,2019,190,230,420,68
KOBOKO,2020,190,240,430,68
KOBOKO,2021,190,230,420,68
KOBOKO,2022,190,230,420,68
KOBOKO,2023,180,220,400,68
KOBOKO,2024,180,200,380,68
KOBOKO,2025,200,210,410,68
KOLE,2015,300,410,710,68
KOLE,2016,310,420,730,68
KOLE,2017,320,430,750,68
KOLE,2018,330,440,770,68
KOLE,2019,340,460,800,68
KOLE,2020,350,470,820,68
KOLE,2021,360,480,840,68
KOLE,2022,370,490,860,68
KOLE,2023,380,510,890,68
KOLE,2024,390,520,910,68
KOLE,2025,400,530,930,68
KOTIDO,2015,130,150,280,68
KOTIDO,2016,140,150,290,68
KOTIDO,2017,140,170,310,68
KOTIDO,2018,160,190,350,68
KOTIDO,2019,160,200,360,68
KOTIDO,2020,170,200,370,68
KOTIDO,2021,170,210,380,68
KOTIDO,2022,160,190,350,68
KOTIDO,2023,150,180,330,68
KOTIDO,2024,150,170,320,68
KOTIDO,2025,160,170,330,68
KUMI,2015,180,260,440,68
KUMI,2016,200,280,480,68
KUMI,2017,220,300,520,68
KUMI,2018,230,330,560,68
KUMI,2019,250,370,620,68
KUMI,2020,250,380,630,68
KUMI,2021,250,370,620,68
KUMI,2022,250,350,600,68
KUMI,2023,230,330,560,68
KUMI,2024,230,320,550,68
KUMI,2025,250,330,580,68
KWANIA,2015,190,270,460,68
KWANIA,2016,190,270,460,68
KWANIA,2017,200,280,480,68
KWANIA,2018,200,290,490,68
KWANIA,2019,210,300,510,68
KWANIA,2020,220,310,530,68
KWANIA,2021,220,310,530,68
KWANIA,2022,230,320,550,68
KWANIA,2023,230,330,560,68
KWANIA,2024,240,340,580,68
KWANIA,2025,250,350,600,68
KWEEN,2015,80,80,160,68
KWEEN,2016,80,90,170,68
KWEEN,2017,80,90,170,68
KWEEN,2018,90,90,180,68
KWEEN,2019,90,90,180,68
KWEEN,2020,90,100,190,68
KWEEN,2021,90,100,190,68
KWEEN,2022,100,100,200,68
KWEEN,2023,100,100,200,68
KWEEN,2024,100,100,200,68
KWEEN,2025,100,110,210,68
KYANKWANZI,2015,230,180,410,68
KYANKWANZI,2016,250,190,440,68
KYANKWANZI,2017,260,200,460,68
KYANKWANZI,2018,270,210,480,68
KYANKWANZI,2019,280,220,500,68
KYANKWANZI,2020,300,230,530,68
KYANKWANZI,2021,310,240,550,68
KYANKWANZI,2022,330,250,580,68
KYANKWANZI,2023,340,260,600,68
KYANKWANZI,2024,360,270,630,68
KYANKWANZI,2025,380,280,660,68
KYEGEGWA,2015,260,300,560,68
KYEGEGWA,2016,280,320,600,68
KYEGEGWA,2017,310,350,660,68
KYEGEGWA,2018,330,370,700,68
KYEGEGWA,2019,360,400,760,68
KYEGEGWA,2020,390,430,820,68
KYEGEGWA,2021,420,470,890,68
KYEGEGWA,2022,450,500,950,68
KYEGEGWA,2023,490,540,1030,68
KYEGEGWA,2024,530,580,1110,68
KYEGEGWA,2025,570,630,1200,68
KYENJOJO,2015,420,520,940,68
KYENJOJO,2016,440,540,980,68
KYENJOJO,2017,460,560,1020,68
KYENJOJO,2018,480,580,1060,68
KYENJOJO,2019,500,600,1100,68
KYENJOJO,2020,520,630,1150,68
KYENJOJO,2021,540,650,1190,68
KYENJOJO,2022,560,670,1230,68
KYENJOJO,2023,580,690,1270,68
KYENJOJO,2024,600,710,1310,68
KYENJOJO,2025,620,740,1360,68
KYOTERA,2015,200,270,470,68
KYOTERA,2016,220,280,500,68
KYOTERA,2017,230,310,540,68
KYOTERA,2018,240,330,570,68
KYOTERA,2019,260,350,610,68
KYOTERA,2020,260,370,630,68
KYOTERA,2021,250,360,610,68
KYOTERA,2022,250,330,580,68
KYOTERA,2023,230,310,540,68
KYOTERA,2024,220,290,510,68
KYOTERA,2025,230,290,520,68
KARENGA,2015,60,70,130,68
KARENGA,2016,70,70,140,68
KARENGA,2017,70,70,140,68
KARENGA,2018,70,70,140,68
KARENGA,2019,70,70,140,68
KARENGA,2020,70,70,140,68
KARENGA,2021,80,80,160,68
KARENGA,2022,80,80,160,68
KARENGA,2023,80,80,160,68
KARENGA,2024,80,80,160,68
KARENGA,2025,80,80,160,68
LAMWO,2015,110,160,270,68
LAMWO,2016,110,160,270,68
LAMWO,2017,120,180,300,68
LAMWO,2018,140,200,340,68
LAMWO,2019,140,220,360,68
LAMWO,2020,140,220,360,68
LAMWO,2021,140,210,350,68
LAMWO,2022,130,200,330,68
LAMWO,2023,120,190,310,68
LAMWO,2024,120,170,290,68
LAMWO,2025,120,170,290,68
LIRA,2015,300,300,600,68
LIRA,2016,300,310,610,68
LIRA,2017,310,320,630,68
LIRA,2018,320,330,650,68
LIRA,2019,330,330,660,68
LIRA,2020,340,340,680,68
LIRA,2021,350,350,700,68
LIRA,2022,360,360,720,68
LIRA,2023,370,370,740,68
LIRA,2024,370,380,750,68
LIRA,2025,380,390,770,68
LUUKA,2015,150,200,350,68
LUUKA,2016,160,200,360,68
LUUKA,2017,170,230,400,68
LUUKA,2018,180,250,430,68
LUUKA,2019,190,270,460,68
LUUKA,2020,200,280,480,68
LUUKA,2021,190,270,460,68
LUUKA,2022,180,260,440,68
LUUKA,2023,180,240,420,68
LUUKA,2024,180,220,400,68
LUUKA,2025,180,230,410,68
LUWERO,2015,300,330,630,68
LUWERO,2016,310,350,660,68
LUWERO,2017,320,390,710,68
LUWERO,2018,350,430,780,68
LUWERO,2019,370,460,830,68
LUWERO,2020,390,470,860,68
LUWERO,2021,380,470,850,68
LUWERO,2022,370,440,810,68
LUWERO,2023,350,400,750,68
LUWERO,2024,350,380,730,68
LUWERO,2025,350,390,740,68
LWENGO,2015,220,280,500,68
LWENGO,2016,230,290,520,68
LWENGO,2017,240,320,560,68
LWENGO,2018,260,350,610,68
LWENGO,2019,270,370,640,68
LWENGO,2020,270,370,640,68
LWENGO,2021,260,370,630,68
LWENGO,2022,260,340,600,68
LWENGO,2023,240,310,550,68
LWENGO,2024,230,290,520,68
LWENGO,2025,240,290,530,68
LYANTONDE,2015,60,70,130,68
LYANTONDE,2016,60,70,130,68
LYANTONDE,2017,60,80,140,68
LYANTONDE,2018,70,80,150,68
LYANTONDE,2019,70,90,160,68
LYANTONDE,2020,80,100,180,68
LYANTONDE,2021,80,100,180,68
LYANTONDE,2022,80,90,170,68
LYANTONDE,2023,70,80,150,68
LYANTONDE,2024,70,80,150,68
LYANTONDE,2025,80,90,170,68
MANAFWA,2015,180,200,380,68
MANAFWA,2016,180,210,390,68
MANAFWA,2017,190,210,400,68
MANAFWA,2018,190,210,400,68
MANAFWA,2019,200,220,420,68
MANAFWA,2020,200,220,420,68
MANAFWA,2021,210,230,440,68
MANAFWA,2022,210,230,440,68
MANAFWA,2023,220,240,460,68
MANAFWA,2024,220,240,460,68
MANAFWA,2025,230,250,480,68
MARACHA,2015,150,270,420,68
MARACHA,2016,150,270,420,68
MARACHA,2017,160,280,440,68
MARACHA,2018,160,280,440,68
MARACHA,2019,160,290,450,68
MARACHA,2020,170,290,460,68
MARACHA,2021,170,300,470,68
MARACHA,2022,170,300,470,68
MARACHA,2023,180,310,490,68
MARACHA,2024,180,310,490,68
MARACHA,2025,180,320,500,68
MASAKA,2015,220,290,510,68
MASAKA,2016,210,270,480,68
MASAKA,2017,210,260,470,68
MASAKA,2018,220,280,500,68
MASAKA,2019,240,300,540,68
MASAKA,2020,250,340,590,68
MASAKA,2021,270,370,640,68
MASAKA,2022,270,380,650,68
MASAKA,2023,270,370,640,68
MASAKA,2024,260,350,610,68
MASAKA,2025,250,320,570,68
MASINDI,2015,200,240,440,68
MASINDI,2016,210,240,450,68
MASINDI,2017,210,250,460,68
MASINDI,2018,220,260,480,68
MASINDI,2019,230,260,490,68
MASINDI,2020,230,270,500,68
MASINDI,2021,240,280,520,68
MASINDI,2022,240,280,520,68
MASINDI,2023,250,290,540,68
MASINDI,2024,260,300,560,68
MASINDI,2025,260,300,560,68
MAYUGE,2015,280,260,540,68
MAYUGE,2016,290,280,570,68
MAYUGE,2017,310,310,620,68
MAYUGE,2018,340,350,690,68
MAYUGE,2019,360,380,740,68
MAYUGE,2020,380,400,780,68
MAYUGE,2021,380,380,760,68
MAYUGE,2022,370,360,730,68
MAYUGE,2023,350,340,690,68
MAYUGE,2024,350,320,670,68
MAYUGE,2025,360,330,690,68
MBALE,2015,430,490,920,68
MBALE,2016,460,520,980,68
MBALE,2017,490,580,1070,68
MBALE,2018,520,650,1170,68
MBALE,2019,560,710,1270,68
MBALE,2020,580,740,1320,68
MBALE,2021,580,740,1320,68
MBALE,2022,560,700,1260,68
MBALE,2023,550,650,1200,68
MBALE,2024,540,620,1160,68
MBALE,2025,560,640,1200,68
MBARARA,2015,200,260,460,68
MBARARA,2016,200,270,470,68
MBARARA,2017,210,270,480,68
MBARARA,2018,210,280,490,68
MBARARA,2019,220,280,500,68
MBARARA,2020,220,290,510,68
MBARARA,2021,230,300,530,68
MBARARA,2022,230,300,530,68
MBARARA,2023,240,310,550,68
MBARARA,2024,240,310,550,68
MBARARA,2025,250,320,570,68
MITOOMA,2015,140,190,330,68
MITOOMA,2016,140,190,330,68
MITOOMA,2017,150,190,340,68
MITOOMA,2018,150,200,350,68
MITOOMA,2019,150,200,350,68
MITOOMA,2020,150,200,350,68
MITOOMA,2021,150,200,350,68
MITOOMA,2022,150,200,350,68
MITOOMA,2023,160,200,360,68
MITOOMA,2024,160,200,360,68
MITOOMA,2025,160,210,370,68
MITYANA,2015,290,290,580,68
MITYANA,2016,300,300,600,68
MITYANA,2017,310,330,640,68
MITYANA,2018,340,360,700,68
MITYANA,2019,350,390,740,68
MITYANA,2020,370,400,770,68
MITYANA,2021,350,390,740,68
MITYANA,2022,350,360,710,68
MITYANA,2023,320,330,650,68
MITYANA,2024,320,320,640,68
MITYANA,2025,320,320,640,68
MOROTO,2015,110,170,280,68
MOROTO,2016,110,180,290,68
MOROTO,2017,130,200,330,68
MOROTO,2018,140,230,370,68
MOROTO,2019,140,240,380,68
MOROTO,2020,140,260,400,68
MOROTO,2021,150,250,400,68
MOROTO,2022,140,240,380,68
MOROTO,2023,130,220,350,68
MOROTO,2024,130,200,330,68
MOROTO,2025,140,210,350,68
MOYO,2015,80,100,180,68
MOYO,2016,80,110,190,68
MOYO,2017,80,110,190,68
MOYO,2018,90,110,200,68
MOYO,2019,90,110,200,68
MOYO,2020,90,120,210,68
MOYO,2021,90,120,210,68
MOYO,2022,90,120,210,68
MOYO,2023,100,120,220,68
MOYO,2024,100,130,230,68
MOYO,2025,100,130,230,68
MPIGI,2015,170,220,390,68
MPIGI,2016,190,240,430,68
MPIGI,2017,190,260,450,68
MPIGI,2018,200,290,490,68
MPIGI,2019,220,320,540,68
MPIGI,2020,220,320,540,68
MPIGI,2021,230,320,550,68
MPIGI,2022,220,290,510,68
MPIGI,2023,210,280,490,68
MPIGI,2024,200,260,460,68
MPIGI,2025,210,270,480,68
MUBENDE,2015,290,240,530,68
MUBENDE,2016,300,260,560,68
MUBENDE,2017,330,300,630,68
MUBENDE,2018,360,330,690,68
MUBENDE,2019,400,370,770,68
MUBENDE,2020,420,400,820,68
MUBENDE,2021,430,390,820,68
MUBENDE,2022,430,390,820,68
MUBENDE,2023,420,360,780,68
MUBENDE,2024,430,350,780,68
MUBENDE,2025,450,370,820,68
MUKONO,2015,360,390,750,68
MUKONO,2016,370,410,780,68
MUKONO,2017,400,450,850,68
MUKONO,2018,430,500,930,68
MUKONO,2019,460,560,1020,68
MUKONO,2020,470,580,1050,68
MUKONO,2021,470,560,1030,68
MUKONO,2022,460,530,990,68
MUKONO,2023,450,500,950,68
MUKONO,2024,440,480,920,68
MUKONO,2025,450,490,940,68
MADI OKOLLO,2015,120,200,320,68
MADI OKOLLO,2016,120,200,320,68
MADI OKOLLO,2017,120,210,330,68
MADI OKOLLO,2018,130,210,340,68
MADI OKOLLO,2019,130,220,350,68
MADI OKOLLO,2020,130,220,350,68
MADI OKOLLO,2021,140,230,370,68
MADI OKOLLO,2022,140,240,380,68
MADI OKOLLO,2023,150,240,390,68
MADI OKOLLO,2024,150,250,400,68
MADI OKOLLO,2025,150,250,400,68
NABILATUK,2015,40,80,120,68
NABILATUK,2016,40,80,120,68
NABILATUK,2017,50,100,150,68
NABILATUK,2018,60,110,170,68
NABILATUK,2019,60,130,190,68
NABILATUK,2020,60,130,190,68
NABILATUK,2021,70,120,190,68
NABILATUK,2022,60,120,180,68
NABILATUK,2023,60,110,170,68
NABILATUK,2024,70,110,180,68
NABILATUK,2025,70,110,180,68
NAKAPIRIPIRIT,2015,80,110,190,68
NAKAPIRIPIRIT,2016,90,120,210,68
NAKAPIRIPIRIT,2017,100,130,230,68
NAKAPIRIPIRIT,2018,100,160,260,68
NAKAPIRIPIRIT,2019,120,160,280,68
NAKAPIRIPIRIT,2020,120,180,300,68
NAKAPIRIPIRIT,2021,130,170,300,68
NAKAPIRIPIRIT,2022,120,170,290,68
NAKAPIRIPIRIT,2023,120,150,270,68
NAKAPIRIPIRIT,2024,120,150,270,68
NAKAPIRIPIRIT,2025,120,160,280,68
NAKASEKE,2015,130,130,260,68
NAKASEKE,2016,130,140,270,68
NAKASEKE,2017,140,140,280,68
NAKASEKE,2018,140,140,280,68
NAKASEKE,2019,150,150,300,68
NAKASEKE,2020,150,150,300,68
NAKASEKE,2021,160,150,310,68
NAKASEKE,2022,160,160,320,68
NAKASEKE,2023,170,160,330,68
NAKASEKE,2024,180,160,340,68
NAKASEKE,2025,180,170,350,68
NAKASONGOLA,2015,100,130,230,68
NAKASONGOLA,2016,110,130,240,68
NAKASONGOLA,2017,120,140,260,68
NAKASONGOLA,2018,140,170,310,68
NAKASONGOLA,2019,140,180,320,68
NAKASONGOLA,2020,140,180,320,68
NAKASONGOLA,2021,150,180,330,68
NAKASONGOLA,2022,140,170,310,68
NAKASONGOLA,2023,130,150,280,68
NAKASONGOLA,2024,140,150,290,68
NAKASONGOLA,2025,140,150,290,68
NAMAYINGO,2015,150,130,280,68
NAMAYINGO,2016,160,130,290,68
NAMAYINGO,2017,160,140,300,68
NAMAYINGO,2018,180,160,340,68
NAMAYINGO,2019,190,180,370,68
NAMAYINGO,2020,190,180,370,68
NAMAYINGO,2021,180,170,350,68
NAMAYINGO,2022,180,160,340,68
NAMAYINGO,2023,170,140,310,68
NAMAYINGO,2024,170,130,300,68
NAMAYINGO,2025,180,140,320,68
NAMISINDWA,2015,250,250,500,68
NAMISINDWA,2016,250,250,500,68
NAMISINDWA,2017,260,260,520,68
NAMISINDWA,2018,270,270,540,68
NAMISINDWA,2019,280,270,550,68
NAMISINDWA,2020,280,280,560,68
NAMISINDWA,2021,290,280,570,68
NAMISINDWA,2022,300,290,590,68
NAMISINDWA,2023,300,300,600,68
NAMISINDWA,2024,310,300,610,68
NAMISINDWA,2025,320,310,630,68
NAMUTUMBA,2015,190,180,370,68
NAMUTUMBA,2016,200,190,390,68
NAMUTUMBA,2017,220,220,440,68
NAMUTUMBA,2018,240,240,480,68
NAMUTUMBA,2019,250,270,520,68
NAMUTUMBA,2020,260,280,540,68
NAMUTUMBA,2021,260,270,530,68
NAMUTUMBA,2022,260,260,520,68
NAMUTUMBA,2023,250,250,500,68
NAMUTUMBA,2024,240,230,470,68
NAMUTUMBA,2025,250,240,490,68
NAPAK,2015,130,240,370,68
NAPAK,2016,150,250,400,68
NAPAK,2017,150,280,430,68
NAPAK,2018,160,300,460,68
NAPAK,2019,160,330,490,68
NAPAK,2020,180,330,510,68
NAPAK,2021,170,330,500,68
NAPAK,2022,160,310,470,68
NAPAK,2023,150,290,440,68
NAPAK,2024,160,270,430,68
NAPAK,2025,160,280,440,68
NEBBI,2015,310,480,790,68
NEBBI,2016,320,500,820,68
NEBBI,2017,330,510,840,68
NEBBI,2018,340,520,860,68
NEBBI,2019,350,540,890,68
NEBBI,2020,360,550,910,68
NEBBI,2021,370,570,940,68
NEBBI,2022,380,580,960,68
NEBBI,2023,390,600,990,68
NEBBI,2024,400,610,1010,68
NEBBI,2025,410,630,1040,68
NGORA,2015,100,130,230,68
NGORA,2016,100,130,230,68
NGORA,2017,110,150,260,68
NGORA,2018,110,170,280,68
NGORA,2019,130,180,310,68
NGORA,2020,130,190,320,68
NGORA,2021,130,180,310,68
NGORA,2022,130,180,310,68
NGORA,2023,120,160,280,68
NGORA,2024,120,150,270,68
NGORA,2025,120,160,280,68
NTOROKO,2015,40,30,70,68
NTOROKO,2016,40,30,70,68
NTOROKO,2017,40,30,70,68
NTOROKO,2018,50,50,100,68
NTOROKO,2019,50,50,100,68
NTOROKO,2020,50,50,100,68
NTOROKO,2021,50,50,100,68
NTOROKO,2022,40,50,90,68
NTOROKO,2023,50,40,90,68
NTOROKO,2024,50,40,90,68
NTOROKO,2025,50,40,90,68
NTUNGAMO,2015,350,480,830,68
NTUNGAMO,2016,360,490,850,68
NTUNGAMO,2017,370,500,870,68
NTUNGAMO,2018,370,510,880,68
NTUNGAMO,2019,380,520,900,68
NTUNGAMO,2020,390,530,920,68
NTUNGAMO,2021,400,540,940,68
NTUNGAMO,2022,410,540,950,68
NTUNGAMO,2023,410,550,960,68
NTUNGAMO,2024,420,560,980,68
NTUNGAMO,2025,430,570,1000,68
NWOYA,2015,100,110,210,68
NWOYA,2016,110,120,230,68
NWOYA,2017,120,140,260,68
NWOYA,2018,130,150,280,68
NWOYA,2019,150,160,310,68
NWOYA,2020,160,180,340,68
NWOYA,2021,180,200,380,68
NWOYA,2022,200,220,420,68
NWOYA,2023,220,240,460,68
NWOYA,2024,240,260,500,68
NWOYA,2025,260,290,550,68
OBONGI,2015,40,50,90,68
OBONGI,2016,40,50,90,68
OBONGI,2017,40,60,100,68
OBONGI,2018,50,60,110,68
OBONGI,2019,50,60,110,68
OBONGI,2020,50,60,110,68
OBONGI,2021,50,60,110,68
OBONGI,2022,40,60,100,68
OBONGI,2023,40,50,90,68
OBONGI,2024,40,50,90,68
OBONGI,2025,50,60,110,68
OMORO,2015,110,160,270,68
OMORO,2016,120,160,280,68
OMORO,2017,130,190,320,68
OMORO,2018,140,200,340,68
OMORO,2019,150,230,380,68
OMORO,2020,150,230,380,68
OMORO,2021,160,230,390,68
OMORO,2022,150,230,380,68
OMORO,2023,150,210,360,68
OMORO,2024,150,200,350,68
OMORO,2025,160,200,360,68
OTUKE,2015,100,100,200,68
OTUKE,2016,100,100,200,68
OTUKE,2017,110,110,220,68
OTUKE,2018,110,110,220,68
OTUKE,2019,110,120,230,68
OTUKE,2020,120,120,240,68
OTUKE,2021,120,130,250,68
OTUKE,2022,130,130,260,68
OTUKE,2023,140,140,280,68
OTUKE,2024,140,140,280,68
OTUKE,2025,150,150,300,68
OYAM,2015,260,330,590,68
OYAM,2016,270,340,610,68
OYAM,2017,280,350,630,68
OYAM,2018,290,360,650,68
OYAM,2019,300,370,670,68
OYAM,2020,300,380,680,68
OYAM,2021,310,390,700,68
OYAM,2022,320,400,720,68
OYAM,2023,330,410,740,68
OYAM,2024,340,420,760,68
OYAM,2025,350,430,780,68
PADER,2015,130,150,280,68
PADER,2016,150,160,310,68
PADER,2017,150,180,330,68
PADER,2018,160,190,350,68
PADER,2019,160,220,380,68
PADER,2020,180,220,400,68
PADER,2021,170,210,380,68
PADER,2022,160,190,350,68
PADER,2023,150,190,340,68
PADER,2024,150,170,320,68
PADER,2025,160,170,330,68
PAKWACH,2015,200,280,480,68
PAKWACH,2016,210,290,500,68
PAKWACH,2017,210,300,510,68
PAKWACH,2018,220,320,540,68
PAKWACH,2019,230,330,560,68
PAKWACH,2020,240,340,580,68
PAKWACH,2021,250,350,600,68
PAKWACH,2022,260,360,620,68
PAKWACH,2023,270,370,640,68
PAKWACH,2024,280,390,670,68
PAKWACH,2025,290,400,690,68
PALLISA,2015,160,260,420,68
PALLISA,2016,180,290,470,68
PALLISA,2017,180,320,500,68
PALLISA,2018,200,360,560,68
PALLISA,2019,220,390,610,68
PALLISA,2020,240,420,660,68
PALLISA,2021,240,420,660,68
PALLISA,2022,240,400,640,68
PALLISA,2023,230,380,610,68
PALLISA,2024,220,360,580,68
PALLISA,2025,240,380,620,68
RAKAI,2015,210,200,410,68
RAKAI,2016,220,220,440,68
RAKAI,2017,240,230,470,68
RAKAI,2018,260,260,520,68
RAKAI,2019,270,280,550,68
RAKAI,2020,280,290,570,68
RAKAI,2021,270,280,550,68
RAKAI,2022,270,270,540,68
RAKAI,2023,260,250,510,68
RAKAI,2024,250,240,490,68
RAKAI,2025,260,240,500,68
RUBANDA,2015,130,170,300,68
RUBANDA,2016,140,180,320,68
RUBANDA,2017,140,180,320,68
RUBANDA,2018,140,180,320,68
RUBANDA,2019,140,180,320,68
RUBANDA,2020,140,180,320,68
RUBANDA,2021,140,180,320,68
RUBANDA,2022,150,180,330,68
RUBANDA,2023,150,180,330,68
RUBANDA,2024,150,190,340,68
RUBANDA,2025,150,190,340,68
RUBIRIZI,2015,110,150,260,68
RUBIRIZI,2016,110,160,270,68
RUBIRIZI,2017,120,160,280,68
RUBIRIZI,2018,120,160,280,68
RUBIRIZI,2019,120,160,280,68
RUBIRIZI,2020,120,170,290,68
RUBIRIZI,2021,130,170,300,68
RUBIRIZI,2022,130,170,300,68
RUBIRIZI,2023,130,180,310,68
RUBIRIZI,2024,130,180,310,68
RUBIRIZI,2025,130,180,310,68
RUKIGA,2015,120,120,240,68
RUKIGA,2016,120,120,240,68
RUKIGA,2017,120,120,240,68
RUKIGA,2018,120,120,240,68
RUKIGA,2019,120,120,240,68
RUKIGA,2020,120,120,240,68
RUKIGA,2021,130,120,250,68
RUKIGA,2022,130,120,250,68
RUKIGA,2023,130,120,250,68
RUKIGA,2024,130,120,250,68
RUKIGA,2025,130,120,250,68
RUKUNGIRI,2015,300,420,720,68
RUKUNGIRI,2016,310,420,730,68
RUKUNGIRI,2017,310,430,740,68
RUKUNGIRI,2018,310,430,740,68
RUKUNGIRI,2019,320,440,760,68
RUKUNGIRI,2020,320,440,760,68
RUKUNGIRI,2021,320,440,760,68
RUKUNGIRI,2022,330,450,780,68
RUKUNGIRI,2023,330,450,780,68
RUKUNGIRI,2024,330,450,780,68
RUKUNGIRI,2025,340,450,790,68
RWAMPARA,2015,90,150,240,68
RWAMPARA,2016,90,150,240,68
RWAMPARA,2017,90,150,240,68
RWAMPARA,2018,100,150,250,68
RWAMPARA,2019,100,160,260,68
RWAMPARA,2020,100,160,260,68
RWAMPARA,2021,100,160,260,68
RWAMPARA,2022,100,170,270,68
RWAMPARA,2023,110,170,280,68
RWAMPARA,2024,110,170,280,68
RWAMPARA,2025,110,180,290,68
SERERE,2015,200,260,460,68
SERERE,2016,210,280,490,68
SERERE,2017,230,310,540,68
SERERE,2018,250,350,600,68
SERERE,2019,270,390,660,68
SERERE,2020,280,410,690,68
SERERE,2021,280,400,680,68
SERERE,2022,280,390,670,68
SERERE,2023,270,360,630,68
SERERE,2024,270,350,620,68
SERERE,2025,280,360,640,68
SHEEMA,2015,190,260,450,68
SHEEMA,2016,190,260,450,68
SHEEMA,2017,190,270,460,68
SHEEMA,2018,200,270,470,68
SHEEMA,2019,200,270,470,68
SHEEMA,2020,200,270,470,68
SHEEMA,2021,200,280,480,68
SHEEMA,2022,200,280,480,68
SHEEMA,2023,210,280,490,68
SHEEMA,2024,210,280,490,68
SHEEMA,2025,210,280,490,68
SIRONKO,2015,270,300,570,68
SIRONKO,2016,280,300,580,68
SIRONKO,2017,290,310,600,68
SIRONKO,2018,290,320,610,68
SIRONKO,2019,300,320,620,68
SIRONKO,2020,310,330,640,68
SIRONKO,2021,310,340,650,68
SIRONKO,2022,320,340,660,68
SIRONKO,2023,330,350,680,68
SIRONKO,2024,330,350,680,68
SIRONKO,2025,340,360,700,68
SOROTI,2015,210,240,450,68
SOROTI,2016,230,260,490,68
SOROTI,2017,250,290,540,68
SOROTI,2018,270,320,590,68
SOROTI,2019,290,350,640,68
SOROTI,2020,310,370,680,68
SOROTI,2021,300,370,670,68
SOROTI,2022,290,350,640,68
SOROTI,2023,280,330,610,68
SOROTI,2024,280,320,600,68
SOROTI,2025,290,330,620,68
SSEMBABULE,2015,160,190,350,68
SSEMBABULE,2016,170,190,360,68
SSEMBABULE,2017,180,220,400,68
SSEMBABULE,2018,190,240,430,68
SSEMBABULE,2019,210,270,480,68
SSEMBABULE,2020,210,270,480,68
SSEMBABULE,2021,220,270,490,68
SSEMBABULE,2022,200,250,450,68
SSEMBABULE,2023,200,240,440,68
SSEMBABULE,2024,190,220,410,68
SSEMBABULE,2025,200,230,430,68
TORORO,2015,460,550,1010,68
TORORO,2016,470,560,1030,68
TORORO,2017,480,580,1060,68
TORORO,2018,490,590,1080,68
TORORO,2019,510,610,1120,68
TORORO,2020,520,620,1140,68
TORORO,2021,530,640,1170,68
TORORO,2022,550,650,1200,68
TORORO,2023,560,660,1220,68
TORORO,2024,570,680,1250,68
TORORO,2025,580,690,1270,68
WAKISO,2015,640,880,1520,68
WAKISO,2016,690,940,1630,68
WAKISO,2017,730,1000,1730,68
WAKISO,2018,780,1070,1850,68
WAKISO,2019,830,1140,1970,68
WAKISO,2020,890,1220,2110,68
WAKISO,2021,940,1300,2240,68
WAKISO,2022,1010,1380,2390,68
WAKISO,2023,1070,1470,2540,68
WAKISO,2024,1140,1560,2700,68
WAKISO,2025,1210,1660,2870,68
YUMBE,2015,490,510,1000,68
YUMBE,2016,520,560,1080,68
YUMBE,2017,570,650,1220,68
YUMBE,2018,630,740,1370,68
YUMBE,2019,680,840,1520,68
YUMBE,2020,720,880,1600,68
YUMBE,2021,730,890,1620,68
YUMBE,2022,730,880,1610,68
YUMBE,2023,720,840,1560,68
YUMBE,2024,720,820,1540,68
YUMBE,2025,760,870,1630,68
ZOMBO,2015,340,650,990,68
ZOMBO,2016,350,670,1020,68
ZOMBO,2017,360,690,1050,68
ZOMBO,2018,380,710,1090,68
ZOMBO,2019,390,730,1120,68
ZOMBO,2020,400,750,1150,68
ZOMBO,2021,410,770,1180,68
ZOMBO,2022,420,780,1200,68
ZOMBO,2023,430,800,1230,68
ZOMBO,2024,440,820,1260,68
ZOMBO,2025,460,840,1300,68
ABIM,2015,70,80,150,69
ABIM,2016,80,90,170,69
ABIM,2017,80,90,170,69
ABIM,2018,80,110,190,69
ABIM,2019,100,120,220,69
ABIM,2020,100,140,240,69
ABIM,2021,110,140,250,69
ABIM,2022,110,150,260,69
ABIM,2023,120,140,260,69
ABIM,2024,120,140,260,69
ABIM,2025,120,140,260,69
ADJUMANI,2015,80,160,240,69
ADJUMANI,2016,80,160,240,69
ADJUMANI,2017,80,160,240,69
ADJUMANI,2018,80,160,240,69
ADJUMANI,2019,80,170,250,69
ADJUMANI,2020,90,170,260,69
ADJUMANI,2021,90,170,260,69
ADJUMANI,2022,90,170,260,69
ADJUMANI,2023,90,170,260,69
ADJUMANI,2024,90,170,260,69
ADJUMANI,2025,90,170,260,69
AGAGO,2015,140,160,300,69
AGAGO,2016,140,160,300,69
AGAGO,2017,140,160,300,69
AGAGO,2018,150,160,310,69
AGAGO,2019,150,170,320,69
AGAGO,2020,150,170,320,69
AGAGO,2021,150,170,320,69
AGAGO,2022,160,180,340,69
AGAGO,2023,160,180,340,69
AGAGO,2024,160,180,340,69
AGAGO,2025,160,180,340,69
ALEBTONG,2015,150,230,380,69
ALEBTONG,2016,140,230,370,69
ALEBTONG,2017,160,250,410,69
ALEBTONG,2018,160,270,430,69
ALEBTONG,2019,180,300,480,69
ALEBTONG,2020,190,320,510,69
ALEBTONG,2021,190,340,530,69
ALEBTONG,2022,200,320,520,69
ALEBTONG,2023,190,310,500,69
ALEBTONG,2024,190,280,470,69
ALEBTONG,2025,180,270,450,69
AMOLATAR,2015,90,120,210,69
AMOLATAR,2016,90,130,220,69
AMOLATAR,2017,80,130,210,69
AMOLATAR,2018,80,120,200,69
AMOLATAR,2019,80,100,180,69
AMOLATAR,2020,80,90,170,69
AMOLATAR,2021,70,100,170,69
AMOLATAR,2022,80,100,180,69
AMOLATAR,2023,90,110,200,69
AMOLATAR,2024,90,120,210,69
AMOLATAR,2025,100,140,240,69
AMUDAT,2015,60,50,110,69
AMUDAT,2016,60,40,100,69
AMUDAT,2017,70,40,110,69
AMUDAT,2018,70,60,130,69
AMUDAT,2019,70,70,140,69
AMUDAT,2020,80,70,150,69
AMUDAT,2021,90,70,160,69
AMUDAT,2022,90,80,170,69
AMUDAT,2023,80,80,160,69
AMUDAT,2024,80,70,150,69
AMUDAT,2025,80,60,140,69
AMURIA,2015,130,140,270,69
AMURIA,2016,130,140,270,69
AMURIA,2017,140,150,290,69
AMURIA,2018,150,170,320,69
AMURIA,2019,160,180,340,69
AMURIA,2020,180,210,390,69
AMURIA,2021,180,210,390,69
AMURIA,2022,190,220,410,69
AMURIA,2023,180,200,380,69
AMURIA,2024,180,180,360,69
AMURIA,2025,170,180,350,69
AMURU,2015,90,110,200,69
AMURU,2016,100,110,210,69
AMURU,2017,100,120,220,69
AMURU,2018,100,130,230,69
AMURU,2019,110,140,250,69
AMURU,2020,130,150,280,69
AMURU,2021,130,170,300,69
AMURU,2022,120,160,280,69
AMURU,2023,120,150,270,69
AMURU,2024,120,140,260,69
AMURU,2025,120,140,260,69
APAC,2015,130,160,290,69
APAC,2016,130,170,300,69
APAC,2017,140,170,310,69
APAC,2018,140,180,320,69
APAC,2019,150,180,330,69
APAC,2020,150,190,340,69
APAC,2021,160,200,360,69
APAC,2022,160,200,360,69
APAC,2023,170,210,380,69
APAC,2024,170,210,380,69
APAC,2025,180,220,400,69
ARUA,2015,350,470,820,69
ARUA,2016,360,480,840,69
ARUA,2017,370,500,870,69
ARUA,2018,380,510,890,69
ARUA,2019,390,520,910,69
ARUA,2020,400,540,940,69
ARUA,2021,410,550,960,69
ARUA,2022,420,560,980,69
ARUA,2023,430,580,1010,69
ARUA,2024,440,590,1030,69
ARUA,2025,450,600,1050,69
BUDAKA,2015,190,250,440,69
BUDAKA,2016,200,240,440,69
BUDAKA,2017,200,260,460,69
BUDAKA,2018,220,290,510,69
BUDAKA,2019,250,330,580,69
BUDAKA,2020,260,360,620,69
BUDAKA,2021,270,370,640,69
BUDAKA,2022,270,360,630,69
BUDAKA,2023,260,350,610,69
BUDAKA,2024,250,330,580,69
BUDAKA,2025,250,320,570,69
BUDUDA,2015,160,200,360,69
BUDUDA,2016,160,210,370,69
BUDUDA,2017,170,220,390,69
BUDUDA,2018,190,240,430,69
BUDUDA,2019,210,280,490,69
BUDUDA,2020,220,310,530,69
BUDUDA,2021,230,320,550,69
BUDUDA,2022,240,320,560,69
BUDUDA,2023,240,310,550,69
BUDUDA,2024,220,290,510,69
BUDUDA,2025,220,280,500,69
BUGIRI,2015,260,300,560,69
BUGIRI,2016,270,290,560,69
BUGIRI,2017,280,310,590,69
BUGIRI,2018,300,350,650,69
BUGIRI,2019,330,390,720,69
BUGIRI,2020,360,430,790,69
BUGIRI,2021,370,450,820,69
BUGIRI,2022,370,460,830,69
BUGIRI,2023,360,440,800,69
BUGIRI,2024,350,410,760,69
BUGIRI,2025,350,390,740,69
BUGWERI,2015,110,100,210,69
BUGWERI,2016,110,100,210,69
BUGWERI,2017,110,100,210,69
BUGWERI,2018,130,110,240,69
BUGWERI,2019,140,130,270,69
BUGWERI,2020,140,140,280,69
BUGWERI,2021,150,140,290,69
BUGWERI,2022,150,140,290,69
BUGWERI,2023,140,140,280,69
BUGWERI,2024,140,120,260,69
BUGWERI,2025,140,120,260,69
BUHWEJU,2015,90,80,170,69
BUHWEJU,2016,90,90,180,69
BUHWEJU,2017,90,90,180,69
BUHWEJU,2018,100,90,190,69
BUHWEJU,2019,100,90,190,69
BUHWEJU,2020,100,100,200,69
BUHWEJU,2021,110,100,210,69
BUHWEJU,2022,110,100,210,69
BUHWEJU,2023,110,100,210,69
BUHWEJU,2024,120,110,230,69
BUHWEJU,2025,120,110,230,69
BUIKWE,2015,250,230,480,69
BUIKWE,2016,240,220,460,69
BUIKWE,2017,250,240,490,69
BUIKWE,2018,270,250,520,69
BUIKWE,2019,280,290,570,69
BUIKWE,2020,310,310,620,69
BUIKWE,2021,310,310,620,69
BUIKWE,2022,310,310,620,69
BUIKWE,2023,290,290,580,69
BUIKWE,2024,290,270,560,69
BUIKWE,2025,280,250,530,69
BUKEDEA,2015,170,200,370,69
BUKEDEA,2016,180,210,390,69
BUKEDEA,2017,180,210,390,69
BUKEDEA,2018,200,240,440,69
BUKEDEA,2019,220,280,500,69
BUKEDEA,2020,240,310,550,69
BUKEDEA,2021,240,320,560,69
BUKEDEA,2022,250,310,560,69
BUKEDEA,2023,250,300,550,69
BUKEDEA,2024,240,280,520,69
BUKEDEA,2025,240,270,510,69
BUKOMANSIMBI,2015,110,140,250,69
BUKOMANSIMBI,2016,120,130,250,69
BUKOMANSIMBI,2017,120,130,250,69
BUKOMANSIMBI,2018,130,150,280,69
BUKOMANSIMBI,2019,140,170,310,69
BUKOMANSIMBI,2020,140,180,320,69
BUKOMANSIMBI,2021,140,180,320,69
BUKOMANSIMBI,2022,140,180,320,69
BUKOMANSIMBI,2023,130,160,290,69
BUKOMANSIMBI,2024,120,150,270,69
BUKOMANSIMBI,2025,120,140,260,69
BUKWO,2015,50,50,100,69
BUKWO,2016,50,60,110,69
BUKWO,2017,50,60,110,69
BUKWO,2018,50,60,110,69
BUKWO,2019,60,70,130,69
BUKWO,2020,60,70,130,69
BUKWO,2021,60,70,130,69
BUKWO,2022,70,70,140,69
BUKWO,2023,70,80,150,69
BUKWO,2024,70,80,150,69
BUKWO,2025,80,90,170,69
BULAMBULI,2015,150,190,340,69
BULAMBULI,2016,140,200,340,69
BULAMBULI,2017,160,210,370,69
BULAMBULI,2018,170,230,400,69
BULAMBULI,2019,200,260,460,69
BULAMBULI,2020,200,290,490,69
BULAMBULI,2021,220,310,530,69
BULAMBULI,2022,220,310,530,69
BULAMBULI,2023,220,300,520,69
BULAMBULI,2024,220,290,510,69
BULAMBULI,2025,210,280,490,69
BULIISA,2015,40,40,80,69
BULIISA,2016,40,40,80,69
BULIISA,2017,40,40,80,69
BULIISA,2018,40,50,90,69
BULIISA,2019,50,50,100,69
BULIISA,2020,50,50,100,69
BULIISA,2021,50,50,100,69
BULIISA,2022,50,50,100,69
BULIISA,2023,60,60,120,69
BULIISA,2024,60,60,120,69
BULIISA,2025,60,60,120,69
BUNDIBUGYO,2015,140,160,300,69
BUNDIBUGYO,2016,130,150,280,69
BUNDIBUGYO,2017,140,170,310,69
BUNDIBUGYO,2018,150,180,330,69
BUNDIBUGYO,2019,160,200,360,69
BUNDIBUGYO,2020,170,220,390,69
BUNDIBUGYO,2021,180,230,410,69
BUNDIBUGYO,2022,170,220,390,69
BUNDIBUGYO,2023,180,210,390,69
BUNDIBUGYO,2024,160,190,350,69
BUNDIBUGYO,2025,160,190,350,69
BUNYANGABU,2015,100,130,230,69
BUNYANGABU,2016,110,120,230,69
BUNYANGABU,2017,110,120,230,69
BUNYANGABU,2018,120,130,250,69
BUNYANGABU,2019,120,160,280,69
BUNYANGABU,2020,140,170,310,69
BUNYANGABU,2021,140,170,310,69
BUNYANGABU,2022,140,160,300,69
BUNYANGABU,2023,130,160,290,69
BUNYANGABU,2024,130,150,280,69
BUNYANGABU,2025,130,140,270,69
BUSHENYI,2015,170,210,380,69
BUSHENYI,2016,170,210,380,69
BUSHENYI,2017,170,210,380,69
BUSHENYI,2018,180,210,390,69
BUSHENYI,2019,180,210,390,69
BUSHENYI,2020,180,210,390,69
BUSHENYI,2021,180,220,400,69
BUSHENYI,2022,180,220,400,69
BUSHENYI,2023,180,220,400,69
BUSHENYI,2024,190,220,410,69
BUSHENYI,2025,190,220,410,69
BUSIA,2015,230,330,560,69
BUSIA,2016,230,330,560,69
BUSIA,2017,250,340,590,69
BUSIA,2018,260,380,640,69
BUSIA,2019,280,420,700,69
BUSIA,2020,310,460,770,69
BUSIA,2021,320,480,800,69
BUSIA,2022,310,470,780,69
BUSIA,2023,310,450,760,69
BUSIA,2024,300,410,710,69
BUSIA,2025,300,390,690,69
BUTALEJA,2015,220,250,470,69
BUTALEJA,2016,220,250,470,69
BUTALEJA,2017,230,270,500,69
BUTALEJA,2018,240,300,540,69
BUTALEJA,2019,270,340,610,69
BUTALEJA,2020,290,380,670,69
BUTALEJA,2021,310,400,710,69
BUTALEJA,2022,300,380,680,69
BUTALEJA,2023,290,360,650,69
BUTALEJA,2024,290,340,630,69
BUTALEJA,2025,290,330,620,69
BUTAMBALA,2015,60,50,110,69
BUTAMBALA,2016,70,40,110,69
BUTAMBALA,2017,70,40,110,69
BUTAMBALA,2018,70,50,120,69
BUTAMBALA,2019,70,50,120,69
BUTAMBALA,2020,80,60,140,69
BUTAMBALA,2021,80,60,140,69
BUTAMBALA,2022,70,50,120,69
BUTAMBALA,2023,70,50,120,69
BUTAMBALA,2024,70,50,120,69
BUTAMBALA,2025,60,40,100,69
BUTEBO,2015,80,130,210,69
BUTEBO,2016,80,130,210,69
BUTEBO,2017,80,130,210,69
BUTEBO,2018,80,150,230,69
BUTEBO,2019,90,160,250,69
BUTEBO,2020,100,170,270,69
BUTEBO,2021,100,170,270,69
BUTEBO,2022,100,160,260,69
BUTEBO,2023,90,150,240,69
BUTEBO,2024,90,150,240,69
BUTEBO,2025,80,140,220,69
BUVUMA,2015,30,20,50,69
BUVUMA,2016,40,20,60,69
BUVUMA,2017,40,30,70,69
BUVUMA,2018,40,30,70,69
BUVUMA,2019,40,30,70,69
BUVUMA,2020,50,30,80,69
BUVUMA,2021,50,30,80,69
BUVUMA,2022,50,40,90,69
BUVUMA,2023,60,40,100,69
BUVUMA,2024,60,40,100,69
BUVUMA,2025,60,40,100,69
BUYENDE,2015,200,200,400,69
BUYENDE,2016,210,210,420,69
BUYENDE,2017,230,220,450,69
BUYENDE,2018,240,250,490,69
BUYENDE,2019,270,290,560,69
BUYENDE,2020,290,320,610,69
BUYENDE,2021,310,320,630,69
BUYENDE,2022,310,320,630,69
BUYENDE,2023,310,310,620,69
BUYENDE,2024,300,290,590,69
BUYENDE,2025,300,280,580,69
DOKOLO,2015,100,140,240,69
DOKOLO,2016,100,140,240,69
DOKOLO,2017,100,150,250,69
DOKOLO,2018,110,150,260,69
DOKOLO,2019,110,160,270,69
DOKOLO,2020,110,160,270,69
DOKOLO,2021,120,170,290,69
DOKOLO,2022,120,170,290,69
DOKOLO,2023,120,170,290,69
DOKOLO,2024,130,180,310,69
DOKOLO,2025,130,180,310,69
GOMBA,2015,140,110,250,69
GOMBA,2016,130,110,240,69
GOMBA,2017,150,110,260,69
GOMBA,2018,150,130,280,69
GOMBA,2019,160,140,300,69
GOMBA,2020,170,150,320,69
GOMBA,2021,180,160,340,69
GOMBA,2022,170,150,320,69
GOMBA,2023,160,140,300,69
GOMBA,2024,150,120,270,69
GOMBA,2025,150,120,270,69
GULU,2015,120,160,280,69
GULU,2016,130,170,300,69
GULU,2017,130,170,300,69
GULU,2018,130,180,310,69
GULU,2019,140,180,320,69
GULU,2020,140,190,330,69
GULU,2021,140,190,330,69
GULU,2022,150,200,350,69
GULU,2023,150,200,350,69
GULU,2024,160,210,370,69
GULU,2025,160,210,370,69
HOIMA,2015,180,210,390,69
HOIMA,2016,190,220,410,69
HOIMA,2017,190,220,410,69
HOIMA,2018,200,230,430,69
HOIMA,2019,210,240,450,69
HOIMA,2020,220,250,470,69
HOIMA,2021,220,260,480,69
HOIMA,2022,230,260,490,69
HOIMA,2023,240,270,510,69
HOIMA,2024,250,280,530,69
HOIMA,2025,250,290,540,69
IBANDA,2015,160,200,360,69
IBANDA,2016,160,200,360,69
IBANDA,2017,170,200,370,69
IBANDA,2018,170,210,380,69
IBANDA,2019,170,210,380,69
IBANDA,2020,180,220,400,69
IBANDA,2021,180,220,400,69
IBANDA,2022,180,220,400,69
IBANDA,2023,190,230,420,69
IBANDA,2024,190,230,420,69
IBANDA,2025,190,230,420,69
IGANGA,2015,240,230,470,69
IGANGA,2016,230,230,460,69
IGANGA,2017,250,240,490,69
IGANGA,2018,270,270,540,69
IGANGA,2019,280,290,570,69
IGANGA,2020,310,320,630,69
IGANGA,2021,320,340,660,69
IGANGA,2022,310,320,630,69
IGANGA,2023,310,310,620,69
IGANGA,2024,300,280,580,69
IGANGA,2025,300,270,570,69
ISINGIRO,2015,270,340,610,69
ISINGIRO,2016,280,350,630,69
ISINGIRO,2017,290,360,650,69
ISINGIRO,2018,300,380,680,69
ISINGIRO,2019,310,390,700,69
ISINGIRO,2020,320,400,720,69
ISINGIRO,2021,330,420,750,69
ISINGIRO,2022,340,430,770,69
ISINGIRO,2023,360,440,800,69
ISINGIRO,2024,370,460,830,69
ISINGIRO,2025,380,470,850,69
JINJA,2015,230,300,530,69
JINJA,2016,240,300,540,69
JINJA,2017,240,310,550,69
JINJA,2018,250,310,560,69
JINJA,2019,250,310,560,69
JINJA,2020,250,320,570,69
JINJA,2021,260,320,580,69
JINJA,2022,260,330,590,69
JINJA,2023,270,330,600,69
JINJA,2024,270,330,600,69
JINJA,2025,270,340,610,69
KAABONG,2015,70,100,170,69
KAABONG,2016,70,100,170,69
KAABONG,2017,70,110,180,69
KAABONG,2018,70,110,180,69
KAABONG,2019,70,110,180,69
KAABONG,2020,70,110,180,69
KAABONG,2021,80,110,190,69
KAABONG,2022,80,120,200,69
KAABONG,2023,80,120,200,69
KAABONG,2024,80,120,200,69
KAABONG,2025,80,120,200,69
KABALE,2015,170,210,380,69
KABALE,2016,180,220,400,69
KABALE,2017,180,220,400,69
KABALE,2018,180,220,400,69
KABALE,2019,180,220,400,69
KABALE,2020,190,230,420,69
KABALE,2021,190,230,420,69
KABALE,2022,190,230,420,69
KABALE,2023,190,230,420,69
KABALE,2024,200,230,430,69
KABALE,2025,200,240,440,69
KABAROLE,2015,230,230,460,69
KABAROLE,2016,240,230,470,69
KABAROLE,2017,240,240,480,69
KABAROLE,2018,250,240,490,69
KABAROLE,2019,250,250,500,69
KABAROLE,2020,260,250,510,69
KABAROLE,2021,260,260,520,69
KABAROLE,2022,270,260,530,69
KABAROLE,2023,270,270,540,69
KABAROLE,2024,280,270,550,69
KABAROLE,2025,280,270,550,69
KABERAMAIDO,2015,60,90,150,69
KABERAMAIDO,2016,60,110,170,69
KABERAMAIDO,2017,60,110,170,69
KABERAMAIDO,2018,70,120,190,69
KABERAMAIDO,2019,60,100,160,69
KABERAMAIDO,2020,60,100,160,69
KABERAMAIDO,2021,60,90,150,69
KABERAMAIDO,2022,60,90,150,69
KABERAMAIDO,2023,60,100,160,69
KABERAMAIDO,2024,70,110,180,69
KABERAMAIDO,2025,80,130,210,69
KAGADI,2015,150,190,340,69
KAGADI,2016,150,190,340,69
KAGADI,2017,160,200,360,69
KAGADI,2018,160,210,370,69
KAGADI,2019,170,220,390,69
KAGADI,2020,170,220,390,69
KAGADI,2021,180,230,410,69
KAGADI,2022,190,240,430,69
KAGADI,2023,190,250,440,69
KAGADI,2024,200,250,450,69
KAGADI,2025,210,260,470,69
KAKUMIRO,2015,170,160,330,69
KAKUMIRO,2016,180,170,350,69
KAKUMIRO,2017,200,190,390,69
KAKUMIRO,2018,220,200,420,69
KAKUMIRO,2019,240,220,460,69
KAKUMIRO,2020,260,240,500,69
KAKUMIRO,2021,280,260,540,69
KAKUMIRO,2022,300,280,580,69
KAKUMIRO,2023,330,300,630,69
KAKUMIRO,2024,360,320,680,69
KAKUMIRO,2025,390,350,740,69
KALAKI,2015,100,160,260,69
KALAKI,2016,100,170,270,69
KALAKI,2017,110,170,280,69
KALAKI,2018,110,180,290,69
KALAKI,2019,120,190,310,69
KALAKI,2020,120,200,320,69
KALAKI,2021,130,200,330,69
KALAKI,2022,130,210,340,69
KALAKI,2023,140,220,360,69
KALAKI,2024,140,230,370,69
KALAKI,2025,150,230,380,69
KALANGALA,2015,20,10,30,69
KALANGALA,2016,20,10,30,69
KALANGALA,2017,30,10,40,69
KALANGALA,2018,30,10,40,69
KALANGALA,2019,30,10,40,69
KALANGALA,2020,30,20,50,69
KALANGALA,2021,30,20,50,69
KALANGALA,2022,30,20,50,69
KALANGALA,2023,30,20,50,69
KALANGALA,2024,30,20,50,69
KALANGALA,2025,30,20,50,69
KALIRO,2015,190,180,370,69
KALIRO,2016,200,190,390,69
KALIRO,2017,200,200,400,69
KALIRO,2018,220,220,440,69
KALIRO,2019,250,250,500,69
KALIRO,2020,260,260,520,69
KALIRO,2021,270,280,550,69
KALIRO,2022,270,280,550,69
KALIRO,2023,270,260,530,69
KALIRO,2024,250,250,500,69
KALIRO,2025,250,240,490,69
KALUNGU,2015,150,180,330,69
KALUNGU,2016,160,170,330,69
KALUNGU,2017,160,190,350,69
KALUNGU,2018,160,210,370,69
KALUNGU,2019,170,220,390,69
KALUNGU,2020,180,240,420,69
KALUNGU,2021,180,240,420,69
KALUNGU,2022,170,230,400,69
KALUNGU,2023,180,210,390,69
KALUNGU,2024,160,190,350,69
KALUNGU,2025,160,180,340,69
KAMPALA,2015,450,460,910,69
KAMPALA,2016,460,470,930,69
KAMPALA,2017,470,470,940,69
KAMPALA,2018,480,480,960,69
KAMPALA,2019,490,490,980,69
KAMPALA,2020,490,500,990,69
KAMPALA,2021,500,510,1010,69
KAMPALA,2022,510,520,1030,69
KAMPALA,2023,520,530,1050,69
KAMPALA,2024,530,530,1060,69
KAMPALA,2025,540,540,1080,69
KAMULI,2015,360,500,860,69
KAMULI,2016,370,490,860,69
KAMULI,2017,380,520,900,69
KAMULI,2018,410,580,990,69
KAMULI,2019,430,640,1070,69
KAMULI,2020,460,700,1160,69
KAMULI,2021,470,720,1190,69
KAMULI,2022,470,700,1170,69
KAMULI,2023,460,660,1120,69
KAMULI,2024,440,610,1050,69
KAMULI,2025,430,580,1010,69
KAMWENGE,2015,120,150,270,69
KAMWENGE,2016,130,150,280,69
KAMWENGE,2017,130,160,290,69
KAMWENGE,2018,140,160,300,69
KAMWENGE,2019,140,170,310,69
KAMWENGE,2020,150,180,330,69
KAMWENGE,2021,160,180,340,69
KAMWENGE,2022,160,190,350,69
KAMWENGE,2023,170,190,360,69
KAMWENGE,2024,170,200,370,69
KAMWENGE,2025,180,210,390,69
KANUNGU,2015,170,240,410,69
KANUNGU,2016,180,250,430,69
KANUNGU,2017,180,250,430,69
KANUNGU,2018,180,250,430,69
KANUNGU,2019,190,260,450,69
KANUNGU,2020,190,260,450,69
KANUNGU,2021,190,270,460,69
KANUNGU,2022,200,270,470,69
KANUNGU,2023,200,270,470,69
KANUNGU,2024,200,280,480,69
KANUNGU,2025,200,280,480,69
KAPCHORWA,2015,80,90,170,69
KAPCHORWA,2016,80,90,170,69
KAPCHORWA,2017,80,100,180,69
KAPCHORWA,2018,80,100,180,69
KAPCHORWA,2019,90,100,190,69
KAPCHORWA,2020,90,110,200,69
KAPCHORWA,2021,90,110,200,69
KAPCHORWA,2022,90,110,200,69
KAPCHORWA,2023,100,110,210,69
KAPCHORWA,2024,100,120,220,69
KAPCHORWA,2025,100,120,220,69
KAPELEBYONG,2015,60,70,130,69
KAPELEBYONG,2016,60,70,130,69
KAPELEBYONG,2017,60,70,130,69
KAPELEBYONG,2018,70,80,150,69
KAPELEBYONG,2019,70,90,160,69
KAPELEBYONG,2020,80,100,180,69
KAPELEBYONG,2021,80,100,180,69
KAPELEBYONG,2022,70,90,160,69
KAPELEBYONG,2023,70,100,170,69
KAPELEBYONG,2024,80,90,170,69
KAPELEBYONG,2025,70,80,150,69
KASESE,2015,340,260,600,69
KASESE,2016,340,260,600,69
KASESE,2017,360,280,640,69
KASESE,2018,370,300,670,69
KASESE,2019,410,340,750,69
KASESE,2020,430,360,790,69
KASESE,2021,450,380,830,69
KASESE,2022,430,360,790,69
KASESE,2023,420,350,770,69
KASESE,2024,410,320,730,69
KASESE,2025,400,310,710,69
KASSANDA,2015,180,140,320,69
KASSANDA,2016,180,140,320,69
KASSANDA,2017,190,150,340,69
KASSANDA,2018,190,150,340,69
KASSANDA,2019,200,150,350,69
KASSANDA,2020,210,160,370,69
KASSANDA,2021,210,160,370,69
KASSANDA,2022,220,160,380,69
KASSANDA,2023,220,170,390,69
KASSANDA,2024,230,170,400,69
KASSANDA,2025,230,170,400,69
KATAKWI,2015,230,270,500,69
KATAKWI,2016,220,270,490,69
KATAKWI,2017,240,280,520,69
KATAKWI,2018,260,310,570,69
KATAKWI,2019,270,360,630,69
KATAKWI,2020,290,380,670,69
KATAKWI,2021,310,400,710,69
KATAKWI,2022,300,380,680,69
KATAKWI,2023,290,360,650,69
KATAKWI,2024,290,340,630,69
KATAKWI,2025,280,320,600,69
KAYUNGA,2015,240,280,520,69
KAYUNGA,2016,240,270,510,69
KAYUNGA,2017,250,290,540,69
KAYUNGA,2018,270,310,580,69
KAYUNGA,2019,280,360,640,69
KAYUNGA,2020,290,380,670,69
KAYUNGA,2021,310,380,690,69
KAYUNGA,2022,300,380,680,69
KAYUNGA,2023,290,350,640,69
KAYUNGA,2024,270,320,590,69
KAYUNGA,2025,260,310,570,69
KAZO,2015,130,150,280,69
KAZO,2016,130,150,280,69
KAZO,2017,140,160,300,69
KAZO,2018,140,160,300,69
KAZO,2019,150,170,320,69
KAZO,2020,150,180,330,69
KAZO,2021,160,180,340,69
KAZO,2022,160,190,350,69
KAZO,2023,170,190,360,69
KAZO,2024,170,200,370,69
KAZO,2025,180,210,390,69
KIBAALE,2015,70,70,140,69
KIBAALE,2016,80,70,150,69
KIBAALE,2017,80,70,150,69
KIBAALE,2018,80,80,160,69
KIBAALE,2019,90,80,170,69
KIBAALE,2020,100,90,190,69
KIBAALE,2021,100,90,190,69
KIBAALE,2022,110,100,210,69
KIBAALE,2023,110,100,210,69
KIBAALE,2024,120,110,230,69
KIBAALE,2025,130,110,240,69
KIBOGA,2015,140,140,280,69
KIBOGA,2016,130,130,260,69
KIBOGA,2017,140,150,290,69
KIBOGA,2018,150,160,310,69
KIBOGA,2019,160,170,330,69
KIBOGA,2020,170,190,360,69
KIBOGA,2021,180,200,380,69
KIBOGA,2022,170,190,360,69
KIBOGA,2023,160,180,340,69
KIBOGA,2024,160,170,330,69
KIBOGA,2025,160,160,320,69
KIBUKU,2015,180,240,420,69
KIBUKU,2016,190,240,430,69
KIBUKU,2017,190,250,440,69
KIBUKU,2018,210,280,490,69
KIBUKU,2019,230,320,550,69
KIBUKU,2020,260,350,610,69
KIBUKU,2021,260,370,630,69
KIBUKU,2022,260,360,620,69
KIBUKU,2023,260,340,600,69
KIBUKU,2024,250,320,570,69
KIBUKU,2025,240,310,550,69
KIKUUBE,2015,150,140,290,69
KIKUUBE,2016,150,140,290,69
KIKUUBE,2017,160,150,310,69
KIKUUBE,2018,170,160,330,69
KIKUUBE,2019,180,170,350,69
KIKUUBE,2020,190,180,370,69
KIKUUBE,2021,200,180,380,69
KIKUUBE,2022,210,190,400,69
KIKUUBE,2023,220,200,420,69
KIKUUBE,2024,230,210,440,69
KIKUUBE,2025,240,220,460,69
KIRUHURA,2015,130,100,230,69
KIRUHURA,2016,130,110,240,69
KIRUHURA,2017,140,110,250,69
KIRUHURA,2018,140,120,260,69
KIRUHURA,2019,150,120,270,69
KIRUHURA,2020,150,120,270,69
KIRUHURA,2021,160,130,290,69
KIRUHURA,2022,160,130,290,69
KIRUHURA,2023,170,140,310,69
KIRUHURA,2024,170,140,310,69
KIRUHURA,2025,180,150,330,69
KIRYANDONGO,2015,160,170,330,69
KIRYANDONGO,2016,160,160,320,69
KIRYANDONGO,2017,170,170,340,69
KIRYANDONGO,2018,170,190,360,69
KIRYANDONGO,2019,200,210,410,69
KIRYANDONGO,2020,200,240,440,69
KIRYANDONGO,2021,220,240,460,69
KIRYANDONGO,2022,210,230,440,69
KIRYANDONGO,2023,210,230,440,69
KIRYANDONGO,2024,200,200,400,69
KIRYANDONGO,2025,190,200,390,69
KISORO,2015,190,200,390,69
KISORO,2016,190,210,400,69
KISORO,2017,200,210,410,69
KISORO,2018,210,240,450,69
KISORO,2019,220,260,480,69
KISORO,2020,240,280,520,69
KISORO,2021,240,300,540,69
KISORO,2022,240,280,520,69
KISORO,2023,240,260,500,69
KISORO,2024,220,250,470,69
KISORO,2025,210,230,440,69
KITAGWENDA,2015,90,120,210,69
KITAGWENDA,2016,100,130,230,69
KITAGWENDA,2017,100,130,230,69
KITAGWENDA,2018,110,140,250,69
KITAGWENDA,2019,110,140,250,69
KITAGWENDA,2020,110,150,260,69
KITAGWENDA,2021,120,150,270,69
KITAGWENDA,2022,120,160,280,69
KITAGWENDA,2023,130,160,290,69
KITAGWENDA,2024,130,170,300,69
KITAGWENDA,2025,140,170,310,69
KITGUM,2015,160,160,320,69
KITGUM,2016,170,150,320,69
KITGUM,2017,170,160,330,69
KITGUM,2018,170,180,350,69
KITGUM,2019,180,200,380,69
KITGUM,2020,200,210,410,69
KITGUM,2021,200,210,410,69
KITGUM,2022,200,220,420,69
KITGUM,2023,190,200,390,69
KITGUM,2024,190,180,370,69
KITGUM,2025,180,170,350,69
KOBOKO,2015,130,110,240,69
KOBOKO,2016,120,120,240,69
KOBOKO,2017,140,120,260,69
KOBOKO,2018,140,130,270,69
KOBOKO,2019,150,160,310,69
KOBOKO,2020,170,170,340,69
KOBOKO,2021,170,180,350,69
KOBOKO,2022,170,180,350,69
KOBOKO,2023,180,180,360,69
KOBOKO,2024,160,160,320,69
KOBOKO,2025,170,160,330,69
KOLE,2015,220,280,500,69
KOLE,2016,230,290,520,69
KOLE,2017,230,300,530,69
KOLE,2018,240,310,550,69
KOLE,2019,250,320,570,69
KOLE,2020,260,330,590,69
KOLE,2021,260,340,600,69
KOLE,2022,270,340,610,69
KOLE,2023,280,350,630,69
KOLE,2024,290,360,650,69
KOLE,2025,300,370,670,69
KOTIDO,2015,110,150,260,69
KOTIDO,2016,110,140,250,69
KOTIDO,2017,120,160,280,69
KOTIDO,2018,130,170,300,69
KOTIDO,2019,140,180,320,69
KOTIDO,2020,140,210,350,69
KOTIDO,2021,150,210,360,69
KOTIDO,2022,150,200,350,69
KOTIDO,2023,140,190,330,69
KOTIDO,2024,130,180,310,69
KOTIDO,2025,140,170,310,69
KUMI,2015,170,250,420,69
KUMI,2016,170,250,420,69
KUMI,2017,180,270,450,69
KUMI,2018,200,290,490,69
KUMI,2019,210,330,540,69
KUMI,2020,230,360,590,69
KUMI,2021,230,370,600,69
KUMI,2022,240,360,600,69
KUMI,2023,220,350,570,69
KUMI,2024,220,320,540,69
KUMI,2025,210,310,520,69
KWANIA,2015,170,200,370,69
KWANIA,2016,170,200,370,69
KWANIA,2017,180,210,390,69
KWANIA,2018,180,210,390,69
KWANIA,2019,190,220,410,69
KWANIA,2020,190,230,420,69
KWANIA,2021,200,230,430,69
KWANIA,2022,210,240,450,69
KWANIA,2023,210,240,450,69
KWANIA,2024,220,250,470,69
KWANIA,2025,220,260,480,69
KWEEN,2015,50,70,120,69
KWEEN,2016,50,70,120,69
KWEEN,2017,50,70,120,69
KWEEN,2018,50,70,120,69
KWEEN,2019,50,70,120,69
KWEEN,2020,60,70,130,69
KWEEN,2021,60,80,140,69
KWEEN,2022,60,80,140,69
KWEEN,2023,60,80,140,69
KWEEN,2024,60,80,140,69
KWEEN,2025,60,80,140,69
KYANKWANZI,2015,180,150,330,69
KYANKWANZI,2016,190,160,350,69
KYANKWANZI,2017,200,160,360,69
KYANKWANZI,2018,210,170,380,69
KYANKWANZI,2019,220,180,400,69
KYANKWANZI,2020,230,190,420,69
KYANKWANZI,2021,240,190,430,69
KYANKWANZI,2022,250,200,450,69
KYANKWANZI,2023,260,210,470,69
KYANKWANZI,2024,280,220,500,69
KYANKWANZI,2025,290,230,520,69
KYEGEGWA,2015,230,240,470,69
KYEGEGWA,2016,250,250,500,69
KYEGEGWA,2017,270,270,540,69
KYEGEGWA,2018,290,300,590,69
KYEGEGWA,2019,310,320,630,69
KYEGEGWA,2020,340,340,680,69
KYEGEGWA,2021,370,370,740,69
KYEGEGWA,2022,400,400,800,69
KYEGEGWA,2023,430,430,860,69
KYEGEGWA,2024,460,460,920,69
KYEGEGWA,2025,490,490,980,69
KYENJOJO,2015,330,440,770,69
KYENJOJO,2016,350,460,810,69
KYENJOJO,2017,360,470,830,69
KYENJOJO,2018,380,490,870,69
KYENJOJO,2019,390,510,900,69
KYENJOJO,2020,410,530,940,69
KYENJOJO,2021,420,540,960,69
KYENJOJO,2022,440,560,1000,69
KYENJOJO,2023,460,580,1040,69
KYENJOJO,2024,470,600,1070,69
KYENJOJO,2025,490,620,1110,69
KYOTERA,2015,180,240,420,69
KYOTERA,2016,180,240,420,69
KYOTERA,2017,180,250,430,69
KYOTERA,2018,200,270,470,69
KYOTERA,2019,210,300,510,69
KYOTERA,2020,220,320,540,69
KYOTERA,2021,220,320,540,69
KYOTERA,2022,220,310,530,69
KYOTERA,2023,210,300,510,69
KYOTERA,2024,200,270,470,69
KYOTERA,2025,190,250,440,69
KARENGA,2015,50,50,100,69
KARENGA,2016,50,50,100,69
KARENGA,2017,60,50,110,69
KARENGA,2018,60,50,110,69
KARENGA,2019,60,50,110,69
KARENGA,2020,60,60,120,69
KARENGA,2021,60,60,120,69
KARENGA,2022,60,60,120,69
KARENGA,2023,60,60,120,69
KARENGA,2024,70,60,130,69
KARENGA,2025,70,60,130,69
LAMWO,2015,80,130,210,69
LAMWO,2016,80,120,200,69
LAMWO,2017,80,120,200,69
LAMWO,2018,80,130,210,69
LAMWO,2019,90,140,230,69
LAMWO,2020,90,170,260,69
LAMWO,2021,90,170,260,69
LAMWO,2022,90,160,250,69
LAMWO,2023,80,150,230,69
LAMWO,2024,80,140,220,69
LAMWO,2025,70,130,200,69
LIRA,2015,190,220,410,69
LIRA,2016,190,230,420,69
LIRA,2017,200,230,430,69
LIRA,2018,200,240,440,69
LIRA,2019,210,250,460,69
LIRA,2020,210,250,460,69
LIRA,2021,220,260,480,69
LIRA,2022,230,270,500,69
LIRA,2023,230,270,500,69
LIRA,2024,240,280,520,69
LIRA,2025,240,290,530,69
LUUKA,2015,170,240,410,69
LUUKA,2016,180,230,410,69
LUUKA,2017,180,250,430,69
LUUKA,2018,190,270,460,69
LUUKA,2019,210,290,500,69
LUUKA,2020,220,320,540,69
LUUKA,2021,220,320,540,69
LUUKA,2022,220,320,540,69
LUUKA,2023,210,300,510,69
LUUKA,2024,200,270,470,69
LUUKA,2025,200,260,460,69
LUWERO,2015,280,380,660,69
LUWERO,2016,280,370,650,69
LUWERO,2017,290,380,670,69
LUWERO,2018,310,420,730,69
LUWERO,2019,330,470,800,69
LUWERO,2020,360,510,870,69
LUWERO,2021,370,520,890,69
LUWERO,2022,360,510,870,69
LUWERO,2023,350,490,840,69
LUWERO,2024,340,450,790,69
LUWERO,2025,330,420,750,69
LWENGO,2015,230,270,500,69
LWENGO,2016,230,270,500,69
LWENGO,2017,240,280,520,69
LWENGO,2018,240,300,540,69
LWENGO,2019,260,330,590,69
LWENGO,2020,270,350,620,69
LWENGO,2021,280,370,650,69
LWENGO,2022,270,350,620,69
LWENGO,2023,260,330,590,69
LWENGO,2024,240,290,530,69
LWENGO,2025,230,270,500,69
LYANTONDE,2015,60,60,120,69
LYANTONDE,2016,60,50,110,69
LYANTONDE,2017,70,70,140,69
LYANTONDE,2018,70,70,140,69
LYANTONDE,2019,70,80,150,69
LYANTONDE,2020,80,80,160,69
LYANTONDE,2021,80,80,160,69
LYANTONDE,2022,70,80,150,69
LYANTONDE,2023,80,90,170,69
LYANTONDE,2024,80,80,160,69
LYANTONDE,2025,70,70,140,69
MANAFWA,2015,110,150,260,69
MANAFWA,2016,110,150,260,69
MANAFWA,2017,120,150,270,69
MANAFWA,2018,120,160,280,69
MANAFWA,2019,120,160,280,69
MANAFWA,2020,120,170,290,69
MANAFWA,2021,130,170,300,69
MANAFWA,2022,130,170,300,69
MANAFWA,2023,130,170,300,69
MANAFWA,2024,140,180,320,69
MANAFWA,2025,140,180,320,69
MARACHA,2015,120,160,280,69
MARACHA,2016,120,160,280,69
MARACHA,2017,130,160,290,69
MARACHA,2018,130,160,290,69
MARACHA,2019,130,170,300,69
MARACHA,2020,130,170,300,69
MARACHA,2021,140,170,310,69
MARACHA,2022,140,180,320,69
MARACHA,2023,140,180,320,69
MARACHA,2024,140,180,320,69
MARACHA,2025,140,180,320,69
MASAKA,2015,200,350,550,69
MASAKA,2016,190,310,500,69
MASAKA,2017,170,280,450,69
MASAKA,2018,180,280,460,69
MASAKA,2019,190,290,480,69
MASAKA,2020,200,320,520,69
MASAKA,2021,220,360,580,69
MASAKA,2022,230,380,610,69
MASAKA,2023,230,410,640,69
MASAKA,2024,240,390,630,69
MASAKA,2025,230,360,590,69
MASINDI,2015,210,150,360,69
MASINDI,2016,210,150,360,69
MASINDI,2017,220,160,380,69
MASINDI,2018,230,160,390,69
MASINDI,2019,230,170,400,69
MASINDI,2020,240,170,410,69
MASINDI,2021,250,170,420,69
MASINDI,2022,250,180,430,69
MASINDI,2023,260,180,440,69
MASINDI,2024,260,190,450,69
MASINDI,2025,270,190,460,69
MAYUGE,2015,310,280,590,69
MAYUGE,2016,310,280,590,69
MAYUGE,2017,330,300,630,69
MAYUGE,2018,350,340,690,69
MAYUGE,2019,380,380,760,69
MAYUGE,2020,410,400,810,69
MAYUGE,2021,420,420,840,69
MAYUGE,2022,420,420,840,69
MAYUGE,2023,410,400,810,69
MAYUGE,2024,400,370,770,69
MAYUGE,2025,390,360,750,69
MBALE,2015,360,420,780,69
MBALE,2016,370,410,780,69
MBALE,2017,380,450,830,69
MBALE,2018,410,500,910,69
MBALE,2019,440,550,990,69
MBALE,2020,470,600,1070,69
MBALE,2021,490,640,1130,69
MBALE,2022,480,620,1100,69
MBALE,2023,470,600,1070,69
MBALE,2024,450,550,1000,69
MBALE,2025,440,530,970,69
MBARARA,2015,160,260,420,69
MBARARA,2016,160,260,420,69
MBARARA,2017,170,270,440,69
MBARARA,2018,170,270,440,69
MBARARA,2019,180,280,460,69
MBARARA,2020,180,280,460,69
MBARARA,2021,180,290,470,69
MBARARA,2022,190,300,490,69
MBARARA,2023,190,300,490,69
MBARARA,2024,190,310,500,69
MBARARA,2025,200,310,510,69
MITOOMA,2015,150,170,320,69
MITOOMA,2016,160,170,330,69
MITOOMA,2017,160,170,330,69
MITOOMA,2018,160,170,330,69
MITOOMA,2019,160,180,340,69
MITOOMA,2020,160,180,340,69
MITOOMA,2021,170,180,350,69
MITOOMA,2022,170,180,350,69
MITOOMA,2023,170,180,350,69
MITOOMA,2024,170,180,350,69
MITOOMA,2025,170,180,350,69
MITYANA,2015,230,270,500,69
MITYANA,2016,230,270,500,69
MITYANA,2017,240,280,520,69
MITYANA,2018,240,300,540,69
MITYANA,2019,270,340,610,69
MITYANA,2020,280,360,640,69
MITYANA,2021,290,370,660,69
MITYANA,2022,280,360,640,69
MITYANA,2023,270,340,610,69
MITYANA,2024,260,310,570,69
MITYANA,2025,250,290,540,69
MOROTO,2015,190,260,450,69
MOROTO,2016,190,260,450,69
MOROTO,2017,190,270,460,69
MOROTO,2018,210,300,510,69
MOROTO,2019,220,340,560,69
MOROTO,2020,230,360,590,69
MOROTO,2021,240,380,620,69
MOROTO,2022,240,360,600,69
MOROTO,2023,240,350,590,69
MOROTO,2024,220,330,550,69
MOROTO,2025,210,310,520,69
MOYO,2015,70,90,160,69
MOYO,2016,70,100,170,69
MOYO,2017,80,100,180,69
MOYO,2018,80,100,180,69
MOYO,2019,80,100,180,69
MOYO,2020,80,100,180,69
MOYO,2021,80,110,190,69
MOYO,2022,80,110,190,69
MOYO,2023,90,110,200,69
MOYO,2024,90,110,200,69
MOYO,2025,90,110,200,69
MPIGI,2015,170,170,340,69
MPIGI,2016,170,160,330,69
MPIGI,2017,170,170,340,69
MPIGI,2018,190,190,380,69
MPIGI,2019,200,210,410,69
MPIGI,2020,200,220,420,69
MPIGI,2021,220,240,460,69
MPIGI,2022,210,230,440,69
MPIGI,2023,210,230,440,69
MPIGI,2024,200,200,400,69
MPIGI,2025,190,190,380,69
MUBENDE,2015,230,190,420,69
MUBENDE,2016,230,200,430,69
MUBENDE,2017,250,210,460,69
MUBENDE,2018,270,240,510,69
MUBENDE,2019,310,280,590,69
MUBENDE,2020,330,310,640,69
MUBENDE,2021,340,320,660,69
MUBENDE,2022,360,320,680,69
MUBENDE,2023,350,310,660,69
MUBENDE,2024,350,310,660,69
MUBENDE,2025,350,290,640,69
MUKONO,2015,360,360,720,69
MUKONO,2016,370,360,730,69
MUKONO,2017,380,380,760,69
MUKONO,2018,410,420,830,69
MUKONO,2019,440,470,910,69
MUKONO,2020,470,510,980,69
MUKONO,2021,490,540,1030,69
MUKONO,2022,480,530,1010,69
MUKONO,2023,470,500,970,69
MUKONO,2024,450,460,910,69
MUKONO,2025,440,440,880,69
MADI OKOLLO,2015,90,90,180,69
MADI OKOLLO,2016,90,90,180,69
MADI OKOLLO,2017,90,100,190,69
MADI OKOLLO,2018,100,100,200,69
MADI OKOLLO,2019,100,100,200,69
MADI OKOLLO,2020,100,100,200,69
MADI OKOLLO,2021,100,110,210,69
MADI OKOLLO,2022,110,110,220,69
MADI OKOLLO,2023,110,110,220,69
MADI OKOLLO,2024,110,120,230,69
MADI OKOLLO,2025,120,120,240,69
NABILATUK,2015,160,350,510,69
NABILATUK,2016,160,360,520,69
NABILATUK,2017,170,380,550,69
NABILATUK,2018,190,440,630,69
NABILATUK,2019,210,490,700,69
NABILATUK,2020,230,540,770,69
NABILATUK,2021,240,560,800,69
NABILATUK,2022,250,570,820,69
NABILATUK,2023,240,550,790,69
NABILATUK,2024,230,520,750,69
NABILATUK,2025,230,510,740,69
NAKAPIRIPIRIT,2015,220,420,640,69
NAKAPIRIPIRIT,2016,220,420,640,69
NAKAPIRIPIRIT,2017,240,460,700,69
NAKAPIRIPIRIT,2018,260,510,770,69
NAKAPIRIPIRIT,2019,280,580,860,69
NAKAPIRIPIRIT,2020,310,640,950,69
NAKAPIRIPIRIT,2021,320,680,1000,69
NAKAPIRIPIRIT,2022,320,680,1000,69
NAKAPIRIPIRIT,2023,320,650,970,69
NAKAPIRIPIRIT,2024,310,610,920,69
NAKAPIRIPIRIT,2025,320,590,910,69
NAKASEKE,2015,90,100,190,69
NAKASEKE,2016,100,100,200,69
NAKASEKE,2017,100,100,200,69
NAKASEKE,2018,100,110,210,69
NAKASEKE,2019,110,110,220,69
NAKASEKE,2020,110,110,220,69
NAKASEKE,2021,120,110,230,69
NAKASEKE,2022,120,120,240,69
NAKASEKE,2023,120,120,240,69
NAKASEKE,2024,130,120,250,69
NAKASEKE,2025,130,120,250,69
NAKASONGOLA,2015,80,110,190,69
NAKASONGOLA,2016,80,110,190,69
NAKASONGOLA,2017,90,120,210,69
NAKASONGOLA,2018,90,130,220,69
NAKASONGOLA,2019,100,140,240,69
NAKASONGOLA,2020,100,150,250,69
NAKASONGOLA,2021,110,170,280,69
NAKASONGOLA,2022,110,160,270,69
NAKASONGOLA,2023,110,150,260,69
NAKASONGOLA,2024,100,150,250,69
NAKASONGOLA,2025,110,140,250,69
NAMAYINGO,2015,100,140,240,69
NAMAYINGO,2016,100,130,230,69
NAMAYINGO,2017,100,130,230,69
NAMAYINGO,2018,120,150,270,69
NAMAYINGO,2019,120,160,280,69
NAMAYINGO,2020,130,170,300,69
NAMAYINGO,2021,130,180,310,69
NAMAYINGO,2022,120,180,300,69
NAMAYINGO,2023,120,160,280,69
NAMAYINGO,2024,120,150,270,69
NAMAYINGO,2025,120,140,260,69
NAMISINDWA,2015,140,160,300,69
NAMISINDWA,2016,140,170,310,69
NAMISINDWA,2017,140,170,310,69
NAMISINDWA,2018,150,180,330,69
NAMISINDWA,2019,150,180,330,69
NAMISINDWA,2020,160,180,340,69
NAMISINDWA,2021,160,190,350,69
NAMISINDWA,2022,160,190,350,69
NAMISINDWA,2023,170,200,370,69
NAMISINDWA,2024,170,200,370,69
NAMISINDWA,2025,180,200,380,69
NAMUTUMBA,2015,230,190,420,69
NAMUTUMBA,2016,230,200,430,69
NAMUTUMBA,2017,250,200,450,69
NAMUTUMBA,2018,270,230,500,69
NAMUTUMBA,2019,280,260,540,69
NAMUTUMBA,2020,310,280,590,69
NAMUTUMBA,2021,320,300,620,69
NAMUTUMBA,2022,320,280,600,69
NAMUTUMBA,2023,320,280,600,69
NAMUTUMBA,2024,310,260,570,69
NAMUTUMBA,2025,310,240,550,69
NAPAK,2015,420,910,1330,69
NAPAK,2016,410,890,1300,69
NAPAK,2017,430,940,1370,69
NAPAK,2018,450,1030,1480,69
NAPAK,2019,480,1140,1620,69
NAPAK,2020,510,1240,1750,69
NAPAK,2021,510,1270,1780,69
NAPAK,2022,510,1240,1750,69
NAPAK,2023,490,1180,1670,69
NAPAK,2024,460,1080,1540,69
NAPAK,2025,460,1020,1480,69
NEBBI,2015,180,340,520,69
NEBBI,2016,190,350,540,69
NEBBI,2017,200,360,560,69
NEBBI,2018,200,370,570,69
NEBBI,2019,210,380,590,69
NEBBI,2020,220,390,610,69
NEBBI,2021,220,400,620,69
NEBBI,2022,230,410,640,69
NEBBI,2023,230,420,650,69
NEBBI,2024,240,430,670,69
NEBBI,2025,250,440,690,69
NGORA,2015,110,140,250,69
NGORA,2016,110,130,240,69
NGORA,2017,120,150,270,69
NGORA,2018,130,160,290,69
NGORA,2019,140,170,310,69
NGORA,2020,150,190,340,69
NGORA,2021,150,200,350,69
NGORA,2022,150,190,340,69
NGORA,2023,150,190,340,69
NGORA,2024,140,170,310,69
NGORA,2025,140,160,300,69
NTOROKO,2015,30,30,60,69
NTOROKO,2016,30,30,60,69
NTOROKO,2017,30,30,60,69
NTOROKO,2018,50,40,90,69
NTOROKO,2019,50,40,90,69
NTOROKO,2020,50,40,90,69
NTOROKO,2021,50,40,90,69
NTOROKO,2022,50,40,90,69
NTOROKO,2023,50,40,90,69
NTOROKO,2024,40,30,70,69
NTOROKO,2025,40,30,70,69
NTUNGAMO,2015,300,440,740,69
NTUNGAMO,2016,310,450,760,69
NTUNGAMO,2017,310,460,770,69
NTUNGAMO,2018,320,460,780,69
NTUNGAMO,2019,330,470,800,69
NTUNGAMO,2020,330,480,810,69
NTUNGAMO,2021,340,490,830,69
NTUNGAMO,2022,350,500,850,69
NTUNGAMO,2023,350,500,850,69
NTUNGAMO,2024,360,510,870,69
NTUNGAMO,2025,360,520,880,69
NWOYA,2015,60,80,140,69
NWOYA,2016,60,90,150,69
NWOYA,2017,70,90,160,69
NWOYA,2018,80,100,180,69
NWOYA,2019,80,110,190,69
NWOYA,2020,90,130,220,69
NWOYA,2021,100,140,240,69
NWOYA,2022,110,150,260,69
NWOYA,2023,120,170,290,69
NWOYA,2024,140,180,320,69
NWOYA,2025,150,200,350,69
OBONGI,2015,20,20,40,69
OBONGI,2016,20,20,40,69
OBONGI,2017,20,20,40,69
OBONGI,2018,20,20,40,69
OBONGI,2019,20,30,50,69
OBONGI,2020,30,30,60,69
OBONGI,2021,30,30,60,69
OBONGI,2022,20,30,50,69
OBONGI,2023,20,30,50,69
OBONGI,2024,20,20,40,69
OBONGI,2025,20,20,40,69
OMORO,2015,100,110,210,69
OMORO,2016,110,120,230,69
OMORO,2017,110,120,230,69
OMORO,2018,130,130,260,69
OMORO,2019,140,160,300,69
OMORO,2020,140,170,310,69
OMORO,2021,150,170,320,69
OMORO,2022,150,180,330,69
OMORO,2023,150,160,310,69
OMORO,2024,140,160,300,69
OMORO,2025,140,150,290,69
OTUKE,2015,70,80,150,69
OTUKE,2016,80,80,160,69
OTUKE,2017,80,90,170,69
OTUKE,2018,80,90,170,69
OTUKE,2019,90,90,180,69
OTUKE,2020,90,100,190,69
OTUKE,2021,90,100,190,69
OTUKE,2022,100,110,210,69
OTUKE,2023,100,110,210,69
OTUKE,2024,110,110,220,69
OTUKE,2025,110,120,230,69
OYAM,2015,250,310,560,69
OYAM,2016,260,320,580,69
OYAM,2017,260,330,590,69
OYAM,2018,270,340,610,69
OYAM,2019,280,350,630,69
OYAM,2020,290,360,650,69
OYAM,2021,300,370,670,69
OYAM,2022,300,380,680,69
OYAM,2023,310,390,700,69
OYAM,2024,320,400,720,69
OYAM,2025,330,410,740,69
PADER,2015,80,110,190,69
PADER,2016,80,110,190,69
PADER,2017,80,110,190,69
PADER,2018,80,120,200,69
PADER,2019,100,140,240,69
PADER,2020,100,150,250,69
PADER,2021,100,160,260,69
PADER,2022,100,150,250,69
PADER,2023,90,140,230,69
PADER,2024,90,120,210,69
PADER,2025,80,130,210,69
PAKWACH,2015,140,210,350,69
PAKWACH,2016,140,210,350,69
PAKWACH,2017,150,220,370,69
PAKWACH,2018,150,230,380,69
PAKWACH,2019,160,240,400,69
PAKWACH,2020,170,250,420,69
PAKWACH,2021,170,250,420,69
PAKWACH,2022,180,260,440,69
PAKWACH,2023,190,270,460,69
PAKWACH,2024,190,280,470,69
PAKWACH,2025,200,290,490,69
PALLISA,2015,230,270,500,69
PALLISA,2016,230,270,500,69
PALLISA,2017,250,290,540,69
PALLISA,2018,270,330,600,69
PALLISA,2019,300,370,670,69
PALLISA,2020,320,400,720,69
PALLISA,2021,330,440,770,69
PALLISA,2022,330,430,760,69
PALLISA,2023,330,410,740,69
PALLISA,2024,320,390,710,69
PALLISA,2025,320,380,700,69
RAKAI,2015,170,170,340,69
RAKAI,2016,170,160,330,69
RAKAI,2017,180,170,350,69
RAKAI,2018,190,190,380,69
RAKAI,2019,200,210,410,69
RAKAI,2020,220,220,440,69
RAKAI,2021,220,240,460,69
RAKAI,2022,220,230,450,69
RAKAI,2023,210,210,420,69
RAKAI,2024,200,200,400,69
RAKAI,2025,200,190,390,69
RUBANDA,2015,130,180,310,69
RUBANDA,2016,140,190,330,69
RUBANDA,2017,140,190,330,69
RUBANDA,2018,140,190,330,69
RUBANDA,2019,140,190,330,69
RUBANDA,2020,140,190,330,69
RUBANDA,2021,140,190,330,69
RUBANDA,2022,150,190,340,69
RUBANDA,2023,150,190,340,69
RUBANDA,2024,150,190,340,69
RUBANDA,2025,150,200,350,69
RUBIRIZI,2015,80,100,180,69
RUBIRIZI,2016,80,100,180,69
RUBIRIZI,2017,80,100,180,69
RUBIRIZI,2018,80,100,180,69
RUBIRIZI,2019,80,100,180,69
RUBIRIZI,2020,80,110,190,69
RUBIRIZI,2021,80,110,190,69
RUBIRIZI,2022,90,110,200,69
RUBIRIZI,2023,90,110,200,69
RUBIRIZI,2024,90,110,200,69
RUBIRIZI,2025,90,120,210,69
RUKIGA,2015,100,110,210,69
RUKIGA,2016,100,110,210,69
RUKIGA,2017,100,110,210,69
RUKIGA,2018,100,110,210,69
RUKIGA,2019,100,110,210,69
RUKIGA,2020,110,110,220,69
RUKIGA,2021,110,110,220,69
RUKIGA,2022,110,120,230,69
RUKIGA,2023,110,120,230,69
RUKIGA,2024,110,120,230,69
RUKIGA,2025,110,120,230,69
RUKUNGIRI,2015,250,340,590,69
RUKUNGIRI,2016,250,350,600,69
RUKUNGIRI,2017,260,350,610,69
RUKUNGIRI,2018,260,350,610,69
RUKUNGIRI,2019,260,360,620,69
RUKUNGIRI,2020,270,360,630,69
RUKUNGIRI,2021,270,360,630,69
RUKUNGIRI,2022,270,370,640,69
RUKUNGIRI,2023,270,370,640,69
RUKUNGIRI,2024,280,370,650,69
RUKUNGIRI,2025,280,370,650,69
RWAMPARA,2015,90,100,190,69
RWAMPARA,2016,90,100,190,69
RWAMPARA,2017,90,100,190,69
RWAMPARA,2018,90,100,190,69
RWAMPARA,2019,100,100,200,69
RWAMPARA,2020,100,110,210,69
RWAMPARA,2021,100,110,210,69
RWAMPARA,2022,100,110,210,69
RWAMPARA,2023,100,110,210,69
RWAMPARA,2024,110,120,230,69
RWAMPARA,2025,110,120,230,69
SERERE,2015,220,250,470,69
SERERE,2016,220,250,470,69
SERERE,2017,240,270,510,69
SERERE,2018,260,300,560,69
SERERE,2019,280,340,620,69
SERERE,2020,290,380,670,69
SERERE,2021,310,400,710,69
SERERE,2022,310,390,700,69
SERERE,2023,310,380,690,69
SERERE,2024,300,350,650,69
SERERE,2025,300,340,640,69
SHEEMA,2015,170,240,410,69
SHEEMA,2016,170,240,410,69
SHEEMA,2017,170,240,410,69
SHEEMA,2018,170,240,410,69
SHEEMA,2019,180,250,430,69
SHEEMA,2020,180,250,430,69
SHEEMA,2021,180,250,430,69
SHEEMA,2022,180,250,430,69
SHEEMA,2023,180,250,430,69
SHEEMA,2024,190,260,450,69
SHEEMA,2025,190,260,450,69
SIRONKO,2015,230,270,500,69
SIRONKO,2016,230,270,500,69
SIRONKO,2017,240,280,520,69
SIRONKO,2018,240,280,520,69
SIRONKO,2019,250,290,540,69
SIRONKO,2020,260,290,550,69
SIRONKO,2021,260,300,560,69
SIRONKO,2022,270,310,580,69
SIRONKO,2023,270,310,580,69
SIRONKO,2024,280,320,600,69
SIRONKO,2025,280,320,600,69
SOROTI,2015,190,220,410,69
SOROTI,2016,200,210,410,69
SOROTI,2017,200,220,420,69
SOROTI,2018,220,250,470,69
SOROTI,2019,250,290,540,69
SOROTI,2020,260,310,570,69
SOROTI,2021,270,320,590,69
SOROTI,2022,270,320,590,69
SOROTI,2023,270,300,570,69
SOROTI,2024,250,280,530,69
SOROTI,2025,250,270,520,69
SSEMBABULE,2015,200,190,390,69
SSEMBABULE,2016,210,200,410,69
SSEMBABULE,2017,210,200,410,69
SSEMBABULE,2018,230,230,460,69
SSEMBABULE,2019,250,250,500,69
SSEMBABULE,2020,270,260,530,69
SSEMBABULE,2021,280,280,560,69
SSEMBABULE,2022,270,270,540,69
SSEMBABULE,2023,270,260,530,69
SSEMBABULE,2024,250,240,490,69
SSEMBABULE,2025,250,230,480,69
TORORO,2015,360,520,880,69
TORORO,2016,370,530,900,69
TORORO,2017,380,550,930,69
TORORO,2018,390,560,950,69
TORORO,2019,400,570,970,69
TORORO,2020,410,590,1000,69
TORORO,2021,420,600,1020,69
TORORO,2022,430,610,1040,69
TORORO,2023,440,630,1070,69
TORORO,2024,450,640,1090,69
TORORO,2025,460,650,1110,69
WAKISO,2015,620,760,1380,69
WAKISO,2016,660,810,1470,69
WAKISO,2017,710,870,1580,69
WAKISO,2018,750,930,1680,69
WAKISO,2019,800,990,1790,69
WAKISO,2020,860,1060,1920,69
WAKISO,2021,910,1130,2040,69
WAKISO,2022,970,1200,2170,69
WAKISO,2023,1030,1280,2310,69
WAKISO,2024,1100,1360,2460,69
WAKISO,2025,1160,1450,2610,69
YUMBE,2015,380,320,700,69
YUMBE,2016,390,330,720,69
YUMBE,2017,420,350,770,69
YUMBE,2018,450,400,850,69
YUMBE,2019,500,460,960,69
YUMBE,2020,550,510,1060,69
YUMBE,2021,570,550,1120,69
YUMBE,2022,580,570,1150,69
YUMBE,2023,590,550,1140,69
YUMBE,2024,570,520,1090,69
YUMBE,2025,570,520,1090,69
ZOMBO,2015,230,390,620,69
ZOMBO,2016,230,400,630,69
ZOMBO,2017,240,410,650,69
ZOMBO,2018,250,420,670,69
ZOMBO,2019,260,440,700,69
ZOMBO,2020,260,450,710,69
ZOMBO,2021,270,460,730,69
ZOMBO,2022,280,470,750,69
ZOMBO,2023,290,480,770,69
ZOMBO,2024,290,490,780,69
ZOMBO,2025,300,500,800,69
ABIM,2015,1930,1860,3790,7
ABIM,2016,2040,1950,3990,7
ABIM,2017,2120,2000,4120,7
ABIM,2018,2200,2080,4280,7
ABIM,2019,2290,2150,4440,7
ABIM,2020,2420,2270,4690,7
ABIM,2021,2640,2440,5080,7
ABIM,2022,2750,2670,5420,7
ABIM,2023,2890,2800,5690,7
ABIM,2024,3040,2950,5990,7
ABIM,2025,3190,3090,6280,7
ADJUMANI,2015,4080,3860,7940,7
ADJUMANI,2016,4110,3900,8010,7
ADJUMANI,2017,4140,3940,8080,7
ADJUMANI,2018,4170,3980,8150,7
ADJUMANI,2019,4200,4010,8210,7
ADJUMANI,2020,4220,4050,8270,7
ADJUMANI,2021,4240,4070,8310,7
ADJUMANI,2022,4260,4100,8360,7
ADJUMANI,2023,4270,4130,8400,7
ADJUMANI,2024,4290,4160,8450,7
ADJUMANI,2025,4300,4180,8480,7
AGAGO,2015,4270,4190,8460,7
AGAGO,2016,4350,4270,8620,7
AGAGO,2017,4420,4340,8760,7
AGAGO,2018,4500,4420,8920,7
AGAGO,2019,4570,4490,9060,7
AGAGO,2020,4650,4560,9210,7
AGAGO,2021,4720,4630,9350,7
AGAGO,2022,4790,4700,9490,7
AGAGO,2023,4860,4770,9630,7
AGAGO,2024,4920,4830,9750,7
AGAGO,2025,4980,4900,9880,7
ALEBTONG,2015,3950,3790,7740,7
ALEBTONG,2016,4020,3840,7860,7
ALEBTONG,2017,4050,3810,7860,7
ALEBTONG,2018,4060,3830,7890,7
ALEBTONG,2019,4100,3850,7950,7
ALEBTONG,2020,4180,3920,8100,7
ALEBTONG,2021,4390,4090,8480,7
ALEBTONG,2022,4420,4330,8750,7
ALEBTONG,2023,4490,4400,8890,7
ALEBTONG,2024,4560,4470,9030,7
ALEBTONG,2025,4630,4530,9160,7
AMOLATAR,2015,2600,2570,5170,7
AMOLATAR,2016,2640,2600,5240,7
AMOLATAR,2017,2660,2580,5240,7
AMOLATAR,2018,2660,2570,5230,7
AMOLATAR,2019,2680,2590,5270,7
AMOLATAR,2020,2730,2640,5370,7
AMOLATAR,2021,2860,2730,5590,7
AMOLATAR,2022,2870,2890,5760,7
AMOLATAR,2023,2920,2930,5850,7
AMOLATAR,2024,2950,2970,5920,7
AMOLATAR,2025,2990,3000,5990,7
AMUDAT,2015,1720,1690,3410,7
AMUDAT,2016,1770,1750,3520,7
AMUDAT,2017,1800,1770,3570,7
AMUDAT,2018,1830,1810,3640,7
AMUDAT,2019,1860,1860,3720,7
AMUDAT,2020,1920,1920,3840,7
AMUDAT,2021,2040,2040,4080,7
AMUDAT,2022,2070,2210,4280,7
AMUDAT,2023,2130,2290,4420,7
AMUDAT,2024,2190,2360,4550,7
AMUDAT,2025,2250,2450,4700,7
AMURIA,2015,3480,3480,6960,7
AMURIA,2016,3570,3550,7120,7
AMURIA,2017,3620,3560,7180,7
AMURIA,2018,3670,3600,7270,7
AMURIA,2019,3730,3650,7380,7
AMURIA,2020,3850,3740,7590,7
AMURIA,2021,4080,3930,8010,7
AMURIA,2022,4140,4200,8340,7
AMURIA,2023,4250,4300,8550,7
AMURIA,2024,4350,4400,8750,7
AMURIA,2025,4460,4500,8960,7
AMURU,2015,3490,3370,6860,7
AMURU,2016,3550,3420,6970,7
AMURU,2017,3570,3390,6960,7
AMURU,2018,3570,3400,6970,7
AMURU,2019,3590,3420,7010,7
AMURU,2020,3660,3480,7140,7
AMURU,2021,3830,3620,7450,7
AMURU,2022,3850,3850,7700,7
AMURU,2023,3910,3900,7810,7
AMURU,2024,3960,3960,7920,7
AMURU,2025,4010,4010,8020,7
APAC,2015,3260,3160,6420,7
APAC,2016,3380,3270,6650,7
APAC,2017,3500,3390,6890,7
APAC,2018,3630,3500,7130,7
APAC,2019,3760,3620,7380,7
APAC,2020,3900,3740,7640,7
APAC,2021,4030,3860,7890,7
APAC,2022,4170,3990,8160,7
APAC,2023,4300,4110,8410,7
APAC,2024,4440,4240,8680,7
APAC,2025,4580,4360,8940,7
ARUA,2015,11070,10490,21560,7
ARUA,2016,11400,10770,22170,7
ARUA,2017,11720,11080,22800,7
ARUA,2018,12060,11370,23430,7
ARUA,2019,12400,11670,24070,7
ARUA,2020,12730,11970,24700,7
ARUA,2021,13080,12260,25340,7
ARUA,2022,13410,12560,25970,7
ARUA,2023,13750,12870,26620,7
ARUA,2024,14090,13170,27260,7
ARUA,2025,14420,13460,27880,7
BUDAKA,2015,3720,3470,7190,7
BUDAKA,2016,3820,3540,7360,7
BUDAKA,2017,3870,3540,7410,7
BUDAKA,2018,3920,3580,7500,7
BUDAKA,2019,3970,3620,7590,7
BUDAKA,2020,4090,3710,7800,7
BUDAKA,2021,4320,3890,8210,7
BUDAKA,2022,4390,4170,8560,7
BUDAKA,2023,4490,4260,8750,7
BUDAKA,2024,4600,4350,8950,7
BUDAKA,2025,4700,4450,9150,7
BUDUDA,2015,3580,3340,6920,7
BUDUDA,2016,3710,3450,7160,7
BUDUDA,2017,3800,3480,7280,7
BUDUDA,2018,3880,3550,7430,7
BUDUDA,2019,3970,3640,7610,7
BUDUDA,2020,4120,3770,7890,7
BUDUDA,2021,4390,3990,8380,7
BUDUDA,2022,4500,4310,8810,7
BUDUDA,2023,4640,4460,9100,7
BUDUDA,2024,4800,4600,9400,7
BUDUDA,2025,4950,4750,9700,7
BUGIRI,2015,7170,6850,14020,7
BUGIRI,2016,7390,7020,14410,7
BUGIRI,2017,7530,7050,14580,7
BUGIRI,2018,7650,7150,14800,7
BUGIRI,2019,7800,7290,15090,7
BUGIRI,2020,8070,7510,15580,7
BUGIRI,2021,8580,7910,16490,7
BUGIRI,2022,8760,8490,17250,7
BUGIRI,2023,9000,8730,17730,7
BUGIRI,2024,9260,8970,18230,7
BUGIRI,2025,9520,9210,18730,7
BUGWERI,2015,2950,2740,5690,7
BUGWERI,2016,3000,2770,5770,7
BUGWERI,2017,3020,2750,5770,7
BUGWERI,2018,3030,2760,5790,7
BUGWERI,2019,3050,2770,5820,7
BUGWERI,2020,3110,2810,5920,7
BUGWERI,2021,3270,2930,6200,7
BUGWERI,2022,3290,3110,6400,7
BUGWERI,2023,3330,3150,6480,7
BUGWERI,2024,3380,3190,6570,7
BUGWERI,2025,3430,3250,6680,7
BUHWEJU,2015,2150,2160,4310,7
BUHWEJU,2016,2220,2230,4450,7
BUHWEJU,2017,2290,2290,4580,7
BUHWEJU,2018,2360,2360,4720,7
BUHWEJU,2019,2440,2430,4870,7
BUHWEJU,2020,2520,2500,5020,7
BUHWEJU,2021,2590,2570,5160,7
BUHWEJU,2022,2670,2650,5320,7
BUHWEJU,2023,2750,2720,5470,7
BUHWEJU,2024,2820,2790,5610,7
BUHWEJU,2025,2900,2860,5760,7
BUIKWE,2015,7200,6700,13900,7
BUIKWE,2016,7280,6740,14020,7
BUIKWE,2017,7280,6660,13940,7
BUIKWE,2018,7240,6640,13880,7
BUIKWE,2019,7230,6630,13860,7
BUIKWE,2020,7330,6710,14040,7
BUIKWE,2021,7630,6950,14580,7
BUIKWE,2022,7630,7320,14950,7
BUIKWE,2023,7690,7390,15080,7
BUIKWE,2024,7750,7450,15200,7
BUIKWE,2025,7800,7510,15310,7
BUKEDEA,2015,3710,3670,7380,7
BUKEDEA,2016,3840,3770,7610,7
BUKEDEA,2017,3930,3800,7730,7
BUKEDEA,2018,4000,3870,7870,7
BUKEDEA,2019,4090,3950,8040,7
BUKEDEA,2020,4240,4070,8310,7
BUKEDEA,2021,4520,4300,8820,7
BUKEDEA,2022,4630,4620,9250,7
BUKEDEA,2023,4780,4760,9540,7
BUKEDEA,2024,4930,4900,9830,7
BUKEDEA,2025,5090,5040,10130,7
BUKOMANSIMBI,2015,2620,2340,4960,7
BUKOMANSIMBI,2016,2610,2310,4920,7
BUKOMANSIMBI,2017,2580,2250,4830,7
BUKOMANSIMBI,2018,2540,2210,4750,7
BUKOMANSIMBI,2019,2500,2170,4670,7
BUKOMANSIMBI,2020,2510,2160,4670,7
BUKOMANSIMBI,2021,2580,2200,4780,7
BUKOMANSIMBI,2022,2550,2280,4830,7
BUKOMANSIMBI,2023,2540,2280,4820,7
BUKOMANSIMBI,2024,2530,2260,4790,7
BUKOMANSIMBI,2025,2510,2240,4750,7
BUKWO,2015,1710,1520,3230,7
BUKWO,2016,1800,1590,3390,7
BUKWO,2017,1890,1670,3560,7
BUKWO,2018,2000,1750,3750,7
BUKWO,2019,2100,1840,3940,7
BUKWO,2020,2210,1920,4130,7
BUKWO,2021,2320,2010,4330,7
BUKWO,2022,2440,2110,4550,7
BUKWO,2023,2560,2200,4760,7
BUKWO,2024,2680,2300,4980,7
BUKWO,2025,2810,2400,5210,7
BULAMBULI,2015,3030,3010,6040,7
BULAMBULI,2016,3160,3110,6270,7
BULAMBULI,2017,3240,3160,6400,7
BULAMBULI,2018,3320,3240,6560,7
BULAMBULI,2019,3410,3330,6740,7
BULAMBULI,2020,3560,3460,7020,7
BULAMBULI,2021,3810,3680,7490,7
BULAMBULI,2022,3920,4000,7920,7
BULAMBULI,2023,4070,4150,8220,7
BULAMBULI,2024,4210,4310,8520,7
BULAMBULI,2025,4370,4460,8830,7
BULIISA,2015,1930,1720,3650,7
BULIISA,2016,2040,1800,3840,7
BULIISA,2017,2150,1880,4030,7
BULIISA,2018,2270,1960,4230,7
BULIISA,2019,2380,2040,4420,7
BULIISA,2020,2510,2130,4640,7
BULIISA,2021,2640,2220,4860,7
BULIISA,2022,2770,2310,5080,7
BULIISA,2023,2920,2410,5330,7
BULIISA,2024,3060,2510,5570,7
BULIISA,2025,3210,2610,5820,7
BUNDIBUGYO,2015,3800,3690,7490,7
BUNDIBUGYO,2016,3880,3750,7630,7
BUNDIBUGYO,2017,3920,3720,7640,7
BUNDIBUGYO,2018,3930,3730,7660,7
BUNDIBUGYO,2019,3970,3760,7730,7
BUNDIBUGYO,2020,4050,3820,7870,7
BUNDIBUGYO,2021,4260,3990,8250,7
BUNDIBUGYO,2022,4310,4240,8550,7
BUNDIBUGYO,2023,4380,4300,8680,7
BUNDIBUGYO,2024,4460,4370,8830,7
BUNDIBUGYO,2025,4530,4430,8960,7
BUNYANGABU,2015,3040,2730,5770,7
BUNYANGABU,2016,3100,2750,5850,7
BUNYANGABU,2017,3110,2720,5830,7
BUNYANGABU,2018,3120,2720,5840,7
BUNYANGABU,2019,3120,2720,5840,7
BUNYANGABU,2020,3180,2760,5940,7
BUNYANGABU,2021,3330,2860,6190,7
BUNYANGABU,2022,3340,3030,6370,7
BUNYANGABU,2023,3390,3070,6460,7
BUNYANGABU,2024,3440,3100,6540,7
BUNYANGABU,2025,3480,3120,6600,7
BUSHENYI,2015,3500,3190,6690,7
BUSHENYI,2016,3540,3220,6760,7
BUSHENYI,2017,3590,3250,6840,7
BUSHENYI,2018,3630,3280,6910,7
BUSHENYI,2019,3670,3310,6980,7
BUSHENYI,2020,3710,3330,7040,7
BUSHENYI,2021,3750,3360,7110,7
BUSHENYI,2022,3780,3380,7160,7
BUSHENYI,2023,3820,3400,7220,7
BUSHENYI,2024,3850,3410,7260,7
BUSHENYI,2025,3870,3430,7300,7
BUSIA,2015,5640,5430,11070,7
BUSIA,2016,5770,5510,11280,7
BUSIA,2017,5830,5480,11310,7
BUSIA,2018,5870,5510,11380,7
BUSIA,2019,5930,5560,11490,7
BUSIA,2020,6070,5670,11740,7
BUSIA,2021,6390,5910,12300,7
BUSIA,2022,6460,6290,12750,7
BUSIA,2023,6590,6410,13000,7
BUSIA,2024,6710,6510,13220,7
BUSIA,2025,6830,6620,13450,7
BUTALEJA,2015,4420,4310,8730,7
BUTALEJA,2016,4550,4400,8950,7
BUTALEJA,2017,4620,4410,9030,7
BUTALEJA,2018,4680,4460,9140,7
BUTALEJA,2019,4750,4530,9280,7
BUTALEJA,2020,4890,4650,9540,7
BUTALEJA,2021,5190,4880,10070,7
BUTALEJA,2022,5280,5220,10500,7
BUTALEJA,2023,5410,5350,10760,7
BUTALEJA,2024,5550,5480,11030,7
BUTALEJA,2025,5680,5610,11290,7
BUTAMBALA,2015,1870,1630,3500,7
BUTAMBALA,2016,1880,1630,3510,7
BUTAMBALA,2017,1870,1600,3470,7
BUTAMBALA,2018,1850,1570,3420,7
BUTAMBALA,2019,1830,1560,3390,7
BUTAMBALA,2020,1850,1560,3410,7
BUTAMBALA,2021,1920,1600,3520,7
BUTAMBALA,2022,1900,1670,3570,7
BUTAMBALA,2023,1900,1660,3560,7
BUTAMBALA,2024,1900,1660,3560,7
BUTAMBALA,2025,1900,1660,3560,7
BUTEBO,2015,2000,1940,3940,7
BUTEBO,2016,2010,1930,3940,7
BUTEBO,2017,2000,1900,3900,7
BUTEBO,2018,1980,1870,3850,7
BUTEBO,2019,1970,1860,3830,7
BUTEBO,2020,1990,1870,3860,7
BUTEBO,2021,2060,1920,3980,7
BUTEBO,2022,2050,2020,4070,7
BUTEBO,2023,2060,2020,4080,7
BUTEBO,2024,2060,2030,4090,7
BUTEBO,2025,2070,2020,4090,7
BUVUMA,2015,1380,1300,2680,7
BUVUMA,2016,1470,1390,2860,7
BUVUMA,2017,1560,1480,3040,7
BUVUMA,2018,1660,1580,3240,7
BUVUMA,2019,1760,1690,3450,7
BUVUMA,2020,1860,1800,3660,7
BUVUMA,2021,1970,1920,3890,7
BUVUMA,2022,2090,2040,4130,7
BUVUMA,2023,2210,2170,4380,7
BUVUMA,2024,2340,2310,4650,7
BUVUMA,2025,2470,2450,4920,7
BUYENDE,2015,6130,5810,11940,7
BUYENDE,2016,6340,5980,12320,7
BUYENDE,2017,6490,6030,12520,7
BUYENDE,2018,6620,6150,12770,7
BUYENDE,2019,6780,6280,13060,7
BUYENDE,2020,7030,6500,13530,7
BUYENDE,2021,7490,6880,14370,7
BUYENDE,2022,7680,7420,15100,7
BUYENDE,2023,7920,7660,15580,7
BUYENDE,2024,8180,7900,16080,7
BUYENDE,2025,8440,8140,16580,7
DOKOLO,2015,3220,3130,6350,7
DOKOLO,2016,3320,3210,6530,7
DOKOLO,2017,3420,3300,6720,7
DOKOLO,2018,3520,3390,6910,7
DOKOLO,2019,3630,3480,7110,7
DOKOLO,2020,3730,3570,7300,7
DOKOLO,2021,3840,3670,7510,7
DOKOLO,2022,3940,3750,7690,7
DOKOLO,2023,4050,3850,7900,7
DOKOLO,2024,4150,3940,8090,7
DOKOLO,2025,4260,4030,8290,7
GOMBA,2015,2780,2600,5380,7
GOMBA,2016,2810,2600,5410,7
GOMBA,2017,2790,2540,5330,7
GOMBA,2018,2770,2510,5280,7
GOMBA,2019,2760,2490,5250,7
GOMBA,2020,2790,2500,5290,7
GOMBA,2021,2900,2570,5470,7
GOMBA,2022,2890,2680,5570,7
GOMBA,2023,2900,2690,5590,7
GOMBA,2024,2920,2690,5610,7
GOMBA,2025,2930,2690,5620,7
GULU,2015,4300,4180,8480,7
GULU,2016,4440,4310,8750,7
GULU,2017,4570,4430,9000,7
GULU,2018,4700,4560,9260,7
GULU,2019,4840,4690,9530,7
GULU,2020,4980,4820,9800,7
GULU,2021,5120,4950,10070,7
GULU,2022,5260,5080,10340,7
GULU,2023,5400,5210,10610,7
GULU,2024,5540,5340,10880,7
GULU,2025,5670,5470,11140,7
HOIMA,2015,4900,4530,9430,7
HOIMA,2016,5080,4690,9770,7
HOIMA,2017,5270,4850,10120,7
HOIMA,2018,5470,5020,10490,7
HOIMA,2019,5670,5190,10860,7
HOIMA,2020,5880,5360,11240,7
HOIMA,2021,6080,5530,11610,7
HOIMA,2022,6290,5710,12000,7
HOIMA,2023,6510,5890,12400,7
HOIMA,2024,6720,6070,12790,7
HOIMA,2025,6940,6250,13190,7
IBANDA,2015,4090,3820,7910,7
IBANDA,2016,4170,3890,8060,7
IBANDA,2017,4250,3960,8210,7
IBANDA,2018,4340,4030,8370,7
IBANDA,2019,4420,4100,8520,7
IBANDA,2020,4500,4170,8670,7
IBANDA,2021,4580,4230,8810,7
IBANDA,2022,4650,4300,8950,7
IBANDA,2023,4730,4360,9090,7
IBANDA,2024,4800,4430,9230,7
IBANDA,2025,4870,4480,9350,7
IGANGA,2015,5810,5470,11280,7
IGANGA,2016,5940,5550,11490,7
IGANGA,2017,6000,5530,11530,7
IGANGA,2018,6040,5560,11600,7
IGANGA,2019,6100,5600,11700,7
IGANGA,2020,6250,5720,11970,7
IGANGA,2021,6580,5970,12550,7
IGANGA,2022,6650,6340,12990,7
IGANGA,2023,6780,6450,13230,7
IGANGA,2024,6910,6570,13480,7
IGANGA,2025,7030,6680,13710,7
ISINGIRO,2015,8310,7930,16240,7
ISINGIRO,2016,8620,8210,16830,7
ISINGIRO,2017,8940,8500,17440,7
ISINGIRO,2018,9270,8790,18060,7
ISINGIRO,2019,9610,9100,18710,7
ISINGIRO,2020,9950,9400,19350,7
ISINGIRO,2021,10300,9710,20010,7
ISINGIRO,2022,10660,10030,20690,7
ISINGIRO,2023,11010,10350,21360,7
ISINGIRO,2024,11380,10670,22050,7
ISINGIRO,2025,11740,11000,22740,7
JINJA,2015,7250,7080,14330,7
JINJA,2016,7370,7190,14560,7
JINJA,2017,7500,7300,14800,7
JINJA,2018,7620,7410,15030,7
JINJA,2019,7740,7520,15260,7
JINJA,2020,7860,7620,15480,7
JINJA,2021,7970,7720,15690,7
JINJA,2022,8080,7820,15900,7
JINJA,2023,8190,7920,16110,7
JINJA,2024,8290,8010,16300,7
JINJA,2025,8380,8090,16470,7
KAABONG,2015,1750,1720,3470,7
KAABONG,2016,1800,1760,3560,7
KAABONG,2017,1850,1810,3660,7
KAABONG,2018,1900,1850,3750,7
KAABONG,2019,1950,1890,3840,7
KAABONG,2020,1990,1940,3930,7
KAABONG,2021,2050,1980,4030,7
KAABONG,2022,2100,2030,4130,7
KAABONG,2023,2150,2060,4210,7
KAABONG,2024,2190,2100,4290,7
KAABONG,2025,2250,2150,4400,7
KABALE,2015,3310,3000,6310,7
KABALE,2016,3370,3040,6410,7
KABALE,2017,3420,3080,6500,7
KABALE,2018,3470,3110,6580,7
KABALE,2019,3520,3140,6660,7
KABALE,2020,3570,3180,6750,7
KABALE,2021,3620,3210,6830,7
KABALE,2022,3660,3240,6900,7
KABALE,2023,3710,3270,6980,7
KABALE,2024,3750,3300,7050,7
KABALE,2025,3790,3320,7110,7
KABAROLE,2015,4680,4430,9110,7
KABAROLE,2016,4780,4530,9310,7
KABAROLE,2017,4890,4630,9520,7
KABAROLE,2018,4990,4730,9720,7
KABAROLE,2019,5100,4820,9920,7
KABAROLE,2020,5200,4920,10120,7
KABAROLE,2021,5310,5020,10330,7
KABAROLE,2022,5410,5110,10520,7
KABAROLE,2023,5510,5210,10720,7
KABAROLE,2024,5600,5300,10900,7
KABAROLE,2025,5700,5390,11090,7
KABERAMAIDO,2015,1990,1880,3870,7
KABERAMAIDO,2016,2050,1930,3980,7
KABERAMAIDO,2017,2090,1940,4030,7
KABERAMAIDO,2018,2130,1970,4100,7
KABERAMAIDO,2019,2180,2010,4190,7
KABERAMAIDO,2020,2250,2070,4320,7
KABERAMAIDO,2021,2400,2180,4580,7
KABERAMAIDO,2022,2450,2350,4800,7
KABERAMAIDO,2023,2520,2420,4940,7
KABERAMAIDO,2024,2610,2480,5090,7
KABERAMAIDO,2025,2670,2550,5220,7
KAGADI,2015,6160,5870,12030,7
KAGADI,2016,6390,6080,12470,7
KAGADI,2017,6630,6290,12920,7
KAGADI,2018,6870,6510,13380,7
KAGADI,2019,7120,6740,13860,7
KAGADI,2020,7370,6970,14340,7
KAGADI,2021,7630,7200,14830,7
KAGADI,2022,7890,7430,15320,7
KAGADI,2023,8150,7670,15820,7
KAGADI,2024,8410,7910,16320,7
KAGADI,2025,8680,8150,16830,7
KAKUMIRO,2015,5190,4910,10100,7
KAKUMIRO,2016,5650,5320,10970,7
KAKUMIRO,2017,6150,5770,11920,7
KAKUMIRO,2018,6690,6260,12950,7
KAKUMIRO,2019,7270,6780,14050,7
KAKUMIRO,2020,7900,7340,15240,7
KAKUMIRO,2021,8580,7940,16520,7
KAKUMIRO,2022,9320,8580,17900,7
KAKUMIRO,2023,10100,9280,19380,7
KAKUMIRO,2024,10950,10020,20970,7
KAKUMIRO,2025,11860,10810,22670,7
KALAKI,2015,2180,1990,4170,7
KALAKI,2016,2280,2070,4350,7
KALAKI,2017,2380,2150,4530,7
KALAKI,2018,2480,2230,4710,7
KALAKI,2019,2580,2310,4890,7
KALAKI,2020,2690,2400,5090,7
KALAKI,2021,2800,2490,5290,7
KALAKI,2022,2910,2580,5490,7
KALAKI,2023,3030,2680,5710,7
KALAKI,2024,3140,2770,5910,7
KALAKI,2025,3270,2870,6140,7
KALANGALA,2015,500,460,960,7
KALANGALA,2016,520,480,1000,7
KALANGALA,2017,540,500,1040,7
KALANGALA,2018,560,520,1080,7
KALANGALA,2019,580,540,1120,7
KALANGALA,2020,600,570,1170,7
KALANGALA,2021,620,590,1210,7
KALANGALA,2022,640,610,1250,7
KALANGALA,2023,660,630,1290,7
KALANGALA,2024,680,660,1340,7
KALANGALA,2025,700,680,1380,7
KALIRO,2015,4310,4210,8520,7
KALIRO,2016,4420,4280,8700,7
KALIRO,2017,4480,4300,8780,7
KALIRO,2018,4530,4340,8870,7
KALIRO,2019,4600,4400,9000,7
KALIRO,2020,4720,4510,9230,7
KALIRO,2021,5000,4740,9740,7
KALIRO,2022,5080,5070,10150,7
KALIRO,2023,5190,5190,10380,7
KALIRO,2024,5310,5310,10620,7
KALIRO,2025,5430,5430,10860,7
KALUNGU,2015,3250,2840,6090,7
KALUNGU,2016,3250,2830,6080,7
KALUNGU,2017,3220,2770,5990,7
KALUNGU,2018,3170,2730,5900,7
KALUNGU,2019,3140,2700,5840,7
KALUNGU,2020,3160,2700,5860,7
KALUNGU,2021,3260,2770,6030,7
KALUNGU,2022,3220,2890,6110,7
KALUNGU,2023,3230,2890,6120,7
KALUNGU,2024,3220,2880,6100,7
KALUNGU,2025,3220,2870,6090,7
KAMPALA,2015,17540,16420,33960,7
KAMPALA,2016,17890,16740,34630,7
KAMPALA,2017,18240,17060,35300,7
KAMPALA,2018,18590,17390,35980,7
KAMPALA,2019,18940,17710,36650,7
KAMPALA,2020,19280,18030,37310,7
KAMPALA,2021,19620,18340,37960,7
KAMPALA,2022,19950,18650,38600,7
KAMPALA,2023,20270,18950,39220,7
KAMPALA,2024,20580,19240,39820,7
KAMPALA,2025,20880,19520,40400,7
KAMULI,2015,8740,8370,17110,7
KAMULI,2016,8880,8440,17320,7
KAMULI,2017,8930,8350,17280,7
KAMULI,2018,8940,8340,17280,7
KAMULI,2019,8980,8360,17340,7
KAMULI,2020,9150,8480,17630,7
KAMULI,2021,9580,8800,18380,7
KAMULI,2022,9640,9300,18940,7
KAMULI,2023,9780,9420,19200,7
KAMULI,2024,9910,9530,19440,7
KAMULI,2025,10040,9620,19660,7
KAMWENGE,2015,4730,4490,9220,7
KAMWENGE,2016,4920,4650,9570,7
KAMWENGE,2017,5120,4810,9930,7
KAMWENGE,2018,5330,4980,10310,7
KAMWENGE,2019,5540,5160,10700,7
KAMWENGE,2020,5750,5330,11080,7
KAMWENGE,2021,5980,5510,11490,7
KAMWENGE,2022,6200,5690,11890,7
KAMWENGE,2023,6430,5880,12310,7
KAMWENGE,2024,6670,6060,12730,7
KAMWENGE,2025,6900,6250,13150,7
KANUNGU,2015,4060,4010,8070,7
KANUNGU,2016,4130,4080,8210,7
KANUNGU,2017,4210,4150,8360,7
KANUNGU,2018,4280,4210,8490,7
KANUNGU,2019,4350,4280,8630,7
KANUNGU,2020,4420,4340,8760,7
KANUNGU,2021,4490,4400,8890,7
KANUNGU,2022,4560,4460,9020,7
KANUNGU,2023,4630,4520,9150,7
KANUNGU,2024,4690,4580,9270,7
KANUNGU,2025,4750,4630,9380,7
KAPCHORWA,2015,1740,1630,3370,7
KAPCHORWA,2016,1790,1670,3460,7
KAPCHORWA,2017,1850,1720,3570,7
KAPCHORWA,2018,1910,1760,3670,7
KAPCHORWA,2019,1960,1810,3770,7
KAPCHORWA,2020,2020,1860,3880,7
KAPCHORWA,2021,2080,1910,3990,7
KAPCHORWA,2022,2130,1960,4090,7
KAPCHORWA,2023,2190,2010,4200,7
KAPCHORWA,2024,2250,2050,4300,7
KAPCHORWA,2025,2300,2100,4400,7
KAPELEBYONG,2015,1590,1600,3190,7
KAPELEBYONG,2016,1620,1630,3250,7
KAPELEBYONG,2017,1640,1620,3260,7
KAPELEBYONG,2018,1650,1620,3270,7
KAPELEBYONG,2019,1670,1640,3310,7
KAPELEBYONG,2020,1710,1670,3380,7
KAPELEBYONG,2021,1790,1740,3530,7
KAPELEBYONG,2022,1820,1850,3670,7
KAPELEBYONG,2023,1850,1880,3730,7
KAPELEBYONG,2024,1890,1910,3800,7
KAPELEBYONG,2025,1930,1940,3870,7
KASESE,2015,11650,10700,22350,7
KASESE,2016,11820,10780,22600,7
KASESE,2017,11860,10660,22520,7
KASESE,2018,11860,10640,22500,7
KASESE,2019,11900,10660,22560,7
KASESE,2020,12100,10810,22910,7
KASESE,2021,12660,11210,23870,7
KASESE,2022,12710,11830,24540,7
KASESE,2023,12870,11970,24840,7
KASESE,2024,13030,12100,25130,7
KASESE,2025,13170,12220,25390,7
KASSANDA,2015,4760,4130,8890,7
KASSANDA,2016,4900,4220,9120,7
KASSANDA,2017,5040,4310,9350,7
KASSANDA,2018,5180,4400,9580,7
KASSANDA,2019,5330,4490,9820,7
KASSANDA,2020,5470,4580,10050,7
KASSANDA,2021,5610,4670,10280,7
KASSANDA,2022,5760,4760,10520,7
KASSANDA,2023,5900,4850,10750,7
KASSANDA,2024,6040,4930,10970,7
KASSANDA,2025,6180,5010,11190,7
KATAKWI,2015,2980,2880,5860,7
KATAKWI,2016,3040,2920,5960,7
KATAKWI,2017,3070,2890,5960,7
KATAKWI,2018,3090,2900,5990,7
KATAKWI,2019,3110,2920,6030,7
KATAKWI,2020,3180,2970,6150,7
KATAKWI,2021,3340,3080,6420,7
KATAKWI,2022,3370,3270,6640,7
KATAKWI,2023,3430,3320,6750,7
KATAKWI,2024,3490,3360,6850,7
KATAKWI,2025,3550,3410,6960,7
KAYUNGA,2015,6670,6100,12770,7
KAYUNGA,2016,6730,6110,12840,7
KAYUNGA,2017,6720,6000,12720,7
KAYUNGA,2018,6690,5960,12650,7
KAYUNGA,2019,6670,5940,12610,7
KAYUNGA,2020,6760,5990,12750,7
KAYUNGA,2021,7030,6180,13210,7
KAYUNGA,2022,7030,6490,13520,7
KAYUNGA,2023,7080,6530,13610,7
KAYUNGA,2024,7130,6570,13700,7
KAYUNGA,2025,7170,6590,13760,7
KAZO,2015,2970,2760,5730,7
KAZO,2016,3080,2850,5930,7
KAZO,2017,3200,2960,6160,7
KAZO,2018,3310,3060,6370,7
KAZO,2019,3440,3170,6610,7
KAZO,2020,3560,3270,6830,7
KAZO,2021,3690,3380,7070,7
KAZO,2022,3820,3490,7310,7
KAZO,2023,3950,3600,7550,7
KAZO,2024,4090,3720,7810,7
KAZO,2025,4220,3830,8050,7
KIBAALE,2015,2500,2430,4930,7
KIBAALE,2016,2670,2570,5240,7
KIBAALE,2017,2830,2720,5550,7
KIBAALE,2018,3010,2880,5890,7
KIBAALE,2019,3200,3040,6240,7
KIBAALE,2020,3400,3210,6610,7
KIBAALE,2021,3610,3390,7000,7
KIBAALE,2022,3830,3580,7410,7
KIBAALE,2023,4060,3770,7830,7
KIBAALE,2024,4300,3980,8280,7
KIBAALE,2025,4550,4190,8740,7
KIBOGA,2015,2440,2210,4650,7
KIBOGA,2016,2480,2230,4710,7
KIBOGA,2017,2500,2200,4700,7
KIBOGA,2018,2500,2210,4710,7
KIBOGA,2019,2510,2210,4720,7
KIBOGA,2020,2560,2240,4800,7
KIBOGA,2021,2680,2330,5010,7
KIBOGA,2022,2710,2460,5170,7
KIBOGA,2023,2750,2500,5250,7
KIBOGA,2024,2780,2530,5310,7
KIBOGA,2025,2820,2560,5380,7
KIBUKU,2015,3540,3520,7060,7
KIBUKU,2016,3640,3600,7240,7
KIBUKU,2017,3710,3610,7320,7
KIBUKU,2018,3770,3650,7420,7
KIBUKU,2019,3820,3720,7540,7
KIBUKU,2020,3940,3820,7760,7
KIBUKU,2021,4190,4020,8210,7
KIBUKU,2022,4260,4310,8570,7
KIBUKU,2023,4370,4420,8790,7
KIBUKU,2024,4490,4540,9030,7
KIBUKU,2025,4610,4650,9260,7
KIKUUBE,2015,4690,4280,8970,7
KIKUUBE,2016,4950,4500,9450,7
KIKUUBE,2017,5210,4730,9940,7
KIKUUBE,2018,5490,4970,10460,7
KIKUUBE,2019,5780,5220,11000,7
KIKUUBE,2020,6080,5480,11560,7
KIKUUBE,2021,6390,5740,12130,7
KIKUUBE,2022,6710,6020,12730,7
KIKUUBE,2023,7040,6300,13340,7
KIKUUBE,2024,7390,6600,13990,7
KIKUUBE,2025,7740,6900,14640,7
KIRUHURA,2015,2370,2010,4380,7
KIRUHURA,2016,2460,2080,4540,7
KIRUHURA,2017,2560,2150,4710,7
KIRUHURA,2018,2660,2230,4890,7
KIRUHURA,2019,2750,2300,5050,7
KIRUHURA,2020,2860,2380,5240,7
KIRUHURA,2021,2960,2460,5420,7
KIRUHURA,2022,3060,2550,5610,7
KIRUHURA,2023,3170,2630,5800,7
KIRUHURA,2024,3270,2710,5980,7
KIRUHURA,2025,3370,2790,6160,7
KIRYANDONGO,2015,4720,4410,9130,7
KIRYANDONGO,2016,4820,4480,9300,7
KIRYANDONGO,2017,4860,4450,9310,7
KIRYANDONGO,2018,4890,4470,9360,7
KIRYANDONGO,2019,4940,4500,9440,7
KIRYANDONGO,2020,5050,4580,9630,7
KIRYANDONGO,2021,5320,4770,10090,7
KIRYANDONGO,2022,5370,5070,10440,7
KIRYANDONGO,2023,5460,5150,10610,7
KIRYANDONGO,2024,5570,5230,10800,7
KIRYANDONGO,2025,5650,5310,10960,7
KISORO,2015,4560,4530,9090,7
KISORO,2016,4610,4570,9180,7
KISORO,2017,4610,4500,9110,7
KISORO,2018,4580,4480,9060,7
KISORO,2019,4580,4480,9060,7
KISORO,2020,4630,4530,9160,7
KISORO,2021,4830,4690,9520,7
KISORO,2022,4820,4950,9770,7
KISORO,2023,4860,4990,9850,7
KISORO,2024,4900,5030,9930,7
KISORO,2025,4930,5070,10000,7
KITAGWENDA,2015,2510,2400,4910,7
KITAGWENDA,2016,2620,2490,5110,7
KITAGWENDA,2017,2720,2580,5300,7
KITAGWENDA,2018,2840,2670,5510,7
KITAGWENDA,2019,2940,2760,5700,7
KITAGWENDA,2020,3060,2860,5920,7
KITAGWENDA,2021,3180,2950,6130,7
KITAGWENDA,2022,3300,3050,6350,7
KITAGWENDA,2023,3420,3150,6570,7
KITAGWENDA,2024,3540,3250,6790,7
KITAGWENDA,2025,3670,3350,7020,7
KITGUM,2015,3550,3430,6980,7
KITGUM,2016,3570,3440,7010,7
KITGUM,2017,3560,3370,6930,7
KITGUM,2018,3530,3350,6880,7
KITGUM,2019,3510,3330,6840,7
KITGUM,2020,3550,3360,6910,7
KITGUM,2021,3680,3460,7140,7
KITGUM,2022,3660,3640,7300,7
KITGUM,2023,3680,3650,7330,7
KITGUM,2024,3690,3670,7360,7
KITGUM,2025,3710,3680,7390,7
KOBOKO,2015,3700,3630,7330,7
KOBOKO,2016,3810,3720,7530,7
KOBOKO,2017,3880,3740,7620,7
KOBOKO,2018,3940,3780,7720,7
KOBOKO,2019,4020,3860,7880,7
KOBOKO,2020,4140,3970,8110,7
KOBOKO,2021,4400,4190,8590,7
KOBOKO,2022,4490,4490,8980,7
KOBOKO,2023,4610,4610,9220,7
KOBOKO,2024,4740,4740,9480,7
KOBOKO,2025,4860,4860,9720,7
KOLE,2015,4210,4140,8350,7
KOLE,2016,4350,4260,8610,7
KOLE,2017,4490,4380,8870,7
KOLE,2018,4640,4510,9150,7
KOLE,2019,4790,4630,9420,7
KOLE,2020,4940,4760,9700,7
KOLE,2021,5090,4890,9980,7
KOLE,2022,5240,5010,10250,7
KOLE,2023,5390,5140,10530,7
KOLE,2024,5540,5270,10810,7
KOLE,2025,5690,5400,11090,7
KOTIDO,2015,2670,2890,5560,7
KOTIDO,2016,2710,2910,5620,7
KOTIDO,2017,2720,2880,5600,7
KOTIDO,2018,2720,2870,5590,7
KOTIDO,2019,2720,2880,5600,7
KOTIDO,2020,2770,2910,5680,7
KOTIDO,2021,2900,3030,5930,7
KOTIDO,2022,2910,3190,6100,7
KOTIDO,2023,2940,3230,6170,7
KOTIDO,2024,2980,3270,6250,7
KOTIDO,2025,3020,3290,6310,7
KUMI,2015,4320,4230,8550,7
KUMI,2016,4420,4290,8710,7
KUMI,2017,4470,4280,8750,7
KUMI,2018,4510,4290,8800,7
KUMI,2019,4550,4330,8880,7
KUMI,2020,4670,4420,9090,7
KUMI,2021,4920,4620,9540,7
KUMI,2022,4980,4910,9890,7
KUMI,2023,5080,4990,10070,7
KUMI,2024,5180,5080,10260,7
KUMI,2025,5270,5160,10430,7
KWANIA,2015,3170,3070,6240,7
KWANIA,2016,3270,3160,6430,7
KWANIA,2017,3370,3250,6620,7
KWANIA,2018,3470,3350,6820,7
KWANIA,2019,3570,3440,7010,7
KWANIA,2020,3680,3530,7210,7
KWANIA,2021,3780,3630,7410,7
KWANIA,2022,3890,3720,7610,7
KWANIA,2023,4000,3810,7810,7
KWANIA,2024,4100,3910,8010,7
KWANIA,2025,4210,4000,8210,7
KWEEN,2015,1700,1520,3220,7
KWEEN,2016,1750,1560,3310,7
KWEEN,2017,1800,1600,3400,7
KWEEN,2018,1860,1640,3500,7
KWEEN,2019,1920,1680,3600,7
KWEEN,2020,1970,1720,3690,7
KWEEN,2021,2030,1760,3790,7
KWEEN,2022,2090,1800,3890,7
KWEEN,2023,2140,1830,3970,7
KWEEN,2024,2200,1870,4070,7
KWEEN,2025,2260,1910,4170,7
KYANKWANZI,2015,3680,3260,6940,7
KYANKWANZI,2016,3870,3410,7280,7
KYANKWANZI,2017,4070,3570,7640,7
KYANKWANZI,2018,4280,3730,8010,7
KYANKWANZI,2019,4490,3900,8390,7
KYANKWANZI,2020,4710,4080,8790,7
KYANKWANZI,2021,4940,4260,9200,7
KYANKWANZI,2022,5180,4450,9630,7
KYANKWANZI,2023,5430,4640,10070,7
KYANKWANZI,2024,5680,4840,10520,7
KYANKWANZI,2025,5940,5040,10980,7
KYEGEGWA,2015,4980,4630,9610,7
KYEGEGWA,2016,5390,5000,10390,7
KYEGEGWA,2017,5830,5400,11230,7
KYEGEGWA,2018,6310,5820,12130,7
KYEGEGWA,2019,6820,6280,13100,7
KYEGEGWA,2020,7370,6760,14130,7
KYEGEGWA,2021,7960,7280,15240,7
KYEGEGWA,2022,8580,7840,16420,7
KYEGEGWA,2023,9260,8430,17690,7
KYEGEGWA,2024,9970,9060,19030,7
KYEGEGWA,2025,10730,9730,20460,7
KYENJOJO,2015,7230,6840,14070,7
KYENJOJO,2016,7530,7090,14620,7
KYENJOJO,2017,7840,7350,15190,7
KYENJOJO,2018,8160,7620,15780,7
KYENJOJO,2019,8490,7890,16380,7
KYENJOJO,2020,8820,8170,16990,7
KYENJOJO,2021,9160,8460,17620,7
KYENJOJO,2022,9510,8750,18260,7
KYENJOJO,2023,9860,9040,18900,7
KYENJOJO,2024,10220,9330,19550,7
KYENJOJO,2025,10590,9630,20220,7
KYOTERA,2015,4070,3650,7720,7
KYOTERA,2016,4090,3650,7740,7
KYOTERA,2017,4080,3580,7660,7
KYOTERA,2018,4050,3540,7590,7
KYOTERA,2019,4020,3520,7540,7
KYOTERA,2020,4060,3540,7600,7
KYOTERA,2021,4220,3640,7860,7
KYOTERA,2022,4200,3820,8020,7
KYOTERA,2023,4220,3830,8050,7
KYOTERA,2024,4240,3840,8080,7
KYOTERA,2025,4250,3840,8090,7
KARENGA,2015,930,1000,1930,7
KARENGA,2016,950,1020,1970,7
KARENGA,2017,970,1040,2010,7
KARENGA,2018,1010,1070,2080,7
KARENGA,2019,1030,1100,2130,7
KARENGA,2020,1060,1120,2180,7
KARENGA,2021,1080,1140,2220,7
KARENGA,2022,1110,1160,2270,7
KARENGA,2023,1130,1190,2320,7
KARENGA,2024,1160,1220,2380,7
KARENGA,2025,1180,1240,2420,7
LAMWO,2015,2660,2490,5150,7
LAMWO,2016,2660,2500,5160,7
LAMWO,2017,2630,2450,5080,7
LAMWO,2018,2590,2430,5020,7
LAMWO,2019,2560,2420,4980,7
LAMWO,2020,2570,2430,5000,7
LAMWO,2021,2650,2500,5150,7
LAMWO,2022,2620,2620,5240,7
LAMWO,2023,2610,2630,5240,7
LAMWO,2024,2610,2640,5250,7
LAMWO,2025,2600,2640,5240,7
LIRA,2015,6430,6320,12750,7
LIRA,2016,6620,6500,13120,7
LIRA,2017,6800,6690,13490,7
LIRA,2018,6990,6880,13870,7
LIRA,2019,7180,7070,14250,7
LIRA,2020,7370,7260,14630,7
LIRA,2021,7560,7450,15010,7
LIRA,2022,7750,7640,15390,7
LIRA,2023,7940,7830,15770,7
LIRA,2024,8130,8030,16160,7
LIRA,2025,8310,8220,16530,7
LUUKA,2015,4140,4200,8340,7
LUUKA,2016,4190,4220,8410,7
LUUKA,2017,4190,4150,8340,7
LUUKA,2018,4180,4140,8320,7
LUUKA,2019,4170,4140,8310,7
LUUKA,2020,4230,4190,8420,7
LUUKA,2021,4400,4330,8730,7
LUUKA,2022,4410,4570,8980,7
LUUKA,2023,4450,4610,9060,7
LUUKA,2024,4480,4650,9130,7
LUUKA,2025,4510,4680,9190,7
LUWERO,2015,7720,7070,14790,7
LUWERO,2016,7840,7130,14970,7
LUWERO,2017,7880,7060,14940,7
LUWERO,2018,7880,7050,14930,7
LUWERO,2019,7900,7070,14970,7
LUWERO,2020,8050,7170,15220,7
LUWERO,2021,8430,7430,15860,7
LUWERO,2022,8470,7850,16320,7
LUWERO,2023,8580,7950,16530,7
LUWERO,2024,8690,8040,16730,7
LUWERO,2025,8790,8120,16910,7
LWENGO,2015,4840,4410,9250,7
LWENGO,2016,4850,4400,9250,7
LWENGO,2017,4800,4300,9100,7
LWENGO,2018,4730,4240,8970,7
LWENGO,2019,4680,4180,8860,7
LWENGO,2020,4700,4190,8890,7
LWENGO,2021,4850,4290,9140,7
LWENGO,2022,4800,4480,9280,7
LWENGO,2023,4790,4470,9260,7
LWENGO,2024,4780,4460,9240,7
LWENGO,2025,4770,4450,9220,7
LYANTONDE,2015,1570,1420,2990,7
LYANTONDE,2016,1600,1440,3040,7
LYANTONDE,2017,1610,1430,3040,7
LYANTONDE,2018,1620,1440,3060,7
LYANTONDE,2019,1630,1450,3080,7
LYANTONDE,2020,1670,1480,3150,7
LYANTONDE,2021,1760,1540,3300,7
LYANTONDE,2022,1770,1640,3410,7
LYANTONDE,2023,1810,1660,3470,7
LYANTONDE,2024,1840,1690,3530,7
LYANTONDE,2025,1870,1720,3590,7
MANAFWA,2015,2690,2460,5150,7
MANAFWA,2016,2750,2520,5270,7
MANAFWA,2017,2820,2580,5400,7
MANAFWA,2018,2890,2630,5520,7
MANAFWA,2019,2960,2690,5650,7
MANAFWA,2020,3030,2740,5770,7
MANAFWA,2021,3100,2800,5900,7
MANAFWA,2022,3170,2860,6030,7
MANAFWA,2023,3230,2910,6140,7
MANAFWA,2024,3300,2960,6260,7
MANAFWA,2025,3370,3010,6380,7
MARACHA,2015,3260,2950,6210,7
MARACHA,2016,3330,3010,6340,7
MARACHA,2017,3400,3070,6470,7
MARACHA,2018,3470,3130,6600,7
MARACHA,2019,3540,3190,6730,7
MARACHA,2020,3610,3240,6850,7
MARACHA,2021,3680,3300,6980,7
MARACHA,2022,3750,3360,7110,7
MARACHA,2023,3810,3410,7220,7
MARACHA,2024,3870,3460,7330,7
MARACHA,2025,3940,3510,7450,7
MASAKA,2015,4740,4370,9110,7
MASAKA,2016,4790,4400,9190,7
MASAKA,2017,4810,4340,9150,7
MASAKA,2018,4790,4340,9130,7
MASAKA,2019,4800,4340,9140,7
MASAKA,2020,4870,4390,9260,7
MASAKA,2021,5090,4540,9630,7
MASAKA,2022,5100,4790,9890,7
MASAKA,2023,5150,4830,9980,7
MASAKA,2024,5200,4880,10080,7
MASAKA,2025,5250,4920,10170,7
MASINDI,2015,4720,4430,9150,7
MASINDI,2016,4860,4540,9400,7
MASINDI,2017,5000,4660,9660,7
MASINDI,2018,5150,4790,9940,7
MASINDI,2019,5290,4910,10200,7
MASINDI,2020,5440,5030,10470,7
MASINDI,2021,5580,5160,10740,7
MASINDI,2022,5730,5280,11010,7
MASINDI,2023,5880,5410,11290,7
MASINDI,2024,6020,5530,11550,7
MASINDI,2025,6170,5650,11820,7
MAYUGE,2015,8510,8070,16580,7
MAYUGE,2016,8700,8210,16910,7
MAYUGE,2017,8790,8180,16970,7
MAYUGE,2018,8840,8240,17080,7
MAYUGE,2019,8930,8330,17260,7
MAYUGE,2020,9160,8510,17670,7
MAYUGE,2021,9650,8890,18540,7
MAYUGE,2022,9760,9470,19230,7
MAYUGE,2023,9950,9670,19620,7
MAYUGE,2024,10140,9850,19990,7
MAYUGE,2025,10320,10030,20350,7
MBALE,2015,7560,7430,14990,7
MBALE,2016,7720,7570,15290,7
MBALE,2017,7800,7570,15370,7
MBALE,2018,7840,7640,15480,7
MBALE,2019,7910,7740,15650,7
MBALE,2020,8100,7930,16030,7
MBALE,2021,8520,8310,16830,7
MBALE,2022,8600,8880,17480,7
MBALE,2023,8760,9080,17840,7
MBALE,2024,8920,9270,18190,7
MBALE,2025,9070,9470,18540,7
MBARARA,2015,4700,4400,9100,7
MBARARA,2016,4810,4500,9310,7
MBARARA,2017,4920,4600,9520,7
MBARARA,2018,5030,4690,9720,7
MBARARA,2019,5140,4790,9930,7
MBARARA,2020,5250,4890,10140,7
MBARARA,2021,5360,4980,10340,7
MBARARA,2022,5460,5070,10530,7
MBARARA,2023,5580,5170,10750,7
MBARARA,2024,5680,5250,10930,7
MBARARA,2025,5780,5340,11120,7
MITOOMA,2015,3000,2860,5860,7
MITOOMA,2016,3030,2890,5920,7
MITOOMA,2017,3070,2910,5980,7
MITOOMA,2018,3110,2940,6050,7
MITOOMA,2019,3140,2960,6100,7
MITOOMA,2020,3170,2990,6160,7
MITOOMA,2021,3200,3010,6210,7
MITOOMA,2022,3230,3030,6260,7
MITOOMA,2023,3260,3050,6310,7
MITOOMA,2024,3280,3060,6340,7
MITOOMA,2025,3310,3080,6390,7
MITYANA,2015,5670,4910,10580,7
MITYANA,2016,5720,4920,10640,7
MITYANA,2017,5700,4830,10530,7
MITYANA,2018,5660,4800,10460,7
MITYANA,2019,5650,4770,10420,7
MITYANA,2020,5710,4810,10520,7
MITYANA,2021,5940,4950,10890,7
MITYANA,2022,5930,5200,11130,7
MITYANA,2023,5970,5230,11200,7
MITYANA,2024,6000,5260,11260,7
MITYANA,2025,6030,5280,11310,7
MOROTO,2015,1710,1710,3420,7
MOROTO,2016,1730,1730,3460,7
MOROTO,2017,1740,1720,3460,7
MOROTO,2018,1730,1720,3450,7
MOROTO,2019,1730,1720,3450,7
MOROTO,2020,1760,1750,3510,7
MOROTO,2021,1840,1830,3670,7
MOROTO,2022,1840,1930,3770,7
MOROTO,2023,1860,1970,3830,7
MOROTO,2024,1880,1990,3870,7
MOROTO,2025,1900,2010,3910,7
MOYO,2015,1720,1520,3240,7
MOYO,2016,1760,1560,3320,7
MOYO,2017,1810,1590,3400,7
MOYO,2018,1850,1620,3470,7
MOYO,2019,1900,1660,3560,7
MOYO,2020,1950,1690,3640,7
MOYO,2021,1990,1720,3710,7
MOYO,2022,2040,1760,3800,7
MOYO,2023,2080,1790,3870,7
MOYO,2024,2130,1820,3950,7
MOYO,2025,2160,1850,4010,7
MPIGI,2015,4310,3890,8200,7
MPIGI,2016,4370,3920,8290,7
MPIGI,2017,4400,3880,8280,7
MPIGI,2018,4390,3890,8280,7
MPIGI,2019,4400,3890,8290,7
MPIGI,2020,4480,3950,8430,7
MPIGI,2021,4680,4100,8780,7
MPIGI,2022,4700,4340,9040,7
MPIGI,2023,4750,4390,9140,7
MPIGI,2024,4810,4440,9250,7
MPIGI,2025,4860,4490,9350,7
MUBENDE,2015,6910,6420,13330,7
MUBENDE,2016,7210,6670,13880,7
MUBENDE,2017,7440,6780,14220,7
MUBENDE,2018,7640,6960,14600,7
MUBENDE,2019,7880,7170,15050,7
MUBENDE,2020,8240,7480,15720,7
MUBENDE,2021,8860,7980,16840,7
MUBENDE,2022,9150,8670,17820,7
MUBENDE,2023,9520,9020,18540,7
MUBENDE,2024,9900,9380,19280,7
MUBENDE,2025,10290,9740,20030,7
MUKONO,2015,9780,8830,18610,7
MUKONO,2016,9940,8970,18910,7
MUKONO,2017,10010,8930,18940,7
MUKONO,2018,10030,8980,19010,7
MUKONO,2019,10100,9050,19150,7
MUKONO,2020,10300,9250,19550,7
MUKONO,2021,10810,9650,20460,7
MUKONO,2022,10880,10270,21150,7
MUKONO,2023,11040,10460,21500,7
MUKONO,2024,11210,10650,21860,7
MUKONO,2025,11360,10830,22190,7
MADI OKOLLO,2015,2380,2270,4650,7
MADI OKOLLO,2016,2450,2340,4790,7
MADI OKOLLO,2017,2530,2390,4920,7
MADI OKOLLO,2018,2600,2460,5060,7
MADI OKOLLO,2019,2670,2520,5190,7
MADI OKOLLO,2020,2750,2590,5340,7
MADI OKOLLO,2021,2810,2650,5460,7
MADI OKOLLO,2022,2890,2720,5610,7
MADI OKOLLO,2023,2970,2780,5750,7
MADI OKOLLO,2024,3040,2840,5880,7
MADI OKOLLO,2025,3110,2910,6020,7
NABILATUK,2015,1130,1210,2340,7
NABILATUK,2016,1180,1240,2420,7
NABILATUK,2017,1210,1260,2470,7
NABILATUK,2018,1250,1280,2530,7
NABILATUK,2019,1280,1310,2590,7
NABILATUK,2020,1340,1360,2700,7
NABILATUK,2021,1430,1440,2870,7
NABILATUK,2022,1480,1560,3040,7
NABILATUK,2023,1540,1610,3150,7
NABILATUK,2024,1600,1670,3270,7
NABILATUK,2025,1650,1720,3370,7
NAKAPIRIPIRIT,2015,1290,1410,2700,7
NAKAPIRIPIRIT,2016,1320,1440,2760,7
NAKAPIRIPIRIT,2017,1360,1450,2810,7
NAKAPIRIPIRIT,2018,1390,1490,2880,7
NAKAPIRIPIRIT,2019,1420,1520,2940,7
NAKAPIRIPIRIT,2020,1470,1570,3040,7
NAKAPIRIPIRIT,2021,1570,1660,3230,7
NAKAPIRIPIRIT,2022,1610,1800,3410,7
NAKAPIRIPIRIT,2023,1660,1850,3510,7
NAKAPIRIPIRIT,2024,1710,1910,3620,7
NAKAPIRIPIRIT,2025,1760,1970,3730,7
NAKASEKE,2015,3260,2820,6080,7
NAKASEKE,2016,3380,2880,6260,7
NAKASEKE,2017,3500,2950,6450,7
NAKASEKE,2018,3620,3020,6640,7
NAKASEKE,2019,3750,3090,6840,7
NAKASEKE,2020,3890,3160,7050,7
NAKASEKE,2021,4020,3230,7250,7
NAKASEKE,2022,4160,3300,7460,7
NAKASEKE,2023,4290,3370,7660,7
NAKASEKE,2024,4430,3430,7860,7
NAKASEKE,2025,4570,3500,8070,7
NAKASONGOLA,2015,3120,2980,6100,7
NAKASONGOLA,2016,3190,3020,6210,7
NAKASONGOLA,2017,3220,3000,6220,7
NAKASONGOLA,2018,3250,3010,6260,7
NAKASONGOLA,2019,3280,3030,6310,7
NAKASONGOLA,2020,3360,3080,6440,7
NAKASONGOLA,2021,3540,3220,6760,7
NAKASONGOLA,2022,3590,3410,7000,7
NAKASONGOLA,2023,3650,3470,7120,7
NAKASONGOLA,2024,3730,3520,7250,7
NAKASONGOLA,2025,3790,3570,7360,7
NAMAYINGO,2015,3950,3760,7710,7
NAMAYINGO,2016,3990,3770,7760,7
NAMAYINGO,2017,3980,3690,7670,7
NAMAYINGO,2018,3960,3660,7620,7
NAMAYINGO,2019,3940,3640,7580,7
NAMAYINGO,2020,3990,3670,7660,7
NAMAYINGO,2021,4150,3780,7930,7
NAMAYINGO,2022,4150,3960,8110,7
NAMAYINGO,2023,4180,3980,8160,7
NAMAYINGO,2024,4200,3990,8190,7
NAMAYINGO,2025,4230,4010,8240,7
NAMISINDWA,2015,3680,3550,7230,7
NAMISINDWA,2016,3790,3630,7420,7
NAMISINDWA,2017,3890,3720,7610,7
NAMISINDWA,2018,4000,3800,7800,7
NAMISINDWA,2019,4110,3890,8000,7
NAMISINDWA,2020,4210,3980,8190,7
NAMISINDWA,2021,4320,4060,8380,7
NAMISINDWA,2022,4430,4150,8580,7
NAMISINDWA,2023,4540,4230,8770,7
NAMISINDWA,2024,4650,4320,8970,7
NAMISINDWA,2025,4750,4400,9150,7
NAMUTUMBA,2015,4610,4500,9110,7
NAMUTUMBA,2016,4730,4590,9320,7
NAMUTUMBA,2017,4800,4580,9380,7
NAMUTUMBA,2018,4850,4620,9470,7
NAMUTUMBA,2019,4920,4670,9590,7
NAMUTUMBA,2020,5060,4780,9840,7
NAMUTUMBA,2021,5350,5020,10370,7
NAMUTUMBA,2022,5420,5350,10770,7
NAMUTUMBA,2023,5540,5460,11000,7
NAMUTUMBA,2024,5670,5580,11250,7
NAMUTUMBA,2025,5800,5690,11490,7
NAPAK,2015,2460,2620,5080,7
NAPAK,2016,2470,2640,5110,7
NAPAK,2017,2470,2610,5080,7
NAPAK,2018,2450,2600,5050,7
NAPAK,2019,2430,2600,5030,7
NAPAK,2020,2450,2640,5090,7
NAPAK,2021,2540,2720,5260,7
NAPAK,2022,2540,2870,5410,7
NAPAK,2023,2550,2910,5460,7
NAPAK,2024,2560,2930,5490,7
NAPAK,2025,2560,2960,5520,7
NEBBI,2015,4270,3920,8190,7
NEBBI,2016,4410,4030,8440,7
NEBBI,2017,4550,4150,8700,7
NEBBI,2018,4690,4260,8950,7
NEBBI,2019,4840,4380,9220,7
NEBBI,2020,4990,4500,9490,7
NEBBI,2021,5130,4620,9750,7
NEBBI,2022,5280,4730,10010,7
NEBBI,2023,5430,4850,10280,7
NEBBI,2024,5570,4970,10540,7
NEBBI,2025,5720,5090,10810,7
NGORA,2015,2520,2430,4950,7
NGORA,2016,2560,2460,5020,7
NGORA,2017,2580,2450,5030,7
NGORA,2018,2590,2450,5040,7
NGORA,2019,2610,2460,5070,7
NGORA,2020,2670,2510,5180,7
NGORA,2021,2800,2610,5410,7
NGORA,2022,2820,2770,5590,7
NGORA,2023,2870,2810,5680,7
NGORA,2024,2920,2850,5770,7
NGORA,2025,2960,2890,5850,7
NTOROKO,2015,1070,980,2050,7
NTOROKO,2016,1100,990,2090,7
NTOROKO,2017,1100,970,2070,7
NTOROKO,2018,1100,970,2070,7
NTOROKO,2019,1100,970,2070,7
NTOROKO,2020,1120,980,2100,7
NTOROKO,2021,1170,1010,2180,7
NTOROKO,2022,1180,1070,2250,7
NTOROKO,2023,1200,1070,2270,7
NTOROKO,2024,1210,1080,2290,7
NTOROKO,2025,1230,1090,2320,7
NTUNGAMO,2015,7800,7530,15330,7
NTUNGAMO,2016,7970,7670,15640,7
NTUNGAMO,2017,8140,7810,15950,7
NTUNGAMO,2018,8310,7960,16270,7
NTUNGAMO,2019,8480,8100,16580,7
NTUNGAMO,2020,8650,8230,16880,7
NTUNGAMO,2021,8820,8370,17190,7
NTUNGAMO,2022,8980,8500,17480,7
NTUNGAMO,2023,9140,8630,17770,7
NTUNGAMO,2024,9300,8760,18060,7
NTUNGAMO,2025,9450,8880,18330,7
NWOYA,2015,2620,2380,5000,7
NWOYA,2016,2890,2620,5510,7
NWOYA,2017,3200,2890,6090,7
NWOYA,2018,3530,3180,6710,7
NWOYA,2019,3900,3500,7400,7
NWOYA,2020,4300,3850,8150,7
NWOYA,2021,4740,4240,8980,7
NWOYA,2022,5220,4660,9880,7
NWOYA,2023,5750,5120,10870,7
NWOYA,2024,6320,5620,11940,7
NWOYA,2025,6940,6160,13100,7
OBONGI,2015,870,750,1620,7
OBONGI,2016,880,760,1640,7
OBONGI,2017,890,760,1650,7
OBONGI,2018,880,750,1630,7
OBONGI,2019,880,750,1630,7
OBONGI,2020,900,760,1660,7
OBONGI,2021,940,790,1730,7
OBONGI,2022,940,830,1770,7
OBONGI,2023,950,840,1790,7
OBONGI,2024,960,850,1810,7
OBONGI,2025,980,850,1830,7
OMORO,2015,2810,2760,5570,7
OMORO,2016,2880,2820,5700,7
OMORO,2017,2930,2820,5750,7
OMORO,2018,2960,2850,5810,7
OMORO,2019,3000,2890,5890,7
OMORO,2020,3090,2970,6060,7
OMORO,2021,3260,3120,6380,7
OMORO,2022,3310,3330,6640,7
OMORO,2023,3390,3400,6790,7
OMORO,2024,3460,3490,6950,7
OMORO,2025,3550,3570,7120,7
OTUKE,2015,1850,1770,3620,7
OTUKE,2016,1940,1840,3780,7
OTUKE,2017,2020,1920,3940,7
OTUKE,2018,2110,2000,4110,7
OTUKE,2019,2210,2090,4300,7
OTUKE,2020,2300,2180,4480,7
OTUKE,2021,2400,2270,4670,7
OTUKE,2022,2500,2360,4860,7
OTUKE,2023,2610,2450,5060,7
OTUKE,2024,2710,2550,5260,7
OTUKE,2025,2820,2640,5460,7
OYAM,2015,6730,6550,13280,7
OYAM,2016,6940,6750,13690,7
OYAM,2017,7150,6950,14100,7
OYAM,2018,7370,7150,14520,7
OYAM,2019,7580,7350,14930,7
OYAM,2020,7800,7550,15350,7
OYAM,2021,8020,7760,15780,7
OYAM,2022,8250,7960,16210,7
OYAM,2023,8470,8170,16640,7
OYAM,2024,8690,8380,17070,7
OYAM,2025,8910,8580,17490,7
PADER,2015,3160,3040,6200,7
PADER,2016,3190,3050,6240,7
PADER,2017,3180,3010,6190,7
PADER,2018,3150,3000,6150,7
PADER,2019,3140,3000,6140,7
PADER,2020,3170,3020,6190,7
PADER,2021,3290,3130,6420,7
PADER,2022,3280,3300,6580,7
PADER,2023,3300,3320,6620,7
PADER,2024,3310,3340,6650,7
PADER,2025,3330,3370,6700,7
PAKWACH,2015,2760,2630,5390,7
PAKWACH,2016,2880,2730,5610,7
PAKWACH,2017,3000,2830,5830,7
PAKWACH,2018,3120,2930,6050,7
PAKWACH,2019,3250,3030,6280,7
PAKWACH,2020,3380,3140,6520,7
PAKWACH,2021,3510,3250,6760,7
PAKWACH,2022,3650,3350,7000,7
PAKWACH,2023,3790,3470,7260,7
PAKWACH,2024,3930,3580,7510,7
PAKWACH,2025,4070,3690,7760,7
PALLISA,2015,4980,4820,9800,7
PALLISA,2016,5150,4960,10110,7
PALLISA,2017,5280,5000,10280,7
PALLISA,2018,5380,5100,10480,7
PALLISA,2019,5510,5210,10720,7
PALLISA,2020,5720,5400,11120,7
PALLISA,2021,6100,5710,11810,7
PALLISA,2022,6250,6160,12410,7
PALLISA,2023,6450,6360,12810,7
PALLISA,2024,6670,6560,13230,7
PALLISA,2025,6870,6760,13630,7
RAKAI,2015,4770,4450,9220,7
RAKAI,2016,4840,4500,9340,7
RAKAI,2017,4870,4450,9320,7
RAKAI,2018,4870,4440,9310,7
RAKAI,2019,4890,4450,9340,7
RAKAI,2020,4990,4510,9500,7
RAKAI,2021,5220,4690,9910,7
RAKAI,2022,5250,4960,10210,7
RAKAI,2023,5320,5010,10330,7
RAKAI,2024,5390,5070,10460,7
RAKAI,2025,5460,5130,10590,7
RUBANDA,2015,3110,3100,6210,7
RUBANDA,2016,3160,3120,6280,7
RUBANDA,2017,3200,3150,6350,7
RUBANDA,2018,3240,3170,6410,7
RUBANDA,2019,3280,3190,6470,7
RUBANDA,2020,3320,3210,6530,7
RUBANDA,2021,3360,3230,6590,7
RUBANDA,2022,3390,3250,6640,7
RUBANDA,2023,3430,3270,6700,7
RUBANDA,2024,3460,3280,6740,7
RUBANDA,2025,3490,3290,6780,7
RUBIRIZI,2015,2230,2040,4270,7
RUBIRIZI,2016,2280,2080,4360,7
RUBIRIZI,2017,2320,2120,4440,7
RUBIRIZI,2018,2370,2160,4530,7
RUBIRIZI,2019,2420,2200,4620,7
RUBIRIZI,2020,2460,2240,4700,7
RUBIRIZI,2021,2510,2280,4790,7
RUBIRIZI,2022,2550,2320,4870,7
RUBIRIZI,2023,2590,2350,4940,7
RUBIRIZI,2024,2630,2390,5020,7
RUBIRIZI,2025,2670,2420,5090,7
RUKIGA,2015,1490,1470,2960,7
RUKIGA,2016,1510,1480,2990,7
RUKIGA,2017,1520,1500,3020,7
RUKIGA,2018,1540,1500,3040,7
RUKIGA,2019,1550,1520,3070,7
RUKIGA,2020,1570,1520,3090,7
RUKIGA,2021,1580,1530,3110,7
RUKIGA,2022,1590,1540,3130,7
RUKIGA,2023,1600,1540,3140,7
RUKIGA,2024,1610,1550,3160,7
RUKIGA,2025,1620,1550,3170,7
RUKUNGIRI,2015,5000,4660,9660,7
RUKUNGIRI,2016,5060,4710,9770,7
RUKUNGIRI,2017,5120,4760,9880,7
RUKUNGIRI,2018,5180,4800,9980,7
RUKUNGIRI,2019,5240,4840,10080,7
RUKUNGIRI,2020,5290,4880,10170,7
RUKUNGIRI,2021,5340,4920,10260,7
RUKUNGIRI,2022,5390,4950,10340,7
RUKUNGIRI,2023,5440,4990,10430,7
RUKUNGIRI,2024,5480,5010,10490,7
RUKUNGIRI,2025,5520,5040,10560,7
RWAMPARA,2015,2090,1970,4060,7
RWAMPARA,2016,2140,2020,4160,7
RWAMPARA,2017,2180,2060,4240,7
RWAMPARA,2018,2230,2100,4330,7
RWAMPARA,2019,2280,2150,4430,7
RWAMPARA,2020,2330,2190,4520,7
RWAMPARA,2021,2380,2230,4610,7
RWAMPARA,2022,2430,2280,4710,7
RWAMPARA,2023,2470,2320,4790,7
RWAMPARA,2024,2520,2370,4890,7
RWAMPARA,2025,2560,2400,4960,7
SERERE,2015,5390,5270,10660,7
SERERE,2016,5550,5410,10960,7
SERERE,2017,5670,5440,11110,7
SERERE,2018,5760,5530,11290,7
SERERE,2019,5870,5630,11500,7
SERERE,2020,6070,5810,11880,7
SERERE,2021,6460,6120,12580,7
SERERE,2022,6590,6580,13170,7
SERERE,2023,6780,6760,13540,7
SERERE,2024,6970,6950,13920,7
SERERE,2025,7160,7140,14300,7
SHEEMA,2015,3140,2880,6020,7
SHEEMA,2016,3180,2910,6090,7
SHEEMA,2017,3220,2940,6160,7
SHEEMA,2018,3260,2970,6230,7
SHEEMA,2019,3300,3000,6300,7
SHEEMA,2020,3330,3030,6360,7
SHEEMA,2021,3370,3050,6420,7
SHEEMA,2022,3400,3080,6480,7
SHEEMA,2023,3430,3100,6530,7
SHEEMA,2024,3450,3120,6570,7
SHEEMA,2025,3480,3140,6620,7
SIRONKO,2015,3980,3570,7550,7
SIRONKO,2016,4080,3640,7720,7
SIRONKO,2017,4170,3710,7880,7
SIRONKO,2018,4270,3790,8060,7
SIRONKO,2019,4370,3860,8230,7
SIRONKO,2020,4470,3930,8400,7
SIRONKO,2021,4560,4010,8570,7
SIRONKO,2022,4660,4080,8740,7
SIRONKO,2023,4750,4150,8900,7
SIRONKO,2024,4840,4210,9050,7
SIRONKO,2025,4930,4280,9210,7
SOROTI,2015,4970,5070,10040,7
SOROTI,2016,5100,5170,10270,7
SOROTI,2017,5190,5180,10370,7
SOROTI,2018,5250,5230,10480,7
SOROTI,2019,5320,5300,10620,7
SOROTI,2020,5470,5450,10920,7
SOROTI,2021,5800,5720,11520,7
SOROTI,2022,5890,6120,12010,7
SOROTI,2023,6030,6260,12290,7
SOROTI,2024,6170,6420,12590,7
SOROTI,2025,6310,6560,12870,7
SSEMBABULE,2015,4290,4150,8440,7
SSEMBABULE,2016,4370,4200,8570,7
SSEMBABULE,2017,4420,4170,8590,7
SSEMBABULE,2018,4440,4190,8630,7
SSEMBABULE,2019,4470,4210,8680,7
SSEMBABULE,2020,4570,4290,8860,7
SSEMBABULE,2021,4800,4470,9270,7
SSEMBABULE,2022,4840,4740,9580,7
SSEMBABULE,2023,4920,4820,9740,7
SSEMBABULE,2024,5010,4880,9890,7
SSEMBABULE,2025,5090,4960,10050,7
TORORO,2015,8820,8620,17440,7
TORORO,2016,9060,8840,17900,7
TORORO,2017,9300,9060,18360,7
TORORO,2018,9540,9280,18820,7
TORORO,2019,9790,9510,19300,7
TORORO,2020,10030,9730,19760,7
TORORO,2021,10280,9950,20230,7
TORORO,2022,10520,10170,20690,7
TORORO,2023,10760,10400,21160,7
TORORO,2024,11000,10610,21610,7
TORORO,2025,11230,10830,22060,7
WAKISO,2015,29400,27990,57390,7
WAKISO,2016,31370,29900,61270,7
WAKISO,2017,33470,31960,65430,7
WAKISO,2018,35690,34120,69810,7
WAKISO,2019,38060,36410,74470,7
WAKISO,2020,40540,38830,79370,7
WAKISO,2021,43150,41400,84550,7
WAKISO,2022,45910,44140,90050,7
WAKISO,2023,48830,46980,95810,7
WAKISO,2024,51870,49970,101840,7
WAKISO,2025,55060,53150,108210,7
YUMBE,2015,10260,11100,21360,7
YUMBE,2016,10690,11590,22280,7
YUMBE,2017,11010,11890,22900,7
YUMBE,2018,11290,12300,23590,7
YUMBE,2019,11630,12760,24390,7
YUMBE,2020,12140,13420,25560,7
YUMBE,2021,13040,14410,27450,7
YUMBE,2022,13430,15780,29210,7
YUMBE,2023,13960,16540,30500,7
YUMBE,2024,14500,17320,31820,7
YUMBE,2025,15050,18130,33180,7
ZOMBO,2015,4480,4260,8740,7
ZOMBO,2016,4620,4380,9000,7
ZOMBO,2017,4760,4500,9260,7
ZOMBO,2018,4910,4620,9530,7
ZOMBO,2019,5060,4750,9810,7
ZOMBO,2020,5210,4880,10090,7
ZOMBO,2021,5350,5000,10350,7
ZOMBO,2022,5500,5130,10630,7
ZOMBO,2023,5650,5250,10900,7
ZOMBO,2024,5800,5380,11180,7
ZOMBO,2025,5950,5500,11450,7
ABIM,2015,70,70,140,70
ABIM,2016,70,70,140,70
ABIM,2017,70,70,140,70
ABIM,2018,80,80,160,70
ABIM,2019,90,90,180,70
ABIM,2020,100,100,200,70
ABIM,2021,110,110,220,70
ABIM,2022,120,120,240,70
ABIM,2023,120,120,240,70
ABIM,2024,120,120,240,70
ABIM,2025,120,110,230,70
ADJUMANI,2015,160,380,540,70
ADJUMANI,2016,160,390,550,70
ADJUMANI,2017,160,390,550,70
ADJUMANI,2018,160,390,550,70
ADJUMANI,2019,160,400,560,70
ADJUMANI,2020,170,400,570,70
ADJUMANI,2021,170,400,570,70
ADJUMANI,2022,170,410,580,70
ADJUMANI,2023,170,410,580,70
ADJUMANI,2024,170,410,580,70
ADJUMANI,2025,170,410,580,70
AGAGO,2015,180,490,670,70
AGAGO,2016,190,500,690,70
AGAGO,2017,190,510,700,70
AGAGO,2018,190,520,710,70
AGAGO,2019,200,530,730,70
AGAGO,2020,200,540,740,70
AGAGO,2021,200,540,740,70
AGAGO,2022,210,550,760,70
AGAGO,2023,210,560,770,70
AGAGO,2024,210,570,780,70
AGAGO,2025,210,580,790,70
ALEBTONG,2015,120,210,330,70
ALEBTONG,2016,120,200,320,70
ALEBTONG,2017,130,190,320,70
ALEBTONG,2018,130,210,340,70
ALEBTONG,2019,140,230,370,70
ALEBTONG,2020,150,250,400,70
ALEBTONG,2021,160,280,440,70
ALEBTONG,2022,160,290,450,70
ALEBTONG,2023,160,280,440,70
ALEBTONG,2024,160,270,430,70
ALEBTONG,2025,150,250,400,70
AMOLATAR,2015,70,100,170,70
AMOLATAR,2016,70,90,160,70
AMOLATAR,2017,70,90,160,70
AMOLATAR,2018,80,90,170,70
AMOLATAR,2019,80,100,180,70
AMOLATAR,2020,90,110,200,70
AMOLATAR,2021,100,130,230,70
AMOLATAR,2022,100,130,230,70
AMOLATAR,2023,100,130,230,70
AMOLATAR,2024,100,120,220,70
AMOLATAR,2025,90,110,200,70
AMUDAT,2015,90,30,120,70
AMUDAT,2016,90,30,120,70
AMUDAT,2017,90,30,120,70
AMUDAT,2018,100,30,130,70
AMUDAT,2019,100,40,140,70
AMUDAT,2020,110,40,150,70
AMUDAT,2021,120,50,170,70
AMUDAT,2022,130,50,180,70
AMUDAT,2023,130,50,180,70
AMUDAT,2024,120,50,170,70
AMUDAT,2025,120,50,170,70
AMURIA,2015,120,220,340,70
AMURIA,2016,120,210,330,70
AMURIA,2017,130,200,330,70
AMURIA,2018,130,220,350,70
AMURIA,2019,140,240,380,70
AMURIA,2020,150,270,420,70
AMURIA,2021,160,300,460,70
AMURIA,2022,170,310,480,70
AMURIA,2023,170,310,480,70
AMURIA,2024,170,300,470,70
AMURIA,2025,160,280,440,70
AMURU,2015,100,150,250,70
AMURU,2016,100,140,240,70
AMURU,2017,90,140,230,70
AMURU,2018,100,150,250,70
AMURU,2019,100,160,260,70
AMURU,2020,120,180,300,70
AMURU,2021,120,190,310,70
AMURU,2022,130,200,330,70
AMURU,2023,120,200,320,70
AMURU,2024,120,190,310,70
AMURU,2025,120,170,290,70
APAC,2015,180,380,560,70
APAC,2016,190,390,580,70
APAC,2017,200,410,610,70
APAC,2018,200,420,620,70
APAC,2019,210,430,640,70
APAC,2020,220,450,670,70
APAC,2021,230,460,690,70
APAC,2022,230,480,710,70
APAC,2023,240,490,730,70
APAC,2024,250,510,760,70
APAC,2025,260,520,780,70
ARUA,2015,610,1240,1850,70
ARUA,2016,620,1280,1900,70
ARUA,2017,640,1310,1950,70
ARUA,2018,660,1350,2010,70
ARUA,2019,680,1380,2060,70
ARUA,2020,700,1420,2120,70
ARUA,2021,720,1450,2170,70
ARUA,2022,730,1490,2220,70
ARUA,2023,750,1520,2270,70
ARUA,2024,770,1560,2330,70
ARUA,2025,790,1590,2380,70
BUDAKA,2015,210,230,440,70
BUDAKA,2016,210,210,420,70
BUDAKA,2017,210,210,420,70
BUDAKA,2018,220,230,450,70
BUDAKA,2019,240,250,490,70
BUDAKA,2020,260,280,540,70
BUDAKA,2021,280,310,590,70
BUDAKA,2022,290,320,610,70
BUDAKA,2023,290,320,610,70
BUDAKA,2024,290,300,590,70
BUDAKA,2025,270,280,550,70
BUDUDA,2015,180,180,360,70
BUDUDA,2016,170,170,340,70
BUDUDA,2017,170,170,340,70
BUDUDA,2018,190,180,370,70
BUDUDA,2019,200,210,410,70
BUDUDA,2020,220,230,450,70
BUDUDA,2021,240,250,490,70
BUDUDA,2022,260,270,530,70
BUDUDA,2023,250,270,520,70
BUDUDA,2024,250,260,510,70
BUDUDA,2025,250,250,500,70
BUGIRI,2015,240,290,530,70
BUGIRI,2016,240,270,510,70
BUGIRI,2017,250,270,520,70
BUGIRI,2018,260,290,550,70
BUGIRI,2019,280,320,600,70
BUGIRI,2020,310,370,680,70
BUGIRI,2021,330,400,730,70
BUGIRI,2022,350,430,780,70
BUGIRI,2023,350,420,770,70
BUGIRI,2024,340,400,740,70
BUGIRI,2025,340,380,720,70
BUGWERI,2015,160,200,360,70
BUGWERI,2016,150,180,330,70
BUGWERI,2017,160,180,340,70
BUGWERI,2018,160,190,350,70
BUGWERI,2019,170,210,380,70
BUGWERI,2020,190,230,420,70
BUGWERI,2021,200,250,450,70
BUGWERI,2022,210,260,470,70
BUGWERI,2023,210,260,470,70
BUGWERI,2024,200,240,440,70
BUGWERI,2025,190,230,420,70
BUHWEJU,2015,170,240,410,70
BUHWEJU,2016,180,250,430,70
BUHWEJU,2017,180,250,430,70
BUHWEJU,2018,190,260,450,70
BUHWEJU,2019,200,270,470,70
BUHWEJU,2020,200,280,480,70
BUHWEJU,2021,210,280,490,70
BUHWEJU,2022,210,290,500,70
BUHWEJU,2023,220,300,520,70
BUHWEJU,2024,230,310,540,70
BUHWEJU,2025,230,320,550,70
BUIKWE,2015,350,470,820,70
BUIKWE,2016,340,430,770,70
BUIKWE,2017,340,430,770,70
BUIKWE,2018,350,450,800,70
BUIKWE,2019,370,490,860,70
BUIKWE,2020,400,550,950,70
BUIKWE,2021,420,590,1010,70
BUIKWE,2022,440,610,1050,70
BUIKWE,2023,430,590,1020,70
BUIKWE,2024,410,560,970,70
BUIKWE,2025,390,510,900,70
BUKEDEA,2015,170,270,440,70
BUKEDEA,2016,170,250,420,70
BUKEDEA,2017,170,250,420,70
BUKEDEA,2018,180,270,450,70
BUKEDEA,2019,200,300,500,70
BUKEDEA,2020,220,340,560,70
BUKEDEA,2021,240,380,620,70
BUKEDEA,2022,240,390,630,70
BUKEDEA,2023,250,390,640,70
BUKEDEA,2024,250,380,630,70
BUKEDEA,2025,240,360,600,70
BUKOMANSIMBI,2015,160,220,380,70
BUKOMANSIMBI,2016,150,200,350,70
BUKOMANSIMBI,2017,150,190,340,70
BUKOMANSIMBI,2018,160,200,360,70
BUKOMANSIMBI,2019,170,220,390,70
BUKOMANSIMBI,2020,170,240,410,70
BUKOMANSIMBI,2021,180,250,430,70
BUKOMANSIMBI,2022,180,260,440,70
BUKOMANSIMBI,2023,180,250,430,70
BUKOMANSIMBI,2024,170,230,400,70
BUKOMANSIMBI,2025,160,210,370,70
BUKWO,2015,60,100,160,70
BUKWO,2016,70,100,170,70
BUKWO,2017,70,110,180,70
BUKWO,2018,80,110,190,70
BUKWO,2019,80,120,200,70
BUKWO,2020,80,120,200,70
BUKWO,2021,90,130,220,70
BUKWO,2022,90,130,220,70
BUKWO,2023,100,140,240,70
BUKWO,2024,100,150,250,70
BUKWO,2025,110,150,260,70
BULAMBULI,2015,140,140,280,70
BULAMBULI,2016,140,130,270,70
BULAMBULI,2017,140,130,270,70
BULAMBULI,2018,150,150,300,70
BULAMBULI,2019,170,160,330,70
BULAMBULI,2020,180,190,370,70
BULAMBULI,2021,200,210,410,70
BULAMBULI,2022,210,220,430,70
BULAMBULI,2023,210,220,430,70
BULAMBULI,2024,210,210,420,70
BULAMBULI,2025,200,200,400,70
BULIISA,2015,90,210,300,70
BULIISA,2016,90,220,310,70
BULIISA,2017,100,230,330,70
BULIISA,2018,110,240,350,70
BULIISA,2019,110,250,360,70
BULIISA,2020,120,270,390,70
BULIISA,2021,120,280,400,70
BULIISA,2022,130,290,420,70
BULIISA,2023,140,300,440,70
BULIISA,2024,140,310,450,70
BULIISA,2025,150,320,470,70
BUNDIBUGYO,2015,180,210,390,70
BUNDIBUGYO,2016,180,190,370,70
BUNDIBUGYO,2017,180,190,370,70
BUNDIBUGYO,2018,190,200,390,70
BUNDIBUGYO,2019,200,220,420,70
BUNDIBUGYO,2020,220,250,470,70
BUNDIBUGYO,2021,230,270,500,70
BUNDIBUGYO,2022,240,280,520,70
BUNDIBUGYO,2023,240,280,520,70
BUNDIBUGYO,2024,230,260,490,70
BUNDIBUGYO,2025,220,240,460,70
BUNYANGABU,2015,180,190,370,70
BUNYANGABU,2016,170,180,350,70
BUNYANGABU,2017,170,170,340,70
BUNYANGABU,2018,180,190,370,70
BUNYANGABU,2019,190,210,400,70
BUNYANGABU,2020,210,230,440,70
BUNYANGABU,2021,220,250,470,70
BUNYANGABU,2022,220,250,470,70
BUNYANGABU,2023,220,250,470,70
BUNYANGABU,2024,220,230,450,70
BUNYANGABU,2025,210,220,430,70
BUSHENYI,2015,410,680,1090,70
BUSHENYI,2016,420,690,1110,70
BUSHENYI,2017,430,700,1130,70
BUSHENYI,2018,430,700,1130,70
BUSHENYI,2019,440,710,1150,70
BUSHENYI,2020,440,710,1150,70
BUSHENYI,2021,440,720,1160,70
BUSHENYI,2022,450,720,1170,70
BUSHENYI,2023,450,730,1180,70
BUSHENYI,2024,460,730,1190,70
BUSHENYI,2025,460,730,1190,70
BUSIA,2015,160,250,410,70
BUSIA,2016,160,230,390,70
BUSIA,2017,160,230,390,70
BUSIA,2018,170,240,410,70
BUSIA,2019,180,270,450,70
BUSIA,2020,200,300,500,70
BUSIA,2021,210,320,530,70
BUSIA,2022,220,340,560,70
BUSIA,2023,220,330,550,70
BUSIA,2024,210,320,530,70
BUSIA,2025,200,290,490,70
BUTALEJA,2015,200,190,390,70
BUTALEJA,2016,190,180,370,70
BUTALEJA,2017,190,170,360,70
BUTALEJA,2018,210,190,400,70
BUTALEJA,2019,220,210,430,70
BUTALEJA,2020,240,230,470,70
BUTALEJA,2021,260,250,510,70
BUTALEJA,2022,270,270,540,70
BUTALEJA,2023,270,260,530,70
BUTALEJA,2024,270,250,520,70
BUTALEJA,2025,260,240,500,70
BUTAMBALA,2015,120,160,280,70
BUTAMBALA,2016,120,140,260,70
BUTAMBALA,2017,110,140,250,70
BUTAMBALA,2018,120,150,270,70
BUTAMBALA,2019,130,160,290,70
BUTAMBALA,2020,130,180,310,70
BUTAMBALA,2021,140,190,330,70
BUTAMBALA,2022,150,190,340,70
BUTAMBALA,2023,140,180,320,70
BUTAMBALA,2024,130,170,300,70
BUTAMBALA,2025,130,160,290,70
BUTEBO,2015,110,120,230,70
BUTEBO,2016,110,110,220,70
BUTEBO,2017,110,110,220,70
BUTEBO,2018,110,110,220,70
BUTEBO,2019,120,120,240,70
BUTEBO,2020,130,130,260,70
BUTEBO,2021,130,150,280,70
BUTEBO,2022,130,150,280,70
BUTEBO,2023,140,140,280,70
BUTEBO,2024,130,140,270,70
BUTEBO,2025,120,120,240,70
BUVUMA,2015,70,70,140,70
BUVUMA,2016,80,80,160,70
BUVUMA,2017,80,80,160,70
BUVUMA,2018,90,90,180,70
BUVUMA,2019,90,90,180,70
BUVUMA,2020,100,100,200,70
BUVUMA,2021,100,110,210,70
BUVUMA,2022,110,110,220,70
BUVUMA,2023,110,120,230,70
BUVUMA,2024,120,130,250,70
BUVUMA,2025,130,140,270,70
BUYENDE,2015,290,310,600,70
BUYENDE,2016,280,290,570,70
BUYENDE,2017,290,300,590,70
BUYENDE,2018,310,320,630,70
BUYENDE,2019,340,360,700,70
BUYENDE,2020,370,410,780,70
BUYENDE,2021,400,450,850,70
BUYENDE,2022,420,470,890,70
BUYENDE,2023,420,470,890,70
BUYENDE,2024,420,460,880,70
BUYENDE,2025,410,430,840,70
DOKOLO,2015,180,430,610,70
DOKOLO,2016,180,440,620,70
DOKOLO,2017,190,450,640,70
DOKOLO,2018,190,460,650,70
DOKOLO,2019,200,470,670,70
DOKOLO,2020,200,490,690,70
DOKOLO,2021,210,500,710,70
DOKOLO,2022,210,510,720,70
DOKOLO,2023,220,520,740,70
DOKOLO,2024,230,540,770,70
DOKOLO,2025,230,550,780,70
GOMBA,2015,150,200,350,70
GOMBA,2016,150,190,340,70
GOMBA,2017,150,180,330,70
GOMBA,2018,150,190,340,70
GOMBA,2019,160,210,370,70
GOMBA,2020,170,230,400,70
GOMBA,2021,180,250,430,70
GOMBA,2022,190,250,440,70
GOMBA,2023,180,240,420,70
GOMBA,2024,180,230,410,70
GOMBA,2025,170,200,370,70
GULU,2015,210,560,770,70
GULU,2016,220,580,800,70
GULU,2017,230,590,820,70
GULU,2018,230,610,840,70
GULU,2019,240,630,870,70
GULU,2020,250,640,890,70
GULU,2021,250,660,910,70
GULU,2022,260,680,940,70
GULU,2023,270,700,970,70
GULU,2024,270,710,980,70
GULU,2025,280,730,1010,70
HOIMA,2015,280,530,810,70
HOIMA,2016,290,550,840,70
HOIMA,2017,300,570,870,70
HOIMA,2018,310,590,900,70
HOIMA,2019,320,610,930,70
HOIMA,2020,330,630,960,70
HOIMA,2021,350,650,1000,70
HOIMA,2022,360,670,1030,70
HOIMA,2023,370,690,1060,70
HOIMA,2024,380,720,1100,70
HOIMA,2025,390,740,1130,70
IBANDA,2015,320,640,960,70
IBANDA,2016,330,660,990,70
IBANDA,2017,330,670,1000,70
IBANDA,2018,340,680,1020,70
IBANDA,2019,350,690,1040,70
IBANDA,2020,350,700,1050,70
IBANDA,2021,360,710,1070,70
IBANDA,2022,370,720,1090,70
IBANDA,2023,370,740,1110,70
IBANDA,2024,380,750,1130,70
IBANDA,2025,380,760,1140,70
IGANGA,2015,280,340,620,70
IGANGA,2016,270,320,590,70
IGANGA,2017,280,320,600,70
IGANGA,2018,290,340,630,70
IGANGA,2019,310,370,680,70
IGANGA,2020,340,420,760,70
IGANGA,2021,360,450,810,70
IGANGA,2022,380,470,850,70
IGANGA,2023,380,470,850,70
IGANGA,2024,360,440,800,70
IGANGA,2025,350,410,760,70
ISINGIRO,2015,560,1090,1650,70
ISINGIRO,2016,590,1130,1720,70
ISINGIRO,2017,610,1170,1780,70
ISINGIRO,2018,630,1210,1840,70
ISINGIRO,2019,650,1260,1910,70
ISINGIRO,2020,680,1300,1980,70
ISINGIRO,2021,700,1340,2040,70
ISINGIRO,2022,720,1380,2100,70
ISINGIRO,2023,750,1430,2180,70
ISINGIRO,2024,770,1470,2240,70
ISINGIRO,2025,800,1520,2320,70
JINJA,2015,510,1070,1580,70
JINJA,2016,520,1090,1610,70
JINJA,2017,530,1100,1630,70
JINJA,2018,540,1120,1660,70
JINJA,2019,540,1140,1680,70
JINJA,2020,550,1150,1700,70
JINJA,2021,560,1170,1730,70
JINJA,2022,570,1180,1750,70
JINJA,2023,580,1200,1780,70
JINJA,2024,580,1210,1790,70
JINJA,2025,590,1220,1810,70
KAABONG,2015,140,90,230,70
KAABONG,2016,140,100,240,70
KAABONG,2017,140,100,240,70
KAABONG,2018,150,100,250,70
KAABONG,2019,150,100,250,70
KAABONG,2020,160,110,270,70
KAABONG,2021,160,110,270,70
KAABONG,2022,170,110,280,70
KAABONG,2023,170,120,290,70
KAABONG,2024,170,120,290,70
KAABONG,2025,180,120,300,70
KABALE,2015,320,650,970,70
KABALE,2016,330,660,990,70
KABALE,2017,340,670,1010,70
KABALE,2018,340,680,1020,70
KABALE,2019,350,680,1030,70
KABALE,2020,350,690,1040,70
KABALE,2021,350,700,1050,70
KABALE,2022,360,700,1060,70
KABALE,2023,360,710,1070,70
KABALE,2024,370,720,1090,70
KABALE,2025,370,720,1090,70
KABAROLE,2015,450,790,1240,70
KABAROLE,2016,460,810,1270,70
KABAROLE,2017,480,830,1310,70
KABAROLE,2018,490,850,1340,70
KABAROLE,2019,500,860,1360,70
KABAROLE,2020,510,880,1390,70
KABAROLE,2021,520,900,1420,70
KABAROLE,2022,530,910,1440,70
KABAROLE,2023,540,930,1470,70
KABAROLE,2024,540,950,1490,70
KABAROLE,2025,550,960,1510,70
KABERAMAIDO,2015,60,80,140,70
KABERAMAIDO,2016,50,80,130,70
KABERAMAIDO,2017,60,80,140,70
KABERAMAIDO,2018,60,90,150,70
KABERAMAIDO,2019,70,100,170,70
KABERAMAIDO,2020,70,110,180,70
KABERAMAIDO,2021,80,120,200,70
KABERAMAIDO,2022,80,130,210,70
KABERAMAIDO,2023,80,130,210,70
KABERAMAIDO,2024,80,120,200,70
KABERAMAIDO,2025,80,110,190,70
KAGADI,2015,290,590,880,70
KAGADI,2016,300,610,910,70
KAGADI,2017,310,630,940,70
KAGADI,2018,320,650,970,70
KAGADI,2019,340,680,1020,70
KAGADI,2020,350,700,1050,70
KAGADI,2021,360,720,1080,70
KAGADI,2022,370,750,1120,70
KAGADI,2023,380,770,1150,70
KAGADI,2024,400,790,1190,70
KAGADI,2025,410,820,1230,70
KAKUMIRO,2015,230,450,680,70
KAKUMIRO,2016,250,490,740,70
KAKUMIRO,2017,270,530,800,70
KAKUMIRO,2018,300,570,870,70
KAKUMIRO,2019,320,620,940,70
KAKUMIRO,2020,350,670,1020,70
KAKUMIRO,2021,380,730,1110,70
KAKUMIRO,2022,410,790,1200,70
KAKUMIRO,2023,450,850,1300,70
KAKUMIRO,2024,480,920,1400,70
KAKUMIRO,2025,520,990,1510,70
KALAKI,2015,130,270,400,70
KALAKI,2016,140,290,430,70
KALAKI,2017,140,300,440,70
KALAKI,2018,150,310,460,70
KALAKI,2019,150,320,470,70
KALAKI,2020,160,330,490,70
KALAKI,2021,170,340,510,70
KALAKI,2022,170,360,530,70
KALAKI,2023,180,370,550,70
KALAKI,2024,190,380,570,70
KALAKI,2025,190,400,590,70
KALANGALA,2015,20,30,50,70
KALANGALA,2016,20,30,50,70
KALANGALA,2017,30,30,60,70
KALANGALA,2018,30,30,60,70
KALANGALA,2019,30,30,60,70
KALANGALA,2020,30,30,60,70
KALANGALA,2021,30,30,60,70
KALANGALA,2022,30,30,60,70
KALANGALA,2023,30,40,70,70
KALANGALA,2024,30,40,70,70
KALANGALA,2025,30,40,70,70
KALIRO,2015,250,240,490,70
KALIRO,2016,250,220,470,70
KALIRO,2017,260,220,480,70
KALIRO,2018,270,240,510,70
KALIRO,2019,290,270,560,70
KALIRO,2020,310,300,610,70
KALIRO,2021,340,320,660,70
KALIRO,2022,350,340,690,70
KALIRO,2023,350,340,690,70
KALIRO,2024,350,320,670,70
KALIRO,2025,340,300,640,70
KALUNGU,2015,160,270,430,70
KALUNGU,2016,150,250,400,70
KALUNGU,2017,160,240,400,70
KALUNGU,2018,160,250,410,70
KALUNGU,2019,170,270,440,70
KALUNGU,2020,180,290,470,70
KALUNGU,2021,190,320,510,70
KALUNGU,2022,190,320,510,70
KALUNGU,2023,180,310,490,70
KALUNGU,2024,180,290,470,70
KALUNGU,2025,170,260,430,70
KAMPALA,2015,630,1230,1860,70
KAMPALA,2016,640,1250,1890,70
KAMPALA,2017,650,1270,1920,70
KAMPALA,2018,660,1300,1960,70
KAMPALA,2019,680,1320,2000,70
KAMPALA,2020,690,1350,2040,70
KAMPALA,2021,700,1370,2070,70
KAMPALA,2022,710,1390,2100,70
KAMPALA,2023,720,1420,2140,70
KAMPALA,2024,730,1440,2170,70
KAMPALA,2025,740,1460,2200,70
KAMULI,2015,470,580,1050,70
KAMULI,2016,450,540,990,70
KAMULI,2017,450,530,980,70
KAMULI,2018,470,560,1030,70
KAMULI,2019,510,620,1130,70
KAMULI,2020,550,690,1240,70
KAMULI,2021,580,740,1320,70
KAMULI,2022,600,770,1370,70
KAMULI,2023,590,750,1340,70
KAMULI,2024,580,710,1290,70
KAMULI,2025,550,650,1200,70
KAMWENGE,2015,270,520,790,70
KAMWENGE,2016,280,540,820,70
KAMWENGE,2017,290,560,850,70
KAMWENGE,2018,300,580,880,70
KAMWENGE,2019,320,600,920,70
KAMWENGE,2020,330,620,950,70
KAMWENGE,2021,340,640,980,70
KAMWENGE,2022,350,660,1010,70
KAMWENGE,2023,370,680,1050,70
KAMWENGE,2024,380,710,1090,70
KAMWENGE,2025,390,730,1120,70
KANUNGU,2015,310,610,920,70
KANUNGU,2016,310,620,930,70
KANUNGU,2017,320,630,950,70
KANUNGU,2018,320,640,960,70
KANUNGU,2019,330,650,980,70
KANUNGU,2020,330,660,990,70
KANUNGU,2021,340,670,1010,70
KANUNGU,2022,340,680,1020,70
KANUNGU,2023,350,680,1030,70
KANUNGU,2024,350,690,1040,70
KANUNGU,2025,360,700,1060,70
KAPCHORWA,2015,110,200,310,70
KAPCHORWA,2016,110,200,310,70
KAPCHORWA,2017,110,210,320,70
KAPCHORWA,2018,120,210,330,70
KAPCHORWA,2019,120,220,340,70
KAPCHORWA,2020,120,220,340,70
KAPCHORWA,2021,130,230,360,70
KAPCHORWA,2022,130,240,370,70
KAPCHORWA,2023,130,240,370,70
KAPCHORWA,2024,140,250,390,70
KAPCHORWA,2025,140,250,390,70
KAPELEBYONG,2015,60,110,170,70
KAPELEBYONG,2016,60,100,160,70
KAPELEBYONG,2017,60,100,160,70
KAPELEBYONG,2018,60,110,170,70
KAPELEBYONG,2019,70,120,190,70
KAPELEBYONG,2020,70,130,200,70
KAPELEBYONG,2021,70,140,210,70
KAPELEBYONG,2022,80,150,230,70
KAPELEBYONG,2023,80,150,230,70
KAPELEBYONG,2024,70,140,210,70
KAPELEBYONG,2025,70,130,200,70
KASESE,2015,630,740,1370,70
KASESE,2016,610,680,1290,70
KASESE,2017,610,670,1280,70
KASESE,2018,640,710,1350,70
KASESE,2019,680,780,1460,70
KASESE,2020,730,870,1600,70
KASESE,2021,780,940,1720,70
KASESE,2022,800,970,1770,70
KASESE,2023,790,950,1740,70
KASESE,2024,770,890,1660,70
KASESE,2025,740,820,1560,70
KASSANDA,2015,380,620,1000,70
KASSANDA,2016,390,630,1020,70
KASSANDA,2017,400,640,1040,70
KASSANDA,2018,410,660,1070,70
KASSANDA,2019,420,670,1090,70
KASSANDA,2020,430,680,1110,70
KASSANDA,2021,450,700,1150,70
KASSANDA,2022,460,710,1170,70
KASSANDA,2023,470,720,1190,70
KASSANDA,2024,480,740,1220,70
KASSANDA,2025,490,750,1240,70
KATAKWI,2015,180,240,420,70
KATAKWI,2016,170,220,390,70
KATAKWI,2017,170,220,390,70
KATAKWI,2018,180,230,410,70
KATAKWI,2019,190,260,450,70
KATAKWI,2020,210,290,500,70
KATAKWI,2021,220,310,530,70
KATAKWI,2022,230,320,550,70
KATAKWI,2023,230,320,550,70
KATAKWI,2024,220,300,520,70
KATAKWI,2025,220,280,500,70
KAYUNGA,2015,370,490,860,70
KAYUNGA,2016,360,450,810,70
KAYUNGA,2017,360,440,800,70
KAYUNGA,2018,370,460,830,70
KAYUNGA,2019,390,500,890,70
KAYUNGA,2020,420,560,980,70
KAYUNGA,2021,450,600,1050,70
KAYUNGA,2022,460,610,1070,70
KAYUNGA,2023,450,600,1050,70
KAYUNGA,2024,440,560,1000,70
KAYUNGA,2025,410,520,930,70
KAZO,2015,310,470,780,70
KAZO,2016,320,490,810,70
KAZO,2017,330,500,830,70
KAZO,2018,340,520,860,70
KAZO,2019,360,540,900,70
KAZO,2020,370,560,930,70
KAZO,2021,380,580,960,70
KAZO,2022,400,590,990,70
KAZO,2023,410,610,1020,70
KAZO,2024,420,630,1050,70
KAZO,2025,440,650,1090,70
KIBAALE,2015,100,190,290,70
KIBAALE,2016,110,210,320,70
KIBAALE,2017,120,220,340,70
KIBAALE,2018,120,230,350,70
KIBAALE,2019,130,240,370,70
KIBAALE,2020,140,260,400,70
KIBAALE,2021,150,270,420,70
KIBAALE,2022,160,290,450,70
KIBAALE,2023,170,300,470,70
KIBAALE,2024,180,320,500,70
KIBAALE,2025,190,340,530,70
KIBOGA,2015,140,150,290,70
KIBOGA,2016,130,140,270,70
KIBOGA,2017,130,140,270,70
KIBOGA,2018,140,150,290,70
KIBOGA,2019,140,160,300,70
KIBOGA,2020,160,180,340,70
KIBOGA,2021,170,190,360,70
KIBOGA,2022,170,200,370,70
KIBOGA,2023,170,200,370,70
KIBOGA,2024,170,190,360,70
KIBOGA,2025,160,170,330,70
KIBUKU,2015,210,200,410,70
KIBUKU,2016,200,190,390,70
KIBUKU,2017,210,180,390,70
KIBUKU,2018,220,200,420,70
KIBUKU,2019,240,220,460,70
KIBUKU,2020,260,250,510,70
KIBUKU,2021,280,280,560,70
KIBUKU,2022,290,290,580,70
KIBUKU,2023,290,290,580,70
KIBUKU,2024,290,270,560,70
KIBUKU,2025,280,260,540,70
KIKUUBE,2015,290,410,700,70
KIKUUBE,2016,310,430,740,70
KIKUUBE,2017,320,460,780,70
KIKUUBE,2018,340,480,820,70
KIKUUBE,2019,360,500,860,70
KIKUUBE,2020,380,530,910,70
KIKUUBE,2021,390,550,940,70
KIKUUBE,2022,410,580,990,70
KIKUUBE,2023,440,610,1050,70
KIKUUBE,2024,460,640,1100,70
KIKUUBE,2025,480,660,1140,70
KIRUHURA,2015,280,410,690,70
KIRUHURA,2016,290,430,720,70
KIRUHURA,2017,300,440,740,70
KIRUHURA,2018,310,460,770,70
KIRUHURA,2019,320,470,790,70
KIRUHURA,2020,340,490,830,70
KIRUHURA,2021,350,510,860,70
KIRUHURA,2022,360,520,880,70
KIRUHURA,2023,370,540,910,70
KIRUHURA,2024,380,560,940,70
KIRUHURA,2025,400,570,970,70
KIRYANDONGO,2015,130,170,300,70
KIRYANDONGO,2016,120,160,280,70
KIRYANDONGO,2017,130,160,290,70
KIRYANDONGO,2018,130,170,300,70
KIRYANDONGO,2019,140,190,330,70
KIRYANDONGO,2020,150,210,360,70
KIRYANDONGO,2021,160,220,380,70
KIRYANDONGO,2022,170,240,410,70
KIRYANDONGO,2023,170,230,400,70
KIRYANDONGO,2024,160,220,380,70
KIRYANDONGO,2025,160,200,360,70
KISORO,2015,270,390,660,70
KISORO,2016,260,360,620,70
KISORO,2017,260,360,620,70
KISORO,2018,270,380,650,70
KISORO,2019,280,410,690,70
KISORO,2020,300,460,760,70
KISORO,2021,320,500,820,70
KISORO,2022,330,510,840,70
KISORO,2023,320,500,820,70
KISORO,2024,310,470,780,70
KISORO,2025,290,430,720,70
KITAGWENDA,2015,200,310,510,70
KITAGWENDA,2016,200,320,520,70
KITAGWENDA,2017,210,330,540,70
KITAGWENDA,2018,220,340,560,70
KITAGWENDA,2019,230,350,580,70
KITAGWENDA,2020,240,360,600,70
KITAGWENDA,2021,250,380,630,70
KITAGWENDA,2022,260,390,650,70
KITAGWENDA,2023,270,400,670,70
KITAGWENDA,2024,270,410,680,70
KITAGWENDA,2025,280,430,710,70
KITGUM,2015,120,200,320,70
KITGUM,2016,120,180,300,70
KITGUM,2017,120,180,300,70
KITGUM,2018,120,190,310,70
KITGUM,2019,130,210,340,70
KITGUM,2020,140,230,370,70
KITGUM,2021,150,240,390,70
KITGUM,2022,150,250,400,70
KITGUM,2023,150,240,390,70
KITGUM,2024,150,230,380,70
KITGUM,2025,140,210,350,70
KOBOKO,2015,100,120,220,70
KOBOKO,2016,100,120,220,70
KOBOKO,2017,100,120,220,70
KOBOKO,2018,110,130,240,70
KOBOKO,2019,120,140,260,70
KOBOKO,2020,120,160,280,70
KOBOKO,2021,130,170,300,70
KOBOKO,2022,140,180,320,70
KOBOKO,2023,140,180,320,70
KOBOKO,2024,140,170,310,70
KOBOKO,2025,140,160,300,70
KOLE,2015,210,480,690,70
KOLE,2016,220,500,720,70
KOLE,2017,220,510,730,70
KOLE,2018,230,530,760,70
KOLE,2019,240,540,780,70
KOLE,2020,250,550,800,70
KOLE,2021,250,570,820,70
KOLE,2022,260,580,840,70
KOLE,2023,270,600,870,70
KOLE,2024,280,610,890,70
KOLE,2025,280,630,910,70
KOTIDO,2015,160,100,260,70
KOTIDO,2016,160,90,250,70
KOTIDO,2017,160,90,250,70
KOTIDO,2018,160,90,250,70
KOTIDO,2019,180,100,280,70
KOTIDO,2020,190,110,300,70
KOTIDO,2021,210,130,340,70
KOTIDO,2022,210,130,340,70
KOTIDO,2023,210,130,340,70
KOTIDO,2024,200,120,320,70
KOTIDO,2025,190,110,300,70
KUMI,2015,200,300,500,70
KUMI,2016,200,280,480,70
KUMI,2017,200,280,480,70
KUMI,2018,210,290,500,70
KUMI,2019,220,320,540,70
KUMI,2020,240,360,600,70
KUMI,2021,260,390,650,70
KUMI,2022,270,410,680,70
KUMI,2023,260,400,660,70
KUMI,2024,260,390,650,70
KUMI,2025,250,360,610,70
KWANIA,2015,160,330,490,70
KWANIA,2016,170,340,510,70
KWANIA,2017,170,350,520,70
KWANIA,2018,180,360,540,70
KWANIA,2019,180,370,550,70
KWANIA,2020,190,380,570,70
KWANIA,2021,190,390,580,70
KWANIA,2022,200,400,600,70
KWANIA,2023,200,410,610,70
KWANIA,2024,210,420,630,70
KWANIA,2025,220,430,650,70
KWEEN,2015,90,110,200,70
KWEEN,2016,90,110,200,70
KWEEN,2017,90,120,210,70
KWEEN,2018,100,120,220,70
KWEEN,2019,100,120,220,70
KWEEN,2020,100,120,220,70
KWEEN,2021,110,130,240,70
KWEEN,2022,110,130,240,70
KWEEN,2023,110,130,240,70
KWEEN,2024,110,140,250,70
KWEEN,2025,120,140,260,70
KYANKWANZI,2015,280,390,670,70
KYANKWANZI,2016,300,400,700,70
KYANKWANZI,2017,310,420,730,70
KYANKWANZI,2018,330,440,770,70
KYANKWANZI,2019,340,460,800,70
KYANKWANZI,2020,360,480,840,70
KYANKWANZI,2021,380,510,890,70
KYANKWANZI,2022,400,530,930,70
KYANKWANZI,2023,410,550,960,70
KYANKWANZI,2024,430,570,1000,70
KYANKWANZI,2025,450,600,1050,70
KYEGEGWA,2015,300,490,790,70
KYEGEGWA,2016,320,530,850,70
KYEGEGWA,2017,350,570,920,70
KYEGEGWA,2018,380,610,990,70
KYEGEGWA,2019,410,660,1070,70
KYEGEGWA,2020,440,710,1150,70
KYEGEGWA,2021,480,770,1250,70
KYEGEGWA,2022,520,820,1340,70
KYEGEGWA,2023,560,890,1450,70
KYEGEGWA,2024,600,950,1550,70
KYEGEGWA,2025,640,1020,1660,70
KYENJOJO,2015,490,880,1370,70
KYENJOJO,2016,510,910,1420,70
KYENJOJO,2017,530,950,1480,70
KYENJOJO,2018,550,980,1530,70
KYENJOJO,2019,580,1020,1600,70
KYENJOJO,2020,600,1050,1650,70
KYENJOJO,2021,620,1090,1710,70
KYENJOJO,2022,650,1130,1780,70
KYENJOJO,2023,670,1160,1830,70
KYENJOJO,2024,690,1200,1890,70
KYENJOJO,2025,720,1240,1960,70
KYOTERA,2015,200,270,470,70
KYOTERA,2016,190,250,440,70
KYOTERA,2017,190,240,430,70
KYOTERA,2018,200,250,450,70
KYOTERA,2019,200,280,480,70
KYOTERA,2020,220,310,530,70
KYOTERA,2021,240,330,570,70
KYOTERA,2022,240,340,580,70
KYOTERA,2023,240,320,560,70
KYOTERA,2024,220,300,520,70
KYOTERA,2025,220,280,500,70
KARENGA,2015,40,60,100,70
KARENGA,2016,40,60,100,70
KARENGA,2017,40,60,100,70
KARENGA,2018,40,60,100,70
KARENGA,2019,40,70,110,70
KARENGA,2020,50,70,120,70
KARENGA,2021,50,70,120,70
KARENGA,2022,50,70,120,70
KARENGA,2023,50,70,120,70
KARENGA,2024,50,70,120,70
KARENGA,2025,50,70,120,70
LAMWO,2015,80,170,250,70
LAMWO,2016,70,160,230,70
LAMWO,2017,80,160,240,70
LAMWO,2018,80,160,240,70
LAMWO,2019,80,180,260,70
LAMWO,2020,90,200,290,70
LAMWO,2021,90,210,300,70
LAMWO,2022,90,220,310,70
LAMWO,2023,90,210,300,70
LAMWO,2024,80,200,280,70
LAMWO,2025,80,180,260,70
LIRA,2015,290,800,1090,70
LIRA,2016,300,830,1130,70
LIRA,2017,300,850,1150,70
LIRA,2018,310,870,1180,70
LIRA,2019,320,900,1220,70
LIRA,2020,330,920,1250,70
LIRA,2021,340,950,1290,70
LIRA,2022,350,970,1320,70
LIRA,2023,360,990,1350,70
LIRA,2024,360,1020,1380,70
LIRA,2025,370,1040,1410,70
LUUKA,2015,210,290,500,70
LUUKA,2016,200,270,470,70
LUUKA,2017,200,260,460,70
LUUKA,2018,210,270,480,70
LUUKA,2019,230,300,530,70
LUUKA,2020,240,330,570,70
LUUKA,2021,250,360,610,70
LUUKA,2022,260,370,630,70
LUUKA,2023,260,370,630,70
LUUKA,2024,250,340,590,70
LUUKA,2025,240,310,550,70
LUWERO,2015,340,490,830,70
LUWERO,2016,340,450,790,70
LUWERO,2017,330,440,770,70
LUWERO,2018,350,470,820,70
LUWERO,2019,370,520,890,70
LUWERO,2020,400,570,970,70
LUWERO,2021,430,620,1050,70
LUWERO,2022,440,640,1080,70
LUWERO,2023,440,630,1070,70
LUWERO,2024,430,590,1020,70
LUWERO,2025,400,540,940,70
LWENGO,2015,200,300,500,70
LWENGO,2016,200,280,480,70
LWENGO,2017,190,270,460,70
LWENGO,2018,200,280,480,70
LWENGO,2019,210,310,520,70
LWENGO,2020,220,340,560,70
LWENGO,2021,230,360,590,70
LWENGO,2022,240,370,610,70
LWENGO,2023,230,350,580,70
LWENGO,2024,220,330,550,70
LWENGO,2025,210,300,510,70
LYANTONDE,2015,70,80,150,70
LYANTONDE,2016,70,80,150,70
LYANTONDE,2017,70,80,150,70
LYANTONDE,2018,70,80,150,70
LYANTONDE,2019,80,90,170,70
LYANTONDE,2020,90,100,190,70
LYANTONDE,2021,90,110,200,70
LYANTONDE,2022,100,110,210,70
LYANTONDE,2023,90,110,200,70
LYANTONDE,2024,100,110,210,70
LYANTONDE,2025,90,100,190,70
MANAFWA,2015,190,310,500,70
MANAFWA,2016,190,310,500,70
MANAFWA,2017,200,320,520,70
MANAFWA,2018,200,330,530,70
MANAFWA,2019,210,340,550,70
MANAFWA,2020,210,340,550,70
MANAFWA,2021,210,350,560,70
MANAFWA,2022,220,360,580,70
MANAFWA,2023,220,360,580,70
MANAFWA,2024,230,370,600,70
MANAFWA,2025,230,380,610,70
MARACHA,2015,200,440,640,70
MARACHA,2016,200,450,650,70
MARACHA,2017,200,460,660,70
MARACHA,2018,210,470,680,70
MARACHA,2019,210,470,680,70
MARACHA,2020,220,480,700,70
MARACHA,2021,220,490,710,70
MARACHA,2022,230,500,730,70
MARACHA,2023,230,510,740,70
MARACHA,2024,230,520,750,70
MARACHA,2025,240,520,760,70
MASAKA,2015,200,320,520,70
MASAKA,2016,180,300,480,70
MASAKA,2017,180,260,440,70
MASAKA,2018,170,250,420,70
MASAKA,2019,170,240,410,70
MASAKA,2020,170,260,430,70
MASAKA,2021,190,280,470,70
MASAKA,2022,200,310,510,70
MASAKA,2023,220,330,550,70
MASAKA,2024,220,350,570,70
MASAKA,2025,210,330,540,70
MASINDI,2015,310,520,830,70
MASINDI,2016,320,540,860,70
MASINDI,2017,330,550,880,70
MASINDI,2018,340,570,910,70
MASINDI,2019,350,580,930,70
MASINDI,2020,350,590,940,70
MASINDI,2021,360,610,970,70
MASINDI,2022,370,620,990,70
MASINDI,2023,380,640,1020,70
MASINDI,2024,390,650,1040,70
MASINDI,2025,400,670,1070,70
MAYUGE,2015,380,420,800,70
MAYUGE,2016,370,390,760,70
MAYUGE,2017,380,390,770,70
MAYUGE,2018,390,410,800,70
MAYUGE,2019,420,460,880,70
MAYUGE,2020,460,510,970,70
MAYUGE,2021,490,560,1050,70
MAYUGE,2022,510,580,1090,70
MAYUGE,2023,510,580,1090,70
MAYUGE,2024,500,550,1050,70
MAYUGE,2025,480,510,990,70
MBALE,2015,420,460,880,70
MBALE,2016,410,430,840,70
MBALE,2017,410,430,840,70
MBALE,2018,430,460,890,70
MBALE,2019,460,510,970,70
MBALE,2020,500,570,1070,70
MBALE,2021,530,630,1160,70
MBALE,2022,550,660,1210,70
MBALE,2023,550,650,1200,70
MBALE,2024,540,620,1160,70
MBALE,2025,510,580,1090,70
MBARARA,2015,370,860,1230,70
MBARARA,2016,380,880,1260,70
MBARARA,2017,390,900,1290,70
MBARARA,2018,400,920,1320,70
MBARARA,2019,410,930,1340,70
MBARARA,2020,410,950,1360,70
MBARARA,2021,420,970,1390,70
MBARARA,2022,430,990,1420,70
MBARARA,2023,440,1010,1450,70
MBARARA,2024,450,1030,1480,70
MBARARA,2025,460,1040,1500,70
MITOOMA,2015,340,590,930,70
MITOOMA,2016,350,600,950,70
MITOOMA,2017,350,610,960,70
MITOOMA,2018,360,610,970,70
MITOOMA,2019,360,620,980,70
MITOOMA,2020,360,620,980,70
MITOOMA,2021,370,630,1000,70
MITOOMA,2022,370,630,1000,70
MITOOMA,2023,370,630,1000,70
MITOOMA,2024,380,640,1020,70
MITOOMA,2025,380,640,1020,70
MITYANA,2015,280,370,650,70
MITYANA,2016,270,340,610,70
MITYANA,2017,270,330,600,70
MITYANA,2018,280,350,630,70
MITYANA,2019,300,380,680,70
MITYANA,2020,320,420,740,70
MITYANA,2021,340,450,790,70
MITYANA,2022,350,470,820,70
MITYANA,2023,340,450,790,70
MITYANA,2024,330,430,760,70
MITYANA,2025,320,390,710,70
MOROTO,2015,100,80,180,70
MOROTO,2016,90,80,170,70
MOROTO,2017,90,70,160,70
MOROTO,2018,100,80,180,70
MOROTO,2019,100,90,190,70
MOROTO,2020,100,100,200,70
MOROTO,2021,110,110,220,70
MOROTO,2022,120,110,230,70
MOROTO,2023,120,110,230,70
MOROTO,2024,110,100,210,70
MOROTO,2025,110,100,210,70
MOYO,2015,90,180,270,70
MOYO,2016,90,190,280,70
MOYO,2017,90,190,280,70
MOYO,2018,90,190,280,70
MOYO,2019,100,200,300,70
MOYO,2020,100,200,300,70
MOYO,2021,100,210,310,70
MOYO,2022,100,210,310,70
MOYO,2023,100,210,310,70
MOYO,2024,110,220,330,70
MOYO,2025,110,220,330,70
MPIGI,2015,230,290,520,70
MPIGI,2016,220,260,480,70
MPIGI,2017,220,260,480,70
MPIGI,2018,230,270,500,70
MPIGI,2019,240,300,540,70
MPIGI,2020,260,330,590,70
MPIGI,2021,280,360,640,70
MPIGI,2022,290,380,670,70
MPIGI,2023,280,370,650,70
MPIGI,2024,270,350,620,70
MPIGI,2025,260,320,580,70
MUBENDE,2015,250,270,520,70
MUBENDE,2016,250,260,510,70
MUBENDE,2017,260,260,520,70
MUBENDE,2018,280,280,560,70
MUBENDE,2019,300,320,620,70
MUBENDE,2020,340,360,700,70
MUBENDE,2021,370,410,780,70
MUBENDE,2022,390,430,820,70
MUBENDE,2023,390,430,820,70
MUBENDE,2024,400,420,820,70
MUBENDE,2025,390,400,790,70
MUKONO,2015,440,600,1040,70
MUKONO,2016,420,560,980,70
MUKONO,2017,420,550,970,70
MUKONO,2018,450,590,1040,70
MUKONO,2019,470,650,1120,70
MUKONO,2020,510,730,1240,70
MUKONO,2021,540,790,1330,70
MUKONO,2022,560,820,1380,70
MUKONO,2023,560,810,1370,70
MUKONO,2024,540,770,1310,70
MUKONO,2025,520,720,1240,70
NABILATUK,2015,70,80,150,70
NABILATUK,2016,70,80,150,70
NABILATUK,2017,70,80,150,70
NABILATUK,2018,70,90,160,70
NABILATUK,2019,80,100,180,70
NABILATUK,2020,90,110,200,70
NABILATUK,2021,100,120,220,70
NABILATUK,2022,100,130,230,70
NABILATUK,2023,110,130,240,70
NABILATUK,2024,110,120,230,70
NABILATUK,2025,110,120,230,70
NAKAPIRIPIRIT,2015,110,90,200,70
NAKAPIRIPIRIT,2016,110,90,200,70
NAKAPIRIPIRIT,2017,110,90,200,70
NAKAPIRIPIRIT,2018,120,90,210,70
NAKAPIRIPIRIT,2019,130,100,230,70
NAKAPIRIPIRIT,2020,150,120,270,70
NAKAPIRIPIRIT,2021,160,130,290,70
NAKAPIRIPIRIT,2022,160,140,300,70
NAKAPIRIPIRIT,2023,160,140,300,70
NAKAPIRIPIRIT,2024,170,130,300,70
NAKAPIRIPIRIT,2025,160,120,280,70
NAKASEKE,2015,300,590,890,70
NAKASEKE,2016,310,600,910,70
NAKASEKE,2017,320,620,940,70
NAKASEKE,2018,330,630,960,70
NAKASEKE,2019,340,650,990,70
NAKASEKE,2020,350,660,1010,70
NAKASEKE,2021,360,680,1040,70
NAKASEKE,2022,380,690,1070,70
NAKASEKE,2023,390,700,1090,70
NAKASEKE,2024,400,720,1120,70
NAKASEKE,2025,410,730,1140,70
NAKASONGOLA,2015,150,150,300,70
NAKASONGOLA,2016,140,140,280,70
NAKASONGOLA,2017,150,130,280,70
NAKASONGOLA,2018,150,140,290,70
NAKASONGOLA,2019,170,160,330,70
NAKASONGOLA,2020,170,180,350,70
NAKASONGOLA,2021,190,190,380,70
NAKASONGOLA,2022,190,200,390,70
NAKASONGOLA,2023,190,190,380,70
NAKASONGOLA,2024,190,180,370,70
NAKASONGOLA,2025,180,170,350,70
NAMAYINGO,2015,100,110,210,70
NAMAYINGO,2016,90,100,190,70
NAMAYINGO,2017,90,100,190,70
NAMAYINGO,2018,100,100,200,70
NAMAYINGO,2019,100,120,220,70
NAMAYINGO,2020,110,130,240,70
NAMAYINGO,2021,110,130,240,70
NAMAYINGO,2022,120,140,260,70
NAMAYINGO,2023,110,130,240,70
NAMAYINGO,2024,110,120,230,70
NAMAYINGO,2025,110,120,230,70
NAMISINDWA,2015,250,400,650,70
NAMISINDWA,2016,260,410,670,70
NAMISINDWA,2017,260,420,680,70
NAMISINDWA,2018,270,430,700,70
NAMISINDWA,2019,280,440,720,70
NAMISINDWA,2020,280,450,730,70
NAMISINDWA,2021,290,460,750,70
NAMISINDWA,2022,300,470,770,70
NAMISINDWA,2023,310,480,790,70
NAMISINDWA,2024,310,480,790,70
NAMISINDWA,2025,320,490,810,70
NAMUTUMBA,2015,260,270,530,70
NAMUTUMBA,2016,260,260,520,70
NAMUTUMBA,2017,260,250,510,70
NAMUTUMBA,2018,270,270,540,70
NAMUTUMBA,2019,290,300,590,70
NAMUTUMBA,2020,320,330,650,70
NAMUTUMBA,2021,340,370,710,70
NAMUTUMBA,2022,360,380,740,70
NAMUTUMBA,2023,360,380,740,70
NAMUTUMBA,2024,350,360,710,70
NAMUTUMBA,2025,340,340,680,70
NAPAK,2015,150,170,320,70
NAPAK,2016,140,160,300,70
NAPAK,2017,140,160,300,70
NAPAK,2018,140,170,310,70
NAPAK,2019,150,180,330,70
NAPAK,2020,160,200,360,70
NAPAK,2021,180,220,400,70
NAPAK,2022,180,230,410,70
NAPAK,2023,170,220,390,70
NAPAK,2024,170,210,380,70
NAPAK,2025,160,190,350,70
NEBBI,2015,180,500,680,70
NEBBI,2016,180,510,690,70
NEBBI,2017,190,530,720,70
NEBBI,2018,190,540,730,70
NEBBI,2019,200,560,760,70
NEBBI,2020,210,570,780,70
NEBBI,2021,210,590,800,70
NEBBI,2022,220,600,820,70
NEBBI,2023,230,620,850,70
NEBBI,2024,230,630,860,70
NEBBI,2025,240,650,890,70
NGORA,2015,140,240,380,70
NGORA,2016,130,230,360,70
NGORA,2017,140,220,360,70
NGORA,2018,140,240,380,70
NGORA,2019,150,260,410,70
NGORA,2020,160,290,450,70
NGORA,2021,180,320,500,70
NGORA,2022,180,330,510,70
NGORA,2023,180,320,500,70
NGORA,2024,170,300,470,70
NGORA,2025,170,280,450,70
NTOROKO,2015,60,70,130,70
NTOROKO,2016,50,70,120,70
NTOROKO,2017,50,60,110,70
NTOROKO,2018,50,70,120,70
NTOROKO,2019,60,70,130,70
NTOROKO,2020,60,80,140,70
NTOROKO,2021,70,90,160,70
NTOROKO,2022,70,90,160,70
NTOROKO,2023,70,90,160,70
NTOROKO,2024,70,90,160,70
NTOROKO,2025,60,80,140,70
NTUNGAMO,2015,730,1380,2110,70
NTUNGAMO,2016,740,1410,2150,70
NTUNGAMO,2017,760,1430,2190,70
NTUNGAMO,2018,780,1460,2240,70
NTUNGAMO,2019,790,1490,2280,70
NTUNGAMO,2020,810,1510,2320,70
NTUNGAMO,2021,820,1540,2360,70
NTUNGAMO,2022,840,1560,2400,70
NTUNGAMO,2023,850,1580,2430,70
NTUNGAMO,2024,870,1610,2480,70
NTUNGAMO,2025,880,1630,2510,70
NWOYA,2015,130,330,460,70
NWOYA,2016,140,370,510,70
NWOYA,2017,150,400,550,70
NWOYA,2018,170,440,610,70
NWOYA,2019,190,490,680,70
NWOYA,2020,210,540,750,70
NWOYA,2021,230,590,820,70
NWOYA,2022,250,650,900,70
NWOYA,2023,280,710,990,70
NWOYA,2024,300,780,1080,70
NWOYA,2025,330,860,1190,70
OBONGI,2015,30,30,60,70
OBONGI,2016,30,20,50,70
OBONGI,2017,30,20,50,70
OBONGI,2018,30,30,60,70
OBONGI,2019,30,30,60,70
OBONGI,2020,30,30,60,70
OBONGI,2021,40,30,70,70
OBONGI,2022,40,40,80,70
OBONGI,2023,40,30,70,70
OBONGI,2024,40,40,80,70
OBONGI,2025,40,30,70,70
OMORO,2015,80,140,220,70
OMORO,2016,80,130,210,70
OMORO,2017,80,130,210,70
OMORO,2018,80,140,220,70
OMORO,2019,90,160,250,70
OMORO,2020,100,180,280,70
OMORO,2021,110,190,300,70
OMORO,2022,120,200,320,70
OMORO,2023,110,200,310,70
OMORO,2024,110,190,300,70
OMORO,2025,110,180,290,70
OTUKE,2015,100,290,390,70
OTUKE,2016,100,300,400,70
OTUKE,2017,110,320,430,70
OTUKE,2018,110,330,440,70
OTUKE,2019,120,340,460,70
OTUKE,2020,120,360,480,70
OTUKE,2021,130,370,500,70
OTUKE,2022,130,390,520,70
OTUKE,2023,140,400,540,70
OTUKE,2024,140,420,560,70
OTUKE,2025,150,440,590,70
OYAM,2015,250,600,850,70
OYAM,2016,260,620,880,70
OYAM,2017,270,630,900,70
OYAM,2018,280,650,930,70
OYAM,2019,290,670,960,70
OYAM,2020,290,690,980,70
OYAM,2021,300,710,1010,70
OYAM,2022,310,730,1040,70
OYAM,2023,320,750,1070,70
OYAM,2024,330,760,1090,70
OYAM,2025,340,780,1120,70
PADER,2015,80,180,260,70
PADER,2016,80,170,250,70
PADER,2017,80,160,240,70
PADER,2018,80,170,250,70
PADER,2019,80,190,270,70
PADER,2020,90,210,300,70
PADER,2021,100,220,320,70
PADER,2022,100,230,330,70
PADER,2023,90,230,320,70
PADER,2024,100,210,310,70
PADER,2025,90,190,280,70
PAKWACH,2015,160,310,470,70
PAKWACH,2016,160,320,480,70
PAKWACH,2017,170,330,500,70
PAKWACH,2018,180,340,520,70
PAKWACH,2019,190,350,540,70
PAKWACH,2020,190,360,550,70
PAKWACH,2021,200,380,580,70
PAKWACH,2022,210,390,600,70
PAKWACH,2023,220,400,620,70
PAKWACH,2024,230,420,650,70
PAKWACH,2025,230,430,660,70
PALLISA,2015,250,280,530,70
PALLISA,2016,250,270,520,70
PALLISA,2017,250,270,520,70
PALLISA,2018,270,290,560,70
PALLISA,2019,290,320,610,70
PALLISA,2020,320,370,690,70
PALLISA,2021,350,400,750,70
PALLISA,2022,360,430,790,70
PALLISA,2023,370,420,790,70
PALLISA,2024,360,410,770,70
PALLISA,2025,360,390,750,70
RAKAI,2015,230,290,520,70
RAKAI,2016,220,270,490,70
RAKAI,2017,220,260,480,70
RAKAI,2018,230,280,510,70
RAKAI,2019,250,310,560,70
RAKAI,2020,270,340,610,70
RAKAI,2021,290,370,660,70
RAKAI,2022,300,380,680,70
RAKAI,2023,290,370,660,70
RAKAI,2024,290,350,640,70
RAKAI,2025,270,330,600,70
RUBANDA,2015,280,460,740,70
RUBANDA,2016,280,460,740,70
RUBANDA,2017,280,470,750,70
RUBANDA,2018,290,470,760,70
RUBANDA,2019,290,470,760,70
RUBANDA,2020,300,480,780,70
RUBANDA,2021,300,480,780,70
RUBANDA,2022,300,480,780,70
RUBANDA,2023,300,480,780,70
RUBANDA,2024,310,490,800,70
RUBANDA,2025,310,490,800,70
RUBIRIZI,2015,200,350,550,70
RUBIRIZI,2016,200,350,550,70
RUBIRIZI,2017,210,360,570,70
RUBIRIZI,2018,210,370,580,70
RUBIRIZI,2019,210,370,580,70
RUBIRIZI,2020,220,380,600,70
RUBIRIZI,2021,220,390,610,70
RUBIRIZI,2022,220,390,610,70
RUBIRIZI,2023,230,400,630,70
RUBIRIZI,2024,230,400,630,70
RUBIRIZI,2025,240,410,650,70
RUKIGA,2015,160,280,440,70
RUKIGA,2016,170,290,460,70
RUKIGA,2017,170,290,460,70
RUKIGA,2018,170,290,460,70
RUKIGA,2019,170,290,460,70
RUKIGA,2020,170,290,460,70
RUKIGA,2021,170,300,470,70
RUKIGA,2022,170,300,470,70
RUKIGA,2023,180,300,480,70
RUKIGA,2024,180,300,480,70
RUKIGA,2025,180,300,480,70
RUKUNGIRI,2015,490,950,1440,70
RUKUNGIRI,2016,500,960,1460,70
RUKUNGIRI,2017,500,970,1470,70
RUKUNGIRI,2018,510,980,1490,70
RUKUNGIRI,2019,520,990,1510,70
RUKUNGIRI,2020,520,990,1510,70
RUKUNGIRI,2021,530,1000,1530,70
RUKUNGIRI,2022,530,1010,1540,70
RUKUNGIRI,2023,530,1020,1550,70
RUKUNGIRI,2024,540,1020,1560,70
RUKUNGIRI,2025,540,1030,1570,70
RWAMPARA,2015,170,320,490,70
RWAMPARA,2016,180,330,510,70
RWAMPARA,2017,180,330,510,70
RWAMPARA,2018,190,340,530,70
RWAMPARA,2019,190,350,540,70
RWAMPARA,2020,190,350,540,70
RWAMPARA,2021,200,360,560,70
RWAMPARA,2022,200,370,570,70
RWAMPARA,2023,210,370,580,70
RWAMPARA,2024,210,380,590,70
RWAMPARA,2025,210,390,600,70
SERERE,2015,240,330,570,70
SERERE,2016,240,310,550,70
SERERE,2017,250,310,560,70
SERERE,2018,260,330,590,70
SERERE,2019,280,370,650,70
SERERE,2020,310,420,730,70
SERERE,2021,330,470,800,70
SERERE,2022,350,490,840,70
SERERE,2023,350,490,840,70
SERERE,2024,340,470,810,70
SERERE,2025,330,440,770,70
SHEEMA,2015,390,730,1120,70
SHEEMA,2016,400,730,1130,70
SHEEMA,2017,400,740,1140,70
SHEEMA,2018,410,750,1160,70
SHEEMA,2019,410,760,1170,70
SHEEMA,2020,420,760,1180,70
SHEEMA,2021,420,770,1190,70
SHEEMA,2022,430,780,1210,70
SHEEMA,2023,430,780,1210,70
SHEEMA,2024,430,790,1220,70
SHEEMA,2025,440,790,1230,70
SIRONKO,2015,450,780,1230,70
SIRONKO,2016,460,800,1260,70
SIRONKO,2017,470,820,1290,70
SIRONKO,2018,480,830,1310,70
SIRONKO,2019,490,850,1340,70
SIRONKO,2020,500,870,1370,70
SIRONKO,2021,510,880,1390,70
SIRONKO,2022,530,900,1430,70
SIRONKO,2023,540,910,1450,70
SIRONKO,2024,550,930,1480,70
SIRONKO,2025,560,940,1500,70
SOROTI,2015,210,320,530,70
SOROTI,2016,210,300,510,70
SOROTI,2017,210,300,510,70
SOROTI,2018,230,330,560,70
SOROTI,2019,240,360,600,70
SOROTI,2020,270,410,680,70
SOROTI,2021,290,450,740,70
SOROTI,2022,300,470,770,70
SOROTI,2023,300,460,760,70
SOROTI,2024,300,440,740,70
SOROTI,2025,280,410,690,70
SSEMBABULE,2015,210,260,470,70
SSEMBABULE,2016,200,240,440,70
SSEMBABULE,2017,200,240,440,70
SSEMBABULE,2018,210,250,460,70
SSEMBABULE,2019,230,280,510,70
SSEMBABULE,2020,240,310,550,70
SSEMBABULE,2021,260,340,600,70
SSEMBABULE,2022,270,350,620,70
SSEMBABULE,2023,270,340,610,70
SSEMBABULE,2024,260,320,580,70
SSEMBABULE,2025,250,300,550,70
TORORO,2015,630,1080,1710,70
TORORO,2016,650,1110,1760,70
TORORO,2017,670,1140,1810,70
TORORO,2018,680,1170,1850,70
TORORO,2019,700,1200,1900,70
TORORO,2020,720,1220,1940,70
TORORO,2021,740,1250,1990,70
TORORO,2022,750,1280,2030,70
TORORO,2023,770,1310,2080,70
TORORO,2024,790,1330,2120,70
TORORO,2025,800,1360,2160,70
WAKISO,2015,1230,2670,3900,70
WAKISO,2016,1310,2850,4160,70
WAKISO,2017,1400,3040,4440,70
WAKISO,2018,1490,3250,4740,70
WAKISO,2019,1590,3470,5060,70
WAKISO,2020,1690,3700,5390,70
WAKISO,2021,1800,3940,5740,70
WAKISO,2022,1920,4200,6120,70
WAKISO,2023,2040,4470,6510,70
WAKISO,2024,2170,4760,6930,70
WAKISO,2025,2300,5060,7360,70
YUMBE,2015,290,230,520,70
YUMBE,2016,290,220,510,70
YUMBE,2017,300,220,520,70
YUMBE,2018,320,240,560,70
YUMBE,2019,350,280,630,70
YUMBE,2020,390,320,710,70
YUMBE,2021,430,350,780,70
YUMBE,2022,450,380,830,70
YUMBE,2023,460,390,850,70
YUMBE,2024,450,380,830,70
YUMBE,2025,450,360,810,70
ZOMBO,2015,190,590,780,70
ZOMBO,2016,200,600,800,70
ZOMBO,2017,210,620,830,70
ZOMBO,2018,210,640,850,70
ZOMBO,2019,220,650,870,70
ZOMBO,2020,220,670,890,70
ZOMBO,2021,230,690,920,70
ZOMBO,2022,240,710,950,70
ZOMBO,2023,240,720,960,70
ZOMBO,2024,250,740,990,70
ZOMBO,2025,260,760,1020,70
MADI OKOLLO,2015,160,280,440,70
MADI OKOLLO,2016,170,280,450,70
MADI OKOLLO,2017,170,290,460,70
MADI OKOLLO,2018,180,300,480,70
MADI OKOLLO,2019,180,310,490,70
MADI OKOLLO,2020,190,320,510,70
MADI OKOLLO,2021,190,320,510,70
MADI OKOLLO,2022,200,330,530,70
MADI OKOLLO,2023,200,340,540,70
MADI OKOLLO,2024,210,350,560,70
MADI OKOLLO,2025,210,350,560,70
ABIM,2015,50,100,150,71
ABIM,2016,60,90,150,71
ABIM,2017,50,80,130,71
ABIM,2018,50,70,120,71
ABIM,2019,50,90,140,71
ABIM,2020,70,100,170,71
ABIM,2021,70,110,180,71
ABIM,2022,80,130,210,71
ABIM,2023,90,140,230,71
ABIM,2024,90,150,240,71
ABIM,2025,80,140,220,71
ADJUMANI,2015,70,120,190,71
ADJUMANI,2016,70,120,190,71
ADJUMANI,2017,70,120,190,71
ADJUMANI,2018,70,120,190,71
ADJUMANI,2019,70,120,190,71
ADJUMANI,2020,70,120,190,71
ADJUMANI,2021,80,120,200,71
ADJUMANI,2022,80,120,200,71
ADJUMANI,2023,80,120,200,71
ADJUMANI,2024,80,130,210,71
ADJUMANI,2025,80,130,210,71
AGAGO,2015,90,120,210,71
AGAGO,2016,90,130,220,71
AGAGO,2017,100,130,230,71
AGAGO,2018,100,130,230,71
AGAGO,2019,100,130,230,71
AGAGO,2020,100,140,240,71
AGAGO,2021,100,140,240,71
AGAGO,2022,100,140,240,71
AGAGO,2023,100,140,240,71
AGAGO,2024,110,140,250,71
AGAGO,2025,110,150,260,71
ALEBTONG,2015,190,230,420,71
ALEBTONG,2016,190,220,410,71
ALEBTONG,2017,170,200,370,71
ALEBTONG,2018,170,190,360,71
ALEBTONG,2019,190,220,410,71
ALEBTONG,2020,200,230,430,71
ALEBTONG,2021,200,250,450,71
ALEBTONG,2022,230,290,520,71
ALEBTONG,2023,230,290,520,71
ALEBTONG,2024,240,280,520,71
ALEBTONG,2025,230,280,510,71
AMOLATAR,2015,80,120,200,71
AMOLATAR,2016,90,120,210,71
AMOLATAR,2017,100,130,230,71
AMOLATAR,2018,100,140,240,71
AMOLATAR,2019,110,160,270,71
AMOLATAR,2020,120,170,290,71
AMOLATAR,2021,110,160,270,71
AMOLATAR,2022,110,160,270,71
AMOLATAR,2023,100,140,240,71
AMOLATAR,2024,110,130,240,71
AMOLATAR,2025,110,130,240,71
AMUDAT,2015,60,40,100,71
AMUDAT,2016,60,30,90,71
AMUDAT,2017,50,30,80,71
AMUDAT,2018,50,30,80,71
AMUDAT,2019,50,30,80,71
AMUDAT,2020,60,30,90,71
AMUDAT,2021,70,40,110,71
AMUDAT,2022,80,60,140,71
AMUDAT,2023,80,60,140,71
AMUDAT,2024,70,60,130,71
AMUDAT,2025,70,50,120,71
AMURIA,2015,140,160,300,71
AMURIA,2016,130,140,270,71
AMURIA,2017,130,140,270,71
AMURIA,2018,130,130,260,71
AMURIA,2019,130,140,270,71
AMURIA,2020,150,170,320,71
AMURIA,2021,160,180,340,71
AMURIA,2022,180,190,370,71
AMURIA,2023,180,210,390,71
AMURIA,2024,180,200,380,71
AMURIA,2025,180,190,370,71
AMURU,2015,90,140,230,71
AMURU,2016,90,120,210,71
AMURU,2017,90,110,200,71
AMURU,2018,90,100,190,71
AMURU,2019,90,110,200,71
AMURU,2020,100,130,230,71
AMURU,2021,100,140,240,71
AMURU,2022,110,150,260,71
AMURU,2023,120,160,280,71
AMURU,2024,120,150,270,71
AMURU,2025,110,140,250,71
APAC,2015,100,110,210,71
APAC,2016,100,110,210,71
APAC,2017,100,120,220,71
APAC,2018,110,120,230,71
APAC,2019,110,130,240,71
APAC,2020,110,130,240,71
APAC,2021,120,130,250,71
APAC,2022,120,140,260,71
APAC,2023,130,140,270,71
APAC,2024,130,150,280,71
APAC,2025,130,150,280,71
ARUA,2015,340,330,670,71
ARUA,2016,350,340,690,71
ARUA,2017,360,350,710,71
ARUA,2018,370,360,730,71
ARUA,2019,380,370,750,71
ARUA,2020,390,380,770,71
ARUA,2021,400,390,790,71
ARUA,2022,410,390,800,71
ARUA,2023,420,400,820,71
ARUA,2024,430,410,840,71
ARUA,2025,440,420,860,71
BUDAKA,2015,200,290,490,71
BUDAKA,2016,190,280,470,71
BUDAKA,2017,190,250,440,71
BUDAKA,2018,180,250,430,71
BUDAKA,2019,200,260,460,71
BUDAKA,2020,210,300,510,71
BUDAKA,2021,230,320,550,71
BUDAKA,2022,240,360,600,71
BUDAKA,2023,260,370,630,71
BUDAKA,2024,250,370,620,71
BUDAKA,2025,250,360,610,71
BUDUDA,2015,120,250,370,71
BUDUDA,2016,130,220,350,71
BUDUDA,2017,120,220,340,71
BUDUDA,2018,130,210,340,71
BUDUDA,2019,130,230,360,71
BUDUDA,2020,140,270,410,71
BUDUDA,2021,160,290,450,71
BUDUDA,2022,170,330,500,71
BUDUDA,2023,180,350,530,71
BUDUDA,2024,180,340,520,71
BUDUDA,2025,180,330,510,71
BUGIRI,2015,290,310,600,71
BUGIRI,2016,280,280,560,71
BUGIRI,2017,280,260,540,71
BUGIRI,2018,290,270,560,71
BUGIRI,2019,290,280,570,71
BUGIRI,2020,320,320,640,71
BUGIRI,2021,350,360,710,71
BUGIRI,2022,380,400,780,71
BUGIRI,2023,400,410,810,71
BUGIRI,2024,400,410,810,71
BUGIRI,2025,390,400,790,71
BUGWERI,2015,80,120,200,71
BUGWERI,2016,90,100,190,71
BUGWERI,2017,80,110,190,71
BUGWERI,2018,80,100,180,71
BUGWERI,2019,80,110,190,71
BUGWERI,2020,80,120,200,71
BUGWERI,2021,90,130,220,71
BUGWERI,2022,110,130,240,71
BUGWERI,2023,110,160,270,71
BUGWERI,2024,100,150,250,71
BUGWERI,2025,100,140,240,71
BUHWEJU,2015,60,50,110,71
BUHWEJU,2016,60,50,110,71
BUHWEJU,2017,60,50,110,71
BUHWEJU,2018,60,50,110,71
BUHWEJU,2019,60,50,110,71
BUHWEJU,2020,70,50,120,71
BUHWEJU,2021,70,50,120,71
BUHWEJU,2022,70,60,130,71
BUHWEJU,2023,70,60,130,71
BUHWEJU,2024,70,60,130,71
BUHWEJU,2025,80,60,140,71
BUIKWE,2015,230,270,500,71
BUIKWE,2016,230,240,470,71
BUIKWE,2017,210,230,440,71
BUIKWE,2018,210,220,430,71
BUIKWE,2019,230,230,460,71
BUIKWE,2020,240,270,510,71
BUIKWE,2021,250,290,540,71
BUIKWE,2022,270,310,580,71
BUIKWE,2023,270,310,580,71
BUIKWE,2024,270,320,590,71
BUIKWE,2025,270,290,560,71
BUKEDEA,2015,170,270,440,71
BUKEDEA,2016,160,240,400,71
BUKEDEA,2017,160,230,390,71
BUKEDEA,2018,160,220,380,71
BUKEDEA,2019,170,250,420,71
BUKEDEA,2020,200,280,480,71
BUKEDEA,2021,200,310,510,71
BUKEDEA,2022,230,340,570,71
BUKEDEA,2023,230,370,600,71
BUKEDEA,2024,240,350,590,71
BUKEDEA,2025,240,350,590,71
BUKOMANSIMBI,2015,120,230,350,71
BUKOMANSIMBI,2016,110,210,320,71
BUKOMANSIMBI,2017,110,190,300,71
BUKOMANSIMBI,2018,110,180,290,71
BUKOMANSIMBI,2019,110,190,300,71
BUKOMANSIMBI,2020,110,200,310,71
BUKOMANSIMBI,2021,120,220,340,71
BUKOMANSIMBI,2022,120,230,350,71
BUKOMANSIMBI,2023,120,230,350,71
BUKOMANSIMBI,2024,120,220,340,71
BUKOMANSIMBI,2025,110,210,320,71
BUKWO,2015,40,50,90,71
BUKWO,2016,50,50,100,71
BUKWO,2017,50,50,100,71
BUKWO,2018,50,60,110,71
BUKWO,2019,60,60,120,71
BUKWO,2020,60,60,120,71
BUKWO,2021,60,70,130,71
BUKWO,2022,60,70,130,71
BUKWO,2023,70,70,140,71
BUKWO,2024,70,80,150,71
BUKWO,2025,70,80,150,71
BULAMBULI,2015,190,220,410,71
BULAMBULI,2016,190,190,380,71
BULAMBULI,2017,170,190,360,71
BULAMBULI,2018,180,180,360,71
BULAMBULI,2019,200,200,400,71
BULAMBULI,2020,210,220,430,71
BULAMBULI,2021,230,250,480,71
BULAMBULI,2022,260,290,550,71
BULAMBULI,2023,270,290,560,71
BULAMBULI,2024,270,300,570,71
BULAMBULI,2025,270,290,560,71
BULIISA,2015,30,30,60,71
BULIISA,2016,30,30,60,71
BULIISA,2017,30,40,70,71
BULIISA,2018,30,40,70,71
BULIISA,2019,30,40,70,71
BULIISA,2020,40,40,80,71
BULIISA,2021,40,40,80,71
BULIISA,2022,40,40,80,71
BULIISA,2023,40,50,90,71
BULIISA,2024,40,50,90,71
BULIISA,2025,50,50,100,71
BUNDIBUGYO,2015,150,120,270,71
BUNDIBUGYO,2016,140,120,260,71
BUNDIBUGYO,2017,150,110,260,71
BUNDIBUGYO,2018,140,100,240,71
BUNDIBUGYO,2019,150,110,260,71
BUNDIBUGYO,2020,170,120,290,71
BUNDIBUGYO,2021,180,140,320,71
BUNDIBUGYO,2022,180,150,330,71
BUNDIBUGYO,2023,200,160,360,71
BUNDIBUGYO,2024,190,150,340,71
BUNDIBUGYO,2025,180,140,320,71
BUNYANGABU,2015,110,180,290,71
BUNYANGABU,2016,110,150,260,71
BUNYANGABU,2017,110,140,250,71
BUNYANGABU,2018,110,130,240,71
BUNYANGABU,2019,110,140,250,71
BUNYANGABU,2020,110,170,280,71
BUNYANGABU,2021,130,180,310,71
BUNYANGABU,2022,140,190,330,71
BUNYANGABU,2023,140,190,330,71
BUNYANGABU,2024,130,190,320,71
BUNYANGABU,2025,130,170,300,71
BUSHENYI,2015,160,160,320,71
BUSHENYI,2016,160,170,330,71
BUSHENYI,2017,160,170,330,71
BUSHENYI,2018,160,170,330,71
BUSHENYI,2019,160,170,330,71
BUSHENYI,2020,170,170,340,71
BUSHENYI,2021,170,170,340,71
BUSHENYI,2022,170,170,340,71
BUSHENYI,2023,170,180,350,71
BUSHENYI,2024,170,180,350,71
BUSHENYI,2025,170,180,350,71
BUSIA,2015,280,350,630,71
BUSIA,2016,260,330,590,71
BUSIA,2017,250,290,540,71
BUSIA,2018,250,300,550,71
BUSIA,2019,270,310,580,71
BUSIA,2020,290,350,640,71
BUSIA,2021,310,400,710,71
BUSIA,2022,330,420,750,71
BUSIA,2023,350,450,800,71
BUSIA,2024,340,430,770,71
BUSIA,2025,340,410,750,71
BUTALEJA,2015,190,270,460,71
BUTALEJA,2016,190,260,450,71
BUTALEJA,2017,170,230,400,71
BUTALEJA,2018,180,240,420,71
BUTALEJA,2019,190,250,440,71
BUTALEJA,2020,210,280,490,71
BUTALEJA,2021,220,320,540,71
BUTALEJA,2022,240,340,580,71
BUTALEJA,2023,260,370,630,71
BUTALEJA,2024,250,350,600,71
BUTALEJA,2025,250,350,600,71
BUTAMBALA,2015,60,80,140,71
BUTAMBALA,2016,60,70,130,71
BUTAMBALA,2017,50,60,110,71
BUTAMBALA,2018,50,60,110,71
BUTAMBALA,2019,50,60,110,71
BUTAMBALA,2020,60,70,130,71
BUTAMBALA,2021,60,70,130,71
BUTAMBALA,2022,60,80,140,71
BUTAMBALA,2023,60,80,140,71
BUTAMBALA,2024,60,70,130,71
BUTAMBALA,2025,60,70,130,71
BUTEBO,2015,90,120,210,71
BUTEBO,2016,90,100,190,71
BUTEBO,2017,80,90,170,71
BUTEBO,2018,80,100,180,71
BUTEBO,2019,80,110,190,71
BUTEBO,2020,100,120,220,71
BUTEBO,2021,100,130,230,71
BUTEBO,2022,110,130,240,71
BUTEBO,2023,110,140,250,71
BUTEBO,2024,100,130,230,71
BUTEBO,2025,100,120,220,71
BUVUMA,2015,30,10,40,71
BUVUMA,2016,30,20,50,71
BUVUMA,2017,30,20,50,71
BUVUMA,2018,30,20,50,71
BUVUMA,2019,30,20,50,71
BUVUMA,2020,40,20,60,71
BUVUMA,2021,40,20,60,71
BUVUMA,2022,40,20,60,71
BUVUMA,2023,40,20,60,71
BUVUMA,2024,40,30,70,71
BUVUMA,2025,50,30,80,71
BUYENDE,2015,230,230,460,71
BUYENDE,2016,210,220,430,71
BUYENDE,2017,210,200,410,71
BUYENDE,2018,220,210,430,71
BUYENDE,2019,230,230,460,71
BUYENDE,2020,250,250,500,71
BUYENDE,2021,280,290,570,71
BUYENDE,2022,300,330,630,71
BUYENDE,2023,320,330,650,71
BUYENDE,2024,330,340,670,71
BUYENDE,2025,310,330,640,71
DOKOLO,2015,110,100,210,71
DOKOLO,2016,110,110,220,71
DOKOLO,2017,110,110,220,71
DOKOLO,2018,120,110,230,71
DOKOLO,2019,120,110,230,71
DOKOLO,2020,120,120,240,71
DOKOLO,2021,130,120,250,71
DOKOLO,2022,130,120,250,71
DOKOLO,2023,140,130,270,71
DOKOLO,2024,140,130,270,71
DOKOLO,2025,140,130,270,71
GOMBA,2015,170,160,330,71
GOMBA,2016,160,140,300,71
GOMBA,2017,150,120,270,71
GOMBA,2018,160,120,280,71
GOMBA,2019,160,120,280,71
GOMBA,2020,170,130,300,71
GOMBA,2021,180,140,320,71
GOMBA,2022,180,150,330,71
GOMBA,2023,200,170,370,71
GOMBA,2024,190,170,360,71
GOMBA,2025,180,160,340,71
GULU,2015,80,100,180,71
GULU,2016,80,100,180,71
GULU,2017,80,100,180,71
GULU,2018,80,110,190,71
GULU,2019,90,110,200,71
GULU,2020,90,110,200,71
GULU,2021,90,120,210,71
GULU,2022,90,120,210,71
GULU,2023,100,120,220,71
GULU,2024,100,130,230,71
GULU,2025,100,130,230,71
HOIMA,2015,160,150,310,71
HOIMA,2016,170,150,320,71
HOIMA,2017,170,160,330,71
HOIMA,2018,180,160,340,71
HOIMA,2019,190,170,360,71
HOIMA,2020,190,180,370,71
HOIMA,2021,200,180,380,71
HOIMA,2022,210,190,400,71
HOIMA,2023,210,190,400,71
HOIMA,2024,220,200,420,71
HOIMA,2025,230,200,430,71
IBANDA,2015,130,130,260,71
IBANDA,2016,130,130,260,71
IBANDA,2017,130,130,260,71
IBANDA,2018,130,130,260,71
IBANDA,2019,140,140,280,71
IBANDA,2020,140,140,280,71
IBANDA,2021,140,140,280,71
IBANDA,2022,140,140,280,71
IBANDA,2023,150,140,290,71
IBANDA,2024,150,150,300,71
IBANDA,2025,150,150,300,71
IGANGA,2015,200,230,430,71
IGANGA,2016,190,210,400,71
IGANGA,2017,190,200,390,71
IGANGA,2018,180,190,370,71
IGANGA,2019,200,200,400,71
IGANGA,2020,210,230,440,71
IGANGA,2021,230,250,480,71
IGANGA,2022,240,270,510,71
IGANGA,2023,240,290,530,71
IGANGA,2024,250,280,530,71
IGANGA,2025,240,280,520,71
ISINGIRO,2015,220,220,440,71
ISINGIRO,2016,230,230,460,71
ISINGIRO,2017,240,230,470,71
ISINGIRO,2018,240,240,480,71
ISINGIRO,2019,250,250,500,71
ISINGIRO,2020,260,260,520,71
ISINGIRO,2021,270,270,540,71
ISINGIRO,2022,280,280,560,71
ISINGIRO,2023,290,290,580,71
ISINGIRO,2024,300,290,590,71
ISINGIRO,2025,310,300,610,71
JINJA,2015,140,130,270,71
JINJA,2016,150,130,280,71
JINJA,2017,150,130,280,71
JINJA,2018,150,130,280,71
JINJA,2019,150,130,280,71
JINJA,2020,160,140,300,71
JINJA,2021,160,140,300,71
JINJA,2022,160,140,300,71
JINJA,2023,160,140,300,71
JINJA,2024,170,140,310,71
JINJA,2025,170,140,310,71
KAABONG,2015,50,60,110,71
KAABONG,2016,50,60,110,71
KAABONG,2017,50,70,120,71
KAABONG,2018,50,70,120,71
KAABONG,2019,50,70,120,71
KAABONG,2020,50,70,120,71
KAABONG,2021,60,70,130,71
KAABONG,2022,60,70,130,71
KAABONG,2023,60,70,130,71
KAABONG,2024,60,80,140,71
KAABONG,2025,60,80,140,71
KABALE,2015,130,190,320,71
KABALE,2016,130,190,320,71
KABALE,2017,130,200,330,71
KABALE,2018,130,200,330,71
KABALE,2019,140,200,340,71
KABALE,2020,140,200,340,71
KABALE,2021,140,210,350,71
KABALE,2022,140,210,350,71
KABALE,2023,140,210,350,71
KABALE,2024,140,210,350,71
KABALE,2025,150,210,360,71
KABAROLE,2015,140,170,310,71
KABAROLE,2016,150,170,320,71
KABAROLE,2017,150,180,330,71
KABAROLE,2018,150,180,330,71
KABAROLE,2019,160,180,340,71
KABAROLE,2020,160,190,350,71
KABAROLE,2021,160,190,350,71
KABAROLE,2022,170,190,360,71
KABAROLE,2023,170,200,370,71
KABAROLE,2024,170,200,370,71
KABAROLE,2025,180,210,390,71
KABERAMAIDO,2015,120,140,260,71
KABERAMAIDO,2016,110,120,230,71
KABERAMAIDO,2017,110,110,220,71
KABERAMAIDO,2018,120,120,240,71
KABERAMAIDO,2019,120,120,240,71
KABERAMAIDO,2020,130,130,260,71
KABERAMAIDO,2021,150,160,310,71
KABERAMAIDO,2022,150,170,320,71
KABERAMAIDO,2023,170,170,340,71
KABERAMAIDO,2024,160,190,350,71
KABERAMAIDO,2025,150,170,320,71
KAGADI,2015,120,120,240,71
KAGADI,2016,120,130,250,71
KAGADI,2017,130,130,260,71
KAGADI,2018,130,140,270,71
KAGADI,2019,140,140,280,71
KAGADI,2020,140,150,290,71
KAGADI,2021,150,150,300,71
KAGADI,2022,150,160,310,71
KAGADI,2023,160,160,320,71
KAGADI,2024,160,170,330,71
KAGADI,2025,170,170,340,71
KAKUMIRO,2015,100,100,200,71
KAKUMIRO,2016,110,100,210,71
KAKUMIRO,2017,120,110,230,71
KAKUMIRO,2018,130,120,250,71
KAKUMIRO,2019,140,130,270,71
KAKUMIRO,2020,160,140,300,71
KAKUMIRO,2021,170,160,330,71
KAKUMIRO,2022,180,170,350,71
KAKUMIRO,2023,200,180,380,71
KAKUMIRO,2024,220,200,420,71
KAKUMIRO,2025,230,210,440,71
KALAKI,2015,90,80,170,71
KALAKI,2016,90,80,170,71
KALAKI,2017,90,90,180,71
KALAKI,2018,100,90,190,71
KALAKI,2019,100,90,190,71
KALAKI,2020,110,100,210,71
KALAKI,2021,110,100,210,71
KALAKI,2022,110,110,220,71
KALAKI,2023,120,110,230,71
KALAKI,2024,120,110,230,71
KALAKI,2025,130,120,250,71
KALANGALA,2015,20,10,30,71
KALANGALA,2016,20,10,30,71
KALANGALA,2017,20,10,30,71
KALANGALA,2018,20,10,30,71
KALANGALA,2019,20,10,30,71
KALANGALA,2020,20,10,30,71
KALANGALA,2021,30,10,40,71
KALANGALA,2022,30,10,40,71
KALANGALA,2023,30,10,40,71
KALANGALA,2024,30,10,40,71
KALANGALA,2025,30,10,40,71
KALIRO,2015,190,220,410,71
KALIRO,2016,170,190,360,71
KALIRO,2017,170,170,340,71
KALIRO,2018,170,180,350,71
KALIRO,2019,190,190,380,71
KALIRO,2020,200,220,420,71
KALIRO,2021,200,230,430,71
KALIRO,2022,230,250,480,71
KALIRO,2023,230,270,500,71
KALIRO,2024,240,260,500,71
KALIRO,2025,230,260,490,71
KALUNGU,2015,150,250,400,71
KALUNGU,2016,140,240,380,71
KALUNGU,2017,130,220,350,71
KALUNGU,2018,130,210,340,71
KALUNGU,2019,130,220,350,71
KALUNGU,2020,140,230,370,71
KALUNGU,2021,160,250,410,71
KALUNGU,2022,170,270,440,71
KALUNGU,2023,170,270,440,71
KALUNGU,2024,160,260,420,71
KALUNGU,2025,150,240,390,71
KAMPALA,2015,240,370,610,71
KAMPALA,2016,240,370,610,71
KAMPALA,2017,250,380,630,71
KAMPALA,2018,250,390,640,71
KAMPALA,2019,260,390,650,71
KAMPALA,2020,260,400,660,71
KAMPALA,2021,270,410,680,71
KAMPALA,2022,270,410,680,71
KAMPALA,2023,280,420,700,71
KAMPALA,2024,280,430,710,71
KAMPALA,2025,290,430,720,71
KAMULI,2015,330,390,720,71
KAMULI,2016,300,340,640,71
KAMULI,2017,300,330,630,71
KAMULI,2018,290,310,600,71
KAMULI,2019,310,340,650,71
KAMULI,2020,330,360,690,71
KAMULI,2021,350,410,760,71
KAMULI,2022,380,440,820,71
KAMULI,2023,380,470,850,71
KAMULI,2024,380,450,830,71
KAMULI,2025,370,430,800,71
KAMWENGE,2015,110,100,210,71
KAMWENGE,2016,110,110,220,71
KAMWENGE,2017,120,110,230,71
KAMWENGE,2018,120,110,230,71
KAMWENGE,2019,130,120,250,71
KAMWENGE,2020,130,120,250,71
KAMWENGE,2021,140,120,260,71
KAMWENGE,2022,140,130,270,71
KAMWENGE,2023,150,130,280,71
KAMWENGE,2024,150,140,290,71
KAMWENGE,2025,160,140,300,71
KANUNGU,2015,110,120,230,71
KANUNGU,2016,120,130,250,71
KANUNGU,2017,120,130,250,71
KANUNGU,2018,120,130,250,71
KANUNGU,2019,120,130,250,71
KANUNGU,2020,120,130,250,71
KANUNGU,2021,130,140,270,71
KANUNGU,2022,130,140,270,71
KANUNGU,2023,130,140,270,71
KANUNGU,2024,130,140,270,71
KANUNGU,2025,130,140,270,71
KAPCHORWA,2015,60,60,120,71
KAPCHORWA,2016,60,60,120,71
KAPCHORWA,2017,70,60,130,71
KAPCHORWA,2018,70,60,130,71
KAPCHORWA,2019,70,70,140,71
KAPCHORWA,2020,70,70,140,71
KAPCHORWA,2021,70,70,140,71
KAPCHORWA,2022,80,70,150,71
KAPCHORWA,2023,80,70,150,71
KAPCHORWA,2024,80,70,150,71
KAPCHORWA,2025,80,80,160,71
KAPELEBYONG,2015,50,80,130,71
KAPELEBYONG,2016,60,70,130,71
KAPELEBYONG,2017,50,60,110,71
KAPELEBYONG,2018,50,70,120,71
KAPELEBYONG,2019,50,80,130,71
KAPELEBYONG,2020,60,80,140,71
KAPELEBYONG,2021,60,90,150,71
KAPELEBYONG,2022,60,100,160,71
KAPELEBYONG,2023,60,100,160,71
KAPELEBYONG,2024,70,90,160,71
KAPELEBYONG,2025,70,90,160,71
KASESE,2015,280,330,610,71
KASESE,2016,260,290,550,71
KASESE,2017,250,260,510,71
KASESE,2018,250,270,520,71
KASESE,2019,250,280,530,71
KASESE,2020,280,300,580,71
KASESE,2021,290,340,630,71
KASESE,2022,320,360,680,71
KASESE,2023,320,390,710,71
KASESE,2024,330,370,700,71
KASESE,2025,310,350,660,71
KASSANDA,2015,130,80,210,71
KASSANDA,2016,130,90,220,71
KASSANDA,2017,140,90,230,71
KASSANDA,2018,140,90,230,71
KASSANDA,2019,150,90,240,71
KASSANDA,2020,150,90,240,71
KASSANDA,2021,150,100,250,71
KASSANDA,2022,160,100,260,71
KASSANDA,2023,160,100,260,71
KASSANDA,2024,160,100,260,71
KASSANDA,2025,170,100,270,71
KATAKWI,2015,230,290,520,71
KATAKWI,2016,210,260,470,71
KATAKWI,2017,210,250,460,71
KATAKWI,2018,210,240,450,71
KATAKWI,2019,230,250,480,71
KATAKWI,2020,240,280,520,71
KATAKWI,2021,250,310,560,71
KATAKWI,2022,270,330,600,71
KATAKWI,2023,270,350,620,71
KATAKWI,2024,280,340,620,71
KATAKWI,2025,270,330,600,71
KAYUNGA,2015,250,270,520,71
KAYUNGA,2016,230,260,490,71
KAYUNGA,2017,210,230,440,71
KAYUNGA,2018,220,220,440,71
KAYUNGA,2019,230,230,460,71
KAYUNGA,2020,240,250,490,71
KAYUNGA,2021,250,290,540,71
KAYUNGA,2022,270,310,580,71
KAYUNGA,2023,270,310,580,71
KAYUNGA,2024,270,300,570,71
KAYUNGA,2025,270,280,550,71
KAZO,2015,100,80,180,71
KAZO,2016,100,80,180,71
KAZO,2017,100,80,180,71
KAZO,2018,110,90,200,71
KAZO,2019,110,90,200,71
KAZO,2020,120,90,210,71
KAZO,2021,120,100,220,71
KAZO,2022,120,100,220,71
KAZO,2023,130,100,230,71
KAZO,2024,130,110,240,71
KAZO,2025,140,110,250,71
KIBAALE,2015,60,60,120,71
KIBAALE,2016,60,70,130,71
KIBAALE,2017,70,70,140,71
KIBAALE,2018,70,70,140,71
KIBAALE,2019,80,80,160,71
KIBAALE,2020,80,80,160,71
KIBAALE,2021,90,90,180,71
KIBAALE,2022,90,90,180,71
KIBAALE,2023,100,100,200,71
KIBAALE,2024,100,100,200,71
KIBAALE,2025,110,110,220,71
KIBOGA,2015,120,160,280,71
KIBOGA,2016,130,140,270,71
KIBOGA,2017,120,140,260,71
KIBOGA,2018,120,130,250,71
KIBOGA,2019,120,140,260,71
KIBOGA,2020,130,150,280,71
KIBOGA,2021,150,160,310,71
KIBOGA,2022,150,190,340,71
KIBOGA,2023,150,190,340,71
KIBOGA,2024,150,190,340,71
KIBOGA,2025,150,170,320,71
KIBUKU,2015,150,230,380,71
KIBUKU,2016,160,210,370,71
KIBUKU,2017,150,190,340,71
KIBUKU,2018,140,190,330,71
KIBUKU,2019,160,200,360,71
KIBUKU,2020,170,230,400,71
KIBUKU,2021,190,250,440,71
KIBUKU,2022,200,290,490,71
KIBUKU,2023,210,290,500,71
KIBUKU,2024,210,300,510,71
KIBUKU,2025,210,280,490,71
KIKUUBE,2015,130,100,230,71
KIKUUBE,2016,140,110,250,71
KIKUUBE,2017,140,110,250,71
KIKUUBE,2018,150,120,270,71
KIKUUBE,2019,160,130,290,71
KIKUUBE,2020,170,130,300,71
KIKUUBE,2021,180,140,320,71
KIKUUBE,2022,180,140,320,71
KIKUUBE,2023,190,150,340,71
KIKUUBE,2024,200,160,360,71
KIKUUBE,2025,210,170,380,71
KIRUHURA,2015,80,60,140,71
KIRUHURA,2016,80,60,140,71
KIRUHURA,2017,90,70,160,71
KIRUHURA,2018,90,70,160,71
KIRUHURA,2019,90,70,160,71
KIRUHURA,2020,100,70,170,71
KIRUHURA,2021,100,80,180,71
KIRUHURA,2022,100,80,180,71
KIRUHURA,2023,110,80,190,71
KIRUHURA,2024,110,80,190,71
KIRUHURA,2025,110,90,200,71
KIRYANDONGO,2015,150,180,330,71
KIRYANDONGO,2016,140,150,290,71
KIRYANDONGO,2017,150,160,310,71
KIRYANDONGO,2018,140,150,290,71
KIRYANDONGO,2019,150,150,300,71
KIRYANDONGO,2020,170,170,340,71
KIRYANDONGO,2021,180,200,380,71
KIRYANDONGO,2022,180,210,390,71
KIRYANDONGO,2023,200,210,410,71
KIRYANDONGO,2024,190,200,390,71
KIRYANDONGO,2025,180,210,390,71
KISORO,2015,150,230,380,71
KISORO,2016,140,210,350,71
KISORO,2017,150,200,350,71
KISORO,2018,140,190,330,71
KISORO,2019,150,200,350,71
KISORO,2020,150,220,370,71
KISORO,2021,180,250,430,71
KISORO,2022,180,270,450,71
KISORO,2023,180,270,450,71
KISORO,2024,180,260,440,71
KISORO,2025,170,240,410,71
KITAGWENDA,2015,70,70,140,71
KITAGWENDA,2016,80,70,150,71
KITAGWENDA,2017,80,80,160,71
KITAGWENDA,2018,80,80,160,71
KITAGWENDA,2019,90,80,170,71
KITAGWENDA,2020,90,90,180,71
KITAGWENDA,2021,90,90,180,71
KITAGWENDA,2022,100,90,190,71
KITAGWENDA,2023,100,90,190,71
KITAGWENDA,2024,100,100,200,71
KITAGWENDA,2025,110,100,210,71
KITGUM,2015,170,200,370,71
KITGUM,2016,170,170,340,71
KITGUM,2017,160,160,320,71
KITGUM,2018,160,150,310,71
KITGUM,2019,160,150,310,71
KITGUM,2020,170,170,340,71
KITGUM,2021,190,180,370,71
KITGUM,2022,200,210,410,71
KITGUM,2023,200,210,410,71
KITGUM,2024,190,200,390,71
KITGUM,2025,180,190,370,71
KOBOKO,2015,110,120,230,71
KOBOKO,2016,100,100,200,71
KOBOKO,2017,90,110,200,71
KOBOKO,2018,110,100,210,71
KOBOKO,2019,110,110,220,71
KOBOKO,2020,110,120,230,71
KOBOKO,2021,130,140,270,71
KOBOKO,2022,140,150,290,71
KOBOKO,2023,140,160,300,71
KOBOKO,2024,150,170,320,71
KOBOKO,2025,140,160,300,71
KOLE,2015,180,180,360,71
KOLE,2016,190,190,380,71
KOLE,2017,190,190,380,71
KOLE,2018,200,200,400,71
KOLE,2019,200,210,410,71
KOLE,2020,210,210,420,71
KOLE,2021,220,220,440,71
KOLE,2022,220,220,440,71
KOLE,2023,230,230,460,71
KOLE,2024,240,230,470,71
KOLE,2025,240,240,480,71
KOTIDO,2015,80,140,220,71
KOTIDO,2016,70,120,190,71
KOTIDO,2017,70,110,180,71
KOTIDO,2018,70,100,170,71
KOTIDO,2019,80,120,200,71
KOTIDO,2020,80,130,210,71
KOTIDO,2021,90,140,230,71
KOTIDO,2022,90,150,240,71
KOTIDO,2023,90,160,250,71
KOTIDO,2024,90,150,240,71
KOTIDO,2025,80,140,220,71
KUMI,2015,250,230,480,71
KUMI,2016,230,210,440,71
KUMI,2017,230,200,430,71
KUMI,2018,220,190,410,71
KUMI,2019,240,200,440,71
KUMI,2020,260,230,490,71
KUMI,2021,280,250,530,71
KUMI,2022,300,270,570,71
KUMI,2023,300,290,590,71
KUMI,2024,310,280,590,71
KUMI,2025,300,260,560,71
KWANIA,2015,90,110,200,71
KWANIA,2016,100,110,210,71
KWANIA,2017,100,110,210,71
KWANIA,2018,100,120,220,71
KWANIA,2019,110,120,230,71
KWANIA,2020,110,120,230,71
KWANIA,2021,110,130,240,71
KWANIA,2022,110,130,240,71
KWANIA,2023,120,130,250,71
KWANIA,2024,120,140,260,71
KWANIA,2025,120,140,260,71
KWEEN,2015,30,30,60,71
KWEEN,2016,30,30,60,71
KWEEN,2017,40,30,70,71
KWEEN,2018,40,40,80,71
KWEEN,2019,40,40,80,71
KWEEN,2020,40,40,80,71
KWEEN,2021,40,40,80,71
KWEEN,2022,40,40,80,71
KWEEN,2023,40,40,80,71
KWEEN,2024,40,40,80,71
KWEEN,2025,40,40,80,71
KYANKWANZI,2015,120,90,210,71
KYANKWANZI,2016,120,100,220,71
KYANKWANZI,2017,130,100,230,71
KYANKWANZI,2018,130,110,240,71
KYANKWANZI,2019,140,110,250,71
KYANKWANZI,2020,150,120,270,71
KYANKWANZI,2021,160,120,280,71
KYANKWANZI,2022,160,130,290,71
KYANKWANZI,2023,170,130,300,71
KYANKWANZI,2024,180,140,320,71
KYANKWANZI,2025,190,150,340,71
KYEGEGWA,2015,120,150,270,71
KYEGEGWA,2016,140,160,300,71
KYEGEGWA,2017,150,180,330,71
KYEGEGWA,2018,160,190,350,71
KYEGEGWA,2019,170,210,380,71
KYEGEGWA,2020,180,220,400,71
KYEGEGWA,2021,200,240,440,71
KYEGEGWA,2022,220,260,480,71
KYEGEGWA,2023,230,280,510,71
KYEGEGWA,2024,250,300,550,71
KYEGEGWA,2025,270,320,590,71
KYENJOJO,2015,200,250,450,71
KYENJOJO,2016,210,260,470,71
KYENJOJO,2017,220,270,490,71
KYENJOJO,2018,230,280,510,71
KYENJOJO,2019,240,290,530,71
KYENJOJO,2020,250,300,550,71
KYENJOJO,2021,260,310,570,71
KYENJOJO,2022,270,320,590,71
KYENJOJO,2023,280,330,610,71
KYENJOJO,2024,290,340,630,71
KYENJOJO,2025,300,360,660,71
KYOTERA,2015,190,270,460,71
KYOTERA,2016,170,260,430,71
KYOTERA,2017,160,230,390,71
KYOTERA,2018,170,220,390,71
KYOTERA,2019,170,230,400,71
KYOTERA,2020,180,250,430,71
KYOTERA,2021,190,290,480,71
KYOTERA,2022,210,310,520,71
KYOTERA,2023,210,310,520,71
KYOTERA,2024,210,300,510,71
KYOTERA,2025,200,280,480,71
KARENGA,2015,20,20,40,71
KARENGA,2016,20,30,50,71
KARENGA,2017,20,30,50,71
KARENGA,2018,30,30,60,71
KARENGA,2019,30,30,60,71
KARENGA,2020,30,30,60,71
KARENGA,2021,30,30,60,71
KARENGA,2022,30,30,60,71
KARENGA,2023,30,30,60,71
KARENGA,2024,30,30,60,71
KARENGA,2025,30,30,60,71
LAMWO,2015,110,140,250,71
LAMWO,2016,100,120,220,71
LAMWO,2017,110,110,220,71
LAMWO,2018,110,100,210,71
LAMWO,2019,110,110,220,71
LAMWO,2020,110,120,230,71
LAMWO,2021,120,130,250,71
LAMWO,2022,120,130,250,71
LAMWO,2023,120,160,280,71
LAMWO,2024,120,150,270,71
LAMWO,2025,110,140,250,71
LIRA,2015,180,190,370,71
LIRA,2016,180,190,370,71
LIRA,2017,190,200,390,71
LIRA,2018,190,200,390,71
LIRA,2019,200,210,410,71
LIRA,2020,210,210,420,71
LIRA,2021,210,220,430,71
LIRA,2022,220,220,440,71
LIRA,2023,220,230,450,71
LIRA,2024,230,240,470,71
LIRA,2025,230,240,470,71
LUUKA,2015,150,180,330,71
LUUKA,2016,140,170,310,71
LUUKA,2017,130,160,290,71
LUUKA,2018,130,150,280,71
LUUKA,2019,130,150,280,71
LUUKA,2020,150,170,320,71
LUUKA,2021,160,200,360,71
LUUKA,2022,170,210,380,71
LUUKA,2023,170,210,380,71
LUUKA,2024,160,200,360,71
LUUKA,2025,170,190,360,71
LUWERO,2015,260,370,630,71
LUWERO,2016,240,330,570,71
LUWERO,2017,240,310,550,71
LUWERO,2018,240,300,540,71
LUWERO,2019,250,310,560,71
LUWERO,2020,260,350,610,71
LUWERO,2021,290,380,670,71
LUWERO,2022,300,420,720,71
LUWERO,2023,320,430,750,71
LUWERO,2024,310,430,740,71
LUWERO,2025,300,400,700,71
LWENGO,2015,200,430,630,71
LWENGO,2016,200,380,580,71
LWENGO,2017,190,340,530,71
LWENGO,2018,180,340,520,71
LWENGO,2019,190,360,550,71
LWENGO,2020,200,380,580,71
LWENGO,2021,200,410,610,71
LWENGO,2022,210,440,650,71
LWENGO,2023,230,450,680,71
LWENGO,2024,220,450,670,71
LWENGO,2025,210,410,620,71
LYANTONDE,2015,80,80,160,71
LYANTONDE,2016,70,70,140,71
LYANTONDE,2017,80,60,140,71
LYANTONDE,2018,80,70,150,71
LYANTONDE,2019,80,80,160,71
LYANTONDE,2020,80,80,160,71
LYANTONDE,2021,90,90,180,71
LYANTONDE,2022,110,100,210,71
LYANTONDE,2023,110,100,210,71
LYANTONDE,2024,100,90,190,71
LYANTONDE,2025,100,90,190,71
MANAFWA,2015,80,100,180,71
MANAFWA,2016,80,100,180,71
MANAFWA,2017,80,100,180,71
MANAFWA,2018,90,100,190,71
MANAFWA,2019,90,110,200,71
MANAFWA,2020,90,110,200,71
MANAFWA,2021,90,110,200,71
MANAFWA,2022,90,110,200,71
MANAFWA,2023,100,120,220,71
MANAFWA,2024,100,120,220,71
MANAFWA,2025,100,120,220,71
MARACHA,2015,140,120,260,71
MARACHA,2016,140,120,260,71
MARACHA,2017,150,120,270,71
MARACHA,2018,150,130,280,71
MARACHA,2019,150,130,280,71
MARACHA,2020,160,130,290,71
MARACHA,2021,160,130,290,71
MARACHA,2022,160,130,290,71
MARACHA,2023,170,140,310,71
MARACHA,2024,170,140,310,71
MARACHA,2025,170,140,310,71
MASAKA,2015,200,350,550,71
MASAKA,2016,190,310,500,71
MASAKA,2017,170,280,450,71
MASAKA,2018,180,280,460,71
MASAKA,2019,190,290,480,71
MASAKA,2020,200,320,520,71
MASAKA,2021,220,360,580,71
MASAKA,2022,230,380,610,71
MASAKA,2023,230,410,640,71
MASAKA,2024,240,390,630,71
MASAKA,2025,230,360,590,71
MASINDI,2015,150,150,300,71
MASINDI,2016,150,150,300,71
MASINDI,2017,160,160,320,71
MASINDI,2018,160,160,320,71
MASINDI,2019,160,160,320,71
MASINDI,2020,170,170,340,71
MASINDI,2021,170,170,340,71
MASINDI,2022,180,180,360,71
MASINDI,2023,180,180,360,71
MASINDI,2024,190,180,370,71
MASINDI,2025,190,190,380,71
MAYUGE,2015,340,370,710,71
MAYUGE,2016,310,340,650,71
MAYUGE,2017,310,310,620,71
MAYUGE,2018,320,310,630,71
MAYUGE,2019,320,340,660,71
MAYUGE,2020,350,360,710,71
MAYUGE,2021,380,410,790,71
MAYUGE,2022,410,460,870,71
MAYUGE,2023,430,470,900,71
MAYUGE,2024,410,470,880,71
MAYUGE,2025,410,450,860,71
MBALE,2015,450,660,1110,71
MBALE,2016,430,600,1030,71
MBALE,2017,420,560,980,71
MBALE,2018,420,550,970,71
MBALE,2019,440,590,1030,71
MBALE,2020,470,660,1130,71
MBALE,2021,510,740,1250,71
MBALE,2022,550,800,1350,71
MBALE,2023,560,840,1400,71
MBALE,2024,560,840,1400,71
MBALE,2025,550,790,1340,71
MBARARA,2015,140,180,320,71
MBARARA,2016,150,180,330,71
MBARARA,2017,150,180,330,71
MBARARA,2018,150,190,340,71
MBARARA,2019,160,190,350,71
MBARARA,2020,160,200,360,71
MBARARA,2021,160,200,360,71
MBARARA,2022,170,200,370,71
MBARARA,2023,170,210,380,71
MBARARA,2024,170,210,380,71
MBARARA,2025,180,210,390,71
MITOOMA,2015,110,130,240,71
MITOOMA,2016,110,130,240,71
MITOOMA,2017,120,130,250,71
MITOOMA,2018,120,140,260,71
MITOOMA,2019,120,140,260,71
MITOOMA,2020,120,140,260,71
MITOOMA,2021,120,140,260,71
MITOOMA,2022,120,140,260,71
MITOOMA,2023,120,140,260,71
MITOOMA,2024,120,140,260,71
MITOOMA,2025,120,140,260,71
MITYANA,2015,260,330,590,71
MITYANA,2016,240,310,550,71
MITYANA,2017,230,280,510,71
MITYANA,2018,240,270,510,71
MITYANA,2019,240,280,520,71
MITYANA,2020,250,320,570,71
MITYANA,2021,280,340,620,71
MITYANA,2022,290,360,650,71
MITYANA,2023,290,370,660,71
MITYANA,2024,280,370,650,71
MITYANA,2025,280,350,630,71
MOROTO,2015,80,120,200,71
MOROTO,2016,70,100,170,71
MOROTO,2017,70,90,160,71
MOROTO,2018,70,90,160,71
MOROTO,2019,70,110,180,71
MOROTO,2020,70,120,190,71
MOROTO,2021,70,130,200,71
MOROTO,2022,80,130,210,71
MOROTO,2023,90,140,230,71
MOROTO,2024,90,130,220,71
MOROTO,2025,80,140,220,71
MOYO,2015,40,90,130,71
MOYO,2016,40,90,130,71
MOYO,2017,40,100,140,71
MOYO,2018,40,100,140,71
MOYO,2019,40,100,140,71
MOYO,2020,40,100,140,71
MOYO,2021,40,100,140,71
MOYO,2022,50,110,160,71
MOYO,2023,50,110,160,71
MOYO,2024,50,110,160,71
MOYO,2025,50,110,160,71
MPIGI,2015,190,310,500,71
MPIGI,2016,170,280,450,71
MPIGI,2017,160,250,410,71
MPIGI,2018,170,250,420,71
MPIGI,2019,170,260,430,71
MPIGI,2020,180,300,480,71
MPIGI,2021,190,320,510,71
MPIGI,2022,210,340,550,71
MPIGI,2023,210,370,580,71
MPIGI,2024,210,350,560,71
MPIGI,2025,210,330,540,71
MUBENDE,2015,250,270,520,71
MUBENDE,2016,240,260,500,71
MUBENDE,2017,240,230,470,71
MUBENDE,2018,250,240,490,71
MUBENDE,2019,270,260,530,71
MUBENDE,2020,290,300,590,71
MUBENDE,2021,320,340,660,71
MUBENDE,2022,360,380,740,71
MUBENDE,2023,380,390,770,71
MUBENDE,2024,380,390,770,71
MUBENDE,2025,380,380,760,71
MUKONO,2015,330,470,800,71
MUKONO,2016,310,410,720,71
MUKONO,2017,310,390,700,71
MUKONO,2018,300,390,690,71
MUKONO,2019,320,400,720,71
MUKONO,2020,350,450,800,71
MUKONO,2021,360,510,870,71
MUKONO,2022,390,560,950,71
MUKONO,2023,410,560,970,71
MUKONO,2024,400,560,960,71
MUKONO,2025,390,540,930,71
NABILATUK,2015,50,80,130,71
NABILATUK,2016,40,70,110,71
NABILATUK,2017,40,80,120,71
NABILATUK,2018,40,70,110,71
NABILATUK,2019,40,80,120,71
NABILATUK,2020,40,80,120,71
NABILATUK,2021,60,90,150,71
NABILATUK,2022,60,110,170,71
NABILATUK,2023,60,120,180,71
NABILATUK,2024,60,110,170,71
NABILATUK,2025,60,100,160,71
NAKAPIRIPIRIT,2015,50,100,150,71
NAKAPIRIPIRIT,2016,40,90,130,71
NAKAPIRIPIRIT,2017,50,80,130,71
NAKAPIRIPIRIT,2018,50,70,120,71
NAKAPIRIPIRIT,2019,50,90,140,71
NAKAPIRIPIRIT,2020,60,100,160,71
NAKAPIRIPIRIT,2021,60,110,170,71
NAKAPIRIPIRIT,2022,60,110,170,71
NAKAPIRIPIRIT,2023,80,120,200,71
NAKAPIRIPIRIT,2024,70,130,200,71
NAKAPIRIPIRIT,2025,70,120,190,71
NAKASEKE,2015,80,70,150,71
NAKASEKE,2016,80,70,150,71
NAKASEKE,2017,80,70,150,71
NAKASEKE,2018,90,70,160,71
NAKASEKE,2019,90,70,160,71
NAKASEKE,2020,90,70,160,71
NAKASEKE,2021,100,80,180,71
NAKASEKE,2022,100,80,180,71
NAKASEKE,2023,100,80,180,71
NAKASEKE,2024,110,80,190,71
NAKASEKE,2025,110,80,190,71
NAKASONGOLA,2015,110,100,210,71
NAKASONGOLA,2016,100,90,190,71
NAKASONGOLA,2017,90,90,180,71
NAKASONGOLA,2018,90,90,180,71
NAKASONGOLA,2019,110,90,200,71
NAKASONGOLA,2020,110,100,210,71
NAKASONGOLA,2021,120,110,230,71
NAKASONGOLA,2022,120,110,230,71
NAKASONGOLA,2023,140,120,260,71
NAKASONGOLA,2024,130,130,260,71
NAKASONGOLA,2025,130,120,250,71
NAMAYINGO,2015,120,140,260,71
NAMAYINGO,2016,110,120,230,71
NAMAYINGO,2017,110,110,220,71
NAMAYINGO,2018,110,100,210,71
NAMAYINGO,2019,110,110,220,71
NAMAYINGO,2020,110,120,230,71
NAMAYINGO,2021,130,140,270,71
NAMAYINGO,2022,140,150,290,71
NAMAYINGO,2023,140,160,300,71
NAMAYINGO,2024,130,150,280,71
NAMAYINGO,2025,130,140,270,71
NAMISINDWA,2015,120,120,240,71
NAMISINDWA,2016,120,120,240,71
NAMISINDWA,2017,120,120,240,71
NAMISINDWA,2018,130,130,260,71
NAMISINDWA,2019,130,130,260,71
NAMISINDWA,2020,130,130,260,71
NAMISINDWA,2021,140,140,280,71
NAMISINDWA,2022,140,140,280,71
NAMISINDWA,2023,140,140,280,71
NAMISINDWA,2024,150,140,290,71
NAMISINDWA,2025,150,150,300,71
NAMUTUMBA,2015,220,250,470,71
NAMUTUMBA,2016,210,220,430,71
NAMUTUMBA,2017,200,220,420,71
NAMUTUMBA,2018,210,210,420,71
NAMUTUMBA,2019,210,230,440,71
NAMUTUMBA,2020,240,250,490,71
NAMUTUMBA,2021,250,290,540,71
NAMUTUMBA,2022,270,310,580,71
NAMUTUMBA,2023,290,330,620,71
NAMUTUMBA,2024,280,320,600,71
NAMUTUMBA,2025,280,310,590,71
NAPAK,2015,110,160,270,71
NAPAK,2016,100,150,250,71
NAPAK,2017,90,140,230,71
NAPAK,2018,90,130,220,71
NAPAK,2019,110,140,250,71
NAPAK,2020,110,150,260,71
NAPAK,2021,120,160,280,71
NAPAK,2022,120,190,310,71
NAPAK,2023,120,190,310,71
NAPAK,2024,120,190,310,71
NAPAK,2025,110,170,280,71
NEBBI,2015,130,170,300,71
NEBBI,2016,130,170,300,71
NEBBI,2017,140,180,320,71
NEBBI,2018,140,180,320,71
NEBBI,2019,150,190,340,71
NEBBI,2020,150,190,340,71
NEBBI,2021,160,200,360,71
NEBBI,2022,160,200,360,71
NEBBI,2023,160,210,370,71
NEBBI,2024,170,210,380,71
NEBBI,2025,170,220,390,71
NGORA,2015,140,120,260,71
NGORA,2016,130,100,230,71
NGORA,2017,120,110,230,71
NGORA,2018,120,100,220,71
NGORA,2019,130,110,240,71
NGORA,2020,140,120,260,71
NGORA,2021,150,130,280,71
NGORA,2022,150,150,300,71
NGORA,2023,170,160,330,71
NGORA,2024,160,150,310,71
NGORA,2025,150,140,290,71
NTOROKO,2015,30,40,70,71
NTOROKO,2016,30,30,60,71
NTOROKO,2017,30,30,60,71
NTOROKO,2018,30,30,60,71
NTOROKO,2019,30,30,60,71
NTOROKO,2020,30,30,60,71
NTOROKO,2021,30,40,70,71
NTOROKO,2022,30,60,90,71
NTOROKO,2023,30,60,90,71
NTOROKO,2024,40,60,100,71
NTOROKO,2025,40,50,90,71
NTUNGAMO,2015,210,260,470,71
NTUNGAMO,2016,210,260,470,71
NTUNGAMO,2017,220,270,490,71
NTUNGAMO,2018,220,270,490,71
NTUNGAMO,2019,230,280,510,71
NTUNGAMO,2020,230,280,510,71
NTUNGAMO,2021,230,290,520,71
NTUNGAMO,2022,240,290,530,71
NTUNGAMO,2023,240,290,530,71
NTUNGAMO,2024,250,300,550,71
NTUNGAMO,2025,250,300,550,71
NWOYA,2015,50,70,120,71
NWOYA,2016,60,80,140,71
NWOYA,2017,60,90,150,71
NWOYA,2018,70,100,170,71
NWOYA,2019,80,110,190,71
NWOYA,2020,90,120,210,71
NWOYA,2021,100,130,230,71
NWOYA,2022,110,140,250,71
NWOYA,2023,120,160,280,71
NWOYA,2024,130,170,300,71
NWOYA,2025,140,190,330,71
OBONGI,2015,30,40,70,71
OBONGI,2016,30,30,60,71
OBONGI,2017,30,30,60,71
OBONGI,2018,30,30,60,71
OBONGI,2019,30,30,60,71
OBONGI,2020,30,30,60,71
OBONGI,2021,30,40,70,71
OBONGI,2022,30,40,70,71
OBONGI,2023,30,60,90,71
OBONGI,2024,30,60,90,71
OBONGI,2025,30,50,80,71
OMORO,2015,110,140,250,71
OMORO,2016,110,120,230,71
OMORO,2017,110,120,230,71
OMORO,2018,110,120,230,71
OMORO,2019,110,120,230,71
OMORO,2020,130,130,260,71
OMORO,2021,130,160,290,71
OMORO,2022,140,170,310,71
OMORO,2023,150,170,320,71
OMORO,2024,150,170,320,71
OMORO,2025,140,170,310,71
OTUKE,2015,70,70,140,71
OTUKE,2016,80,80,160,71
OTUKE,2017,80,80,160,71
OTUKE,2018,90,80,170,71
OTUKE,2019,90,90,180,71
OTUKE,2020,90,90,180,71
OTUKE,2021,100,100,200,71
OTUKE,2022,100,100,200,71
OTUKE,2023,100,100,200,71
OTUKE,2024,110,110,220,71
OTUKE,2025,110,110,220,71
OYAM,2015,210,250,460,71
OYAM,2016,220,260,480,71
OYAM,2017,230,270,500,71
OYAM,2018,230,280,510,71
OYAM,2019,240,290,530,71
OYAM,2020,250,290,540,71
OYAM,2021,260,300,560,71
OYAM,2022,260,310,570,71
OYAM,2023,270,320,590,71
OYAM,2024,280,330,610,71
OYAM,2025,280,330,610,71
PADER,2015,90,120,210,71
PADER,2016,90,120,210,71
PADER,2017,80,110,190,71
PADER,2018,90,100,190,71
PADER,2019,90,110,200,71
PADER,2020,100,120,220,71
PADER,2021,100,130,230,71
PADER,2022,110,130,240,71
PADER,2023,110,140,250,71
PADER,2024,100,130,230,71
PADER,2025,100,140,240,71
PAKWACH,2015,90,120,210,71
PAKWACH,2016,100,120,220,71
PAKWACH,2017,100,120,220,71
PAKWACH,2018,110,130,240,71
PAKWACH,2019,110,130,240,71
PAKWACH,2020,110,140,250,71
PAKWACH,2021,120,140,260,71
PAKWACH,2022,120,150,270,71
PAKWACH,2023,130,150,280,71
PAKWACH,2024,130,160,290,71
PAKWACH,2025,140,160,300,71
PALLISA,2015,230,330,560,71
PALLISA,2016,230,310,540,71
PALLISA,2017,210,280,490,71
PALLISA,2018,220,280,500,71
PALLISA,2019,240,310,550,71
PALLISA,2020,260,350,610,71
PALLISA,2021,290,400,690,71
PALLISA,2022,300,440,740,71
PALLISA,2023,320,470,790,71
PALLISA,2024,330,450,780,71
PALLISA,2025,320,430,750,71
RAKAI,2015,190,200,390,71
RAKAI,2016,190,170,360,71
RAKAI,2017,170,170,340,71
RAKAI,2018,170,160,330,71
RAKAI,2019,190,170,360,71
RAKAI,2020,200,180,380,71
RAKAI,2021,200,200,400,71
RAKAI,2022,230,230,460,71
RAKAI,2023,230,230,460,71
RAKAI,2024,220,220,440,71
RAKAI,2025,230,210,440,71
RUBANDA,2015,90,100,190,71
RUBANDA,2016,90,100,190,71
RUBANDA,2017,90,100,190,71
RUBANDA,2018,90,100,190,71
RUBANDA,2019,90,100,190,71
RUBANDA,2020,90,100,190,71
RUBANDA,2021,90,100,190,71
RUBANDA,2022,100,100,200,71
RUBANDA,2023,100,100,200,71
RUBANDA,2024,100,100,200,71
RUBANDA,2025,100,100,200,71
RUBIRIZI,2015,70,70,140,71
RUBIRIZI,2016,70,70,140,71
RUBIRIZI,2017,70,80,150,71
RUBIRIZI,2018,70,80,150,71
RUBIRIZI,2019,70,80,150,71
RUBIRIZI,2020,70,80,150,71
RUBIRIZI,2021,80,80,160,71
RUBIRIZI,2022,80,80,160,71
RUBIRIZI,2023,80,80,160,71
RUBIRIZI,2024,80,90,170,71
RUBIRIZI,2025,80,90,170,71
RUKIGA,2015,60,90,150,71
RUKIGA,2016,60,90,150,71
RUKIGA,2017,60,90,150,71
RUKIGA,2018,60,100,160,71
RUKIGA,2019,60,100,160,71
RUKIGA,2020,60,100,160,71
RUKIGA,2021,60,100,160,71
RUKIGA,2022,60,100,160,71
RUKIGA,2023,60,100,160,71
RUKIGA,2024,60,100,160,71
RUKIGA,2025,60,100,160,71
RUKUNGIRI,2015,190,240,430,71
RUKUNGIRI,2016,190,240,430,71
RUKUNGIRI,2017,190,240,430,71
RUKUNGIRI,2018,200,240,440,71
RUKUNGIRI,2019,200,240,440,71
RUKUNGIRI,2020,200,250,450,71
RUKUNGIRI,2021,200,250,450,71
RUKUNGIRI,2022,200,250,450,71
RUKUNGIRI,2023,210,250,460,71
RUKUNGIRI,2024,210,250,460,71
RUKUNGIRI,2025,210,250,460,71
RWAMPARA,2015,50,70,120,71
RWAMPARA,2016,50,70,120,71
RWAMPARA,2017,50,70,120,71
RWAMPARA,2018,50,70,120,71
RWAMPARA,2019,50,80,130,71
RWAMPARA,2020,50,80,130,71
RWAMPARA,2021,60,80,140,71
RWAMPARA,2022,60,80,140,71
RWAMPARA,2023,60,80,140,71
RWAMPARA,2024,60,80,140,71
RWAMPARA,2025,60,80,140,71
SERERE,2015,200,290,490,71
SERERE,2016,200,260,460,71
SERERE,2017,190,250,440,71
SERERE,2018,200,240,440,71
SERERE,2019,200,260,460,71
SERERE,2020,220,300,520,71
SERERE,2021,250,320,570,71
SERERE,2022,260,360,620,71
SERERE,2023,270,390,660,71
SERERE,2024,280,370,650,71
SERERE,2025,270,360,630,71
SHEEMA,2015,130,170,300,71
SHEEMA,2016,130,170,300,71
SHEEMA,2017,130,170,300,71
SHEEMA,2018,130,170,300,71
SHEEMA,2019,130,170,300,71
SHEEMA,2020,140,170,310,71
SHEEMA,2021,140,180,320,71
SHEEMA,2022,140,180,320,71
SHEEMA,2023,140,180,320,71
SHEEMA,2024,140,180,320,71
SHEEMA,2025,140,180,320,71
SIRONKO,2015,170,190,360,71
SIRONKO,2016,170,190,360,71
SIRONKO,2017,180,200,380,71
SIRONKO,2018,180,200,380,71
SIRONKO,2019,190,210,400,71
SIRONKO,2020,190,210,400,71
SIRONKO,2021,190,210,400,71
SIRONKO,2022,200,220,420,71
SIRONKO,2023,200,220,420,71
SIRONKO,2024,210,230,440,71
SIRONKO,2025,210,230,440,71
SOROTI,2015,220,250,470,71
SOROTI,2016,200,240,440,71
SOROTI,2017,200,220,420,71
SOROTI,2018,210,220,430,71
SOROTI,2019,210,230,440,71
SOROTI,2020,240,270,510,71
SOROTI,2021,250,290,540,71
SOROTI,2022,270,330,600,71
SOROTI,2023,270,350,620,71
SOROTI,2024,280,340,620,71
SOROTI,2025,280,330,610,71
SSEMBABULE,2015,170,250,420,71
SSEMBABULE,2016,160,220,380,71
SSEMBABULE,2017,150,200,350,71
SSEMBABULE,2018,160,210,370,71
SSEMBABULE,2019,160,220,380,71
SSEMBABULE,2020,170,250,420,71
SSEMBABULE,2021,190,270,460,71
SSEMBABULE,2022,200,290,490,71
SSEMBABULE,2023,200,310,510,71
SSEMBABULE,2024,210,300,510,71
SSEMBABULE,2025,200,280,480,71
TORORO,2015,360,370,730,71
TORORO,2016,370,380,750,71
TORORO,2017,380,390,770,71
TORORO,2018,390,400,790,71
TORORO,2019,400,410,810,71
TORORO,2020,410,420,830,71
TORORO,2021,420,430,850,71
TORORO,2022,430,440,870,71
TORORO,2023,440,440,880,71
TORORO,2024,450,450,900,71
TORORO,2025,460,460,920,71
WAKISO,2015,440,610,1050,71
WAKISO,2016,470,650,1120,71
WAKISO,2017,500,690,1190,71
WAKISO,2018,530,740,1270,71
WAKISO,2019,570,790,1360,71
WAKISO,2020,600,840,1440,71
WAKISO,2021,640,900,1540,71
WAKISO,2022,680,960,1640,71
WAKISO,2023,730,1020,1750,71
WAKISO,2024,770,1080,1850,71
WAKISO,2025,820,1150,1970,71
YUMBE,2015,310,290,600,71
YUMBE,2016,310,280,590,71
YUMBE,2017,310,260,570,71
YUMBE,2018,320,270,590,71
YUMBE,2019,330,290,620,71
YUMBE,2020,360,330,690,71
YUMBE,2021,410,400,810,71
YUMBE,2022,440,440,880,71
YUMBE,2023,460,470,930,71
YUMBE,2024,470,470,940,71
YUMBE,2025,460,470,930,71
ZOMBO,2015,200,260,460,71
ZOMBO,2016,210,270,480,71
ZOMBO,2017,220,280,500,71
ZOMBO,2018,220,290,510,71
ZOMBO,2019,230,290,520,71
ZOMBO,2020,240,300,540,71
ZOMBO,2021,240,310,550,71
ZOMBO,2022,250,320,570,71
ZOMBO,2023,260,320,580,71
ZOMBO,2024,270,330,600,71
ZOMBO,2025,270,340,610,71
MADI OKOLLO,2015,80,80,160,71
MADI OKOLLO,2016,80,80,160,71
MADI OKOLLO,2017,80,90,170,71
MADI OKOLLO,2018,80,90,170,71
MADI OKOLLO,2019,90,90,180,71
MADI OKOLLO,2020,90,90,180,71
MADI OKOLLO,2021,90,100,190,71
MADI OKOLLO,2022,90,100,190,71
MADI OKOLLO,2023,100,100,200,71
MADI OKOLLO,2024,100,100,200,71
MADI OKOLLO,2025,100,100,200,71
ABIM,2015,60,50,110,72
ABIM,2016,60,50,110,72
ABIM,2017,60,40,100,72
ABIM,2018,60,50,110,72
ABIM,2019,60,50,110,72
ABIM,2020,60,50,110,72
ABIM,2021,70,60,130,72
ABIM,2022,80,70,150,72
ABIM,2023,90,70,160,72
ABIM,2024,100,80,180,72
ABIM,2025,100,80,180,72
ADJUMANI,2015,90,120,210,72
ADJUMANI,2016,90,120,210,72
ADJUMANI,2017,90,120,210,72
ADJUMANI,2018,100,120,220,72
ADJUMANI,2019,100,120,220,72
ADJUMANI,2020,100,120,220,72
ADJUMANI,2021,100,120,220,72
ADJUMANI,2022,100,120,220,72
ADJUMANI,2023,100,120,220,72
ADJUMANI,2024,100,130,230,72
ADJUMANI,2025,100,130,230,72
AGAGO,2015,140,150,290,72
AGAGO,2016,140,160,300,72
AGAGO,2017,150,160,310,72
AGAGO,2018,150,160,310,72
AGAGO,2019,150,170,320,72
AGAGO,2020,150,170,320,72
AGAGO,2021,160,170,330,72
AGAGO,2022,160,170,330,72
AGAGO,2023,160,180,340,72
AGAGO,2024,160,180,340,72
AGAGO,2025,170,180,350,72
ALEBTONG,2015,230,290,520,72
ALEBTONG,2016,220,270,490,72
ALEBTONG,2017,200,240,440,72
ALEBTONG,2018,200,230,430,72
ALEBTONG,2019,200,220,420,72
ALEBTONG,2020,210,240,450,72
ALEBTONG,2021,220,270,490,72
ALEBTONG,2022,240,290,530,72
ALEBTONG,2023,250,320,570,72
ALEBTONG,2024,260,340,600,72
ALEBTONG,2025,270,320,590,72
AMOLATAR,2015,60,90,150,72
AMOLATAR,2016,60,110,170,72
AMOLATAR,2017,60,110,170,72
AMOLATAR,2018,70,110,180,72
AMOLATAR,2019,60,100,160,72
AMOLATAR,2020,60,90,150,72
AMOLATAR,2021,60,80,140,72
AMOLATAR,2022,50,80,130,72
AMOLATAR,2023,60,90,150,72
AMOLATAR,2024,70,100,170,72
AMOLATAR,2025,70,110,180,72
AMUDAT,2015,40,40,80,72
AMUDAT,2016,50,40,90,72
AMUDAT,2017,40,30,70,72
AMUDAT,2018,40,30,70,72
AMUDAT,2019,40,40,80,72
AMUDAT,2020,40,40,80,72
AMUDAT,2021,50,40,90,72
AMUDAT,2022,50,40,90,72
AMUDAT,2023,50,50,100,72
AMUDAT,2024,50,50,100,72
AMUDAT,2025,50,60,110,72
AMURIA,2015,130,190,320,72
AMURIA,2016,130,180,310,72
AMURIA,2017,120,160,280,72
AMURIA,2018,120,150,270,72
AMURIA,2019,120,150,270,72
AMURIA,2020,130,160,290,72
AMURIA,2021,140,170,310,72
AMURIA,2022,150,200,350,72
AMURIA,2023,160,220,380,72
AMURIA,2024,170,230,400,72
AMURIA,2025,170,230,400,72
AMURU,2015,100,150,250,72
AMURU,2016,90,130,220,72
AMURU,2017,90,120,210,72
AMURU,2018,90,110,200,72
AMURU,2019,90,110,200,72
AMURU,2020,100,110,210,72
AMURU,2021,100,120,220,72
AMURU,2022,100,140,240,72
AMURU,2023,110,150,260,72
AMURU,2024,120,160,280,72
AMURU,2025,120,160,280,72
APAC,2015,180,170,350,72
APAC,2016,190,170,360,72
APAC,2017,190,180,370,72
APAC,2018,200,180,380,72
APAC,2019,210,190,400,72
APAC,2020,210,200,410,72
APAC,2021,220,200,420,72
APAC,2022,230,210,440,72
APAC,2023,240,220,460,72
APAC,2024,240,220,460,72
APAC,2025,250,230,480,72
ARUA,2015,500,540,1040,72
ARUA,2016,510,550,1060,72
ARUA,2017,530,570,1100,72
ARUA,2018,540,580,1120,72
ARUA,2019,560,600,1160,72
ARUA,2020,570,610,1180,72
ARUA,2021,590,630,1220,72
ARUA,2022,600,640,1240,72
ARUA,2023,620,660,1280,72
ARUA,2024,630,670,1300,72
ARUA,2025,650,690,1340,72
BUDAKA,2015,160,230,390,72
BUDAKA,2016,150,210,360,72
BUDAKA,2017,140,190,330,72
BUDAKA,2018,140,180,320,72
BUDAKA,2019,140,170,310,72
BUDAKA,2020,150,190,340,72
BUDAKA,2021,160,210,370,72
BUDAKA,2022,170,230,400,72
BUDAKA,2023,190,260,450,72
BUDAKA,2024,190,280,470,72
BUDAKA,2025,200,260,460,72
BUDUDA,2015,200,250,450,72
BUDUDA,2016,190,240,430,72
BUDUDA,2017,190,220,410,72
BUDUDA,2018,180,210,390,72
BUDUDA,2019,190,210,400,72
BUDUDA,2020,210,230,440,72
BUDUDA,2021,220,260,480,72
BUDUDA,2022,240,290,530,72
BUDUDA,2023,260,320,580,72
BUDUDA,2024,270,340,610,72
BUDUDA,2025,280,330,610,72
BUGIRI,2015,330,320,650,72
BUGIRI,2016,320,300,620,72
BUGIRI,2017,300,270,570,72
BUGIRI,2018,300,260,560,72
BUGIRI,2019,300,250,550,72
BUGIRI,2020,330,270,600,72
BUGIRI,2021,360,310,670,72
BUGIRI,2022,380,360,740,72
BUGIRI,2023,420,390,810,72
BUGIRI,2024,440,410,850,72
BUGIRI,2025,430,400,830,72
BUGWERI,2015,140,190,330,72
BUGWERI,2016,130,170,300,72
BUGWERI,2017,130,160,290,72
BUGWERI,2018,120,140,260,72
BUGWERI,2019,120,150,270,72
BUGWERI,2020,130,150,280,72
BUGWERI,2021,130,160,290,72
BUGWERI,2022,150,190,340,72
BUGWERI,2023,150,200,350,72
BUGWERI,2024,150,200,350,72
BUGWERI,2025,160,210,370,72
BUHWEJU,2015,80,80,160,72
BUHWEJU,2016,80,80,160,72
BUHWEJU,2017,90,80,170,72
BUHWEJU,2018,90,90,180,72
BUHWEJU,2019,90,90,180,72
BUHWEJU,2020,100,90,190,72
BUHWEJU,2021,100,90,190,72
BUHWEJU,2022,100,100,200,72
BUHWEJU,2023,100,100,200,72
BUHWEJU,2024,110,100,210,72
BUHWEJU,2025,110,100,210,72
BUIKWE,2015,270,330,600,72
BUIKWE,2016,250,310,560,72
BUIKWE,2017,240,270,510,72
BUIKWE,2018,220,260,480,72
BUIKWE,2019,230,250,480,72
BUIKWE,2020,230,270,500,72
BUIKWE,2021,250,290,540,72
BUIKWE,2022,270,320,590,72
BUIKWE,2023,280,340,620,72
BUIKWE,2024,290,360,650,72
BUIKWE,2025,280,340,620,72
BUKEDEA,2015,180,270,450,72
BUKEDEA,2016,170,240,410,72
BUKEDEA,2017,170,220,390,72
BUKEDEA,2018,170,210,380,72
BUKEDEA,2019,170,210,380,72
BUKEDEA,2020,180,230,410,72
BUKEDEA,2021,200,260,460,72
BUKEDEA,2022,220,290,510,72
BUKEDEA,2023,240,320,560,72
BUKEDEA,2024,250,340,590,72
BUKEDEA,2025,250,330,580,72
BUKOMANSIMBI,2015,130,250,380,72
BUKOMANSIMBI,2016,130,230,360,72
BUKOMANSIMBI,2017,120,200,320,72
BUKOMANSIMBI,2018,110,180,290,72
BUKOMANSIMBI,2019,110,170,280,72
BUKOMANSIMBI,2020,110,180,290,72
BUKOMANSIMBI,2021,120,190,310,72
BUKOMANSIMBI,2022,120,210,330,72
BUKOMANSIMBI,2023,130,220,350,72
BUKOMANSIMBI,2024,130,230,360,72
BUKOMANSIMBI,2025,120,220,340,72
BUKWO,2015,50,70,120,72
BUKWO,2016,50,80,130,72
BUKWO,2017,50,80,130,72
BUKWO,2018,60,90,150,72
BUKWO,2019,60,90,150,72
BUKWO,2020,60,90,150,72
BUKWO,2021,70,100,170,72
BUKWO,2022,70,100,170,72
BUKWO,2023,70,110,180,72
BUKWO,2024,80,110,190,72
BUKWO,2025,80,120,200,72
BULAMBULI,2015,190,230,420,72
BULAMBULI,2016,170,210,380,72
BULAMBULI,2017,170,200,370,72
BULAMBULI,2018,170,190,360,72
BULAMBULI,2019,180,190,370,72
BULAMBULI,2020,190,210,400,72
BULAMBULI,2021,210,230,440,72
BULAMBULI,2022,230,270,500,72
BULAMBULI,2023,240,300,540,72
BULAMBULI,2024,260,310,570,72
BULAMBULI,2025,270,310,580,72
BULIISA,2015,60,70,130,72
BULIISA,2016,70,70,140,72
BULIISA,2017,70,70,140,72
BULIISA,2018,80,70,150,72
BULIISA,2019,80,80,160,72
BULIISA,2020,80,80,160,72
BULIISA,2021,90,80,170,72
BULIISA,2022,90,90,180,72
BULIISA,2023,100,90,190,72
BULIISA,2024,100,100,200,72
BULIISA,2025,110,100,210,72
BUNDIBUGYO,2015,160,120,280,72
BUNDIBUGYO,2016,150,120,270,72
BUNDIBUGYO,2017,140,110,250,72
BUNDIBUGYO,2018,140,100,240,72
BUNDIBUGYO,2019,140,90,230,72
BUNDIBUGYO,2020,140,100,240,72
BUNDIBUGYO,2021,160,110,270,72
BUNDIBUGYO,2022,170,120,290,72
BUNDIBUGYO,2023,180,130,310,72
BUNDIBUGYO,2024,190,140,330,72
BUNDIBUGYO,2025,190,140,330,72
BUNYANGABU,2015,130,200,330,72
BUNYANGABU,2016,120,180,300,72
BUNYANGABU,2017,110,170,280,72
BUNYANGABU,2018,110,150,260,72
BUNYANGABU,2019,110,150,260,72
BUNYANGABU,2020,110,160,270,72
BUNYANGABU,2021,120,170,290,72
BUNYANGABU,2022,130,190,320,72
BUNYANGABU,2023,140,210,350,72
BUNYANGABU,2024,150,220,370,72
BUNYANGABU,2025,140,210,350,72
BUSHENYI,2015,220,210,430,72
BUSHENYI,2016,220,220,440,72
BUSHENYI,2017,230,220,450,72
BUSHENYI,2018,230,220,450,72
BUSHENYI,2019,230,220,450,72
BUSHENYI,2020,230,220,450,72
BUSHENYI,2021,240,220,460,72
BUSHENYI,2022,240,230,470,72
BUSHENYI,2023,240,230,470,72
BUSHENYI,2024,240,230,470,72
BUSHENYI,2025,240,230,470,72
BUSIA,2015,250,390,640,72
BUSIA,2016,230,360,590,72
BUSIA,2017,220,330,550,72
BUSIA,2018,220,300,520,72
BUSIA,2019,220,300,520,72
BUSIA,2020,230,310,540,72
BUSIA,2021,250,350,600,72
BUSIA,2022,260,390,650,72
BUSIA,2023,280,420,700,72
BUSIA,2024,290,440,730,72
BUSIA,2025,290,440,730,72
BUTALEJA,2015,190,250,440,72
BUTALEJA,2016,180,240,420,72
BUTALEJA,2017,180,210,390,72
BUTALEJA,2018,170,200,370,72
BUTALEJA,2019,170,200,370,72
BUTALEJA,2020,180,220,400,72
BUTALEJA,2021,200,230,430,72
BUTALEJA,2022,220,270,490,72
BUTALEJA,2023,240,300,540,72
BUTALEJA,2024,240,310,550,72
BUTALEJA,2025,240,310,550,72
BUTAMBALA,2015,60,90,150,72
BUTAMBALA,2016,50,80,130,72
BUTAMBALA,2017,50,70,120,72
BUTAMBALA,2018,50,70,120,72
BUTAMBALA,2019,50,70,120,72
BUTAMBALA,2020,50,80,130,72
BUTAMBALA,2021,50,80,130,72
BUTAMBALA,2022,50,90,140,72
BUTAMBALA,2023,50,90,140,72
BUTAMBALA,2024,50,100,150,72
BUTAMBALA,2025,50,90,140,72
BUTEBO,2015,90,120,210,72
BUTEBO,2016,80,110,190,72
BUTEBO,2017,80,90,170,72
BUTEBO,2018,70,100,170,72
BUTEBO,2019,70,90,160,72
BUTEBO,2020,70,90,160,72
BUTEBO,2021,70,100,170,72
BUTEBO,2022,90,110,200,72
BUTEBO,2023,90,120,210,72
BUTEBO,2024,90,120,210,72
BUTEBO,2025,90,110,200,72
BUVUMA,2015,60,20,80,72
BUVUMA,2016,60,20,80,72
BUVUMA,2017,70,20,90,72
BUVUMA,2018,70,20,90,72
BUVUMA,2019,80,30,110,72
BUVUMA,2020,80,30,110,72
BUVUMA,2021,90,30,120,72
BUVUMA,2022,90,30,120,72
BUVUMA,2023,100,30,130,72
BUVUMA,2024,100,40,140,72
BUVUMA,2025,110,40,150,72
BUYENDE,2015,220,230,450,72
BUYENDE,2016,210,210,420,72
BUYENDE,2017,200,190,390,72
BUYENDE,2018,200,180,380,72
BUYENDE,2019,200,180,380,72
BUYENDE,2020,220,200,420,72
BUYENDE,2021,240,220,460,72
BUYENDE,2022,260,240,500,72
BUYENDE,2023,280,270,550,72
BUYENDE,2024,300,290,590,72
BUYENDE,2025,300,290,590,72
DOKOLO,2015,160,160,320,72
DOKOLO,2016,160,160,320,72
DOKOLO,2017,170,170,340,72
DOKOLO,2018,170,170,340,72
DOKOLO,2019,180,180,360,72
DOKOLO,2020,180,180,360,72
DOKOLO,2021,190,180,370,72
DOKOLO,2022,190,190,380,72
DOKOLO,2023,200,190,390,72
DOKOLO,2024,200,200,400,72
DOKOLO,2025,210,200,410,72
GOMBA,2015,130,190,320,72
GOMBA,2016,120,180,300,72
GOMBA,2017,120,160,280,72
GOMBA,2018,110,140,250,72
GOMBA,2019,110,140,250,72
GOMBA,2020,110,140,250,72
GOMBA,2021,120,150,270,72
GOMBA,2022,130,180,310,72
GOMBA,2023,140,190,330,72
GOMBA,2024,140,190,330,72
GOMBA,2025,130,180,310,72
GULU,2015,170,200,370,72
GULU,2016,180,200,380,72
GULU,2017,180,210,390,72
GULU,2018,190,210,400,72
GULU,2019,190,220,410,72
GULU,2020,200,220,420,72
GULU,2021,200,230,430,72
GULU,2022,210,240,450,72
GULU,2023,220,240,460,72
GULU,2024,220,250,470,72
GULU,2025,230,260,490,72
HOIMA,2015,220,250,470,72
HOIMA,2016,230,250,480,72
HOIMA,2017,240,260,500,72
HOIMA,2018,240,270,510,72
HOIMA,2019,250,280,530,72
HOIMA,2020,260,290,550,72
HOIMA,2021,270,300,570,72
HOIMA,2022,280,310,590,72
HOIMA,2023,290,320,610,72
HOIMA,2024,300,330,630,72
HOIMA,2025,310,340,650,72
IBANDA,2015,210,220,430,72
IBANDA,2016,210,230,440,72
IBANDA,2017,210,230,440,72
IBANDA,2018,220,240,460,72
IBANDA,2019,220,240,460,72
IBANDA,2020,230,250,480,72
IBANDA,2021,230,250,480,72
IBANDA,2022,230,250,480,72
IBANDA,2023,240,260,500,72
IBANDA,2024,240,260,500,72
IBANDA,2025,240,260,500,72
IGANGA,2015,190,270,460,72
IGANGA,2016,180,250,430,72
IGANGA,2017,180,220,400,72
IGANGA,2018,170,210,380,72
IGANGA,2019,170,210,380,72
IGANGA,2020,180,220,400,72
IGANGA,2021,190,240,430,72
IGANGA,2022,210,270,480,72
IGANGA,2023,230,300,530,72
IGANGA,2024,230,310,540,72
IGANGA,2025,230,300,530,72
ISINGIRO,2015,350,330,680,72
ISINGIRO,2016,360,340,700,72
ISINGIRO,2017,370,350,720,72
ISINGIRO,2018,390,360,750,72
ISINGIRO,2019,400,380,780,72
ISINGIRO,2020,410,390,800,72
ISINGIRO,2021,430,400,830,72
ISINGIRO,2022,440,420,860,72
ISINGIRO,2023,460,430,890,72
ISINGIRO,2024,470,440,910,72
ISINGIRO,2025,490,460,950,72
JINJA,2015,280,300,580,72
JINJA,2016,280,300,580,72
JINJA,2017,290,310,600,72
JINJA,2018,290,310,600,72
JINJA,2019,300,320,620,72
JINJA,2020,300,320,620,72
JINJA,2021,310,320,630,72
JINJA,2022,310,330,640,72
JINJA,2023,310,330,640,72
JINJA,2024,320,340,660,72
JINJA,2025,320,340,660,72
KAABONG,2015,40,60,100,72
KAABONG,2016,40,60,100,72
KAABONG,2017,40,60,100,72
KAABONG,2018,40,60,100,72
KAABONG,2019,50,60,110,72
KAABONG,2020,50,70,120,72
KAABONG,2021,50,70,120,72
KAABONG,2022,50,70,120,72
KAABONG,2023,50,70,120,72
KAABONG,2024,50,70,120,72
KAABONG,2025,50,70,120,72
KABALE,2015,220,250,470,72
KABALE,2016,220,250,470,72
KABALE,2017,220,250,470,72
KABALE,2018,230,260,490,72
KABALE,2019,230,260,490,72
KABALE,2020,230,260,490,72
KABALE,2021,240,270,510,72
KABALE,2022,240,270,510,72
KABALE,2023,240,270,510,72
KABALE,2024,250,270,520,72
KABALE,2025,250,270,520,72
KABAROLE,2015,240,260,500,72
KABAROLE,2016,250,270,520,72
KABAROLE,2017,250,270,520,72
KABAROLE,2018,260,280,540,72
KABAROLE,2019,260,280,540,72
KABAROLE,2020,270,290,560,72
KABAROLE,2021,270,290,560,72
KABAROLE,2022,280,300,580,72
KABAROLE,2023,280,310,590,72
KABAROLE,2024,290,310,600,72
KABAROLE,2025,290,320,610,72
KABERAMAIDO,2015,100,130,230,72
KABERAMAIDO,2016,90,130,220,72
KABERAMAIDO,2017,90,120,210,72
KABERAMAIDO,2018,90,100,190,72
KABERAMAIDO,2019,90,110,200,72
KABERAMAIDO,2020,100,110,210,72
KABERAMAIDO,2021,100,130,230,72
KABERAMAIDO,2022,110,140,250,72
KABERAMAIDO,2023,130,170,300,72
KABERAMAIDO,2024,130,170,300,72
KABERAMAIDO,2025,130,170,300,72
KAGADI,2015,180,190,370,72
KAGADI,2016,190,200,390,72
KAGADI,2017,200,200,400,72
KAGADI,2018,200,210,410,72
KAGADI,2019,210,220,430,72
KAGADI,2020,220,230,450,72
KAGADI,2021,230,230,460,72
KAGADI,2022,230,240,470,72
KAGADI,2023,240,250,490,72
KAGADI,2024,250,260,510,72
KAGADI,2025,260,260,520,72
KAKUMIRO,2015,190,150,340,72
KAKUMIRO,2016,200,170,370,72
KAKUMIRO,2017,220,180,400,72
KAKUMIRO,2018,240,200,440,72
KAKUMIRO,2019,260,210,470,72
KAKUMIRO,2020,280,230,510,72
KAKUMIRO,2021,310,250,560,72
KAKUMIRO,2022,330,270,600,72
KAKUMIRO,2023,360,290,650,72
KAKUMIRO,2024,390,320,710,72
KAKUMIRO,2025,420,340,760,72
KALAKI,2015,100,110,210,72
KALAKI,2016,100,120,220,72
KALAKI,2017,110,120,230,72
KALAKI,2018,110,120,230,72
KALAKI,2019,120,130,250,72
KALAKI,2020,120,130,250,72
KALAKI,2021,130,140,270,72
KALAKI,2022,130,140,270,72
KALAKI,2023,140,150,290,72
KALAKI,2024,140,160,300,72
KALAKI,2025,150,160,310,72
KALANGALA,2015,50,20,70,72
KALANGALA,2016,50,20,70,72
KALANGALA,2017,60,20,80,72
KALANGALA,2018,60,20,80,72
KALANGALA,2019,60,20,80,72
KALANGALA,2020,60,30,90,72
KALANGALA,2021,60,30,90,72
KALANGALA,2022,70,30,100,72
KALANGALA,2023,70,30,100,72
KALANGALA,2024,70,30,100,72
KALANGALA,2025,70,30,100,72
KALIRO,2015,140,200,340,72
KALIRO,2016,140,190,330,72
KALIRO,2017,130,170,300,72
KALIRO,2018,130,160,290,72
KALIRO,2019,130,160,290,72
KALIRO,2020,140,170,310,72
KALIRO,2021,150,190,340,72
KALIRO,2022,160,210,370,72
KALIRO,2023,170,240,410,72
KALIRO,2024,180,240,420,72
KALIRO,2025,180,240,420,72
KALUNGU,2015,170,290,460,72
KALUNGU,2016,160,270,430,72
KALUNGU,2017,150,240,390,72
KALUNGU,2018,140,220,360,72
KALUNGU,2019,140,210,350,72
KALUNGU,2020,140,220,360,72
KALUNGU,2021,160,240,400,72
KALUNGU,2022,170,270,440,72
KALUNGU,2023,170,280,450,72
KALUNGU,2024,170,290,460,72
KALUNGU,2025,170,280,450,72
KAMPALA,2015,410,440,850,72
KAMPALA,2016,420,450,870,72
KAMPALA,2017,430,460,890,72
KAMPALA,2018,440,470,910,72
KAMPALA,2019,450,480,930,72
KAMPALA,2020,450,490,940,72
KAMPALA,2021,460,490,950,72
KAMPALA,2022,470,500,970,72
KAMPALA,2023,480,510,990,72
KAMPALA,2024,490,520,1010,72
KAMPALA,2025,490,530,1020,72
KAMULI,2015,320,440,760,72
KAMULI,2016,300,410,710,72
KAMULI,2017,280,370,650,72
KAMULI,2018,270,340,610,72
KAMULI,2019,270,330,600,72
KAMULI,2020,290,350,640,72
KAMULI,2021,310,390,700,72
KAMULI,2022,330,430,760,72
KAMULI,2023,350,460,810,72
KAMULI,2024,360,480,840,72
KAMULI,2025,350,470,820,72
KAMWENGE,2015,150,150,300,72
KAMWENGE,2016,160,150,310,72
KAMWENGE,2017,170,160,330,72
KAMWENGE,2018,170,170,340,72
KAMWENGE,2019,180,170,350,72
KAMWENGE,2020,190,180,370,72
KAMWENGE,2021,190,180,370,72
KAMWENGE,2022,200,190,390,72
KAMWENGE,2023,210,200,410,72
KAMWENGE,2024,220,200,420,72
KAMWENGE,2025,220,210,430,72
KANUNGU,2015,170,210,380,72
KANUNGU,2016,170,210,380,72
KANUNGU,2017,180,210,390,72
KANUNGU,2018,180,220,400,72
KANUNGU,2019,180,220,400,72
KANUNGU,2020,190,220,410,72
KANUNGU,2021,190,230,420,72
KANUNGU,2022,190,230,420,72
KANUNGU,2023,200,230,430,72
KANUNGU,2024,200,240,440,72
KANUNGU,2025,200,240,440,72
KAPCHORWA,2015,120,100,220,72
KAPCHORWA,2016,120,100,220,72
KAPCHORWA,2017,120,100,220,72
KAPCHORWA,2018,130,110,240,72
KAPCHORWA,2019,130,110,240,72
KAPCHORWA,2020,140,110,250,72
KAPCHORWA,2021,140,120,260,72
KAPCHORWA,2022,140,120,260,72
KAPCHORWA,2023,150,120,270,72
KAPCHORWA,2024,150,130,280,72
KAPCHORWA,2025,150,130,280,72
KAPELEBYONG,2015,50,80,130,72
KAPELEBYONG,2016,50,70,120,72
KAPELEBYONG,2017,50,60,110,72
KAPELEBYONG,2018,50,70,120,72
KAPELEBYONG,2019,50,60,110,72
KAPELEBYONG,2020,50,70,120,72
KAPELEBYONG,2021,50,70,120,72
KAPELEBYONG,2022,60,80,140,72
KAPELEBYONG,2023,60,90,150,72
KAPELEBYONG,2024,60,100,160,72
KAPELEBYONG,2025,60,90,150,72
KASESE,2015,420,430,850,72
KASESE,2016,390,380,770,72
KASESE,2017,370,350,720,72
KASESE,2018,360,320,680,72
KASESE,2019,360,310,670,72
KASESE,2020,370,330,700,72
KASESE,2021,400,370,770,72
KASESE,2022,440,400,840,72
KASESE,2023,460,440,900,72
KASESE,2024,470,450,920,72
KASESE,2025,470,440,910,72
KASSANDA,2015,230,180,410,72
KASSANDA,2016,240,190,430,72
KASSANDA,2017,250,190,440,72
KASSANDA,2018,250,190,440,72
KASSANDA,2019,260,200,460,72
KASSANDA,2020,270,200,470,72
KASSANDA,2021,270,210,480,72
KASSANDA,2022,280,210,490,72
KASSANDA,2023,290,210,500,72
KASSANDA,2024,290,220,510,72
KASSANDA,2025,300,220,520,72
KATAKWI,2015,220,320,540,72
KATAKWI,2016,200,300,500,72
KATAKWI,2017,190,270,460,72
KATAKWI,2018,190,250,440,72
KATAKWI,2019,190,250,440,72
KATAKWI,2020,200,260,460,72
KATAKWI,2021,220,290,510,72
KATAKWI,2022,230,320,550,72
KATAKWI,2023,240,340,580,72
KATAKWI,2024,260,360,620,72
KATAKWI,2025,250,360,610,72
KAYUNGA,2015,260,330,590,72
KAYUNGA,2016,250,300,550,72
KAYUNGA,2017,230,270,500,72
KAYUNGA,2018,220,250,470,72
KAYUNGA,2019,220,240,460,72
KAYUNGA,2020,230,260,490,72
KAYUNGA,2021,240,280,520,72
KAYUNGA,2022,260,300,560,72
KAYUNGA,2023,270,330,600,72
KAYUNGA,2024,280,340,620,72
KAYUNGA,2025,280,320,600,72
KAZO,2015,120,120,240,72
KAZO,2016,130,130,260,72
KAZO,2017,130,130,260,72
KAZO,2018,140,130,270,72
KAZO,2019,140,140,280,72
KAZO,2020,150,140,290,72
KAZO,2021,150,150,300,72
KAZO,2022,160,150,310,72
KAZO,2023,160,160,320,72
KAZO,2024,170,160,330,72
KAZO,2025,170,170,340,72
KIBAALE,2015,80,80,160,72
KIBAALE,2016,90,90,180,72
KIBAALE,2017,100,90,190,72
KIBAALE,2018,100,100,200,72
KIBAALE,2019,110,110,220,72
KIBAALE,2020,110,110,220,72
KIBAALE,2021,120,120,240,72
KIBAALE,2022,130,120,250,72
KIBAALE,2023,140,130,270,72
KIBAALE,2024,140,140,280,72
KIBAALE,2025,150,150,300,72
KIBOGA,2015,150,150,300,72
KIBOGA,2016,150,130,280,72
KIBOGA,2017,130,120,250,72
KIBOGA,2018,140,100,240,72
KIBOGA,2019,130,110,240,72
KIBOGA,2020,140,110,250,72
KIBOGA,2021,150,120,270,72
KIBOGA,2022,170,130,300,72
KIBOGA,2023,170,150,320,72
KIBOGA,2024,170,160,330,72
KIBOGA,2025,180,150,330,72
KIBUKU,2015,140,210,350,72
KIBUKU,2016,140,200,340,72
KIBUKU,2017,130,190,320,72
KIBUKU,2018,130,170,300,72
KIBUKU,2019,130,170,300,72
KIBUKU,2020,140,190,330,72
KIBUKU,2021,150,200,350,72
KIBUKU,2022,170,230,400,72
KIBUKU,2023,180,260,440,72
KIBUKU,2024,180,260,440,72
KIBUKU,2025,190,260,450,72
KIKUUBE,2015,200,160,360,72
KIKUUBE,2016,210,160,370,72
KIKUUBE,2017,220,170,390,72
KIKUUBE,2018,230,180,410,72
KIKUUBE,2019,240,190,430,72
KIKUUBE,2020,260,200,460,72
KIKUUBE,2021,270,210,480,72
KIKUUBE,2022,280,220,500,72
KIKUUBE,2023,300,230,530,72
KIKUUBE,2024,310,240,550,72
KIKUUBE,2025,330,250,580,72
KIRUHURA,2015,100,80,180,72
KIRUHURA,2016,100,80,180,72
KIRUHURA,2017,110,80,190,72
KIRUHURA,2018,110,90,200,72
KIRUHURA,2019,110,90,200,72
KIRUHURA,2020,120,90,210,72
KIRUHURA,2021,120,90,210,72
KIRUHURA,2022,130,100,230,72
KIRUHURA,2023,130,100,230,72
KIRUHURA,2024,130,100,230,72
KIRUHURA,2025,140,110,250,72
KIRYANDONGO,2015,180,190,370,72
KIRYANDONGO,2016,160,170,330,72
KIRYANDONGO,2017,160,150,310,72
KIRYANDONGO,2018,150,140,290,72
KIRYANDONGO,2019,160,140,300,72
KIRYANDONGO,2020,160,150,310,72
KIRYANDONGO,2021,170,160,330,72
KIRYANDONGO,2022,190,180,370,72
KIRYANDONGO,2023,200,200,400,72
KIRYANDONGO,2024,210,200,410,72
KIRYANDONGO,2025,200,210,410,72
KISORO,2015,200,290,490,72
KISORO,2016,180,260,440,72
KISORO,2017,180,230,410,72
KISORO,2018,170,220,390,72
KISORO,2019,160,210,370,72
KISORO,2020,170,230,400,72
KISORO,2021,180,240,420,72
KISORO,2022,200,280,480,72
KISORO,2023,210,300,510,72
KISORO,2024,210,300,510,72
KISORO,2025,210,300,510,72
KITAGWENDA,2015,120,110,230,72
KITAGWENDA,2016,130,110,240,72
KITAGWENDA,2017,130,120,250,72
KITAGWENDA,2018,140,120,260,72
KITAGWENDA,2019,140,130,270,72
KITAGWENDA,2020,150,130,280,72
KITAGWENDA,2021,160,130,290,72
KITAGWENDA,2022,160,140,300,72
KITAGWENDA,2023,170,140,310,72
KITAGWENDA,2024,170,150,320,72
KITAGWENDA,2025,180,150,330,72
KITGUM,2015,140,200,340,72
KITGUM,2016,140,190,330,72
KITGUM,2017,130,170,300,72
KITGUM,2018,120,150,270,72
KITGUM,2019,120,150,270,72
KITGUM,2020,130,150,280,72
KITGUM,2021,130,170,300,72
KITGUM,2022,140,190,330,72
KITGUM,2023,140,200,340,72
KITGUM,2024,150,200,350,72
KITGUM,2025,150,210,360,72
KOBOKO,2015,120,130,250,72
KOBOKO,2016,120,130,250,72
KOBOKO,2017,110,120,230,72
KOBOKO,2018,110,110,220,72
KOBOKO,2019,120,110,230,72
KOBOKO,2020,120,120,240,72
KOBOKO,2021,130,130,260,72
KOBOKO,2022,140,140,280,72
KOBOKO,2023,150,170,320,72
KOBOKO,2024,160,170,330,72
KOBOKO,2025,160,170,330,72
KOLE,2015,240,300,540,72
KOLE,2016,250,310,560,72
KOLE,2017,260,320,580,72
KOLE,2018,270,330,600,72
KOLE,2019,270,340,610,72
KOLE,2020,280,340,620,72
KOLE,2021,290,350,640,72
KOLE,2022,300,360,660,72
KOLE,2023,310,370,680,72
KOLE,2024,320,380,700,72
KOLE,2025,330,390,720,72
KOTIDO,2015,90,90,180,72
KOTIDO,2016,80,80,160,72
KOTIDO,2017,80,70,150,72
KOTIDO,2018,80,70,150,72
KOTIDO,2019,80,60,140,72
KOTIDO,2020,80,80,160,72
KOTIDO,2021,90,80,170,72
KOTIDO,2022,100,90,190,72
KOTIDO,2023,100,90,190,72
KOTIDO,2024,100,100,200,72
KOTIDO,2025,110,90,200,72
KUMI,2015,200,290,490,72
KUMI,2016,180,260,440,72
KUMI,2017,180,240,420,72
KUMI,2018,180,230,410,72
KUMI,2019,170,220,390,72
KUMI,2020,180,240,420,72
KUMI,2021,200,270,470,72
KUMI,2022,220,290,510,72
KUMI,2023,230,320,550,72
KUMI,2024,240,340,580,72
KUMI,2025,240,320,560,72
KWANIA,2015,170,200,370,72
KWANIA,2016,180,200,380,72
KWANIA,2017,180,210,390,72
KWANIA,2018,190,220,410,72
KWANIA,2019,190,220,410,72
KWANIA,2020,200,230,430,72
KWANIA,2021,210,230,440,72
KWANIA,2022,210,240,450,72
KWANIA,2023,220,250,470,72
KWANIA,2024,220,250,470,72
KWANIA,2025,230,260,490,72
KWEEN,2015,60,50,110,72
KWEEN,2016,70,50,120,72
KWEEN,2017,70,50,120,72
KWEEN,2018,70,50,120,72
KWEEN,2019,70,50,120,72
KWEEN,2020,70,50,120,72
KWEEN,2021,80,50,130,72
KWEEN,2022,80,60,140,72
KWEEN,2023,80,60,140,72
KWEEN,2024,80,60,140,72
KWEEN,2025,90,60,150,72
KYANKWANZI,2015,180,150,330,72
KYANKWANZI,2016,190,160,350,72
KYANKWANZI,2017,200,170,370,72
KYANKWANZI,2018,210,180,390,72
KYANKWANZI,2019,220,180,400,72
KYANKWANZI,2020,230,190,420,72
KYANKWANZI,2021,240,200,440,72
KYANKWANZI,2022,250,210,460,72
KYANKWANZI,2023,270,220,490,72
KYANKWANZI,2024,280,230,510,72
KYANKWANZI,2025,290,240,530,72
KYEGEGWA,2015,180,190,370,72
KYEGEGWA,2016,200,200,400,72
KYEGEGWA,2017,220,220,440,72
KYEGEGWA,2018,230,240,470,72
KYEGEGWA,2019,250,250,500,72
KYEGEGWA,2020,270,270,540,72
KYEGEGWA,2021,300,290,590,72
KYEGEGWA,2022,320,320,640,72
KYEGEGWA,2023,340,340,680,72
KYEGEGWA,2024,370,370,740,72
KYEGEGWA,2025,400,390,790,72
KYENJOJO,2015,310,340,650,72
KYENJOJO,2016,330,350,680,72
KYENJOJO,2017,340,360,700,72
KYENJOJO,2018,350,380,730,72
KYENJOJO,2019,370,390,760,72
KYENJOJO,2020,380,400,780,72
KYENJOJO,2021,400,420,820,72
KYENJOJO,2022,410,430,840,72
KYENJOJO,2023,430,450,880,72
KYENJOJO,2024,440,460,900,72
KYENJOJO,2025,460,480,940,72
KYOTERA,2015,200,320,520,72
KYOTERA,2016,180,290,470,72
KYOTERA,2017,170,260,430,72
KYOTERA,2018,170,240,410,72
KYOTERA,2019,160,230,390,72
KYOTERA,2020,170,250,420,72
KYOTERA,2021,180,270,450,72
KYOTERA,2022,190,290,480,72
KYOTERA,2023,200,320,520,72
KYOTERA,2024,210,320,530,72
KYOTERA,2025,200,310,510,72
KARENGA,2015,50,40,90,72
KARENGA,2016,50,40,90,72
KARENGA,2017,50,40,90,72
KARENGA,2018,50,40,90,72
KARENGA,2019,60,50,110,72
KARENGA,2020,60,50,110,72
KARENGA,2021,60,50,110,72
KARENGA,2022,60,50,110,72
KARENGA,2023,60,50,110,72
KARENGA,2024,60,50,110,72
KARENGA,2025,60,50,110,72
LAMWO,2015,100,170,270,72
LAMWO,2016,90,160,250,72
LAMWO,2017,80,150,230,72
LAMWO,2018,80,130,210,72
LAMWO,2019,80,130,210,72
LAMWO,2020,80,130,210,72
LAMWO,2021,80,140,220,72
LAMWO,2022,90,170,260,72
LAMWO,2023,100,180,280,72
LAMWO,2024,100,180,280,72
LAMWO,2025,100,170,270,72
LIRA,2015,300,290,590,72
LIRA,2016,310,290,600,72
LIRA,2017,310,300,610,72
LIRA,2018,320,310,630,72
LIRA,2019,330,320,650,72
LIRA,2020,340,330,670,72
LIRA,2021,350,340,690,72
LIRA,2022,360,350,710,72
LIRA,2023,370,350,720,72
LIRA,2024,380,360,740,72
LIRA,2025,380,370,750,72
LUUKA,2015,150,240,390,72
LUUKA,2016,140,210,350,72
LUUKA,2017,130,190,320,72
LUUKA,2018,130,180,310,72
LUUKA,2019,120,170,290,72
LUUKA,2020,130,190,320,72
LUUKA,2021,140,200,340,72
LUUKA,2022,150,220,370,72
LUUKA,2023,150,250,400,72
LUUKA,2024,160,250,410,72
LUUKA,2025,160,240,400,72
LUWERO,2015,320,430,750,72
LUWERO,2016,300,390,690,72
LUWERO,2017,290,350,640,72
LUWERO,2018,280,320,600,72
LUWERO,2019,280,320,600,72
LUWERO,2020,290,330,620,72
LUWERO,2021,310,370,680,72
LUWERO,2022,330,410,740,72
LUWERO,2023,350,450,800,72
LUWERO,2024,360,450,810,72
LUWERO,2025,360,450,810,72
LWENGO,2015,250,360,610,72
LWENGO,2016,230,330,560,72
LWENGO,2017,220,300,520,72
LWENGO,2018,210,270,480,72
LWENGO,2019,200,250,450,72
LWENGO,2020,210,270,480,72
LWENGO,2021,220,300,520,72
LWENGO,2022,240,320,560,72
LWENGO,2023,240,340,580,72
LWENGO,2024,250,350,600,72
LWENGO,2025,240,340,580,72
LYANTONDE,2015,50,90,140,72
LYANTONDE,2016,50,80,130,72
LYANTONDE,2017,40,70,110,72
LYANTONDE,2018,50,70,120,72
LYANTONDE,2019,50,70,120,72
LYANTONDE,2020,50,80,130,72
LYANTONDE,2021,50,80,130,72
LYANTONDE,2022,50,90,140,72
LYANTONDE,2023,50,90,140,72
LYANTONDE,2024,60,110,170,72
LYANTONDE,2025,60,100,160,72
MANAFWA,2015,170,230,400,72
MANAFWA,2016,170,240,410,72
MANAFWA,2017,170,240,410,72
MANAFWA,2018,180,250,430,72
MANAFWA,2019,180,250,430,72
MANAFWA,2020,190,260,450,72
MANAFWA,2021,190,260,450,72
MANAFWA,2022,190,270,460,72
MANAFWA,2023,200,270,470,72
MANAFWA,2024,200,280,480,72
MANAFWA,2025,210,280,490,72
MARACHA,2015,170,190,360,72
MARACHA,2016,170,190,360,72
MARACHA,2017,170,200,370,72
MARACHA,2018,180,200,380,72
MARACHA,2019,180,210,390,72
MARACHA,2020,180,210,390,72
MARACHA,2021,190,210,400,72
MARACHA,2022,190,220,410,72
MARACHA,2023,190,220,410,72
MARACHA,2024,200,220,420,72
MARACHA,2025,200,230,430,72
MASAKA,2015,200,320,520,72
MASAKA,2016,180,300,480,72
MASAKA,2017,180,260,440,72
MASAKA,2018,170,250,420,72
MASAKA,2019,170,240,410,72
MASAKA,2020,170,260,430,72
MASAKA,2021,190,280,470,72
MASAKA,2022,200,310,510,72
MASAKA,2023,220,330,550,72
MASAKA,2024,220,350,570,72
MASAKA,2025,210,330,540,72
MASINDI,2015,230,200,430,72
MASINDI,2016,240,200,440,72
MASINDI,2017,250,210,460,72
MASINDI,2018,250,220,470,72
MASINDI,2019,260,220,480,72
MASINDI,2020,270,230,500,72
MASINDI,2021,270,230,500,72
MASINDI,2022,280,240,520,72
MASINDI,2023,290,240,530,72
MASINDI,2024,290,250,540,72
MASINDI,2025,300,250,550,72
MAYUGE,2015,270,350,620,72
MAYUGE,2016,260,320,580,72
MAYUGE,2017,240,280,520,72
MAYUGE,2018,240,270,510,72
MAYUGE,2019,240,260,500,72
MAYUGE,2020,250,280,530,72
MAYUGE,2021,270,320,590,72
MAYUGE,2022,300,360,660,72
MAYUGE,2023,310,380,690,72
MAYUGE,2024,320,390,710,72
MAYUGE,2025,320,390,710,72
MBALE,2015,400,710,1110,72
MBALE,2016,380,660,1040,72
MBALE,2017,360,600,960,72
MBALE,2018,350,560,910,72
MBALE,2019,350,560,910,72
MBALE,2020,370,600,970,72
MBALE,2021,400,660,1060,72
MBALE,2022,430,740,1170,72
MBALE,2023,460,810,1270,72
MBALE,2024,470,850,1320,72
MBALE,2025,480,840,1320,72
MBARARA,2015,210,270,480,72
MBARARA,2016,220,270,490,72
MBARARA,2017,220,280,500,72
MBARARA,2018,230,280,510,72
MBARARA,2019,230,290,520,72
MBARARA,2020,240,290,530,72
MBARARA,2021,240,300,540,72
MBARARA,2022,240,310,550,72
MBARARA,2023,250,310,560,72
MBARARA,2024,250,320,570,72
MBARARA,2025,260,320,580,72
MITOOMA,2015,150,180,330,72
MITOOMA,2016,150,180,330,72
MITOOMA,2017,150,190,340,72
MITOOMA,2018,150,190,340,72
MITOOMA,2019,160,190,350,72
MITOOMA,2020,160,190,350,72
MITOOMA,2021,160,190,350,72
MITOOMA,2022,160,190,350,72
MITOOMA,2023,160,190,350,72
MITOOMA,2024,160,200,360,72
MITOOMA,2025,160,200,360,72
MITYANA,2015,310,390,700,72
MITYANA,2016,280,350,630,72
MITYANA,2017,270,320,590,72
MITYANA,2018,260,290,550,72
MITYANA,2019,260,280,540,72
MITYANA,2020,270,290,560,72
MITYANA,2021,280,330,610,72
MITYANA,2022,310,360,670,72
MITYANA,2023,320,380,700,72
MITYANA,2024,330,390,720,72
MITYANA,2025,320,380,700,72
MOROTO,2015,40,70,110,72
MOROTO,2016,40,70,110,72
MOROTO,2017,30,60,90,72
MOROTO,2018,40,60,100,72
MOROTO,2019,40,50,90,72
MOROTO,2020,40,60,100,72
MOROTO,2021,40,60,100,72
MOROTO,2022,40,70,110,72
MOROTO,2023,50,80,130,72
MOROTO,2024,50,80,130,72
MOROTO,2025,40,80,120,72
MOYO,2015,70,90,160,72
MOYO,2016,70,90,160,72
MOYO,2017,70,90,160,72
MOYO,2018,70,90,160,72
MOYO,2019,70,100,170,72
MOYO,2020,70,100,170,72
MOYO,2021,80,100,180,72
MOYO,2022,80,100,180,72
MOYO,2023,80,100,180,72
MOYO,2024,80,110,190,72
MOYO,2025,80,110,190,72
MPIGI,2015,180,240,420,72
MPIGI,2016,170,230,400,72
MPIGI,2017,160,200,360,72
MPIGI,2018,160,190,350,72
MPIGI,2019,160,180,340,72
MPIGI,2020,170,190,360,72
MPIGI,2021,170,210,380,72
MPIGI,2022,190,230,420,72
MPIGI,2023,200,260,460,72
MPIGI,2024,200,260,460,72
MPIGI,2025,200,260,460,72
MUBENDE,2015,250,280,530,72
MUBENDE,2016,240,260,500,72
MUBENDE,2017,230,250,480,72
MUBENDE,2018,230,240,470,72
MUBENDE,2019,230,240,470,72
MUBENDE,2020,250,260,510,72
MUBENDE,2021,280,300,580,72
MUBENDE,2022,310,330,640,72
MUBENDE,2023,330,370,700,72
MUBENDE,2024,360,390,750,72
MUBENDE,2025,360,390,750,72
MUKONO,2015,390,520,910,72
MUKONO,2016,370,480,850,72
MUKONO,2017,350,430,780,72
MUKONO,2018,340,400,740,72
MUKONO,2019,330,400,730,72
MUKONO,2020,350,430,780,72
MUKONO,2021,370,470,840,72
MUKONO,2022,400,520,920,72
MUKONO,2023,430,580,1010,72
MUKONO,2024,450,600,1050,72
MUKONO,2025,440,590,1030,72
MADI OKOLLO,2015,120,130,250,72
MADI OKOLLO,2016,120,140,260,72
MADI OKOLLO,2017,120,140,260,72
MADI OKOLLO,2018,130,150,280,72
MADI OKOLLO,2019,130,150,280,72
MADI OKOLLO,2020,130,150,280,72
MADI OKOLLO,2021,140,160,300,72
MADI OKOLLO,2022,140,160,300,72
MADI OKOLLO,2023,140,170,310,72
MADI OKOLLO,2024,150,170,320,72
MADI OKOLLO,2025,150,170,320,72
NABILATUK,2015,40,50,90,72
NABILATUK,2016,40,50,90,72
NABILATUK,2017,30,50,80,72
NABILATUK,2018,30,50,80,72
NABILATUK,2019,30,50,80,72
NABILATUK,2020,40,50,90,72
NABILATUK,2021,40,50,90,72
NABILATUK,2022,40,70,110,72
NABILATUK,2023,50,70,120,72
NABILATUK,2024,50,70,120,72
NABILATUK,2025,50,70,120,72
NAKAPIRIPIRIT,2015,80,90,170,72
NAKAPIRIPIRIT,2016,70,100,170,72
NAKAPIRIPIRIT,2017,70,80,150,72
NAKAPIRIPIRIT,2018,70,80,150,72
NAKAPIRIPIRIT,2019,70,80,150,72
NAKAPIRIPIRIT,2020,80,90,170,72
NAKAPIRIPIRIT,2021,80,100,180,72
NAKAPIRIPIRIT,2022,100,110,210,72
NAKAPIRIPIRIT,2023,100,120,220,72
NAKAPIRIPIRIT,2024,100,130,230,72
NAKAPIRIPIRIT,2025,110,130,240,72
NAKASEKE,2015,130,110,240,72
NAKASEKE,2016,130,120,250,72
NAKASEKE,2017,140,120,260,72
NAKASEKE,2018,140,120,260,72
NAKASEKE,2019,150,130,280,72
NAKASEKE,2020,150,130,280,72
NAKASEKE,2021,160,130,290,72
NAKASEKE,2022,160,130,290,72
NAKASEKE,2023,170,140,310,72
NAKASEKE,2024,170,140,310,72
NAKASEKE,2025,180,140,320,72
NAKASONGOLA,2015,130,150,280,72
NAKASONGOLA,2016,120,130,250,72
NAKASONGOLA,2017,120,120,240,72
NAKASONGOLA,2018,110,100,210,72
NAKASONGOLA,2019,120,110,230,72
NAKASONGOLA,2020,120,110,230,72
NAKASONGOLA,2021,130,120,250,72
NAKASONGOLA,2022,140,140,280,72
NAKASONGOLA,2023,140,150,290,72
NAKASONGOLA,2024,150,160,310,72
NAKASONGOLA,2025,150,160,310,72
NAMAYINGO,2015,130,120,250,72
NAMAYINGO,2016,120,110,230,72
NAMAYINGO,2017,110,100,210,72
NAMAYINGO,2018,110,90,200,72
NAMAYINGO,2019,110,90,200,72
NAMAYINGO,2020,110,90,200,72
NAMAYINGO,2021,110,100,210,72
NAMAYINGO,2022,130,110,240,72
NAMAYINGO,2023,130,120,250,72
NAMAYINGO,2024,140,120,260,72
NAMAYINGO,2025,130,120,250,72
NAMISINDWA,2015,190,250,440,72
NAMISINDWA,2016,200,260,460,72
NAMISINDWA,2017,200,260,460,72
NAMISINDWA,2018,210,270,480,72
NAMISINDWA,2019,210,280,490,72
NAMISINDWA,2020,220,280,500,72
NAMISINDWA,2021,230,290,520,72
NAMISINDWA,2022,230,300,530,72
NAMISINDWA,2023,240,300,540,72
NAMISINDWA,2024,240,310,550,72
NAMISINDWA,2025,250,310,560,72
NAMUTUMBA,2015,200,210,410,72
NAMUTUMBA,2016,180,190,370,72
NAMUTUMBA,2017,180,180,360,72
NAMUTUMBA,2018,180,160,340,72
NAMUTUMBA,2019,180,160,340,72
NAMUTUMBA,2020,180,170,350,72
NAMUTUMBA,2021,200,190,390,72
NAMUTUMBA,2022,220,210,430,72
NAMUTUMBA,2023,240,240,480,72
NAMUTUMBA,2024,250,240,490,72
NAMUTUMBA,2025,240,240,480,72
NAPAK,2015,70,150,220,72
NAPAK,2016,60,130,190,72
NAPAK,2017,60,120,180,72
NAPAK,2018,60,100,160,72
NAPAK,2019,50,100,150,72
NAPAK,2020,60,110,170,72
NAPAK,2021,60,120,180,72
NAPAK,2022,60,130,190,72
NAPAK,2023,60,140,200,72
NAPAK,2024,70,160,230,72
NAPAK,2025,70,150,220,72
NEBBI,2015,240,310,550,72
NEBBI,2016,250,320,570,72
NEBBI,2017,260,320,580,72
NEBBI,2018,270,330,600,72
NEBBI,2019,270,340,610,72
NEBBI,2020,280,350,630,72
NEBBI,2021,290,360,650,72
NEBBI,2022,300,370,670,72
NEBBI,2023,310,380,690,72
NEBBI,2024,320,390,710,72
NEBBI,2025,320,400,720,72
NGORA,2015,130,160,290,72
NGORA,2016,130,140,270,72
NGORA,2017,120,130,250,72
NGORA,2018,120,110,230,72
NGORA,2019,120,120,240,72
NGORA,2020,120,120,240,72
NGORA,2021,130,130,260,72
NGORA,2022,140,160,300,72
NGORA,2023,150,170,320,72
NGORA,2024,150,170,320,72
NGORA,2025,160,170,330,72
NTOROKO,2015,60,40,100,72
NTOROKO,2016,50,40,90,72
NTOROKO,2017,60,30,90,72
NTOROKO,2018,60,40,100,72
NTOROKO,2019,50,40,90,72
NTOROKO,2020,60,40,100,72
NTOROKO,2021,60,40,100,72
NTOROKO,2022,60,40,100,72
NTOROKO,2023,70,50,120,72
NTOROKO,2024,70,50,120,72
NTOROKO,2025,70,50,120,72
NTUNGAMO,2015,310,390,700,72
NTUNGAMO,2016,310,400,710,72
NTUNGAMO,2017,320,410,730,72
NTUNGAMO,2018,330,410,740,72
NTUNGAMO,2019,340,420,760,72
NTUNGAMO,2020,340,430,770,72
NTUNGAMO,2021,350,430,780,72
NTUNGAMO,2022,350,440,790,72
NTUNGAMO,2023,360,450,810,72
NTUNGAMO,2024,370,460,830,72
NTUNGAMO,2025,370,460,830,72
NWOYA,2015,70,90,160,72
NWOYA,2016,80,100,180,72
NWOYA,2017,90,110,200,72
NWOYA,2018,100,130,230,72
NWOYA,2019,110,140,250,72
NWOYA,2020,120,150,270,72
NWOYA,2021,140,170,310,72
NWOYA,2022,150,180,330,72
NWOYA,2023,160,200,360,72
NWOYA,2024,180,220,400,72
NWOYA,2025,200,240,440,72
OBONGI,2015,10,30,40,72
OBONGI,2016,10,20,30,72
OBONGI,2017,10,20,30,72
OBONGI,2018,10,20,30,72
OBONGI,2019,10,20,30,72
OBONGI,2020,10,20,30,72
OBONGI,2021,10,20,30,72
OBONGI,2022,10,20,30,72
OBONGI,2023,10,20,30,72
OBONGI,2024,10,20,30,72
OBONGI,2025,10,20,30,72
OMORO,2015,110,210,320,72
OMORO,2016,100,190,290,72
OMORO,2017,100,180,280,72
OMORO,2018,100,160,260,72
OMORO,2019,90,160,250,72
OMORO,2020,100,170,270,72
OMORO,2021,110,190,300,72
OMORO,2022,120,220,340,72
OMORO,2023,130,240,370,72
OMORO,2024,140,250,390,72
OMORO,2025,130,250,380,72
OTUKE,2015,100,80,180,72
OTUKE,2016,110,80,190,72
OTUKE,2017,110,90,200,72
OTUKE,2018,120,90,210,72
OTUKE,2019,120,100,220,72
OTUKE,2020,130,100,230,72
OTUKE,2021,130,100,230,72
OTUKE,2022,140,110,250,72
OTUKE,2023,140,110,250,72
OTUKE,2024,150,120,270,72
OTUKE,2025,160,120,280,72
OYAM,2015,320,340,660,72
OYAM,2016,330,350,680,72
OYAM,2017,340,360,700,72
OYAM,2018,350,370,720,72
OYAM,2019,360,380,740,72
OYAM,2020,370,390,760,72
OYAM,2021,380,410,790,72
OYAM,2022,390,420,810,72
OYAM,2023,400,430,830,72
OYAM,2024,410,440,850,72
OYAM,2025,420,450,870,72
PADER,2015,110,170,280,72
PADER,2016,100,160,260,72
PADER,2017,90,150,240,72
PADER,2018,100,130,230,72
PADER,2019,90,130,220,72
PADER,2020,100,130,230,72
PADER,2021,100,150,250,72
PADER,2022,100,170,270,72
PADER,2023,120,180,300,72
PADER,2024,120,180,300,72
PADER,2025,120,180,300,72
PAKWACH,2015,110,140,250,72
PAKWACH,2016,120,150,270,72
PAKWACH,2017,120,150,270,72
PAKWACH,2018,130,160,290,72
PAKWACH,2019,130,170,300,72
PAKWACH,2020,140,170,310,72
PAKWACH,2021,140,180,320,72
PAKWACH,2022,150,180,330,72
PAKWACH,2023,150,190,340,72
PAKWACH,2024,160,200,360,72
PAKWACH,2025,160,200,360,72
PALLISA,2015,190,250,440,72
PALLISA,2016,170,240,410,72
PALLISA,2017,170,220,390,72
PALLISA,2018,170,200,370,72
PALLISA,2019,170,200,370,72
PALLISA,2020,180,220,400,72
PALLISA,2021,200,240,440,72
PALLISA,2022,220,280,500,72
PALLISA,2023,240,310,550,72
PALLISA,2024,250,320,570,72
PALLISA,2025,250,320,570,72
RAKAI,2015,200,290,490,72
RAKAI,2016,180,260,440,72
RAKAI,2017,180,240,420,72
RAKAI,2018,170,220,390,72
RAKAI,2019,170,220,390,72
RAKAI,2020,170,230,400,72
RAKAI,2021,190,260,450,72
RAKAI,2022,200,280,480,72
RAKAI,2023,220,310,530,72
RAKAI,2024,220,310,530,72
RAKAI,2025,220,310,530,72
RUBANDA,2015,140,150,290,72
RUBANDA,2016,150,150,300,72
RUBANDA,2017,150,150,300,72
RUBANDA,2018,150,150,300,72
RUBANDA,2019,150,150,300,72
RUBANDA,2020,150,150,300,72
RUBANDA,2021,150,150,300,72
RUBANDA,2022,160,150,310,72
RUBANDA,2023,160,150,310,72
RUBANDA,2024,160,150,310,72
RUBANDA,2025,160,150,310,72
RUBIRIZI,2015,100,120,220,72
RUBIRIZI,2016,100,120,220,72
RUBIRIZI,2017,100,130,230,72
RUBIRIZI,2018,100,130,230,72
RUBIRIZI,2019,110,130,240,72
RUBIRIZI,2020,110,130,240,72
RUBIRIZI,2021,110,140,250,72
RUBIRIZI,2022,110,140,250,72
RUBIRIZI,2023,110,140,250,72
RUBIRIZI,2024,120,140,260,72
RUBIRIZI,2025,120,140,260,72
RUKIGA,2015,100,110,210,72
RUKIGA,2016,100,110,210,72
RUKIGA,2017,110,110,220,72
RUKIGA,2018,110,110,220,72
RUKIGA,2019,110,110,220,72
RUKIGA,2020,110,110,220,72
RUKIGA,2021,110,110,220,72
RUKIGA,2022,110,110,220,72
RUKIGA,2023,110,110,220,72
RUKIGA,2024,110,110,220,72
RUKIGA,2025,110,110,220,72
RUKUNGIRI,2015,300,350,650,72
RUKUNGIRI,2016,310,350,660,72
RUKUNGIRI,2017,310,350,660,72
RUKUNGIRI,2018,320,360,680,72
RUKUNGIRI,2019,320,360,680,72
RUKUNGIRI,2020,320,360,680,72
RUKUNGIRI,2021,330,370,700,72
RUKUNGIRI,2022,330,370,700,72
RUKUNGIRI,2023,330,370,700,72
RUKUNGIRI,2024,330,370,700,72
RUKUNGIRI,2025,340,380,720,72
RWAMPARA,2015,110,100,210,72
RWAMPARA,2016,110,110,220,72
RWAMPARA,2017,120,110,230,72
RWAMPARA,2018,120,110,230,72
RWAMPARA,2019,120,110,230,72
RWAMPARA,2020,120,120,240,72
RWAMPARA,2021,130,120,250,72
RWAMPARA,2022,130,120,250,72
RWAMPARA,2023,130,120,250,72
RWAMPARA,2024,130,130,260,72
RWAMPARA,2025,140,130,270,72
SERERE,2015,200,250,450,72
SERERE,2016,190,240,430,72
SERERE,2017,190,220,410,72
SERERE,2018,180,210,390,72
SERERE,2019,190,200,390,72
SERERE,2020,200,220,420,72
SERERE,2021,220,240,460,72
SERERE,2022,240,280,520,72
SERERE,2023,250,310,560,72
SERERE,2024,260,320,580,72
SERERE,2025,270,320,590,72
SHEEMA,2015,150,210,360,72
SHEEMA,2016,150,210,360,72
SHEEMA,2017,160,210,370,72
SHEEMA,2018,160,210,370,72
SHEEMA,2019,160,220,380,72
SHEEMA,2020,160,220,380,72
SHEEMA,2021,160,220,380,72
SHEEMA,2022,160,220,380,72
SHEEMA,2023,170,220,390,72
SHEEMA,2024,170,220,390,72
SHEEMA,2025,170,220,390,72
SIRONKO,2015,260,330,590,72
SIRONKO,2016,270,340,610,72
SIRONKO,2017,280,340,620,72
SIRONKO,2018,280,350,630,72
SIRONKO,2019,290,360,650,72
SIRONKO,2020,300,360,660,72
SIRONKO,2021,300,370,670,72
SIRONKO,2022,310,380,690,72
SIRONKO,2023,320,380,700,72
SIRONKO,2024,320,390,710,72
SIRONKO,2025,330,400,730,72
SOROTI,2015,210,230,440,72
SOROTI,2016,190,210,400,72
SOROTI,2017,190,190,380,72
SOROTI,2018,180,180,360,72
SOROTI,2019,190,180,370,72
SOROTI,2020,200,190,390,72
SOROTI,2021,220,210,430,72
SOROTI,2022,230,240,470,72
SOROTI,2023,240,260,500,72
SOROTI,2024,260,280,540,72
SOROTI,2025,260,280,540,72
SSEMBABULE,2015,180,230,410,72
SSEMBABULE,2016,160,210,370,72
SSEMBABULE,2017,160,190,350,72
SSEMBABULE,2018,150,180,330,72
SSEMBABULE,2019,160,170,330,72
SSEMBABULE,2020,160,180,340,72
SSEMBABULE,2021,170,200,370,72
SSEMBABULE,2022,180,220,400,72
SSEMBABULE,2023,200,250,450,72
SSEMBABULE,2024,210,250,460,72
SSEMBABULE,2025,200,250,450,72
TORORO,2015,480,520,1000,72
TORORO,2016,500,540,1040,72
TORORO,2017,510,550,1060,72
TORORO,2018,520,570,1090,72
TORORO,2019,540,580,1120,72
TORORO,2020,550,590,1140,72
TORORO,2021,560,610,1170,72
TORORO,2022,580,620,1200,72
TORORO,2023,590,630,1220,72
TORORO,2024,600,650,1250,72
TORORO,2025,620,660,1280,72
WAKISO,2015,640,880,1520,72
WAKISO,2016,680,940,1620,72
WAKISO,2017,720,1010,1730,72
WAKISO,2018,770,1080,1850,72
WAKISO,2019,820,1150,1970,72
WAKISO,2020,880,1230,2110,72
WAKISO,2021,930,1310,2240,72
WAKISO,2022,990,1390,2380,72
WAKISO,2023,1060,1480,2540,72
WAKISO,2024,1120,1580,2700,72
WAKISO,2025,1190,1680,2870,72
YUMBE,2015,270,310,580,72
YUMBE,2016,270,300,570,72
YUMBE,2017,250,270,520,72
YUMBE,2018,260,270,530,72
YUMBE,2019,260,260,520,72
YUMBE,2020,280,290,570,72
YUMBE,2021,310,340,650,72
YUMBE,2022,340,390,730,72
YUMBE,2023,370,440,810,72
YUMBE,2024,390,470,860,72
YUMBE,2025,400,470,870,72
ZOMBO,2015,270,350,620,72
ZOMBO,2016,280,360,640,72
ZOMBO,2017,290,370,660,72
ZOMBO,2018,300,380,680,72
ZOMBO,2019,310,390,700,72
ZOMBO,2020,320,400,720,72
ZOMBO,2021,330,410,740,72
ZOMBO,2022,340,420,760,72
ZOMBO,2023,350,430,780,72
ZOMBO,2024,360,440,800,72
ZOMBO,2025,360,450,810,72
ABIM,2015,40,50,90,73
ABIM,2016,40,70,110,73
ABIM,2017,50,60,110,73
ABIM,2018,50,50,100,73
ABIM,2019,50,50,100,73
ABIM,2020,40,60,100,73
ABIM,2021,60,60,120,73
ABIM,2022,60,70,130,73
ABIM,2023,60,70,130,73
ABIM,2024,70,90,160,73
ABIM,2025,80,90,170,73
ADJUMANI,2015,40,90,130,73
ADJUMANI,2016,40,90,130,73
ADJUMANI,2017,40,90,130,73
ADJUMANI,2018,40,90,130,73
ADJUMANI,2019,40,100,140,73
ADJUMANI,2020,40,100,140,73
ADJUMANI,2021,40,100,140,73
ADJUMANI,2022,40,100,140,73
ADJUMANI,2023,40,100,140,73
ADJUMANI,2024,40,100,140,73
ADJUMANI,2025,40,100,140,73
AGAGO,2015,110,130,240,73
AGAGO,2016,110,140,250,73
AGAGO,2017,110,140,250,73
AGAGO,2018,120,140,260,73
AGAGO,2019,120,140,260,73
AGAGO,2020,120,150,270,73
AGAGO,2021,120,150,270,73
AGAGO,2022,120,150,270,73
AGAGO,2023,120,150,270,73
AGAGO,2024,130,150,280,73
AGAGO,2025,130,160,290,73
ALEBTONG,2015,180,240,420,73
ALEBTONG,2016,180,220,400,73
ALEBTONG,2017,170,200,370,73
ALEBTONG,2018,160,190,350,73
ALEBTONG,2019,160,170,330,73
ALEBTONG,2020,160,170,330,73
ALEBTONG,2021,170,180,350,73
ALEBTONG,2022,180,200,380,73
ALEBTONG,2023,190,220,410,73
ALEBTONG,2024,210,240,450,73
ALEBTONG,2025,210,250,460,73
AMOLATAR,2015,70,80,150,73
AMOLATAR,2016,70,70,140,73
AMOLATAR,2017,70,80,150,73
AMOLATAR,2018,70,100,170,73
AMOLATAR,2019,70,100,170,73
AMOLATAR,2020,70,90,160,73
AMOLATAR,2021,70,80,150,73
AMOLATAR,2022,70,70,140,73
AMOLATAR,2023,70,70,140,73
AMOLATAR,2024,70,70,140,73
AMOLATAR,2025,70,80,150,73
AMUDAT,2015,30,40,70,73
AMUDAT,2016,30,30,60,73
AMUDAT,2017,30,30,60,73
AMUDAT,2018,20,30,50,73
AMUDAT,2019,20,20,40,73
AMUDAT,2020,20,20,40,73
AMUDAT,2021,20,20,40,73
AMUDAT,2022,40,30,70,73
AMUDAT,2023,40,30,70,73
AMUDAT,2024,40,30,70,73
AMUDAT,2025,40,50,90,73
AMURIA,2015,120,190,310,73
AMURIA,2016,120,180,300,73
AMURIA,2017,120,160,280,73
AMURIA,2018,110,150,260,73
AMURIA,2019,100,140,240,73
AMURIA,2020,110,140,250,73
AMURIA,2021,120,150,270,73
AMURIA,2022,130,160,290,73
AMURIA,2023,140,190,330,73
AMURIA,2024,150,200,350,73
AMURIA,2025,160,220,380,73
AMURU,2015,100,130,230,73
AMURU,2016,100,120,220,73
AMURU,2017,90,110,200,73
AMURU,2018,80,100,180,73
AMURU,2019,80,100,180,73
AMURU,2020,90,90,180,73
AMURU,2021,90,100,190,73
AMURU,2022,90,110,200,73
AMURU,2023,100,120,220,73
AMURU,2024,100,120,220,73
AMURU,2025,100,140,240,73
APAC,2015,100,110,210,73
APAC,2016,100,110,210,73
APAC,2017,110,120,230,73
APAC,2018,110,120,230,73
APAC,2019,120,130,250,73
APAC,2020,120,130,250,73
APAC,2021,120,140,260,73
APAC,2022,130,140,270,73
APAC,2023,130,140,270,73
APAC,2024,140,150,290,73
APAC,2025,140,150,290,73
ARUA,2015,260,300,560,73
ARUA,2016,270,310,580,73
ARUA,2017,280,320,600,73
ARUA,2018,290,330,620,73
ARUA,2019,300,330,630,73
ARUA,2020,300,340,640,73
ARUA,2021,310,350,660,73
ARUA,2022,320,360,680,73
ARUA,2023,330,370,700,73
ARUA,2024,340,380,720,73
ARUA,2025,340,390,730,73
BUDAKA,2015,160,260,420,73
BUDAKA,2016,160,260,420,73
BUDAKA,2017,160,230,390,73
BUDAKA,2018,140,220,360,73
BUDAKA,2019,150,200,350,73
BUDAKA,2020,150,200,350,73
BUDAKA,2021,150,210,360,73
BUDAKA,2022,170,240,410,73
BUDAKA,2023,170,260,430,73
BUDAKA,2024,200,290,490,73
BUDAKA,2025,200,310,510,73
BUDUDA,2015,150,220,370,73
BUDUDA,2016,160,220,380,73
BUDUDA,2017,140,200,340,73
BUDUDA,2018,140,190,330,73
BUDUDA,2019,140,180,320,73
BUDUDA,2020,150,180,330,73
BUDUDA,2021,160,200,360,73
BUDUDA,2022,170,210,380,73
BUDUDA,2023,190,250,440,73
BUDUDA,2024,200,280,480,73
BUDUDA,2025,210,290,500,73
BUGIRI,2015,220,310,530,73
BUGIRI,2016,230,310,540,73
BUGIRI,2017,210,290,500,73
BUGIRI,2018,210,270,480,73
BUGIRI,2019,200,250,450,73
BUGIRI,2020,200,250,450,73
BUGIRI,2021,220,270,490,73
BUGIRI,2022,240,300,540,73
BUGIRI,2023,260,330,590,73
BUGIRI,2024,290,370,660,73
BUGIRI,2025,290,390,680,73
BUGWERI,2015,100,110,210,73
BUGWERI,2016,100,120,220,73
BUGWERI,2017,90,110,200,73
BUGWERI,2018,80,100,180,73
BUGWERI,2019,80,90,170,73
BUGWERI,2020,90,80,170,73
BUGWERI,2021,90,90,180,73
BUGWERI,2022,90,110,200,73
BUGWERI,2023,100,120,220,73
BUGWERI,2024,100,120,220,73
BUGWERI,2025,100,120,220,73
BUHWEJU,2015,70,60,130,73
BUHWEJU,2016,70,60,130,73
BUHWEJU,2017,70,70,140,73
BUHWEJU,2018,70,70,140,73
BUHWEJU,2019,80,70,150,73
BUHWEJU,2020,80,70,150,73
BUHWEJU,2021,80,70,150,73
BUHWEJU,2022,80,80,160,73
BUHWEJU,2023,90,80,170,73
BUHWEJU,2024,90,80,170,73
BUHWEJU,2025,90,80,170,73
BUIKWE,2015,220,260,480,73
BUIKWE,2016,210,240,450,73
BUIKWE,2017,200,230,430,73
BUIKWE,2018,190,200,390,73
BUIKWE,2019,180,180,360,73
BUIKWE,2020,180,190,370,73
BUIKWE,2021,190,200,390,73
BUIKWE,2022,200,210,410,73
BUIKWE,2023,210,230,440,73
BUIKWE,2024,230,260,490,73
BUIKWE,2025,240,260,500,73
BUKEDEA,2015,160,260,420,73
BUKEDEA,2016,170,240,410,73
BUKEDEA,2017,160,230,390,73
BUKEDEA,2018,160,200,360,73
BUKEDEA,2019,150,200,350,73
BUKEDEA,2020,160,200,360,73
BUKEDEA,2021,160,210,370,73
BUKEDEA,2022,180,240,420,73
BUKEDEA,2023,200,270,470,73
BUKEDEA,2024,210,290,500,73
BUKEDEA,2025,220,310,530,73
BUKOMANSIMBI,2015,150,220,370,73
BUKOMANSIMBI,2016,140,210,350,73
BUKOMANSIMBI,2017,130,180,310,73
BUKOMANSIMBI,2018,130,160,290,73
BUKOMANSIMBI,2019,130,160,290,73
BUKOMANSIMBI,2020,120,150,270,73
BUKOMANSIMBI,2021,130,160,290,73
BUKOMANSIMBI,2022,130,170,300,73
BUKOMANSIMBI,2023,140,190,330,73
BUKOMANSIMBI,2024,140,200,340,73
BUKOMANSIMBI,2025,140,200,340,73
BUKWO,2015,40,30,70,73
BUKWO,2016,40,30,70,73
BUKWO,2017,50,40,90,73
BUKWO,2018,50,40,90,73
BUKWO,2019,50,40,90,73
BUKWO,2020,50,40,90,73
BUKWO,2021,60,40,100,73
BUKWO,2022,60,50,110,73
BUKWO,2023,60,50,110,73
BUKWO,2024,70,50,120,73
BUKWO,2025,70,50,120,73
BULAMBULI,2015,150,180,330,73
BULAMBULI,2016,140,170,310,73
BULAMBULI,2017,140,170,310,73
BULAMBULI,2018,130,150,280,73
BULAMBULI,2019,140,150,290,73
BULAMBULI,2020,130,140,270,73
BULAMBULI,2021,150,160,310,73
BULAMBULI,2022,170,170,340,73
BULAMBULI,2023,170,200,370,73
BULAMBULI,2024,200,210,410,73
BULAMBULI,2025,210,230,440,73
BULIISA,2015,40,40,80,73
BULIISA,2016,50,50,100,73
BULIISA,2017,50,50,100,73
BULIISA,2018,50,50,100,73
BULIISA,2019,50,50,100,73
BULIISA,2020,60,50,110,73
BULIISA,2021,60,60,120,73
BULIISA,2022,60,60,120,73
BULIISA,2023,70,60,130,73
BULIISA,2024,70,60,130,73
BULIISA,2025,70,70,140,73
BUNDIBUGYO,2015,160,160,320,73
BUNDIBUGYO,2016,170,160,330,73
BUNDIBUGYO,2017,160,150,310,73
BUNDIBUGYO,2018,140,140,280,73
BUNDIBUGYO,2019,150,120,270,73
BUNDIBUGYO,2020,150,120,270,73
BUNDIBUGYO,2021,160,130,290,73
BUNDIBUGYO,2022,170,150,320,73
BUNDIBUGYO,2023,170,160,330,73
BUNDIBUGYO,2024,200,170,370,73
BUNDIBUGYO,2025,200,190,390,73
BUNYANGABU,2015,150,200,350,73
BUNYANGABU,2016,140,190,330,73
BUNYANGABU,2017,130,170,300,73
BUNYANGABU,2018,120,150,270,73
BUNYANGABU,2019,130,150,280,73
BUNYANGABU,2020,120,140,260,73
BUNYANGABU,2021,130,150,280,73
BUNYANGABU,2022,140,160,300,73
BUNYANGABU,2023,150,190,340,73
BUNYANGABU,2024,160,200,360,73
BUNYANGABU,2025,160,200,360,73
BUSHENYI,2015,160,170,330,73
BUSHENYI,2016,160,180,340,73
BUSHENYI,2017,160,180,340,73
BUSHENYI,2018,160,180,340,73
BUSHENYI,2019,160,180,340,73
BUSHENYI,2020,170,180,350,73
BUSHENYI,2021,170,180,350,73
BUSHENYI,2022,170,180,350,73
BUSHENYI,2023,170,190,360,73
BUSHENYI,2024,170,190,360,73
BUSHENYI,2025,170,190,360,73
BUSIA,2015,190,270,460,73
BUSIA,2016,200,280,480,73
BUSIA,2017,180,250,430,73
BUSIA,2018,180,230,410,73
BUSIA,2019,170,210,380,73
BUSIA,2020,180,200,380,73
BUSIA,2021,180,220,400,73
BUSIA,2022,200,240,440,73
BUSIA,2023,210,270,480,73
BUSIA,2024,220,290,510,73
BUSIA,2025,240,310,550,73
BUTALEJA,2015,220,330,550,73
BUTALEJA,2016,230,330,560,73
BUTALEJA,2017,210,290,500,73
BUTALEJA,2018,210,270,480,73
BUTALEJA,2019,200,260,460,73
BUTALEJA,2020,200,250,450,73
BUTALEJA,2021,220,270,490,73
BUTALEJA,2022,240,300,540,73
BUTALEJA,2023,250,350,600,73
BUTALEJA,2024,270,370,640,73
BUTALEJA,2025,290,390,680,73
BUTAMBALA,2015,70,70,140,73
BUTAMBALA,2016,70,70,140,73
BUTAMBALA,2017,70,60,130,73
BUTAMBALA,2018,60,50,110,73
BUTAMBALA,2019,60,50,110,73
BUTAMBALA,2020,60,50,110,73
BUTAMBALA,2021,60,50,110,73
BUTAMBALA,2022,70,50,120,73
BUTAMBALA,2023,70,60,130,73
BUTAMBALA,2024,80,60,140,73
BUTAMBALA,2025,80,60,140,73
BUTEBO,2015,60,130,190,73
BUTEBO,2016,60,120,180,73
BUTEBO,2017,50,110,160,73
BUTEBO,2018,50,100,150,73
BUTEBO,2019,50,90,140,73
BUTEBO,2020,40,80,120,73
BUTEBO,2021,50,100,150,73
BUTEBO,2022,50,110,160,73
BUTEBO,2023,50,120,170,73
BUTEBO,2024,70,120,190,73
BUTEBO,2025,70,120,190,73
BUVUMA,2015,20,10,30,73
BUVUMA,2016,30,10,40,73
BUVUMA,2017,30,10,40,73
BUVUMA,2018,30,10,40,73
BUVUMA,2019,30,10,40,73
BUVUMA,2020,30,10,40,73
BUVUMA,2021,30,20,50,73
BUVUMA,2022,40,20,60,73
BUVUMA,2023,40,20,60,73
BUVUMA,2024,40,20,60,73
BUVUMA,2025,40,20,60,73
BUYENDE,2015,190,260,450,73
BUYENDE,2016,180,240,420,73
BUYENDE,2017,180,230,410,73
BUYENDE,2018,180,200,380,73
BUYENDE,2019,170,200,370,73
BUYENDE,2020,180,200,380,73
BUYENDE,2021,190,210,400,73
BUYENDE,2022,200,240,440,73
BUYENDE,2023,220,270,490,73
BUYENDE,2024,250,310,560,73
BUYENDE,2025,260,310,570,73
DOKOLO,2015,90,110,200,73
DOKOLO,2016,90,110,200,73
DOKOLO,2017,90,120,210,73
DOKOLO,2018,100,120,220,73
DOKOLO,2019,100,120,220,73
DOKOLO,2020,100,120,220,73
DOKOLO,2021,110,130,240,73
DOKOLO,2022,110,130,240,73
DOKOLO,2023,110,130,240,73
DOKOLO,2024,110,140,250,73
DOKOLO,2025,120,140,260,73
GOMBA,2015,180,200,380,73
GOMBA,2016,170,190,360,73
GOMBA,2017,160,170,330,73
GOMBA,2018,140,150,290,73
GOMBA,2019,150,150,300,73
GOMBA,2020,150,140,290,73
GOMBA,2021,150,150,300,73
GOMBA,2022,150,160,310,73
GOMBA,2023,160,170,330,73
GOMBA,2024,180,180,360,73
GOMBA,2025,180,190,370,73
GULU,2015,110,110,220,73
GULU,2016,110,120,230,73
GULU,2017,120,120,240,73
GULU,2018,120,120,240,73
GULU,2019,120,130,250,73
GULU,2020,130,130,260,73
GULU,2021,130,140,270,73
GULU,2022,140,140,280,73
GULU,2023,140,140,280,73
GULU,2024,140,150,290,73
GULU,2025,150,150,300,73
HOIMA,2015,130,170,300,73
HOIMA,2016,140,170,310,73
HOIMA,2017,140,180,320,73
HOIMA,2018,150,190,340,73
HOIMA,2019,160,190,350,73
HOIMA,2020,160,200,360,73
HOIMA,2021,170,210,380,73
HOIMA,2022,170,210,380,73
HOIMA,2023,180,220,400,73
HOIMA,2024,180,230,410,73
HOIMA,2025,190,230,420,73
IBANDA,2015,130,180,310,73
IBANDA,2016,130,180,310,73
IBANDA,2017,130,180,310,73
IBANDA,2018,130,190,320,73
IBANDA,2019,140,190,330,73
IBANDA,2020,140,190,330,73
IBANDA,2021,140,200,340,73
IBANDA,2022,140,200,340,73
IBANDA,2023,150,200,350,73
IBANDA,2024,150,200,350,73
IBANDA,2025,150,210,360,73
IGANGA,2015,160,160,320,73
IGANGA,2016,160,160,320,73
IGANGA,2017,140,150,290,73
IGANGA,2018,140,140,280,73
IGANGA,2019,140,120,260,73
IGANGA,2020,130,120,250,73
IGANGA,2021,150,130,280,73
IGANGA,2022,150,150,300,73
IGANGA,2023,170,160,330,73
IGANGA,2024,180,180,360,73
IGANGA,2025,180,190,370,73
ISINGIRO,2015,220,280,500,73
ISINGIRO,2016,230,290,520,73
ISINGIRO,2017,230,300,530,73
ISINGIRO,2018,240,310,550,73
ISINGIRO,2019,250,320,570,73
ISINGIRO,2020,260,330,590,73
ISINGIRO,2021,270,340,610,73
ISINGIRO,2022,280,350,630,73
ISINGIRO,2023,290,370,660,73
ISINGIRO,2024,300,380,680,73
ISINGIRO,2025,310,390,700,73
JINJA,2015,130,150,280,73
JINJA,2016,130,150,280,73
JINJA,2017,140,150,290,73
JINJA,2018,140,150,290,73
JINJA,2019,140,160,300,73
JINJA,2020,140,160,300,73
JINJA,2021,140,160,300,73
JINJA,2022,150,160,310,73
JINJA,2023,150,170,320,73
JINJA,2024,150,170,320,73
JINJA,2025,150,170,320,73
KAABONG,2015,40,50,90,73
KAABONG,2016,40,50,90,73
KAABONG,2017,40,50,90,73
KAABONG,2018,40,50,90,73
KAABONG,2019,40,50,90,73
KAABONG,2020,40,50,90,73
KAABONG,2021,50,50,100,73
KAABONG,2022,50,60,110,73
KAABONG,2023,50,60,110,73
KAABONG,2024,50,60,110,73
KAABONG,2025,50,60,110,73
KABALE,2015,190,250,440,73
KABALE,2016,200,260,460,73
KABALE,2017,200,260,460,73
KABALE,2018,200,260,460,73
KABALE,2019,210,260,470,73
KABALE,2020,210,270,480,73
KABALE,2021,210,270,480,73
KABALE,2022,210,270,480,73
KABALE,2023,220,270,490,73
KABALE,2024,220,280,500,73
KABALE,2025,220,280,500,73
KABAROLE,2015,200,220,420,73
KABAROLE,2016,200,220,420,73
KABAROLE,2017,210,230,440,73
KABAROLE,2018,210,230,440,73
KABAROLE,2019,220,240,460,73
KABAROLE,2020,220,240,460,73
KABAROLE,2021,220,250,470,73
KABAROLE,2022,230,250,480,73
KABAROLE,2023,230,250,480,73
KABAROLE,2024,240,260,500,73
KABAROLE,2025,240,260,500,73
KABERAMAIDO,2015,90,130,220,73
KABERAMAIDO,2016,80,140,220,73
KABERAMAIDO,2017,90,120,210,73
KABERAMAIDO,2018,80,110,190,73
KABERAMAIDO,2019,80,110,190,73
KABERAMAIDO,2020,90,110,200,73
KABERAMAIDO,2021,90,110,200,73
KABERAMAIDO,2022,90,130,220,73
KABERAMAIDO,2023,110,140,250,73
KABERAMAIDO,2024,120,150,270,73
KABERAMAIDO,2025,120,170,290,73
KAGADI,2015,160,160,320,73
KAGADI,2016,160,170,330,73
KAGADI,2017,170,180,350,73
KAGADI,2018,170,180,350,73
KAGADI,2019,180,190,370,73
KAGADI,2020,190,190,380,73
KAGADI,2021,190,200,390,73
KAGADI,2022,200,210,410,73
KAGADI,2023,210,210,420,73
KAGADI,2024,210,220,430,73
KAGADI,2025,220,230,450,73
KAKUMIRO,2015,120,120,240,73
KAKUMIRO,2016,130,130,260,73
KAKUMIRO,2017,150,150,300,73
KAKUMIRO,2018,160,160,320,73
KAKUMIRO,2019,170,170,340,73
KAKUMIRO,2020,190,190,380,73
KAKUMIRO,2021,200,200,400,73
KAKUMIRO,2022,220,220,440,73
KAKUMIRO,2023,240,230,470,73
KAKUMIRO,2024,260,250,510,73
KAKUMIRO,2025,280,270,550,73
KALAKI,2015,80,140,220,73
KALAKI,2016,90,140,230,73
KALAKI,2017,90,150,240,73
KALAKI,2018,90,150,240,73
KALAKI,2019,100,160,260,73
KALAKI,2020,100,170,270,73
KALAKI,2021,110,170,280,73
KALAKI,2022,110,180,290,73
KALAKI,2023,110,190,300,73
KALAKI,2024,120,190,310,73
KALAKI,2025,120,200,320,73
KALANGALA,2015,30,20,50,73
KALANGALA,2016,30,20,50,73
KALANGALA,2017,30,20,50,73
KALANGALA,2018,30,20,50,73
KALANGALA,2019,30,20,50,73
KALANGALA,2020,30,20,50,73
KALANGALA,2021,40,20,60,73
KALANGALA,2022,40,20,60,73
KALANGALA,2023,40,20,60,73
KALANGALA,2024,40,20,60,73
KALANGALA,2025,40,20,60,73
KALIRO,2015,220,290,510,73
KALIRO,2016,210,280,490,73
KALIRO,2017,210,260,470,73
KALIRO,2018,190,230,420,73
KALIRO,2019,190,220,410,73
KALIRO,2020,200,210,410,73
KALIRO,2021,210,230,440,73
KALIRO,2022,230,260,490,73
KALIRO,2023,240,290,530,73
KALIRO,2024,260,320,580,73
KALIRO,2025,280,340,620,73
KALUNGU,2015,160,290,450,73
KALUNGU,2016,160,290,450,73
KALUNGU,2017,140,260,400,73
KALUNGU,2018,140,230,370,73
KALUNGU,2019,140,210,350,73
KALUNGU,2020,130,200,330,73
KALUNGU,2021,140,210,350,73
KALUNGU,2022,140,220,360,73
KALUNGU,2023,150,250,400,73
KALUNGU,2024,160,280,440,73
KALUNGU,2025,160,280,440,73
KAMPALA,2015,250,290,540,73
KAMPALA,2016,260,290,550,73
KAMPALA,2017,260,300,560,73
KAMPALA,2018,270,300,570,73
KAMPALA,2019,270,310,580,73
KAMPALA,2020,280,310,590,73
KAMPALA,2021,280,320,600,73
KAMPALA,2022,290,320,610,73
KAMPALA,2023,290,330,620,73
KAMPALA,2024,300,340,640,73
KAMPALA,2025,300,340,640,73
KAMULI,2015,270,400,670,73
KAMULI,2016,270,380,650,73
KAMULI,2017,250,350,600,73
KAMULI,2018,240,310,550,73
KAMULI,2019,230,300,530,73
KAMULI,2020,230,280,510,73
KAMULI,2021,240,310,550,73
KAMULI,2022,260,330,590,73
KAMULI,2023,270,380,650,73
KAMULI,2024,300,400,700,73
KAMULI,2025,300,400,700,73
KAMWENGE,2015,120,120,240,73
KAMWENGE,2016,130,120,250,73
KAMWENGE,2017,140,130,270,73
KAMWENGE,2018,140,130,270,73
KAMWENGE,2019,150,130,280,73
KAMWENGE,2020,150,140,290,73
KAMWENGE,2021,160,140,300,73
KAMWENGE,2022,160,150,310,73
KAMWENGE,2023,170,150,320,73
KAMWENGE,2024,180,160,340,73
KAMWENGE,2025,180,160,340,73
KANUNGU,2015,160,200,360,73
KANUNGU,2016,160,200,360,73
KANUNGU,2017,170,200,370,73
KANUNGU,2018,170,210,380,73
KANUNGU,2019,170,210,380,73
KANUNGU,2020,170,210,380,73
KANUNGU,2021,180,220,400,73
KANUNGU,2022,180,220,400,73
KANUNGU,2023,180,220,400,73
KANUNGU,2024,190,220,410,73
KANUNGU,2025,190,230,420,73
KAPCHORWA,2015,60,70,130,73
KAPCHORWA,2016,60,70,130,73
KAPCHORWA,2017,60,70,130,73
KAPCHORWA,2018,60,70,130,73
KAPCHORWA,2019,60,70,130,73
KAPCHORWA,2020,60,70,130,73
KAPCHORWA,2021,70,80,150,73
KAPCHORWA,2022,70,80,150,73
KAPCHORWA,2023,70,80,150,73
KAPCHORWA,2024,70,80,150,73
KAPCHORWA,2025,70,80,150,73
KAPELEBYONG,2015,40,90,130,73
KAPELEBYONG,2016,40,90,130,73
KAPELEBYONG,2017,40,80,120,73
KAPELEBYONG,2018,50,70,120,73
KAPELEBYONG,2019,50,60,110,73
KAPELEBYONG,2020,40,70,110,73
KAPELEBYONG,2021,50,70,120,73
KAPELEBYONG,2022,50,80,130,73
KAPELEBYONG,2023,50,90,140,73
KAPELEBYONG,2024,50,90,140,73
KAPELEBYONG,2025,50,90,140,73
KASESE,2015,410,380,790,73
KASESE,2016,410,380,790,73
KASESE,2017,380,340,720,73
KASESE,2018,360,300,660,73
KASESE,2019,350,280,630,73
KASESE,2020,360,270,630,73
KASESE,2021,360,290,650,73
KASESE,2022,390,320,710,73
KASESE,2023,420,360,780,73
KASESE,2024,460,380,840,73
KASESE,2025,460,400,860,73
KASSANDA,2015,140,140,280,73
KASSANDA,2016,140,140,280,73
KASSANDA,2017,150,150,300,73
KASSANDA,2018,150,150,300,73
KASSANDA,2019,150,150,300,73
KASSANDA,2020,160,160,320,73
KASSANDA,2021,160,160,320,73
KASSANDA,2022,170,160,330,73
KASSANDA,2023,170,170,340,73
KASSANDA,2024,180,170,350,73
KASSANDA,2025,180,170,350,73
KATAKWI,2015,220,310,530,73
KATAKWI,2016,210,290,500,73
KATAKWI,2017,210,260,470,73
KATAKWI,2018,190,240,430,73
KATAKWI,2019,190,220,410,73
KATAKWI,2020,190,220,410,73
KATAKWI,2021,210,230,440,73
KATAKWI,2022,210,260,470,73
KATAKWI,2023,240,290,530,73
KATAKWI,2024,250,310,560,73
KATAKWI,2025,260,330,590,73
KAYUNGA,2015,240,290,530,73
KAYUNGA,2016,240,280,520,73
KAYUNGA,2017,220,260,480,73
KAYUNGA,2018,210,230,440,73
KAYUNGA,2019,200,210,410,73
KAYUNGA,2020,200,200,400,73
KAYUNGA,2021,210,220,430,73
KAYUNGA,2022,230,240,470,73
KAYUNGA,2023,240,260,500,73
KAYUNGA,2024,250,280,530,73
KAYUNGA,2025,260,290,550,73
KAZO,2015,100,80,180,73
KAZO,2016,100,80,180,73
KAZO,2017,110,90,200,73
KAZO,2018,110,90,200,73
KAZO,2019,120,90,210,73
KAZO,2020,120,100,220,73
KAZO,2021,130,100,230,73
KAZO,2022,130,100,230,73
KAZO,2023,130,110,240,73
KAZO,2024,140,110,250,73
KAZO,2025,140,110,250,73
KIBAALE,2015,50,50,100,73
KIBAALE,2016,50,60,110,73
KIBAALE,2017,50,60,110,73
KIBAALE,2018,60,60,120,73
KIBAALE,2019,60,70,130,73
KIBAALE,2020,60,70,130,73
KIBAALE,2021,70,70,140,73
KIBAALE,2022,70,80,150,73
KIBAALE,2023,80,80,160,73
KIBAALE,2024,80,90,170,73
KIBAALE,2025,90,90,180,73
KIBOGA,2015,120,180,300,73
KIBOGA,2016,110,170,280,73
KIBOGA,2017,120,170,290,73
KIBOGA,2018,110,150,260,73
KIBOGA,2019,100,140,240,73
KIBOGA,2020,100,130,230,73
KIBOGA,2021,110,150,260,73
KIBOGA,2022,120,160,280,73
KIBOGA,2023,120,170,290,73
KIBOGA,2024,130,180,310,73
KIBOGA,2025,140,200,340,73
KIBUKU,2015,150,240,390,73
KIBUKU,2016,160,240,400,73
KIBUKU,2017,140,220,360,73
KIBUKU,2018,130,200,330,73
KIBUKU,2019,140,180,320,73
KIBUKU,2020,130,190,320,73
KIBUKU,2021,150,200,350,73
KIBUKU,2022,150,220,370,73
KIBUKU,2023,170,250,420,73
KIBUKU,2024,180,280,460,73
KIBUKU,2025,200,290,490,73
KIKUUBE,2015,110,110,220,73
KIKUUBE,2016,120,120,240,73
KIKUUBE,2017,120,120,240,73
KIKUUBE,2018,130,130,260,73
KIKUUBE,2019,140,140,280,73
KIKUUBE,2020,140,140,280,73
KIKUUBE,2021,150,150,300,73
KIKUUBE,2022,160,160,320,73
KIKUUBE,2023,170,170,340,73
KIKUUBE,2024,180,170,350,73
KIKUUBE,2025,180,180,360,73
KIRUHURA,2015,80,70,150,73
KIRUHURA,2016,80,70,150,73
KIRUHURA,2017,80,80,160,73
KIRUHURA,2018,90,80,170,73
KIRUHURA,2019,90,80,170,73
KIRUHURA,2020,90,90,180,73
KIRUHURA,2021,90,90,180,73
KIRUHURA,2022,100,90,190,73
KIRUHURA,2023,100,90,190,73
KIRUHURA,2024,100,100,200,73
KIRUHURA,2025,110,100,210,73
KIRYANDONGO,2015,150,150,300,73
KIRYANDONGO,2016,140,160,300,73
KIRYANDONGO,2017,130,140,270,73
KIRYANDONGO,2018,130,120,250,73
KIRYANDONGO,2019,130,110,240,73
KIRYANDONGO,2020,120,120,240,73
KIRYANDONGO,2021,140,120,260,73
KIRYANDONGO,2022,140,130,270,73
KIRYANDONGO,2023,150,140,290,73
KIRYANDONGO,2024,170,170,340,73
KIRYANDONGO,2025,170,170,340,73
KISORO,2015,280,460,740,73
KISORO,2016,270,430,700,73
KISORO,2017,250,400,650,73
KISORO,2018,240,350,590,73
KISORO,2019,230,330,560,73
KISORO,2020,230,320,550,73
KISORO,2021,240,340,580,73
KISORO,2022,250,370,620,73
KISORO,2023,270,420,690,73
KISORO,2024,290,440,730,73
KISORO,2025,290,470,760,73
KITAGWENDA,2015,90,70,160,73
KITAGWENDA,2016,100,80,180,73
KITAGWENDA,2017,100,80,180,73
KITAGWENDA,2018,110,80,190,73
KITAGWENDA,2019,110,80,190,73
KITAGWENDA,2020,120,90,210,73
KITAGWENDA,2021,120,90,210,73
KITAGWENDA,2022,120,90,210,73
KITAGWENDA,2023,130,100,230,73
KITAGWENDA,2024,130,100,230,73
KITAGWENDA,2025,140,100,240,73
KITGUM,2015,160,220,380,73
KITGUM,2016,160,210,370,73
KITGUM,2017,140,200,340,73
KITGUM,2018,130,180,310,73
KITGUM,2019,130,160,290,73
KITGUM,2020,130,150,280,73
KITGUM,2021,140,160,300,73
KITGUM,2022,140,180,320,73
KITGUM,2023,150,200,350,73
KITGUM,2024,160,210,370,73
KITGUM,2025,160,220,380,73
KOBOKO,2015,100,130,230,73
KOBOKO,2016,100,120,220,73
KOBOKO,2017,100,120,220,73
KOBOKO,2018,100,110,210,73
KOBOKO,2019,90,100,190,73
KOBOKO,2020,90,90,180,73
KOBOKO,2021,100,110,210,73
KOBOKO,2022,110,120,230,73
KOBOKO,2023,110,130,240,73
KOBOKO,2024,130,150,280,73
KOBOKO,2025,130,160,290,73
KOLE,2015,160,190,350,73
KOLE,2016,160,200,360,73
KOLE,2017,170,200,370,73
KOLE,2018,180,210,390,73
KOLE,2019,180,210,390,73
KOLE,2020,190,220,410,73
KOLE,2021,190,230,420,73
KOLE,2022,200,230,430,73
KOLE,2023,200,240,440,73
KOLE,2024,210,240,450,73
KOLE,2025,210,250,460,73
KOTIDO,2015,70,90,160,73
KOTIDO,2016,70,100,170,73
KOTIDO,2017,70,90,160,73
KOTIDO,2018,60,80,140,73
KOTIDO,2019,70,70,140,73
KOTIDO,2020,70,70,140,73
KOTIDO,2021,70,70,140,73
KOTIDO,2022,70,80,150,73
KOTIDO,2023,70,90,160,73
KOTIDO,2024,80,110,190,73
KOTIDO,2025,80,110,190,73
KUMI,2015,220,310,530,73
KUMI,2016,210,310,520,73
KUMI,2017,210,280,490,73
KUMI,2018,210,260,470,73
KUMI,2019,190,230,420,73
KUMI,2020,200,240,440,73
KUMI,2021,210,240,450,73
KUMI,2022,230,280,510,73
KUMI,2023,240,300,540,73
KUMI,2024,260,340,600,73
KUMI,2025,260,360,620,73
KWANIA,2015,90,110,200,73
KWANIA,2016,100,120,220,73
KWANIA,2017,100,120,220,73
KWANIA,2018,100,120,220,73
KWANIA,2019,110,130,240,73
KWANIA,2020,110,130,240,73
KWANIA,2021,110,130,240,73
KWANIA,2022,110,140,250,73
KWANIA,2023,120,140,260,73
KWANIA,2024,120,140,260,73
KWANIA,2025,120,150,270,73
KWEEN,2015,20,40,60,73
KWEEN,2016,20,40,60,73
KWEEN,2017,30,40,70,73
KWEEN,2018,30,40,70,73
KWEEN,2019,30,40,70,73
KWEEN,2020,30,40,70,73
KWEEN,2021,30,40,70,73
KWEEN,2022,30,40,70,73
KWEEN,2023,30,40,70,73
KWEEN,2024,30,50,80,73
KWEEN,2025,30,50,80,73
KYANKWANZI,2015,140,120,260,73
KYANKWANZI,2016,140,130,270,73
KYANKWANZI,2017,150,130,280,73
KYANKWANZI,2018,160,140,300,73
KYANKWANZI,2019,170,150,320,73
KYANKWANZI,2020,180,150,330,73
KYANKWANZI,2021,180,160,340,73
KYANKWANZI,2022,190,170,360,73
KYANKWANZI,2023,200,170,370,73
KYANKWANZI,2024,210,180,390,73
KYANKWANZI,2025,220,190,410,73
KYEGEGWA,2015,150,160,310,73
KYEGEGWA,2016,160,170,330,73
KYEGEGWA,2017,170,190,360,73
KYEGEGWA,2018,190,200,390,73
KYEGEGWA,2019,200,220,420,73
KYEGEGWA,2020,220,230,450,73
KYEGEGWA,2021,230,250,480,73
KYEGEGWA,2022,250,270,520,73
KYEGEGWA,2023,270,290,560,73
KYEGEGWA,2024,290,310,600,73
KYEGEGWA,2025,320,330,650,73
KYENJOJO,2015,250,310,560,73
KYENJOJO,2016,260,330,590,73
KYENJOJO,2017,270,340,610,73
KYENJOJO,2018,290,350,640,73
KYENJOJO,2019,300,360,660,73
KYENJOJO,2020,310,380,690,73
KYENJOJO,2021,320,390,710,73
KYENJOJO,2022,330,400,730,73
KYENJOJO,2023,350,420,770,73
KYENJOJO,2024,360,430,790,73
KYENJOJO,2025,370,440,810,73
KYOTERA,2015,240,350,590,73
KYOTERA,2016,230,330,560,73
KYOTERA,2017,210,290,500,73
KYOTERA,2018,190,270,460,73
KYOTERA,2019,190,250,440,73
KYOTERA,2020,190,240,430,73
KYOTERA,2021,190,240,430,73
KYOTERA,2022,200,280,480,73
KYOTERA,2023,220,300,520,73
KYOTERA,2024,230,320,550,73
KYOTERA,2025,240,330,570,73
KARENGA,2015,30,30,60,73
KARENGA,2016,30,30,60,73
KARENGA,2017,30,30,60,73
KARENGA,2018,30,30,60,73
KARENGA,2019,30,30,60,73
KARENGA,2020,30,30,60,73
KARENGA,2021,30,40,70,73
KARENGA,2022,30,40,70,73
KARENGA,2023,30,40,70,73
KARENGA,2024,30,40,70,73
KARENGA,2025,30,40,70,73
LAMWO,2015,70,150,220,73
LAMWO,2016,70,140,210,73
LAMWO,2017,80,120,200,73
LAMWO,2018,70,110,180,73
LAMWO,2019,70,110,180,73
LAMWO,2020,70,110,180,73
LAMWO,2021,70,110,180,73
LAMWO,2022,70,120,190,73
LAMWO,2023,70,130,200,73
LAMWO,2024,80,140,220,73
LAMWO,2025,80,140,220,73
LIRA,2015,190,200,390,73
LIRA,2016,200,200,400,73
LIRA,2017,200,210,410,73
LIRA,2018,210,220,430,73
LIRA,2019,220,220,440,73
LIRA,2020,220,230,450,73
LIRA,2021,230,230,460,73
LIRA,2022,230,240,470,73
LIRA,2023,240,250,490,73
LIRA,2024,240,250,490,73
LIRA,2025,250,260,510,73
LUUKA,2015,130,200,330,73
LUUKA,2016,130,190,320,73
LUUKA,2017,130,170,300,73
LUUKA,2018,120,160,280,73
LUUKA,2019,110,150,260,73
LUUKA,2020,110,140,250,73
LUUKA,2021,110,150,260,73
LUUKA,2022,130,160,290,73
LUUKA,2023,140,190,330,73
LUUKA,2024,140,200,340,73
LUUKA,2025,140,200,340,73
LUWERO,2015,290,350,640,73
LUWERO,2016,300,350,650,73
LUWERO,2017,280,310,590,73
LUWERO,2018,270,290,560,73
LUWERO,2019,250,260,510,73
LUWERO,2020,260,260,520,73
LUWERO,2021,260,270,530,73
LUWERO,2022,280,300,580,73
LUWERO,2023,300,330,630,73
LUWERO,2024,330,350,680,73
LUWERO,2025,330,370,700,73
LWENGO,2015,240,350,590,73
LWENGO,2016,230,330,560,73
LWENGO,2017,220,290,510,73
LWENGO,2018,210,260,470,73
LWENGO,2019,190,230,420,73
LWENGO,2020,190,220,410,73
LWENGO,2021,190,240,430,73
LWENGO,2022,200,260,460,73
LWENGO,2023,220,290,510,73
LWENGO,2024,230,310,540,73
LWENGO,2025,240,310,550,73
LYANTONDE,2015,60,70,130,73
LYANTONDE,2016,60,90,150,73
LYANTONDE,2017,50,80,130,73
LYANTONDE,2018,50,70,120,73
LYANTONDE,2019,60,60,120,73
LYANTONDE,2020,60,60,120,73
LYANTONDE,2021,60,60,120,73
LYANTONDE,2022,60,70,130,73
LYANTONDE,2023,60,70,130,73
LYANTONDE,2024,70,90,160,73
LYANTONDE,2025,70,90,160,73
MANAFWA,2015,70,90,160,73
MANAFWA,2016,80,90,170,73
MANAFWA,2017,80,90,170,73
MANAFWA,2018,80,90,170,73
MANAFWA,2019,80,90,170,73
MANAFWA,2020,80,100,180,73
MANAFWA,2021,80,100,180,73
MANAFWA,2022,90,100,190,73
MANAFWA,2023,90,100,190,73
MANAFWA,2024,90,100,190,73
MANAFWA,2025,90,110,200,73
MARACHA,2015,80,100,180,73
MARACHA,2016,90,110,200,73
MARACHA,2017,90,110,200,73
MARACHA,2018,90,110,200,73
MARACHA,2019,90,110,200,73
MARACHA,2020,90,110,200,73
MARACHA,2021,90,120,210,73
MARACHA,2022,100,120,220,73
MARACHA,2023,100,120,220,73
MARACHA,2024,100,120,220,73
MARACHA,2025,100,120,220,73
MASAKA,2015,240,330,570,73
MASAKA,2016,230,310,540,73
MASAKA,2017,220,280,500,73
MASAKA,2018,210,260,470,73
MASAKA,2019,190,230,420,73
MASAKA,2020,200,220,420,73
MASAKA,2021,210,240,450,73
MASAKA,2022,230,260,490,73
MASAKA,2023,240,290,530,73
MASAKA,2024,250,320,570,73
MASAKA,2025,260,330,590,73
MASINDI,2015,140,140,280,73
MASINDI,2016,140,140,280,73
MASINDI,2017,140,150,290,73
MASINDI,2018,150,150,300,73
MASINDI,2019,150,160,310,73
MASINDI,2020,160,160,320,73
MASINDI,2021,160,160,320,73
MASINDI,2022,170,170,340,73
MASINDI,2023,170,170,340,73
MASINDI,2024,170,170,340,73
MASINDI,2025,180,180,360,73
MAYUGE,2015,250,290,540,73
MAYUGE,2016,240,280,520,73
MAYUGE,2017,240,260,500,73
MAYUGE,2018,220,230,450,73
MAYUGE,2019,220,220,440,73
MAYUGE,2020,210,210,420,73
MAYUGE,2021,230,230,460,73
MAYUGE,2022,250,250,500,73
MAYUGE,2023,260,290,550,73
MAYUGE,2024,290,310,600,73
MAYUGE,2025,290,330,620,73
MBALE,2015,280,470,750,73
MBALE,2016,280,470,750,73
MBALE,2017,260,430,690,73
MBALE,2018,250,390,640,73
MBALE,2019,250,370,620,73
MBALE,2020,250,370,620,73
MBALE,2021,260,390,650,73
MBALE,2022,280,440,720,73
MBALE,2023,300,490,790,73
MBALE,2024,330,540,870,73
MBALE,2025,340,560,900,73
MBARARA,2015,130,190,320,73
MBARARA,2016,140,190,330,73
MBARARA,2017,140,190,330,73
MBARARA,2018,140,200,340,73
MBARARA,2019,140,200,340,73
MBARARA,2020,150,210,360,73
MBARARA,2021,150,210,360,73
MBARARA,2022,150,210,360,73
MBARARA,2023,160,220,380,73
MBARARA,2024,160,220,380,73
MBARARA,2025,160,220,380,73
MITOOMA,2015,130,150,280,73
MITOOMA,2016,130,150,280,73
MITOOMA,2017,140,150,290,73
MITOOMA,2018,140,160,300,73
MITOOMA,2019,140,160,300,73
MITOOMA,2020,140,160,300,73
MITOOMA,2021,140,160,300,73
MITOOMA,2022,140,160,300,73
MITOOMA,2023,140,160,300,73
MITOOMA,2024,150,160,310,73
MITOOMA,2025,150,160,310,73
MITYANA,2015,290,370,660,73
MITYANA,2016,280,350,630,73
MITYANA,2017,280,320,600,73
MITYANA,2018,250,290,540,73
MITYANA,2019,240,260,500,73
MITYANA,2020,250,260,510,73
MITYANA,2021,250,270,520,73
MITYANA,2022,270,290,560,73
MITYANA,2023,290,330,620,73
MITYANA,2024,300,350,650,73
MITYANA,2025,310,360,670,73
MOROTO,2015,40,90,130,73
MOROTO,2016,40,90,130,73
MOROTO,2017,40,80,120,73
MOROTO,2018,40,70,110,73
MOROTO,2019,50,60,110,73
MOROTO,2020,40,60,100,73
MOROTO,2021,50,60,110,73
MOROTO,2022,50,80,130,73
MOROTO,2023,50,90,140,73
MOROTO,2024,50,90,140,73
MOROTO,2025,50,90,140,73
MOYO,2015,30,40,70,73
MOYO,2016,30,40,70,73
MOYO,2017,30,50,80,73
MOYO,2018,30,50,80,73
MOYO,2019,30,50,80,73
MOYO,2020,40,50,90,73
MOYO,2021,40,50,90,73
MOYO,2022,40,50,90,73
MOYO,2023,40,50,90,73
MOYO,2024,40,50,90,73
MOYO,2025,40,50,90,73
MPIGI,2015,150,270,420,73
MPIGI,2016,140,260,400,73
MPIGI,2017,140,230,370,73
MPIGI,2018,130,220,350,73
MPIGI,2019,130,200,330,73
MPIGI,2020,120,190,310,73
MPIGI,2021,140,210,350,73
MPIGI,2022,140,220,360,73
MPIGI,2023,150,250,400,73
MPIGI,2024,160,280,440,73
MPIGI,2025,170,280,450,73
MUBENDE,2015,190,290,480,73
MUBENDE,2016,180,290,470,73
MUBENDE,2017,180,280,460,73
MUBENDE,2018,180,260,440,73
MUBENDE,2019,180,250,430,73
MUBENDE,2020,180,250,430,73
MUBENDE,2021,190,270,460,73
MUBENDE,2022,210,300,510,73
MUBENDE,2023,240,350,590,73
MUBENDE,2024,260,380,640,73
MUBENDE,2025,280,400,680,73
MUKONO,2015,320,420,740,73
MUKONO,2016,330,410,740,73
MUKONO,2017,300,380,680,73
MUKONO,2018,290,340,630,73
MUKONO,2019,280,320,600,73
MUKONO,2020,280,320,600,73
MUKONO,2021,300,330,630,73
MUKONO,2022,320,370,690,73
MUKONO,2023,340,420,760,73
MUKONO,2024,360,460,820,73
MUKONO,2025,370,470,840,73
MADI OKOLLO,2015,50,60,110,73
MADI OKOLLO,2016,50,60,110,73
MADI OKOLLO,2017,60,70,130,73
MADI OKOLLO,2018,60,70,130,73
MADI OKOLLO,2019,60,70,130,73
MADI OKOLLO,2020,60,70,130,73
MADI OKOLLO,2021,60,70,130,73
MADI OKOLLO,2022,60,70,130,73
MADI OKOLLO,2023,60,80,140,73
MADI OKOLLO,2024,70,80,150,73
MADI OKOLLO,2025,70,80,150,73
NABILATUK,2015,30,40,70,73
NABILATUK,2016,30,30,60,73
NABILATUK,2017,40,50,90,73
NABILATUK,2018,40,40,80,73
NABILATUK,2019,30,40,70,73
NABILATUK,2020,30,40,70,73
NABILATUK,2021,30,40,70,73
NABILATUK,2022,40,40,80,73
NABILATUK,2023,40,40,80,73
NABILATUK,2024,50,50,100,73
NABILATUK,2025,50,60,110,73
NAKAPIRIPIRIT,2015,30,70,100,73
NAKAPIRIPIRIT,2016,30,70,100,73
NAKAPIRIPIRIT,2017,30,60,90,73
NAKAPIRIPIRIT,2018,20,50,70,73
NAKAPIRIPIRIT,2019,30,60,90,73
NAKAPIRIPIRIT,2020,30,60,90,73
NAKAPIRIPIRIT,2021,30,60,90,73
NAKAPIRIPIRIT,2022,40,70,110,73
NAKAPIRIPIRIT,2023,40,70,110,73
NAKAPIRIPIRIT,2024,40,90,130,73
NAKAPIRIPIRIT,2025,40,90,130,73
NAKASEKE,2015,80,90,170,73
NAKASEKE,2016,80,90,170,73
NAKASEKE,2017,90,100,190,73
NAKASEKE,2018,90,100,190,73
NAKASEKE,2019,90,100,190,73
NAKASEKE,2020,100,100,200,73
NAKASEKE,2021,100,110,210,73
NAKASEKE,2022,100,110,210,73
NAKASEKE,2023,110,110,220,73
NAKASEKE,2024,110,110,220,73
NAKASEKE,2025,110,120,230,73
NAKASONGOLA,2015,100,150,250,73
NAKASONGOLA,2016,100,140,240,73
NAKASONGOLA,2017,90,120,210,73
NAKASONGOLA,2018,100,110,210,73
NAKASONGOLA,2019,90,100,190,73
NAKASONGOLA,2020,90,110,200,73
NAKASONGOLA,2021,90,110,200,73
NAKASONGOLA,2022,110,120,230,73
NAKASONGOLA,2023,110,130,240,73
NAKASONGOLA,2024,120,140,260,73
NAKASONGOLA,2025,120,160,280,73
NAMAYINGO,2015,90,130,220,73
NAMAYINGO,2016,80,120,200,73
NAMAYINGO,2017,80,110,190,73
NAMAYINGO,2018,70,100,170,73
NAMAYINGO,2019,70,90,160,73
NAMAYINGO,2020,80,80,160,73
NAMAYINGO,2021,80,90,170,73
NAMAYINGO,2022,80,90,170,73
NAMAYINGO,2023,90,120,210,73
NAMAYINGO,2024,90,120,210,73
NAMAYINGO,2025,90,120,210,73
NAMISINDWA,2015,70,90,160,73
NAMISINDWA,2016,70,90,160,73
NAMISINDWA,2017,70,90,160,73
NAMISINDWA,2018,80,100,180,73
NAMISINDWA,2019,80,100,180,73
NAMISINDWA,2020,80,100,180,73
NAMISINDWA,2021,80,100,180,73
NAMISINDWA,2022,80,100,180,73
NAMISINDWA,2023,90,110,200,73
NAMISINDWA,2024,90,110,200,73
NAMISINDWA,2025,90,110,200,73
NAMUTUMBA,2015,210,270,480,73
NAMUTUMBA,2016,200,260,460,73
NAMUTUMBA,2017,200,250,450,73
NAMUTUMBA,2018,180,220,400,73
NAMUTUMBA,2019,180,210,390,73
NAMUTUMBA,2020,180,200,380,73
NAMUTUMBA,2021,190,220,410,73
NAMUTUMBA,2022,210,240,450,73
NAMUTUMBA,2023,220,270,490,73
NAMUTUMBA,2024,250,310,560,73
NAMUTUMBA,2025,250,310,560,73
NAPAK,2015,70,110,180,73
NAPAK,2016,70,100,170,73
NAPAK,2017,70,110,180,73
NAPAK,2018,60,100,160,73
NAPAK,2019,60,90,150,73
NAPAK,2020,60,80,140,73
NAPAK,2021,60,90,150,73
NAPAK,2022,60,90,150,73
NAPAK,2023,60,100,160,73
NAPAK,2024,70,110,180,73
NAPAK,2025,70,120,190,73
NEBBI,2015,130,230,360,73
NEBBI,2016,130,240,370,73
NEBBI,2017,140,250,390,73
NEBBI,2018,140,250,390,73
NEBBI,2019,150,260,410,73
NEBBI,2020,150,270,420,73
NEBBI,2021,160,270,430,73
NEBBI,2022,160,280,440,73
NEBBI,2023,170,290,460,73
NEBBI,2024,170,300,470,73
NEBBI,2025,170,300,470,73
NGORA,2015,130,180,310,73
NGORA,2016,130,170,300,73
NGORA,2017,120,170,290,73
NGORA,2018,110,150,260,73
NGORA,2019,110,140,250,73
NGORA,2020,110,130,240,73
NGORA,2021,110,150,260,73
NGORA,2022,130,160,290,73
NGORA,2023,140,170,310,73
NGORA,2024,140,180,320,73
NGORA,2025,140,200,340,73
NTOROKO,2015,40,40,80,73
NTOROKO,2016,40,30,70,73
NTOROKO,2017,50,30,80,73
NTOROKO,2018,50,30,80,73
NTOROKO,2019,50,20,70,73
NTOROKO,2020,40,20,60,73
NTOROKO,2021,50,20,70,73
NTOROKO,2022,50,40,90,73
NTOROKO,2023,50,40,90,73
NTOROKO,2024,50,50,100,73
NTOROKO,2025,50,50,100,73
NTUNGAMO,2015,250,360,610,73
NTUNGAMO,2016,250,370,620,73
NTUNGAMO,2017,260,380,640,73
NTUNGAMO,2018,260,380,640,73
NTUNGAMO,2019,270,390,660,73
NTUNGAMO,2020,280,400,680,73
NTUNGAMO,2021,280,400,680,73
NTUNGAMO,2022,290,410,700,73
NTUNGAMO,2023,290,410,700,73
NTUNGAMO,2024,300,420,720,73
NTUNGAMO,2025,300,430,730,73
NWOYA,2015,60,70,130,73
NWOYA,2016,60,70,130,73
NWOYA,2017,70,80,150,73
NWOYA,2018,80,90,170,73
NWOYA,2019,90,100,190,73
NWOYA,2020,90,110,200,73
NWOYA,2021,100,120,220,73
NWOYA,2022,110,130,240,73
NWOYA,2023,130,140,270,73
NWOYA,2024,140,160,300,73
NWOYA,2025,150,170,320,73
OBONGI,2015,10,20,30,73
OBONGI,2016,10,20,30,73
OBONGI,2017,10,20,30,73
OBONGI,2018,10,10,20,73
OBONGI,2019,10,10,20,73
OBONGI,2020,10,10,20,73
OBONGI,2021,10,10,20,73
OBONGI,2022,10,10,20,73
OBONGI,2023,10,10,20,73
OBONGI,2024,30,20,50,73
OBONGI,2025,30,20,50,73
OMORO,2015,120,160,280,73
OMORO,2016,110,170,280,73
OMORO,2017,100,150,250,73
OMORO,2018,100,140,240,73
OMORO,2019,100,140,240,73
OMORO,2020,100,130,230,73
OMORO,2021,100,150,250,73
OMORO,2022,120,160,280,73
OMORO,2023,120,170,290,73
OMORO,2024,130,200,330,73
OMORO,2025,140,200,340,73
OTUKE,2015,50,70,120,73
OTUKE,2016,60,70,130,73
OTUKE,2017,60,80,140,73
OTUKE,2018,60,80,140,73
OTUKE,2019,60,80,140,73
OTUKE,2020,70,90,160,73
OTUKE,2021,70,90,160,73
OTUKE,2022,70,90,160,73
OTUKE,2023,70,100,170,73
OTUKE,2024,80,100,180,73
OTUKE,2025,80,100,180,73
OYAM,2015,180,220,400,73
OYAM,2016,180,230,410,73
OYAM,2017,190,240,430,73
OYAM,2018,190,240,430,73
OYAM,2019,200,250,450,73
OYAM,2020,200,260,460,73
OYAM,2021,210,260,470,73
OYAM,2022,210,270,480,73
OYAM,2023,220,280,500,73
OYAM,2024,230,280,510,73
OYAM,2025,230,290,520,73
PADER,2015,70,130,200,73
PADER,2016,70,120,190,73
PADER,2017,70,110,180,73
PADER,2018,60,100,160,73
PADER,2019,60,100,160,73
PADER,2020,60,90,150,73
PADER,2021,60,100,160,73
PADER,2022,60,110,170,73
PADER,2023,70,120,190,73
PADER,2024,80,120,200,73
PADER,2025,80,120,200,73
PAKWACH,2015,70,120,190,73
PAKWACH,2016,70,120,190,73
PAKWACH,2017,70,120,190,73
PAKWACH,2018,70,130,200,73
PAKWACH,2019,80,130,210,73
PAKWACH,2020,80,140,220,73
PAKWACH,2021,80,140,220,73
PAKWACH,2022,90,150,240,73
PAKWACH,2023,90,150,240,73
PAKWACH,2024,90,160,250,73
PAKWACH,2025,100,160,260,73
PALLISA,2015,190,290,480,73
PALLISA,2016,180,290,470,73
PALLISA,2017,180,260,440,73
PALLISA,2018,170,240,410,73
PALLISA,2019,170,230,400,73
PALLISA,2020,180,240,420,73
PALLISA,2021,180,260,440,73
PALLISA,2022,200,280,480,73
PALLISA,2023,220,320,540,73
PALLISA,2024,250,350,600,73
PALLISA,2025,250,370,620,73
RAKAI,2015,210,260,470,73
RAKAI,2016,200,260,460,73
RAKAI,2017,200,230,430,73
RAKAI,2018,180,200,380,73
RAKAI,2019,170,200,370,73
RAKAI,2020,180,190,370,73
RAKAI,2021,180,200,380,73
RAKAI,2022,190,220,410,73
RAKAI,2023,210,250,460,73
RAKAI,2024,220,260,480,73
RAKAI,2025,240,260,500,73
RUBANDA,2015,120,170,290,73
RUBANDA,2016,120,170,290,73
RUBANDA,2017,120,170,290,73
RUBANDA,2018,120,170,290,73
RUBANDA,2019,120,170,290,73
RUBANDA,2020,130,170,300,73
RUBANDA,2021,130,180,310,73
RUBANDA,2022,130,180,310,73
RUBANDA,2023,130,180,310,73
RUBANDA,2024,130,180,310,73
RUBANDA,2025,130,180,310,73
RUBIRIZI,2015,70,80,150,73
RUBIRIZI,2016,70,80,150,73
RUBIRIZI,2017,70,90,160,73
RUBIRIZI,2018,80,90,170,73
RUBIRIZI,2019,80,90,170,73
RUBIRIZI,2020,80,90,170,73
RUBIRIZI,2021,80,90,170,73
RUBIRIZI,2022,80,90,170,73
RUBIRIZI,2023,80,100,180,73
RUBIRIZI,2024,80,100,180,73
RUBIRIZI,2025,90,100,190,73
RUKIGA,2015,60,100,160,73
RUKIGA,2016,60,100,160,73
RUKIGA,2017,60,100,160,73
RUKIGA,2018,60,100,160,73
RUKIGA,2019,60,100,160,73
RUKIGA,2020,70,100,170,73
RUKIGA,2021,70,100,170,73
RUKIGA,2022,70,100,170,73
RUKIGA,2023,70,100,170,73
RUKIGA,2024,70,100,170,73
RUKIGA,2025,70,100,170,73
RUKUNGIRI,2015,200,330,530,73
RUKUNGIRI,2016,210,340,550,73
RUKUNGIRI,2017,210,340,550,73
RUKUNGIRI,2018,210,340,550,73
RUKUNGIRI,2019,210,340,550,73
RUKUNGIRI,2020,220,350,570,73
RUKUNGIRI,2021,220,350,570,73
RUKUNGIRI,2022,220,350,570,73
RUKUNGIRI,2023,220,360,580,73
RUKUNGIRI,2024,220,360,580,73
RUKUNGIRI,2025,230,360,590,73
RWAMPARA,2015,70,90,160,73
RWAMPARA,2016,70,90,160,73
RWAMPARA,2017,70,90,160,73
RWAMPARA,2018,70,100,170,73
RWAMPARA,2019,70,100,170,73
RWAMPARA,2020,80,100,180,73
RWAMPARA,2021,80,100,180,73
RWAMPARA,2022,80,100,180,73
RWAMPARA,2023,80,110,190,73
RWAMPARA,2024,80,110,190,73
RWAMPARA,2025,80,110,190,73
SERERE,2015,240,260,500,73
SERERE,2016,240,260,500,73
SERERE,2017,240,230,470,73
SERERE,2018,220,220,440,73
SERERE,2019,220,200,420,73
SERERE,2020,220,200,420,73
SERERE,2021,240,220,460,73
SERERE,2022,250,240,490,73
SERERE,2023,270,270,540,73
SERERE,2024,300,310,610,73
SERERE,2025,310,310,620,73
SHEEMA,2015,130,170,300,73
SHEEMA,2016,130,170,300,73
SHEEMA,2017,140,180,320,73
SHEEMA,2018,140,180,320,73
SHEEMA,2019,140,180,320,73
SHEEMA,2020,140,180,320,73
SHEEMA,2021,140,180,320,73
SHEEMA,2022,140,180,320,73
SHEEMA,2023,150,190,340,73
SHEEMA,2024,150,190,340,73
SHEEMA,2025,150,190,340,73
SIRONKO,2015,160,200,360,73
SIRONKO,2016,160,200,360,73
SIRONKO,2017,170,210,380,73
SIRONKO,2018,170,210,380,73
SIRONKO,2019,170,210,380,73
SIRONKO,2020,180,220,400,73
SIRONKO,2021,180,220,400,73
SIRONKO,2022,190,230,420,73
SIRONKO,2023,190,230,420,73
SIRONKO,2024,190,230,420,73
SIRONKO,2025,200,240,440,73
SOROTI,2015,210,240,450,73
SOROTI,2016,210,240,450,73
SOROTI,2017,200,220,420,73
SOROTI,2018,190,200,390,73
SOROTI,2019,190,180,370,73
SOROTI,2020,190,190,380,73
SOROTI,2021,210,200,410,73
SOROTI,2022,210,220,430,73
SOROTI,2023,240,260,500,73
SOROTI,2024,260,280,540,73
SOROTI,2025,260,290,550,73
SSEMBABULE,2015,180,240,420,73
SSEMBABULE,2016,170,240,410,73
SSEMBABULE,2017,160,220,380,73
SSEMBABULE,2018,160,200,360,73
SSEMBABULE,2019,150,180,330,73
SSEMBABULE,2020,150,180,330,73
SSEMBABULE,2021,160,200,360,73
SSEMBABULE,2022,170,210,380,73
SSEMBABULE,2023,190,230,420,73
SSEMBABULE,2024,200,260,460,73
SSEMBABULE,2025,200,260,460,73
TORORO,2015,300,370,670,73
TORORO,2016,310,380,690,73
TORORO,2017,320,390,710,73
TORORO,2018,330,390,720,73
TORORO,2019,340,400,740,73
TORORO,2020,350,410,760,73
TORORO,2021,350,420,770,73
TORORO,2022,360,430,790,73
TORORO,2023,370,440,810,73
TORORO,2024,380,450,830,73
TORORO,2025,390,460,850,73
WAKISO,2015,450,690,1140,73
WAKISO,2016,480,730,1210,73
WAKISO,2017,510,780,1290,73
WAKISO,2018,540,840,1380,73
WAKISO,2019,580,890,1470,73
WAKISO,2020,610,950,1560,73
WAKISO,2021,650,1010,1660,73
WAKISO,2022,700,1080,1780,73
WAKISO,2023,740,1150,1890,73
WAKISO,2024,790,1220,2010,73
WAKISO,2025,830,1300,2130,73
YUMBE,2015,250,260,510,73
YUMBE,2016,250,240,490,73
YUMBE,2017,250,230,480,73
YUMBE,2018,240,220,460,73
YUMBE,2019,240,210,450,73
YUMBE,2020,250,210,460,73
YUMBE,2021,260,230,490,73
YUMBE,2022,280,260,540,73
YUMBE,2023,310,300,610,73
YUMBE,2024,350,340,690,73
YUMBE,2025,370,370,740,73
ZOMBO,2015,200,290,490,73
ZOMBO,2016,200,300,500,73
ZOMBO,2017,210,300,510,73
ZOMBO,2018,220,310,530,73
ZOMBO,2019,220,320,540,73
ZOMBO,2020,230,330,560,73
ZOMBO,2021,230,340,570,73
ZOMBO,2022,240,350,590,73
ZOMBO,2023,250,350,600,73
ZOMBO,2024,250,360,610,73
ZOMBO,2025,260,370,630,73
ABIM,2015,40,60,100,74
ABIM,2016,40,60,100,74
ABIM,2017,40,50,90,74
ABIM,2018,40,50,90,74
ABIM,2019,40,50,90,74
ABIM,2020,40,50,90,74
ABIM,2021,40,50,90,74
ABIM,2022,50,50,100,74
ABIM,2023,50,60,110,74
ABIM,2024,60,70,130,74
ABIM,2025,60,80,140,74
ADJUMANI,2015,60,100,160,74
ADJUMANI,2016,60,100,160,74
ADJUMANI,2017,60,100,160,74
ADJUMANI,2018,60,100,160,74
ADJUMANI,2019,60,100,160,74
ADJUMANI,2020,60,100,160,74
ADJUMANI,2021,60,100,160,74
ADJUMANI,2022,70,100,170,74
ADJUMANI,2023,70,100,170,74
ADJUMANI,2024,70,110,180,74
ADJUMANI,2025,70,110,180,74
AGAGO,2015,110,150,260,74
AGAGO,2016,110,150,260,74
AGAGO,2017,110,150,260,74
AGAGO,2018,120,150,270,74
AGAGO,2019,120,160,280,74
AGAGO,2020,120,160,280,74
AGAGO,2021,120,160,280,74
AGAGO,2022,120,160,280,74
AGAGO,2023,120,170,290,74
AGAGO,2024,130,170,300,74
AGAGO,2025,130,170,300,74
ALEBTONG,2015,130,210,340,74
ALEBTONG,2016,140,230,370,74
ALEBTONG,2017,130,220,350,74
ALEBTONG,2018,130,210,340,74
ALEBTONG,2019,120,180,300,74
ALEBTONG,2020,120,170,290,74
ALEBTONG,2021,120,170,290,74
ALEBTONG,2022,120,180,300,74
ALEBTONG,2023,130,190,320,74
ALEBTONG,2024,140,220,360,74
ALEBTONG,2025,160,240,400,74
AMOLATAR,2015,90,120,210,74
AMOLATAR,2016,90,130,220,74
AMOLATAR,2017,80,130,210,74
AMOLATAR,2018,80,120,200,74
AMOLATAR,2019,80,100,180,74
AMOLATAR,2020,80,90,170,74
AMOLATAR,2021,70,100,170,74
AMOLATAR,2022,80,100,180,74
AMOLATAR,2023,90,110,200,74
AMOLATAR,2024,90,120,210,74
AMOLATAR,2025,100,140,240,74
AMUDAT,2015,50,30,80,74
AMUDAT,2016,50,30,80,74
AMUDAT,2017,50,40,90,74
AMUDAT,2018,40,40,80,74
AMUDAT,2019,50,30,80,74
AMUDAT,2020,50,30,80,74
AMUDAT,2021,40,30,70,74
AMUDAT,2022,50,30,80,74
AMUDAT,2023,60,40,100,74
AMUDAT,2024,60,50,110,74
AMUDAT,2025,60,50,110,74
AMURIA,2015,110,140,250,74
AMURIA,2016,120,140,260,74
AMURIA,2017,110,140,250,74
AMURIA,2018,110,130,240,74
AMURIA,2019,100,120,220,74
AMURIA,2020,110,110,220,74
AMURIA,2021,100,110,210,74
AMURIA,2022,110,120,230,74
AMURIA,2023,120,130,250,74
AMURIA,2024,130,150,280,74
AMURIA,2025,140,160,300,74
AMURU,2015,80,110,190,74
AMURU,2016,90,120,210,74
AMURU,2017,80,120,200,74
AMURU,2018,80,110,190,74
AMURU,2019,70,100,170,74
AMURU,2020,80,90,170,74
AMURU,2021,70,90,160,74
AMURU,2022,80,90,170,74
AMURU,2023,80,100,180,74
AMURU,2024,80,110,190,74
AMURU,2025,100,130,230,74
APAC,2015,130,120,250,74
APAC,2016,130,130,260,74
APAC,2017,140,130,270,74
APAC,2018,140,140,280,74
APAC,2019,150,140,290,74
APAC,2020,150,150,300,74
APAC,2021,160,150,310,74
APAC,2022,160,160,320,74
APAC,2023,170,160,330,74
APAC,2024,170,170,340,74
APAC,2025,180,170,350,74
ARUA,2015,300,360,660,74
ARUA,2016,310,370,680,74
ARUA,2017,320,380,700,74
ARUA,2018,320,390,710,74
ARUA,2019,330,400,730,74
ARUA,2020,340,410,750,74
ARUA,2021,350,420,770,74
ARUA,2022,360,430,790,74
ARUA,2023,370,440,810,74
ARUA,2024,380,450,830,74
ARUA,2025,390,460,850,74
BUDAKA,2015,170,270,440,74
BUDAKA,2016,180,290,470,74
BUDAKA,2017,190,270,460,74
BUDAKA,2018,170,260,430,74
BUDAKA,2019,170,230,400,74
BUDAKA,2020,170,220,390,74
BUDAKA,2021,170,220,390,74
BUDAKA,2022,170,240,410,74
BUDAKA,2023,190,260,450,74
BUDAKA,2024,210,290,500,74
BUDAKA,2025,230,320,550,74
BUDUDA,2015,230,280,510,74
BUDUDA,2016,240,300,540,74
BUDUDA,2017,240,300,540,74
BUDUDA,2018,230,290,520,74
BUDUDA,2019,230,260,490,74
BUDUDA,2020,230,240,470,74
BUDUDA,2021,230,240,470,74
BUDUDA,2022,240,270,510,74
BUDUDA,2023,270,300,570,74
BUDUDA,2024,290,340,630,74
BUDUDA,2025,320,370,690,74
BUGIRI,2015,270,380,650,74
BUGIRI,2016,280,410,690,74
BUGIRI,2017,280,400,680,74
BUGIRI,2018,270,370,640,74
BUGIRI,2019,260,340,600,74
BUGIRI,2020,260,320,580,74
BUGIRI,2021,260,320,580,74
BUGIRI,2022,280,350,630,74
BUGIRI,2023,300,380,680,74
BUGIRI,2024,320,440,760,74
BUGIRI,2025,360,470,830,74
BUGWERI,2015,110,170,280,74
BUGWERI,2016,110,170,280,74
BUGWERI,2017,100,180,280,74
BUGWERI,2018,100,160,260,74
BUGWERI,2019,100,150,250,74
BUGWERI,2020,90,130,220,74
BUGWERI,2021,90,130,220,74
BUGWERI,2022,100,140,240,74
BUGWERI,2023,100,150,250,74
BUGWERI,2024,110,180,290,74
BUGWERI,2025,120,190,310,74
BUHWEJU,2015,100,110,210,74
BUHWEJU,2016,100,110,210,74
BUHWEJU,2017,110,110,220,74
BUHWEJU,2018,110,120,230,74
BUHWEJU,2019,110,120,230,74
BUHWEJU,2020,120,120,240,74
BUHWEJU,2021,120,130,250,74
BUHWEJU,2022,120,130,250,74
BUHWEJU,2023,130,140,270,74
BUHWEJU,2024,130,140,270,74
BUHWEJU,2025,130,140,270,74
BUIKWE,2015,240,250,490,74
BUIKWE,2016,250,260,510,74
BUIKWE,2017,240,240,480,74
BUIKWE,2018,230,230,460,74
BUIKWE,2019,220,200,420,74
BUIKWE,2020,210,190,400,74
BUIKWE,2021,210,180,390,74
BUIKWE,2022,220,200,420,74
BUIKWE,2023,230,210,440,74
BUIKWE,2024,250,230,480,74
BUIKWE,2025,260,260,520,74
BUKEDEA,2015,150,280,430,74
BUKEDEA,2016,160,300,460,74
BUKEDEA,2017,170,300,470,74
BUKEDEA,2018,160,280,440,74
BUKEDEA,2019,150,250,400,74
BUKEDEA,2020,150,240,390,74
BUKEDEA,2021,160,230,390,74
BUKEDEA,2022,170,250,420,74
BUKEDEA,2023,180,280,460,74
BUKEDEA,2024,200,320,520,74
BUKEDEA,2025,220,350,570,74
BUKOMANSIMBI,2015,130,170,300,74
BUKOMANSIMBI,2016,130,170,300,74
BUKOMANSIMBI,2017,130,160,290,74
BUKOMANSIMBI,2018,120,150,270,74
BUKOMANSIMBI,2019,110,130,240,74
BUKOMANSIMBI,2020,110,120,230,74
BUKOMANSIMBI,2021,100,110,210,74
BUKOMANSIMBI,2022,110,120,230,74
BUKOMANSIMBI,2023,110,130,240,74
BUKOMANSIMBI,2024,120,140,260,74
BUKOMANSIMBI,2025,120,150,270,74
BUKWO,2015,60,70,130,74
BUKWO,2016,60,70,130,74
BUKWO,2017,70,70,140,74
BUKWO,2018,70,80,150,74
BUKWO,2019,80,80,160,74
BUKWO,2020,80,80,160,74
BUKWO,2021,80,90,170,74
BUKWO,2022,90,90,180,74
BUKWO,2023,90,100,190,74
BUKWO,2024,100,100,200,74
BUKWO,2025,100,110,210,74
BULAMBULI,2015,200,280,480,74
BULAMBULI,2016,210,310,520,74
BULAMBULI,2017,210,310,520,74
BULAMBULI,2018,210,290,500,74
BULAMBULI,2019,200,270,470,74
BULAMBULI,2020,200,250,450,74
BULAMBULI,2021,210,260,470,74
BULAMBULI,2022,220,270,490,74
BULAMBULI,2023,240,310,550,74
BULAMBULI,2024,270,360,630,74
BULAMBULI,2025,290,390,680,74
BULIISA,2015,60,70,130,74
BULIISA,2016,60,70,130,74
BULIISA,2017,70,70,140,74
BULIISA,2018,70,80,150,74
BULIISA,2019,70,80,150,74
BULIISA,2020,80,80,160,74
BULIISA,2021,80,90,170,74
BULIISA,2022,80,90,170,74
BULIISA,2023,90,90,180,74
BULIISA,2024,90,100,190,74
BULIISA,2025,100,100,200,74
BUNDIBUGYO,2015,130,200,330,74
BUNDIBUGYO,2016,150,220,370,74
BUNDIBUGYO,2017,140,210,350,74
BUNDIBUGYO,2018,140,200,340,74
BUNDIBUGYO,2019,130,170,300,74
BUNDIBUGYO,2020,130,170,300,74
BUNDIBUGYO,2021,130,160,290,74
BUNDIBUGYO,2022,130,170,300,74
BUNDIBUGYO,2023,140,190,330,74
BUNDIBUGYO,2024,150,210,360,74
BUNDIBUGYO,2025,160,230,390,74
BUNYANGABU,2015,130,170,300,74
BUNYANGABU,2016,130,170,300,74
BUNYANGABU,2017,120,160,280,74
BUNYANGABU,2018,120,160,280,74
BUNYANGABU,2019,110,140,250,74
BUNYANGABU,2020,110,130,240,74
BUNYANGABU,2021,110,130,240,74
BUNYANGABU,2022,110,130,240,74
BUNYANGABU,2023,120,140,260,74
BUNYANGABU,2024,130,160,290,74
BUNYANGABU,2025,140,180,320,74
BUSHENYI,2015,240,220,460,74
BUSHENYI,2016,240,220,460,74
BUSHENYI,2017,240,220,460,74
BUSHENYI,2018,250,220,470,74
BUSHENYI,2019,250,220,470,74
BUSHENYI,2020,250,230,480,74
BUSHENYI,2021,250,230,480,74
BUSHENYI,2022,260,230,490,74
BUSHENYI,2023,260,230,490,74
BUSHENYI,2024,260,230,490,74
BUSHENYI,2025,260,230,490,74
BUSIA,2015,190,330,520,74
BUSIA,2016,200,350,550,74
BUSIA,2017,200,340,540,74
BUSIA,2018,190,320,510,74
BUSIA,2019,180,290,470,74
BUSIA,2020,180,270,450,74
BUSIA,2021,180,260,440,74
BUSIA,2022,190,280,470,74
BUSIA,2023,200,300,500,74
BUSIA,2024,220,340,560,74
BUSIA,2025,240,370,610,74
BUTALEJA,2015,190,300,490,74
BUTALEJA,2016,200,330,530,74
BUTALEJA,2017,190,320,510,74
BUTALEJA,2018,190,300,490,74
BUTALEJA,2019,180,270,450,74
BUTALEJA,2020,180,250,430,74
BUTALEJA,2021,180,250,430,74
BUTALEJA,2022,200,270,470,74
BUTALEJA,2023,210,300,510,74
BUTALEJA,2024,230,330,560,74
BUTALEJA,2025,240,360,600,74
BUTAMBALA,2015,50,80,130,74
BUTAMBALA,2016,60,90,150,74
BUTAMBALA,2017,60,90,150,74
BUTAMBALA,2018,50,80,130,74
BUTAMBALA,2019,50,70,120,74
BUTAMBALA,2020,50,60,110,74
BUTAMBALA,2021,40,60,100,74
BUTAMBALA,2022,50,60,110,74
BUTAMBALA,2023,50,70,120,74
BUTAMBALA,2024,50,70,120,74
BUTAMBALA,2025,50,80,130,74
BUTEBO,2015,90,110,200,74
BUTEBO,2016,90,120,210,74
BUTEBO,2017,80,110,190,74
BUTEBO,2018,80,100,180,74
BUTEBO,2019,70,90,160,74
BUTEBO,2020,80,90,170,74
BUTEBO,2021,70,80,150,74
BUTEBO,2022,80,90,170,74
BUTEBO,2023,80,90,170,74
BUTEBO,2024,80,100,180,74
BUTEBO,2025,90,110,200,74
BUVUMA,2015,30,30,60,74
BUVUMA,2016,40,30,70,74
BUVUMA,2017,40,30,70,74
BUVUMA,2018,40,30,70,74
BUVUMA,2019,40,30,70,74
BUVUMA,2020,50,40,90,74
BUVUMA,2021,50,40,90,74
BUVUMA,2022,50,40,90,74
BUVUMA,2023,50,40,90,74
BUVUMA,2024,60,40,100,74
BUVUMA,2025,60,50,110,74
BUYENDE,2015,190,230,420,74
BUYENDE,2016,200,240,440,74
BUYENDE,2017,200,240,440,74
BUYENDE,2018,200,230,430,74
BUYENDE,2019,190,210,400,74
BUYENDE,2020,190,200,390,74
BUYENDE,2021,190,200,390,74
BUYENDE,2022,200,210,410,74
BUYENDE,2023,220,240,460,74
BUYENDE,2024,240,270,510,74
BUYENDE,2025,260,300,560,74
DOKOLO,2015,110,150,260,74
DOKOLO,2016,110,150,260,74
DOKOLO,2017,120,150,270,74
DOKOLO,2018,120,160,280,74
DOKOLO,2019,120,160,280,74
DOKOLO,2020,130,170,300,74
DOKOLO,2021,130,170,300,74
DOKOLO,2022,130,180,310,74
DOKOLO,2023,140,180,320,74
DOKOLO,2024,140,180,320,74
DOKOLO,2025,140,190,330,74
GOMBA,2015,120,120,240,74
GOMBA,2016,120,130,250,74
GOMBA,2017,120,120,240,74
GOMBA,2018,110,110,220,74
GOMBA,2019,100,100,200,74
GOMBA,2020,100,90,190,74
GOMBA,2021,100,90,190,74
GOMBA,2022,110,90,200,74
GOMBA,2023,110,100,210,74
GOMBA,2024,120,110,230,74
GOMBA,2025,120,120,240,74
GULU,2015,100,120,220,74
GULU,2016,100,130,230,74
GULU,2017,110,130,240,74
GULU,2018,110,130,240,74
GULU,2019,110,140,250,74
GULU,2020,120,140,260,74
GULU,2021,120,150,270,74
GULU,2022,120,150,270,74
GULU,2023,130,150,280,74
GULU,2024,130,160,290,74
GULU,2025,130,160,290,74
HOIMA,2015,190,230,420,74
HOIMA,2016,200,240,440,74
HOIMA,2017,210,250,460,74
HOIMA,2018,210,250,460,74
HOIMA,2019,220,260,480,74
HOIMA,2020,230,270,500,74
HOIMA,2021,240,280,520,74
HOIMA,2022,250,290,540,74
HOIMA,2023,250,300,550,74
HOIMA,2024,260,310,570,74
HOIMA,2025,270,320,590,74
IBANDA,2015,210,250,460,74
IBANDA,2016,220,260,480,74
IBANDA,2017,220,260,480,74
IBANDA,2018,220,270,490,74
IBANDA,2019,230,270,500,74
IBANDA,2020,230,280,510,74
IBANDA,2021,240,280,520,74
IBANDA,2022,240,280,520,74
IBANDA,2023,250,290,540,74
IBANDA,2024,250,290,540,74
IBANDA,2025,250,300,550,74
IGANGA,2015,180,250,430,74
IGANGA,2016,190,270,460,74
IGANGA,2017,190,260,450,74
IGANGA,2018,180,240,420,74
IGANGA,2019,180,220,400,74
IGANGA,2020,170,210,380,74
IGANGA,2021,170,200,370,74
IGANGA,2022,180,210,390,74
IGANGA,2023,190,240,430,74
IGANGA,2024,210,270,480,74
IGANGA,2025,230,290,520,74
ISINGIRO,2015,320,380,700,74
ISINGIRO,2016,330,390,720,74
ISINGIRO,2017,340,410,750,74
ISINGIRO,2018,360,420,780,74
ISINGIRO,2019,370,440,810,74
ISINGIRO,2020,380,450,830,74
ISINGIRO,2021,400,470,870,74
ISINGIRO,2022,410,480,890,74
ISINGIRO,2023,420,500,920,74
ISINGIRO,2024,440,510,950,74
ISINGIRO,2025,450,530,980,74
JINJA,2015,230,280,510,74
JINJA,2016,230,290,520,74
JINJA,2017,230,290,520,74
JINJA,2018,240,290,530,74
JINJA,2019,240,300,540,74
JINJA,2020,250,300,550,74
JINJA,2021,250,310,560,74
JINJA,2022,250,310,560,74
JINJA,2023,260,310,570,74
JINJA,2024,260,320,580,74
JINJA,2025,260,320,580,74
KAABONG,2015,50,30,80,74
KAABONG,2016,50,30,80,74
KAABONG,2017,50,30,80,74
KAABONG,2018,50,30,80,74
KAABONG,2019,50,30,80,74
KAABONG,2020,50,30,80,74
KAABONG,2021,50,30,80,74
KAABONG,2022,50,30,80,74
KAABONG,2023,60,30,90,74
KAABONG,2024,60,30,90,74
KAABONG,2025,60,40,100,74
KABALE,2015,210,360,570,74
KABALE,2016,210,360,570,74
KABALE,2017,210,370,580,74
KABALE,2018,220,370,590,74
KABALE,2019,220,380,600,74
KABALE,2020,220,380,600,74
KABALE,2021,230,380,610,74
KABALE,2022,230,390,620,74
KABALE,2023,230,390,620,74
KABALE,2024,230,390,620,74
KABALE,2025,240,400,640,74
KABAROLE,2015,200,270,470,74
KABAROLE,2016,210,280,490,74
KABAROLE,2017,210,280,490,74
KABAROLE,2018,220,290,510,74
KABAROLE,2019,220,290,510,74
KABAROLE,2020,230,300,530,74
KABAROLE,2021,230,310,540,74
KABAROLE,2022,240,310,550,74
KABAROLE,2023,240,320,560,74
KABAROLE,2024,240,320,560,74
KABAROLE,2025,250,330,580,74
KABERAMAIDO,2015,70,140,210,74
KABERAMAIDO,2016,70,140,210,74
KABERAMAIDO,2017,60,140,200,74
KABERAMAIDO,2018,60,130,190,74
KABERAMAIDO,2019,60,120,180,74
KABERAMAIDO,2020,60,110,170,74
KABERAMAIDO,2021,60,110,170,74
KABERAMAIDO,2022,70,120,190,74
KABERAMAIDO,2023,70,140,210,74
KABERAMAIDO,2024,70,160,230,74
KABERAMAIDO,2025,90,170,260,74
KAGADI,2015,180,210,390,74
KAGADI,2016,190,220,410,74
KAGADI,2017,200,230,430,74
KAGADI,2018,200,240,440,74
KAGADI,2019,210,240,450,74
KAGADI,2020,220,250,470,74
KAGADI,2021,230,260,490,74
KAGADI,2022,230,270,500,74
KAGADI,2023,240,280,520,74
KAGADI,2024,250,290,540,74
KAGADI,2025,260,300,560,74
KAKUMIRO,2015,150,150,300,74
KAKUMIRO,2016,160,170,330,74
KAKUMIRO,2017,180,180,360,74
KAKUMIRO,2018,190,200,390,74
KAKUMIRO,2019,210,210,420,74
KAKUMIRO,2020,230,230,460,74
KAKUMIRO,2021,250,250,500,74
KAKUMIRO,2022,270,270,540,74
KAKUMIRO,2023,290,290,580,74
KAKUMIRO,2024,310,310,620,74
KAKUMIRO,2025,340,340,680,74
KALAKI,2015,70,140,210,74
KALAKI,2016,70,150,220,74
KALAKI,2017,70,160,230,74
KALAKI,2018,80,160,240,74
KALAKI,2019,80,170,250,74
KALAKI,2020,80,170,250,74
KALAKI,2021,90,180,270,74
KALAKI,2022,90,190,280,74
KALAKI,2023,90,190,280,74
KALAKI,2024,100,200,300,74
KALAKI,2025,100,210,310,74
KALANGALA,2015,20,10,30,74
KALANGALA,2016,20,10,30,74
KALANGALA,2017,20,10,30,74
KALANGALA,2018,20,10,30,74
KALANGALA,2019,20,10,30,74
KALANGALA,2020,30,10,40,74
KALANGALA,2021,30,10,40,74
KALANGALA,2022,30,10,40,74
KALANGALA,2023,30,10,40,74
KALANGALA,2024,30,10,40,74
KALANGALA,2025,30,10,40,74
KALIRO,2015,150,200,350,74
KALIRO,2016,160,220,380,74
KALIRO,2017,170,220,390,74
KALIRO,2018,160,200,360,74
KALIRO,2019,150,180,330,74
KALIRO,2020,150,170,320,74
KALIRO,2021,150,170,320,74
KALIRO,2022,160,180,340,74
KALIRO,2023,170,200,370,74
KALIRO,2024,180,230,410,74
KALIRO,2025,200,250,450,74
KALUNGU,2015,130,210,340,74
KALUNGU,2016,130,220,350,74
KALUNGU,2017,130,210,340,74
KALUNGU,2018,120,200,320,74
KALUNGU,2019,110,170,280,74
KALUNGU,2020,110,160,270,74
KALUNGU,2021,100,150,250,74
KALUNGU,2022,110,160,270,74
KALUNGU,2023,110,170,280,74
KALUNGU,2024,120,190,310,74
KALUNGU,2025,130,210,340,74
KAMPALA,2015,330,410,740,74
KAMPALA,2016,330,410,740,74
KAMPALA,2017,340,420,760,74
KAMPALA,2018,350,430,780,74
KAMPALA,2019,350,440,790,74
KAMPALA,2020,360,450,810,74
KAMPALA,2021,370,450,820,74
KAMPALA,2022,370,460,830,74
KAMPALA,2023,380,470,850,74
KAMPALA,2024,380,480,860,74
KAMPALA,2025,390,480,870,74
KAMULI,2015,330,420,750,74
KAMULI,2016,340,440,780,74
KAMULI,2017,330,430,760,74
KAMULI,2018,320,380,700,74
KAMULI,2019,300,350,650,74
KAMULI,2020,290,320,610,74
KAMULI,2021,300,320,620,74
KAMULI,2022,310,340,650,74
KAMULI,2023,330,370,700,74
KAMULI,2024,360,410,770,74
KAMULI,2025,380,440,820,74
KAMWENGE,2015,160,180,340,74
KAMWENGE,2016,170,190,360,74
KAMWENGE,2017,180,190,370,74
KAMWENGE,2018,180,200,380,74
KAMWENGE,2019,190,210,400,74
KAMWENGE,2020,200,210,410,74
KAMWENGE,2021,210,220,430,74
KAMWENGE,2022,210,230,440,74
KAMWENGE,2023,220,240,460,74
KAMWENGE,2024,230,240,470,74
KAMWENGE,2025,240,250,490,74
KANUNGU,2015,180,240,420,74
KANUNGU,2016,180,240,420,74
KANUNGU,2017,190,250,440,74
KANUNGU,2018,190,250,440,74
KANUNGU,2019,190,260,450,74
KANUNGU,2020,200,260,460,74
KANUNGU,2021,200,260,460,74
KANUNGU,2022,200,270,470,74
KANUNGU,2023,210,270,480,74
KANUNGU,2024,210,270,480,74
KANUNGU,2025,210,280,490,74
KAPCHORWA,2015,90,160,250,74
KAPCHORWA,2016,90,160,250,74
KAPCHORWA,2017,90,170,260,74
KAPCHORWA,2018,100,170,270,74
KAPCHORWA,2019,100,180,280,74
KAPCHORWA,2020,100,180,280,74
KAPCHORWA,2021,110,180,290,74
KAPCHORWA,2022,110,190,300,74
KAPCHORWA,2023,110,190,300,74
KAPCHORWA,2024,120,200,320,74
KAPCHORWA,2025,120,200,320,74
KAPELEBYONG,2015,50,70,120,74
KAPELEBYONG,2016,50,70,120,74
KAPELEBYONG,2017,50,70,120,74
KAPELEBYONG,2018,50,60,110,74
KAPELEBYONG,2019,50,50,100,74
KAPELEBYONG,2020,50,60,110,74
KAPELEBYONG,2021,40,50,90,74
KAPELEBYONG,2022,50,50,100,74
KAPELEBYONG,2023,50,60,110,74
KAPELEBYONG,2024,60,60,120,74
KAPELEBYONG,2025,60,70,130,74
KASESE,2015,370,410,780,74
KASESE,2016,370,430,800,74
KASESE,2017,360,410,770,74
KASESE,2018,350,370,720,74
KASESE,2019,330,340,670,74
KASESE,2020,320,320,640,74
KASESE,2021,320,310,630,74
KASESE,2022,330,320,650,74
KASESE,2023,350,360,710,74
KASESE,2024,380,400,780,74
KASESE,2025,410,430,840,74
KASSANDA,2015,210,150,360,74
KASSANDA,2016,210,150,360,74
KASSANDA,2017,220,160,380,74
KASSANDA,2018,220,160,380,74
KASSANDA,2019,230,160,390,74
KASSANDA,2020,240,170,410,74
KASSANDA,2021,240,170,410,74
KASSANDA,2022,250,170,420,74
KASSANDA,2023,250,180,430,74
KASSANDA,2024,260,180,440,74
KASSANDA,2025,270,180,450,74
KATAKWI,2015,180,260,440,74
KATAKWI,2016,190,270,460,74
KATAKWI,2017,190,260,450,74
KATAKWI,2018,180,240,420,74
KATAKWI,2019,180,220,400,74
KATAKWI,2020,170,200,370,74
KATAKWI,2021,170,200,370,74
KATAKWI,2022,180,210,390,74
KATAKWI,2023,200,230,430,74
KATAKWI,2024,210,260,470,74
KATAKWI,2025,230,280,510,74
KAYUNGA,2015,240,290,530,74
KAYUNGA,2016,250,300,550,74
KAYUNGA,2017,240,300,540,74
KAYUNGA,2018,230,270,500,74
KAYUNGA,2019,220,230,450,74
KAYUNGA,2020,210,220,430,74
KAYUNGA,2021,210,210,420,74
KAYUNGA,2022,220,230,450,74
KAYUNGA,2023,230,250,480,74
KAYUNGA,2024,250,270,520,74
KAYUNGA,2025,260,300,560,74
KAZO,2015,140,150,290,74
KAZO,2016,140,150,290,74
KAZO,2017,150,160,310,74
KAZO,2018,160,160,320,74
KAZO,2019,160,170,330,74
KAZO,2020,170,180,350,74
KAZO,2021,170,180,350,74
KAZO,2022,180,190,370,74
KAZO,2023,190,190,380,74
KAZO,2024,190,200,390,74
KAZO,2025,200,210,410,74
KIBAALE,2015,60,100,160,74
KIBAALE,2016,60,110,170,74
KIBAALE,2017,70,110,180,74
KIBAALE,2018,70,120,190,74
KIBAALE,2019,80,130,210,74
KIBAALE,2020,80,130,210,74
KIBAALE,2021,90,140,230,74
KIBAALE,2022,90,150,240,74
KIBAALE,2023,100,160,260,74
KIBAALE,2024,100,160,260,74
KIBAALE,2025,110,170,280,74
KIBOGA,2015,150,120,270,74
KIBOGA,2016,160,130,290,74
KIBOGA,2017,160,130,290,74
KIBOGA,2018,150,120,270,74
KIBOGA,2019,140,100,240,74
KIBOGA,2020,140,90,230,74
KIBOGA,2021,140,100,240,74
KIBOGA,2022,140,100,240,74
KIBOGA,2023,150,110,260,74
KIBOGA,2024,170,120,290,74
KIBOGA,2025,170,140,310,74
KIBUKU,2015,150,270,420,74
KIBUKU,2016,160,290,450,74
KIBUKU,2017,160,290,450,74
KIBUKU,2018,160,260,420,74
KIBUKU,2019,140,230,370,74
KIBUKU,2020,140,220,360,74
KIBUKU,2021,150,220,370,74
KIBUKU,2022,150,240,390,74
KIBUKU,2023,170,260,430,74
KIBUKU,2024,180,300,480,74
KIBUKU,2025,200,330,530,74
KIKUUBE,2015,170,150,320,74
KIKUUBE,2016,180,160,340,74
KIKUUBE,2017,190,170,360,74
KIKUUBE,2018,200,180,380,74
KIKUUBE,2019,210,190,400,74
KIKUUBE,2020,220,200,420,74
KIKUUBE,2021,230,210,440,74
KIKUUBE,2022,240,220,460,74
KIKUUBE,2023,250,230,480,74
KIKUUBE,2024,260,240,500,74
KIKUUBE,2025,280,250,530,74
KIRUHURA,2015,90,90,180,74
KIRUHURA,2016,100,90,190,74
KIRUHURA,2017,100,90,190,74
KIRUHURA,2018,100,100,200,74
KIRUHURA,2019,110,100,210,74
KIRUHURA,2020,110,100,210,74
KIRUHURA,2021,110,110,220,74
KIRUHURA,2022,120,110,230,74
KIRUHURA,2023,120,110,230,74
KIRUHURA,2024,130,120,250,74
KIRUHURA,2025,130,120,250,74
KIRYANDONGO,2015,120,140,260,74
KIRYANDONGO,2016,130,140,270,74
KIRYANDONGO,2017,120,130,250,74
KIRYANDONGO,2018,120,130,250,74
KIRYANDONGO,2019,110,110,220,74
KIRYANDONGO,2020,110,100,210,74
KIRYANDONGO,2021,110,110,220,74
KIRYANDONGO,2022,110,110,220,74
KIRYANDONGO,2023,130,120,250,74
KIRYANDONGO,2024,130,140,270,74
KIRYANDONGO,2025,150,150,300,74
KISORO,2015,180,320,500,74
KISORO,2016,180,340,520,74
KISORO,2017,190,320,510,74
KISORO,2018,170,300,470,74
KISORO,2019,160,270,430,74
KISORO,2020,160,240,400,74
KISORO,2021,160,240,400,74
KISORO,2022,170,250,420,74
KISORO,2023,170,280,450,74
KISORO,2024,180,310,490,74
KISORO,2025,200,330,530,74
KITAGWENDA,2015,130,140,270,74
KITAGWENDA,2016,130,140,270,74
KITAGWENDA,2017,140,150,290,74
KITAGWENDA,2018,140,160,300,74
KITAGWENDA,2019,150,160,310,74
KITAGWENDA,2020,150,170,320,74
KITAGWENDA,2021,160,170,330,74
KITAGWENDA,2022,170,180,350,74
KITAGWENDA,2023,170,180,350,74
KITAGWENDA,2024,180,190,370,74
KITAGWENDA,2025,180,190,370,74
KITGUM,2015,120,160,280,74
KITGUM,2016,120,160,280,74
KITGUM,2017,110,160,270,74
KITGUM,2018,100,150,250,74
KITGUM,2019,100,130,230,74
KITGUM,2020,100,120,220,74
KITGUM,2021,100,120,220,74
KITGUM,2022,100,130,230,74
KITGUM,2023,100,140,240,74
KITGUM,2024,110,150,260,74
KITGUM,2025,120,160,280,74
KOBOKO,2015,80,90,170,74
KOBOKO,2016,80,100,180,74
KOBOKO,2017,80,100,180,74
KOBOKO,2018,80,90,170,74
KOBOKO,2019,70,90,160,74
KOBOKO,2020,80,80,160,74
KOBOKO,2021,70,80,150,74
KOBOKO,2022,80,90,170,74
KOBOKO,2023,90,90,180,74
KOBOKO,2024,90,110,200,74
KOBOKO,2025,100,120,220,74
KOLE,2015,170,240,410,74
KOLE,2016,180,250,430,74
KOLE,2017,180,260,440,74
KOLE,2018,190,260,450,74
KOLE,2019,200,270,470,74
KOLE,2020,200,280,480,74
KOLE,2021,210,290,500,74
KOLE,2022,220,290,510,74
KOLE,2023,220,300,520,74
KOLE,2024,230,310,540,74
KOLE,2025,230,320,550,74
KOTIDO,2015,80,100,180,74
KOTIDO,2016,90,100,190,74
KOTIDO,2017,80,100,180,74
KOTIDO,2018,80,100,180,74
KOTIDO,2019,70,90,160,74
KOTIDO,2020,80,80,160,74
KOTIDO,2021,70,80,150,74
KOTIDO,2022,80,80,160,74
KOTIDO,2023,80,90,170,74
KOTIDO,2024,80,100,180,74
KOTIDO,2025,100,110,210,74
KUMI,2015,180,300,480,74
KUMI,2016,180,330,510,74
KUMI,2017,190,320,510,74
KUMI,2018,180,290,470,74
KUMI,2019,170,260,430,74
KUMI,2020,170,240,410,74
KUMI,2021,170,240,410,74
KUMI,2022,170,260,430,74
KUMI,2023,190,290,480,74
KUMI,2024,210,320,530,74
KUMI,2025,220,340,560,74
KWANIA,2015,120,160,280,74
KWANIA,2016,130,160,290,74
KWANIA,2017,130,170,300,74
KWANIA,2018,130,170,300,74
KWANIA,2019,140,180,320,74
KWANIA,2020,140,180,320,74
KWANIA,2021,150,190,340,74
KWANIA,2022,150,190,340,74
KWANIA,2023,160,200,360,74
KWANIA,2024,160,200,360,74
KWANIA,2025,160,210,370,74
KWEEN,2015,60,90,150,74
KWEEN,2016,60,90,150,74
KWEEN,2017,60,90,150,74
KWEEN,2018,60,90,150,74
KWEEN,2019,60,100,160,74
KWEEN,2020,70,100,170,74
KWEEN,2021,70,100,170,74
KWEEN,2022,70,100,170,74
KWEEN,2023,70,110,180,74
KWEEN,2024,70,110,180,74
KWEEN,2025,70,110,180,74
KYANKWANZI,2015,180,160,340,74
KYANKWANZI,2016,190,160,350,74
KYANKWANZI,2017,200,170,370,74
KYANKWANZI,2018,210,180,390,74
KYANKWANZI,2019,220,190,410,74
KYANKWANZI,2020,230,200,430,74
KYANKWANZI,2021,240,200,440,74
KYANKWANZI,2022,260,210,470,74
KYANKWANZI,2023,270,220,490,74
KYANKWANZI,2024,280,230,510,74
KYANKWANZI,2025,290,240,530,74
KYEGEGWA,2015,190,200,390,74
KYEGEGWA,2016,200,210,410,74
KYEGEGWA,2017,220,230,450,74
KYEGEGWA,2018,240,250,490,74
KYEGEGWA,2019,260,270,530,74
KYEGEGWA,2020,280,290,570,74
KYEGEGWA,2021,300,310,610,74
KYEGEGWA,2022,320,330,650,74
KYEGEGWA,2023,350,360,710,74
KYEGEGWA,2024,370,380,750,74
KYEGEGWA,2025,400,410,810,74
KYENJOJO,2015,330,440,770,74
KYENJOJO,2016,340,460,800,74
KYENJOJO,2017,350,480,830,74
KYENJOJO,2018,370,500,870,74
KYENJOJO,2019,380,510,890,74
KYENJOJO,2020,400,530,930,74
KYENJOJO,2021,410,550,960,74
KYENJOJO,2022,430,570,1000,74
KYENJOJO,2023,450,590,1040,74
KYENJOJO,2024,460,610,1070,74
KYENJOJO,2025,480,630,1110,74
KYOTERA,2015,200,290,490,74
KYOTERA,2016,210,300,510,74
KYOTERA,2017,200,290,490,74
KYOTERA,2018,200,270,470,74
KYOTERA,2019,180,230,410,74
KYOTERA,2020,170,210,380,74
KYOTERA,2021,180,210,390,74
KYOTERA,2022,180,220,400,74
KYOTERA,2023,190,240,430,74
KYOTERA,2024,210,270,480,74
KYOTERA,2025,220,290,510,74
KARENGA,2015,40,40,80,74
KARENGA,2016,40,50,90,74
KARENGA,2017,40,50,90,74
KARENGA,2018,40,50,90,74
KARENGA,2019,40,50,90,74
KARENGA,2020,40,50,90,74
KARENGA,2021,50,50,100,74
KARENGA,2022,50,50,100,74
KARENGA,2023,50,50,100,74
KARENGA,2024,50,50,100,74
KARENGA,2025,50,60,110,74
LAMWO,2015,80,140,220,74
LAMWO,2016,80,150,230,74
LAMWO,2017,80,140,220,74
LAMWO,2018,80,130,210,74
LAMWO,2019,70,110,180,74
LAMWO,2020,70,100,170,74
LAMWO,2021,70,100,170,74
LAMWO,2022,70,110,180,74
LAMWO,2023,70,120,190,74
LAMWO,2024,70,130,200,74
LAMWO,2025,80,140,220,74
LIRA,2015,240,230,470,74
LIRA,2016,240,230,470,74
LIRA,2017,250,240,490,74
LIRA,2018,260,250,510,74
LIRA,2019,260,250,510,74
LIRA,2020,270,260,530,74
LIRA,2021,280,270,550,74
LIRA,2022,280,270,550,74
LIRA,2023,290,280,570,74
LIRA,2024,300,290,590,74
LIRA,2025,300,300,600,74
LUUKA,2015,160,270,430,74
LUUKA,2016,160,280,440,74
LUUKA,2017,160,270,430,74
LUUKA,2018,160,250,410,74
LUUKA,2019,140,230,370,74
LUUKA,2020,140,210,350,74
LUUKA,2021,140,200,340,74
LUUKA,2022,140,210,350,74
LUUKA,2023,160,230,390,74
LUUKA,2024,170,260,430,74
LUUKA,2025,170,280,450,74
LUWERO,2015,250,340,590,74
LUWERO,2016,260,360,620,74
LUWERO,2017,260,340,600,74
LUWERO,2018,240,320,560,74
LUWERO,2019,230,290,520,74
LUWERO,2020,230,260,490,74
LUWERO,2021,230,260,490,74
LUWERO,2022,230,270,500,74
LUWERO,2023,250,300,550,74
LUWERO,2024,270,330,600,74
LUWERO,2025,290,360,650,74
LWENGO,2015,190,260,450,74
LWENGO,2016,190,270,460,74
LWENGO,2017,190,250,440,74
LWENGO,2018,180,230,410,74
LWENGO,2019,170,210,380,74
LWENGO,2020,160,190,350,74
LWENGO,2021,160,180,340,74
LWENGO,2022,170,190,360,74
LWENGO,2023,170,200,370,74
LWENGO,2024,180,220,400,74
LWENGO,2025,190,240,430,74
LYANTONDE,2015,60,70,130,74
LYANTONDE,2016,60,70,130,74
LYANTONDE,2017,60,70,130,74
LYANTONDE,2018,50,60,110,74
LYANTONDE,2019,50,50,100,74
LYANTONDE,2020,50,60,110,74
LYANTONDE,2021,50,50,100,74
LYANTONDE,2022,50,50,100,74
LYANTONDE,2023,60,60,120,74
LYANTONDE,2024,60,60,120,74
LYANTONDE,2025,70,80,150,74
MANAFWA,2015,150,250,400,74
MANAFWA,2016,150,250,400,74
MANAFWA,2017,160,260,420,74
MANAFWA,2018,160,260,420,74
MANAFWA,2019,160,270,430,74
MANAFWA,2020,170,270,440,74
MANAFWA,2021,170,280,450,74
MANAFWA,2022,180,290,470,74
MANAFWA,2023,180,290,470,74
MANAFWA,2024,180,300,480,74
MANAFWA,2025,190,300,490,74
MARACHA,2015,110,150,260,74
MARACHA,2016,120,160,280,74
MARACHA,2017,120,160,280,74
MARACHA,2018,120,160,280,74
MARACHA,2019,120,170,290,74
MARACHA,2020,130,170,300,74
MARACHA,2021,130,170,300,74
MARACHA,2022,130,180,310,74
MARACHA,2023,130,180,310,74
MARACHA,2024,140,180,320,74
MARACHA,2025,140,180,320,74
MASAKA,2015,160,270,430,74
MASAKA,2016,170,280,450,74
MASAKA,2017,170,270,440,74
MASAKA,2018,160,250,410,74
MASAKA,2019,150,230,380,74
MASAKA,2020,140,210,350,74
MASAKA,2021,150,200,350,74
MASAKA,2022,150,210,360,74
MASAKA,2023,160,240,400,74
MASAKA,2024,170,260,430,74
MASAKA,2025,180,280,460,74
MASINDI,2015,200,180,380,74
MASINDI,2016,200,180,380,74
MASINDI,2017,210,190,400,74
MASINDI,2018,210,190,400,74
MASINDI,2019,220,200,420,74
MASINDI,2020,230,200,430,74
MASINDI,2021,230,210,440,74
MASINDI,2022,240,210,450,74
MASINDI,2023,240,220,460,74
MASINDI,2024,250,220,470,74
MASINDI,2025,260,230,490,74
MAYUGE,2015,310,350,660,74
MAYUGE,2016,320,370,690,74
MAYUGE,2017,320,360,680,74
MAYUGE,2018,300,330,630,74
MAYUGE,2019,290,300,590,74
MAYUGE,2020,280,280,560,74
MAYUGE,2021,280,280,560,74
MAYUGE,2022,300,300,600,74
MAYUGE,2023,320,330,650,74
MAYUGE,2024,350,370,720,74
MAYUGE,2025,370,400,770,74
MBALE,2015,370,550,920,74
MBALE,2016,380,580,960,74
MBALE,2017,370,570,940,74
MBALE,2018,350,530,880,74
MBALE,2019,340,490,830,74
MBALE,2020,330,450,780,74
MBALE,2021,330,450,780,74
MBALE,2022,350,480,830,74
MBALE,2023,380,530,910,74
MBALE,2024,410,600,1010,74
MBALE,2025,430,650,1080,74
MBARARA,2015,170,280,450,74
MBARARA,2016,180,280,460,74
MBARARA,2017,180,290,470,74
MBARARA,2018,180,290,470,74
MBARARA,2019,190,300,490,74
MBARARA,2020,190,310,500,74
MBARARA,2021,200,310,510,74
MBARARA,2022,200,320,520,74
MBARARA,2023,200,320,520,74
MBARARA,2024,210,330,540,74
MBARARA,2025,210,340,550,74
MITOOMA,2015,160,170,330,74
MITOOMA,2016,160,180,340,74
MITOOMA,2017,160,180,340,74
MITOOMA,2018,170,180,350,74
MITOOMA,2019,170,180,350,74
MITOOMA,2020,170,180,350,74
MITOOMA,2021,170,180,350,74
MITOOMA,2022,170,180,350,74
MITOOMA,2023,170,190,360,74
MITOOMA,2024,170,190,360,74
MITOOMA,2025,180,190,370,74
MITYANA,2015,260,290,550,74
MITYANA,2016,270,310,580,74
MITYANA,2017,260,300,560,74
MITYANA,2018,250,270,520,74
MITYANA,2019,230,240,470,74
MITYANA,2020,230,220,450,74
MITYANA,2021,220,220,440,74
MITYANA,2022,230,230,460,74
MITYANA,2023,240,250,490,74
MITYANA,2024,270,280,550,74
MITYANA,2025,280,300,580,74
MOROTO,2015,60,90,150,74
MOROTO,2016,60,90,150,74
MOROTO,2017,60,100,160,74
MOROTO,2018,60,90,150,74
MOROTO,2019,60,80,140,74
MOROTO,2020,50,70,120,74
MOROTO,2021,50,70,120,74
MOROTO,2022,50,80,130,74
MOROTO,2023,60,80,140,74
MOROTO,2024,70,90,160,74
MOROTO,2025,70,100,170,74
MOYO,2015,40,50,90,74
MOYO,2016,40,50,90,74
MOYO,2017,50,50,100,74
MOYO,2018,50,50,100,74
MOYO,2019,50,60,110,74
MOYO,2020,50,60,110,74
MOYO,2021,50,60,110,74
MOYO,2022,50,60,110,74
MOYO,2023,50,60,110,74
MOYO,2024,50,60,110,74
MOYO,2025,50,60,110,74
MPIGI,2015,150,210,360,74
MPIGI,2016,160,230,390,74
MPIGI,2017,160,220,380,74
MPIGI,2018,150,200,350,74
MPIGI,2019,140,180,320,74
MPIGI,2020,140,170,310,74
MPIGI,2021,130,170,300,74
MPIGI,2022,140,170,310,74
MPIGI,2023,150,190,340,74
MPIGI,2024,170,210,380,74
MPIGI,2025,170,240,410,74
MUBENDE,2015,230,230,460,74
MUBENDE,2016,240,240,480,74
MUBENDE,2017,240,240,480,74
MUBENDE,2018,240,230,470,74
MUBENDE,2019,230,220,450,74
MUBENDE,2020,230,210,440,74
MUBENDE,2021,240,200,440,74
MUBENDE,2022,260,220,480,74
MUBENDE,2023,280,250,530,74
MUBENDE,2024,320,290,610,74
MUBENDE,2025,340,320,660,74
MUKONO,2015,300,360,660,74
MUKONO,2016,310,380,690,74
MUKONO,2017,310,370,680,74
MUKONO,2018,290,340,630,74
MUKONO,2019,270,310,580,74
MUKONO,2020,260,290,550,74
MUKONO,2021,270,290,560,74
MUKONO,2022,280,310,590,74
MUKONO,2023,300,340,640,74
MUKONO,2024,320,380,700,74
MUKONO,2025,350,410,760,74
MADI OKOLLO,2015,60,80,140,74
MADI OKOLLO,2016,60,90,150,74
MADI OKOLLO,2017,70,90,160,74
MADI OKOLLO,2018,70,90,160,74
MADI OKOLLO,2019,70,90,160,74
MADI OKOLLO,2020,70,90,160,74
MADI OKOLLO,2021,70,100,170,74
MADI OKOLLO,2022,70,100,170,74
MADI OKOLLO,2023,80,100,180,74
MADI OKOLLO,2024,80,100,180,74
MADI OKOLLO,2025,80,110,190,74
NABILATUK,2015,40,60,100,74
NABILATUK,2016,40,60,100,74
NABILATUK,2017,40,50,90,74
NABILATUK,2018,30,50,80,74
NABILATUK,2019,30,40,70,74
NABILATUK,2020,40,50,90,74
NABILATUK,2021,40,50,90,74
NABILATUK,2022,40,50,90,74
NABILATUK,2023,40,50,90,74
NABILATUK,2024,50,60,110,74
NABILATUK,2025,50,70,120,74
NAKAPIRIPIRIT,2015,60,100,160,74
NAKAPIRIPIRIT,2016,60,100,160,74
NAKAPIRIPIRIT,2017,60,100,160,74
NAKAPIRIPIRIT,2018,60,100,160,74
NAKAPIRIPIRIT,2019,60,90,150,74
NAKAPIRIPIRIT,2020,50,90,140,74
NAKAPIRIPIRIT,2021,60,80,140,74
NAKAPIRIPIRIT,2022,60,90,150,74
NAKAPIRIPIRIT,2023,60,100,160,74
NAKAPIRIPIRIT,2024,70,120,190,74
NAKAPIRIPIRIT,2025,80,130,210,74
NAKASEKE,2015,110,120,230,74
NAKASEKE,2016,120,120,240,74
NAKASEKE,2017,120,120,240,74
NAKASEKE,2018,130,130,260,74
NAKASEKE,2019,130,130,260,74
NAKASEKE,2020,140,130,270,74
NAKASEKE,2021,140,140,280,74
NAKASEKE,2022,150,140,290,74
NAKASEKE,2023,150,140,290,74
NAKASEKE,2024,160,140,300,74
NAKASEKE,2025,160,150,310,74
NAKASONGOLA,2015,100,120,220,74
NAKASONGOLA,2016,110,140,250,74
NAKASONGOLA,2017,100,130,230,74
NAKASONGOLA,2018,100,120,220,74
NAKASONGOLA,2019,100,100,200,74
NAKASONGOLA,2020,90,100,190,74
NAKASONGOLA,2021,90,100,190,74
NAKASONGOLA,2022,100,100,200,74
NAKASONGOLA,2023,100,120,220,74
NAKASONGOLA,2024,120,130,250,74
NAKASONGOLA,2025,120,140,260,74
NAMAYINGO,2015,80,90,170,74
NAMAYINGO,2016,80,90,170,74
NAMAYINGO,2017,90,100,190,74
NAMAYINGO,2018,90,100,190,74
NAMAYINGO,2019,80,110,190,74
NAMAYINGO,2020,80,100,180,74
NAMAYINGO,2021,70,90,160,74
NAMAYINGO,2022,80,80,160,74
NAMAYINGO,2023,80,80,160,74
NAMAYINGO,2024,80,80,160,74
NAMAYINGO,2025,80,90,170,74
NAMISINDWA,2015,210,230,440,74
NAMISINDWA,2016,210,230,440,74
NAMISINDWA,2017,220,240,460,74
NAMISINDWA,2018,220,240,460,74
NAMISINDWA,2019,230,250,480,74
NAMISINDWA,2020,240,260,500,74
NAMISINDWA,2021,240,260,500,74
NAMISINDWA,2022,250,270,520,74
NAMISINDWA,2023,250,270,520,74
NAMISINDWA,2024,260,280,540,74
NAMISINDWA,2025,270,280,550,74
NAMUTUMBA,2015,200,260,460,74
NAMUTUMBA,2016,200,280,480,74
NAMUTUMBA,2017,200,270,470,74
NAMUTUMBA,2018,200,260,460,74
NAMUTUMBA,2019,190,230,420,74
NAMUTUMBA,2020,190,210,400,74
NAMUTUMBA,2021,190,210,400,74
NAMUTUMBA,2022,200,230,430,74
NAMUTUMBA,2023,210,250,460,74
NAMUTUMBA,2024,230,290,520,74
NAMUTUMBA,2025,250,310,560,74
NAPAK,2015,130,190,320,74
NAPAK,2016,140,200,340,74
NAPAK,2017,140,190,330,74
NAPAK,2018,130,180,310,74
NAPAK,2019,120,160,280,74
NAPAK,2020,110,140,250,74
NAPAK,2021,120,140,260,74
NAPAK,2022,120,150,270,74
NAPAK,2023,130,160,290,74
NAPAK,2024,130,190,320,74
NAPAK,2025,140,200,340,74
NEBBI,2015,150,250,400,74
NEBBI,2016,160,260,420,74
NEBBI,2017,160,260,420,74
NEBBI,2018,170,270,440,74
NEBBI,2019,170,280,450,74
NEBBI,2020,180,290,470,74
NEBBI,2021,180,290,470,74
NEBBI,2022,190,300,490,74
NEBBI,2023,190,310,500,74
NEBBI,2024,200,320,520,74
NEBBI,2025,200,320,520,74
NGORA,2015,100,150,250,74
NGORA,2016,100,150,250,74
NGORA,2017,90,150,240,74
NGORA,2018,90,140,230,74
NGORA,2019,90,120,210,74
NGORA,2020,80,120,200,74
NGORA,2021,80,110,190,74
NGORA,2022,90,120,210,74
NGORA,2023,90,140,230,74
NGORA,2024,100,150,250,74
NGORA,2025,110,160,270,74
NTOROKO,2015,50,30,80,74
NTOROKO,2016,50,30,80,74
NTOROKO,2017,50,30,80,74
NTOROKO,2018,40,30,70,74
NTOROKO,2019,40,30,70,74
NTOROKO,2020,40,20,60,74
NTOROKO,2021,40,20,60,74
NTOROKO,2022,50,20,70,74
NTOROKO,2023,50,30,80,74
NTOROKO,2024,50,30,80,74
NTOROKO,2025,50,30,80,74
NTUNGAMO,2015,350,480,830,74
NTUNGAMO,2016,350,490,840,74
NTUNGAMO,2017,360,500,860,74
NTUNGAMO,2018,370,510,880,74
NTUNGAMO,2019,380,520,900,74
NTUNGAMO,2020,380,520,900,74
NTUNGAMO,2021,390,530,920,74
NTUNGAMO,2022,400,540,940,74
NTUNGAMO,2023,410,550,960,74
NTUNGAMO,2024,410,560,970,74
NTUNGAMO,2025,420,570,990,74
NWOYA,2015,60,80,140,74
NWOYA,2016,70,90,160,74
NWOYA,2017,70,100,170,74
NWOYA,2018,80,110,190,74
NWOYA,2019,90,120,210,74
NWOYA,2020,100,130,230,74
NWOYA,2021,110,140,250,74
NWOYA,2022,120,150,270,74
NWOYA,2023,130,170,300,74
NWOYA,2024,150,190,340,74
NWOYA,2025,160,200,360,74
OBONGI,2015,20,20,40,74
OBONGI,2016,20,20,40,74
OBONGI,2017,20,20,40,74
OBONGI,2018,20,20,40,74
OBONGI,2019,20,20,40,74
OBONGI,2020,20,20,40,74
OBONGI,2021,10,20,30,74
OBONGI,2022,20,20,40,74
OBONGI,2023,20,30,50,74
OBONGI,2024,20,30,50,74
OBONGI,2025,20,30,50,74
OMORO,2015,70,110,180,74
OMORO,2016,70,130,200,74
OMORO,2017,60,120,180,74
OMORO,2018,60,120,180,74
OMORO,2019,60,100,160,74
OMORO,2020,60,90,150,74
OMORO,2021,60,100,160,74
OMORO,2022,60,100,160,74
OMORO,2023,70,120,190,74
OMORO,2024,70,130,200,74
OMORO,2025,80,140,220,74
OTUKE,2015,60,80,140,74
OTUKE,2016,70,80,150,74
OTUKE,2017,70,80,150,74
OTUKE,2018,70,90,160,74
OTUKE,2019,80,90,170,74
OTUKE,2020,80,90,170,74
OTUKE,2021,80,100,180,74
OTUKE,2022,90,100,190,74
OTUKE,2023,90,100,190,74
OTUKE,2024,90,110,200,74
OTUKE,2025,100,110,210,74
OYAM,2015,230,350,580,74
OYAM,2016,240,360,600,74
OYAM,2017,240,370,610,74
OYAM,2018,250,380,630,74
OYAM,2019,260,390,650,74
OYAM,2020,260,400,660,74
OYAM,2021,270,410,680,74
OYAM,2022,280,420,700,74
OYAM,2023,290,440,730,74
OYAM,2024,290,450,740,74
OYAM,2025,300,460,760,74
PADER,2015,100,120,220,74
PADER,2016,100,130,230,74
PADER,2017,90,120,210,74
PADER,2018,90,120,210,74
PADER,2019,90,100,190,74
PADER,2020,80,90,170,74
PADER,2021,80,90,170,74
PADER,2022,80,100,180,74
PADER,2023,90,110,200,74
PADER,2024,90,120,210,74
PADER,2025,100,130,230,74
PAKWACH,2015,80,120,200,74
PAKWACH,2016,90,130,220,74
PAKWACH,2017,90,130,220,74
PAKWACH,2018,90,140,230,74
PAKWACH,2019,100,140,240,74
PAKWACH,2020,100,150,250,74
PAKWACH,2021,110,150,260,74
PAKWACH,2022,110,160,270,74
PAKWACH,2023,110,160,270,74
PAKWACH,2024,120,170,290,74
PAKWACH,2025,120,170,290,74
PALLISA,2015,180,290,470,74
PALLISA,2016,190,310,500,74
PALLISA,2017,190,310,500,74
PALLISA,2018,190,290,480,74
PALLISA,2019,180,270,450,74
PALLISA,2020,180,250,430,74
PALLISA,2021,180,250,430,74
PALLISA,2022,200,270,470,74
PALLISA,2023,210,300,510,74
PALLISA,2024,240,340,580,74
PALLISA,2025,260,380,640,74
RAKAI,2015,230,280,510,74
RAKAI,2016,240,290,530,74
RAKAI,2017,230,290,520,74
RAKAI,2018,230,260,490,74
RAKAI,2019,220,230,450,74
RAKAI,2020,200,210,410,74
RAKAI,2021,210,210,420,74
RAKAI,2022,210,220,430,74
RAKAI,2023,230,250,480,74
RAKAI,2024,250,280,530,74
RAKAI,2025,260,300,560,74
RUBANDA,2015,130,250,380,74
RUBANDA,2016,130,250,380,74
RUBANDA,2017,130,250,380,74
RUBANDA,2018,130,260,390,74
RUBANDA,2019,130,260,390,74
RUBANDA,2020,140,260,400,74
RUBANDA,2021,140,260,400,74
RUBANDA,2022,140,260,400,74
RUBANDA,2023,140,260,400,74
RUBANDA,2024,140,270,410,74
RUBANDA,2025,140,270,410,74
RUBIRIZI,2015,110,140,250,74
RUBIRIZI,2016,120,150,270,74
RUBIRIZI,2017,120,150,270,74
RUBIRIZI,2018,120,150,270,74
RUBIRIZI,2019,120,160,280,74
RUBIRIZI,2020,130,160,290,74
RUBIRIZI,2021,130,160,290,74
RUBIRIZI,2022,130,160,290,74
RUBIRIZI,2023,130,170,300,74
RUBIRIZI,2024,130,170,300,74
RUBIRIZI,2025,140,170,310,74
RUKIGA,2015,80,140,220,74
RUKIGA,2016,90,150,240,74
RUKIGA,2017,90,150,240,74
RUKIGA,2018,90,150,240,74
RUKIGA,2019,90,150,240,74
RUKIGA,2020,90,150,240,74
RUKIGA,2021,90,150,240,74
RUKIGA,2022,90,150,240,74
RUKIGA,2023,90,150,240,74
RUKIGA,2024,90,150,240,74
RUKIGA,2025,90,150,240,74
RUKUNGIRI,2015,310,400,710,74
RUKUNGIRI,2016,310,400,710,74
RUKUNGIRI,2017,320,410,730,74
RUKUNGIRI,2018,320,410,730,74
RUKUNGIRI,2019,320,410,730,74
RUKUNGIRI,2020,330,420,750,74
RUKUNGIRI,2021,330,420,750,74
RUKUNGIRI,2022,330,420,750,74
RUKUNGIRI,2023,340,430,770,74
RUKUNGIRI,2024,340,430,770,74
RUKUNGIRI,2025,340,430,770,74
RWAMPARA,2015,80,120,200,74
RWAMPARA,2016,90,120,210,74
RWAMPARA,2017,90,130,220,74
RWAMPARA,2018,90,130,220,74
RWAMPARA,2019,90,130,220,74
RWAMPARA,2020,90,130,220,74
RWAMPARA,2021,100,140,240,74
RWAMPARA,2022,100,140,240,74
RWAMPARA,2023,100,140,240,74
RWAMPARA,2024,100,140,240,74
RWAMPARA,2025,100,150,250,74
SERERE,2015,190,260,450,74
SERERE,2016,200,280,480,74
SERERE,2017,190,270,460,74
SERERE,2018,190,260,450,74
SERERE,2019,180,230,410,74
SERERE,2020,180,220,400,74
SERERE,2021,180,220,400,74
SERERE,2022,200,240,440,74
SERERE,2023,210,260,470,74
SERERE,2024,230,300,530,74
SERERE,2025,250,330,580,74
SHEEMA,2015,170,220,390,74
SHEEMA,2016,180,230,410,74
SHEEMA,2017,180,230,410,74
SHEEMA,2018,180,230,410,74
SHEEMA,2019,180,230,410,74
SHEEMA,2020,180,240,420,74
SHEEMA,2021,190,240,430,74
SHEEMA,2022,190,240,430,74
SHEEMA,2023,190,240,430,74
SHEEMA,2024,190,240,430,74
SHEEMA,2025,190,240,430,74
SIRONKO,2015,310,410,720,74
SIRONKO,2016,320,420,740,74
SIRONKO,2017,320,430,750,74
SIRONKO,2018,330,440,770,74
SIRONKO,2019,340,440,780,74
SIRONKO,2020,350,450,800,74
SIRONKO,2021,350,460,810,74
SIRONKO,2022,360,470,830,74
SIRONKO,2023,370,480,850,74
SIRONKO,2024,370,480,850,74
SIRONKO,2025,380,490,870,74
SOROTI,2015,130,210,340,74
SOROTI,2016,150,230,380,74
SOROTI,2017,140,230,370,74
SOROTI,2018,140,210,350,74
SOROTI,2019,130,190,320,74
SOROTI,2020,130,180,310,74
SOROTI,2021,130,170,300,74
SOROTI,2022,140,190,330,74
SOROTI,2023,150,210,360,74
SOROTI,2024,160,240,400,74
SOROTI,2025,170,270,440,74
SSEMBABULE,2015,180,210,390,74
SSEMBABULE,2016,190,230,420,74
SSEMBABULE,2017,190,230,420,74
SSEMBABULE,2018,180,210,390,74
SSEMBABULE,2019,170,190,360,74
SSEMBABULE,2020,170,170,340,74
SSEMBABULE,2021,170,170,340,74
SSEMBABULE,2022,170,180,350,74
SSEMBABULE,2023,190,200,390,74
SSEMBABULE,2024,200,220,420,74
SSEMBABULE,2025,220,250,470,74
TORORO,2015,410,540,950,74
TORORO,2016,420,560,980,74
TORORO,2017,430,570,1000,74
TORORO,2018,440,590,1030,74
TORORO,2019,450,600,1050,74
TORORO,2020,460,610,1070,74
TORORO,2021,470,630,1100,74
TORORO,2022,480,640,1120,74
TORORO,2023,500,660,1160,74
TORORO,2024,510,670,1180,74
TORORO,2025,520,680,1200,74
WAKISO,2015,520,720,1240,74
WAKISO,2016,560,770,1330,74
WAKISO,2017,600,830,1430,74
WAKISO,2018,640,880,1520,74
WAKISO,2019,680,940,1620,74
WAKISO,2020,720,1010,1730,74
WAKISO,2021,770,1070,1840,74
WAKISO,2022,820,1140,1960,74
WAKISO,2023,870,1220,2090,74
WAKISO,2024,920,1290,2210,74
WAKISO,2025,980,1380,2360,74
YUMBE,2015,170,200,370,74
YUMBE,2016,180,220,400,74
YUMBE,2017,190,220,410,74
YUMBE,2018,180,220,400,74
YUMBE,2019,180,200,380,74
YUMBE,2020,170,190,360,74
YUMBE,2021,180,200,380,74
YUMBE,2022,190,210,400,74
YUMBE,2023,200,250,450,74
YUMBE,2024,230,280,510,74
YUMBE,2025,250,320,570,74
ZOMBO,2015,160,310,470,74
ZOMBO,2016,160,320,480,74
ZOMBO,2017,170,320,490,74
ZOMBO,2018,180,330,510,74
ZOMBO,2019,180,340,520,74
ZOMBO,2020,190,350,540,74
ZOMBO,2021,190,360,550,74
ZOMBO,2022,200,370,570,74
ZOMBO,2023,200,380,580,74
ZOMBO,2024,210,390,600,74
ZOMBO,2025,210,400,610,74
ABIM,2015,50,70,120,75
ABIM,2016,60,80,140,75
ABIM,2017,60,90,150,75
ABIM,2018,70,90,160,75
ABIM,2019,60,90,150,75
ABIM,2020,70,80,150,75
ABIM,2021,60,80,140,75
ABIM,2022,70,80,150,75
ABIM,2023,80,90,170,75
ABIM,2024,80,100,180,75
ABIM,2025,90,110,200,75
ADJUMANI,2015,80,140,220,75
ADJUMANI,2016,80,140,220,75
ADJUMANI,2017,80,140,220,75
ADJUMANI,2018,80,140,220,75
ADJUMANI,2019,80,140,220,75
ADJUMANI,2020,80,140,220,75
ADJUMANI,2021,80,140,220,75
ADJUMANI,2022,80,140,220,75
ADJUMANI,2023,80,150,230,75
ADJUMANI,2024,80,150,230,75
ADJUMANI,2025,80,150,230,75
AGAGO,2015,130,270,400,75
AGAGO,2016,140,280,420,75
AGAGO,2017,140,280,420,75
AGAGO,2018,140,290,430,75
AGAGO,2019,140,290,430,75
AGAGO,2020,140,300,440,75
AGAGO,2021,150,300,450,75
AGAGO,2022,150,310,460,75
AGAGO,2023,150,310,460,75
AGAGO,2024,150,320,470,75
AGAGO,2025,150,320,470,75
ALEBTONG,2015,150,220,370,75
ALEBTONG,2016,160,250,410,75
ALEBTONG,2017,170,260,430,75
ALEBTONG,2018,170,260,430,75
ALEBTONG,2019,160,240,400,75
ALEBTONG,2020,150,210,360,75
ALEBTONG,2021,150,200,350,75
ALEBTONG,2022,150,200,350,75
ALEBTONG,2023,150,210,360,75
ALEBTONG,2024,170,230,400,75
ALEBTONG,2025,180,260,440,75
AMOLATAR,2015,60,90,150,75
AMOLATAR,2016,60,110,170,75
AMOLATAR,2017,60,110,170,75
AMOLATAR,2018,70,110,180,75
AMOLATAR,2019,60,100,160,75
AMOLATAR,2020,60,90,150,75
AMOLATAR,2021,60,80,140,75
AMOLATAR,2022,50,80,130,75
AMOLATAR,2023,60,90,150,75
AMOLATAR,2024,70,100,170,75
AMOLATAR,2025,70,110,180,75
AMUDAT,2015,40,20,60,75
AMUDAT,2016,40,30,70,75
AMUDAT,2017,40,30,70,75
AMUDAT,2018,40,40,80,75
AMUDAT,2019,40,30,70,75
AMUDAT,2020,40,30,70,75
AMUDAT,2021,40,30,70,75
AMUDAT,2022,40,20,60,75
AMUDAT,2023,40,30,70,75
AMUDAT,2024,50,30,80,75
AMUDAT,2025,50,40,90,75
AMURIA,2015,100,200,300,75
AMURIA,2016,110,230,340,75
AMURIA,2017,120,250,370,75
AMURIA,2018,120,240,360,75
AMURIA,2019,110,220,330,75
AMURIA,2020,110,200,310,75
AMURIA,2021,110,180,290,75
AMURIA,2022,110,180,290,75
AMURIA,2023,120,190,310,75
AMURIA,2024,120,220,340,75
AMURIA,2025,140,250,390,75
AMURU,2015,80,150,230,75
AMURU,2016,90,170,260,75
AMURU,2017,90,180,270,75
AMURU,2018,90,170,260,75
AMURU,2019,80,160,240,75
AMURU,2020,80,140,220,75
AMURU,2021,80,130,210,75
AMURU,2022,80,130,210,75
AMURU,2023,80,140,220,75
AMURU,2024,90,150,240,75
AMURU,2025,90,170,260,75
APAC,2015,140,170,310,75
APAC,2016,140,180,320,75
APAC,2017,150,180,330,75
APAC,2018,150,190,340,75
APAC,2019,160,200,360,75
APAC,2020,160,200,360,75
APAC,2021,170,210,380,75
APAC,2022,180,220,400,75
APAC,2023,180,220,400,75
APAC,2024,190,230,420,75
APAC,2025,190,240,430,75
ARUA,2015,420,630,1050,75
ARUA,2016,430,640,1070,75
ARUA,2017,440,660,1100,75
ARUA,2018,450,680,1130,75
ARUA,2019,470,700,1170,75
ARUA,2020,480,710,1190,75
ARUA,2021,490,730,1220,75
ARUA,2022,500,750,1250,75
ARUA,2023,520,770,1290,75
ARUA,2024,530,790,1320,75
ARUA,2025,540,800,1340,75
BUDAKA,2015,130,150,280,75
BUDAKA,2016,150,170,320,75
BUDAKA,2017,150,190,340,75
BUDAKA,2018,150,180,330,75
BUDAKA,2019,140,170,310,75
BUDAKA,2020,140,160,300,75
BUDAKA,2021,140,140,280,75
BUDAKA,2022,140,140,280,75
BUDAKA,2023,150,150,300,75
BUDAKA,2024,160,170,330,75
BUDAKA,2025,170,190,360,75
BUDUDA,2015,90,110,200,75
BUDUDA,2016,110,130,240,75
BUDUDA,2017,110,130,240,75
BUDUDA,2018,110,130,240,75
BUDUDA,2019,110,130,240,75
BUDUDA,2020,100,110,210,75
BUDUDA,2021,110,110,220,75
BUDUDA,2022,100,110,210,75
BUDUDA,2023,110,120,230,75
BUDUDA,2024,120,130,250,75
BUDUDA,2025,130,150,280,75
BUGIRI,2015,180,210,390,75
BUGIRI,2016,200,230,430,75
BUGIRI,2017,210,250,460,75
BUGIRI,2018,210,240,450,75
BUGIRI,2019,200,230,430,75
BUGIRI,2020,190,210,400,75
BUGIRI,2021,190,200,390,75
BUGIRI,2022,190,200,390,75
BUGIRI,2023,200,210,410,75
BUGIRI,2024,220,240,460,75
BUGIRI,2025,240,260,500,75
BUGWERI,2015,90,110,200,75
BUGWERI,2016,100,130,230,75
BUGWERI,2017,110,130,240,75
BUGWERI,2018,100,120,220,75
BUGWERI,2019,100,120,220,75
BUGWERI,2020,100,110,210,75
BUGWERI,2021,90,100,190,75
BUGWERI,2022,90,100,190,75
BUGWERI,2023,100,100,200,75
BUGWERI,2024,100,110,210,75
BUGWERI,2025,110,130,240,75
BUHWEJU,2015,80,90,170,75
BUHWEJU,2016,90,90,180,75
BUHWEJU,2017,90,90,180,75
BUHWEJU,2018,90,100,190,75
BUHWEJU,2019,90,100,190,75
BUHWEJU,2020,100,100,200,75
BUHWEJU,2021,100,100,200,75
BUHWEJU,2022,100,110,210,75
BUHWEJU,2023,110,110,220,75
BUHWEJU,2024,110,110,220,75
BUHWEJU,2025,110,120,230,75
BUIKWE,2015,240,300,540,75
BUIKWE,2016,270,330,600,75
BUIKWE,2017,280,350,630,75
BUIKWE,2018,270,340,610,75
BUIKWE,2019,260,310,570,75
BUIKWE,2020,240,280,520,75
BUIKWE,2021,230,260,490,75
BUIKWE,2022,230,250,480,75
BUIKWE,2023,240,260,500,75
BUIKWE,2024,260,290,550,75
BUIKWE,2025,270,320,590,75
BUKEDEA,2015,150,230,380,75
BUKEDEA,2016,170,270,440,75
BUKEDEA,2017,180,280,460,75
BUKEDEA,2018,180,280,460,75
BUKEDEA,2019,180,260,440,75
BUKEDEA,2020,170,240,410,75
BUKEDEA,2021,170,220,390,75
BUKEDEA,2022,170,230,400,75
BUKEDEA,2023,180,240,420,75
BUKEDEA,2024,200,270,470,75
BUKEDEA,2025,220,310,530,75
BUKOMANSIMBI,2015,130,180,310,75
BUKOMANSIMBI,2016,130,200,330,75
BUKOMANSIMBI,2017,130,210,340,75
BUKOMANSIMBI,2018,130,210,340,75
BUKOMANSIMBI,2019,120,180,300,75
BUKOMANSIMBI,2020,110,160,270,75
BUKOMANSIMBI,2021,110,150,260,75
BUKOMANSIMBI,2022,100,140,240,75
BUKOMANSIMBI,2023,110,150,260,75
BUKOMANSIMBI,2024,120,160,280,75
BUKOMANSIMBI,2025,120,170,290,75
BUKWO,2015,40,40,80,75
BUKWO,2016,40,50,90,75
BUKWO,2017,40,50,90,75
BUKWO,2018,40,50,90,75
BUKWO,2019,40,50,90,75
BUKWO,2020,50,60,110,75
BUKWO,2021,50,60,110,75
BUKWO,2022,50,60,110,75
BUKWO,2023,50,60,110,75
BUKWO,2024,60,70,130,75
BUKWO,2025,60,70,130,75
BULAMBULI,2015,100,120,220,75
BULAMBULI,2016,110,130,240,75
BULAMBULI,2017,120,140,260,75
BULAMBULI,2018,120,140,260,75
BULAMBULI,2019,110,130,240,75
BULAMBULI,2020,110,120,230,75
BULAMBULI,2021,110,120,230,75
BULAMBULI,2022,110,120,230,75
BULAMBULI,2023,120,130,250,75
BULAMBULI,2024,130,150,280,75
BULAMBULI,2025,150,170,320,75
BULIISA,2015,50,70,120,75
BULIISA,2016,50,70,120,75
BULIISA,2017,50,70,120,75
BULIISA,2018,60,70,130,75
BULIISA,2019,60,80,140,75
BULIISA,2020,60,80,140,75
BULIISA,2021,70,80,150,75
BULIISA,2022,70,90,160,75
BULIISA,2023,70,90,160,75
BULIISA,2024,80,100,180,75
BULIISA,2025,80,100,180,75
BUNDIBUGYO,2015,130,150,280,75
BUNDIBUGYO,2016,140,170,310,75
BUNDIBUGYO,2017,150,180,330,75
BUNDIBUGYO,2018,150,170,320,75
BUNDIBUGYO,2019,140,160,300,75
BUNDIBUGYO,2020,140,140,280,75
BUNDIBUGYO,2021,130,130,260,75
BUNDIBUGYO,2022,140,130,270,75
BUNDIBUGYO,2023,140,140,280,75
BUNDIBUGYO,2024,150,150,300,75
BUNDIBUGYO,2025,160,170,330,75
BUNYANGABU,2015,130,160,290,75
BUNYANGABU,2016,140,170,310,75
BUNYANGABU,2017,140,190,330,75
BUNYANGABU,2018,150,180,330,75
BUNYANGABU,2019,140,160,300,75
BUNYANGABU,2020,130,150,280,75
BUNYANGABU,2021,130,130,260,75
BUNYANGABU,2022,130,140,270,75
BUNYANGABU,2023,130,140,270,75
BUNYANGABU,2024,140,150,290,75
BUNYANGABU,2025,150,170,320,75
BUSHENYI,2015,190,240,430,75
BUSHENYI,2016,190,240,430,75
BUSHENYI,2017,190,240,430,75
BUSHENYI,2018,200,240,440,75
BUSHENYI,2019,200,240,440,75
BUSHENYI,2020,200,250,450,75
BUSHENYI,2021,200,250,450,75
BUSHENYI,2022,210,250,460,75
BUSHENYI,2023,210,250,460,75
BUSHENYI,2024,210,250,460,75
BUSHENYI,2025,210,250,460,75
BUSIA,2015,140,220,360,75
BUSIA,2016,160,260,420,75
BUSIA,2017,160,270,430,75
BUSIA,2018,160,270,430,75
BUSIA,2019,150,240,390,75
BUSIA,2020,150,220,370,75
BUSIA,2021,150,210,360,75
BUSIA,2022,140,200,340,75
BUSIA,2023,150,220,370,75
BUSIA,2024,160,240,400,75
BUSIA,2025,180,260,440,75
BUTALEJA,2015,130,170,300,75
BUTALEJA,2016,150,190,340,75
BUTALEJA,2017,160,200,360,75
BUTALEJA,2018,150,200,350,75
BUTALEJA,2019,150,180,330,75
BUTALEJA,2020,150,170,320,75
BUTALEJA,2021,140,150,290,75
BUTALEJA,2022,140,150,290,75
BUTALEJA,2023,150,170,320,75
BUTALEJA,2024,170,190,360,75
BUTALEJA,2025,180,210,390,75
BUTAMBALA,2015,90,120,210,75
BUTAMBALA,2016,100,140,240,75
BUTAMBALA,2017,100,140,240,75
BUTAMBALA,2018,90,130,220,75
BUTAMBALA,2019,90,130,220,75
BUTAMBALA,2020,80,110,190,75
BUTAMBALA,2021,80,100,180,75
BUTAMBALA,2022,80,100,180,75
BUTAMBALA,2023,80,100,180,75
BUTAMBALA,2024,90,110,200,75
BUTAMBALA,2025,90,120,210,75
BUTEBO,2015,70,90,160,75
BUTEBO,2016,70,100,170,75
BUTEBO,2017,70,100,170,75
BUTEBO,2018,70,100,170,75
BUTEBO,2019,70,90,160,75
BUTEBO,2020,70,80,150,75
BUTEBO,2021,60,80,140,75
BUTEBO,2022,60,70,130,75
BUTEBO,2023,60,80,140,75
BUTEBO,2024,70,80,150,75
BUTEBO,2025,70,90,160,75
BUVUMA,2015,20,20,40,75
BUVUMA,2016,20,30,50,75
BUVUMA,2017,30,30,60,75
BUVUMA,2018,30,30,60,75
BUVUMA,2019,30,30,60,75
BUVUMA,2020,30,30,60,75
BUVUMA,2021,30,40,70,75
BUVUMA,2022,30,40,70,75
BUVUMA,2023,40,40,80,75
BUVUMA,2024,40,40,80,75
BUVUMA,2025,40,50,90,75
BUYENDE,2015,150,160,310,75
BUYENDE,2016,160,180,340,75
BUYENDE,2017,170,200,370,75
BUYENDE,2018,170,190,360,75
BUYENDE,2019,170,180,350,75
BUYENDE,2020,160,160,320,75
BUYENDE,2021,160,150,310,75
BUYENDE,2022,160,150,310,75
BUYENDE,2023,180,170,350,75
BUYENDE,2024,190,190,380,75
BUYENDE,2025,210,210,420,75
DOKOLO,2015,120,190,310,75
DOKOLO,2016,120,200,320,75
DOKOLO,2017,120,200,320,75
DOKOLO,2018,130,210,340,75
DOKOLO,2019,130,220,350,75
DOKOLO,2020,140,220,360,75
DOKOLO,2021,140,230,370,75
DOKOLO,2022,140,230,370,75
DOKOLO,2023,150,240,390,75
DOKOLO,2024,150,240,390,75
DOKOLO,2025,150,250,400,75
GOMBA,2015,130,170,300,75
GOMBA,2016,140,180,320,75
GOMBA,2017,140,190,330,75
GOMBA,2018,140,190,330,75
GOMBA,2019,130,170,300,75
GOMBA,2020,130,150,280,75
GOMBA,2021,120,130,250,75
GOMBA,2022,120,130,250,75
GOMBA,2023,120,140,260,75
GOMBA,2024,130,150,280,75
GOMBA,2025,140,170,310,75
GULU,2015,150,270,420,75
GULU,2016,150,270,420,75
GULU,2017,150,280,430,75
GULU,2018,160,290,450,75
GULU,2019,160,300,460,75
GULU,2020,170,310,480,75
GULU,2021,170,310,480,75
GULU,2022,180,320,500,75
GULU,2023,180,330,510,75
GULU,2024,190,340,530,75
GULU,2025,190,350,540,75
HOIMA,2015,170,230,400,75
HOIMA,2016,170,240,410,75
HOIMA,2017,180,250,430,75
HOIMA,2018,190,260,450,75
HOIMA,2019,190,260,450,75
HOIMA,2020,200,270,470,75
HOIMA,2021,210,280,490,75
HOIMA,2022,220,290,510,75
HOIMA,2023,220,300,520,75
HOIMA,2024,230,310,540,75
HOIMA,2025,240,320,560,75
IBANDA,2015,150,220,370,75
IBANDA,2016,150,220,370,75
IBANDA,2017,150,230,380,75
IBANDA,2018,150,230,380,75
IBANDA,2019,160,240,400,75
IBANDA,2020,160,240,400,75
IBANDA,2021,160,240,400,75
IBANDA,2022,170,250,420,75
IBANDA,2023,170,250,420,75
IBANDA,2024,170,250,420,75
IBANDA,2025,170,260,430,75
IGANGA,2015,160,220,380,75
IGANGA,2016,180,260,440,75
IGANGA,2017,180,270,450,75
IGANGA,2018,180,260,440,75
IGANGA,2019,180,240,420,75
IGANGA,2020,160,220,380,75
IGANGA,2021,160,210,370,75
IGANGA,2022,160,200,360,75
IGANGA,2023,170,210,380,75
IGANGA,2024,180,240,420,75
IGANGA,2025,200,260,460,75
ISINGIRO,2015,230,380,610,75
ISINGIRO,2016,240,390,630,75
ISINGIRO,2017,250,410,660,75
ISINGIRO,2018,260,420,680,75
ISINGIRO,2019,270,440,710,75
ISINGIRO,2020,280,450,730,75
ISINGIRO,2021,290,470,760,75
ISINGIRO,2022,300,480,780,75
ISINGIRO,2023,310,500,810,75
ISINGIRO,2024,320,510,830,75
ISINGIRO,2025,330,530,860,75
JINJA,2015,220,340,560,75
JINJA,2016,220,350,570,75
JINJA,2017,230,350,580,75
JINJA,2018,230,360,590,75
JINJA,2019,230,360,590,75
JINJA,2020,240,370,610,75
JINJA,2021,240,370,610,75
JINJA,2022,240,380,620,75
JINJA,2023,250,380,630,75
JINJA,2024,250,390,640,75
JINJA,2025,250,390,640,75
KAABONG,2015,50,60,110,75
KAABONG,2016,50,60,110,75
KAABONG,2017,60,70,130,75
KAABONG,2018,60,70,130,75
KAABONG,2019,60,70,130,75
KAABONG,2020,60,70,130,75
KAABONG,2021,60,70,130,75
KAABONG,2022,60,70,130,75
KAABONG,2023,70,70,140,75
KAABONG,2024,70,80,150,75
KAABONG,2025,70,80,150,75
KABALE,2015,180,270,450,75
KABALE,2016,180,270,450,75
KABALE,2017,180,280,460,75
KABALE,2018,190,280,470,75
KABALE,2019,190,280,470,75
KABALE,2020,190,290,480,75
KABALE,2021,190,290,480,75
KABALE,2022,200,290,490,75
KABALE,2023,200,290,490,75
KABALE,2024,200,300,500,75
KABALE,2025,200,300,500,75
KABAROLE,2015,230,290,520,75
KABAROLE,2016,230,290,520,75
KABAROLE,2017,240,300,540,75
KABAROLE,2018,240,300,540,75
KABAROLE,2019,250,310,560,75
KABAROLE,2020,250,320,570,75
KABAROLE,2021,260,320,580,75
KABAROLE,2022,260,330,590,75
KABAROLE,2023,270,340,610,75
KABAROLE,2024,270,340,610,75
KABAROLE,2025,280,350,630,75
KABERAMAIDO,2015,60,90,150,75
KABERAMAIDO,2016,60,110,170,75
KABERAMAIDO,2017,60,110,170,75
KABERAMAIDO,2018,70,120,190,75
KABERAMAIDO,2019,60,100,160,75
KABERAMAIDO,2020,60,100,160,75
KABERAMAIDO,2021,60,90,150,75
KABERAMAIDO,2022,60,90,150,75
KABERAMAIDO,2023,60,100,160,75
KABERAMAIDO,2024,70,110,180,75
KABERAMAIDO,2025,80,130,210,75
KAGADI,2015,150,190,340,75
KAGADI,2016,160,190,350,75
KAGADI,2017,170,200,370,75
KAGADI,2018,170,210,380,75
KAGADI,2019,180,210,390,75
KAGADI,2020,180,220,400,75
KAGADI,2021,190,230,420,75
KAGADI,2022,200,230,430,75
KAGADI,2023,200,240,440,75
KAGADI,2024,210,250,460,75
KAGADI,2025,220,260,480,75
KAKUMIRO,2015,140,150,290,75
KAKUMIRO,2016,150,160,310,75
KAKUMIRO,2017,170,170,340,75
KAKUMIRO,2018,180,190,370,75
KAKUMIRO,2019,200,200,400,75
KAKUMIRO,2020,210,220,430,75
KAKUMIRO,2021,230,240,470,75
KAKUMIRO,2022,250,260,510,75
KAKUMIRO,2023,270,280,550,75
KAKUMIRO,2024,290,300,590,75
KAKUMIRO,2025,320,330,650,75
KALAKI,2015,90,140,230,75
KALAKI,2016,100,140,240,75
KALAKI,2017,100,150,250,75
KALAKI,2018,110,160,270,75
KALAKI,2019,110,160,270,75
KALAKI,2020,120,170,290,75
KALAKI,2021,120,170,290,75
KALAKI,2022,130,180,310,75
KALAKI,2023,130,190,320,75
KALAKI,2024,140,190,330,75
KALAKI,2025,140,200,340,75
KALANGALA,2015,20,10,30,75
KALANGALA,2016,20,20,40,75
KALANGALA,2017,20,20,40,75
KALANGALA,2018,20,20,40,75
KALANGALA,2019,20,20,40,75
KALANGALA,2020,20,20,40,75
KALANGALA,2021,20,20,40,75
KALANGALA,2022,20,20,40,75
KALANGALA,2023,20,20,40,75
KALANGALA,2024,20,20,40,75
KALANGALA,2025,30,20,50,75
KALIRO,2015,120,160,280,75
KALIRO,2016,130,180,310,75
KALIRO,2017,130,190,320,75
KALIRO,2018,140,190,330,75
KALIRO,2019,140,180,320,75
KALIRO,2020,130,160,290,75
KALIRO,2021,130,150,280,75
KALIRO,2022,120,150,270,75
KALIRO,2023,130,160,290,75
KALIRO,2024,140,170,310,75
KALIRO,2025,150,200,350,75
KALUNGU,2015,140,220,360,75
KALUNGU,2016,150,250,400,75
KALUNGU,2017,160,260,420,75
KALUNGU,2018,150,250,400,75
KALUNGU,2019,140,220,360,75
KALUNGU,2020,130,200,330,75
KALUNGU,2021,130,180,310,75
KALUNGU,2022,120,170,290,75
KALUNGU,2023,130,190,320,75
KALUNGU,2024,140,200,340,75
KALUNGU,2025,150,220,370,75
KAMPALA,2015,350,530,880,75
KAMPALA,2016,350,540,890,75
KAMPALA,2017,360,550,910,75
KAMPALA,2018,370,570,940,75
KAMPALA,2019,380,580,960,75
KAMPALA,2020,380,590,970,75
KAMPALA,2021,390,600,990,75
KAMPALA,2022,400,610,1010,75
KAMPALA,2023,400,620,1020,75
KAMPALA,2024,410,630,1040,75
KAMPALA,2025,410,630,1040,75
KAMULI,2015,210,320,530,75
KAMULI,2016,230,370,600,75
KAMULI,2017,230,390,620,75
KAMULI,2018,230,370,600,75
KAMULI,2019,220,340,560,75
KAMULI,2020,210,310,520,75
KAMULI,2021,200,290,490,75
KAMULI,2022,200,280,480,75
KAMULI,2023,220,300,520,75
KAMULI,2024,230,330,560,75
KAMULI,2025,250,360,610,75
KAMWENGE,2015,130,160,290,75
KAMWENGE,2016,130,170,300,75
KAMWENGE,2017,140,170,310,75
KAMWENGE,2018,140,180,320,75
KAMWENGE,2019,150,190,340,75
KAMWENGE,2020,150,190,340,75
KAMWENGE,2021,160,200,360,75
KAMWENGE,2022,170,200,370,75
KAMWENGE,2023,170,210,380,75
KAMWENGE,2024,180,220,400,75
KAMWENGE,2025,180,220,400,75
KANUNGU,2015,160,250,410,75
KANUNGU,2016,160,250,410,75
KANUNGU,2017,170,250,420,75
KANUNGU,2018,170,260,430,75
KANUNGU,2019,170,260,430,75
KANUNGU,2020,170,270,440,75
KANUNGU,2021,180,270,450,75
KANUNGU,2022,180,270,450,75
KANUNGU,2023,180,280,460,75
KANUNGU,2024,180,280,460,75
KANUNGU,2025,190,280,470,75
KAPCHORWA,2015,60,100,160,75
KAPCHORWA,2016,60,100,160,75
KAPCHORWA,2017,70,100,170,75
KAPCHORWA,2018,70,110,180,75
KAPCHORWA,2019,70,110,180,75
KAPCHORWA,2020,70,110,180,75
KAPCHORWA,2021,70,110,180,75
KAPCHORWA,2022,80,120,200,75
KAPCHORWA,2023,80,120,200,75
KAPCHORWA,2024,80,120,200,75
KAPCHORWA,2025,80,130,210,75
KAPELEBYONG,2015,50,80,130,75
KAPELEBYONG,2016,60,100,160,75
KAPELEBYONG,2017,60,100,160,75
KAPELEBYONG,2018,60,100,160,75
KAPELEBYONG,2019,60,100,160,75
KAPELEBYONG,2020,50,80,130,75
KAPELEBYONG,2021,60,80,140,75
KAPELEBYONG,2022,50,70,120,75
KAPELEBYONG,2023,60,80,140,75
KAPELEBYONG,2024,60,90,150,75
KAPELEBYONG,2025,70,100,170,75
KASESE,2015,350,430,780,75
KASESE,2016,380,490,870,75
KASESE,2017,400,510,910,75
KASESE,2018,390,500,890,75
KASESE,2019,370,460,830,75
KASESE,2020,350,410,760,75
KASESE,2021,340,380,720,75
KASESE,2022,340,370,710,75
KASESE,2023,360,390,750,75
KASESE,2024,380,440,820,75
KASESE,2025,410,480,890,75
KASSANDA,2015,200,200,400,75
KASSANDA,2016,210,210,420,75
KASSANDA,2017,210,210,420,75
KASSANDA,2018,220,220,440,75
KASSANDA,2019,220,220,440,75
KASSANDA,2020,230,220,450,75
KASSANDA,2021,240,230,470,75
KASSANDA,2022,240,230,470,75
KASSANDA,2023,250,240,490,75
KASSANDA,2024,250,240,490,75
KASSANDA,2025,260,250,510,75
KATAKWI,2015,130,230,360,75
KATAKWI,2016,140,270,410,75
KATAKWI,2017,140,270,410,75
KATAKWI,2018,150,270,420,75
KATAKWI,2019,140,250,390,75
KATAKWI,2020,130,220,350,75
KATAKWI,2021,130,210,340,75
KATAKWI,2022,130,200,330,75
KATAKWI,2023,130,220,350,75
KATAKWI,2024,150,240,390,75
KATAKWI,2025,150,260,410,75
KAYUNGA,2015,250,320,570,75
KAYUNGA,2016,270,370,640,75
KAYUNGA,2017,280,390,670,75
KAYUNGA,2018,270,370,640,75
KAYUNGA,2019,260,340,600,75
KAYUNGA,2020,240,300,540,75
KAYUNGA,2021,230,280,510,75
KAYUNGA,2022,230,270,500,75
KAYUNGA,2023,240,280,520,75
KAYUNGA,2024,260,310,570,75
KAYUNGA,2025,280,340,620,75
KAZO,2015,100,120,220,75
KAZO,2016,110,130,240,75
KAZO,2017,110,130,240,75
KAZO,2018,120,130,250,75
KAZO,2019,120,140,260,75
KAZO,2020,120,140,260,75
KAZO,2021,130,150,280,75
KAZO,2022,130,150,280,75
KAZO,2023,140,160,300,75
KAZO,2024,140,160,300,75
KAZO,2025,150,170,320,75
KIBAALE,2015,60,60,120,75
KIBAALE,2016,70,60,130,75
KIBAALE,2017,70,70,140,75
KIBAALE,2018,70,70,140,75
KIBAALE,2019,80,70,150,75
KIBAALE,2020,80,80,160,75
KIBAALE,2021,90,80,170,75
KIBAALE,2022,90,90,180,75
KIBAALE,2023,100,90,190,75
KIBAALE,2024,110,100,210,75
KIBAALE,2025,110,100,210,75
KIBOGA,2015,100,120,220,75
KIBOGA,2016,110,130,240,75
KIBOGA,2017,110,130,240,75
KIBOGA,2018,110,130,240,75
KIBOGA,2019,100,120,220,75
KIBOGA,2020,100,110,210,75
KIBOGA,2021,100,100,200,75
KIBOGA,2022,100,100,200,75
KIBOGA,2023,100,100,200,75
KIBOGA,2024,110,110,220,75
KIBOGA,2025,120,130,250,75
KIBUKU,2015,120,120,240,75
KIBUKU,2016,120,140,260,75
KIBUKU,2017,130,140,270,75
KIBUKU,2018,140,140,280,75
KIBUKU,2019,130,140,270,75
KIBUKU,2020,130,120,250,75
KIBUKU,2021,120,120,240,75
KIBUKU,2022,120,110,230,75
KIBUKU,2023,130,120,250,75
KIBUKU,2024,140,140,280,75
KIBUKU,2025,150,150,300,75
KIKUUBE,2015,150,120,270,75
KIKUUBE,2016,160,130,290,75
KIKUUBE,2017,170,140,310,75
KIKUUBE,2018,180,140,320,75
KIKUUBE,2019,190,150,340,75
KIKUUBE,2020,200,160,360,75
KIKUUBE,2021,210,170,380,75
KIKUUBE,2022,220,170,390,75
KIKUUBE,2023,230,180,410,75
KIKUUBE,2024,240,190,430,75
KIKUUBE,2025,250,200,450,75
KIRUHURA,2015,110,110,220,75
KIRUHURA,2016,110,120,230,75
KIRUHURA,2017,110,120,230,75
KIRUHURA,2018,120,130,250,75
KIRUHURA,2019,120,130,250,75
KIRUHURA,2020,130,140,270,75
KIRUHURA,2021,130,140,270,75
KIRUHURA,2022,140,140,280,75
KIRUHURA,2023,140,150,290,75
KIRUHURA,2024,150,150,300,75
KIRUHURA,2025,150,160,310,75
KIRYANDONGO,2015,100,130,230,75
KIRYANDONGO,2016,110,160,270,75
KIRYANDONGO,2017,120,160,280,75
KIRYANDONGO,2018,110,150,260,75
KIRYANDONGO,2019,110,140,250,75
KIRYANDONGO,2020,100,130,230,75
KIRYANDONGO,2021,100,120,220,75
KIRYANDONGO,2022,100,120,220,75
KIRYANDONGO,2023,110,130,240,75
KIRYANDONGO,2024,120,140,260,75
KIRYANDONGO,2025,120,160,280,75
KISORO,2015,220,310,530,75
KISORO,2016,240,340,580,75
KISORO,2017,240,360,600,75
KISORO,2018,240,350,590,75
KISORO,2019,220,310,530,75
KISORO,2020,210,280,490,75
KISORO,2021,200,260,460,75
KISORO,2022,200,260,460,75
KISORO,2023,210,270,480,75
KISORO,2024,230,300,530,75
KISORO,2025,240,330,570,75
KITAGWENDA,2015,80,100,180,75
KITAGWENDA,2016,80,110,190,75
KITAGWENDA,2017,90,110,200,75
KITAGWENDA,2018,90,110,200,75
KITAGWENDA,2019,90,120,210,75
KITAGWENDA,2020,100,120,220,75
KITAGWENDA,2021,100,130,230,75
KITAGWENDA,2022,110,130,240,75
KITAGWENDA,2023,110,130,240,75
KITAGWENDA,2024,110,140,250,75
KITAGWENDA,2025,120,140,260,75
KITGUM,2015,120,200,320,75
KITGUM,2016,130,220,350,75
KITGUM,2017,130,230,360,75
KITGUM,2018,130,220,350,75
KITGUM,2019,130,200,330,75
KITGUM,2020,120,180,300,75
KITGUM,2021,110,170,280,75
KITGUM,2022,110,160,270,75
KITGUM,2023,110,170,280,75
KITGUM,2024,120,190,310,75
KITGUM,2025,130,200,330,75
KOBOKO,2015,80,110,190,75
KOBOKO,2016,90,130,220,75
KOBOKO,2017,100,130,230,75
KOBOKO,2018,90,130,220,75
KOBOKO,2019,100,130,230,75
KOBOKO,2020,90,110,200,75
KOBOKO,2021,80,110,190,75
KOBOKO,2022,90,100,190,75
KOBOKO,2023,90,120,210,75
KOBOKO,2024,100,120,220,75
KOBOKO,2025,110,140,250,75
KOLE,2015,180,260,440,75
KOLE,2016,180,270,450,75
KOLE,2017,190,280,470,75
KOLE,2018,190,290,480,75
KOLE,2019,200,300,500,75
KOLE,2020,210,300,510,75
KOLE,2021,210,310,520,75
KOLE,2022,220,320,540,75
KOLE,2023,220,330,550,75
KOLE,2024,230,340,570,75
KOLE,2025,240,340,580,75
KOTIDO,2015,80,70,150,75
KOTIDO,2016,80,80,160,75
KOTIDO,2017,80,90,170,75
KOTIDO,2018,90,90,180,75
KOTIDO,2019,80,80,160,75
KOTIDO,2020,70,70,140,75
KOTIDO,2021,70,60,130,75
KOTIDO,2022,80,70,150,75
KOTIDO,2023,80,70,150,75
KOTIDO,2024,80,80,160,75
KOTIDO,2025,90,80,170,75
KUMI,2015,160,310,470,75
KUMI,2016,170,350,520,75
KUMI,2017,180,370,550,75
KUMI,2018,170,360,530,75
KUMI,2019,170,330,500,75
KUMI,2020,160,300,460,75
KUMI,2021,150,280,430,75
KUMI,2022,160,280,440,75
KUMI,2023,170,290,460,75
KUMI,2024,180,330,510,75
KUMI,2025,190,360,550,75
KWANIA,2015,120,160,280,75
KWANIA,2016,120,160,280,75
KWANIA,2017,120,170,290,75
KWANIA,2018,130,170,300,75
KWANIA,2019,130,180,310,75
KWANIA,2020,130,180,310,75
KWANIA,2021,140,190,330,75
KWANIA,2022,140,190,330,75
KWANIA,2023,150,200,350,75
KWANIA,2024,150,200,350,75
KWANIA,2025,150,210,360,75
KWEEN,2015,50,70,120,75
KWEEN,2016,50,70,120,75
KWEEN,2017,50,70,120,75
KWEEN,2018,50,70,120,75
KWEEN,2019,50,70,120,75
KWEEN,2020,60,70,130,75
KWEEN,2021,60,80,140,75
KWEEN,2022,60,80,140,75
KWEEN,2023,60,80,140,75
KWEEN,2024,60,80,140,75
KWEEN,2025,60,80,140,75
KYANKWANZI,2015,110,150,260,75
KYANKWANZI,2016,120,150,270,75
KYANKWANZI,2017,120,160,280,75
KYANKWANZI,2018,130,170,300,75
KYANKWANZI,2019,140,180,320,75
KYANKWANZI,2020,140,180,320,75
KYANKWANZI,2021,150,190,340,75
KYANKWANZI,2022,160,200,360,75
KYANKWANZI,2023,160,210,370,75
KYANKWANZI,2024,170,220,390,75
KYANKWANZI,2025,180,230,410,75
KYEGEGWA,2015,130,170,300,75
KYEGEGWA,2016,140,190,330,75
KYEGEGWA,2017,160,200,360,75
KYEGEGWA,2018,170,220,390,75
KYEGEGWA,2019,180,230,410,75
KYEGEGWA,2020,200,250,450,75
KYEGEGWA,2021,210,270,480,75
KYEGEGWA,2022,230,290,520,75
KYEGEGWA,2023,250,310,560,75
KYEGEGWA,2024,270,340,610,75
KYEGEGWA,2025,290,360,650,75
KYENJOJO,2015,280,320,600,75
KYENJOJO,2016,290,340,630,75
KYENJOJO,2017,310,350,660,75
KYENJOJO,2018,320,360,680,75
KYENJOJO,2019,330,370,700,75
KYENJOJO,2020,350,390,740,75
KYENJOJO,2021,360,400,760,75
KYENJOJO,2022,370,410,780,75
KYENJOJO,2023,390,430,820,75
KYENJOJO,2024,400,440,840,75
KYENJOJO,2025,410,460,870,75
KYOTERA,2015,190,250,440,75
KYOTERA,2016,200,280,480,75
KYOTERA,2017,210,290,500,75
KYOTERA,2018,200,290,490,75
KYOTERA,2019,190,260,450,75
KYOTERA,2020,180,230,410,75
KYOTERA,2021,180,210,390,75
KYOTERA,2022,170,200,370,75
KYOTERA,2023,180,220,400,75
KYOTERA,2024,190,240,430,75
KYOTERA,2025,200,260,460,75
KARENGA,2015,30,30,60,75
KARENGA,2016,30,30,60,75
KARENGA,2017,30,30,60,75
KARENGA,2018,40,30,70,75
KARENGA,2019,40,40,80,75
KARENGA,2020,40,40,80,75
KARENGA,2021,40,40,80,75
KARENGA,2022,40,40,80,75
KARENGA,2023,40,40,80,75
KARENGA,2024,40,40,80,75
KARENGA,2025,40,40,80,75
LAMWO,2015,80,170,250,75
LAMWO,2016,90,180,270,75
LAMWO,2017,90,190,280,75
LAMWO,2018,90,180,270,75
LAMWO,2019,90,170,260,75
LAMWO,2020,80,150,230,75
LAMWO,2021,80,130,210,75
LAMWO,2022,80,130,210,75
LAMWO,2023,80,140,220,75
LAMWO,2024,80,150,230,75
LAMWO,2025,90,170,260,75
LIRA,2015,250,350,600,75
LIRA,2016,260,360,620,75
LIRA,2017,260,370,630,75
LIRA,2018,270,380,650,75
LIRA,2019,280,390,670,75
LIRA,2020,290,400,690,75
LIRA,2021,290,410,700,75
LIRA,2022,300,420,720,75
LIRA,2023,310,430,740,75
LIRA,2024,320,440,760,75
LIRA,2025,320,450,770,75
LUUKA,2015,130,170,300,75
LUUKA,2016,140,180,320,75
LUUKA,2017,140,200,340,75
LUUKA,2018,140,190,330,75
LUUKA,2019,140,180,320,75
LUUKA,2020,130,160,290,75
LUUKA,2021,120,140,260,75
LUUKA,2022,120,140,260,75
LUUKA,2023,130,150,280,75
LUUKA,2024,130,170,300,75
LUUKA,2025,150,180,330,75
LUWERO,2015,260,380,640,75
LUWERO,2016,280,430,710,75
LUWERO,2017,290,450,740,75
LUWERO,2018,280,440,720,75
LUWERO,2019,270,400,670,75
LUWERO,2020,260,360,620,75
LUWERO,2021,250,330,580,75
LUWERO,2022,250,330,580,75
LUWERO,2023,260,350,610,75
LUWERO,2024,280,380,660,75
LUWERO,2025,300,420,720,75
LWENGO,2015,190,280,470,75
LWENGO,2016,200,310,510,75
LWENGO,2017,200,320,520,75
LWENGO,2018,200,310,510,75
LWENGO,2019,180,280,460,75
LWENGO,2020,170,250,420,75
LWENGO,2021,160,220,380,75
LWENGO,2022,160,220,380,75
LWENGO,2023,170,230,400,75
LWENGO,2024,180,250,430,75
LWENGO,2025,190,270,460,75
LYANTONDE,2015,50,60,110,75
LYANTONDE,2016,50,60,110,75
LYANTONDE,2017,50,70,120,75
LYANTONDE,2018,50,60,110,75
LYANTONDE,2019,50,60,110,75
LYANTONDE,2020,40,60,100,75
LYANTONDE,2021,50,50,100,75
LYANTONDE,2022,50,50,100,75
LYANTONDE,2023,50,50,100,75
LYANTONDE,2024,50,60,110,75
LYANTONDE,2025,50,70,120,75
MANAFWA,2015,100,110,210,75
MANAFWA,2016,100,110,210,75
MANAFWA,2017,100,120,220,75
MANAFWA,2018,100,120,220,75
MANAFWA,2019,110,120,230,75
MANAFWA,2020,110,120,230,75
MANAFWA,2021,110,130,240,75
MANAFWA,2022,110,130,240,75
MANAFWA,2023,120,130,250,75
MANAFWA,2024,120,130,250,75
MANAFWA,2025,120,140,260,75
MARACHA,2015,120,180,300,75
MARACHA,2016,120,190,310,75
MARACHA,2017,120,190,310,75
MARACHA,2018,120,190,310,75
MARACHA,2019,130,200,330,75
MARACHA,2020,130,200,330,75
MARACHA,2021,130,210,340,75
MARACHA,2022,130,210,340,75
MARACHA,2023,140,210,350,75
MARACHA,2024,140,220,360,75
MARACHA,2025,140,220,360,75
MASAKA,2015,150,240,390,75
MASAKA,2016,170,280,450,75
MASAKA,2017,170,280,450,75
MASAKA,2018,170,280,450,75
MASAKA,2019,160,260,420,75
MASAKA,2020,150,230,380,75
MASAKA,2021,150,210,360,75
MASAKA,2022,150,200,350,75
MASAKA,2023,150,220,370,75
MASAKA,2024,160,240,400,75
MASAKA,2025,180,260,440,75
MASINDI,2015,180,180,360,75
MASINDI,2016,190,190,380,75
MASINDI,2017,190,190,380,75
MASINDI,2018,200,200,400,75
MASINDI,2019,200,200,400,75
MASINDI,2020,210,210,420,75
MASINDI,2021,210,210,420,75
MASINDI,2022,220,220,440,75
MASINDI,2023,220,220,440,75
MASINDI,2024,230,230,460,75
MASINDI,2025,240,230,470,75
MAYUGE,2015,220,220,440,75
MAYUGE,2016,240,260,500,75
MAYUGE,2017,250,270,520,75
MAYUGE,2018,250,270,520,75
MAYUGE,2019,230,250,480,75
MAYUGE,2020,220,220,440,75
MAYUGE,2021,220,210,430,75
MAYUGE,2022,220,200,420,75
MAYUGE,2023,230,220,450,75
MAYUGE,2024,250,240,490,75
MAYUGE,2025,270,270,540,75
MBALE,2015,270,320,590,75
MBALE,2016,290,380,670,75
MBALE,2017,310,400,710,75
MBALE,2018,310,380,690,75
MBALE,2019,300,360,660,75
MBALE,2020,280,330,610,75
MBALE,2021,270,310,580,75
MBALE,2022,270,300,570,75
MBALE,2023,290,330,620,75
MBALE,2024,310,360,670,75
MBALE,2025,330,410,740,75
MBARARA,2015,170,250,420,75
MBARARA,2016,170,260,430,75
MBARARA,2017,180,260,440,75
MBARARA,2018,180,270,450,75
MBARARA,2019,190,280,470,75
MBARARA,2020,190,280,470,75
MBARARA,2021,190,290,480,75
MBARARA,2022,200,290,490,75
MBARARA,2023,200,300,500,75
MBARARA,2024,210,300,510,75
MBARARA,2025,210,310,520,75
MITOOMA,2015,150,210,360,75
MITOOMA,2016,160,220,380,75
MITOOMA,2017,160,220,380,75
MITOOMA,2018,160,220,380,75
MITOOMA,2019,160,220,380,75
MITOOMA,2020,160,220,380,75
MITOOMA,2021,160,230,390,75
MITOOMA,2022,170,230,400,75
MITOOMA,2023,170,230,400,75
MITOOMA,2024,170,230,400,75
MITOOMA,2025,170,230,400,75
MITYANA,2015,270,310,580,75
MITYANA,2016,290,340,630,75
MITYANA,2017,310,360,670,75
MITYANA,2018,290,340,630,75
MITYANA,2019,280,310,590,75
MITYANA,2020,270,280,550,75
MITYANA,2021,250,260,510,75
MITYANA,2022,250,250,500,75
MITYANA,2023,260,260,520,75
MITYANA,2024,280,290,570,75
MITYANA,2025,290,320,610,75
MOROTO,2015,40,80,120,75
MOROTO,2016,40,90,130,75
MOROTO,2017,40,90,130,75
MOROTO,2018,40,90,130,75
MOROTO,2019,40,90,130,75
MOROTO,2020,40,80,120,75
MOROTO,2021,40,70,110,75
MOROTO,2022,40,70,110,75
MOROTO,2023,40,80,120,75
MOROTO,2024,40,80,120,75
MOROTO,2025,50,90,140,75
MOYO,2015,40,70,110,75
MOYO,2016,50,70,120,75
MOYO,2017,50,80,130,75
MOYO,2018,50,80,130,75
MOYO,2019,50,80,130,75
MOYO,2020,50,80,130,75
MOYO,2021,50,80,130,75
MOYO,2022,50,80,130,75
MOYO,2023,50,80,130,75
MOYO,2024,60,90,150,75
MOYO,2025,60,90,150,75
MPIGI,2015,160,240,400,75
MPIGI,2016,180,280,460,75
MPIGI,2017,180,280,460,75
MPIGI,2018,180,280,460,75
MPIGI,2019,170,260,430,75
MPIGI,2020,160,230,390,75
MPIGI,2021,150,210,360,75
MPIGI,2022,160,210,370,75
MPIGI,2023,160,220,380,75
MPIGI,2024,180,240,420,75
MPIGI,2025,190,270,460,75
MUBENDE,2015,180,200,380,75
MUBENDE,2016,200,230,430,75
MUBENDE,2017,220,250,470,75
MUBENDE,2018,210,250,460,75
MUBENDE,2019,220,230,450,75
MUBENDE,2020,210,220,430,75
MUBENDE,2021,200,210,410,75
MUBENDE,2022,210,210,420,75
MUBENDE,2023,220,220,440,75
MUBENDE,2024,250,260,510,75
MUBENDE,2025,280,290,570,75
MUKONO,2015,310,450,760,75
MUKONO,2016,340,500,840,75
MUKONO,2017,350,540,890,75
MUKONO,2018,340,520,860,75
MUKONO,2019,330,480,810,75
MUKONO,2020,320,440,760,75
MUKONO,2021,310,400,710,75
MUKONO,2022,310,400,710,75
MUKONO,2023,320,430,750,75
MUKONO,2024,340,470,810,75
MUKONO,2025,370,530,900,75
MADI OKOLLO,2015,120,130,250,75
MADI OKOLLO,2016,120,140,260,75
MADI OKOLLO,2017,120,140,260,75
MADI OKOLLO,2018,130,150,280,75
MADI OKOLLO,2019,130,150,280,75
MADI OKOLLO,2020,130,150,280,75
MADI OKOLLO,2021,140,160,300,75
MADI OKOLLO,2022,140,160,300,75
MADI OKOLLO,2023,140,160,300,75
MADI OKOLLO,2024,150,170,320,75
MADI OKOLLO,2025,150,170,320,75
NABILATUK,2015,30,60,90,75
NABILATUK,2016,40,60,100,75
NABILATUK,2017,40,80,120,75
NABILATUK,2018,40,70,110,75
NABILATUK,2019,40,60,100,75
NABILATUK,2020,40,60,100,75
NABILATUK,2021,40,60,100,75
NABILATUK,2022,40,60,100,75
NABILATUK,2023,40,60,100,75
NABILATUK,2024,40,70,110,75
NABILATUK,2025,50,80,130,75
NAKAPIRIPIRIT,2015,40,60,100,75
NAKAPIRIPIRIT,2016,50,70,120,75
NAKAPIRIPIRIT,2017,50,80,130,75
NAKAPIRIPIRIT,2018,50,70,120,75
NAKAPIRIPIRIT,2019,50,70,120,75
NAKAPIRIPIRIT,2020,50,60,110,75
NAKAPIRIPIRIT,2021,50,60,110,75
NAKAPIRIPIRIT,2022,50,60,110,75
NAKAPIRIPIRIT,2023,50,60,110,75
NAKAPIRIPIRIT,2024,60,80,140,75
NAKAPIRIPIRIT,2025,60,80,140,75
NAKASEKE,2015,150,210,360,75
NAKASEKE,2016,150,220,370,75
NAKASEKE,2017,160,220,380,75
NAKASEKE,2018,170,230,400,75
NAKASEKE,2019,170,230,400,75
NAKASEKE,2020,180,240,420,75
NAKASEKE,2021,180,240,420,75
NAKASEKE,2022,190,250,440,75
NAKASEKE,2023,200,250,450,75
NAKASEKE,2024,200,260,460,75
NAKASEKE,2025,210,260,470,75
NAKASONGOLA,2015,90,120,210,75
NAKASONGOLA,2016,100,130,230,75
NAKASONGOLA,2017,110,140,250,75
NAKASONGOLA,2018,100,130,230,75
NAKASONGOLA,2019,100,120,220,75
NAKASONGOLA,2020,100,110,210,75
NAKASONGOLA,2021,90,100,190,75
NAKASONGOLA,2022,100,100,200,75
NAKASONGOLA,2023,100,110,210,75
NAKASONGOLA,2024,110,120,230,75
NAKASONGOLA,2025,120,140,260,75
NAMAYINGO,2015,70,100,170,75
NAMAYINGO,2016,70,120,190,75
NAMAYINGO,2017,80,120,200,75
NAMAYINGO,2018,80,120,200,75
NAMAYINGO,2019,70,100,170,75
NAMAYINGO,2020,70,90,160,75
NAMAYINGO,2021,60,90,150,75
NAMAYINGO,2022,60,90,150,75
NAMAYINGO,2023,70,90,160,75
NAMAYINGO,2024,70,100,170,75
NAMAYINGO,2025,80,110,190,75
NAMISINDWA,2015,130,110,240,75
NAMISINDWA,2016,130,120,250,75
NAMISINDWA,2017,130,120,250,75
NAMISINDWA,2018,140,120,260,75
NAMISINDWA,2019,140,130,270,75
NAMISINDWA,2020,140,130,270,75
NAMISINDWA,2021,150,130,280,75
NAMISINDWA,2022,150,130,280,75
NAMISINDWA,2023,150,140,290,75
NAMISINDWA,2024,160,140,300,75
NAMISINDWA,2025,160,140,300,75
NAMUTUMBA,2015,150,190,340,75
NAMUTUMBA,2016,170,220,390,75
NAMUTUMBA,2017,170,240,410,75
NAMUTUMBA,2018,170,230,400,75
NAMUTUMBA,2019,170,220,390,75
NAMUTUMBA,2020,150,190,340,75
NAMUTUMBA,2021,150,180,330,75
NAMUTUMBA,2022,160,180,340,75
NAMUTUMBA,2023,170,190,360,75
NAMUTUMBA,2024,180,210,390,75
NAMUTUMBA,2025,190,240,430,75
NAPAK,2015,130,180,310,75
NAPAK,2016,130,200,330,75
NAPAK,2017,130,220,350,75
NAPAK,2018,130,210,340,75
NAPAK,2019,130,190,320,75
NAPAK,2020,120,170,290,75
NAPAK,2021,110,160,270,75
NAPAK,2022,110,150,260,75
NAPAK,2023,120,170,290,75
NAPAK,2024,120,180,300,75
NAPAK,2025,130,200,330,75
NEBBI,2015,160,280,440,75
NEBBI,2016,170,290,460,75
NEBBI,2017,170,300,470,75
NEBBI,2018,180,310,490,75
NEBBI,2019,190,320,510,75
NEBBI,2020,190,330,520,75
NEBBI,2021,200,330,530,75
NEBBI,2022,200,340,540,75
NEBBI,2023,210,350,560,75
NEBBI,2024,210,360,570,75
NEBBI,2025,220,370,590,75
NGORA,2015,120,220,340,75
NGORA,2016,120,250,370,75
NGORA,2017,130,260,390,75
NGORA,2018,130,250,380,75
NGORA,2019,130,230,360,75
NGORA,2020,120,210,330,75
NGORA,2021,110,200,310,75
NGORA,2022,120,190,310,75
NGORA,2023,120,200,320,75
NGORA,2024,130,230,360,75
NGORA,2025,140,250,390,75
NTOROKO,2015,30,30,60,75
NTOROKO,2016,30,40,70,75
NTOROKO,2017,30,50,80,75
NTOROKO,2018,30,40,70,75
NTOROKO,2019,30,40,70,75
NTOROKO,2020,30,40,70,75
NTOROKO,2021,30,30,60,75
NTOROKO,2022,30,30,60,75
NTOROKO,2023,30,30,60,75
NTOROKO,2024,30,30,60,75
NTOROKO,2025,30,40,70,75
NTUNGAMO,2015,290,450,740,75
NTUNGAMO,2016,300,460,760,75
NTUNGAMO,2017,310,460,770,75
NTUNGAMO,2018,310,470,780,75
NTUNGAMO,2019,320,480,800,75
NTUNGAMO,2020,330,490,820,75
NTUNGAMO,2021,330,500,830,75
NTUNGAMO,2022,340,500,840,75
NTUNGAMO,2023,350,510,860,75
NTUNGAMO,2024,350,520,870,75
NTUNGAMO,2025,360,530,890,75
NWOYA,2015,70,170,240,75
NWOYA,2016,80,190,270,75
NWOYA,2017,80,210,290,75
NWOYA,2018,90,230,320,75
NWOYA,2019,100,250,350,75
NWOYA,2020,110,270,380,75
NWOYA,2021,130,300,430,75
NWOYA,2022,140,330,470,75
NWOYA,2023,150,360,510,75
NWOYA,2024,170,400,570,75
NWOYA,2025,180,440,620,75
OBONGI,2015,20,20,40,75
OBONGI,2016,20,20,40,75
OBONGI,2017,20,20,40,75
OBONGI,2018,20,20,40,75
OBONGI,2019,20,20,40,75
OBONGI,2020,10,10,20,75
OBONGI,2021,10,10,20,75
OBONGI,2022,10,10,20,75
OBONGI,2023,10,10,20,75
OBONGI,2024,10,10,20,75
OBONGI,2025,20,20,40,75
OMORO,2015,70,160,230,75
OMORO,2016,80,180,260,75
OMORO,2017,80,200,280,75
OMORO,2018,80,190,270,75
OMORO,2019,80,180,260,75
OMORO,2020,70,160,230,75
OMORO,2021,70,150,220,75
OMORO,2022,80,150,230,75
OMORO,2023,80,160,240,75
OMORO,2024,90,180,270,75
OMORO,2025,90,200,290,75
OTUKE,2015,90,130,220,75
OTUKE,2016,90,140,230,75
OTUKE,2017,100,150,250,75
OTUKE,2018,100,150,250,75
OTUKE,2019,110,160,270,75
OTUKE,2020,110,160,270,75
OTUKE,2021,120,170,290,75
OTUKE,2022,120,180,300,75
OTUKE,2023,130,180,310,75
OTUKE,2024,130,190,320,75
OTUKE,2025,140,200,340,75
OYAM,2015,260,310,570,75
OYAM,2016,260,320,580,75
OYAM,2017,270,330,600,75
OYAM,2018,280,330,610,75
OYAM,2019,290,340,630,75
OYAM,2020,300,350,650,75
OYAM,2021,300,360,660,75
OYAM,2022,310,370,680,75
OYAM,2023,320,380,700,75
OYAM,2024,330,390,720,75
OYAM,2025,340,400,740,75
PADER,2015,90,170,260,75
PADER,2016,110,190,300,75
PADER,2017,110,210,320,75
PADER,2018,100,200,300,75
PADER,2019,100,180,280,75
PADER,2020,90,160,250,75
PADER,2021,90,150,240,75
PADER,2022,90,150,240,75
PADER,2023,90,150,240,75
PADER,2024,90,170,260,75
PADER,2025,100,190,290,75
PAKWACH,2015,80,150,230,75
PAKWACH,2016,80,160,240,75
PAKWACH,2017,90,170,260,75
PAKWACH,2018,90,170,260,75
PAKWACH,2019,90,180,270,75
PAKWACH,2020,100,180,280,75
PAKWACH,2021,100,190,290,75
PAKWACH,2022,100,200,300,75
PAKWACH,2023,110,200,310,75
PAKWACH,2024,110,210,320,75
PAKWACH,2025,120,220,340,75
PALLISA,2015,180,230,410,75
PALLISA,2016,200,270,470,75
PALLISA,2017,210,280,490,75
PALLISA,2018,210,290,500,75
PALLISA,2019,200,260,460,75
PALLISA,2020,190,240,430,75
PALLISA,2021,190,230,420,75
PALLISA,2022,190,230,420,75
PALLISA,2023,210,250,460,75
PALLISA,2024,230,280,510,75
PALLISA,2025,250,320,570,75
RAKAI,2015,160,210,370,75
RAKAI,2016,170,240,410,75
RAKAI,2017,180,250,430,75
RAKAI,2018,170,240,410,75
RAKAI,2019,170,220,390,75
RAKAI,2020,150,200,350,75
RAKAI,2021,150,190,340,75
RAKAI,2022,160,180,340,75
RAKAI,2023,160,190,350,75
RAKAI,2024,180,210,390,75
RAKAI,2025,190,230,420,75
RUBANDA,2015,130,180,310,75
RUBANDA,2016,140,180,320,75
RUBANDA,2017,140,180,320,75
RUBANDA,2018,140,190,330,75
RUBANDA,2019,140,190,330,75
RUBANDA,2020,140,190,330,75
RUBANDA,2021,140,190,330,75
RUBANDA,2022,150,190,340,75
RUBANDA,2023,150,190,340,75
RUBANDA,2024,150,190,340,75
RUBANDA,2025,150,190,340,75
RUBIRIZI,2015,90,110,200,75
RUBIRIZI,2016,90,120,210,75
RUBIRIZI,2017,90,120,210,75
RUBIRIZI,2018,90,120,210,75
RUBIRIZI,2019,100,120,220,75
RUBIRIZI,2020,100,120,220,75
RUBIRIZI,2021,100,130,230,75
RUBIRIZI,2022,100,130,230,75
RUBIRIZI,2023,100,130,230,75
RUBIRIZI,2024,110,130,240,75
RUBIRIZI,2025,110,130,240,75
RUKIGA,2015,90,130,220,75
RUKIGA,2016,90,130,220,75
RUKIGA,2017,90,130,220,75
RUKIGA,2018,90,130,220,75
RUKIGA,2019,100,140,240,75
RUKIGA,2020,100,140,240,75
RUKIGA,2021,100,140,240,75
RUKIGA,2022,100,140,240,75
RUKIGA,2023,100,140,240,75
RUKIGA,2024,100,140,240,75
RUKIGA,2025,100,140,240,75
RUKUNGIRI,2015,280,370,650,75
RUKUNGIRI,2016,280,370,650,75
RUKUNGIRI,2017,280,380,660,75
RUKUNGIRI,2018,290,380,670,75
RUKUNGIRI,2019,290,390,680,75
RUKUNGIRI,2020,290,390,680,75
RUKUNGIRI,2021,300,390,690,75
RUKUNGIRI,2022,300,390,690,75
RUKUNGIRI,2023,300,400,700,75
RUKUNGIRI,2024,300,400,700,75
RUKUNGIRI,2025,310,400,710,75
RWAMPARA,2015,90,140,230,75
RWAMPARA,2016,90,140,230,75
RWAMPARA,2017,90,150,240,75
RWAMPARA,2018,90,150,240,75
RWAMPARA,2019,100,150,250,75
RWAMPARA,2020,100,160,260,75
RWAMPARA,2021,100,160,260,75
RWAMPARA,2022,100,160,260,75
RWAMPARA,2023,100,160,260,75
RWAMPARA,2024,110,170,280,75
RWAMPARA,2025,110,170,280,75
SERERE,2015,190,310,500,75
SERERE,2016,210,360,570,75
SERERE,2017,220,380,600,75
SERERE,2018,220,370,590,75
SERERE,2019,220,340,560,75
SERERE,2020,210,320,530,75
SERERE,2021,200,300,500,75
SERERE,2022,200,300,500,75
SERERE,2023,220,320,540,75
SERERE,2024,240,360,600,75
SERERE,2025,260,410,670,75
SHEEMA,2015,170,240,410,75
SHEEMA,2016,170,240,410,75
SHEEMA,2017,170,240,410,75
SHEEMA,2018,170,250,420,75
SHEEMA,2019,170,250,420,75
SHEEMA,2020,180,250,430,75
SHEEMA,2021,180,250,430,75
SHEEMA,2022,180,250,430,75
SHEEMA,2023,180,260,440,75
SHEEMA,2024,180,260,440,75
SHEEMA,2025,180,260,440,75
SIRONKO,2015,170,280,450,75
SIRONKO,2016,170,290,460,75
SIRONKO,2017,180,290,470,75
SIRONKO,2018,180,300,480,75
SIRONKO,2019,180,300,480,75
SIRONKO,2020,190,310,500,75
SIRONKO,2021,190,310,500,75
SIRONKO,2022,200,320,520,75
SIRONKO,2023,200,330,530,75
SIRONKO,2024,200,330,530,75
SIRONKO,2025,210,340,550,75
SOROTI,2015,160,260,420,75
SOROTI,2016,170,300,470,75
SOROTI,2017,180,320,500,75
SOROTI,2018,180,310,490,75
SOROTI,2019,170,290,460,75
SOROTI,2020,160,260,420,75
SOROTI,2021,160,250,410,75
SOROTI,2022,160,250,410,75
SOROTI,2023,180,260,440,75
SOROTI,2024,180,290,470,75
SOROTI,2025,200,330,530,75
SSEMBABULE,2015,140,180,320,75
SSEMBABULE,2016,150,210,360,75
SSEMBABULE,2017,160,230,390,75
SSEMBABULE,2018,150,210,360,75
SSEMBABULE,2019,150,200,350,75
SSEMBABULE,2020,140,180,320,75
SSEMBABULE,2021,140,170,310,75
SSEMBABULE,2022,140,170,310,75
SSEMBABULE,2023,150,170,320,75
SSEMBABULE,2024,160,190,350,75
SSEMBABULE,2025,170,210,380,75
TORORO,2015,370,440,810,75
TORORO,2016,380,450,830,75
TORORO,2017,390,460,850,75
TORORO,2018,400,470,870,75
TORORO,2019,410,480,890,75
TORORO,2020,420,490,910,75
TORORO,2021,430,500,930,75
TORORO,2022,440,520,960,75
TORORO,2023,450,530,980,75
TORORO,2024,460,540,1000,75
TORORO,2025,470,550,1020,75
WAKISO,2015,720,1140,1860,75
WAKISO,2016,760,1220,1980,75
WAKISO,2017,820,1300,2120,75
WAKISO,2018,870,1390,2260,75
WAKISO,2019,930,1480,2410,75
WAKISO,2020,990,1580,2570,75
WAKISO,2021,1050,1690,2740,75
WAKISO,2022,1120,1800,2920,75
WAKISO,2023,1190,1910,3100,75
WAKISO,2024,1260,2040,3300,75
WAKISO,2025,1340,2170,3510,75
YUMBE,2015,290,260,550,75
YUMBE,2016,320,310,630,75
YUMBE,2017,340,340,680,75
YUMBE,2018,340,340,680,75
YUMBE,2019,330,320,650,75
YUMBE,2020,320,300,620,75
YUMBE,2021,330,290,620,75
YUMBE,2022,330,290,620,75
YUMBE,2023,360,320,680,75
YUMBE,2024,390,370,760,75
YUMBE,2025,430,420,850,75
ZOMBO,2015,170,300,470,75
ZOMBO,2016,170,310,480,75
ZOMBO,2017,180,320,500,75
ZOMBO,2018,180,330,510,75
ZOMBO,2019,190,330,520,75
ZOMBO,2020,190,340,530,75
ZOMBO,2021,200,350,550,75
ZOMBO,2022,210,360,570,75
ZOMBO,2023,210,370,580,75
ZOMBO,2024,220,380,600,75
ZOMBO,2025,220,390,610,75
ABIM,2015,50,50,100,76
ABIM,2016,60,60,120,76
ABIM,2017,60,70,130,76
ABIM,2018,60,70,130,76
ABIM,2019,70,60,130,76
ABIM,2020,70,70,140,76
ABIM,2021,60,60,120,76
ABIM,2022,70,60,130,76
ABIM,2023,70,60,130,76
ABIM,2024,80,70,150,76
ABIM,2025,80,80,160,76
ADJUMANI,2015,50,90,140,76
ADJUMANI,2016,50,90,140,76
ADJUMANI,2017,50,90,140,76
ADJUMANI,2018,50,100,150,76
ADJUMANI,2019,50,100,150,76
ADJUMANI,2020,50,100,150,76
ADJUMANI,2021,50,100,150,76
ADJUMANI,2022,50,100,150,76
ADJUMANI,2023,50,100,150,76
ADJUMANI,2024,50,100,150,76
ADJUMANI,2025,50,100,150,76
AGAGO,2015,80,120,200,76
AGAGO,2016,80,130,210,76
AGAGO,2017,90,130,220,76
AGAGO,2018,90,130,220,76
AGAGO,2019,90,130,220,76
AGAGO,2020,90,130,220,76
AGAGO,2021,90,140,230,76
AGAGO,2022,90,140,230,76
AGAGO,2023,90,140,230,76
AGAGO,2024,100,140,240,76
AGAGO,2025,100,140,240,76
ALEBTONG,2015,130,200,330,76
ALEBTONG,2016,130,190,320,76
ALEBTONG,2017,150,230,380,76
ALEBTONG,2018,150,240,390,76
ALEBTONG,2019,140,230,370,76
ALEBTONG,2020,140,220,360,76
ALEBTONG,2021,130,190,320,76
ALEBTONG,2022,120,170,290,76
ALEBTONG,2023,130,180,310,76
ALEBTONG,2024,130,190,320,76
ALEBTONG,2025,140,210,350,76
AMOLATAR,2015,70,80,150,76
AMOLATAR,2016,70,70,140,76
AMOLATAR,2017,70,80,150,76
AMOLATAR,2018,70,100,170,76
AMOLATAR,2019,70,100,170,76
AMOLATAR,2020,70,90,160,76
AMOLATAR,2021,70,80,150,76
AMOLATAR,2022,70,70,140,76
AMOLATAR,2023,70,70,140,76
AMOLATAR,2024,70,70,140,76
AMOLATAR,2025,70,80,150,76
AMUDAT,2015,20,30,50,76
AMUDAT,2016,20,30,50,76
AMUDAT,2017,20,30,50,76
AMUDAT,2018,20,30,50,76
AMUDAT,2019,20,30,50,76
AMUDAT,2020,20,30,50,76
AMUDAT,2021,20,30,50,76
AMUDAT,2022,20,20,40,76
AMUDAT,2023,20,20,40,76
AMUDAT,2024,20,20,40,76
AMUDAT,2025,20,30,50,76
AMURIA,2015,90,110,200,76
AMURIA,2016,90,100,190,76
AMURIA,2017,100,120,220,76
AMURIA,2018,110,140,250,76
AMURIA,2019,110,130,240,76
AMURIA,2020,100,120,220,76
AMURIA,2021,100,110,210,76
AMURIA,2022,100,100,200,76
AMURIA,2023,90,100,190,76
AMURIA,2024,110,100,210,76
AMURIA,2025,110,130,240,76
AMURU,2015,70,120,190,76
AMURU,2016,80,120,200,76
AMURU,2017,90,130,220,76
AMURU,2018,90,140,230,76
AMURU,2019,80,140,220,76
AMURU,2020,80,130,210,76
AMURU,2021,80,110,190,76
AMURU,2022,80,100,180,76
AMURU,2023,80,100,180,76
AMURU,2024,80,120,200,76
AMURU,2025,80,130,210,76
APAC,2015,100,100,200,76
APAC,2016,100,110,210,76
APAC,2017,100,110,210,76
APAC,2018,110,110,220,76
APAC,2019,110,120,230,76
APAC,2020,110,120,230,76
APAC,2021,120,130,250,76
APAC,2022,120,130,250,76
APAC,2023,130,130,260,76
APAC,2024,130,140,270,76
APAC,2025,130,140,270,76
ARUA,2015,240,240,480,76
ARUA,2016,240,250,490,76
ARUA,2017,250,260,510,76
ARUA,2018,260,260,520,76
ARUA,2019,260,270,530,76
ARUA,2020,270,280,550,76
ARUA,2021,280,280,560,76
ARUA,2022,280,290,570,76
ARUA,2023,290,300,590,76
ARUA,2024,300,300,600,76
ARUA,2025,310,310,620,76
BUDAKA,2015,140,150,290,76
BUDAKA,2016,150,150,300,76
BUDAKA,2017,160,170,330,76
BUDAKA,2018,170,190,360,76
BUDAKA,2019,160,180,340,76
BUDAKA,2020,160,160,320,76
BUDAKA,2021,150,150,300,76
BUDAKA,2022,150,140,290,76
BUDAKA,2023,150,130,280,76
BUDAKA,2024,160,150,310,76
BUDAKA,2025,170,160,330,76
BUDUDA,2015,190,210,400,76
BUDUDA,2016,200,210,410,76
BUDUDA,2017,210,250,460,76
BUDUDA,2018,220,270,490,76
BUDUDA,2019,220,260,480,76
BUDUDA,2020,220,240,460,76
BUDUDA,2021,210,230,440,76
BUDUDA,2022,210,220,430,76
BUDUDA,2023,220,210,430,76
BUDUDA,2024,230,230,460,76
BUDUDA,2025,250,260,510,76
BUGIRI,2015,200,180,380,76
BUGIRI,2016,200,180,380,76
BUGIRI,2017,220,210,430,76
BUGIRI,2018,230,220,450,76
BUGIRI,2019,230,230,460,76
BUGIRI,2020,220,200,420,76
BUGIRI,2021,210,190,400,76
BUGIRI,2022,210,170,380,76
BUGIRI,2023,220,180,400,76
BUGIRI,2024,230,190,420,76
BUGIRI,2025,250,210,460,76
BUGWERI,2015,60,120,180,76
BUGWERI,2016,60,130,190,76
BUGWERI,2017,60,150,210,76
BUGWERI,2018,60,150,210,76
BUGWERI,2019,60,140,200,76
BUGWERI,2020,50,140,190,76
BUGWERI,2021,60,130,190,76
BUGWERI,2022,60,120,180,76
BUGWERI,2023,60,110,170,76
BUGWERI,2024,60,120,180,76
BUGWERI,2025,60,140,200,76
BUHWEJU,2015,60,60,120,76
BUHWEJU,2016,60,60,120,76
BUHWEJU,2017,60,70,130,76
BUHWEJU,2018,60,70,130,76
BUHWEJU,2019,60,70,130,76
BUHWEJU,2020,70,70,140,76
BUHWEJU,2021,70,70,140,76
BUHWEJU,2022,70,80,150,76
BUHWEJU,2023,70,80,150,76
BUHWEJU,2024,70,80,150,76
BUHWEJU,2025,80,80,160,76
BUIKWE,2015,170,200,370,76
BUIKWE,2016,160,210,370,76
BUIKWE,2017,180,230,410,76
BUIKWE,2018,180,240,420,76
BUIKWE,2019,180,230,410,76
BUIKWE,2020,170,220,390,76
BUIKWE,2021,160,190,350,76
BUIKWE,2022,150,170,320,76
BUIKWE,2023,150,170,320,76
BUIKWE,2024,160,190,350,76
BUIKWE,2025,170,200,370,76
BUKEDEA,2015,140,180,320,76
BUKEDEA,2016,150,190,340,76
BUKEDEA,2017,170,210,380,76
BUKEDEA,2018,170,240,410,76
BUKEDEA,2019,180,230,410,76
BUKEDEA,2020,160,220,380,76
BUKEDEA,2021,160,200,360,76
BUKEDEA,2022,160,190,350,76
BUKEDEA,2023,170,190,360,76
BUKEDEA,2024,170,200,370,76
BUKEDEA,2025,190,230,420,76
BUKOMANSIMBI,2015,120,150,270,76
BUKOMANSIMBI,2016,110,150,260,76
BUKOMANSIMBI,2017,120,170,290,76
BUKOMANSIMBI,2018,120,170,290,76
BUKOMANSIMBI,2019,120,160,280,76
BUKOMANSIMBI,2020,110,140,250,76
BUKOMANSIMBI,2021,100,130,230,76
BUKOMANSIMBI,2022,100,120,220,76
BUKOMANSIMBI,2023,90,110,200,76
BUKOMANSIMBI,2024,100,120,220,76
BUKOMANSIMBI,2025,100,130,230,76
BUKWO,2015,40,40,80,76
BUKWO,2016,40,50,90,76
BUKWO,2017,40,50,90,76
BUKWO,2018,40,50,90,76
BUKWO,2019,50,50,100,76
BUKWO,2020,50,60,110,76
BUKWO,2021,50,60,110,76
BUKWO,2022,50,60,110,76
BUKWO,2023,60,60,120,76
BUKWO,2024,60,70,130,76
BUKWO,2025,60,70,130,76
BULAMBULI,2015,120,200,320,76
BULAMBULI,2016,130,190,320,76
BULAMBULI,2017,130,230,360,76
BULAMBULI,2018,150,250,400,76
BULAMBULI,2019,140,240,380,76
BULAMBULI,2020,140,230,370,76
BULAMBULI,2021,130,220,350,76
BULAMBULI,2022,130,210,340,76
BULAMBULI,2023,140,200,340,76
BULAMBULI,2024,140,220,360,76
BULAMBULI,2025,160,250,410,76
BULIISA,2015,40,30,70,76
BULIISA,2016,40,30,70,76
BULIISA,2017,40,30,70,76
BULIISA,2018,40,30,70,76
BULIISA,2019,50,30,80,76
BULIISA,2020,50,30,80,76
BULIISA,2021,50,30,80,76
BULIISA,2022,50,30,80,76
BULIISA,2023,60,40,100,76
BULIISA,2024,60,40,100,76
BULIISA,2025,60,40,100,76
BUNDIBUGYO,2015,70,110,180,76
BUNDIBUGYO,2016,80,100,180,76
BUNDIBUGYO,2017,90,120,210,76
BUNDIBUGYO,2018,90,120,210,76
BUNDIBUGYO,2019,80,110,190,76
BUNDIBUGYO,2020,80,120,200,76
BUNDIBUGYO,2021,80,100,180,76
BUNDIBUGYO,2022,80,90,170,76
BUNDIBUGYO,2023,80,90,170,76
BUNDIBUGYO,2024,80,90,170,76
BUNDIBUGYO,2025,90,110,200,76
BUNYANGABU,2015,110,140,250,76
BUNYANGABU,2016,110,150,260,76
BUNYANGABU,2017,120,170,290,76
BUNYANGABU,2018,120,170,290,76
BUNYANGABU,2019,120,160,280,76
BUNYANGABU,2020,120,160,280,76
BUNYANGABU,2021,110,140,250,76
BUNYANGABU,2022,110,130,240,76
BUNYANGABU,2023,100,120,220,76
BUNYANGABU,2024,120,130,250,76
BUNYANGABU,2025,120,150,270,76
BUSHENYI,2015,150,130,280,76
BUSHENYI,2016,150,130,280,76
BUSHENYI,2017,150,130,280,76
BUSHENYI,2018,150,130,280,76
BUSHENYI,2019,160,130,290,76
BUSHENYI,2020,160,130,290,76
BUSHENYI,2021,160,130,290,76
BUSHENYI,2022,160,130,290,76
BUSHENYI,2023,160,140,300,76
BUSHENYI,2024,160,140,300,76
BUSHENYI,2025,170,140,310,76
BUSIA,2015,180,270,450,76
BUSIA,2016,170,280,450,76
BUSIA,2017,190,310,500,76
BUSIA,2018,200,340,540,76
BUSIA,2019,200,320,520,76
BUSIA,2020,190,300,490,76
BUSIA,2021,180,270,450,76
BUSIA,2022,170,250,420,76
BUSIA,2023,180,240,420,76
BUSIA,2024,180,270,450,76
BUSIA,2025,200,300,500,76
BUTALEJA,2015,150,180,330,76
BUTALEJA,2016,160,180,340,76
BUTALEJA,2017,170,210,380,76
BUTALEJA,2018,180,220,400,76
BUTALEJA,2019,190,230,420,76
BUTALEJA,2020,170,200,370,76
BUTALEJA,2021,170,180,350,76
BUTALEJA,2022,160,170,330,76
BUTALEJA,2023,170,170,340,76
BUTALEJA,2024,180,190,370,76
BUTALEJA,2025,190,200,390,76
BUTAMBALA,2015,60,80,140,76
BUTAMBALA,2016,60,70,130,76
BUTAMBALA,2017,60,80,140,76
BUTAMBALA,2018,60,100,160,76
BUTAMBALA,2019,60,100,160,76
BUTAMBALA,2020,50,90,140,76
BUTAMBALA,2021,50,80,130,76
BUTAMBALA,2022,50,70,120,76
BUTAMBALA,2023,50,70,120,76
BUTAMBALA,2024,50,70,120,76
BUTAMBALA,2025,50,80,130,76
BUTEBO,2015,80,80,160,76
BUTEBO,2016,80,70,150,76
BUTEBO,2017,90,80,170,76
BUTEBO,2018,90,100,190,76
BUTEBO,2019,80,100,180,76
BUTEBO,2020,80,90,170,76
BUTEBO,2021,70,80,150,76
BUTEBO,2022,70,70,140,76
BUTEBO,2023,70,70,140,76
BUTEBO,2024,80,70,150,76
BUTEBO,2025,80,80,160,76
BUVUMA,2015,20,10,30,76
BUVUMA,2016,20,10,30,76
BUVUMA,2017,20,10,30,76
BUVUMA,2018,20,10,30,76
BUVUMA,2019,30,10,40,76
BUVUMA,2020,30,10,40,76
BUVUMA,2021,30,10,40,76
BUVUMA,2022,30,10,40,76
BUVUMA,2023,30,10,40,76
BUVUMA,2024,30,10,40,76
BUVUMA,2025,40,10,50,76
BUYENDE,2015,150,150,300,76
BUYENDE,2016,160,160,320,76
BUYENDE,2017,170,180,350,76
BUYENDE,2018,180,200,380,76
BUYENDE,2019,190,190,380,76
BUYENDE,2020,170,190,360,76
BUYENDE,2021,170,160,330,76
BUYENDE,2022,170,160,330,76
BUYENDE,2023,170,160,330,76
BUYENDE,2024,180,170,350,76
BUYENDE,2025,200,190,390,76
DOKOLO,2015,100,100,200,76
DOKOLO,2016,100,100,200,76
DOKOLO,2017,110,100,210,76
DOKOLO,2018,110,110,220,76
DOKOLO,2019,110,110,220,76
DOKOLO,2020,120,110,230,76
DOKOLO,2021,120,120,240,76
DOKOLO,2022,120,120,240,76
DOKOLO,2023,130,120,250,76
DOKOLO,2024,130,120,250,76
DOKOLO,2025,130,130,260,76
GOMBA,2015,80,90,170,76
GOMBA,2016,80,90,170,76
GOMBA,2017,90,100,190,76
GOMBA,2018,100,100,200,76
GOMBA,2019,90,100,190,76
GOMBA,2020,90,100,190,76
GOMBA,2021,80,90,170,76
GOMBA,2022,80,80,160,76
GOMBA,2023,80,80,160,76
GOMBA,2024,80,80,160,76
GOMBA,2025,80,90,170,76
GULU,2015,90,130,220,76
GULU,2016,90,130,220,76
GULU,2017,100,130,230,76
GULU,2018,100,140,240,76
GULU,2019,100,140,240,76
GULU,2020,100,150,250,76
GULU,2021,110,150,260,76
GULU,2022,110,150,260,76
GULU,2023,110,160,270,76
GULU,2024,120,160,280,76
GULU,2025,120,170,290,76
HOIMA,2015,140,140,280,76
HOIMA,2016,150,150,300,76
HOIMA,2017,150,160,310,76
HOIMA,2018,160,160,320,76
HOIMA,2019,160,170,330,76
HOIMA,2020,170,170,340,76
HOIMA,2021,180,180,360,76
HOIMA,2022,180,180,360,76
HOIMA,2023,190,190,380,76
HOIMA,2024,190,190,380,76
HOIMA,2025,200,200,400,76
IBANDA,2015,130,160,290,76
IBANDA,2016,130,160,290,76
IBANDA,2017,140,160,300,76
IBANDA,2018,140,170,310,76
IBANDA,2019,140,170,310,76
IBANDA,2020,140,170,310,76
IBANDA,2021,150,170,320,76
IBANDA,2022,150,180,330,76
IBANDA,2023,150,180,330,76
IBANDA,2024,150,180,330,76
IBANDA,2025,150,180,330,76
IGANGA,2015,130,150,280,76
IGANGA,2016,140,150,290,76
IGANGA,2017,150,170,320,76
IGANGA,2018,150,190,340,76
IGANGA,2019,150,180,330,76
IGANGA,2020,140,160,300,76
IGANGA,2021,140,150,290,76
IGANGA,2022,130,140,270,76
IGANGA,2023,130,130,260,76
IGANGA,2024,140,150,290,76
IGANGA,2025,150,160,310,76
ISINGIRO,2015,170,200,370,76
ISINGIRO,2016,180,200,380,76
ISINGIRO,2017,180,210,390,76
ISINGIRO,2018,190,220,410,76
ISINGIRO,2019,200,220,420,76
ISINGIRO,2020,200,230,430,76
ISINGIRO,2021,210,240,450,76
ISINGIRO,2022,220,250,470,76
ISINGIRO,2023,230,250,480,76
ISINGIRO,2024,230,260,490,76
ISINGIRO,2025,240,270,510,76
JINJA,2015,130,140,270,76
JINJA,2016,130,140,270,76
JINJA,2017,140,140,280,76
JINJA,2018,140,140,280,76
JINJA,2019,140,140,280,76
JINJA,2020,140,150,290,76
JINJA,2021,140,150,290,76
JINJA,2022,150,150,300,76
JINJA,2023,150,150,300,76
JINJA,2024,150,150,300,76
JINJA,2025,150,150,300,76
KAABONG,2015,20,20,40,76
KAABONG,2016,20,20,40,76
KAABONG,2017,20,20,40,76
KAABONG,2018,20,20,40,76
KAABONG,2019,20,20,40,76
KAABONG,2020,20,20,40,76
KAABONG,2021,20,20,40,76
KAABONG,2022,20,20,40,76
KAABONG,2023,20,20,40,76
KAABONG,2024,20,20,40,76
KAABONG,2025,20,20,40,76
KABALE,2015,110,150,260,76
KABALE,2016,120,160,280,76
KABALE,2017,120,160,280,76
KABALE,2018,120,160,280,76
KABALE,2019,120,160,280,76
KABALE,2020,120,160,280,76
KABALE,2021,120,160,280,76
KABALE,2022,130,170,300,76
KABALE,2023,130,170,300,76
KABALE,2024,130,170,300,76
KABALE,2025,130,170,300,76
KABAROLE,2015,110,160,270,76
KABAROLE,2016,110,160,270,76
KABAROLE,2017,120,170,290,76
KABAROLE,2018,120,170,290,76
KABAROLE,2019,120,170,290,76
KABAROLE,2020,120,180,300,76
KABAROLE,2021,130,180,310,76
KABAROLE,2022,130,180,310,76
KABAROLE,2023,130,190,320,76
KABAROLE,2024,130,190,320,76
KABAROLE,2025,140,190,330,76
KABERAMAIDO,2015,60,90,150,76
KABERAMAIDO,2016,70,100,170,76
KABERAMAIDO,2017,70,120,190,76
KABERAMAIDO,2018,70,120,190,76
KABERAMAIDO,2019,70,110,180,76
KABERAMAIDO,2020,80,120,200,76
KABERAMAIDO,2021,70,100,170,76
KABERAMAIDO,2022,70,90,160,76
KABERAMAIDO,2023,80,90,170,76
KABERAMAIDO,2024,80,100,180,76
KABERAMAIDO,2025,80,110,190,76
KAGADI,2015,100,110,210,76
KAGADI,2016,100,120,220,76
KAGADI,2017,100,120,220,76
KAGADI,2018,110,130,240,76
KAGADI,2019,110,130,240,76
KAGADI,2020,110,130,240,76
KAGADI,2021,120,140,260,76
KAGADI,2022,120,140,260,76
KAGADI,2023,130,150,280,76
KAGADI,2024,130,150,280,76
KAGADI,2025,130,160,290,76
KAKUMIRO,2015,80,90,170,76
KAKUMIRO,2016,90,90,180,76
KAKUMIRO,2017,90,100,190,76
KAKUMIRO,2018,100,110,210,76
KAKUMIRO,2019,110,120,230,76
KAKUMIRO,2020,120,130,250,76
KAKUMIRO,2021,130,140,270,76
KAKUMIRO,2022,140,150,290,76
KAKUMIRO,2023,150,160,310,76
KAKUMIRO,2024,170,180,350,76
KAKUMIRO,2025,180,190,370,76
KALAKI,2015,50,70,120,76
KALAKI,2016,50,70,120,76
KALAKI,2017,60,70,130,76
KALAKI,2018,60,80,140,76
KALAKI,2019,60,80,140,76
KALAKI,2020,60,80,140,76
KALAKI,2021,70,90,160,76
KALAKI,2022,70,90,160,76
KALAKI,2023,70,90,160,76
KALAKI,2024,70,100,170,76
KALAKI,2025,80,100,180,76
KALANGALA,2015,10,10,20,76
KALANGALA,2016,10,10,20,76
KALANGALA,2017,10,10,20,76
KALANGALA,2018,10,10,20,76
KALANGALA,2019,10,10,20,76
KALANGALA,2020,10,10,20,76
KALANGALA,2021,10,10,20,76
KALANGALA,2022,10,10,20,76
KALANGALA,2023,10,10,20,76
KALANGALA,2024,10,10,20,76
KALANGALA,2025,10,10,20,76
KALIRO,2015,130,150,280,76
KALIRO,2016,130,150,280,76
KALIRO,2017,130,180,310,76
KALIRO,2018,150,190,340,76
KALIRO,2019,140,180,320,76
KALIRO,2020,140,170,310,76
KALIRO,2021,130,150,280,76
KALIRO,2022,130,150,280,76
KALIRO,2023,130,140,270,76
KALIRO,2024,130,150,280,76
KALIRO,2025,150,180,330,76
KALUNGU,2015,130,200,330,76
KALUNGU,2016,130,210,340,76
KALUNGU,2017,130,230,360,76
KALUNGU,2018,150,240,390,76
KALUNGU,2019,140,230,370,76
KALUNGU,2020,130,200,330,76
KALUNGU,2021,120,180,300,76
KALUNGU,2022,120,160,280,76
KALUNGU,2023,110,160,270,76
KALUNGU,2024,120,160,280,76
KALUNGU,2025,120,180,300,76
KAMPALA,2015,210,250,460,76
KAMPALA,2016,210,250,460,76
KAMPALA,2017,210,260,470,76
KAMPALA,2018,220,260,480,76
KAMPALA,2019,220,270,490,76
KAMPALA,2020,230,270,500,76
KAMPALA,2021,230,280,510,76
KAMPALA,2022,230,280,510,76
KAMPALA,2023,240,290,530,76
KAMPALA,2024,240,290,530,76
KAMPALA,2025,250,290,540,76
KAMULI,2015,250,270,520,76
KAMULI,2016,240,270,510,76
KAMULI,2017,270,310,580,76
KAMULI,2018,270,320,590,76
KAMULI,2019,270,310,580,76
KAMULI,2020,260,290,550,76
KAMULI,2021,240,250,490,76
KAMULI,2022,240,240,480,76
KAMULI,2023,240,230,470,76
KAMULI,2024,250,240,490,76
KAMULI,2025,270,280,550,76
KAMWENGE,2015,100,60,160,76
KAMWENGE,2016,100,70,170,76
KAMWENGE,2017,100,70,170,76
KAMWENGE,2018,110,70,180,76
KAMWENGE,2019,110,70,180,76
KAMWENGE,2020,120,80,200,76
KAMWENGE,2021,120,80,200,76
KAMWENGE,2022,120,80,200,76
KAMWENGE,2023,130,80,210,76
KAMWENGE,2024,130,90,220,76
KAMWENGE,2025,140,90,230,76
KANUNGU,2015,120,110,230,76
KANUNGU,2016,130,110,240,76
KANUNGU,2017,130,120,250,76
KANUNGU,2018,130,120,250,76
KANUNGU,2019,130,120,250,76
KANUNGU,2020,130,120,250,76
KANUNGU,2021,140,120,260,76
KANUNGU,2022,140,120,260,76
KANUNGU,2023,140,130,270,76
KANUNGU,2024,140,130,270,76
KANUNGU,2025,140,130,270,76
KAPCHORWA,2015,50,70,120,76
KAPCHORWA,2016,50,70,120,76
KAPCHORWA,2017,60,80,140,76
KAPCHORWA,2018,60,80,140,76
KAPCHORWA,2019,60,80,140,76
KAPCHORWA,2020,60,80,140,76
KAPCHORWA,2021,60,80,140,76
KAPCHORWA,2022,70,90,160,76
KAPCHORWA,2023,70,90,160,76
KAPCHORWA,2024,70,90,160,76
KAPCHORWA,2025,70,90,160,76
KAPELEBYONG,2015,50,30,80,76
KAPELEBYONG,2016,50,30,80,76
KAPELEBYONG,2017,50,30,80,76
KAPELEBYONG,2018,50,50,100,76
KAPELEBYONG,2019,50,50,100,76
KAPELEBYONG,2020,40,40,80,76
KAPELEBYONG,2021,50,40,90,76
KAPELEBYONG,2022,50,30,80,76
KAPELEBYONG,2023,50,30,80,76
KAPELEBYONG,2024,50,30,80,76
KAPELEBYONG,2025,50,40,90,76
KASESE,2015,220,260,480,76
KASESE,2016,220,250,470,76
KASESE,2017,240,280,520,76
KASESE,2018,240,300,540,76
KASESE,2019,250,290,540,76
KASESE,2020,230,260,490,76
KASESE,2021,220,240,460,76
KASESE,2022,210,220,430,76
KASESE,2023,220,220,440,76
KASESE,2024,220,230,450,76
KASESE,2025,230,250,480,76
KASSANDA,2015,100,80,180,76
KASSANDA,2016,100,80,180,76
KASSANDA,2017,110,80,190,76
KASSANDA,2018,110,90,200,76
KASSANDA,2019,110,90,200,76
KASSANDA,2020,120,90,210,76
KASSANDA,2021,120,90,210,76
KASSANDA,2022,120,90,210,76
KASSANDA,2023,120,90,210,76
KASSANDA,2024,130,100,230,76
KASSANDA,2025,130,100,230,76
KATAKWI,2015,140,200,340,76
KATAKWI,2016,150,190,340,76
KATAKWI,2017,160,230,390,76
KATAKWI,2018,170,240,410,76
KATAKWI,2019,160,240,400,76
KATAKWI,2020,150,220,370,76
KATAKWI,2021,150,190,340,76
KATAKWI,2022,140,190,330,76
KATAKWI,2023,150,180,330,76
KATAKWI,2024,150,190,340,76
KATAKWI,2025,160,210,370,76
KAYUNGA,2015,180,260,440,76
KAYUNGA,2016,170,250,420,76
KAYUNGA,2017,180,280,460,76
KAYUNGA,2018,200,300,500,76
KAYUNGA,2019,190,290,480,76
KAYUNGA,2020,170,260,430,76
KAYUNGA,2021,170,230,400,76
KAYUNGA,2022,160,220,380,76
KAYUNGA,2023,160,210,370,76
KAYUNGA,2024,160,220,380,76
KAYUNGA,2025,180,240,420,76
KAZO,2015,90,60,150,76
KAZO,2016,90,60,150,76
KAZO,2017,100,60,160,76
KAZO,2018,100,70,170,76
KAZO,2019,100,70,170,76
KAZO,2020,110,70,180,76
KAZO,2021,110,70,180,76
KAZO,2022,120,70,190,76
KAZO,2023,120,80,200,76
KAZO,2024,120,80,200,76
KAZO,2025,130,80,210,76
KIBAALE,2015,50,40,90,76
KIBAALE,2016,50,50,100,76
KIBAALE,2017,60,50,110,76
KIBAALE,2018,60,50,110,76
KIBAALE,2019,70,50,120,76
KIBAALE,2020,70,60,130,76
KIBAALE,2021,70,60,130,76
KIBAALE,2022,80,60,140,76
KIBAALE,2023,80,70,150,76
KIBAALE,2024,90,70,160,76
KIBAALE,2025,90,70,160,76
KIBOGA,2015,70,70,140,76
KIBOGA,2016,70,70,140,76
KIBOGA,2017,80,70,150,76
KIBOGA,2018,80,80,160,76
KIBOGA,2019,80,80,160,76
KIBOGA,2020,80,80,160,76
KIBOGA,2021,80,80,160,76
KIBOGA,2022,90,80,170,76
KIBOGA,2023,90,90,180,76
KIBOGA,2024,90,90,180,76
KIBOGA,2025,90,90,180,76
KIBUKU,2015,110,170,280,76
KIBUKU,2016,100,160,260,76
KIBUKU,2017,120,180,300,76
KIBUKU,2018,120,200,320,76
KIBUKU,2019,130,190,320,76
KIBUKU,2020,120,190,310,76
KIBUKU,2021,110,160,270,76
KIBUKU,2022,120,160,280,76
KIBUKU,2023,110,160,270,76
KIBUKU,2024,120,160,280,76
KIBUKU,2025,130,190,320,76
KIKUUBE,2015,90,80,170,76
KIKUUBE,2016,90,80,170,76
KIKUUBE,2017,100,90,190,76
KIKUUBE,2018,100,90,190,76
KIKUUBE,2019,110,100,210,76
KIKUUBE,2020,120,100,220,76
KIKUUBE,2021,120,110,230,76
KIKUUBE,2022,130,110,240,76
KIKUUBE,2023,130,120,250,76
KIKUUBE,2024,140,120,260,76
KIKUUBE,2025,150,130,280,76
KIRUHURA,2015,60,50,110,76
KIRUHURA,2016,60,60,120,76
KIRUHURA,2017,60,60,120,76
KIRUHURA,2018,60,60,120,76
KIRUHURA,2019,70,60,130,76
KIRUHURA,2020,70,60,130,76
KIRUHURA,2021,70,70,140,76
KIRUHURA,2022,70,70,140,76
KIRUHURA,2023,80,70,150,76
KIRUHURA,2024,80,70,150,76
KIRUHURA,2025,80,70,150,76
KIRYANDONGO,2015,110,120,230,76
KIRYANDONGO,2016,100,130,230,76
KIRYANDONGO,2017,110,150,260,76
KIRYANDONGO,2018,110,150,260,76
KIRYANDONGO,2019,120,140,260,76
KIRYANDONGO,2020,110,140,250,76
KIRYANDONGO,2021,100,130,230,76
KIRYANDONGO,2022,100,120,220,76
KIRYANDONGO,2023,100,110,210,76
KIRYANDONGO,2024,110,130,240,76
KIRYANDONGO,2025,110,140,250,76
KISORO,2015,140,170,310,76
KISORO,2016,140,160,300,76
KISORO,2017,150,180,330,76
KISORO,2018,150,200,350,76
KISORO,2019,150,190,340,76
KISORO,2020,140,170,310,76
KISORO,2021,130,150,280,76
KISORO,2022,120,140,260,76
KISORO,2023,130,140,270,76
KISORO,2024,130,150,280,76
KISORO,2025,140,160,300,76
KITAGWENDA,2015,80,70,150,76
KITAGWENDA,2016,80,70,150,76
KITAGWENDA,2017,80,80,160,76
KITAGWENDA,2018,90,80,170,76
KITAGWENDA,2019,90,80,170,76
KITAGWENDA,2020,90,80,170,76
KITAGWENDA,2021,100,90,190,76
KITAGWENDA,2022,100,90,190,76
KITAGWENDA,2023,100,90,190,76
KITAGWENDA,2024,110,100,210,76
KITAGWENDA,2025,110,100,210,76
KITGUM,2015,120,150,270,76
KITGUM,2016,110,150,260,76
KITGUM,2017,120,180,300,76
KITGUM,2018,120,190,310,76
KITGUM,2019,120,180,300,76
KITGUM,2020,110,160,270,76
KITGUM,2021,110,140,250,76
KITGUM,2022,110,130,240,76
KITGUM,2023,100,130,230,76
KITGUM,2024,110,140,250,76
KITGUM,2025,110,150,260,76
KOBOKO,2015,70,80,150,76
KOBOKO,2016,70,90,160,76
KOBOKO,2017,70,100,170,76
KOBOKO,2018,90,100,190,76
KOBOKO,2019,80,100,180,76
KOBOKO,2020,80,90,170,76
KOBOKO,2021,70,90,160,76
KOBOKO,2022,80,80,160,76
KOBOKO,2023,80,80,160,76
KOBOKO,2024,80,80,160,76
KOBOKO,2025,90,100,190,76
KOLE,2015,120,150,270,76
KOLE,2016,130,150,280,76
KOLE,2017,130,150,280,76
KOLE,2018,140,160,300,76
KOLE,2019,140,160,300,76
KOLE,2020,140,170,310,76
KOLE,2021,150,170,320,76
KOLE,2022,150,180,330,76
KOLE,2023,160,180,340,76
KOLE,2024,160,180,340,76
KOLE,2025,170,190,360,76
KOTIDO,2015,50,60,110,76
KOTIDO,2016,50,60,110,76
KOTIDO,2017,50,70,120,76
KOTIDO,2018,50,80,130,76
KOTIDO,2019,60,80,140,76
KOTIDO,2020,50,70,120,76
KOTIDO,2021,50,60,110,76
KOTIDO,2022,50,60,110,76
KOTIDO,2023,50,60,110,76
KOTIDO,2024,50,60,110,76
KOTIDO,2025,50,60,110,76
KUMI,2015,180,240,420,76
KUMI,2016,180,240,420,76
KUMI,2017,190,280,470,76
KUMI,2018,210,290,500,76
KUMI,2019,210,290,500,76
KUMI,2020,200,260,460,76
KUMI,2021,190,240,430,76
KUMI,2022,180,220,400,76
KUMI,2023,190,220,410,76
KUMI,2024,190,230,420,76
KUMI,2025,210,260,470,76
KWANIA,2015,80,130,210,76
KWANIA,2016,90,130,220,76
KWANIA,2017,90,130,220,76
KWANIA,2018,90,140,230,76
KWANIA,2019,90,140,230,76
KWANIA,2020,100,150,250,76
KWANIA,2021,100,150,250,76
KWANIA,2022,100,150,250,76
KWANIA,2023,110,160,270,76
KWANIA,2024,110,160,270,76
KWANIA,2025,110,160,270,76
KWEEN,2015,30,50,80,76
KWEEN,2016,30,50,80,76
KWEEN,2017,30,50,80,76
KWEEN,2018,30,50,80,76
KWEEN,2019,30,60,90,76
KWEEN,2020,30,60,90,76
KWEEN,2021,30,60,90,76
KWEEN,2022,40,60,100,76
KWEEN,2023,40,60,100,76
KWEEN,2024,40,60,100,76
KWEEN,2025,40,60,100,76
KYANKWANZI,2015,100,90,190,76
KYANKWANZI,2016,110,90,200,76
KYANKWANZI,2017,110,90,200,76
KYANKWANZI,2018,120,100,220,76
KYANKWANZI,2019,130,100,230,76
KYANKWANZI,2020,130,110,240,76
KYANKWANZI,2021,140,110,250,76
KYANKWANZI,2022,150,120,270,76
KYANKWANZI,2023,150,120,270,76
KYANKWANZI,2024,160,130,290,76
KYANKWANZI,2025,170,130,300,76
KYEGEGWA,2015,120,100,220,76
KYEGEGWA,2016,130,110,240,76
KYEGEGWA,2017,140,120,260,76
KYEGEGWA,2018,150,120,270,76
KYEGEGWA,2019,160,130,290,76
KYEGEGWA,2020,180,140,320,76
KYEGEGWA,2021,190,160,350,76
KYEGEGWA,2022,200,170,370,76
KYEGEGWA,2023,220,180,400,76
KYEGEGWA,2024,240,190,430,76
KYEGEGWA,2025,260,210,470,76
KYENJOJO,2015,190,200,390,76
KYENJOJO,2016,190,210,400,76
KYENJOJO,2017,200,220,420,76
KYENJOJO,2018,210,230,440,76
KYENJOJO,2019,220,230,450,76
KYENJOJO,2020,230,240,470,76
KYENJOJO,2021,240,250,490,76
KYENJOJO,2022,250,260,510,76
KYENJOJO,2023,250,270,520,76
KYENJOJO,2024,260,280,540,76
KYENJOJO,2025,270,290,560,76
KYOTERA,2015,150,260,410,76
KYOTERA,2016,150,250,400,76
KYOTERA,2017,160,280,440,76
KYOTERA,2018,160,300,460,76
KYOTERA,2019,160,290,450,76
KYOTERA,2020,150,260,410,76
KYOTERA,2021,140,230,370,76
KYOTERA,2022,130,210,340,76
KYOTERA,2023,130,210,340,76
KYOTERA,2024,140,220,360,76
KYOTERA,2025,150,240,390,76
KARENGA,2015,20,20,40,76
KARENGA,2016,20,20,40,76
KARENGA,2017,20,20,40,76
KARENGA,2018,20,20,40,76
KARENGA,2019,20,20,40,76
KARENGA,2020,20,20,40,76
KARENGA,2021,20,20,40,76
KARENGA,2022,20,20,40,76
KARENGA,2023,20,20,40,76
KARENGA,2024,30,20,50,76
KARENGA,2025,30,20,50,76
LAMWO,2015,110,150,260,76
LAMWO,2016,100,150,250,76
LAMWO,2017,110,170,280,76
LAMWO,2018,110,170,280,76
LAMWO,2019,110,160,270,76
LAMWO,2020,100,140,240,76
LAMWO,2021,90,140,230,76
LAMWO,2022,90,130,220,76
LAMWO,2023,80,120,200,76
LAMWO,2024,90,130,220,76
LAMWO,2025,100,140,240,76
LIRA,2015,150,150,300,76
LIRA,2016,150,150,300,76
LIRA,2017,150,160,310,76
LIRA,2018,160,160,320,76
LIRA,2019,160,170,330,76
LIRA,2020,170,170,340,76
LIRA,2021,170,170,340,76
LIRA,2022,180,180,360,76
LIRA,2023,180,180,360,76
LIRA,2024,180,190,370,76
LIRA,2025,190,190,380,76
LUUKA,2015,90,120,210,76
LUUKA,2016,90,130,220,76
LUUKA,2017,100,150,250,76
LUUKA,2018,110,150,260,76
LUUKA,2019,110,140,250,76
LUUKA,2020,100,130,230,76
LUUKA,2021,90,110,200,76
LUUKA,2022,90,120,210,76
LUUKA,2023,80,110,190,76
LUUKA,2024,100,120,220,76
LUUKA,2025,100,130,230,76
LUWERO,2015,190,300,490,76
LUWERO,2016,180,300,480,76
LUWERO,2017,210,350,560,76
LUWERO,2018,210,350,560,76
LUWERO,2019,210,350,560,76
LUWERO,2020,200,320,520,76
LUWERO,2021,190,290,480,76
LUWERO,2022,180,270,450,76
LUWERO,2023,180,270,450,76
LUWERO,2024,190,280,470,76
LUWERO,2025,200,300,500,76
LWENGO,2015,170,200,370,76
LWENGO,2016,160,190,350,76
LWENGO,2017,170,210,380,76
LWENGO,2018,170,240,410,76
LWENGO,2019,160,230,390,76
LWENGO,2020,150,200,350,76
LWENGO,2021,140,180,320,76
LWENGO,2022,140,160,300,76
LWENGO,2023,140,160,300,76
LWENGO,2024,140,160,300,76
LWENGO,2025,150,180,330,76
LYANTONDE,2015,40,80,120,76
LYANTONDE,2016,30,70,100,76
LYANTONDE,2017,50,80,130,76
LYANTONDE,2018,50,80,130,76
LYANTONDE,2019,50,80,130,76
LYANTONDE,2020,40,90,130,76
LYANTONDE,2021,40,80,120,76
LYANTONDE,2022,40,70,110,76
LYANTONDE,2023,40,70,110,76
LYANTONDE,2024,40,70,110,76
LYANTONDE,2025,40,80,120,76
MANAFWA,2015,110,160,270,76
MANAFWA,2016,120,160,280,76
MANAFWA,2017,120,170,290,76
MANAFWA,2018,120,170,290,76
MANAFWA,2019,130,170,300,76
MANAFWA,2020,130,180,310,76
MANAFWA,2021,130,180,310,76
MANAFWA,2022,130,180,310,76
MANAFWA,2023,140,190,330,76
MANAFWA,2024,140,190,330,76
MANAFWA,2025,140,190,330,76
MARACHA,2015,60,90,150,76
MARACHA,2016,60,100,160,76
MARACHA,2017,60,100,160,76
MARACHA,2018,60,100,160,76
MARACHA,2019,60,100,160,76
MARACHA,2020,60,100,160,76
MARACHA,2021,70,100,170,76
MARACHA,2022,70,110,180,76
MARACHA,2023,70,110,180,76
MARACHA,2024,70,110,180,76
MARACHA,2025,70,110,180,76
MASAKA,2015,140,240,380,76
MASAKA,2016,150,240,390,76
MASAKA,2017,160,260,420,76
MASAKA,2018,160,290,450,76
MASAKA,2019,150,270,420,76
MASAKA,2020,150,240,390,76
MASAKA,2021,140,230,370,76
MASAKA,2022,130,210,340,76
MASAKA,2023,140,200,340,76
MASAKA,2024,140,210,350,76
MASAKA,2025,150,240,390,76
MASINDI,2015,110,110,220,76
MASINDI,2016,110,110,220,76
MASINDI,2017,120,120,240,76
MASINDI,2018,120,120,240,76
MASINDI,2019,120,120,240,76
MASINDI,2020,130,130,260,76
MASINDI,2021,130,130,260,76
MASINDI,2022,130,130,260,76
MASINDI,2023,140,130,270,76
MASINDI,2024,140,140,280,76
MASINDI,2025,140,140,280,76
MAYUGE,2015,240,230,470,76
MAYUGE,2016,240,220,460,76
MAYUGE,2017,270,260,530,76
MAYUGE,2018,270,270,540,76
MAYUGE,2019,270,270,540,76
MAYUGE,2020,260,240,500,76
MAYUGE,2021,250,230,480,76
MAYUGE,2022,240,210,450,76
MAYUGE,2023,240,210,450,76
MAYUGE,2024,260,220,480,76
MAYUGE,2025,270,250,520,76
MBALE,2015,340,560,900,76
MBALE,2016,340,580,920,76
MBALE,2017,380,660,1040,76
MBALE,2018,390,690,1080,76
MBALE,2019,390,690,1080,76
MBALE,2020,370,630,1000,76
MBALE,2021,350,570,920,76
MBALE,2022,350,540,890,76
MBALE,2023,350,530,880,76
MBALE,2024,360,570,930,76
MBALE,2025,390,640,1030,76
MBARARA,2015,130,180,310,76
MBARARA,2016,130,190,320,76
MBARARA,2017,140,190,330,76
MBARARA,2018,140,190,330,76
MBARARA,2019,140,200,340,76
MBARARA,2020,140,200,340,76
MBARARA,2021,150,210,360,76
MBARARA,2022,150,210,360,76
MBARARA,2023,150,210,360,76
MBARARA,2024,160,220,380,76
MBARARA,2025,160,220,380,76
MITOOMA,2015,120,110,230,76
MITOOMA,2016,120,120,240,76
MITOOMA,2017,120,120,240,76
MITOOMA,2018,120,120,240,76
MITOOMA,2019,120,120,240,76
MITOOMA,2020,120,120,240,76
MITOOMA,2021,120,120,240,76
MITOOMA,2022,130,120,250,76
MITOOMA,2023,130,120,250,76
MITOOMA,2024,130,120,250,76
MITOOMA,2025,130,120,250,76
MITYANA,2015,180,240,420,76
MITYANA,2016,170,240,410,76
MITYANA,2017,180,280,460,76
MITYANA,2018,200,290,490,76
MITYANA,2019,190,270,460,76
MITYANA,2020,170,240,410,76
MITYANA,2021,160,230,390,76
MITYANA,2022,160,210,370,76
MITYANA,2023,160,200,360,76
MITYANA,2024,160,210,370,76
MITYANA,2025,170,240,410,76
MOROTO,2015,20,60,80,76
MOROTO,2016,20,70,90,76
MOROTO,2017,20,80,100,76
MOROTO,2018,20,80,100,76
MOROTO,2019,20,80,100,76
MOROTO,2020,20,70,90,76
MOROTO,2021,20,60,80,76
MOROTO,2022,20,60,80,76
MOROTO,2023,20,60,80,76
MOROTO,2024,20,70,90,76
MOROTO,2025,20,80,100,76
MOYO,2015,30,40,70,76
MOYO,2016,30,40,70,76
MOYO,2017,30,40,70,76
MOYO,2018,30,40,70,76
MOYO,2019,30,40,70,76
MOYO,2020,30,40,70,76
MOYO,2021,40,40,80,76
MOYO,2022,40,40,80,76
MOYO,2023,40,40,80,76
MOYO,2024,40,40,80,76
MOYO,2025,40,40,80,76
MPIGI,2015,110,200,310,76
MPIGI,2016,100,190,290,76
MPIGI,2017,110,210,320,76
MPIGI,2018,110,240,350,76
MPIGI,2019,110,230,340,76
MPIGI,2020,110,200,310,76
MPIGI,2021,100,190,290,76
MPIGI,2022,100,170,270,76
MPIGI,2023,90,170,260,76
MPIGI,2024,110,170,280,76
MPIGI,2025,110,200,310,76
MUBENDE,2015,170,180,350,76
MUBENDE,2016,160,190,350,76
MUBENDE,2017,180,210,390,76
MUBENDE,2018,200,240,440,76
MUBENDE,2019,200,240,440,76
MUBENDE,2020,200,220,420,76
MUBENDE,2021,190,200,390,76
MUBENDE,2022,190,200,390,76
MUBENDE,2023,200,200,400,76
MUBENDE,2024,210,210,420,76
MUBENDE,2025,230,240,470,76
MUKONO,2015,260,320,580,76
MUKONO,2016,260,330,590,76
MUKONO,2017,280,360,640,76
MUKONO,2018,290,390,680,76
MUKONO,2019,280,390,670,76
MUKONO,2020,270,350,620,76
MUKONO,2021,260,320,580,76
MUKONO,2022,250,290,540,76
MUKONO,2023,250,290,540,76
MUKONO,2024,270,310,580,76
MUKONO,2025,280,340,620,76
MADI OKOLLO,2015,70,40,110,76
MADI OKOLLO,2016,70,40,110,76
MADI OKOLLO,2017,70,40,110,76
MADI OKOLLO,2018,70,40,110,76
MADI OKOLLO,2019,70,40,110,76
MADI OKOLLO,2020,80,40,120,76
MADI OKOLLO,2021,80,40,120,76
MADI OKOLLO,2022,80,40,120,76
MADI OKOLLO,2023,80,50,130,76
MADI OKOLLO,2024,80,50,130,76
MADI OKOLLO,2025,90,50,140,76
NABILATUK,2015,20,60,80,76
NABILATUK,2016,20,60,80,76
NABILATUK,2017,40,70,110,76
NABILATUK,2018,40,70,110,76
NABILATUK,2019,40,60,100,76
NABILATUK,2020,30,70,100,76
NABILATUK,2021,30,60,90,76
NABILATUK,2022,30,60,90,76
NABILATUK,2023,30,60,90,76
NABILATUK,2024,40,60,100,76
NABILATUK,2025,40,80,120,76
NAKAPIRIPIRIT,2015,50,80,130,76
NAKAPIRIPIRIT,2016,50,70,120,76
NAKAPIRIPIRIT,2017,50,100,150,76
NAKAPIRIPIRIT,2018,50,100,150,76
NAKAPIRIPIRIT,2019,50,100,150,76
NAKAPIRIPIRIT,2020,50,90,140,76
NAKAPIRIPIRIT,2021,50,90,140,76
NAKAPIRIPIRIT,2022,50,80,130,76
NAKAPIRIPIRIT,2023,50,80,130,76
NAKAPIRIPIRIT,2024,50,80,130,76
NAKAPIRIPIRIT,2025,60,100,160,76
NAKASEKE,2015,70,80,150,76
NAKASEKE,2016,70,80,150,76
NAKASEKE,2017,70,80,150,76
NAKASEKE,2018,80,80,160,76
NAKASEKE,2019,80,80,160,76
NAKASEKE,2020,80,80,160,76
NAKASEKE,2021,90,90,180,76
NAKASEKE,2022,90,90,180,76
NAKASEKE,2023,90,90,180,76
NAKASEKE,2024,90,90,180,76
NAKASEKE,2025,100,90,190,76
NAKASONGOLA,2015,60,140,200,76
NAKASONGOLA,2016,70,130,200,76
NAKASONGOLA,2017,70,150,220,76
NAKASONGOLA,2018,70,150,220,76
NAKASONGOLA,2019,70,160,230,76
NAKASONGOLA,2020,70,140,210,76
NAKASONGOLA,2021,70,130,200,76
NAKASONGOLA,2022,70,120,190,76
NAKASONGOLA,2023,70,110,180,76
NAKASONGOLA,2024,70,130,200,76
NAKASONGOLA,2025,70,140,210,76
NAMAYINGO,2015,80,90,170,76
NAMAYINGO,2016,80,90,170,76
NAMAYINGO,2017,90,100,190,76
NAMAYINGO,2018,90,100,190,76
NAMAYINGO,2019,80,110,190,76
NAMAYINGO,2020,80,100,180,76
NAMAYINGO,2021,70,90,160,76
NAMAYINGO,2022,80,80,160,76
NAMAYINGO,2023,80,80,160,76
NAMAYINGO,2024,80,80,160,76
NAMAYINGO,2025,80,90,170,76
NAMISINDWA,2015,150,140,290,76
NAMISINDWA,2016,150,140,290,76
NAMISINDWA,2017,150,140,290,76
NAMISINDWA,2018,160,150,310,76
NAMISINDWA,2019,160,150,310,76
NAMISINDWA,2020,170,150,320,76
NAMISINDWA,2021,170,160,330,76
NAMISINDWA,2022,180,160,340,76
NAMISINDWA,2023,180,160,340,76
NAMISINDWA,2024,180,170,350,76
NAMISINDWA,2025,190,170,360,76
NAMUTUMBA,2015,130,150,280,76
NAMUTUMBA,2016,130,160,290,76
NAMUTUMBA,2017,150,180,330,76
NAMUTUMBA,2018,150,190,340,76
NAMUTUMBA,2019,150,190,340,76
NAMUTUMBA,2020,140,170,310,76
NAMUTUMBA,2021,130,150,280,76
NAMUTUMBA,2022,130,150,280,76
NAMUTUMBA,2023,130,140,270,76
NAMUTUMBA,2024,140,150,290,76
NAMUTUMBA,2025,150,180,330,76
NAPAK,2015,70,110,180,76
NAPAK,2016,70,100,170,76
NAPAK,2017,70,120,190,76
NAPAK,2018,70,120,190,76
NAPAK,2019,70,110,180,76
NAPAK,2020,70,100,170,76
NAPAK,2021,60,100,160,76
NAPAK,2022,70,90,160,76
NAPAK,2023,70,90,160,76
NAPAK,2024,70,90,160,76
NAPAK,2025,70,100,170,76
NEBBI,2015,140,160,300,76
NEBBI,2016,140,160,300,76
NEBBI,2017,150,170,320,76
NEBBI,2018,150,170,320,76
NEBBI,2019,160,180,340,76
NEBBI,2020,160,180,340,76
NEBBI,2021,170,190,360,76
NEBBI,2022,170,190,360,76
NEBBI,2023,180,190,370,76
NEBBI,2024,180,200,380,76
NEBBI,2025,190,200,390,76
NGORA,2015,110,140,250,76
NGORA,2016,100,150,250,76
NGORA,2017,110,170,280,76
NGORA,2018,110,170,280,76
NGORA,2019,120,160,280,76
NGORA,2020,110,160,270,76
NGORA,2021,100,140,240,76
NGORA,2022,100,130,230,76
NGORA,2023,100,120,220,76
NGORA,2024,110,140,250,76
NGORA,2025,110,150,260,76
NTOROKO,2015,20,30,50,76
NTOROKO,2016,20,30,50,76
NTOROKO,2017,20,30,50,76
NTOROKO,2018,20,30,50,76
NTOROKO,2019,20,30,50,76
NTOROKO,2020,20,30,50,76
NTOROKO,2021,20,30,50,76
NTOROKO,2022,20,20,40,76
NTOROKO,2023,20,20,40,76
NTOROKO,2024,20,20,40,76
NTOROKO,2025,20,30,50,76
NTUNGAMO,2015,210,240,450,76
NTUNGAMO,2016,220,250,470,76
NTUNGAMO,2017,220,250,470,76
NTUNGAMO,2018,230,250,480,76
NTUNGAMO,2019,230,260,490,76
NTUNGAMO,2020,230,260,490,76
NTUNGAMO,2021,240,270,510,76
NTUNGAMO,2022,240,270,510,76
NTUNGAMO,2023,250,280,530,76
NTUNGAMO,2024,250,280,530,76
NTUNGAMO,2025,260,280,540,76
NWOYA,2015,60,60,120,76
NWOYA,2016,70,70,140,76
NWOYA,2017,80,80,160,76
NWOYA,2018,80,90,170,76
NWOYA,2019,90,90,180,76
NWOYA,2020,100,100,200,76
NWOYA,2021,110,110,220,76
NWOYA,2022,120,130,250,76
NWOYA,2023,140,140,280,76
NWOYA,2024,150,150,300,76
NWOYA,2025,160,170,330,76
OBONGI,2015,10,20,30,76
OBONGI,2016,10,10,20,76
OBONGI,2017,10,20,30,76
OBONGI,2018,10,20,30,76
OBONGI,2019,10,20,30,76
OBONGI,2020,10,10,20,76
OBONGI,2021,10,10,20,76
OBONGI,2022,10,10,20,76
OBONGI,2023,10,10,20,76
OBONGI,2024,10,10,20,76
OBONGI,2025,10,10,20,76
OMORO,2015,80,150,230,76
OMORO,2016,80,160,240,76
OMORO,2017,90,180,270,76
OMORO,2018,100,200,300,76
OMORO,2019,90,190,280,76
OMORO,2020,90,170,260,76
OMORO,2021,90,160,250,76
OMORO,2022,90,150,240,76
OMORO,2023,80,160,240,76
OMORO,2024,90,160,250,76
OMORO,2025,100,180,280,76
OTUKE,2015,50,50,100,76
OTUKE,2016,60,50,110,76
OTUKE,2017,60,60,120,76
OTUKE,2018,60,60,120,76
OTUKE,2019,60,60,120,76
OTUKE,2020,70,60,130,76
OTUKE,2021,70,70,140,76
OTUKE,2022,70,70,140,76
OTUKE,2023,80,70,150,76
OTUKE,2024,80,70,150,76
OTUKE,2025,80,80,160,76
OYAM,2015,210,240,450,76
OYAM,2016,210,250,460,76
OYAM,2017,220,250,470,76
OYAM,2018,230,260,490,76
OYAM,2019,230,270,500,76
OYAM,2020,240,280,520,76
OYAM,2021,250,280,530,76
OYAM,2022,250,290,540,76
OYAM,2023,260,300,560,76
OYAM,2024,270,310,580,76
OYAM,2025,270,310,580,76
PADER,2015,70,140,210,76
PADER,2016,80,130,210,76
PADER,2017,90,150,240,76
PADER,2018,90,150,240,76
PADER,2019,80,160,240,76
PADER,2020,80,140,220,76
PADER,2021,70,130,200,76
PADER,2022,70,120,190,76
PADER,2023,70,110,180,76
PADER,2024,70,120,190,76
PADER,2025,80,130,210,76
PAKWACH,2015,80,80,160,76
PAKWACH,2016,80,80,160,76
PAKWACH,2017,80,80,160,76
PAKWACH,2018,90,80,170,76
PAKWACH,2019,90,90,180,76
PAKWACH,2020,90,90,180,76
PAKWACH,2021,100,90,190,76
PAKWACH,2022,100,100,200,76
PAKWACH,2023,100,100,200,76
PAKWACH,2024,110,100,210,76
PAKWACH,2025,110,110,220,76
PALLISA,2015,210,210,420,76
PALLISA,2016,210,220,430,76
PALLISA,2017,230,250,480,76
PALLISA,2018,240,270,510,76
PALLISA,2019,250,270,520,76
PALLISA,2020,240,240,480,76
PALLISA,2021,230,230,460,76
PALLISA,2022,230,220,450,76
PALLISA,2023,240,210,450,76
PALLISA,2024,250,230,480,76
PALLISA,2025,270,260,530,76
RAKAI,2015,130,180,310,76
RAKAI,2016,140,180,320,76
RAKAI,2017,150,210,360,76
RAKAI,2018,150,220,370,76
RAKAI,2019,150,210,360,76
RAKAI,2020,140,190,330,76
RAKAI,2021,130,180,310,76
RAKAI,2022,130,160,290,76
RAKAI,2023,130,160,290,76
RAKAI,2024,130,160,290,76
RAKAI,2025,150,190,340,76
RUBANDA,2015,60,80,140,76
RUBANDA,2016,60,80,140,76
RUBANDA,2017,60,80,140,76
RUBANDA,2018,70,80,150,76
RUBANDA,2019,70,80,150,76
RUBANDA,2020,70,80,150,76
RUBANDA,2021,70,80,150,76
RUBANDA,2022,70,80,150,76
RUBANDA,2023,70,80,150,76
RUBANDA,2024,70,80,150,76
RUBANDA,2025,70,80,150,76
RUBIRIZI,2015,70,50,120,76
RUBIRIZI,2016,70,50,120,76
RUBIRIZI,2017,70,50,120,76
RUBIRIZI,2018,70,60,130,76
RUBIRIZI,2019,70,60,130,76
RUBIRIZI,2020,80,60,140,76
RUBIRIZI,2021,80,60,140,76
RUBIRIZI,2022,80,60,140,76
RUBIRIZI,2023,80,60,140,76
RUBIRIZI,2024,80,60,140,76
RUBIRIZI,2025,80,60,140,76
RUKIGA,2015,70,60,130,76
RUKIGA,2016,70,60,130,76
RUKIGA,2017,70,60,130,76
RUKIGA,2018,70,60,130,76
RUKIGA,2019,70,70,140,76
RUKIGA,2020,70,70,140,76
RUKIGA,2021,70,70,140,76
RUKIGA,2022,70,70,140,76
RUKIGA,2023,70,70,140,76
RUKIGA,2024,70,70,140,76
RUKIGA,2025,70,70,140,76
RUKUNGIRI,2015,180,210,390,76
RUKUNGIRI,2016,180,210,390,76
RUKUNGIRI,2017,180,210,390,76
RUKUNGIRI,2018,180,210,390,76
RUKUNGIRI,2019,180,220,400,76
RUKUNGIRI,2020,190,220,410,76
RUKUNGIRI,2021,190,220,410,76
RUKUNGIRI,2022,190,220,410,76
RUKUNGIRI,2023,190,220,410,76
RUKUNGIRI,2024,190,220,410,76
RUKUNGIRI,2025,190,220,410,76
RWAMPARA,2015,60,50,110,76
RWAMPARA,2016,60,60,120,76
RWAMPARA,2017,70,60,130,76
RWAMPARA,2018,70,60,130,76
RWAMPARA,2019,70,60,130,76
RWAMPARA,2020,70,60,130,76
RWAMPARA,2021,70,60,130,76
RWAMPARA,2022,70,60,130,76
RWAMPARA,2023,70,60,130,76
RWAMPARA,2024,70,70,140,76
RWAMPARA,2025,80,70,150,76
SERERE,2015,170,200,370,76
SERERE,2016,160,210,370,76
SERERE,2017,180,230,410,76
SERERE,2018,200,250,450,76
SERERE,2019,190,260,450,76
SERERE,2020,190,230,420,76
SERERE,2021,180,220,400,76
SERERE,2022,170,200,370,76
SERERE,2023,180,200,380,76
SERERE,2024,190,220,410,76
SERERE,2025,200,240,440,76
SHEEMA,2015,140,130,270,76
SHEEMA,2016,140,140,280,76
SHEEMA,2017,140,140,280,76
SHEEMA,2018,140,140,280,76
SHEEMA,2019,150,140,290,76
SHEEMA,2020,150,140,290,76
SHEEMA,2021,150,140,290,76
SHEEMA,2022,150,140,290,76
SHEEMA,2023,150,140,290,76
SHEEMA,2024,150,150,300,76
SHEEMA,2025,150,150,300,76
SIRONKO,2015,210,240,450,76
SIRONKO,2016,220,240,460,76
SIRONKO,2017,220,250,470,76
SIRONKO,2018,230,250,480,76
SIRONKO,2019,230,260,490,76
SIRONKO,2020,240,260,500,76
SIRONKO,2021,240,270,510,76
SIRONKO,2022,250,270,520,76
SIRONKO,2023,250,280,530,76
SIRONKO,2024,260,280,540,76
SIRONKO,2025,260,290,550,76
SOROTI,2015,140,200,340,76
SOROTI,2016,150,210,360,76
SOROTI,2017,160,230,390,76
SOROTI,2018,160,250,410,76
SOROTI,2019,160,240,400,76
SOROTI,2020,150,230,380,76
SOROTI,2021,150,200,350,76
SOROTI,2022,140,200,340,76
SOROTI,2023,150,190,340,76
SOROTI,2024,160,210,370,76
SOROTI,2025,170,230,400,76
SSEMBABULE,2015,130,170,300,76
SSEMBABULE,2016,140,160,300,76
SSEMBABULE,2017,150,200,350,76
SSEMBABULE,2018,150,200,350,76
SSEMBABULE,2019,150,190,340,76
SSEMBABULE,2020,140,190,330,76
SSEMBABULE,2021,130,160,290,76
SSEMBABULE,2022,130,150,280,76
SSEMBABULE,2023,130,160,290,76
SSEMBABULE,2024,130,160,290,76
SSEMBABULE,2025,150,180,330,76
TORORO,2015,280,310,590,76
TORORO,2016,280,320,600,76
TORORO,2017,290,330,620,76
TORORO,2018,300,340,640,76
TORORO,2019,310,350,660,76
TORORO,2020,310,350,660,76
TORORO,2021,320,360,680,76
TORORO,2022,330,370,700,76
TORORO,2023,340,380,720,76
TORORO,2024,340,390,730,76
TORORO,2025,350,390,740,76
WAKISO,2015,370,520,890,76
WAKISO,2016,390,560,950,76
WAKISO,2017,420,600,1020,76
WAKISO,2018,450,640,1090,76
WAKISO,2019,480,680,1160,76
WAKISO,2020,510,730,1240,76
WAKISO,2021,540,780,1320,76
WAKISO,2022,570,830,1400,76
WAKISO,2023,610,880,1490,76
WAKISO,2024,650,940,1590,76
WAKISO,2025,690,1000,1690,76
YUMBE,2015,140,140,280,76
YUMBE,2016,150,130,280,76
YUMBE,2017,170,170,340,76
YUMBE,2018,170,170,340,76
YUMBE,2019,180,180,360,76
YUMBE,2020,170,170,340,76
YUMBE,2021,170,150,320,76
YUMBE,2022,170,150,320,76
YUMBE,2023,170,160,330,76
YUMBE,2024,180,170,350,76
YUMBE,2025,200,190,390,76
ZOMBO,2015,150,190,340,76
ZOMBO,2016,160,200,360,76
ZOMBO,2017,160,200,360,76
ZOMBO,2018,170,210,380,76
ZOMBO,2019,170,210,380,76
ZOMBO,2020,180,220,400,76
ZOMBO,2021,180,220,400,76
ZOMBO,2022,190,230,420,76
ZOMBO,2023,190,230,420,76
ZOMBO,2024,200,240,440,76
ZOMBO,2025,200,250,450,76
ABIM,2015,30,40,70,77
ABIM,2016,30,40,70,77
ABIM,2017,30,60,90,77
ABIM,2018,40,70,110,77
ABIM,2019,40,70,110,77
ABIM,2020,40,60,100,77
ABIM,2021,40,60,100,77
ABIM,2022,30,50,80,77
ABIM,2023,30,60,90,77
ABIM,2024,40,60,100,77
ABIM,2025,40,60,100,77
ADJUMANI,2015,40,40,80,77
ADJUMANI,2016,40,40,80,77
ADJUMANI,2017,40,40,80,77
ADJUMANI,2018,50,40,90,77
ADJUMANI,2019,50,40,90,77
ADJUMANI,2020,50,40,90,77
ADJUMANI,2021,50,40,90,77
ADJUMANI,2022,50,40,90,77
ADJUMANI,2023,50,40,90,77
ADJUMANI,2024,50,40,90,77
ADJUMANI,2025,50,40,90,77
AGAGO,2015,70,80,150,77
AGAGO,2016,70,80,150,77
AGAGO,2017,80,80,160,77
AGAGO,2018,80,80,160,77
AGAGO,2019,80,80,160,77
AGAGO,2020,80,80,160,77
AGAGO,2021,80,80,160,77
AGAGO,2022,80,90,170,77
AGAGO,2023,80,90,170,77
AGAGO,2024,80,90,170,77
AGAGO,2025,90,90,180,77
ALEBTONG,2015,100,130,230,77
ALEBTONG,2016,110,160,270,77
ALEBTONG,2017,100,160,260,77
ALEBTONG,2018,110,180,290,77
ALEBTONG,2019,120,180,300,77
ALEBTONG,2020,120,170,290,77
ALEBTONG,2021,110,170,280,77
ALEBTONG,2022,100,150,250,77
ALEBTONG,2023,110,140,250,77
ALEBTONG,2024,110,130,240,77
ALEBTONG,2025,110,140,250,77
AMOLATAR,2015,80,90,170,77
AMOLATAR,2016,80,100,180,77
AMOLATAR,2017,80,100,180,77
AMOLATAR,2018,80,110,190,77
AMOLATAR,2019,100,110,210,77
AMOLATAR,2020,90,130,220,77
AMOLATAR,2021,90,120,210,77
AMOLATAR,2022,80,100,180,77
AMOLATAR,2023,80,90,170,77
AMOLATAR,2024,80,90,170,77
AMOLATAR,2025,90,90,180,77
AMUDAT,2015,10,20,30,77
AMUDAT,2016,10,20,30,77
AMUDAT,2017,10,20,30,77
AMUDAT,2018,10,20,30,77
AMUDAT,2019,10,20,30,77
AMUDAT,2020,10,20,30,77
AMUDAT,2021,10,20,30,77
AMUDAT,2022,10,30,40,77
AMUDAT,2023,20,30,50,77
AMUDAT,2024,20,30,50,77
AMUDAT,2025,20,30,50,77
AMURIA,2015,60,110,170,77
AMURIA,2016,70,120,190,77
AMURIA,2017,80,120,200,77
AMURIA,2018,80,150,230,77
AMURIA,2019,80,160,240,77
AMURIA,2020,80,150,230,77
AMURIA,2021,70,130,200,77
AMURIA,2022,80,120,200,77
AMURIA,2023,80,120,200,77
AMURIA,2024,80,120,200,77
AMURIA,2025,80,120,200,77
AMURU,2015,60,50,110,77
AMURU,2016,70,60,130,77
AMURU,2017,70,60,130,77
AMURU,2018,70,70,140,77
AMURU,2019,70,70,140,77
AMURU,2020,70,60,130,77
AMURU,2021,70,60,130,77
AMURU,2022,70,50,120,77
AMURU,2023,70,50,120,77
AMURU,2024,60,40,100,77
AMURU,2025,70,50,120,77
APAC,2015,80,60,140,77
APAC,2016,80,60,140,77
APAC,2017,90,70,160,77
APAC,2018,90,70,160,77
APAC,2019,90,70,160,77
APAC,2020,90,70,160,77
APAC,2021,100,80,180,77
APAC,2022,100,80,180,77
APAC,2023,100,80,180,77
APAC,2024,110,80,190,77
APAC,2025,110,90,200,77
ARUA,2015,150,150,300,77
ARUA,2016,150,150,300,77
ARUA,2017,150,160,310,77
ARUA,2018,160,160,320,77
ARUA,2019,160,170,330,77
ARUA,2020,170,170,340,77
ARUA,2021,170,170,340,77
ARUA,2022,180,180,360,77
ARUA,2023,180,180,360,77
ARUA,2024,190,190,380,77
ARUA,2025,190,190,380,77
BUDAKA,2015,100,130,230,77
BUDAKA,2016,120,140,260,77
BUDAKA,2017,120,140,260,77
BUDAKA,2018,120,150,270,77
BUDAKA,2019,140,160,300,77
BUDAKA,2020,130,170,300,77
BUDAKA,2021,120,150,270,77
BUDAKA,2022,130,140,270,77
BUDAKA,2023,120,120,240,77
BUDAKA,2024,120,130,250,77
BUDAKA,2025,130,140,270,77
BUDUDA,2015,130,160,290,77
BUDUDA,2016,150,180,330,77
BUDUDA,2017,140,200,340,77
BUDUDA,2018,160,220,380,77
BUDUDA,2019,170,250,420,77
BUDUDA,2020,170,240,410,77
BUDUDA,2021,160,230,390,77
BUDUDA,2022,160,200,360,77
BUDUDA,2023,160,200,360,77
BUDUDA,2024,160,190,350,77
BUDUDA,2025,180,220,400,77
BUGIRI,2015,160,180,340,77
BUGIRI,2016,180,200,380,77
BUGIRI,2017,170,220,390,77
BUGIRI,2018,190,240,430,77
BUGIRI,2019,190,270,460,77
BUGIRI,2020,200,260,460,77
BUGIRI,2021,200,250,450,77
BUGIRI,2022,180,220,400,77
BUGIRI,2023,180,200,380,77
BUGIRI,2024,190,210,400,77
BUGIRI,2025,200,220,420,77
BUGWERI,2015,80,90,170,77
BUGWERI,2016,80,100,180,77
BUGWERI,2017,90,100,190,77
BUGWERI,2018,100,130,230,77
BUGWERI,2019,100,140,240,77
BUGWERI,2020,90,130,220,77
BUGWERI,2021,90,120,210,77
BUGWERI,2022,90,100,190,77
BUGWERI,2023,90,90,180,77
BUGWERI,2024,90,90,180,77
BUGWERI,2025,90,110,200,77
BUHWEJU,2015,40,30,70,77
BUHWEJU,2016,40,30,70,77
BUHWEJU,2017,50,30,80,77
BUHWEJU,2018,50,30,80,77
BUHWEJU,2019,50,40,90,77
BUHWEJU,2020,50,40,90,77
BUHWEJU,2021,50,40,90,77
BUHWEJU,2022,50,40,90,77
BUHWEJU,2023,60,40,100,77
BUHWEJU,2024,60,40,100,77
BUHWEJU,2025,60,40,100,77
BUIKWE,2015,130,160,290,77
BUIKWE,2016,140,180,320,77
BUIKWE,2017,130,180,310,77
BUIKWE,2018,150,220,370,77
BUIKWE,2019,150,230,380,77
BUIKWE,2020,150,210,360,77
BUIKWE,2021,140,190,330,77
BUIKWE,2022,140,170,310,77
BUIKWE,2023,130,150,280,77
BUIKWE,2024,130,160,290,77
BUIKWE,2025,130,170,300,77
BUKEDEA,2015,120,160,280,77
BUKEDEA,2016,120,200,320,77
BUKEDEA,2017,130,200,330,77
BUKEDEA,2018,140,220,360,77
BUKEDEA,2019,150,250,400,77
BUKEDEA,2020,150,240,390,77
BUKEDEA,2021,150,230,380,77
BUKEDEA,2022,140,200,340,77
BUKEDEA,2023,140,200,340,77
BUKEDEA,2024,140,190,330,77
BUKEDEA,2025,150,220,370,77
BUKOMANSIMBI,2015,100,130,230,77
BUKOMANSIMBI,2016,110,140,250,77
BUKOMANSIMBI,2017,100,140,240,77
BUKOMANSIMBI,2018,110,150,260,77
BUKOMANSIMBI,2019,110,160,270,77
BUKOMANSIMBI,2020,110,150,260,77
BUKOMANSIMBI,2021,100,130,230,77
BUKOMANSIMBI,2022,90,120,210,77
BUKOMANSIMBI,2023,90,110,200,77
BUKOMANSIMBI,2024,90,100,190,77
BUKOMANSIMBI,2025,90,110,200,77
BUKWO,2015,30,20,50,77
BUKWO,2016,30,20,50,77
BUKWO,2017,30,20,50,77
BUKWO,2018,30,30,60,77
BUKWO,2019,30,30,60,77
BUKWO,2020,40,30,70,77
BUKWO,2021,40,30,70,77
BUKWO,2022,40,30,70,77
BUKWO,2023,40,30,70,77
BUKWO,2024,40,30,70,77
BUKWO,2025,50,30,80,77
BULAMBULI,2015,140,160,300,77
BULAMBULI,2016,150,200,350,77
BULAMBULI,2017,160,200,360,77
BULAMBULI,2018,180,240,420,77
BULAMBULI,2019,180,250,430,77
BULAMBULI,2020,190,260,450,77
BULAMBULI,2021,170,230,400,77
BULAMBULI,2022,170,220,390,77
BULAMBULI,2023,170,200,370,77
BULAMBULI,2024,180,210,390,77
BULAMBULI,2025,190,220,410,77
BULIISA,2015,30,20,50,77
BULIISA,2016,30,20,50,77
BULIISA,2017,30,20,50,77
BULIISA,2018,40,20,60,77
BULIISA,2019,40,20,60,77
BULIISA,2020,40,20,60,77
BULIISA,2021,40,20,60,77
BULIISA,2022,40,20,60,77
BULIISA,2023,50,20,70,77
BULIISA,2024,50,30,80,77
BULIISA,2025,50,30,80,77
BUNDIBUGYO,2015,50,50,100,77
BUNDIBUGYO,2016,50,60,110,77
BUNDIBUGYO,2017,50,60,110,77
BUNDIBUGYO,2018,50,70,120,77
BUNDIBUGYO,2019,70,70,140,77
BUNDIBUGYO,2020,70,60,130,77
BUNDIBUGYO,2021,60,80,140,77
BUNDIBUGYO,2022,60,70,130,77
BUNDIBUGYO,2023,50,60,110,77
BUNDIBUGYO,2024,50,60,110,77
BUNDIBUGYO,2025,60,60,120,77
BUNYANGABU,2015,80,90,170,77
BUNYANGABU,2016,80,100,180,77
BUNYANGABU,2017,80,100,180,77
BUNYANGABU,2018,80,110,190,77
BUNYANGABU,2019,80,110,190,77
BUNYANGABU,2020,80,110,190,77
BUNYANGABU,2021,90,100,190,77
BUNYANGABU,2022,80,80,160,77
BUNYANGABU,2023,80,90,170,77
BUNYANGABU,2024,80,90,170,77
BUNYANGABU,2025,80,90,170,77
BUSHENYI,2015,130,100,230,77
BUSHENYI,2016,130,100,230,77
BUSHENYI,2017,130,100,230,77
BUSHENYI,2018,130,100,230,77
BUSHENYI,2019,130,110,240,77
BUSHENYI,2020,140,110,250,77
BUSHENYI,2021,140,110,250,77
BUSHENYI,2022,140,110,250,77
BUSHENYI,2023,140,110,250,77
BUSHENYI,2024,140,110,250,77
BUSHENYI,2025,140,110,250,77
BUSIA,2015,170,260,430,77
BUSIA,2016,180,280,460,77
BUSIA,2017,170,300,470,77
BUSIA,2018,190,330,520,77
BUSIA,2019,190,340,530,77
BUSIA,2020,200,340,540,77
BUSIA,2021,190,310,500,77
BUSIA,2022,180,290,470,77
BUSIA,2023,170,260,430,77
BUSIA,2024,170,270,440,77
BUSIA,2025,190,280,470,77
BUTALEJA,2015,140,150,290,77
BUTALEJA,2016,160,160,320,77
BUTALEJA,2017,160,160,320,77
BUTALEJA,2018,160,200,360,77
BUTALEJA,2019,180,200,380,77
BUTALEJA,2020,170,190,360,77
BUTALEJA,2021,170,170,340,77
BUTALEJA,2022,160,170,330,77
BUTALEJA,2023,160,150,310,77
BUTALEJA,2024,160,150,310,77
BUTALEJA,2025,180,170,350,77
BUTAMBALA,2015,40,40,80,77
BUTAMBALA,2016,40,40,80,77
BUTAMBALA,2017,40,40,80,77
BUTAMBALA,2018,40,40,80,77
BUTAMBALA,2019,40,70,110,77
BUTAMBALA,2020,40,60,100,77
BUTAMBALA,2021,40,60,100,77
BUTAMBALA,2022,30,50,80,77
BUTAMBALA,2023,30,50,80,77
BUTAMBALA,2024,30,40,70,77
BUTAMBALA,2025,30,50,80,77
BUTEBO,2015,60,90,150,77
BUTEBO,2016,70,100,170,77
BUTEBO,2017,70,100,170,77
BUTEBO,2018,70,130,200,77
BUTEBO,2019,70,140,210,77
BUTEBO,2020,70,130,200,77
BUTEBO,2021,60,120,180,77
BUTEBO,2022,60,100,160,77
BUTEBO,2023,70,90,160,77
BUTEBO,2024,60,90,150,77
BUTEBO,2025,70,90,160,77
BUVUMA,2015,10,10,20,77
BUVUMA,2016,10,10,20,77
BUVUMA,2017,10,10,20,77
BUVUMA,2018,10,10,20,77
BUVUMA,2019,10,10,20,77
BUVUMA,2020,10,10,20,77
BUVUMA,2021,10,10,20,77
BUVUMA,2022,10,10,20,77
BUVUMA,2023,10,10,20,77
BUVUMA,2024,10,10,20,77
BUVUMA,2025,10,10,20,77
BUYENDE,2015,100,130,230,77
BUYENDE,2016,120,140,260,77
BUYENDE,2017,120,140,260,77
BUYENDE,2018,120,180,300,77
BUYENDE,2019,140,180,320,77
BUYENDE,2020,130,170,300,77
BUYENDE,2021,140,170,310,77
BUYENDE,2022,130,150,280,77
BUYENDE,2023,130,140,270,77
BUYENDE,2024,130,150,280,77
BUYENDE,2025,140,150,290,77
DOKOLO,2015,90,80,170,77
DOKOLO,2016,90,90,180,77
DOKOLO,2017,90,90,180,77
DOKOLO,2018,90,90,180,77
DOKOLO,2019,100,90,190,77
DOKOLO,2020,100,100,200,77
DOKOLO,2021,100,100,200,77
DOKOLO,2022,110,100,210,77
DOKOLO,2023,110,100,210,77
DOKOLO,2024,110,110,220,77
DOKOLO,2025,110,110,220,77
GOMBA,2015,90,110,200,77
GOMBA,2016,90,120,210,77
GOMBA,2017,90,120,210,77
GOMBA,2018,100,130,230,77
GOMBA,2019,110,140,250,77
GOMBA,2020,110,130,240,77
GOMBA,2021,100,120,220,77
GOMBA,2022,90,100,190,77
GOMBA,2023,90,90,180,77
GOMBA,2024,90,90,180,77
GOMBA,2025,90,90,180,77
GULU,2015,60,80,140,77
GULU,2016,60,90,150,77
GULU,2017,70,90,160,77
GULU,2018,70,90,160,77
GULU,2019,70,100,170,77
GULU,2020,70,100,170,77
GULU,2021,70,100,170,77
GULU,2022,80,100,180,77
GULU,2023,80,110,190,77
GULU,2024,80,110,190,77
GULU,2025,80,110,190,77
HOIMA,2015,120,130,250,77
HOIMA,2016,120,130,250,77
HOIMA,2017,120,140,260,77
HOIMA,2018,130,140,270,77
HOIMA,2019,130,140,270,77
HOIMA,2020,140,150,290,77
HOIMA,2021,140,150,290,77
HOIMA,2022,150,160,310,77
HOIMA,2023,150,160,310,77
HOIMA,2024,160,170,330,77
HOIMA,2025,160,170,330,77
IBANDA,2015,100,90,190,77
IBANDA,2016,100,100,200,77
IBANDA,2017,100,100,200,77
IBANDA,2018,100,100,200,77
IBANDA,2019,100,100,200,77
IBANDA,2020,100,100,200,77
IBANDA,2021,110,100,210,77
IBANDA,2022,110,110,220,77
IBANDA,2023,110,110,220,77
IBANDA,2024,110,110,220,77
IBANDA,2025,110,110,220,77
IGANGA,2015,120,130,250,77
IGANGA,2016,120,140,260,77
IGANGA,2017,130,140,270,77
IGANGA,2018,140,180,320,77
IGANGA,2019,140,180,320,77
IGANGA,2020,130,170,300,77
IGANGA,2021,140,150,290,77
IGANGA,2022,130,140,270,77
IGANGA,2023,120,140,260,77
IGANGA,2024,130,130,260,77
IGANGA,2025,130,140,270,77
ISINGIRO,2015,190,120,310,77
ISINGIRO,2016,200,120,320,77
ISINGIRO,2017,210,120,330,77
ISINGIRO,2018,210,130,340,77
ISINGIRO,2019,220,130,350,77
ISINGIRO,2020,230,140,370,77
ISINGIRO,2021,240,140,380,77
ISINGIRO,2022,250,150,400,77
ISINGIRO,2023,260,150,410,77
ISINGIRO,2024,260,160,420,77
ISINGIRO,2025,270,160,430,77
JINJA,2015,100,90,190,77
JINJA,2016,110,90,200,77
JINJA,2017,110,90,200,77
JINJA,2018,110,90,200,77
JINJA,2019,110,90,200,77
JINJA,2020,110,100,210,77
JINJA,2021,110,100,210,77
JINJA,2022,120,100,220,77
JINJA,2023,120,100,220,77
JINJA,2024,120,100,220,77
JINJA,2025,120,100,220,77
KAABONG,2015,10,20,30,77
KAABONG,2016,10,20,30,77
KAABONG,2017,10,20,30,77
KAABONG,2018,10,20,30,77
KAABONG,2019,10,20,30,77
KAABONG,2020,10,20,30,77
KAABONG,2021,10,20,30,77
KAABONG,2022,20,20,40,77
KAABONG,2023,20,20,40,77
KAABONG,2024,20,20,40,77
KAABONG,2025,20,20,40,77
KABALE,2015,120,90,210,77
KABALE,2016,120,90,210,77
KABALE,2017,120,100,220,77
KABALE,2018,130,100,230,77
KABALE,2019,130,100,230,77
KABALE,2020,130,100,230,77
KABALE,2021,130,100,230,77
KABALE,2022,130,100,230,77
KABALE,2023,130,100,230,77
KABALE,2024,140,100,240,77
KABALE,2025,140,100,240,77
KABAROLE,2015,120,120,240,77
KABAROLE,2016,120,130,250,77
KABAROLE,2017,130,130,260,77
KABAROLE,2018,130,130,260,77
KABAROLE,2019,130,130,260,77
KABAROLE,2020,130,140,270,77
KABAROLE,2021,140,140,280,77
KABAROLE,2022,140,140,280,77
KABAROLE,2023,140,140,280,77
KABAROLE,2024,140,150,290,77
KABAROLE,2025,150,150,300,77
KABERAMAIDO,2015,60,50,110,77
KABERAMAIDO,2016,70,80,150,77
KABERAMAIDO,2017,70,80,150,77
KABERAMAIDO,2018,70,90,160,77
KABERAMAIDO,2019,80,90,170,77
KABERAMAIDO,2020,80,90,170,77
KABERAMAIDO,2021,70,80,150,77
KABERAMAIDO,2022,70,70,140,77
KABERAMAIDO,2023,70,80,150,77
KABERAMAIDO,2024,80,70,150,77
KABERAMAIDO,2025,80,80,160,77
KAGADI,2015,60,80,140,77
KAGADI,2016,70,80,150,77
KAGADI,2017,70,80,150,77
KAGADI,2018,70,90,160,77
KAGADI,2019,70,90,160,77
KAGADI,2020,80,90,170,77
KAGADI,2021,80,100,180,77
KAGADI,2022,80,100,180,77
KAGADI,2023,80,100,180,77
KAGADI,2024,90,110,200,77
KAGADI,2025,90,110,200,77
KAKUMIRO,2015,70,80,150,77
KAKUMIRO,2016,80,80,160,77
KAKUMIRO,2017,90,90,180,77
KAKUMIRO,2018,90,100,190,77
KAKUMIRO,2019,100,110,210,77
KAKUMIRO,2020,110,110,220,77
KAKUMIRO,2021,120,120,240,77
KAKUMIRO,2022,130,130,260,77
KAKUMIRO,2023,140,150,290,77
KAKUMIRO,2024,150,160,310,77
KAKUMIRO,2025,170,170,340,77
KALAKI,2015,50,60,110,77
KALAKI,2016,50,60,110,77
KALAKI,2017,60,60,120,77
KALAKI,2018,60,60,120,77
KALAKI,2019,60,70,130,77
KALAKI,2020,60,70,130,77
KALAKI,2021,70,70,140,77
KALAKI,2022,70,80,150,77
KALAKI,2023,70,80,150,77
KALAKI,2024,70,80,150,77
KALAKI,2025,80,80,160,77
KALANGALA,2015,10,10,20,77
KALANGALA,2016,10,10,20,77
KALANGALA,2017,10,10,20,77
KALANGALA,2018,10,10,20,77
KALANGALA,2019,10,10,20,77
KALANGALA,2020,10,10,20,77
KALANGALA,2021,10,10,20,77
KALANGALA,2022,10,10,20,77
KALANGALA,2023,10,10,20,77
KALANGALA,2024,20,10,30,77
KALANGALA,2025,20,10,30,77
KALIRO,2015,100,110,210,77
KALIRO,2016,110,140,250,77
KALIRO,2017,100,140,240,77
KALIRO,2018,120,150,270,77
KALIRO,2019,120,160,280,77
KALIRO,2020,120,170,290,77
KALIRO,2021,120,150,270,77
KALIRO,2022,120,140,260,77
KALIRO,2023,110,120,230,77
KALIRO,2024,120,130,250,77
KALIRO,2025,120,140,260,77
KALUNGU,2015,120,150,270,77
KALUNGU,2016,140,160,300,77
KALUNGU,2017,130,160,290,77
KALUNGU,2018,140,180,320,77
KALUNGU,2019,140,180,320,77
KALUNGU,2020,130,190,320,77
KALUNGU,2021,120,170,290,77
KALUNGU,2022,120,150,270,77
KALUNGU,2023,110,140,250,77
KALUNGU,2024,110,130,240,77
KALUNGU,2025,110,140,250,77
KAMPALA,2015,150,200,350,77
KAMPALA,2016,150,200,350,77
KAMPALA,2017,160,210,370,77
KAMPALA,2018,160,210,370,77
KAMPALA,2019,160,210,370,77
KAMPALA,2020,170,220,390,77
KAMPALA,2021,170,220,390,77
KAMPALA,2022,170,230,400,77
KAMPALA,2023,170,230,400,77
KAMPALA,2024,180,230,410,77
KAMPALA,2025,180,240,420,77
KAMULI,2015,250,220,470,77
KAMULI,2016,260,240,500,77
KAMULI,2017,260,260,520,77
KAMULI,2018,270,290,560,77
KAMULI,2019,290,290,580,77
KAMULI,2020,280,300,580,77
KAMULI,2021,270,270,540,77
KAMULI,2022,250,240,490,77
KAMULI,2023,250,220,470,77
KAMULI,2024,250,220,470,77
KAMULI,2025,260,230,490,77
KAMWENGE,2015,60,30,90,77
KAMWENGE,2016,70,40,110,77
KAMWENGE,2017,70,40,110,77
KAMWENGE,2018,70,40,110,77
KAMWENGE,2019,70,40,110,77
KAMWENGE,2020,80,40,120,77
KAMWENGE,2021,80,40,120,77
KAMWENGE,2022,80,40,120,77
KAMWENGE,2023,90,40,130,77
KAMWENGE,2024,90,50,140,77
KAMWENGE,2025,90,50,140,77
KANUNGU,2015,90,60,150,77
KANUNGU,2016,90,60,150,77
KANUNGU,2017,90,60,150,77
KANUNGU,2018,90,60,150,77
KANUNGU,2019,90,70,160,77
KANUNGU,2020,90,70,160,77
KANUNGU,2021,100,70,170,77
KANUNGU,2022,100,70,170,77
KANUNGU,2023,100,70,170,77
KANUNGU,2024,100,70,170,77
KANUNGU,2025,100,70,170,77
KAPCHORWA,2015,50,50,100,77
KAPCHORWA,2016,50,50,100,77
KAPCHORWA,2017,50,50,100,77
KAPCHORWA,2018,50,50,100,77
KAPCHORWA,2019,50,50,100,77
KAPCHORWA,2020,50,50,100,77
KAPCHORWA,2021,50,60,110,77
KAPCHORWA,2022,60,60,120,77
KAPCHORWA,2023,60,60,120,77
KAPCHORWA,2024,60,60,120,77
KAPCHORWA,2025,60,60,120,77
KAPELEBYONG,2015,40,40,80,77
KAPELEBYONG,2016,40,40,80,77
KAPELEBYONG,2017,40,40,80,77
KAPELEBYONG,2018,50,40,90,77
KAPELEBYONG,2019,60,70,130,77
KAPELEBYONG,2020,50,60,110,77
KAPELEBYONG,2021,50,60,110,77
KAPELEBYONG,2022,50,50,100,77
KAPELEBYONG,2023,40,50,90,77
KAPELEBYONG,2024,40,40,80,77
KAPELEBYONG,2025,40,50,90,77
KASESE,2015,190,160,350,77
KASESE,2016,200,180,380,77
KASESE,2017,210,180,390,77
KASESE,2018,220,200,420,77
KASESE,2019,220,200,420,77
KASESE,2020,230,190,420,77
KASESE,2021,210,190,400,77
KASESE,2022,210,170,380,77
KASESE,2023,200,150,350,77
KASESE,2024,190,150,340,77
KASESE,2025,210,150,360,77
KASSANDA,2015,70,70,140,77
KASSANDA,2016,70,70,140,77
KASSANDA,2017,80,70,150,77
KASSANDA,2018,80,70,150,77
KASSANDA,2019,80,80,160,77
KASSANDA,2020,80,80,160,77
KASSANDA,2021,90,80,170,77
KASSANDA,2022,90,80,170,77
KASSANDA,2023,90,80,170,77
KASSANDA,2024,90,80,170,77
KASSANDA,2025,90,90,180,77
KATAKWI,2015,100,160,260,77
KATAKWI,2016,110,180,290,77
KATAKWI,2017,100,180,280,77
KATAKWI,2018,120,220,340,77
KATAKWI,2019,120,230,350,77
KATAKWI,2020,120,210,330,77
KATAKWI,2021,120,190,310,77
KATAKWI,2022,120,190,310,77
KATAKWI,2023,110,170,280,77
KATAKWI,2024,110,160,270,77
KATAKWI,2025,120,170,290,77
KAYUNGA,2015,160,160,320,77
KAYUNGA,2016,160,180,340,77
KAYUNGA,2017,160,180,340,77
KAYUNGA,2018,180,200,380,77
KAYUNGA,2019,180,200,380,77
KAYUNGA,2020,170,210,380,77
KAYUNGA,2021,160,190,350,77
KAYUNGA,2022,160,170,330,77
KAYUNGA,2023,150,150,300,77
KAYUNGA,2024,150,150,300,77
KAYUNGA,2025,150,150,300,77
KAZO,2015,50,60,110,77
KAZO,2016,50,60,110,77
KAZO,2017,50,60,110,77
KAZO,2018,60,60,120,77
KAZO,2019,60,70,130,77
KAZO,2020,60,70,130,77
KAZO,2021,60,70,130,77
KAZO,2022,60,70,130,77
KAZO,2023,70,80,150,77
KAZO,2024,70,80,150,77
KAZO,2025,70,80,150,77
KIBAALE,2015,40,40,80,77
KIBAALE,2016,40,40,80,77
KIBAALE,2017,40,40,80,77
KIBAALE,2018,40,50,90,77
KIBAALE,2019,50,50,100,77
KIBAALE,2020,50,50,100,77
KIBAALE,2021,50,50,100,77
KIBAALE,2022,50,60,110,77
KIBAALE,2023,60,60,120,77
KIBAALE,2024,60,60,120,77
KIBAALE,2025,60,70,130,77
KIBOGA,2015,80,60,140,77
KIBOGA,2016,80,60,140,77
KIBOGA,2017,80,60,140,77
KIBOGA,2018,80,60,140,77
KIBOGA,2019,90,70,160,77
KIBOGA,2020,90,70,160,77
KIBOGA,2021,90,70,160,77
KIBOGA,2022,90,70,160,77
KIBOGA,2023,100,70,170,77
KIBOGA,2024,100,70,170,77
KIBOGA,2025,100,70,170,77
KIBUKU,2015,100,130,230,77
KIBUKU,2016,120,140,260,77
KIBUKU,2017,120,140,260,77
KIBUKU,2018,120,180,300,77
KIBUKU,2019,140,180,320,77
KIBUKU,2020,130,170,300,77
KIBUKU,2021,120,150,270,77
KIBUKU,2022,130,150,280,77
KIBUKU,2023,120,140,260,77
KIBUKU,2024,130,130,260,77
KIBUKU,2025,130,150,280,77
KIKUUBE,2015,60,80,140,77
KIKUUBE,2016,70,80,150,77
KIKUUBE,2017,70,90,160,77
KIKUUBE,2018,70,90,160,77
KIKUUBE,2019,80,90,170,77
KIKUUBE,2020,80,100,180,77
KIKUUBE,2021,90,100,190,77
KIKUUBE,2022,90,110,200,77
KIKUUBE,2023,90,110,200,77
KIKUUBE,2024,100,120,220,77
KIKUUBE,2025,100,120,220,77
KIRUHURA,2015,60,40,100,77
KIRUHURA,2016,60,50,110,77
KIRUHURA,2017,60,50,110,77
KIRUHURA,2018,60,50,110,77
KIRUHURA,2019,70,50,120,77
KIRUHURA,2020,70,50,120,77
KIRUHURA,2021,70,50,120,77
KIRUHURA,2022,70,60,130,77
KIRUHURA,2023,80,60,140,77
KIRUHURA,2024,80,60,140,77
KIRUHURA,2025,80,60,140,77
KIRYANDONGO,2015,120,90,210,77
KIRYANDONGO,2016,120,100,220,77
KIRYANDONGO,2017,130,120,250,77
KIRYANDONGO,2018,140,130,270,77
KIRYANDONGO,2019,140,140,280,77
KIRYANDONGO,2020,150,130,280,77
KIRYANDONGO,2021,140,120,260,77
KIRYANDONGO,2022,130,100,230,77
KIRYANDONGO,2023,130,110,240,77
KIRYANDONGO,2024,130,100,230,77
KIRYANDONGO,2025,130,110,240,77
KISORO,2015,90,110,200,77
KISORO,2016,90,120,210,77
KISORO,2017,90,120,210,77
KISORO,2018,100,130,230,77
KISORO,2019,100,140,240,77
KISORO,2020,90,130,220,77
KISORO,2021,100,120,220,77
KISORO,2022,90,120,210,77
KISORO,2023,90,110,200,77
KISORO,2024,90,100,190,77
KISORO,2025,90,110,200,77
KITAGWENDA,2015,50,50,100,77
KITAGWENDA,2016,50,60,110,77
KITAGWENDA,2017,50,60,110,77
KITAGWENDA,2018,50,60,110,77
KITAGWENDA,2019,60,60,120,77
KITAGWENDA,2020,60,60,120,77
KITAGWENDA,2021,60,70,130,77
KITAGWENDA,2022,60,70,130,77
KITAGWENDA,2023,70,70,140,77
KITAGWENDA,2024,70,70,140,77
KITAGWENDA,2025,70,70,140,77
KITGUM,2015,80,130,210,77
KITGUM,2016,80,140,220,77
KITGUM,2017,80,140,220,77
KITGUM,2018,80,150,230,77
KITGUM,2019,80,160,240,77
KITGUM,2020,80,150,230,77
KITGUM,2021,70,130,200,77
KITGUM,2022,70,120,190,77
KITGUM,2023,80,110,190,77
KITGUM,2024,80,120,200,77
KITGUM,2025,80,120,200,77
KOBOKO,2015,50,50,100,77
KOBOKO,2016,50,60,110,77
KOBOKO,2017,50,60,110,77
KOBOKO,2018,50,70,120,77
KOBOKO,2019,70,70,140,77
KOBOKO,2020,70,90,160,77
KOBOKO,2021,60,80,140,77
KOBOKO,2022,60,70,130,77
KOBOKO,2023,50,60,110,77
KOBOKO,2024,60,60,120,77
KOBOKO,2025,70,60,130,77
KOLE,2015,110,100,210,77
KOLE,2016,110,110,220,77
KOLE,2017,110,110,220,77
KOLE,2018,120,110,230,77
KOLE,2019,120,120,240,77
KOLE,2020,130,120,250,77
KOLE,2021,130,120,250,77
KOLE,2022,130,130,260,77
KOLE,2023,140,130,270,77
KOLE,2024,140,130,270,77
KOLE,2025,150,130,280,77
KOTIDO,2015,30,50,80,77
KOTIDO,2016,30,60,90,77
KOTIDO,2017,30,60,90,77
KOTIDO,2018,40,70,110,77
KOTIDO,2019,40,70,110,77
KOTIDO,2020,40,60,100,77
KOTIDO,2021,40,80,120,77
KOTIDO,2022,30,70,100,77
KOTIDO,2023,30,60,90,77
KOTIDO,2024,30,60,90,77
KOTIDO,2025,30,60,90,77
KUMI,2015,140,160,300,77
KUMI,2016,160,200,360,77
KUMI,2017,160,200,360,77
KUMI,2018,160,220,380,77
KUMI,2019,180,230,410,77
KUMI,2020,170,240,410,77
KUMI,2021,170,210,380,77
KUMI,2022,160,190,350,77
KUMI,2023,150,180,330,77
KUMI,2024,160,180,340,77
KUMI,2025,170,190,360,77
KWANIA,2015,80,100,180,77
KWANIA,2016,80,100,180,77
KWANIA,2017,80,100,180,77
KWANIA,2018,90,110,200,77
KWANIA,2019,90,110,200,77
KWANIA,2020,90,110,200,77
KWANIA,2021,100,120,220,77
KWANIA,2022,100,120,220,77
KWANIA,2023,100,120,220,77
KWANIA,2024,100,120,220,77
KWANIA,2025,110,130,240,77
KWEEN,2015,20,20,40,77
KWEEN,2016,20,20,40,77
KWEEN,2017,20,20,40,77
KWEEN,2018,20,20,40,77
KWEEN,2019,20,20,40,77
KWEEN,2020,20,20,40,77
KWEEN,2021,20,20,40,77
KWEEN,2022,20,30,50,77
KWEEN,2023,20,30,50,77
KWEEN,2024,30,30,60,77
KWEEN,2025,30,30,60,77
KYANKWANZI,2015,60,50,110,77
KYANKWANZI,2016,60,60,120,77
KYANKWANZI,2017,70,60,130,77
KYANKWANZI,2018,70,60,130,77
KYANKWANZI,2019,70,60,130,77
KYANKWANZI,2020,80,70,150,77
KYANKWANZI,2021,80,70,150,77
KYANKWANZI,2022,90,70,160,77
KYANKWANZI,2023,90,80,170,77
KYANKWANZI,2024,90,80,170,77
KYANKWANZI,2025,100,80,180,77
KYEGEGWA,2015,80,60,140,77
KYEGEGWA,2016,90,70,160,77
KYEGEGWA,2017,90,70,160,77
KYEGEGWA,2018,100,80,180,77
KYEGEGWA,2019,110,80,190,77
KYEGEGWA,2020,120,90,210,77
KYEGEGWA,2021,130,100,230,77
KYEGEGWA,2022,140,110,250,77
KYEGEGWA,2023,150,110,260,77
KYEGEGWA,2024,160,120,280,77
KYEGEGWA,2025,170,130,300,77
KYENJOJO,2015,170,170,340,77
KYENJOJO,2016,180,180,360,77
KYENJOJO,2017,190,180,370,77
KYENJOJO,2018,200,190,390,77
KYENJOJO,2019,200,200,400,77
KYENJOJO,2020,210,200,410,77
KYENJOJO,2021,220,210,430,77
KYENJOJO,2022,230,220,450,77
KYENJOJO,2023,240,230,470,77
KYENJOJO,2024,250,230,480,77
KYENJOJO,2025,250,240,490,77
KYOTERA,2015,140,200,340,77
KYOTERA,2016,150,240,390,77
KYOTERA,2017,140,240,380,77
KYOTERA,2018,150,260,410,77
KYOTERA,2019,150,270,420,77
KYOTERA,2020,160,260,420,77
KYOTERA,2021,150,230,380,77
KYOTERA,2022,140,200,340,77
KYOTERA,2023,130,200,330,77
KYOTERA,2024,130,190,320,77
KYOTERA,2025,130,200,330,77
KARENGA,2015,10,10,20,77
KARENGA,2016,10,10,20,77
KARENGA,2017,10,10,20,77
KARENGA,2018,10,10,20,77
KARENGA,2019,10,10,20,77
KARENGA,2020,10,10,20,77
KARENGA,2021,10,10,20,77
KARENGA,2022,10,10,20,77
KARENGA,2023,10,10,20,77
KARENGA,2024,10,10,20,77
KARENGA,2025,10,10,20,77
LAMWO,2015,60,90,150,77
LAMWO,2016,70,100,170,77
LAMWO,2017,70,100,170,77
LAMWO,2018,70,110,180,77
LAMWO,2019,70,140,210,77
LAMWO,2020,70,130,200,77
LAMWO,2021,60,120,180,77
LAMWO,2022,60,100,160,77
LAMWO,2023,50,90,140,77
LAMWO,2024,50,90,140,77
LAMWO,2025,60,90,150,77
LIRA,2015,130,110,240,77
LIRA,2016,140,110,250,77
LIRA,2017,140,110,250,77
LIRA,2018,140,120,260,77
LIRA,2019,150,120,270,77
LIRA,2020,150,120,270,77
LIRA,2021,160,130,290,77
LIRA,2022,160,130,290,77
LIRA,2023,160,130,290,77
LIRA,2024,170,140,310,77
LIRA,2025,170,140,310,77
LUUKA,2015,90,130,220,77
LUUKA,2016,90,140,230,77
LUUKA,2017,100,140,240,77
LUUKA,2018,110,150,260,77
LUUKA,2019,110,160,270,77
LUUKA,2020,110,150,260,77
LUUKA,2021,100,150,250,77
LUUKA,2022,90,140,230,77
LUUKA,2023,100,120,220,77
LUUKA,2024,100,120,220,77
LUUKA,2025,100,120,220,77
LUWERO,2015,180,240,420,77
LUWERO,2016,190,280,470,77
LUWERO,2017,200,280,480,77
LUWERO,2018,210,310,520,77
LUWERO,2019,210,340,550,77
LUWERO,2020,210,320,530,77
LUWERO,2021,200,290,490,77
LUWERO,2022,200,270,470,77
LUWERO,2023,180,250,430,77
LUWERO,2024,180,240,420,77
LUWERO,2025,200,250,450,77
LWENGO,2015,130,180,310,77
LWENGO,2016,140,200,340,77
LWENGO,2017,140,200,340,77
LWENGO,2018,150,220,370,77
LWENGO,2019,150,230,380,77
LWENGO,2020,150,210,360,77
LWENGO,2021,140,190,330,77
LWENGO,2022,130,170,300,77
LWENGO,2023,120,150,270,77
LWENGO,2024,120,160,280,77
LWENGO,2025,120,170,290,77
LYANTONDE,2015,30,40,70,77
LYANTONDE,2016,30,60,90,77
LYANTONDE,2017,30,60,90,77
LYANTONDE,2018,30,70,100,77
LYANTONDE,2019,40,70,110,77
LYANTONDE,2020,40,60,100,77
LYANTONDE,2021,40,60,100,77
LYANTONDE,2022,30,50,80,77
LYANTONDE,2023,30,50,80,77
LYANTONDE,2024,30,40,70,77
LYANTONDE,2025,30,50,80,77
MANAFWA,2015,80,100,180,77
MANAFWA,2016,90,100,190,77
MANAFWA,2017,90,100,190,77
MANAFWA,2018,90,100,190,77
MANAFWA,2019,90,110,200,77
MANAFWA,2020,100,110,210,77
MANAFWA,2021,100,110,210,77
MANAFWA,2022,100,110,210,77
MANAFWA,2023,100,110,210,77
MANAFWA,2024,100,120,220,77
MANAFWA,2025,110,120,230,77
MARACHA,2015,60,50,110,77
MARACHA,2016,60,50,110,77
MARACHA,2017,60,50,110,77
MARACHA,2018,60,50,110,77
MARACHA,2019,70,60,130,77
MARACHA,2020,70,60,130,77
MARACHA,2021,70,60,130,77
MARACHA,2022,70,60,130,77
MARACHA,2023,70,60,130,77
MARACHA,2024,70,60,130,77
MARACHA,2025,70,60,130,77
MASAKA,2015,170,220,390,77
MASAKA,2016,180,240,420,77
MASAKA,2017,170,240,410,77
MASAKA,2018,190,290,480,77
MASAKA,2019,190,290,480,77
MASAKA,2020,190,280,470,77
MASAKA,2021,170,250,420,77
MASAKA,2022,170,240,410,77
MASAKA,2023,160,220,380,77
MASAKA,2024,160,210,370,77
MASAKA,2025,180,220,400,77
MASINDI,2015,90,100,190,77
MASINDI,2016,100,100,200,77
MASINDI,2017,100,100,200,77
MASINDI,2018,100,110,210,77
MASINDI,2019,110,110,220,77
MASINDI,2020,110,110,220,77
MASINDI,2021,110,110,220,77
MASINDI,2022,110,120,230,77
MASINDI,2023,120,120,240,77
MASINDI,2024,120,120,240,77
MASINDI,2025,120,130,250,77
MAYUGE,2015,170,160,330,77
MAYUGE,2016,180,200,380,77
MAYUGE,2017,180,200,380,77
MAYUGE,2018,190,220,410,77
MAYUGE,2019,210,250,460,77
MAYUGE,2020,200,240,440,77
MAYUGE,2021,200,210,410,77
MAYUGE,2022,180,200,380,77
MAYUGE,2023,180,180,360,77
MAYUGE,2024,180,180,360,77
MAYUGE,2025,200,190,390,77
MBALE,2015,270,380,650,77
MBALE,2016,280,450,730,77
MBALE,2017,290,440,730,77
MBALE,2018,300,510,810,77
MBALE,2019,320,540,860,77
MBALE,2020,320,530,850,77
MBALE,2021,310,480,790,77
MBALE,2022,290,440,730,77
MBALE,2023,280,420,700,77
MBALE,2024,290,410,700,77
MBALE,2025,300,430,730,77
MBARARA,2015,110,100,210,77
MBARARA,2016,110,110,220,77
MBARARA,2017,110,110,220,77
MBARARA,2018,120,110,230,77
MBARARA,2019,120,110,230,77
MBARARA,2020,120,120,240,77
MBARARA,2021,120,120,240,77
MBARARA,2022,130,120,250,77
MBARARA,2023,130,120,250,77
MBARARA,2024,130,120,250,77
MBARARA,2025,130,130,260,77
MITOOMA,2015,100,70,170,77
MITOOMA,2016,100,70,170,77
MITOOMA,2017,100,70,170,77
MITOOMA,2018,100,70,170,77
MITOOMA,2019,100,70,170,77
MITOOMA,2020,100,70,170,77
MITOOMA,2021,100,70,170,77
MITOOMA,2022,110,70,180,77
MITOOMA,2023,110,70,180,77
MITOOMA,2024,110,70,180,77
MITOOMA,2025,110,70,180,77
MITYANA,2015,210,220,430,77
MITYANA,2016,220,240,460,77
MITYANA,2017,210,260,470,77
MITYANA,2018,230,290,520,77
MITYANA,2019,240,290,530,77
MITYANA,2020,230,280,510,77
MITYANA,2021,220,250,470,77
MITYANA,2022,210,240,450,77
MITYANA,2023,200,220,420,77
MITYANA,2024,200,210,410,77
MITYANA,2025,210,220,430,77
MOROTO,2015,30,40,70,77
MOROTO,2016,30,40,70,77
MOROTO,2017,30,40,70,77
MOROTO,2018,30,40,70,77
MOROTO,2019,30,50,80,77
MOROTO,2020,30,40,70,77
MOROTO,2021,20,40,60,77
MOROTO,2022,20,30,50,77
MOROTO,2023,20,30,50,77
MOROTO,2024,20,30,50,77
MOROTO,2025,20,30,50,77
MOYO,2015,40,40,80,77
MOYO,2016,40,40,80,77
MOYO,2017,40,40,80,77
MOYO,2018,40,40,80,77
MOYO,2019,40,40,80,77
MOYO,2020,40,40,80,77
MOYO,2021,40,40,80,77
MOYO,2022,50,40,90,77
MOYO,2023,50,40,90,77
MOYO,2024,50,40,90,77
MOYO,2025,50,40,90,77
MPIGI,2015,130,180,310,77
MPIGI,2016,140,200,340,77
MPIGI,2017,130,220,350,77
MPIGI,2018,140,240,380,77
MPIGI,2019,150,250,400,77
MPIGI,2020,150,240,390,77
MPIGI,2021,140,210,350,77
MPIGI,2022,130,200,330,77
MPIGI,2023,130,180,310,77
MPIGI,2024,130,180,310,77
MPIGI,2025,130,190,320,77
MUBENDE,2015,140,160,300,77
MUBENDE,2016,160,180,340,77
MUBENDE,2017,160,200,360,77
MUBENDE,2018,180,220,400,77
MUBENDE,2019,190,250,440,77
MUBENDE,2020,190,240,430,77
MUBENDE,2021,190,230,420,77
MUBENDE,2022,180,200,380,77
MUBENDE,2023,180,200,380,77
MUBENDE,2024,190,210,400,77
MUBENDE,2025,200,220,420,77
MUKONO,2015,170,240,410,77
MUKONO,2016,190,280,470,77
MUKONO,2017,180,280,460,77
MUKONO,2018,190,310,500,77
MUKONO,2019,210,340,550,77
MUKONO,2020,200,320,520,77
MUKONO,2021,200,310,510,77
MUKONO,2022,180,270,450,77
MUKONO,2023,170,260,430,77
MUKONO,2024,180,250,430,77
MUKONO,2025,190,260,450,77
MADI OKOLLO,2015,40,30,70,77
MADI OKOLLO,2016,40,30,70,77
MADI OKOLLO,2017,40,30,70,77
MADI OKOLLO,2018,50,30,80,77
MADI OKOLLO,2019,50,30,80,77
MADI OKOLLO,2020,50,30,80,77
MADI OKOLLO,2021,50,30,80,77
MADI OKOLLO,2022,50,40,90,77
MADI OKOLLO,2023,50,40,90,77
MADI OKOLLO,2024,50,40,90,77
MADI OKOLLO,2025,50,40,90,77
NABILATUK,2015,10,20,30,77
NABILATUK,2016,10,20,30,77
NABILATUK,2017,10,20,30,77
NABILATUK,2018,10,20,30,77
NABILATUK,2019,10,20,30,77
NABILATUK,2020,10,40,50,77
NABILATUK,2021,10,40,50,77
NABILATUK,2022,10,30,40,77
NABILATUK,2023,10,30,40,77
NABILATUK,2024,10,30,40,77
NABILATUK,2025,10,30,40,77
NAKAPIRIPIRIT,2015,30,20,50,77
NAKAPIRIPIRIT,2016,30,20,50,77
NAKAPIRIPIRIT,2017,30,20,50,77
NAKAPIRIPIRIT,2018,30,20,50,77
NAKAPIRIPIRIT,2019,30,20,50,77
NAKAPIRIPIRIT,2020,30,20,50,77
NAKAPIRIPIRIT,2021,20,20,40,77
NAKAPIRIPIRIT,2022,30,30,60,77
NAKAPIRIPIRIT,2023,30,30,60,77
NAKAPIRIPIRIT,2024,30,30,60,77
NAKAPIRIPIRIT,2025,30,30,60,77
NAKASEKE,2015,70,60,130,77
NAKASEKE,2016,70,60,130,77
NAKASEKE,2017,70,60,130,77
NAKASEKE,2018,80,60,140,77
NAKASEKE,2019,80,70,150,77
NAKASEKE,2020,80,70,150,77
NAKASEKE,2021,90,70,160,77
NAKASEKE,2022,90,70,160,77
NAKASEKE,2023,90,70,160,77
NAKASEKE,2024,90,70,160,77
NAKASEKE,2025,100,70,170,77
NAKASONGOLA,2015,80,70,150,77
NAKASONGOLA,2016,80,80,160,77
NAKASONGOLA,2017,90,80,170,77
NAKASONGOLA,2018,100,110,210,77
NAKASONGOLA,2019,100,110,210,77
NAKASONGOLA,2020,90,110,200,77
NAKASONGOLA,2021,100,100,200,77
NAKASONGOLA,2022,90,80,170,77
NAKASONGOLA,2023,90,80,170,77
NAKASONGOLA,2024,90,70,160,77
NAKASONGOLA,2025,90,80,170,77
NAMAYINGO,2015,90,70,160,77
NAMAYINGO,2016,90,80,170,77
NAMAYINGO,2017,90,80,170,77
NAMAYINGO,2018,110,110,220,77
NAMAYINGO,2019,110,110,220,77
NAMAYINGO,2020,110,110,220,77
NAMAYINGO,2021,100,100,200,77
NAMAYINGO,2022,90,80,170,77
NAMAYINGO,2023,90,80,170,77
NAMAYINGO,2024,90,70,160,77
NAMAYINGO,2025,90,80,170,77
NAMISINDWA,2015,100,90,190,77
NAMISINDWA,2016,100,100,200,77
NAMISINDWA,2017,110,100,210,77
NAMISINDWA,2018,110,100,210,77
NAMISINDWA,2019,110,100,210,77
NAMISINDWA,2020,110,110,220,77
NAMISINDWA,2021,120,110,230,77
NAMISINDWA,2022,120,110,230,77
NAMISINDWA,2023,120,110,230,77
NAMISINDWA,2024,130,120,250,77
NAMISINDWA,2025,130,120,250,77
NAMUTUMBA,2015,130,150,280,77
NAMUTUMBA,2016,140,160,300,77
NAMUTUMBA,2017,140,180,320,77
NAMUTUMBA,2018,150,200,350,77
NAMUTUMBA,2019,150,200,350,77
NAMUTUMBA,2020,160,190,350,77
NAMUTUMBA,2021,150,190,340,77
NAMUTUMBA,2022,150,170,320,77
NAMUTUMBA,2023,140,150,290,77
NAMUTUMBA,2024,140,160,300,77
NAMUTUMBA,2025,150,170,320,77
NAPAK,2015,40,50,90,77
NAPAK,2016,40,80,120,77
NAPAK,2017,40,80,120,77
NAPAK,2018,40,90,130,77
NAPAK,2019,40,90,130,77
NAPAK,2020,40,90,130,77
NAPAK,2021,40,80,120,77
NAPAK,2022,30,70,100,77
NAPAK,2023,30,60,90,77
NAPAK,2024,30,60,90,77
NAPAK,2025,30,60,90,77
NEBBI,2015,110,110,220,77
NEBBI,2016,110,110,220,77
NEBBI,2017,120,110,230,77
NEBBI,2018,120,120,240,77
NEBBI,2019,120,120,240,77
NEBBI,2020,130,120,250,77
NEBBI,2021,130,130,260,77
NEBBI,2022,130,130,260,77
NEBBI,2023,140,130,270,77
NEBBI,2024,140,130,270,77
NEBBI,2025,150,140,290,77
NGORA,2015,80,70,150,77
NGORA,2016,80,80,160,77
NGORA,2017,90,80,170,77
NGORA,2018,100,90,190,77
NGORA,2019,100,110,210,77
NGORA,2020,90,110,200,77
NGORA,2021,90,100,190,77
NGORA,2022,80,80,160,77
NGORA,2023,90,80,170,77
NGORA,2024,90,70,160,77
NGORA,2025,90,80,170,77
NTOROKO,2015,10,20,30,77
NTOROKO,2016,10,20,30,77
NTOROKO,2017,10,20,30,77
NTOROKO,2018,10,20,30,77
NTOROKO,2019,10,20,30,77
NTOROKO,2020,10,20,30,77
NTOROKO,2021,10,20,30,77
NTOROKO,2022,10,20,30,77
NTOROKO,2023,10,20,30,77
NTOROKO,2024,10,10,20,77
NTOROKO,2025,10,20,30,77
NTUNGAMO,2015,190,160,350,77
NTUNGAMO,2016,200,160,360,77
NTUNGAMO,2017,200,170,370,77
NTUNGAMO,2018,210,170,380,77
NTUNGAMO,2019,210,170,380,77
NTUNGAMO,2020,220,170,390,77
NTUNGAMO,2021,220,180,400,77
NTUNGAMO,2022,220,180,400,77
NTUNGAMO,2023,230,180,410,77
NTUNGAMO,2024,230,190,420,77
NTUNGAMO,2025,240,190,430,77
NWOYA,2015,50,30,80,77
NWOYA,2016,60,40,100,77
NWOYA,2017,60,40,100,77
NWOYA,2018,70,40,110,77
NWOYA,2019,70,50,120,77
NWOYA,2020,80,50,130,77
NWOYA,2021,90,60,150,77
NWOYA,2022,100,70,170,77
NWOYA,2023,110,70,180,77
NWOYA,2024,120,80,200,77
NWOYA,2025,130,90,220,77
OBONGI,2015,10,20,30,77
OBONGI,2016,10,20,30,77
OBONGI,2017,10,20,30,77
OBONGI,2018,10,20,30,77
OBONGI,2019,10,20,30,77
OBONGI,2020,10,20,30,77
OBONGI,2021,10,20,30,77
OBONGI,2022,10,20,30,77
OBONGI,2023,10,20,30,77
OBONGI,2024,10,10,20,77
OBONGI,2025,10,20,30,77
OMORO,2015,60,90,150,77
OMORO,2016,70,120,190,77
OMORO,2017,80,120,200,77
OMORO,2018,80,130,210,77
OMORO,2019,80,140,220,77
OMORO,2020,80,130,210,77
OMORO,2021,70,130,200,77
OMORO,2022,80,120,200,77
OMORO,2023,80,110,190,77
OMORO,2024,80,100,180,77
OMORO,2025,80,110,190,77
OTUKE,2015,30,40,70,77
OTUKE,2016,30,40,70,77
OTUKE,2017,30,40,70,77
OTUKE,2018,40,50,90,77
OTUKE,2019,40,50,90,77
OTUKE,2020,40,50,90,77
OTUKE,2021,40,50,90,77
OTUKE,2022,40,60,100,77
OTUKE,2023,40,60,100,77
OTUKE,2024,50,60,110,77
OTUKE,2025,50,60,110,77
OYAM,2015,140,140,280,77
OYAM,2016,150,150,300,77
OYAM,2017,150,150,300,77
OYAM,2018,160,160,320,77
OYAM,2019,160,160,320,77
OYAM,2020,170,170,340,77
OYAM,2021,170,170,340,77
OYAM,2022,170,180,350,77
OYAM,2023,180,180,360,77
OYAM,2024,180,180,360,77
OYAM,2025,190,190,380,77
PADER,2015,80,70,150,77
PADER,2016,80,80,160,77
PADER,2017,90,80,170,77
PADER,2018,100,90,190,77
PADER,2019,100,90,190,77
PADER,2020,90,90,180,77
PADER,2021,90,80,170,77
PADER,2022,80,70,150,77
PADER,2023,80,80,160,77
PADER,2024,80,70,150,77
PADER,2025,80,80,160,77
PAKWACH,2015,40,50,90,77
PAKWACH,2016,40,60,100,77
PAKWACH,2017,50,60,110,77
PAKWACH,2018,50,60,110,77
PAKWACH,2019,50,60,110,77
PAKWACH,2020,50,70,120,77
PAKWACH,2021,50,70,120,77
PAKWACH,2022,60,70,130,77
PAKWACH,2023,60,70,130,77
PAKWACH,2024,60,70,130,77
PAKWACH,2025,60,80,140,77
PALLISA,2015,170,180,350,77
PALLISA,2016,190,220,410,77
PALLISA,2017,200,220,420,77
PALLISA,2018,210,260,470,77
PALLISA,2019,220,270,490,77
PALLISA,2020,230,280,510,77
PALLISA,2021,210,250,460,77
PALLISA,2022,210,240,450,77
PALLISA,2023,210,230,440,77
PALLISA,2024,220,220,440,77
PALLISA,2025,220,250,470,77
RAKAI,2015,120,110,230,77
RAKAI,2016,120,120,240,77
RAKAI,2017,120,120,240,77
RAKAI,2018,140,130,270,77
RAKAI,2019,140,140,280,77
RAKAI,2020,130,150,280,77
RAKAI,2021,120,130,250,77
RAKAI,2022,130,120,250,77
RAKAI,2023,120,110,230,77
RAKAI,2024,120,100,220,77
RAKAI,2025,120,110,230,77
RUBANDA,2015,60,70,130,77
RUBANDA,2016,60,70,130,77
RUBANDA,2017,60,70,130,77
RUBANDA,2018,60,70,130,77
RUBANDA,2019,60,70,130,77
RUBANDA,2020,60,70,130,77
RUBANDA,2021,60,70,130,77
RUBANDA,2022,60,70,130,77
RUBANDA,2023,60,70,130,77
RUBANDA,2024,60,70,130,77
RUBANDA,2025,60,70,130,77
RUBIRIZI,2015,40,40,80,77
RUBIRIZI,2016,40,40,80,77
RUBIRIZI,2017,40,40,80,77
RUBIRIZI,2018,40,50,90,77
RUBIRIZI,2019,50,50,100,77
RUBIRIZI,2020,50,50,100,77
RUBIRIZI,2021,50,50,100,77
RUBIRIZI,2022,50,50,100,77
RUBIRIZI,2023,50,50,100,77
RUBIRIZI,2024,50,50,100,77
RUBIRIZI,2025,50,50,100,77
RUKIGA,2015,40,40,80,77
RUKIGA,2016,40,40,80,77
RUKIGA,2017,40,40,80,77
RUKIGA,2018,40,40,80,77
RUKIGA,2019,40,40,80,77
RUKIGA,2020,40,40,80,77
RUKIGA,2021,40,40,80,77
RUKIGA,2022,40,40,80,77
RUKIGA,2023,40,40,80,77
RUKIGA,2024,40,40,80,77
RUKIGA,2025,40,40,80,77
RUKUNGIRI,2015,140,140,280,77
RUKUNGIRI,2016,140,140,280,77
RUKUNGIRI,2017,140,140,280,77
RUKUNGIRI,2018,140,140,280,77
RUKUNGIRI,2019,150,150,300,77
RUKUNGIRI,2020,150,150,300,77
RUKUNGIRI,2021,150,150,300,77
RUKUNGIRI,2022,150,150,300,77
RUKUNGIRI,2023,150,150,300,77
RUKUNGIRI,2024,150,150,300,77
RUKUNGIRI,2025,150,150,300,77
RWAMPARA,2015,60,40,100,77
RWAMPARA,2016,60,40,100,77
RWAMPARA,2017,60,40,100,77
RWAMPARA,2018,60,50,110,77
RWAMPARA,2019,60,50,110,77
RWAMPARA,2020,60,50,110,77
RWAMPARA,2021,60,50,110,77
RWAMPARA,2022,60,50,110,77
RWAMPARA,2023,70,50,120,77
RWAMPARA,2024,70,50,120,77
RWAMPARA,2025,70,50,120,77
SERERE,2015,190,180,370,77
SERERE,2016,200,200,400,77
SERERE,2017,210,220,430,77
SERERE,2018,230,240,470,77
SERERE,2019,240,270,510,77
SERERE,2020,240,260,500,77
SERERE,2021,240,250,490,77
SERERE,2022,230,220,450,77
SERERE,2023,220,200,420,77
SERERE,2024,230,210,440,77
SERERE,2025,240,220,460,77
SHEEMA,2015,120,100,220,77
SHEEMA,2016,120,100,220,77
SHEEMA,2017,120,100,220,77
SHEEMA,2018,120,100,220,77
SHEEMA,2019,120,100,220,77
SHEEMA,2020,120,100,220,77
SHEEMA,2021,130,100,230,77
SHEEMA,2022,130,100,230,77
SHEEMA,2023,130,110,240,77
SHEEMA,2024,130,110,240,77
SHEEMA,2025,130,110,240,77
SIRONKO,2015,150,160,310,77
SIRONKO,2016,150,170,320,77
SIRONKO,2017,150,170,320,77
SIRONKO,2018,160,170,330,77
SIRONKO,2019,160,180,340,77
SIRONKO,2020,170,180,350,77
SIRONKO,2021,170,180,350,77
SIRONKO,2022,170,190,360,77
SIRONKO,2023,180,190,370,77
SIRONKO,2024,180,190,370,77
SIRONKO,2025,180,200,380,77
SOROTI,2015,120,150,270,77
SOROTI,2016,120,180,300,77
SOROTI,2017,130,180,310,77
SOROTI,2018,140,200,340,77
SOROTI,2019,140,230,370,77
SOROTI,2020,150,210,360,77
SOROTI,2021,140,190,330,77
SOROTI,2022,140,170,310,77
SOROTI,2023,130,170,300,77
SOROTI,2024,130,160,290,77
SOROTI,2025,140,170,310,77
SSEMBABULE,2015,130,150,280,77
SSEMBABULE,2016,140,160,300,77
SSEMBABULE,2017,130,160,290,77
SSEMBABULE,2018,140,180,320,77
SSEMBABULE,2019,150,200,350,77
SSEMBABULE,2020,150,190,340,77
SSEMBABULE,2021,140,170,310,77
SSEMBABULE,2022,140,150,290,77
SSEMBABULE,2023,130,140,270,77
SSEMBABULE,2024,130,150,280,77
SSEMBABULE,2025,140,150,290,77
TORORO,2015,270,240,510,77
TORORO,2016,280,250,530,77
TORORO,2017,280,250,530,77
TORORO,2018,290,260,550,77
TORORO,2019,300,260,560,77
TORORO,2020,310,270,580,77
TORORO,2021,310,280,590,77
TORORO,2022,320,280,600,77
TORORO,2023,330,290,620,77
TORORO,2024,330,290,620,77
TORORO,2025,340,300,640,77
WAKISO,2015,280,430,710,77
WAKISO,2016,300,460,760,77
WAKISO,2017,320,490,810,77
WAKISO,2018,340,530,870,77
WAKISO,2019,360,560,920,77
WAKISO,2020,380,600,980,77
WAKISO,2021,410,640,1050,77
WAKISO,2022,430,680,1110,77
WAKISO,2023,460,730,1190,77
WAKISO,2024,490,770,1260,77
WAKISO,2025,520,820,1340,77
YUMBE,2015,100,160,260,77
YUMBE,2016,120,180,300,77
YUMBE,2017,120,200,320,77
YUMBE,2018,140,240,380,77
YUMBE,2019,140,250,390,77
YUMBE,2020,150,260,410,77
YUMBE,2021,140,250,390,77
YUMBE,2022,140,220,360,77
YUMBE,2023,130,220,350,77
YUMBE,2024,140,220,360,77
YUMBE,2025,140,250,390,77
ZOMBO,2015,100,120,220,77
ZOMBO,2016,110,120,230,77
ZOMBO,2017,110,130,240,77
ZOMBO,2018,110,130,240,77
ZOMBO,2019,120,130,250,77
ZOMBO,2020,120,140,260,77
ZOMBO,2021,120,140,260,77
ZOMBO,2022,130,140,270,77
ZOMBO,2023,130,150,280,77
ZOMBO,2024,130,150,280,77
ZOMBO,2025,140,150,290,77
ABIM,2015,30,50,80,78
ABIM,2016,40,60,100,78
ABIM,2017,50,80,130,78
ABIM,2018,40,70,110,78
ABIM,2019,60,90,150,78
ABIM,2020,60,100,160,78
ABIM,2021,60,90,150,78
ABIM,2022,60,90,150,78
ABIM,2023,60,80,140,78
ABIM,2024,60,80,140,78
ABIM,2025,60,90,150,78
ADJUMANI,2015,40,90,130,78
ADJUMANI,2016,40,90,130,78
ADJUMANI,2017,40,90,130,78
ADJUMANI,2018,40,90,130,78
ADJUMANI,2019,40,90,130,78
ADJUMANI,2020,40,90,130,78
ADJUMANI,2021,40,90,130,78
ADJUMANI,2022,50,90,140,78
ADJUMANI,2023,50,90,140,78
ADJUMANI,2024,50,90,140,78
ADJUMANI,2025,50,90,140,78
AGAGO,2015,90,140,230,78
AGAGO,2016,100,140,240,78
AGAGO,2017,100,150,250,78
AGAGO,2018,100,150,250,78
AGAGO,2019,100,150,250,78
AGAGO,2020,100,150,250,78
AGAGO,2021,100,160,260,78
AGAGO,2022,110,160,270,78
AGAGO,2023,110,160,270,78
AGAGO,2024,110,160,270,78
AGAGO,2025,110,160,270,78
ALEBTONG,2015,100,100,200,78
ALEBTONG,2016,110,130,240,78
ALEBTONG,2017,120,140,260,78
ALEBTONG,2018,120,140,260,78
ALEBTONG,2019,120,160,280,78
ALEBTONG,2020,130,170,300,78
ALEBTONG,2021,130,170,300,78
ALEBTONG,2022,130,160,290,78
ALEBTONG,2023,120,140,260,78
ALEBTONG,2024,110,130,240,78
ALEBTONG,2025,120,130,250,78
AMOLATAR,2015,60,60,120,78
AMOLATAR,2016,60,70,130,78
AMOLATAR,2017,60,80,140,78
AMOLATAR,2018,60,70,130,78
AMOLATAR,2019,70,80,150,78
AMOLATAR,2020,80,80,160,78
AMOLATAR,2021,70,90,160,78
AMOLATAR,2022,70,80,150,78
AMOLATAR,2023,60,70,130,78
AMOLATAR,2024,60,70,130,78
AMOLATAR,2025,70,60,130,78
AMUDAT,2015,20,20,40,78
AMUDAT,2016,30,20,50,78
AMUDAT,2017,30,20,50,78
AMUDAT,2018,30,30,60,78
AMUDAT,2019,30,40,70,78
AMUDAT,2020,30,40,70,78
AMUDAT,2021,30,30,60,78
AMUDAT,2022,30,30,60,78
AMUDAT,2023,20,30,50,78
AMUDAT,2024,20,20,40,78
AMUDAT,2025,30,30,60,78
AMURIA,2015,80,80,160,78
AMURIA,2016,80,100,180,78
AMURIA,2017,80,110,190,78
AMURIA,2018,90,120,210,78
AMURIA,2019,90,130,220,78
AMURIA,2020,100,150,250,78
AMURIA,2021,100,140,240,78
AMURIA,2022,90,120,210,78
AMURIA,2023,100,120,220,78
AMURIA,2024,90,110,200,78
AMURIA,2025,100,100,200,78
AMURU,2015,50,80,130,78
AMURU,2016,50,90,140,78
AMURU,2017,60,110,170,78
AMURU,2018,60,110,170,78
AMURU,2019,70,120,190,78
AMURU,2020,70,120,190,78
AMURU,2021,60,130,190,78
AMURU,2022,60,110,170,78
AMURU,2023,60,100,160,78
AMURU,2024,60,90,150,78
AMURU,2025,60,100,160,78
APAC,2015,80,110,190,78
APAC,2016,80,110,190,78
APAC,2017,90,120,210,78
APAC,2018,90,120,210,78
APAC,2019,90,130,220,78
APAC,2020,100,130,230,78
APAC,2021,100,140,240,78
APAC,2022,100,140,240,78
APAC,2023,110,140,250,78
APAC,2024,110,150,260,78
APAC,2025,110,150,260,78
ARUA,2015,250,330,580,78
ARUA,2016,260,340,600,78
ARUA,2017,270,350,620,78
ARUA,2018,270,360,630,78
ARUA,2019,280,370,650,78
ARUA,2020,290,380,670,78
ARUA,2021,300,390,690,78
ARUA,2022,300,390,690,78
ARUA,2023,310,400,710,78
ARUA,2024,320,410,730,78
ARUA,2025,330,420,750,78
BUDAKA,2015,110,90,200,78
BUDAKA,2016,110,120,230,78
BUDAKA,2017,130,130,260,78
BUDAKA,2018,120,140,260,78
BUDAKA,2019,140,150,290,78
BUDAKA,2020,140,170,310,78
BUDAKA,2021,150,160,310,78
BUDAKA,2022,140,150,290,78
BUDAKA,2023,130,140,270,78
BUDAKA,2024,130,120,250,78
BUDAKA,2025,130,130,260,78
BUDUDA,2015,170,120,290,78
BUDUDA,2016,190,140,330,78
BUDUDA,2017,200,170,370,78
BUDUDA,2018,200,170,370,78
BUDUDA,2019,230,200,430,78
BUDUDA,2020,240,220,460,78
BUDUDA,2021,240,210,450,78
BUDUDA,2022,230,200,430,78
BUDUDA,2023,220,180,400,78
BUDUDA,2024,220,170,390,78
BUDUDA,2025,220,180,400,78
BUGIRI,2015,130,130,260,78
BUGIRI,2016,140,160,300,78
BUGIRI,2017,160,180,340,78
BUGIRI,2018,150,190,340,78
BUGIRI,2019,170,220,390,78
BUGIRI,2020,180,240,420,78
BUGIRI,2021,170,230,400,78
BUGIRI,2022,170,220,390,78
BUGIRI,2023,170,200,370,78
BUGIRI,2024,170,180,350,78
BUGIRI,2025,160,180,340,78
BUGWERI,2015,80,70,150,78
BUGWERI,2016,80,80,160,78
BUGWERI,2017,80,90,170,78
BUGWERI,2018,90,80,170,78
BUGWERI,2019,90,90,180,78
BUGWERI,2020,90,110,200,78
BUGWERI,2021,90,100,190,78
BUGWERI,2022,90,90,180,78
BUGWERI,2023,90,80,170,78
BUGWERI,2024,80,70,150,78
BUGWERI,2025,80,80,160,78
BUHWEJU,2015,60,60,120,78
BUHWEJU,2016,60,60,120,78
BUHWEJU,2017,60,60,120,78
BUHWEJU,2018,60,70,130,78
BUHWEJU,2019,70,70,140,78
BUHWEJU,2020,70,70,140,78
BUHWEJU,2021,70,70,140,78
BUHWEJU,2022,70,70,140,78
BUHWEJU,2023,70,80,150,78
BUHWEJU,2024,80,80,160,78
BUHWEJU,2025,80,80,160,78
BUIKWE,2015,130,130,260,78
BUIKWE,2016,140,150,290,78
BUIKWE,2017,150,170,320,78
BUIKWE,2018,140,180,320,78
BUIKWE,2019,160,200,360,78
BUIKWE,2020,160,210,370,78
BUIKWE,2021,160,210,370,78
BUIKWE,2022,150,190,340,78
BUIKWE,2023,140,160,300,78
BUIKWE,2024,140,160,300,78
BUIKWE,2025,130,150,280,78
BUKEDEA,2015,100,120,220,78
BUKEDEA,2016,110,140,250,78
BUKEDEA,2017,120,160,280,78
BUKEDEA,2018,120,170,290,78
BUKEDEA,2019,130,190,320,78
BUKEDEA,2020,140,210,350,78
BUKEDEA,2021,140,210,350,78
BUKEDEA,2022,140,190,330,78
BUKEDEA,2023,130,170,300,78
BUKEDEA,2024,130,170,300,78
BUKEDEA,2025,130,160,290,78
BUKOMANSIMBI,2015,90,120,210,78
BUKOMANSIMBI,2016,100,130,230,78
BUKOMANSIMBI,2017,100,150,250,78
BUKOMANSIMBI,2018,110,150,260,78
BUKOMANSIMBI,2019,110,160,270,78
BUKOMANSIMBI,2020,110,170,280,78
BUKOMANSIMBI,2021,110,160,270,78
BUKOMANSIMBI,2022,100,150,250,78
BUKOMANSIMBI,2023,100,130,230,78
BUKOMANSIMBI,2024,90,120,210,78
BUKOMANSIMBI,2025,90,110,200,78
BUKWO,2015,30,50,80,78
BUKWO,2016,30,50,80,78
BUKWO,2017,30,50,80,78
BUKWO,2018,30,50,80,78
BUKWO,2019,30,60,90,78
BUKWO,2020,40,60,100,78
BUKWO,2021,40,60,100,78
BUKWO,2022,40,60,100,78
BUKWO,2023,40,70,110,78
BUKWO,2024,40,70,110,78
BUKWO,2025,40,70,110,78
BULAMBULI,2015,90,120,210,78
BULAMBULI,2016,100,130,230,78
BULAMBULI,2017,110,160,270,78
BULAMBULI,2018,110,170,280,78
BULAMBULI,2019,120,190,310,78
BULAMBULI,2020,130,210,340,78
BULAMBULI,2021,130,210,340,78
BULAMBULI,2022,130,200,330,78
BULAMBULI,2023,130,180,310,78
BULAMBULI,2024,120,170,290,78
BULAMBULI,2025,130,180,310,78
BULIISA,2015,30,40,70,78
BULIISA,2016,40,50,90,78
BULIISA,2017,40,50,90,78
BULIISA,2018,40,50,90,78
BULIISA,2019,40,50,90,78
BULIISA,2020,40,60,100,78
BULIISA,2021,50,60,110,78
BULIISA,2022,50,60,110,78
BULIISA,2023,50,60,110,78
BULIISA,2024,50,60,110,78
BULIISA,2025,60,70,130,78
BUNDIBUGYO,2015,60,40,100,78
BUNDIBUGYO,2016,60,50,110,78
BUNDIBUGYO,2017,60,50,110,78
BUNDIBUGYO,2018,70,60,130,78
BUNDIBUGYO,2019,80,70,150,78
BUNDIBUGYO,2020,80,70,150,78
BUNDIBUGYO,2021,70,70,140,78
BUNDIBUGYO,2022,80,60,140,78
BUNDIBUGYO,2023,70,50,120,78
BUNDIBUGYO,2024,70,60,130,78
BUNDIBUGYO,2025,70,60,130,78
BUNYANGABU,2015,70,80,150,78
BUNYANGABU,2016,70,90,160,78
BUNYANGABU,2017,70,100,170,78
BUNYANGABU,2018,80,110,190,78
BUNYANGABU,2019,90,120,210,78
BUNYANGABU,2020,90,120,210,78
BUNYANGABU,2021,80,110,190,78
BUNYANGABU,2022,80,100,180,78
BUNYANGABU,2023,80,100,180,78
BUNYANGABU,2024,80,90,170,78
BUNYANGABU,2025,70,90,160,78
BUSHENYI,2015,170,170,340,78
BUSHENYI,2016,170,170,340,78
BUSHENYI,2017,180,170,350,78
BUSHENYI,2018,180,170,350,78
BUSHENYI,2019,180,180,360,78
BUSHENYI,2020,180,180,360,78
BUSHENYI,2021,180,180,360,78
BUSHENYI,2022,190,180,370,78
BUSHENYI,2023,190,180,370,78
BUSHENYI,2024,190,180,370,78
BUSHENYI,2025,190,180,370,78
BUSIA,2015,140,130,270,78
BUSIA,2016,140,150,290,78
BUSIA,2017,160,170,330,78
BUSIA,2018,150,180,330,78
BUSIA,2019,170,200,370,78
BUSIA,2020,170,210,380,78
BUSIA,2021,170,210,380,78
BUSIA,2022,170,190,360,78
BUSIA,2023,160,170,330,78
BUSIA,2024,160,160,320,78
BUSIA,2025,160,160,320,78
BUTALEJA,2015,130,130,260,78
BUTALEJA,2016,140,160,300,78
BUTALEJA,2017,150,180,330,78
BUTALEJA,2018,150,190,340,78
BUTALEJA,2019,160,220,380,78
BUTALEJA,2020,170,230,400,78
BUTALEJA,2021,170,230,400,78
BUTALEJA,2022,160,210,370,78
BUTALEJA,2023,160,190,350,78
BUTALEJA,2024,160,180,340,78
BUTALEJA,2025,160,180,340,78
BUTAMBALA,2015,40,40,80,78
BUTAMBALA,2016,40,50,90,78
BUTAMBALA,2017,50,50,100,78
BUTAMBALA,2018,40,50,90,78
BUTAMBALA,2019,50,60,110,78
BUTAMBALA,2020,50,60,110,78
BUTAMBALA,2021,50,60,110,78
BUTAMBALA,2022,40,50,90,78
BUTAMBALA,2023,40,50,90,78
BUTAMBALA,2024,40,40,80,78
BUTAMBALA,2025,40,40,80,78
BUTEBO,2015,50,50,100,78
BUTEBO,2016,60,60,120,78
BUTEBO,2017,60,60,120,78
BUTEBO,2018,60,60,120,78
BUTEBO,2019,70,70,140,78
BUTEBO,2020,70,70,140,78
BUTEBO,2021,60,70,130,78
BUTEBO,2022,60,60,120,78
BUTEBO,2023,60,50,110,78
BUTEBO,2024,50,50,100,78
BUTEBO,2025,50,50,100,78
BUVUMA,2015,20,10,30,78
BUVUMA,2016,20,10,30,78
BUVUMA,2017,20,10,30,78
BUVUMA,2018,20,10,30,78
BUVUMA,2019,30,10,40,78
BUVUMA,2020,30,10,40,78
BUVUMA,2021,30,10,40,78
BUVUMA,2022,30,10,40,78
BUVUMA,2023,30,10,40,78
BUVUMA,2024,30,10,40,78
BUVUMA,2025,40,20,60,78
BUYENDE,2015,100,110,210,78
BUYENDE,2016,110,130,240,78
BUYENDE,2017,120,150,270,78
BUYENDE,2018,120,150,270,78
BUYENDE,2019,130,180,310,78
BUYENDE,2020,130,190,320,78
BUYENDE,2021,140,180,320,78
BUYENDE,2022,140,180,320,78
BUYENDE,2023,130,160,290,78
BUYENDE,2024,130,150,280,78
BUYENDE,2025,130,150,280,78
DOKOLO,2015,80,110,190,78
DOKOLO,2016,90,120,210,78
DOKOLO,2017,90,120,210,78
DOKOLO,2018,90,120,210,78
DOKOLO,2019,90,130,220,78
DOKOLO,2020,100,130,230,78
DOKOLO,2021,100,130,230,78
DOKOLO,2022,100,140,240,78
DOKOLO,2023,110,140,250,78
DOKOLO,2024,110,140,250,78
DOKOLO,2025,110,150,260,78
GOMBA,2015,80,80,160,78
GOMBA,2016,80,90,170,78
GOMBA,2017,80,100,180,78
GOMBA,2018,80,100,180,78
GOMBA,2019,90,110,200,78
GOMBA,2020,90,110,200,78
GOMBA,2021,90,100,190,78
GOMBA,2022,80,90,170,78
GOMBA,2023,80,80,160,78
GOMBA,2024,80,70,150,78
GOMBA,2025,70,80,150,78
GULU,2015,120,150,270,78
GULU,2016,120,150,270,78
GULU,2017,130,160,290,78
GULU,2018,130,160,290,78
GULU,2019,130,170,300,78
GULU,2020,140,170,310,78
GULU,2021,140,180,320,78
GULU,2022,150,180,330,78
GULU,2023,150,190,340,78
GULU,2024,150,190,340,78
GULU,2025,160,200,360,78
HOIMA,2015,120,170,290,78
HOIMA,2016,130,180,310,78
HOIMA,2017,130,190,320,78
HOIMA,2018,140,190,330,78
HOIMA,2019,140,200,340,78
HOIMA,2020,150,210,360,78
HOIMA,2021,150,210,360,78
HOIMA,2022,160,220,380,78
HOIMA,2023,160,230,390,78
HOIMA,2024,170,230,400,78
HOIMA,2025,180,240,420,78
IBANDA,2015,140,180,320,78
IBANDA,2016,140,180,320,78
IBANDA,2017,140,190,330,78
IBANDA,2018,140,190,330,78
IBANDA,2019,150,190,340,78
IBANDA,2020,150,200,350,78
IBANDA,2021,150,200,350,78
IBANDA,2022,150,200,350,78
IBANDA,2023,160,200,360,78
IBANDA,2024,160,210,370,78
IBANDA,2025,160,210,370,78
IGANGA,2015,80,110,190,78
IGANGA,2016,90,130,220,78
IGANGA,2017,100,150,250,78
IGANGA,2018,100,150,250,78
IGANGA,2019,100,180,280,78
IGANGA,2020,110,180,290,78
IGANGA,2021,110,180,290,78
IGANGA,2022,100,170,270,78
IGANGA,2023,100,150,250,78
IGANGA,2024,100,140,240,78
IGANGA,2025,100,140,240,78
ISINGIRO,2015,160,200,360,78
ISINGIRO,2016,170,210,380,78
ISINGIRO,2017,180,210,390,78
ISINGIRO,2018,180,220,400,78
ISINGIRO,2019,190,230,420,78
ISINGIRO,2020,200,240,440,78
ISINGIRO,2021,200,240,440,78
ISINGIRO,2022,210,250,460,78
ISINGIRO,2023,220,260,480,78
ISINGIRO,2024,220,270,490,78
ISINGIRO,2025,230,280,510,78
JINJA,2015,110,140,250,78
JINJA,2016,120,140,260,78
JINJA,2017,120,140,260,78
JINJA,2018,120,150,270,78
JINJA,2019,120,150,270,78
JINJA,2020,120,150,270,78
JINJA,2021,120,150,270,78
JINJA,2022,130,150,280,78
JINJA,2023,130,160,290,78
JINJA,2024,130,160,290,78
JINJA,2025,130,160,290,78
KAABONG,2015,20,20,40,78
KAABONG,2016,20,20,40,78
KAABONG,2017,20,20,40,78
KAABONG,2018,20,20,40,78
KAABONG,2019,20,20,40,78
KAABONG,2020,20,20,40,78
KAABONG,2021,20,20,40,78
KAABONG,2022,20,20,40,78
KAABONG,2023,20,20,40,78
KAABONG,2024,20,20,40,78
KAABONG,2025,20,20,40,78
KABALE,2015,120,150,270,78
KABALE,2016,130,150,280,78
KABALE,2017,130,150,280,78
KABALE,2018,130,150,280,78
KABALE,2019,130,160,290,78
KABALE,2020,130,160,290,78
KABALE,2021,140,160,300,78
KABALE,2022,140,160,300,78
KABALE,2023,140,160,300,78
KABALE,2024,140,160,300,78
KABALE,2025,140,160,300,78
KABAROLE,2015,110,170,280,78
KABAROLE,2016,120,180,300,78
KABAROLE,2017,120,180,300,78
KABAROLE,2018,120,190,310,78
KABAROLE,2019,120,190,310,78
KABAROLE,2020,130,190,320,78
KABAROLE,2021,130,200,330,78
KABAROLE,2022,130,200,330,78
KABAROLE,2023,130,210,340,78
KABAROLE,2024,140,210,350,78
KABAROLE,2025,140,210,350,78
KABERAMAIDO,2015,50,70,120,78
KABERAMAIDO,2016,50,80,130,78
KABERAMAIDO,2017,50,90,140,78
KABERAMAIDO,2018,60,100,160,78
KABERAMAIDO,2019,70,110,180,78
KABERAMAIDO,2020,70,110,180,78
KABERAMAIDO,2021,60,110,170,78
KABERAMAIDO,2022,70,100,170,78
KABERAMAIDO,2023,60,90,150,78
KABERAMAIDO,2024,60,90,150,78
KABERAMAIDO,2025,70,90,160,78
KAGADI,2015,100,110,210,78
KAGADI,2016,100,120,220,78
KAGADI,2017,100,120,220,78
KAGADI,2018,110,120,230,78
KAGADI,2019,110,130,240,78
KAGADI,2020,120,130,250,78
KAGADI,2021,120,140,260,78
KAGADI,2022,120,140,260,78
KAGADI,2023,130,150,280,78
KAGADI,2024,130,150,280,78
KAGADI,2025,140,160,300,78
KAKUMIRO,2015,80,100,180,78
KAKUMIRO,2016,90,110,200,78
KAKUMIRO,2017,100,120,220,78
KAKUMIRO,2018,110,130,240,78
KAKUMIRO,2019,120,140,260,78
KAKUMIRO,2020,130,150,280,78
KAKUMIRO,2021,140,160,300,78
KAKUMIRO,2022,150,170,320,78
KAKUMIRO,2023,160,190,350,78
KAKUMIRO,2024,180,200,380,78
KAKUMIRO,2025,190,220,410,78
KALAKI,2015,60,80,140,78
KALAKI,2016,60,80,140,78
KALAKI,2017,60,80,140,78
KALAKI,2018,70,90,160,78
KALAKI,2019,70,90,160,78
KALAKI,2020,70,90,160,78
KALAKI,2021,80,100,180,78
KALAKI,2022,80,100,180,78
KALAKI,2023,80,110,190,78
KALAKI,2024,90,110,200,78
KALAKI,2025,90,110,200,78
KALANGALA,2015,20,10,30,78
KALANGALA,2016,20,10,30,78
KALANGALA,2017,20,10,30,78
KALANGALA,2018,20,10,30,78
KALANGALA,2019,20,10,30,78
KALANGALA,2020,20,10,30,78
KALANGALA,2021,20,10,30,78
KALANGALA,2022,20,10,30,78
KALANGALA,2023,20,10,30,78
KALANGALA,2024,20,10,30,78
KALANGALA,2025,20,20,40,78
KALIRO,2015,80,130,210,78
KALIRO,2016,100,140,240,78
KALIRO,2017,100,170,270,78
KALIRO,2018,100,170,270,78
KALIRO,2019,110,200,310,78
KALIRO,2020,110,210,320,78
KALIRO,2021,120,210,330,78
KALIRO,2022,110,190,300,78
KALIRO,2023,100,170,270,78
KALIRO,2024,110,170,280,78
KALIRO,2025,100,160,260,78
KALUNGU,2015,80,130,210,78
KALUNGU,2016,100,150,250,78
KALUNGU,2017,100,170,270,78
KALUNGU,2018,100,180,280,78
KALUNGU,2019,100,200,300,78
KALUNGU,2020,100,210,310,78
KALUNGU,2021,100,200,300,78
KALUNGU,2022,90,180,270,78
KALUNGU,2023,90,160,250,78
KALUNGU,2024,80,140,220,78
KALUNGU,2025,80,140,220,78
KAMPALA,2015,200,330,530,78
KAMPALA,2016,200,330,530,78
KAMPALA,2017,210,340,550,78
KAMPALA,2018,210,350,560,78
KAMPALA,2019,210,350,560,78
KAMPALA,2020,220,360,580,78
KAMPALA,2021,220,360,580,78
KAMPALA,2022,230,370,600,78
KAMPALA,2023,230,380,610,78
KAMPALA,2024,230,380,610,78
KAMPALA,2025,240,390,630,78
KAMULI,2015,170,180,350,78
KAMULI,2016,180,210,390,78
KAMULI,2017,190,240,430,78
KAMULI,2018,190,240,430,78
KAMULI,2019,210,270,480,78
KAMULI,2020,210,290,500,78
KAMULI,2021,210,280,490,78
KAMULI,2022,200,260,460,78
KAMULI,2023,190,230,420,78
KAMULI,2024,190,220,410,78
KAMULI,2025,180,210,390,78
KAMWENGE,2015,70,80,150,78
KAMWENGE,2016,80,90,170,78
KAMWENGE,2017,80,90,170,78
KAMWENGE,2018,80,90,170,78
KAMWENGE,2019,80,90,170,78
KAMWENGE,2020,90,100,190,78
KAMWENGE,2021,90,100,190,78
KAMWENGE,2022,90,100,190,78
KAMWENGE,2023,100,110,210,78
KAMWENGE,2024,100,110,210,78
KAMWENGE,2025,110,110,220,78
KANUNGU,2015,120,150,270,78
KANUNGU,2016,120,150,270,78
KANUNGU,2017,120,150,270,78
KANUNGU,2018,120,150,270,78
KANUNGU,2019,120,160,280,78
KANUNGU,2020,130,160,290,78
KANUNGU,2021,130,160,290,78
KANUNGU,2022,130,160,290,78
KANUNGU,2023,130,170,300,78
KANUNGU,2024,130,170,300,78
KANUNGU,2025,140,170,310,78
KAPCHORWA,2015,70,70,140,78
KAPCHORWA,2016,70,80,150,78
KAPCHORWA,2017,80,80,160,78
KAPCHORWA,2018,80,80,160,78
KAPCHORWA,2019,80,80,160,78
KAPCHORWA,2020,80,90,170,78
KAPCHORWA,2021,90,90,180,78
KAPCHORWA,2022,90,90,180,78
KAPCHORWA,2023,90,90,180,78
KAPCHORWA,2024,90,90,180,78
KAPCHORWA,2025,100,100,200,78
KAPELEBYONG,2015,30,40,70,78
KAPELEBYONG,2016,40,50,90,78
KAPELEBYONG,2017,40,50,90,78
KAPELEBYONG,2018,40,60,100,78
KAPELEBYONG,2019,40,70,110,78
KAPELEBYONG,2020,40,70,110,78
KAPELEBYONG,2021,50,70,120,78
KAPELEBYONG,2022,40,60,100,78
KAPELEBYONG,2023,40,50,90,78
KAPELEBYONG,2024,40,50,90,78
KAPELEBYONG,2025,40,60,100,78
KASESE,2015,170,150,320,78
KASESE,2016,180,170,350,78
KASESE,2017,190,210,400,78
KASESE,2018,190,200,390,78
KASESE,2019,210,220,430,78
KASESE,2020,210,240,450,78
KASESE,2021,210,230,440,78
KASESE,2022,200,220,420,78
KASESE,2023,190,190,380,78
KASESE,2024,180,170,350,78
KASESE,2025,180,180,360,78
KASSANDA,2015,120,130,250,78
KASSANDA,2016,120,130,250,78
KASSANDA,2017,130,140,270,78
KASSANDA,2018,130,140,270,78
KASSANDA,2019,130,140,270,78
KASSANDA,2020,140,140,280,78
KASSANDA,2021,140,150,290,78
KASSANDA,2022,150,150,300,78
KASSANDA,2023,150,150,300,78
KASSANDA,2024,150,160,310,78
KASSANDA,2025,160,160,320,78
KATAKWI,2015,90,120,210,78
KATAKWI,2016,100,130,230,78
KATAKWI,2017,110,150,260,78
KATAKWI,2018,110,160,270,78
KATAKWI,2019,110,180,290,78
KATAKWI,2020,120,180,300,78
KATAKWI,2021,120,180,300,78
KATAKWI,2022,110,170,280,78
KATAKWI,2023,110,150,260,78
KATAKWI,2024,110,140,250,78
KATAKWI,2025,100,140,240,78
KAYUNGA,2015,140,140,280,78
KAYUNGA,2016,160,160,320,78
KAYUNGA,2017,160,190,350,78
KAYUNGA,2018,170,190,360,78
KAYUNGA,2019,180,210,390,78
KAYUNGA,2020,180,230,410,78
KAYUNGA,2021,180,220,400,78
KAYUNGA,2022,170,200,370,78
KAYUNGA,2023,160,170,330,78
KAYUNGA,2024,160,170,330,78
KAYUNGA,2025,160,160,320,78
KAZO,2015,60,80,140,78
KAZO,2016,70,90,160,78
KAZO,2017,70,90,160,78
KAZO,2018,70,90,160,78
KAZO,2019,70,90,160,78
KAZO,2020,80,100,180,78
KAZO,2021,80,100,180,78
KAZO,2022,80,100,180,78
KAZO,2023,80,110,190,78
KAZO,2024,90,110,200,78
KAZO,2025,90,110,200,78
KIBAALE,2015,50,50,100,78
KIBAALE,2016,50,50,100,78
KIBAALE,2017,50,60,110,78
KIBAALE,2018,50,60,110,78
KIBAALE,2019,60,60,120,78
KIBAALE,2020,60,70,130,78
KIBAALE,2021,70,70,140,78
KIBAALE,2022,70,70,140,78
KIBAALE,2023,70,80,150,78
KIBAALE,2024,80,80,160,78
KIBAALE,2025,80,90,170,78
KIBOGA,2015,70,80,150,78
KIBOGA,2016,70,80,150,78
KIBOGA,2017,70,80,150,78
KIBOGA,2018,70,80,150,78
KIBOGA,2019,80,90,170,78
KIBOGA,2020,80,90,170,78
KIBOGA,2021,80,90,170,78
KIBOGA,2022,80,90,170,78
KIBOGA,2023,80,90,170,78
KIBOGA,2024,80,100,180,78
KIBOGA,2025,90,100,190,78
KIBUKU,2015,80,80,160,78
KIBUKU,2016,90,100,190,78
KIBUKU,2017,90,120,210,78
KIBUKU,2018,90,120,210,78
KIBUKU,2019,100,130,230,78
KIBUKU,2020,100,150,250,78
KIBUKU,2021,110,140,250,78
KIBUKU,2022,100,130,230,78
KIBUKU,2023,100,120,220,78
KIBUKU,2024,100,110,210,78
KIBUKU,2025,100,110,210,78
KIKUUBE,2015,90,80,170,78
KIKUUBE,2016,100,90,190,78
KIKUUBE,2017,100,90,190,78
KIKUUBE,2018,110,90,200,78
KIKUUBE,2019,110,100,210,78
KIKUUBE,2020,120,100,220,78
KIKUUBE,2021,120,110,230,78
KIKUUBE,2022,130,110,240,78
KIKUUBE,2023,140,120,260,78
KIKUUBE,2024,140,130,270,78
KIKUUBE,2025,150,130,280,78
KIRUHURA,2015,60,50,110,78
KIRUHURA,2016,70,50,120,78
KIRUHURA,2017,70,50,120,78
KIRUHURA,2018,70,50,120,78
KIRUHURA,2019,70,60,130,78
KIRUHURA,2020,80,60,140,78
KIRUHURA,2021,80,60,140,78
KIRUHURA,2022,80,60,140,78
KIRUHURA,2023,90,60,150,78
KIRUHURA,2024,90,70,160,78
KIRUHURA,2025,90,70,160,78
KIRYANDONGO,2015,50,80,130,78
KIRYANDONGO,2016,50,100,150,78
KIRYANDONGO,2017,60,110,170,78
KIRYANDONGO,2018,60,110,170,78
KIRYANDONGO,2019,70,120,190,78
KIRYANDONGO,2020,70,130,200,78
KIRYANDONGO,2021,60,130,190,78
KIRYANDONGO,2022,70,110,180,78
KIRYANDONGO,2023,60,110,170,78
KIRYANDONGO,2024,60,100,160,78
KIRYANDONGO,2025,60,100,160,78
KISORO,2015,100,120,220,78
KISORO,2016,110,130,240,78
KISORO,2017,120,150,270,78
KISORO,2018,120,150,270,78
KISORO,2019,120,180,300,78
KISORO,2020,130,180,310,78
KISORO,2021,130,170,300,78
KISORO,2022,120,160,280,78
KISORO,2023,110,150,260,78
KISORO,2024,110,130,240,78
KISORO,2025,110,130,240,78
KITAGWENDA,2015,50,60,110,78
KITAGWENDA,2016,60,70,130,78
KITAGWENDA,2017,60,70,130,78
KITAGWENDA,2018,60,70,130,78
KITAGWENDA,2019,60,70,130,78
KITAGWENDA,2020,70,80,150,78
KITAGWENDA,2021,70,80,150,78
KITAGWENDA,2022,70,80,150,78
KITAGWENDA,2023,70,80,150,78
KITAGWENDA,2024,80,90,170,78
KITAGWENDA,2025,80,90,170,78
KITGUM,2015,80,140,220,78
KITGUM,2016,90,160,250,78
KITGUM,2017,90,180,270,78
KITGUM,2018,90,180,270,78
KITGUM,2019,90,210,300,78
KITGUM,2020,100,220,320,78
KITGUM,2021,100,210,310,78
KITGUM,2022,90,190,280,78
KITGUM,2023,90,170,260,78
KITGUM,2024,80,160,240,78
KITGUM,2025,80,150,230,78
KOBOKO,2015,50,50,100,78
KOBOKO,2016,50,60,110,78
KOBOKO,2017,50,60,110,78
KOBOKO,2018,60,70,130,78
KOBOKO,2019,70,80,150,78
KOBOKO,2020,70,80,150,78
KOBOKO,2021,60,80,140,78
KOBOKO,2022,70,80,150,78
KOBOKO,2023,60,70,130,78
KOBOKO,2024,60,70,130,78
KOBOKO,2025,70,70,140,78
KOLE,2015,150,140,290,78
KOLE,2016,160,150,310,78
KOLE,2017,160,150,310,78
KOLE,2018,170,150,320,78
KOLE,2019,170,160,330,78
KOLE,2020,180,160,340,78
KOLE,2021,180,170,350,78
KOLE,2022,190,170,360,78
KOLE,2023,190,180,370,78
KOLE,2024,200,180,380,78
KOLE,2025,200,190,390,78
KOTIDO,2015,60,60,120,78
KOTIDO,2016,60,70,130,78
KOTIDO,2017,70,80,150,78
KOTIDO,2018,70,70,140,78
KOTIDO,2019,80,90,170,78
KOTIDO,2020,80,100,180,78
KOTIDO,2021,70,90,160,78
KOTIDO,2022,80,80,160,78
KOTIDO,2023,70,70,140,78
KOTIDO,2024,70,70,140,78
KOTIDO,2025,70,60,130,78
KUMI,2015,80,140,220,78
KUMI,2016,130,170,300,78
KUMI,2017,140,210,350,78
KUMI,2018,140,200,340,78
KUMI,2019,150,230,380,78
KUMI,2020,160,240,400,78
KUMI,2021,170,240,410,78
KUMI,2022,150,220,370,78
KUMI,2023,150,200,350,78
KUMI,2024,140,180,320,78
KUMI,2025,150,180,330,78
KWANIA,2015,100,140,240,78
KWANIA,2016,100,150,250,78
KWANIA,2017,110,150,260,78
KWANIA,2018,110,150,260,78
KWANIA,2019,110,160,270,78
KWANIA,2020,120,160,280,78
KWANIA,2021,120,170,290,78
KWANIA,2022,120,170,290,78
KWANIA,2023,130,170,300,78
KWANIA,2024,130,180,310,78
KWANIA,2025,130,180,310,78
KWEEN,2015,40,60,100,78
KWEEN,2016,50,60,110,78
KWEEN,2017,50,60,110,78
KWEEN,2018,50,60,110,78
KWEEN,2019,50,60,110,78
KWEEN,2020,50,60,110,78
KWEEN,2021,50,60,110,78
KWEEN,2022,50,70,120,78
KWEEN,2023,60,70,130,78
KWEEN,2024,60,70,130,78
KWEEN,2025,60,70,130,78
KYANKWANZI,2015,90,90,180,78
KYANKWANZI,2016,100,90,190,78
KYANKWANZI,2017,100,100,200,78
KYANKWANZI,2018,110,100,210,78
KYANKWANZI,2019,110,110,220,78
KYANKWANZI,2020,120,110,230,78
KYANKWANZI,2021,120,120,240,78
KYANKWANZI,2022,130,120,250,78
KYANKWANZI,2023,130,130,260,78
KYANKWANZI,2024,140,130,270,78
KYANKWANZI,2025,150,140,290,78
KYEGEGWA,2015,100,120,220,78
KYEGEGWA,2016,110,130,240,78
KYEGEGWA,2017,120,140,260,78
KYEGEGWA,2018,130,150,280,78
KYEGEGWA,2019,140,160,300,78
KYEGEGWA,2020,150,170,320,78
KYEGEGWA,2021,170,190,360,78
KYEGEGWA,2022,180,200,380,78
KYEGEGWA,2023,190,220,410,78
KYEGEGWA,2024,210,230,440,78
KYEGEGWA,2025,220,250,470,78
KYENJOJO,2015,170,200,370,78
KYENJOJO,2016,180,200,380,78
KYENJOJO,2017,180,210,390,78
KYENJOJO,2018,190,220,410,78
KYENJOJO,2019,200,230,430,78
KYENJOJO,2020,210,230,440,78
KYENJOJO,2021,210,240,450,78
KYENJOJO,2022,220,250,470,78
KYENJOJO,2023,230,260,490,78
KYENJOJO,2024,240,270,510,78
KYENJOJO,2025,250,280,530,78
KYOTERA,2015,110,130,240,78
KYOTERA,2016,120,150,270,78
KYOTERA,2017,130,170,300,78
KYOTERA,2018,120,170,290,78
KYOTERA,2019,130,190,320,78
KYOTERA,2020,140,210,350,78
KYOTERA,2021,140,200,340,78
KYOTERA,2022,130,180,310,78
KYOTERA,2023,120,160,280,78
KYOTERA,2024,110,140,250,78
KYOTERA,2025,120,140,260,78
KARENGA,2015,20,20,40,78
KARENGA,2016,20,20,40,78
KARENGA,2017,20,20,40,78
KARENGA,2018,20,20,40,78
KARENGA,2019,20,20,40,78
KARENGA,2020,20,20,40,78
KARENGA,2021,20,20,40,78
KARENGA,2022,20,20,40,78
KARENGA,2023,20,20,40,78
KARENGA,2024,20,20,40,78
KARENGA,2025,20,20,40,78
LAMWO,2015,70,110,180,78
LAMWO,2016,70,130,200,78
LAMWO,2017,70,140,210,78
LAMWO,2018,70,140,210,78
LAMWO,2019,80,150,230,78
LAMWO,2020,80,170,250,78
LAMWO,2021,70,160,230,78
LAMWO,2022,70,150,220,78
LAMWO,2023,60,130,190,78
LAMWO,2024,60,120,180,78
LAMWO,2025,60,110,170,78
LIRA,2015,150,210,360,78
LIRA,2016,160,210,370,78
LIRA,2017,160,220,380,78
LIRA,2018,170,230,400,78
LIRA,2019,170,230,400,78
LIRA,2020,180,240,420,78
LIRA,2021,180,240,420,78
LIRA,2022,180,250,430,78
LIRA,2023,190,260,450,78
LIRA,2024,190,260,450,78
LIRA,2025,200,270,470,78
LUUKA,2015,80,90,170,78
LUUKA,2016,90,110,200,78
LUUKA,2017,90,120,210,78
LUUKA,2018,90,120,210,78
LUUKA,2019,90,130,220,78
LUUKA,2020,90,150,240,78
LUUKA,2021,100,140,240,78
LUUKA,2022,90,120,210,78
LUUKA,2023,90,110,200,78
LUUKA,2024,80,100,180,78
LUUKA,2025,80,100,180,78
LUWERO,2015,160,200,360,78
LUWERO,2016,180,240,420,78
LUWERO,2017,180,280,460,78
LUWERO,2018,190,280,470,78
LUWERO,2019,200,320,520,78
LUWERO,2020,210,330,540,78
LUWERO,2021,200,320,520,78
LUWERO,2022,200,290,490,78
LUWERO,2023,180,260,440,78
LUWERO,2024,180,240,420,78
LUWERO,2025,180,240,420,78
LWENGO,2015,120,150,270,78
LWENGO,2016,120,170,290,78
LWENGO,2017,130,190,320,78
LWENGO,2018,120,190,310,78
LWENGO,2019,130,210,340,78
LWENGO,2020,130,220,350,78
LWENGO,2021,130,220,350,78
LWENGO,2022,130,200,330,78
LWENGO,2023,120,170,290,78
LWENGO,2024,110,160,270,78
LWENGO,2025,110,150,260,78
LYANTONDE,2015,30,30,60,78
LYANTONDE,2016,30,40,70,78
LYANTONDE,2017,40,40,80,78
LYANTONDE,2018,40,40,80,78
LYANTONDE,2019,40,60,100,78
LYANTONDE,2020,40,60,100,78
LYANTONDE,2021,40,60,100,78
LYANTONDE,2022,30,50,80,78
LYANTONDE,2023,30,50,80,78
LYANTONDE,2024,30,40,70,78
LYANTONDE,2025,30,40,70,78
MANAFWA,2015,120,140,260,78
MANAFWA,2016,120,140,260,78
MANAFWA,2017,130,150,280,78
MANAFWA,2018,130,150,280,78
MANAFWA,2019,130,150,280,78
MANAFWA,2020,140,160,300,78
MANAFWA,2021,140,160,300,78
MANAFWA,2022,140,160,300,78
MANAFWA,2023,150,170,320,78
MANAFWA,2024,150,170,320,78
MANAFWA,2025,150,170,320,78
MARACHA,2015,80,100,180,78
MARACHA,2016,80,100,180,78
MARACHA,2017,80,100,180,78
MARACHA,2018,80,100,180,78
MARACHA,2019,80,100,180,78
MARACHA,2020,80,100,180,78
MARACHA,2021,80,110,190,78
MARACHA,2022,90,110,200,78
MARACHA,2023,90,110,200,78
MARACHA,2024,90,110,200,78
MARACHA,2025,90,110,200,78
MASAKA,2015,110,150,260,78
MASAKA,2016,120,180,300,78
MASAKA,2017,130,210,340,78
MASAKA,2018,120,210,330,78
MASAKA,2019,140,230,370,78
MASAKA,2020,140,240,380,78
MASAKA,2021,140,240,380,78
MASAKA,2022,140,220,360,78
MASAKA,2023,130,190,320,78
MASAKA,2024,120,180,300,78
MASAKA,2025,130,180,310,78
MASINDI,2015,130,130,260,78
MASINDI,2016,130,140,270,78
MASINDI,2017,130,140,270,78
MASINDI,2018,140,150,290,78
MASINDI,2019,140,150,290,78
MASINDI,2020,140,150,290,78
MASINDI,2021,150,160,310,78
MASINDI,2022,150,160,310,78
MASINDI,2023,160,160,320,78
MASINDI,2024,160,170,330,78
MASINDI,2025,160,170,330,78
MAYUGE,2015,140,130,270,78
MAYUGE,2016,150,150,300,78
MAYUGE,2017,160,170,330,78
MAYUGE,2018,160,170,330,78
MAYUGE,2019,180,200,380,78
MAYUGE,2020,180,210,390,78
MAYUGE,2021,180,210,390,78
MAYUGE,2022,170,190,360,78
MAYUGE,2023,170,170,340,78
MAYUGE,2024,160,160,320,78
MAYUGE,2025,160,160,320,78
MBALE,2015,250,280,530,78
MBALE,2016,260,340,600,78
MBALE,2017,280,400,680,78
MBALE,2018,280,400,680,78
MBALE,2019,310,460,770,78
MBALE,2020,320,480,800,78
MBALE,2021,320,470,790,78
MBALE,2022,310,450,760,78
MBALE,2023,290,400,690,78
MBALE,2024,290,370,660,78
MBALE,2025,290,380,670,78
MBARARA,2015,150,150,300,78
MBARARA,2016,150,160,310,78
MBARARA,2017,150,160,310,78
MBARARA,2018,160,160,320,78
MBARARA,2019,160,170,330,78
MBARARA,2020,160,170,330,78
MBARARA,2021,170,170,340,78
MBARARA,2022,170,180,350,78
MBARARA,2023,170,180,350,78
MBARARA,2024,180,180,360,78
MBARARA,2025,180,190,370,78
MITOOMA,2015,90,120,210,78
MITOOMA,2016,90,130,220,78
MITOOMA,2017,90,130,220,78
MITOOMA,2018,100,130,230,78
MITOOMA,2019,100,130,230,78
MITOOMA,2020,100,130,230,78
MITOOMA,2021,100,130,230,78
MITOOMA,2022,100,130,230,78
MITOOMA,2023,100,130,230,78
MITOOMA,2024,100,130,230,78
MITOOMA,2025,100,130,230,78
MITYANA,2015,170,180,350,78
MITYANA,2016,180,200,380,78
MITYANA,2017,190,230,420,78
MITYANA,2018,190,230,420,78
MITYANA,2019,200,260,460,78
MITYANA,2020,210,270,480,78
MITYANA,2021,200,260,460,78
MITYANA,2022,200,240,440,78
MITYANA,2023,180,210,390,78
MITYANA,2024,170,200,370,78
MITYANA,2025,180,190,370,78
MOROTO,2015,30,30,60,78
MOROTO,2016,30,40,70,78
MOROTO,2017,30,40,70,78
MOROTO,2018,30,40,70,78
MOROTO,2019,30,50,80,78
MOROTO,2020,30,50,80,78
MOROTO,2021,30,50,80,78
MOROTO,2022,30,40,70,78
MOROTO,2023,20,40,60,78
MOROTO,2024,20,30,50,78
MOROTO,2025,20,30,50,78
MOYO,2015,30,40,70,78
MOYO,2016,30,40,70,78
MOYO,2017,30,40,70,78
MOYO,2018,30,40,70,78
MOYO,2019,30,50,80,78
MOYO,2020,30,50,80,78
MOYO,2021,30,50,80,78
MOYO,2022,30,50,80,78
MOYO,2023,40,50,90,78
MOYO,2024,40,50,90,78
MOYO,2025,40,50,90,78
MPIGI,2015,100,130,230,78
MPIGI,2016,110,150,260,78
MPIGI,2017,110,170,280,78
MPIGI,2018,120,180,300,78
MPIGI,2019,120,200,320,78
MPIGI,2020,120,210,330,78
MPIGI,2021,120,210,330,78
MPIGI,2022,120,190,310,78
MPIGI,2023,110,170,280,78
MPIGI,2024,110,160,270,78
MPIGI,2025,110,150,260,78
MUBENDE,2015,110,120,230,78
MUBENDE,2016,120,130,250,78
MUBENDE,2017,130,160,290,78
MUBENDE,2018,130,170,300,78
MUBENDE,2019,150,200,350,78
MUBENDE,2020,160,220,380,78
MUBENDE,2021,170,210,380,78
MUBENDE,2022,150,200,350,78
MUBENDE,2023,150,180,330,78
MUBENDE,2024,150,170,320,78
MUBENDE,2025,160,180,340,78
MUKONO,2015,190,240,430,78
MUKONO,2016,210,290,500,78
MUKONO,2017,220,320,540,78
MUKONO,2018,220,330,550,78
MUKONO,2019,250,380,630,78
MUKONO,2020,250,400,650,78
MUKONO,2021,250,390,640,78
MUKONO,2022,240,360,600,78
MUKONO,2023,230,330,560,78
MUKONO,2024,220,310,530,78
MUKONO,2025,220,300,520,78
MADI OKOLLO,2015,80,90,170,78
MADI OKOLLO,2016,80,90,170,78
MADI OKOLLO,2017,80,90,170,78
MADI OKOLLO,2018,90,100,190,78
MADI OKOLLO,2019,90,100,190,78
MADI OKOLLO,2020,90,100,190,78
MADI OKOLLO,2021,90,100,190,78
MADI OKOLLO,2022,100,110,210,78
MADI OKOLLO,2023,100,110,210,78
MADI OKOLLO,2024,100,110,210,78
MADI OKOLLO,2025,100,110,210,78
NABILATUK,2015,20,10,30,78
NABILATUK,2016,20,20,40,78
NABILATUK,2017,20,20,40,78
NABILATUK,2018,20,20,40,78
NABILATUK,2019,20,20,40,78
NABILATUK,2020,20,20,40,78
NABILATUK,2021,20,20,40,78
NABILATUK,2022,20,20,40,78
NABILATUK,2023,20,20,40,78
NABILATUK,2024,20,20,40,78
NABILATUK,2025,20,20,40,78
NAKAPIRIPIRIT,2015,30,30,60,78
NAKAPIRIPIRIT,2016,30,30,60,78
NAKAPIRIPIRIT,2017,30,30,60,78
NAKAPIRIPIRIT,2018,30,30,60,78
NAKAPIRIPIRIT,2019,30,40,70,78
NAKAPIRIPIRIT,2020,30,40,70,78
NAKAPIRIPIRIT,2021,30,30,60,78
NAKAPIRIPIRIT,2022,30,40,70,78
NAKAPIRIPIRIT,2023,30,40,70,78
NAKAPIRIPIRIT,2024,30,30,60,78
NAKAPIRIPIRIT,2025,30,30,60,78
NAKASEKE,2015,110,80,190,78
NAKASEKE,2016,110,90,200,78
NAKASEKE,2017,110,90,200,78
NAKASEKE,2018,120,90,210,78
NAKASEKE,2019,120,90,210,78
NAKASEKE,2020,130,90,220,78
NAKASEKE,2021,130,100,230,78
NAKASEKE,2022,140,100,240,78
NAKASEKE,2023,140,100,240,78
NAKASEKE,2024,140,100,240,78
NAKASEKE,2025,150,110,260,78
NAKASONGOLA,2015,70,60,130,78
NAKASONGOLA,2016,70,70,140,78
NAKASONGOLA,2017,70,90,160,78
NAKASONGOLA,2018,80,80,160,78
NAKASONGOLA,2019,90,90,180,78
NAKASONGOLA,2020,90,100,190,78
NAKASONGOLA,2021,90,90,180,78
NAKASONGOLA,2022,80,90,170,78
NAKASONGOLA,2023,80,80,160,78
NAKASONGOLA,2024,80,70,150,78
NAKASONGOLA,2025,80,70,150,78
NAMAYINGO,2015,60,50,110,78
NAMAYINGO,2016,60,60,120,78
NAMAYINGO,2017,60,60,120,78
NAMAYINGO,2018,70,70,140,78
NAMAYINGO,2019,80,80,160,78
NAMAYINGO,2020,80,80,160,78
NAMAYINGO,2021,70,80,150,78
NAMAYINGO,2022,70,70,140,78
NAMAYINGO,2023,60,60,120,78
NAMAYINGO,2024,60,60,120,78
NAMAYINGO,2025,70,60,130,78
NAMISINDWA,2015,140,170,310,78
NAMISINDWA,2016,140,170,310,78
NAMISINDWA,2017,150,180,330,78
NAMISINDWA,2018,150,180,330,78
NAMISINDWA,2019,150,190,340,78
NAMISINDWA,2020,160,190,350,78
NAMISINDWA,2021,160,190,350,78
NAMISINDWA,2022,170,200,370,78
NAMISINDWA,2023,170,200,370,78
NAMISINDWA,2024,170,210,380,78
NAMISINDWA,2025,180,210,390,78
NAMUTUMBA,2015,80,110,190,78
NAMUTUMBA,2016,90,130,220,78
NAMUTUMBA,2017,100,150,250,78
NAMUTUMBA,2018,100,160,260,78
NAMUTUMBA,2019,110,180,290,78
NAMUTUMBA,2020,110,190,300,78
NAMUTUMBA,2021,110,180,290,78
NAMUTUMBA,2022,110,180,290,78
NAMUTUMBA,2023,100,160,260,78
NAMUTUMBA,2024,110,150,260,78
NAMUTUMBA,2025,100,140,240,78
NAPAK,2015,40,50,90,78
NAPAK,2016,40,60,100,78
NAPAK,2017,50,60,110,78
NAPAK,2018,40,70,110,78
NAPAK,2019,50,80,130,78
NAPAK,2020,50,80,130,78
NAPAK,2021,50,80,130,78
NAPAK,2022,50,70,120,78
NAPAK,2023,50,60,110,78
NAPAK,2024,50,60,110,78
NAPAK,2025,40,60,100,78
NEBBI,2015,130,150,280,78
NEBBI,2016,130,160,290,78
NEBBI,2017,140,160,300,78
NEBBI,2018,140,170,310,78
NEBBI,2019,150,170,320,78
NEBBI,2020,150,170,320,78
NEBBI,2021,150,180,330,78
NEBBI,2022,160,180,340,78
NEBBI,2023,160,190,350,78
NEBBI,2024,170,190,360,78
NEBBI,2025,170,200,370,78
NGORA,2015,90,100,190,78
NGORA,2016,100,120,220,78
NGORA,2017,110,140,250,78
NGORA,2018,110,140,250,78
NGORA,2019,120,150,270,78
NGORA,2020,120,170,290,78
NGORA,2021,120,160,280,78
NGORA,2022,120,150,270,78
NGORA,2023,110,140,250,78
NGORA,2024,110,120,230,78
NGORA,2025,110,120,230,78
NTOROKO,2015,20,20,40,78
NTOROKO,2016,30,20,50,78
NTOROKO,2017,30,20,50,78
NTOROKO,2018,30,20,50,78
NTOROKO,2019,30,20,50,78
NTOROKO,2020,30,20,50,78
NTOROKO,2021,30,20,50,78
NTOROKO,2022,30,20,50,78
NTOROKO,2023,20,20,40,78
NTOROKO,2024,20,20,40,78
NTOROKO,2025,20,20,40,78
NTUNGAMO,2015,220,280,500,78
NTUNGAMO,2016,230,290,520,78
NTUNGAMO,2017,230,290,520,78
NTUNGAMO,2018,240,300,540,78
NTUNGAMO,2019,240,300,540,78
NTUNGAMO,2020,250,310,560,78
NTUNGAMO,2021,250,310,560,78
NTUNGAMO,2022,260,320,580,78
NTUNGAMO,2023,260,320,580,78
NTUNGAMO,2024,270,330,600,78
NTUNGAMO,2025,270,330,600,78
NWOYA,2015,70,80,150,78
NWOYA,2016,80,90,170,78
NWOYA,2017,90,90,180,78
NWOYA,2018,100,100,200,78
NWOYA,2019,100,110,210,78
NWOYA,2020,120,130,250,78
NWOYA,2021,130,140,270,78
NWOYA,2022,140,150,290,78
NWOYA,2023,150,170,320,78
NWOYA,2024,170,180,350,78
NWOYA,2025,190,200,390,78
OBONGI,2015,10,10,20,78
OBONGI,2016,10,10,20,78
OBONGI,2017,10,10,20,78
OBONGI,2018,10,20,30,78
OBONGI,2019,10,20,30,78
OBONGI,2020,10,20,30,78
OBONGI,2021,20,20,40,78
OBONGI,2022,20,20,40,78
OBONGI,2023,20,20,40,78
OBONGI,2024,20,20,40,78
OBONGI,2025,10,20,30,78
OMORO,2015,70,90,160,78
OMORO,2016,70,110,180,78
OMORO,2017,80,130,210,78
OMORO,2018,80,130,210,78
OMORO,2019,90,140,230,78
OMORO,2020,90,160,250,78
OMORO,2021,90,150,240,78
OMORO,2022,80,150,230,78
OMORO,2023,90,130,220,78
OMORO,2024,80,120,200,78
OMORO,2025,80,120,200,78
OTUKE,2015,70,80,150,78
OTUKE,2016,80,90,170,78
OTUKE,2017,80,90,170,78
OTUKE,2018,90,90,180,78
OTUKE,2019,90,100,190,78
OTUKE,2020,90,100,190,78
OTUKE,2021,100,110,210,78
OTUKE,2022,100,110,210,78
OTUKE,2023,100,110,210,78
OTUKE,2024,110,120,230,78
OTUKE,2025,110,120,230,78
OYAM,2015,200,210,410,78
OYAM,2016,210,220,430,78
OYAM,2017,220,230,450,78
OYAM,2018,220,230,450,78
OYAM,2019,230,240,470,78
OYAM,2020,240,250,490,78
OYAM,2021,240,250,490,78
OYAM,2022,250,260,510,78
OYAM,2023,260,270,530,78
OYAM,2024,260,270,530,78
OYAM,2025,270,280,550,78
PADER,2015,50,100,150,78
PADER,2016,50,120,170,78
PADER,2017,60,130,190,78
PADER,2018,60,140,200,78
PADER,2019,70,150,220,78
PADER,2020,70,160,230,78
PADER,2021,60,150,210,78
PADER,2022,60,130,190,78
PADER,2023,60,130,190,78
PADER,2024,50,120,170,78
PADER,2025,50,110,160,78
PAKWACH,2015,60,80,140,78
PAKWACH,2016,60,80,140,78
PAKWACH,2017,70,80,150,78
PAKWACH,2018,70,90,160,78
PAKWACH,2019,70,90,160,78
PAKWACH,2020,70,90,160,78
PAKWACH,2021,80,100,180,78
PAKWACH,2022,80,100,180,78
PAKWACH,2023,80,100,180,78
PAKWACH,2024,90,110,200,78
PAKWACH,2025,90,110,200,78
PALLISA,2015,130,130,260,78
PALLISA,2016,130,160,290,78
PALLISA,2017,150,190,340,78
PALLISA,2018,150,190,340,78
PALLISA,2019,160,220,380,78
PALLISA,2020,170,240,410,78
PALLISA,2021,170,240,410,78
PALLISA,2022,170,230,400,78
PALLISA,2023,170,210,380,78
PALLISA,2024,170,190,360,78
PALLISA,2025,160,190,350,78
RAKAI,2015,110,100,210,78
RAKAI,2016,110,120,230,78
RAKAI,2017,130,130,260,78
RAKAI,2018,120,140,260,78
RAKAI,2019,130,150,280,78
RAKAI,2020,140,160,300,78
RAKAI,2021,140,150,290,78
RAKAI,2022,130,150,280,78
RAKAI,2023,130,130,260,78
RAKAI,2024,120,120,240,78
RAKAI,2025,120,110,230,78
RUBANDA,2015,80,120,200,78
RUBANDA,2016,90,120,210,78
RUBANDA,2017,90,120,210,78
RUBANDA,2018,90,120,210,78
RUBANDA,2019,90,120,210,78
RUBANDA,2020,90,120,210,78
RUBANDA,2021,90,120,210,78
RUBANDA,2022,90,120,210,78
RUBANDA,2023,90,120,210,78
RUBANDA,2024,90,120,210,78
RUBANDA,2025,90,120,210,78
RUBIRIZI,2015,60,70,130,78
RUBIRIZI,2016,60,70,130,78
RUBIRIZI,2017,60,70,130,78
RUBIRIZI,2018,60,70,130,78
RUBIRIZI,2019,60,70,130,78
RUBIRIZI,2020,60,70,130,78
RUBIRIZI,2021,60,70,130,78
RUBIRIZI,2022,70,80,150,78
RUBIRIZI,2023,70,80,150,78
RUBIRIZI,2024,70,80,150,78
RUBIRIZI,2025,70,80,150,78
RUKIGA,2015,60,80,140,78
RUKIGA,2016,60,80,140,78
RUKIGA,2017,60,80,140,78
RUKIGA,2018,60,80,140,78
RUKIGA,2019,60,80,140,78
RUKIGA,2020,60,90,150,78
RUKIGA,2021,60,90,150,78
RUKIGA,2022,60,90,150,78
RUKIGA,2023,60,90,150,78
RUKIGA,2024,60,90,150,78
RUKIGA,2025,60,90,150,78
RUKUNGIRI,2015,190,220,410,78
RUKUNGIRI,2016,190,220,410,78
RUKUNGIRI,2017,190,220,410,78
RUKUNGIRI,2018,190,220,410,78
RUKUNGIRI,2019,200,220,420,78
RUKUNGIRI,2020,200,230,430,78
RUKUNGIRI,2021,200,230,430,78
RUKUNGIRI,2022,200,230,430,78
RUKUNGIRI,2023,200,230,430,78
RUKUNGIRI,2024,210,230,440,78
RUKUNGIRI,2025,210,230,440,78
RWAMPARA,2015,60,90,150,78
RWAMPARA,2016,60,90,150,78
RWAMPARA,2017,70,100,170,78
RWAMPARA,2018,70,100,170,78
RWAMPARA,2019,70,100,170,78
RWAMPARA,2020,70,100,170,78
RWAMPARA,2021,70,100,170,78
RWAMPARA,2022,70,110,180,78
RWAMPARA,2023,70,110,180,78
RWAMPARA,2024,70,110,180,78
RWAMPARA,2025,80,110,190,78
SERERE,2015,120,120,240,78
SERERE,2016,130,140,270,78
SERERE,2017,140,160,300,78
SERERE,2018,140,170,310,78
SERERE,2019,160,200,360,78
SERERE,2020,160,210,370,78
SERERE,2021,170,210,380,78
SERERE,2022,160,200,360,78
SERERE,2023,150,170,320,78
SERERE,2024,150,170,320,78
SERERE,2025,160,170,330,78
SHEEMA,2015,140,160,300,78
SHEEMA,2016,140,160,300,78
SHEEMA,2017,140,170,310,78
SHEEMA,2018,140,170,310,78
SHEEMA,2019,140,170,310,78
SHEEMA,2020,140,170,310,78
SHEEMA,2021,150,170,320,78
SHEEMA,2022,150,170,320,78
SHEEMA,2023,150,170,320,78
SHEEMA,2024,150,180,330,78
SHEEMA,2025,150,180,330,78
SIRONKO,2015,230,290,520,78
SIRONKO,2016,230,290,520,78
SIRONKO,2017,240,300,540,78
SIRONKO,2018,240,310,550,78
SIRONKO,2019,250,310,560,78
SIRONKO,2020,250,320,570,78
SIRONKO,2021,260,320,580,78
SIRONKO,2022,270,330,600,78
SIRONKO,2023,270,340,610,78
SIRONKO,2024,280,340,620,78
SIRONKO,2025,280,350,630,78
SOROTI,2015,100,130,230,78
SOROTI,2016,110,150,260,78
SOROTI,2017,120,180,300,78
SOROTI,2018,120,190,310,78
SOROTI,2019,130,210,340,78
SOROTI,2020,140,230,370,78
SOROTI,2021,140,220,360,78
SOROTI,2022,140,210,350,78
SOROTI,2023,130,190,320,78
SOROTI,2024,130,170,300,78
SOROTI,2025,130,180,310,78
SSEMBABULE,2015,100,100,200,78
SSEMBABULE,2016,110,120,230,78
SSEMBABULE,2017,110,130,240,78
SSEMBABULE,2018,120,140,260,78
SSEMBABULE,2019,120,150,270,78
SSEMBABULE,2020,120,160,280,78
SSEMBABULE,2021,130,160,290,78
SSEMBABULE,2022,120,150,270,78
SSEMBABULE,2023,120,130,250,78
SSEMBABULE,2024,110,120,230,78
SSEMBABULE,2025,110,120,230,78
TORORO,2015,290,340,630,78
TORORO,2016,300,350,650,78
TORORO,2017,310,360,670,78
TORORO,2018,320,370,690,78
TORORO,2019,320,380,700,78
TORORO,2020,330,390,720,78
TORORO,2021,340,390,730,78
TORORO,2022,350,400,750,78
TORORO,2023,360,410,770,78
TORORO,2024,360,420,780,78
TORORO,2025,370,430,800,78
WAKISO,2015,370,680,1050,78
WAKISO,2016,400,720,1120,78
WAKISO,2017,430,770,1200,78
WAKISO,2018,450,820,1270,78
WAKISO,2019,480,880,1360,78
WAKISO,2020,520,940,1460,78
WAKISO,2021,550,1000,1550,78
WAKISO,2022,580,1060,1640,78
WAKISO,2023,620,1130,1750,78
WAKISO,2024,660,1210,1870,78
WAKISO,2025,700,1280,1980,78
YUMBE,2015,140,140,280,78
YUMBE,2016,150,170,320,78
YUMBE,2017,160,210,370,78
YUMBE,2018,170,210,380,78
YUMBE,2019,190,250,440,78
YUMBE,2020,200,270,470,78
YUMBE,2021,200,280,480,78
YUMBE,2022,200,260,460,78
YUMBE,2023,200,240,440,78
YUMBE,2024,200,230,430,78
YUMBE,2025,200,230,430,78
ZOMBO,2015,150,200,350,78
ZOMBO,2016,160,200,360,78
ZOMBO,2017,160,210,370,78
ZOMBO,2018,170,220,390,78
ZOMBO,2019,170,220,390,78
ZOMBO,2020,180,230,410,78
ZOMBO,2021,180,230,410,78
ZOMBO,2022,190,240,430,78
ZOMBO,2023,190,250,440,78
ZOMBO,2024,200,250,450,78
ZOMBO,2025,200,260,460,78
ABIM,2015,30,20,50,79
ABIM,2016,30,30,60,79
ABIM,2017,30,40,70,79
ABIM,2018,40,40,80,79
ABIM,2019,30,40,70,79
ABIM,2020,40,50,90,79
ABIM,2021,50,50,100,79
ABIM,2022,50,60,110,79
ABIM,2023,40,60,100,79
ABIM,2024,40,50,90,79
ABIM,2025,50,50,100,79
ADJUMANI,2015,40,60,100,79
ADJUMANI,2016,40,60,100,79
ADJUMANI,2017,40,60,100,79
ADJUMANI,2018,40,70,110,79
ADJUMANI,2019,40,70,110,79
ADJUMANI,2020,40,70,110,79
ADJUMANI,2021,40,70,110,79
ADJUMANI,2022,40,70,110,79
ADJUMANI,2023,40,70,110,79
ADJUMANI,2024,40,70,110,79
ADJUMANI,2025,40,70,110,79
AGAGO,2015,80,70,150,79
AGAGO,2016,80,70,150,79
AGAGO,2017,80,70,150,79
AGAGO,2018,90,70,160,79
AGAGO,2019,90,80,170,79
AGAGO,2020,90,80,170,79
AGAGO,2021,90,80,170,79
AGAGO,2022,90,80,170,79
AGAGO,2023,90,80,170,79
AGAGO,2024,90,80,170,79
AGAGO,2025,90,80,170,79
ALEBTONG,2015,80,90,170,79
ALEBTONG,2016,100,100,200,79
ALEBTONG,2017,100,120,220,79
ALEBTONG,2018,110,130,240,79
ALEBTONG,2019,100,150,250,79
ALEBTONG,2020,120,160,280,79
ALEBTONG,2021,120,170,290,79
ALEBTONG,2022,120,160,280,79
ALEBTONG,2023,110,160,270,79
ALEBTONG,2024,110,140,250,79
ALEBTONG,2025,110,130,240,79
AMOLATAR,2015,70,40,110,79
AMOLATAR,2016,80,50,130,79
AMOLATAR,2017,80,50,130,79
AMOLATAR,2018,80,70,150,79
AMOLATAR,2019,80,70,150,79
AMOLATAR,2020,80,80,160,79
AMOLATAR,2021,100,80,180,79
AMOLATAR,2022,100,80,180,79
AMOLATAR,2023,90,70,160,79
AMOLATAR,2024,80,60,140,79
AMOLATAR,2025,80,60,140,79
AMUDAT,2015,20,20,40,79
AMUDAT,2016,20,20,40,79
AMUDAT,2017,20,30,50,79
AMUDAT,2018,40,30,70,79
AMUDAT,2019,30,30,60,79
AMUDAT,2020,40,30,70,79
AMUDAT,2021,40,30,70,79
AMUDAT,2022,40,30,70,79
AMUDAT,2023,30,30,60,79
AMUDAT,2024,30,30,60,79
AMUDAT,2025,30,20,50,79
AMURIA,2015,40,50,90,79
AMURIA,2016,40,60,100,79
AMURIA,2017,60,70,130,79
AMURIA,2018,60,70,130,79
AMURIA,2019,60,70,130,79
AMURIA,2020,60,100,160,79
AMURIA,2021,60,100,160,79
AMURIA,2022,70,100,170,79
AMURIA,2023,70,90,160,79
AMURIA,2024,60,80,140,79
AMURIA,2025,60,80,140,79
AMURU,2015,30,40,70,79
AMURU,2016,30,50,80,79
AMURU,2017,30,50,80,79
AMURU,2018,40,60,100,79
AMURU,2019,50,60,110,79
AMURU,2020,50,70,120,79
AMURU,2021,50,70,120,79
AMURU,2022,50,60,110,79
AMURU,2023,40,60,100,79
AMURU,2024,40,50,90,79
AMURU,2025,40,60,100,79
APAC,2015,100,80,180,79
APAC,2016,100,80,180,79
APAC,2017,100,90,190,79
APAC,2018,110,90,200,79
APAC,2019,110,90,200,79
APAC,2020,120,90,210,79
APAC,2021,120,100,220,79
APAC,2022,120,100,220,79
APAC,2023,130,100,230,79
APAC,2024,130,110,240,79
APAC,2025,140,110,250,79
ARUA,2015,130,140,270,79
ARUA,2016,140,140,280,79
ARUA,2017,140,150,290,79
ARUA,2018,150,150,300,79
ARUA,2019,150,150,300,79
ARUA,2020,150,160,310,79
ARUA,2021,160,160,320,79
ARUA,2022,160,170,330,79
ARUA,2023,170,170,340,79
ARUA,2024,170,170,340,79
ARUA,2025,170,180,350,79
BUDAKA,2015,120,100,220,79
BUDAKA,2016,120,130,250,79
BUDAKA,2017,130,150,280,79
BUDAKA,2018,140,160,300,79
BUDAKA,2019,140,180,320,79
BUDAKA,2020,160,200,360,79
BUDAKA,2021,160,200,360,79
BUDAKA,2022,170,210,380,79
BUDAKA,2023,150,190,340,79
BUDAKA,2024,140,180,320,79
BUDAKA,2025,150,160,310,79
BUDUDA,2015,100,120,220,79
BUDUDA,2016,100,150,250,79
BUDUDA,2017,110,170,280,79
BUDUDA,2018,120,210,330,79
BUDUDA,2019,130,210,340,79
BUDUDA,2020,130,240,370,79
BUDUDA,2021,150,270,420,79
BUDUDA,2022,140,260,400,79
BUDUDA,2023,140,250,390,79
BUDUDA,2024,130,230,360,79
BUDUDA,2025,140,210,350,79
BUGIRI,2015,120,130,250,79
BUGIRI,2016,120,150,270,79
BUGIRI,2017,140,190,330,79
BUGIRI,2018,140,220,360,79
BUGIRI,2019,150,220,370,79
BUGIRI,2020,160,260,420,79
BUGIRI,2021,170,270,440,79
BUGIRI,2022,180,270,450,79
BUGIRI,2023,160,250,410,79
BUGIRI,2024,160,230,390,79
BUGIRI,2025,160,220,380,79
BUGWERI,2015,50,50,100,79
BUGWERI,2016,50,70,120,79
BUGWERI,2017,70,80,150,79
BUGWERI,2018,70,90,160,79
BUGWERI,2019,70,90,160,79
BUGWERI,2020,70,100,170,79
BUGWERI,2021,70,100,170,79
BUGWERI,2022,70,100,170,79
BUGWERI,2023,80,100,180,79
BUGWERI,2024,70,90,160,79
BUGWERI,2025,70,80,150,79
BUHWEJU,2015,40,50,90,79
BUHWEJU,2016,40,50,90,79
BUHWEJU,2017,40,50,90,79
BUHWEJU,2018,40,50,90,79
BUHWEJU,2019,40,50,90,79
BUHWEJU,2020,40,60,100,79
BUHWEJU,2021,40,60,100,79
BUHWEJU,2022,40,60,100,79
BUHWEJU,2023,50,60,110,79
BUHWEJU,2024,50,60,110,79
BUHWEJU,2025,50,60,110,79
BUIKWE,2015,120,110,230,79
BUIKWE,2016,120,130,250,79
BUIKWE,2017,130,150,280,79
BUIKWE,2018,130,160,290,79
BUIKWE,2019,140,180,320,79
BUIKWE,2020,150,200,350,79
BUIKWE,2021,150,200,350,79
BUIKWE,2022,140,190,330,79
BUIKWE,2023,130,170,300,79
BUIKWE,2024,130,170,300,79
BUIKWE,2025,130,150,280,79
BUKEDEA,2015,110,100,210,79
BUKEDEA,2016,110,130,240,79
BUKEDEA,2017,130,150,280,79
BUKEDEA,2018,130,160,290,79
BUKEDEA,2019,130,180,310,79
BUKEDEA,2020,150,200,350,79
BUKEDEA,2021,160,220,380,79
BUKEDEA,2022,150,210,360,79
BUKEDEA,2023,150,200,350,79
BUKEDEA,2024,140,180,320,79
BUKEDEA,2025,150,170,320,79
BUKOMANSIMBI,2015,70,70,140,79
BUKOMANSIMBI,2016,80,80,160,79
BUKOMANSIMBI,2017,80,90,170,79
BUKOMANSIMBI,2018,80,100,180,79
BUKOMANSIMBI,2019,80,100,180,79
BUKOMANSIMBI,2020,80,110,190,79
BUKOMANSIMBI,2021,90,120,210,79
BUKOMANSIMBI,2022,80,110,190,79
BUKOMANSIMBI,2023,80,100,180,79
BUKOMANSIMBI,2024,70,90,160,79
BUKOMANSIMBI,2025,70,80,150,79
BUKWO,2015,20,30,50,79
BUKWO,2016,20,30,50,79
BUKWO,2017,20,30,50,79
BUKWO,2018,20,30,50,79
BUKWO,2019,20,40,60,79
BUKWO,2020,30,40,70,79
BUKWO,2021,30,40,70,79
BUKWO,2022,30,40,70,79
BUKWO,2023,30,40,70,79
BUKWO,2024,30,40,70,79
BUKWO,2025,30,50,80,79
BULAMBULI,2015,80,90,170,79
BULAMBULI,2016,90,100,190,79
BULAMBULI,2017,90,120,210,79
BULAMBULI,2018,110,150,260,79
BULAMBULI,2019,100,150,250,79
BULAMBULI,2020,120,180,300,79
BULAMBULI,2021,120,190,310,79
BULAMBULI,2022,130,190,320,79
BULAMBULI,2023,120,170,290,79
BULAMBULI,2024,120,170,290,79
BULAMBULI,2025,120,150,270,79
BULIISA,2015,30,30,60,79
BULIISA,2016,30,30,60,79
BULIISA,2017,30,30,60,79
BULIISA,2018,30,40,70,79
BULIISA,2019,30,40,70,79
BULIISA,2020,30,40,70,79
BULIISA,2021,30,40,70,79
BULIISA,2022,40,40,80,79
BULIISA,2023,40,40,80,79
BULIISA,2024,40,50,90,79
BULIISA,2025,40,50,90,79
BUNDIBUGYO,2015,50,40,90,79
BUNDIBUGYO,2016,50,60,110,79
BUNDIBUGYO,2017,60,70,130,79
BUNDIBUGYO,2018,60,70,130,79
BUNDIBUGYO,2019,60,70,130,79
BUNDIBUGYO,2020,70,80,150,79
BUNDIBUGYO,2021,70,80,150,79
BUNDIBUGYO,2022,70,80,150,79
BUNDIBUGYO,2023,70,90,160,79
BUNDIBUGYO,2024,60,80,140,79
BUNDIBUGYO,2025,60,70,130,79
BUNYANGABU,2015,60,70,130,79
BUNYANGABU,2016,60,80,140,79
BUNYANGABU,2017,70,90,160,79
BUNYANGABU,2018,70,120,190,79
BUNYANGABU,2019,70,120,190,79
BUNYANGABU,2020,80,130,210,79
BUNYANGABU,2021,90,140,230,79
BUNYANGABU,2022,80,130,210,79
BUNYANGABU,2023,80,120,200,79
BUNYANGABU,2024,70,110,180,79
BUNYANGABU,2025,70,100,170,79
BUSHENYI,2015,90,100,190,79
BUSHENYI,2016,100,110,210,79
BUSHENYI,2017,100,110,210,79
BUSHENYI,2018,100,110,210,79
BUSHENYI,2019,100,110,210,79
BUSHENYI,2020,100,110,210,79
BUSHENYI,2021,100,110,210,79
BUSHENYI,2022,100,110,210,79
BUSHENYI,2023,100,110,210,79
BUSHENYI,2024,100,110,210,79
BUSHENYI,2025,100,110,210,79
BUSIA,2015,120,150,270,79
BUSIA,2016,130,170,300,79
BUSIA,2017,140,200,340,79
BUSIA,2018,150,240,390,79
BUSIA,2019,150,230,380,79
BUSIA,2020,160,280,440,79
BUSIA,2021,170,290,460,79
BUSIA,2022,170,290,460,79
BUSIA,2023,160,260,420,79
BUSIA,2024,150,230,380,79
BUSIA,2025,150,220,370,79
BUTALEJA,2015,100,110,210,79
BUTALEJA,2016,110,140,250,79
BUTALEJA,2017,110,160,270,79
BUTALEJA,2018,120,190,310,79
BUTALEJA,2019,130,190,320,79
BUTALEJA,2020,130,210,340,79
BUTALEJA,2021,150,240,390,79
BUTALEJA,2022,140,220,360,79
BUTALEJA,2023,130,220,350,79
BUTALEJA,2024,130,190,320,79
BUTALEJA,2025,130,190,320,79
BUTAMBALA,2015,20,40,60,79
BUTAMBALA,2016,20,50,70,79
BUTAMBALA,2017,20,50,70,79
BUTAMBALA,2018,20,60,80,79
BUTAMBALA,2019,20,60,80,79
BUTAMBALA,2020,20,70,90,79
BUTAMBALA,2021,40,70,110,79
BUTAMBALA,2022,40,60,100,79
BUTAMBALA,2023,30,60,90,79
BUTAMBALA,2024,30,50,80,79
BUTAMBALA,2025,30,50,80,79
BUTEBO,2015,40,50,90,79
BUTEBO,2016,40,60,100,79
BUTEBO,2017,50,70,120,79
BUTEBO,2018,50,90,140,79
BUTEBO,2019,50,90,140,79
BUTEBO,2020,50,100,150,79
BUTEBO,2021,50,100,150,79
BUTEBO,2022,50,100,150,79
BUTEBO,2023,40,90,130,79
BUTEBO,2024,50,80,130,79
BUTEBO,2025,50,70,120,79
BUVUMA,2015,10,10,20,79
BUVUMA,2016,10,10,20,79
BUVUMA,2017,10,10,20,79
BUVUMA,2018,10,10,20,79
BUVUMA,2019,10,10,20,79
BUVUMA,2020,10,10,20,79
BUVUMA,2021,10,10,20,79
BUVUMA,2022,10,10,20,79
BUVUMA,2023,10,10,20,79
BUVUMA,2024,10,10,20,79
BUVUMA,2025,10,10,20,79
BUYENDE,2015,110,90,200,79
BUYENDE,2016,110,100,210,79
BUYENDE,2017,130,130,260,79
BUYENDE,2018,130,150,280,79
BUYENDE,2019,140,160,300,79
BUYENDE,2020,150,180,330,79
BUYENDE,2021,160,200,360,79
BUYENDE,2022,150,190,340,79
BUYENDE,2023,150,170,320,79
BUYENDE,2024,150,170,320,79
BUYENDE,2025,150,150,300,79
DOKOLO,2015,70,60,130,79
DOKOLO,2016,80,70,150,79
DOKOLO,2017,80,70,150,79
DOKOLO,2018,80,70,150,79
DOKOLO,2019,80,70,150,79
DOKOLO,2020,90,70,160,79
DOKOLO,2021,90,70,160,79
DOKOLO,2022,90,80,170,79
DOKOLO,2023,90,80,170,79
DOKOLO,2024,100,80,180,79
DOKOLO,2025,100,80,180,79
GOMBA,2015,50,50,100,79
GOMBA,2016,50,60,110,79
GOMBA,2017,70,70,140,79
GOMBA,2018,70,90,160,79
GOMBA,2019,70,90,160,79
GOMBA,2020,70,100,170,79
GOMBA,2021,70,100,170,79
GOMBA,2022,70,100,170,79
GOMBA,2023,70,90,160,79
GOMBA,2024,60,80,140,79
GOMBA,2025,60,70,130,79
GULU,2015,60,60,120,79
GULU,2016,60,60,120,79
GULU,2017,60,60,120,79
GULU,2018,70,60,130,79
GULU,2019,70,60,130,79
GULU,2020,70,70,140,79
GULU,2021,70,70,140,79
GULU,2022,70,70,140,79
GULU,2023,80,70,150,79
GULU,2024,80,70,150,79
GULU,2025,80,70,150,79
HOIMA,2015,90,100,190,79
HOIMA,2016,90,100,190,79
HOIMA,2017,90,110,200,79
HOIMA,2018,100,110,210,79
HOIMA,2019,100,110,210,79
HOIMA,2020,110,120,230,79
HOIMA,2021,110,120,230,79
HOIMA,2022,110,120,230,79
HOIMA,2023,120,130,250,79
HOIMA,2024,120,130,250,79
HOIMA,2025,120,140,260,79
IBANDA,2015,80,80,160,79
IBANDA,2016,80,80,160,79
IBANDA,2017,90,80,170,79
IBANDA,2018,90,80,170,79
IBANDA,2019,90,90,180,79
IBANDA,2020,90,90,180,79
IBANDA,2021,90,90,180,79
IBANDA,2022,90,90,180,79
IBANDA,2023,100,90,190,79
IBANDA,2024,100,90,190,79
IBANDA,2025,100,90,190,79
IGANGA,2015,80,110,190,79
IGANGA,2016,90,140,230,79
IGANGA,2017,100,160,260,79
IGANGA,2018,110,180,290,79
IGANGA,2019,100,190,290,79
IGANGA,2020,120,210,330,79
IGANGA,2021,120,220,340,79
IGANGA,2022,120,220,340,79
IGANGA,2023,110,200,310,79
IGANGA,2024,110,190,300,79
IGANGA,2025,110,170,280,79
ISINGIRO,2015,120,150,270,79
ISINGIRO,2016,120,150,270,79
ISINGIRO,2017,120,160,280,79
ISINGIRO,2018,130,160,290,79
ISINGIRO,2019,130,170,300,79
ISINGIRO,2020,140,180,320,79
ISINGIRO,2021,140,180,320,79
ISINGIRO,2022,150,190,340,79
ISINGIRO,2023,150,190,340,79
ISINGIRO,2024,160,200,360,79
ISINGIRO,2025,160,210,370,79
JINJA,2015,100,140,240,79
JINJA,2016,110,150,260,79
JINJA,2017,110,150,260,79
JINJA,2018,110,150,260,79
JINJA,2019,110,150,260,79
JINJA,2020,110,150,260,79
JINJA,2021,110,160,270,79
JINJA,2022,120,160,280,79
JINJA,2023,120,160,280,79
JINJA,2024,120,160,280,79
JINJA,2025,120,160,280,79
KAABONG,2015,40,40,80,79
KAABONG,2016,40,40,80,79
KAABONG,2017,40,40,80,79
KAABONG,2018,40,40,80,79
KAABONG,2019,40,40,80,79
KAABONG,2020,40,40,80,79
KAABONG,2021,40,40,80,79
KAABONG,2022,40,40,80,79
KAABONG,2023,40,40,80,79
KAABONG,2024,50,20,70,79
KAABONG,2025,50,20,70,79
KABALE,2015,80,120,200,79
KABALE,2016,80,120,200,79
KABALE,2017,80,120,200,79
KABALE,2018,80,130,210,79
KABALE,2019,80,130,210,79
KABALE,2020,80,130,210,79
KABALE,2021,90,130,220,79
KABALE,2022,90,130,220,79
KABALE,2023,90,130,220,79
KABALE,2024,90,130,220,79
KABALE,2025,90,130,220,79
KABAROLE,2015,90,110,200,79
KABAROLE,2016,90,110,200,79
KABAROLE,2017,90,110,200,79
KABAROLE,2018,100,110,210,79
KABAROLE,2019,100,120,220,79
KABAROLE,2020,100,120,220,79
KABAROLE,2021,100,120,220,79
KABAROLE,2022,100,120,220,79
KABAROLE,2023,110,130,240,79
KABAROLE,2024,110,130,240,79
KABAROLE,2025,110,130,240,79
KABERAMAIDO,2015,40,50,90,79
KABERAMAIDO,2016,40,70,110,79
KABERAMAIDO,2017,50,80,130,79
KABERAMAIDO,2018,60,90,150,79
KABERAMAIDO,2019,60,90,150,79
KABERAMAIDO,2020,60,110,170,79
KABERAMAIDO,2021,60,120,180,79
KABERAMAIDO,2022,70,110,180,79
KABERAMAIDO,2023,70,100,170,79
KABERAMAIDO,2024,60,100,160,79
KABERAMAIDO,2025,60,90,150,79
KAGADI,2015,70,80,150,79
KAGADI,2016,80,90,170,79
KAGADI,2017,80,90,170,79
KAGADI,2018,80,90,170,79
KAGADI,2019,90,100,190,79
KAGADI,2020,90,100,190,79
KAGADI,2021,90,100,190,79
KAGADI,2022,90,110,200,79
KAGADI,2023,100,110,210,79
KAGADI,2024,100,110,210,79
KAGADI,2025,100,120,220,79
KAKUMIRO,2015,60,70,130,79
KAKUMIRO,2016,60,70,130,79
KAKUMIRO,2017,70,80,150,79
KAKUMIRO,2018,70,90,160,79
KAKUMIRO,2019,80,90,170,79
KAKUMIRO,2020,90,100,190,79
KAKUMIRO,2021,100,110,210,79
KAKUMIRO,2022,100,120,220,79
KAKUMIRO,2023,110,130,240,79
KAKUMIRO,2024,120,140,260,79
KAKUMIRO,2025,130,150,280,79
KALAKI,2015,50,50,100,79
KALAKI,2016,50,60,110,79
KALAKI,2017,50,60,110,79
KALAKI,2018,60,60,120,79
KALAKI,2019,60,60,120,79
KALAKI,2020,60,60,120,79
KALAKI,2021,60,70,130,79
KALAKI,2022,70,70,140,79
KALAKI,2023,70,70,140,79
KALAKI,2024,70,70,140,79
KALAKI,2025,70,80,150,79
KALANGALA,2015,10,10,20,79
KALANGALA,2016,10,10,20,79
KALANGALA,2017,10,10,20,79
KALANGALA,2018,10,10,20,79
KALANGALA,2019,20,10,30,79
KALANGALA,2020,20,10,30,79
KALANGALA,2021,20,10,30,79
KALANGALA,2022,20,10,30,79
KALANGALA,2023,20,10,30,79
KALANGALA,2024,20,10,30,79
KALANGALA,2025,20,10,30,79
KALIRO,2015,70,60,130,79
KALIRO,2016,90,80,170,79
KALIRO,2017,90,90,180,79
KALIRO,2018,90,100,190,79
KALIRO,2019,90,100,190,79
KALIRO,2020,110,130,240,79
KALIRO,2021,110,140,250,79
KALIRO,2022,110,130,240,79
KALIRO,2023,110,120,230,79
KALIRO,2024,100,110,210,79
KALIRO,2025,100,100,200,79
KALUNGU,2015,70,90,160,79
KALUNGU,2016,80,100,180,79
KALUNGU,2017,80,120,200,79
KALUNGU,2018,80,130,210,79
KALUNGU,2019,80,130,210,79
KALUNGU,2020,80,150,230,79
KALUNGU,2021,90,150,240,79
KALUNGU,2022,80,140,220,79
KALUNGU,2023,80,130,210,79
KALUNGU,2024,80,110,190,79
KALUNGU,2025,80,100,180,79
KAMPALA,2015,140,200,340,79
KAMPALA,2016,140,200,340,79
KAMPALA,2017,140,210,350,79
KAMPALA,2018,140,210,350,79
KAMPALA,2019,150,210,360,79
KAMPALA,2020,150,220,370,79
KAMPALA,2021,150,220,370,79
KAMPALA,2022,150,230,380,79
KAMPALA,2023,160,230,390,79
KAMPALA,2024,160,230,390,79
KAMPALA,2025,160,240,400,79
KAMULI,2015,180,150,330,79
KAMULI,2016,190,180,370,79
KAMULI,2017,200,210,410,79
KAMULI,2018,220,240,460,79
KAMULI,2019,220,250,470,79
KAMULI,2020,240,280,520,79
KAMULI,2021,240,290,530,79
KAMULI,2022,250,290,540,79
KAMULI,2023,230,260,490,79
KAMULI,2024,210,240,450,79
KAMULI,2025,210,220,430,79
KAMWENGE,2015,40,60,100,79
KAMWENGE,2016,40,70,110,79
KAMWENGE,2017,40,70,110,79
KAMWENGE,2018,40,70,110,79
KAMWENGE,2019,50,70,120,79
KAMWENGE,2020,50,80,130,79
KAMWENGE,2021,50,80,130,79
KAMWENGE,2022,50,80,130,79
KAMWENGE,2023,50,80,130,79
KAMWENGE,2024,60,90,150,79
KAMWENGE,2025,60,90,150,79
KANUNGU,2015,60,100,160,79
KANUNGU,2016,70,100,170,79
KANUNGU,2017,70,110,180,79
KANUNGU,2018,70,110,180,79
KANUNGU,2019,70,110,180,79
KANUNGU,2020,70,110,180,79
KANUNGU,2021,70,110,180,79
KANUNGU,2022,70,110,180,79
KANUNGU,2023,70,120,190,79
KANUNGU,2024,80,120,200,79
KANUNGU,2025,80,120,200,79
KAPCHORWA,2015,40,50,90,79
KAPCHORWA,2016,40,50,90,79
KAPCHORWA,2017,40,50,90,79
KAPCHORWA,2018,40,50,90,79
KAPCHORWA,2019,40,60,100,79
KAPCHORWA,2020,40,60,100,79
KAPCHORWA,2021,40,60,100,79
KAPCHORWA,2022,40,60,100,79
KAPCHORWA,2023,50,60,110,79
KAPCHORWA,2024,50,60,110,79
KAPCHORWA,2025,50,60,110,79
KAPELEBYONG,2015,30,20,50,79
KAPELEBYONG,2016,30,20,50,79
KAPELEBYONG,2017,30,30,60,79
KAPELEBYONG,2018,40,30,70,79
KAPELEBYONG,2019,30,30,60,79
KAPELEBYONG,2020,40,30,70,79
KAPELEBYONG,2021,40,30,70,79
KAPELEBYONG,2022,40,30,70,79
KAPELEBYONG,2023,40,30,70,79
KAPELEBYONG,2024,40,30,70,79
KAPELEBYONG,2025,40,20,60,79
KASESE,2015,120,110,230,79
KASESE,2016,130,140,270,79
KASESE,2017,140,160,300,79
KASESE,2018,140,180,320,79
KASESE,2019,140,180,320,79
KASESE,2020,160,210,370,79
KASESE,2021,160,220,380,79
KASESE,2022,150,210,360,79
KASESE,2023,150,190,340,79
KASESE,2024,140,180,320,79
KASESE,2025,140,160,300,79
KASSANDA,2015,90,70,160,79
KASSANDA,2016,90,70,160,79
KASSANDA,2017,90,70,160,79
KASSANDA,2018,100,70,170,79
KASSANDA,2019,100,70,170,79
KASSANDA,2020,100,70,170,79
KASSANDA,2021,100,80,180,79
KASSANDA,2022,110,80,190,79
KASSANDA,2023,110,80,190,79
KASSANDA,2024,110,80,190,79
KASSANDA,2025,110,80,190,79
KATAKWI,2015,80,80,160,79
KATAKWI,2016,90,90,180,79
KATAKWI,2017,90,110,200,79
KATAKWI,2018,90,130,220,79
KATAKWI,2019,100,130,230,79
KATAKWI,2020,110,150,260,79
KATAKWI,2021,110,150,260,79
KATAKWI,2022,110,140,250,79
KATAKWI,2023,110,140,250,79
KATAKWI,2024,100,130,230,79
KATAKWI,2025,100,120,220,79
KAYUNGA,2015,140,120,260,79
KAYUNGA,2016,140,150,290,79
KAYUNGA,2017,150,170,320,79
KAYUNGA,2018,170,190,360,79
KAYUNGA,2019,160,190,350,79
KAYUNGA,2020,170,210,380,79
KAYUNGA,2021,170,240,410,79
KAYUNGA,2022,180,220,400,79
KAYUNGA,2023,160,200,360,79
KAYUNGA,2024,150,180,330,79
KAYUNGA,2025,150,160,310,79
KAZO,2015,50,40,90,79
KAZO,2016,50,40,90,79
KAZO,2017,50,40,90,79
KAZO,2018,60,40,100,79
KAZO,2019,60,40,100,79
KAZO,2020,60,40,100,79
KAZO,2021,60,40,100,79
KAZO,2022,60,50,110,79
KAZO,2023,70,50,120,79
KAZO,2024,70,50,120,79
KAZO,2025,70,50,120,79
KIBAALE,2015,30,40,70,79
KIBAALE,2016,30,40,70,79
KIBAALE,2017,40,40,80,79
KIBAALE,2018,40,50,90,79
KIBAALE,2019,40,50,90,79
KIBAALE,2020,40,50,90,79
KIBAALE,2021,50,50,100,79
KIBAALE,2022,50,60,110,79
KIBAALE,2023,50,60,110,79
KIBAALE,2024,50,60,110,79
KIBAALE,2025,60,70,130,79
KIBOGA,2015,50,50,100,79
KIBOGA,2016,60,50,110,79
KIBOGA,2017,60,50,110,79
KIBOGA,2018,60,50,110,79
KIBOGA,2019,60,50,110,79
KIBOGA,2020,60,50,110,79
KIBOGA,2021,60,60,120,79
KIBOGA,2022,70,60,130,79
KIBOGA,2023,70,60,130,79
KIBOGA,2024,70,60,130,79
KIBOGA,2025,70,60,130,79
KIBUKU,2015,70,90,160,79
KIBUKU,2016,80,120,200,79
KIBUKU,2017,80,130,210,79
KIBUKU,2018,80,160,240,79
KIBUKU,2019,90,160,250,79
KIBUKU,2020,100,180,280,79
KIBUKU,2021,100,200,300,79
KIBUKU,2022,100,190,290,79
KIBUKU,2023,100,190,290,79
KIBUKU,2024,90,170,260,79
KIBUKU,2025,90,150,240,79
KIKUUBE,2015,60,60,120,79
KIKUUBE,2016,60,60,120,79
KIKUUBE,2017,60,60,120,79
KIKUUBE,2018,70,70,140,79
KIKUUBE,2019,70,70,140,79
KIKUUBE,2020,70,70,140,79
KIKUUBE,2021,80,80,160,79
KIKUUBE,2022,80,80,160,79
KIKUUBE,2023,80,80,160,79
KIKUUBE,2024,90,90,180,79
KIKUUBE,2025,90,90,180,79
KIRUHURA,2015,40,50,90,79
KIRUHURA,2016,40,50,90,79
KIRUHURA,2017,50,50,100,79
KIRUHURA,2018,50,50,100,79
KIRUHURA,2019,50,50,100,79
KIRUHURA,2020,50,50,100,79
KIRUHURA,2021,50,60,110,79
KIRUHURA,2022,50,60,110,79
KIRUHURA,2023,60,60,120,79
KIRUHURA,2024,60,60,120,79
KIRUHURA,2025,60,60,120,79
KIRYANDONGO,2015,50,50,100,79
KIRYANDONGO,2016,50,60,110,79
KIRYANDONGO,2017,60,70,130,79
KIRYANDONGO,2018,60,90,150,79
KIRYANDONGO,2019,60,90,150,79
KIRYANDONGO,2020,60,100,160,79
KIRYANDONGO,2021,60,100,160,79
KIRYANDONGO,2022,70,100,170,79
KIRYANDONGO,2023,70,90,160,79
KIRYANDONGO,2024,60,80,140,79
KIRYANDONGO,2025,60,80,140,79
KISORO,2015,80,90,170,79
KISORO,2016,90,100,190,79
KISORO,2017,90,120,210,79
KISORO,2018,90,150,240,79
KISORO,2019,90,150,240,79
KISORO,2020,100,160,260,79
KISORO,2021,110,170,280,79
KISORO,2022,110,160,270,79
KISORO,2023,100,140,240,79
KISORO,2024,90,140,230,79
KISORO,2025,90,130,220,79
KITAGWENDA,2015,40,40,80,79
KITAGWENDA,2016,50,40,90,79
KITAGWENDA,2017,50,40,90,79
KITAGWENDA,2018,50,40,90,79
KITAGWENDA,2019,50,40,90,79
KITAGWENDA,2020,50,50,100,79
KITAGWENDA,2021,50,50,100,79
KITAGWENDA,2022,60,50,110,79
KITAGWENDA,2023,60,50,110,79
KITAGWENDA,2024,60,50,110,79
KITAGWENDA,2025,60,50,110,79
KITGUM,2015,60,80,140,79
KITGUM,2016,60,90,150,79
KITGUM,2017,80,120,200,79
KITGUM,2018,80,130,210,79
KITGUM,2019,80,130,210,79
KITGUM,2020,80,150,230,79
KITGUM,2021,90,150,240,79
KITGUM,2022,80,140,220,79
KITGUM,2023,80,130,210,79
KITGUM,2024,70,110,180,79
KITGUM,2025,70,120,190,79
KOBOKO,2015,40,30,70,79
KOBOKO,2016,50,50,100,79
KOBOKO,2017,60,50,110,79
KOBOKO,2018,60,60,120,79
KOBOKO,2019,60,60,120,79
KOBOKO,2020,60,70,130,79
KOBOKO,2021,70,70,140,79
KOBOKO,2022,70,60,130,79
KOBOKO,2023,70,70,140,79
KOBOKO,2024,60,60,120,79
KOBOKO,2025,70,60,130,79
KOLE,2015,120,110,230,79
KOLE,2016,130,120,250,79
KOLE,2017,130,120,250,79
KOLE,2018,140,120,260,79
KOLE,2019,140,130,270,79
KOLE,2020,140,130,270,79
KOLE,2021,150,140,290,79
KOLE,2022,150,140,290,79
KOLE,2023,160,140,300,79
KOLE,2024,160,150,310,79
KOLE,2025,170,150,320,79
KOTIDO,2015,40,40,80,79
KOTIDO,2016,40,50,90,79
KOTIDO,2017,50,50,100,79
KOTIDO,2018,50,60,110,79
KOTIDO,2019,50,60,110,79
KOTIDO,2020,50,70,120,79
KOTIDO,2021,50,70,120,79
KOTIDO,2022,50,60,110,79
KOTIDO,2023,40,60,100,79
KOTIDO,2024,50,50,100,79
KOTIDO,2025,50,50,100,79
KUMI,2015,60,110,170,79
KUMI,2016,110,140,250,79
KUMI,2017,110,160,270,79
KUMI,2018,130,180,310,79
KUMI,2019,130,190,320,79
KUMI,2020,130,210,340,79
KUMI,2021,150,220,370,79
KUMI,2022,140,220,360,79
KUMI,2023,130,200,330,79
KUMI,2024,130,180,310,79
KUMI,2025,130,170,300,79
KWANIA,2015,90,80,170,79
KWANIA,2016,90,90,180,79
KWANIA,2017,90,90,180,79
KWANIA,2018,100,90,190,79
KWANIA,2019,100,90,190,79
KWANIA,2020,100,100,200,79
KWANIA,2021,110,100,210,79
KWANIA,2022,110,100,210,79
KWANIA,2023,110,100,210,79
KWANIA,2024,110,110,220,79
KWANIA,2025,120,110,230,79
KWEEN,2015,30,20,50,79
KWEEN,2016,30,30,60,79
KWEEN,2017,30,30,60,79
KWEEN,2018,30,30,60,79
KWEEN,2019,30,30,60,79
KWEEN,2020,30,30,60,79
KWEEN,2021,30,30,60,79
KWEEN,2022,30,30,60,79
KWEEN,2023,30,30,60,79
KWEEN,2024,40,30,70,79
KWEEN,2025,40,30,70,79
KYANKWANZI,2015,50,40,90,79
KYANKWANZI,2016,50,40,90,79
KYANKWANZI,2017,50,40,90,79
KYANKWANZI,2018,60,50,110,79
KYANKWANZI,2019,60,50,110,79
KYANKWANZI,2020,60,50,110,79
KYANKWANZI,2021,70,50,120,79
KYANKWANZI,2022,70,50,120,79
KYANKWANZI,2023,70,60,130,79
KYANKWANZI,2024,80,60,140,79
KYANKWANZI,2025,80,60,140,79
KYEGEGWA,2015,40,80,120,79
KYEGEGWA,2016,50,80,130,79
KYEGEGWA,2017,50,90,140,79
KYEGEGWA,2018,60,90,150,79
KYEGEGWA,2019,60,100,160,79
KYEGEGWA,2020,60,110,170,79
KYEGEGWA,2021,70,120,190,79
KYEGEGWA,2022,80,130,210,79
KYEGEGWA,2023,80,140,220,79
KYEGEGWA,2024,90,150,240,79
KYEGEGWA,2025,90,160,250,79
KYENJOJO,2015,150,150,300,79
KYENJOJO,2016,160,150,310,79
KYENJOJO,2017,160,160,320,79
KYENJOJO,2018,170,160,330,79
KYENJOJO,2019,180,170,350,79
KYENJOJO,2020,180,180,360,79
KYENJOJO,2021,190,180,370,79
KYENJOJO,2022,200,190,390,79
KYENJOJO,2023,210,190,400,79
KYENJOJO,2024,210,200,410,79
KYENJOJO,2025,220,210,430,79
KYOTERA,2015,100,120,220,79
KYOTERA,2016,100,140,240,79
KYOTERA,2017,100,170,270,79
KYOTERA,2018,110,190,300,79
KYOTERA,2019,120,190,310,79
KYOTERA,2020,120,210,330,79
KYOTERA,2021,120,220,340,79
KYOTERA,2022,120,210,330,79
KYOTERA,2023,110,190,300,79
KYOTERA,2024,100,180,280,79
KYOTERA,2025,100,160,260,79
KARENGA,2015,10,20,30,79
KARENGA,2016,10,20,30,79
KARENGA,2017,10,20,30,79
KARENGA,2018,10,20,30,79
KARENGA,2019,10,20,30,79
KARENGA,2020,10,20,30,79
KARENGA,2021,10,20,30,79
KARENGA,2022,10,20,30,79
KARENGA,2023,20,30,50,79
KARENGA,2024,20,30,50,79
KARENGA,2025,20,30,50,79
LAMWO,2015,50,60,110,79
LAMWO,2016,50,70,120,79
LAMWO,2017,60,80,140,79
LAMWO,2018,60,90,150,79
LAMWO,2019,60,90,150,79
LAMWO,2020,60,100,160,79
LAMWO,2021,60,100,160,79
LAMWO,2022,60,110,170,79
LAMWO,2023,50,100,150,79
LAMWO,2024,50,90,140,79
LAMWO,2025,50,80,130,79
LIRA,2015,110,90,200,79
LIRA,2016,110,90,200,79
LIRA,2017,120,100,220,79
LIRA,2018,120,100,220,79
LIRA,2019,120,100,220,79
LIRA,2020,130,100,230,79
LIRA,2021,130,110,240,79
LIRA,2022,130,110,240,79
LIRA,2023,140,110,250,79
LIRA,2024,140,110,250,79
LIRA,2025,140,120,260,79
LUUKA,2015,70,100,170,79
LUUKA,2016,80,120,200,79
LUUKA,2017,80,130,210,79
LUUKA,2018,80,150,230,79
LUUKA,2019,80,160,240,79
LUUKA,2020,80,180,260,79
LUUKA,2021,100,190,290,79
LUUKA,2022,100,180,280,79
LUUKA,2023,90,160,250,79
LUUKA,2024,80,140,220,79
LUUKA,2025,80,140,220,79
LUWERO,2015,150,180,330,79
LUWERO,2016,160,210,370,79
LUWERO,2017,170,250,420,79
LUWERO,2018,190,280,470,79
LUWERO,2019,180,280,460,79
LUWERO,2020,190,330,520,79
LUWERO,2021,210,340,550,79
LUWERO,2022,200,340,540,79
LUWERO,2023,200,300,500,79
LUWERO,2024,180,270,450,79
LUWERO,2025,180,260,440,79
LWENGO,2015,80,110,190,79
LWENGO,2016,90,130,220,79
LWENGO,2017,90,150,240,79
LWENGO,2018,90,160,250,79
LWENGO,2019,90,160,250,79
LWENGO,2020,100,180,280,79
LWENGO,2021,100,190,290,79
LWENGO,2022,100,180,280,79
LWENGO,2023,100,160,260,79
LWENGO,2024,90,150,240,79
LWENGO,2025,90,140,230,79
LYANTONDE,2015,30,20,50,79
LYANTONDE,2016,30,30,60,79
LYANTONDE,2017,30,40,70,79
LYANTONDE,2018,40,40,80,79
LYANTONDE,2019,50,40,90,79
LYANTONDE,2020,50,50,100,79
LYANTONDE,2021,50,50,100,79
LYANTONDE,2022,50,50,100,79
LYANTONDE,2023,40,40,80,79
LYANTONDE,2024,40,40,80,79
LYANTONDE,2025,40,30,70,79
MANAFWA,2015,110,120,230,79
MANAFWA,2016,120,130,250,79
MANAFWA,2017,120,130,250,79
MANAFWA,2018,120,130,250,79
MANAFWA,2019,130,130,260,79
MANAFWA,2020,130,140,270,79
MANAFWA,2021,130,140,270,79
MANAFWA,2022,130,140,270,79
MANAFWA,2023,140,150,290,79
MANAFWA,2024,140,150,290,79
MANAFWA,2025,140,150,290,79
MARACHA,2015,50,50,100,79
MARACHA,2016,50,50,100,79
MARACHA,2017,50,50,100,79
MARACHA,2018,50,50,100,79
MARACHA,2019,50,50,100,79
MARACHA,2020,50,50,100,79
MARACHA,2021,50,50,100,79
MARACHA,2022,50,50,100,79
MARACHA,2023,50,50,100,79
MARACHA,2024,50,50,100,79
MARACHA,2025,60,60,120,79
MASAKA,2015,100,80,180,79
MASAKA,2016,110,90,200,79
MASAKA,2017,110,120,230,79
MASAKA,2018,120,130,250,79
MASAKA,2019,120,130,250,79
MASAKA,2020,130,150,280,79
MASAKA,2021,130,150,280,79
MASAKA,2022,130,160,290,79
MASAKA,2023,120,140,260,79
MASAKA,2024,110,130,240,79
MASAKA,2025,120,120,240,79
MASINDI,2015,100,80,180,79
MASINDI,2016,100,80,180,79
MASINDI,2017,100,80,180,79
MASINDI,2018,110,90,200,79
MASINDI,2019,110,90,200,79
MASINDI,2020,110,90,200,79
MASINDI,2021,120,90,210,79
MASINDI,2022,120,100,220,79
MASINDI,2023,120,100,220,79
MASINDI,2024,130,100,230,79
MASINDI,2025,130,100,230,79
MAYUGE,2015,150,120,270,79
MAYUGE,2016,160,140,300,79
MAYUGE,2017,170,170,340,79
MAYUGE,2018,180,190,370,79
MAYUGE,2019,180,210,390,79
MAYUGE,2020,190,230,420,79
MAYUGE,2021,210,240,450,79
MAYUGE,2022,200,240,440,79
MAYUGE,2023,200,220,420,79
MAYUGE,2024,180,200,380,79
MAYUGE,2025,180,190,370,79
MBALE,2015,150,190,340,79
MBALE,2016,160,220,380,79
MBALE,2017,170,270,440,79
MBALE,2018,190,310,500,79
MBALE,2019,180,310,490,79
MBALE,2020,210,360,570,79
MBALE,2021,210,390,600,79
MBALE,2022,210,390,600,79
MBALE,2023,200,350,550,79
MBALE,2024,190,320,510,79
MBALE,2025,180,300,480,79
MBARARA,2015,100,110,210,79
MBARARA,2016,100,110,210,79
MBARARA,2017,100,110,210,79
MBARARA,2018,100,120,220,79
MBARARA,2019,100,120,220,79
MBARARA,2020,110,120,230,79
MBARARA,2021,110,120,230,79
MBARARA,2022,110,130,240,79
MBARARA,2023,110,130,240,79
MBARARA,2024,120,130,250,79
MBARARA,2025,120,130,250,79
MITOOMA,2015,80,70,150,79
MITOOMA,2016,80,70,150,79
MITOOMA,2017,80,70,150,79
MITOOMA,2018,80,70,150,79
MITOOMA,2019,80,70,150,79
MITOOMA,2020,80,70,150,79
MITOOMA,2021,80,70,150,79
MITOOMA,2022,80,70,150,79
MITOOMA,2023,80,70,150,79
MITOOMA,2024,80,70,150,79
MITOOMA,2025,80,70,150,79
MITYANA,2015,150,130,280,79
MITYANA,2016,150,150,300,79
MITYANA,2017,170,170,340,79
MITYANA,2018,180,210,390,79
MITYANA,2019,170,210,380,79
MITYANA,2020,180,230,410,79
MITYANA,2021,200,240,440,79
MITYANA,2022,190,220,410,79
MITYANA,2023,180,220,400,79
MITYANA,2024,160,190,350,79
MITYANA,2025,170,170,340,79
MOROTO,2015,20,40,60,79
MOROTO,2016,20,50,70,79
MOROTO,2017,20,50,70,79
MOROTO,2018,20,60,80,79
MOROTO,2019,20,60,80,79
MOROTO,2020,20,70,90,79
MOROTO,2021,20,70,90,79
MOROTO,2022,20,60,80,79
MOROTO,2023,20,70,90,79
MOROTO,2024,20,60,80,79
MOROTO,2025,20,60,80,79
MOYO,2015,30,40,70,79
MOYO,2016,30,40,70,79
MOYO,2017,30,40,70,79
MOYO,2018,30,40,70,79
MOYO,2019,30,40,70,79
MOYO,2020,30,40,70,79
MOYO,2021,30,40,70,79
MOYO,2022,30,40,70,79
MOYO,2023,30,40,70,79
MOYO,2024,30,40,70,79
MOYO,2025,30,40,70,79
MPIGI,2015,80,80,160,79
MPIGI,2016,90,90,180,79
MPIGI,2017,90,120,210,79
MPIGI,2018,90,130,220,79
MPIGI,2019,100,130,230,79
MPIGI,2020,110,150,260,79
MPIGI,2021,110,150,260,79
MPIGI,2022,110,140,250,79
MPIGI,2023,100,140,240,79
MPIGI,2024,100,130,230,79
MPIGI,2025,100,120,220,79
MUBENDE,2015,80,100,180,79
MUBENDE,2016,100,120,220,79
MUBENDE,2017,100,150,250,79
MUBENDE,2018,120,160,280,79
MUBENDE,2019,120,180,300,79
MUBENDE,2020,130,200,330,79
MUBENDE,2021,130,220,350,79
MUBENDE,2022,140,210,350,79
MUBENDE,2023,130,200,330,79
MUBENDE,2024,130,190,320,79
MUBENDE,2025,60,170,230,79
MUKONO,2015,160,160,320,79
MUKONO,2016,170,200,370,79
MUKONO,2017,180,230,410,79
MUKONO,2018,200,270,470,79
MUKONO,2019,200,260,460,79
MUKONO,2020,210,290,500,79
MUKONO,2021,220,320,540,79
MUKONO,2022,210,320,530,79
MUKONO,2023,210,290,500,79
MUKONO,2024,190,270,460,79
MUKONO,2025,190,240,430,79
MADI OKOLLO,2015,30,30,60,79
MADI OKOLLO,2016,30,40,70,79
MADI OKOLLO,2017,30,40,70,79
MADI OKOLLO,2018,30,40,70,79
MADI OKOLLO,2019,30,40,70,79
MADI OKOLLO,2020,30,40,70,79
MADI OKOLLO,2021,30,40,70,79
MADI OKOLLO,2022,30,40,70,79
MADI OKOLLO,2023,40,40,80,79
MADI OKOLLO,2024,40,40,80,79
MADI OKOLLO,2025,40,40,80,79
NABILATUK,2015,20,20,40,79
NABILATUK,2016,20,20,40,79
NABILATUK,2017,20,30,50,79
NABILATUK,2018,20,30,50,79
NABILATUK,2019,20,40,60,79
NABILATUK,2020,20,50,70,79
NABILATUK,2021,20,50,70,79
NABILATUK,2022,20,50,70,79
NABILATUK,2023,20,40,60,79
NABILATUK,2024,30,40,70,79
NABILATUK,2025,30,30,60,79
NAKAPIRIPIRIT,2015,20,20,40,79
NAKAPIRIPIRIT,2016,30,20,50,79
NAKAPIRIPIRIT,2017,30,40,70,79
NAKAPIRIPIRIT,2018,40,40,80,79
NAKAPIRIPIRIT,2019,30,40,70,79
NAKAPIRIPIRIT,2020,40,50,90,79
NAKAPIRIPIRIT,2021,40,50,90,79
NAKAPIRIPIRIT,2022,40,50,90,79
NAKAPIRIPIRIT,2023,40,40,80,79
NAKAPIRIPIRIT,2024,40,40,80,79
NAKAPIRIPIRIT,2025,40,50,90,79
NAKASEKE,2015,60,50,110,79
NAKASEKE,2016,60,50,110,79
NAKASEKE,2017,60,50,110,79
NAKASEKE,2018,70,50,120,79
NAKASEKE,2019,70,60,130,79
NAKASEKE,2020,70,60,130,79
NAKASEKE,2021,70,60,130,79
NAKASEKE,2022,70,60,130,79
NAKASEKE,2023,80,60,140,79
NAKASEKE,2024,80,60,140,79
NAKASEKE,2025,80,60,140,79
NAKASONGOLA,2015,60,40,100,79
NAKASONGOLA,2016,60,60,120,79
NAKASONGOLA,2017,70,70,140,79
NAKASONGOLA,2018,80,70,150,79
NAKASONGOLA,2019,80,70,150,79
NAKASONGOLA,2020,80,80,160,79
NAKASONGOLA,2021,90,80,170,79
NAKASONGOLA,2022,80,80,160,79
NAKASONGOLA,2023,90,70,160,79
NAKASONGOLA,2024,80,80,160,79
NAKASONGOLA,2025,80,70,150,79
NAMAYINGO,2015,60,60,120,79
NAMAYINGO,2016,60,70,130,79
NAMAYINGO,2017,80,80,160,79
NAMAYINGO,2018,80,90,170,79
NAMAYINGO,2019,80,90,170,79
NAMAYINGO,2020,80,100,180,79
NAMAYINGO,2021,90,100,190,79
NAMAYINGO,2022,80,110,190,79
NAMAYINGO,2023,80,100,180,79
NAMAYINGO,2024,70,90,160,79
NAMAYINGO,2025,70,80,150,79
NAMISINDWA,2015,100,110,210,79
NAMISINDWA,2016,100,110,210,79
NAMISINDWA,2017,110,110,220,79
NAMISINDWA,2018,110,120,230,79
NAMISINDWA,2019,110,120,230,79
NAMISINDWA,2020,120,120,240,79
NAMISINDWA,2021,120,120,240,79
NAMISINDWA,2022,120,130,250,79
NAMISINDWA,2023,120,130,250,79
NAMISINDWA,2024,130,130,260,79
NAMISINDWA,2025,130,130,260,79
NAMUTUMBA,2015,80,80,160,79
NAMUTUMBA,2016,100,90,190,79
NAMUTUMBA,2017,100,120,220,79
NAMUTUMBA,2018,110,130,240,79
NAMUTUMBA,2019,120,130,250,79
NAMUTUMBA,2020,120,150,270,79
NAMUTUMBA,2021,120,170,290,79
NAMUTUMBA,2022,130,160,290,79
NAMUTUMBA,2023,120,140,260,79
NAMUTUMBA,2024,110,140,250,79
NAMUTUMBA,2025,120,130,250,79
NAPAK,2015,40,60,100,79
NAPAK,2016,40,70,110,79
NAPAK,2017,50,90,140,79
NAPAK,2018,50,100,150,79
NAPAK,2019,60,100,160,79
NAPAK,2020,60,110,170,79
NAPAK,2021,60,120,180,79
NAPAK,2022,60,110,170,79
NAPAK,2023,50,100,150,79
NAPAK,2024,50,90,140,79
NAPAK,2025,50,90,140,79
NEBBI,2015,100,110,210,79
NEBBI,2016,100,110,210,79
NEBBI,2017,100,110,210,79
NEBBI,2018,110,120,230,79
NEBBI,2019,110,120,230,79
NEBBI,2020,110,120,230,79
NEBBI,2021,120,130,250,79
NEBBI,2022,120,130,250,79
NEBBI,2023,130,130,260,79
NEBBI,2024,130,130,260,79
NEBBI,2025,130,140,270,79
NGORA,2015,60,60,120,79
NGORA,2016,60,70,130,79
NGORA,2017,70,90,160,79
NGORA,2018,70,100,170,79
NGORA,2019,70,100,170,79
NGORA,2020,80,110,190,79
NGORA,2021,90,120,210,79
NGORA,2022,80,130,210,79
NGORA,2023,80,120,200,79
NGORA,2024,70,100,170,79
NGORA,2025,80,90,170,79
NTOROKO,2015,10,20,30,79
NTOROKO,2016,10,20,30,79
NTOROKO,2017,10,30,40,79
NTOROKO,2018,10,30,40,79
NTOROKO,2019,10,30,40,79
NTOROKO,2020,20,30,50,79
NTOROKO,2021,20,30,50,79
NTOROKO,2022,20,30,50,79
NTOROKO,2023,20,30,50,79
NTOROKO,2024,20,30,50,79
NTOROKO,2025,20,20,40,79
NTUNGAMO,2015,130,170,300,79
NTUNGAMO,2016,130,170,300,79
NTUNGAMO,2017,140,180,320,79
NTUNGAMO,2018,140,180,320,79
NTUNGAMO,2019,140,180,320,79
NTUNGAMO,2020,150,190,340,79
NTUNGAMO,2021,150,190,340,79
NTUNGAMO,2022,150,190,340,79
NTUNGAMO,2023,150,190,340,79
NTUNGAMO,2024,160,200,360,79
NTUNGAMO,2025,160,200,360,79
NWOYA,2015,50,40,90,79
NWOYA,2016,50,50,100,79
NWOYA,2017,60,50,110,79
NWOYA,2018,60,60,120,79
NWOYA,2019,70,60,130,79
NWOYA,2020,70,70,140,79
NWOYA,2021,80,80,160,79
NWOYA,2022,90,80,170,79
NWOYA,2023,100,90,190,79
NWOYA,2024,110,100,210,79
NWOYA,2025,120,110,230,79
OBONGI,2015,10,10,20,79
OBONGI,2016,10,10,20,79
OBONGI,2017,10,10,20,79
OBONGI,2018,10,10,20,79
OBONGI,2019,10,10,20,79
OBONGI,2020,10,20,30,79
OBONGI,2021,10,20,30,79
OBONGI,2022,10,20,30,79
OBONGI,2023,10,10,20,79
OBONGI,2024,10,10,20,79
OBONGI,2025,10,10,20,79
OMORO,2015,50,50,100,79
OMORO,2016,60,70,130,79
OMORO,2017,70,80,150,79
OMORO,2018,70,90,160,79
OMORO,2019,70,90,160,79
OMORO,2020,80,100,180,79
OMORO,2021,90,120,210,79
OMORO,2022,80,110,190,79
OMORO,2023,80,100,180,79
OMORO,2024,70,90,160,79
OMORO,2025,80,80,160,79
OTUKE,2015,20,40,60,79
OTUKE,2016,30,40,70,79
OTUKE,2017,30,40,70,79
OTUKE,2018,30,50,80,79
OTUKE,2019,30,50,80,79
OTUKE,2020,30,50,80,79
OTUKE,2021,30,50,80,79
OTUKE,2022,30,60,90,79
OTUKE,2023,30,60,90,79
OTUKE,2024,40,60,100,79
OTUKE,2025,40,60,100,79
OYAM,2015,160,170,330,79
OYAM,2016,170,170,340,79
OYAM,2017,180,180,360,79
OYAM,2018,180,180,360,79
OYAM,2019,190,190,380,79
OYAM,2020,190,200,390,79
OYAM,2021,200,200,400,79
OYAM,2022,200,210,410,79
OYAM,2023,210,210,420,79
OYAM,2024,210,220,430,79
OYAM,2025,220,220,440,79
PADER,2015,40,50,90,79
PADER,2016,40,60,100,79
PADER,2017,50,70,120,79
PADER,2018,50,90,140,79
PADER,2019,50,90,140,79
PADER,2020,50,100,150,79
PADER,2021,50,100,150,79
PADER,2022,50,100,150,79
PADER,2023,40,90,130,79
PADER,2024,40,80,120,79
PADER,2025,40,70,110,79
PAKWACH,2015,50,50,100,79
PAKWACH,2016,50,50,100,79
PAKWACH,2017,50,60,110,79
PAKWACH,2018,50,60,110,79
PAKWACH,2019,50,60,110,79
PAKWACH,2020,60,60,120,79
PAKWACH,2021,60,60,120,79
PAKWACH,2022,60,70,130,79
PAKWACH,2023,60,70,130,79
PAKWACH,2024,70,70,140,79
PAKWACH,2025,70,70,140,79
PALLISA,2015,110,110,220,79
PALLISA,2016,110,130,240,79
PALLISA,2017,130,160,290,79
PALLISA,2018,130,180,310,79
PALLISA,2019,140,190,330,79
PALLISA,2020,150,210,360,79
PALLISA,2021,160,240,400,79
PALLISA,2022,150,220,370,79
PALLISA,2023,150,220,370,79
PALLISA,2024,140,190,330,79
PALLISA,2025,150,190,340,79
RAKAI,2015,80,70,150,79
RAKAI,2016,90,80,170,79
RAKAI,2017,100,90,190,79
RAKAI,2018,110,100,210,79
RAKAI,2019,100,100,200,79
RAKAI,2020,110,110,220,79
RAKAI,2021,120,140,260,79
RAKAI,2022,120,130,250,79
RAKAI,2023,110,120,230,79
RAKAI,2024,100,100,200,79
RAKAI,2025,100,90,190,79
RUBANDA,2015,60,80,140,79
RUBANDA,2016,60,80,140,79
RUBANDA,2017,60,80,140,79
RUBANDA,2018,60,80,140,79
RUBANDA,2019,60,80,140,79
RUBANDA,2020,60,80,140,79
RUBANDA,2021,70,80,150,79
RUBANDA,2022,70,80,150,79
RUBANDA,2023,70,80,150,79
RUBANDA,2024,70,80,150,79
RUBANDA,2025,70,80,150,79
RUBIRIZI,2015,50,40,90,79
RUBIRIZI,2016,50,40,90,79
RUBIRIZI,2017,50,40,90,79
RUBIRIZI,2018,50,40,90,79
RUBIRIZI,2019,50,40,90,79
RUBIRIZI,2020,50,40,90,79
RUBIRIZI,2021,50,40,90,79
RUBIRIZI,2022,50,40,90,79
RUBIRIZI,2023,60,40,100,79
RUBIRIZI,2024,60,40,100,79
RUBIRIZI,2025,60,40,100,79
RUKIGA,2015,40,60,100,79
RUKIGA,2016,40,60,100,79
RUKIGA,2017,50,60,110,79
RUKIGA,2018,50,60,110,79
RUKIGA,2019,50,60,110,79
RUKIGA,2020,50,60,110,79
RUKIGA,2021,50,60,110,79
RUKIGA,2022,50,60,110,79
RUKIGA,2023,50,60,110,79
RUKIGA,2024,50,60,110,79
RUKIGA,2025,50,60,110,79
RUKUNGIRI,2015,120,160,280,79
RUKUNGIRI,2016,120,160,280,79
RUKUNGIRI,2017,120,160,280,79
RUKUNGIRI,2018,120,160,280,79
RUKUNGIRI,2019,120,170,290,79
RUKUNGIRI,2020,130,170,300,79
RUKUNGIRI,2021,130,170,300,79
RUKUNGIRI,2022,130,170,300,79
RUKUNGIRI,2023,130,170,300,79
RUKUNGIRI,2024,130,170,300,79
RUKUNGIRI,2025,130,170,300,79
RWAMPARA,2015,40,60,100,79
RWAMPARA,2016,40,60,100,79
RWAMPARA,2017,40,60,100,79
RWAMPARA,2018,40,60,100,79
RWAMPARA,2019,40,60,100,79
RWAMPARA,2020,40,60,100,79
RWAMPARA,2021,40,60,100,79
RWAMPARA,2022,40,60,100,79
RWAMPARA,2023,40,70,110,79
RWAMPARA,2024,40,70,110,79
RWAMPARA,2025,50,70,120,79
SERERE,2015,120,120,240,79
SERERE,2016,120,140,260,79
SERERE,2017,140,170,310,79
SERERE,2018,140,190,330,79
SERERE,2019,150,210,360,79
SERERE,2020,160,230,390,79
SERERE,2021,170,250,420,79
SERERE,2022,170,260,430,79
SERERE,2023,160,230,390,79
SERERE,2024,150,220,370,79
SERERE,2025,160,200,360,79
SHEEMA,2015,100,110,210,79
SHEEMA,2016,100,110,210,79
SHEEMA,2017,100,110,210,79
SHEEMA,2018,100,110,210,79
SHEEMA,2019,100,110,210,79
SHEEMA,2020,100,110,210,79
SHEEMA,2021,100,110,210,79
SHEEMA,2022,100,110,210,79
SHEEMA,2023,100,110,210,79
SHEEMA,2024,110,110,220,79
SHEEMA,2025,110,120,230,79
SIRONKO,2015,130,170,300,79
SIRONKO,2016,130,170,300,79
SIRONKO,2017,130,170,300,79
SIRONKO,2018,140,180,320,79
SIRONKO,2019,140,180,320,79
SIRONKO,2020,140,180,320,79
SIRONKO,2021,150,190,340,79
SIRONKO,2022,150,190,340,79
SIRONKO,2023,150,190,340,79
SIRONKO,2024,160,200,360,79
SIRONKO,2025,160,200,360,79
SOROTI,2015,70,100,170,79
SOROTI,2016,80,130,210,79
SOROTI,2017,90,150,240,79
SOROTI,2018,90,160,250,79
SOROTI,2019,90,180,270,79
SOROTI,2020,110,200,310,79
SOROTI,2021,110,220,330,79
SOROTI,2022,110,210,320,79
SOROTI,2023,110,190,300,79
SOROTI,2024,100,180,280,79
SOROTI,2025,100,160,260,79
SSEMBABULE,2015,70,80,150,79
SSEMBABULE,2016,90,90,180,79
SSEMBABULE,2017,90,110,200,79
SSEMBABULE,2018,90,120,210,79
SSEMBABULE,2019,90,120,210,79
SSEMBABULE,2020,110,150,260,79
SSEMBABULE,2021,110,150,260,79
SSEMBABULE,2022,110,140,250,79
SSEMBABULE,2023,100,130,230,79
SSEMBABULE,2024,100,110,210,79
SSEMBABULE,2025,100,120,220,79
TORORO,2015,210,250,460,79
TORORO,2016,210,260,470,79
TORORO,2017,220,260,480,79
TORORO,2018,230,270,500,79
TORORO,2019,230,280,510,79
TORORO,2020,240,280,520,79
TORORO,2021,240,290,530,79
TORORO,2022,250,290,540,79
TORORO,2023,260,300,560,79
TORORO,2024,260,310,570,79
TORORO,2025,270,310,580,79
WAKISO,2015,270,420,690,79
WAKISO,2016,290,440,730,79
WAKISO,2017,310,470,780,79
WAKISO,2018,330,510,840,79
WAKISO,2019,350,540,890,79
WAKISO,2020,370,580,950,79
WAKISO,2021,400,610,1010,79
WAKISO,2022,420,660,1080,79
WAKISO,2023,450,700,1150,79
WAKISO,2024,480,740,1220,79
WAKISO,2025,510,790,1300,79
YUMBE,2015,100,70,170,79
YUMBE,2016,100,90,190,79
YUMBE,2017,110,110,220,79
YUMBE,2018,120,130,250,79
YUMBE,2019,130,130,260,79
YUMBE,2020,130,160,290,79
YUMBE,2021,150,170,320,79
YUMBE,2022,140,180,320,79
YUMBE,2023,140,170,310,79
YUMBE,2024,140,150,290,79
YUMBE,2025,140,150,290,79
ZOMBO,2015,80,110,190,79
ZOMBO,2016,80,110,190,79
ZOMBO,2017,80,120,200,79
ZOMBO,2018,90,120,210,79
ZOMBO,2019,90,120,210,79
ZOMBO,2020,90,130,220,79
ZOMBO,2021,100,130,230,79
ZOMBO,2022,100,130,230,79
ZOMBO,2023,100,140,240,79
ZOMBO,2024,100,140,240,79
ZOMBO,2025,110,140,250,79
ABIM,2015,2220,2280,4500,8
ABIM,2016,2340,2390,4730,8
ABIM,2017,2470,2490,4960,8
ABIM,2018,2570,2570,5140,8
ABIM,2019,2680,2650,5330,8
ABIM,2020,2780,2760,5540,8
ABIM,2021,2950,2910,5860,8
ABIM,2022,3200,3120,6320,8
ABIM,2023,3330,3430,6760,8
ABIM,2024,3510,3600,7110,8
ABIM,2025,3690,3770,7460,8
ADJUMANI,2015,3880,3610,7490,8
ADJUMANI,2016,3910,3650,7560,8
ADJUMANI,2017,3940,3680,7620,8
ADJUMANI,2018,3960,3720,7680,8
ADJUMANI,2019,3990,3750,7740,8
ADJUMANI,2020,4010,3780,7790,8
ADJUMANI,2021,4030,3810,7840,8
ADJUMANI,2022,4050,3840,7890,8
ADJUMANI,2023,4070,3860,7930,8
ADJUMANI,2024,4080,3890,7970,8
ADJUMANI,2025,4090,3910,8000,8
AGAGO,2015,4440,4200,8640,8
AGAGO,2016,4520,4280,8800,8
AGAGO,2017,4600,4350,8950,8
AGAGO,2018,4680,4430,9110,8
AGAGO,2019,4750,4500,9250,8
AGAGO,2020,4830,4580,9410,8
AGAGO,2021,4900,4650,9550,8
AGAGO,2022,4970,4720,9690,8
AGAGO,2023,5050,4780,9830,8
AGAGO,2024,5110,4850,9960,8
AGAGO,2025,5170,4910,10080,8
ALEBTONG,2015,4250,3980,8230,8
ALEBTONG,2016,4330,4020,8350,8
ALEBTONG,2017,4410,4070,8480,8
ALEBTONG,2018,4430,4050,8480,8
ALEBTONG,2019,4460,4060,8520,8
ALEBTONG,2020,4480,4090,8570,8
ALEBTONG,2021,4570,4160,8730,8
ALEBTONG,2022,4800,4330,9130,8
ALEBTONG,2023,4830,4590,9420,8
ALEBTONG,2024,4920,4670,9590,8
ALEBTONG,2025,4990,4740,9730,8
AMOLATAR,2015,2550,2360,4910,8
AMOLATAR,2016,2600,2390,4990,8
AMOLATAR,2017,2650,2410,5060,8
AMOLATAR,2018,2660,2390,5050,8
AMOLATAR,2019,2660,2400,5060,8
AMOLATAR,2020,2680,2400,5080,8
AMOLATAR,2021,2720,2440,5160,8
AMOLATAR,2022,2850,2530,5380,8
AMOLATAR,2023,2870,2680,5550,8
AMOLATAR,2024,2910,2720,5630,8
AMOLATAR,2025,2950,2760,5710,8
AMUDAT,2015,2550,2500,5050,8
AMUDAT,2016,2630,2580,5210,8
AMUDAT,2017,2700,2660,5360,8
AMUDAT,2018,2760,2690,5450,8
AMUDAT,2019,2800,2750,5550,8
AMUDAT,2020,2850,2820,5670,8
AMUDAT,2021,2940,2920,5860,8
AMUDAT,2022,3120,3100,6220,8
AMUDAT,2023,3180,3360,6540,8
AMUDAT,2024,3260,3480,6740,8
AMUDAT,2025,3350,3600,6950,8
AMURIA,2015,3140,3050,6190,8
AMURIA,2016,3220,3120,6340,8
AMURIA,2017,3300,3180,6480,8
AMURIA,2018,3360,3180,6540,8
AMURIA,2019,3400,3220,6620,8
AMURIA,2020,3450,3260,6710,8
AMURIA,2021,3560,3350,6910,8
AMURIA,2022,3770,3510,7280,8
AMURIA,2023,3840,3760,7600,8
AMURIA,2024,3930,3840,7770,8
AMURIA,2025,4030,3930,7960,8
AMURU,2015,3490,3310,6800,8
AMURU,2016,3550,3350,6900,8
AMURU,2017,3610,3400,7010,8
AMURU,2018,3630,3370,7000,8
AMURU,2019,3640,3380,7020,8
AMURU,2020,3650,3400,7050,8
AMURU,2021,3720,3460,7180,8
AMURU,2022,3900,3600,7500,8
AMURU,2023,3920,3820,7740,8
AMURU,2024,3980,3880,7860,8
AMURU,2025,4030,3930,7960,8
APAC,2015,3160,3130,6290,8
APAC,2016,3270,3240,6510,8
APAC,2017,3390,3350,6740,8
APAC,2018,3520,3460,6980,8
APAC,2019,3640,3580,7220,8
APAC,2020,3770,3700,7470,8
APAC,2021,3900,3820,7720,8
APAC,2022,4040,3940,7980,8
APAC,2023,4170,4070,8240,8
APAC,2024,4300,4190,8490,8
APAC,2025,4440,4320,8760,8
ARUA,2015,10030,10140,20170,8
ARUA,2016,10330,10410,20740,8
ARUA,2017,10610,10710,21320,8
ARUA,2018,10920,10980,21900,8
ARUA,2019,11230,11280,22510,8
ARUA,2020,11530,11560,23090,8
ARUA,2021,11850,11850,23700,8
ARUA,2022,12150,12140,24290,8
ARUA,2023,12450,12440,24890,8
ARUA,2024,12760,12720,25480,8
ARUA,2025,13060,13010,26070,8
BUDAKA,2015,3760,3580,7340,8
BUDAKA,2016,3850,3650,7500,8
BUDAKA,2017,3950,3720,7670,8
BUDAKA,2018,4010,3720,7730,8
BUDAKA,2019,4050,3760,7810,8
BUDAKA,2020,4110,3810,7920,8
BUDAKA,2021,4230,3910,8140,8
BUDAKA,2022,4480,4100,8580,8
BUDAKA,2023,4540,4370,8910,8
BUDAKA,2024,4650,4470,9120,8
BUDAKA,2025,4750,4580,9330,8
BUDUDA,2015,4090,3830,7920,8
BUDUDA,2016,4230,3950,8180,8
BUDUDA,2017,4380,4070,8450,8
BUDUDA,2018,4490,4110,8600,8
BUDUDA,2019,4590,4200,8790,8
BUDUDA,2020,4680,4290,8970,8
BUDUDA,2021,4870,4450,9320,8
BUDUDA,2022,5200,4720,9920,8
BUDUDA,2023,5320,5090,10410,8
BUDUDA,2024,5490,5260,10750,8
BUDUDA,2025,5670,5430,11100,8
BUGIRI,2015,7140,6820,13960,8
BUGIRI,2016,7360,6990,14350,8
BUGIRI,2017,7590,7150,14740,8
BUGIRI,2018,7740,7200,14940,8
BUGIRI,2019,7860,7300,15160,8
BUGIRI,2020,8020,7430,15450,8
BUGIRI,2021,8290,7660,15950,8
BUGIRI,2022,8810,8070,16880,8
BUGIRI,2023,8980,8660,17640,8
BUGIRI,2024,9250,8910,18160,8
BUGIRI,2025,9500,9150,18650,8
BUGWERI,2015,2970,2700,5670,8
BUGWERI,2016,3020,2730,5750,8
BUGWERI,2017,3070,2750,5820,8
BUGWERI,2018,3090,2740,5830,8
BUGWERI,2019,3100,2740,5840,8
BUGWERI,2020,3120,2760,5880,8
BUGWERI,2021,3180,2800,5980,8
BUGWERI,2022,3340,2910,6250,8
BUGWERI,2023,3350,3090,6440,8
BUGWERI,2024,3400,3130,6530,8
BUGWERI,2025,3460,3180,6640,8
BUHWEJU,2015,2030,2060,4090,8
BUHWEJU,2016,2100,2120,4220,8
BUHWEJU,2017,2160,2190,4350,8
BUHWEJU,2018,2240,2250,4490,8
BUHWEJU,2019,2310,2320,4630,8
BUHWEJU,2020,2380,2390,4770,8
BUHWEJU,2021,2450,2450,4900,8
BUHWEJU,2022,2520,2520,5040,8
BUHWEJU,2023,2600,2590,5190,8
BUHWEJU,2024,2670,2660,5330,8
BUHWEJU,2025,2740,2730,5470,8
BUIKWE,2015,6580,6440,13020,8
BUIKWE,2016,6650,6480,13130,8
BUIKWE,2017,6720,6520,13240,8
BUIKWE,2018,6720,6440,13160,8
BUIKWE,2019,6690,6410,13100,8
BUIKWE,2020,6680,6410,13090,8
BUIKWE,2021,6770,6480,13250,8
BUIKWE,2022,7050,6710,13760,8
BUIKWE,2023,7050,7080,14130,8
BUIKWE,2024,7100,7150,14250,8
BUIKWE,2025,7160,7210,14370,8
BUKEDEA,2015,3670,3690,7360,8
BUKEDEA,2016,3800,3790,7590,8
BUKEDEA,2017,3920,3880,7800,8
BUKEDEA,2018,4010,3910,7920,8
BUKEDEA,2019,4090,3980,8070,8
BUKEDEA,2020,4190,4060,8250,8
BUKEDEA,2021,4340,4190,8530,8
BUKEDEA,2022,4630,4430,9060,8
BUKEDEA,2023,4730,4760,9490,8
BUKEDEA,2024,4880,4910,9790,8
BUKEDEA,2025,5040,5040,10080,8
BUKOMANSIMBI,2015,2600,2380,4980,8
BUKOMANSIMBI,2016,2600,2370,4970,8
BUKOMANSIMBI,2017,2600,2330,4930,8
BUKOMANSIMBI,2018,2560,2270,4830,8
BUKOMANSIMBI,2019,2520,2230,4750,8
BUKOMANSIMBI,2020,2490,2190,4680,8
BUKOMANSIMBI,2021,2490,2190,4680,8
BUKOMANSIMBI,2022,2560,2230,4790,8
BUKOMANSIMBI,2023,2530,2310,4840,8
BUKOMANSIMBI,2024,2520,2290,4810,8
BUKOMANSIMBI,2025,2510,2280,4790,8
BUKWO,2015,1730,1510,3240,8
BUKWO,2016,1820,1580,3400,8
BUKWO,2017,1920,1660,3580,8
BUKWO,2018,2020,1740,3760,8
BUKWO,2019,2120,1820,3940,8
BUKWO,2020,2230,1910,4140,8
BUKWO,2021,2350,2000,4350,8
BUKWO,2022,2470,2090,4560,8
BUKWO,2023,2590,2180,4770,8
BUKWO,2024,2710,2280,4990,8
BUKWO,2025,2840,2380,5220,8
BULAMBULI,2015,3230,3010,6240,8
BULAMBULI,2016,3360,3120,6480,8
BULAMBULI,2017,3500,3220,6720,8
BULAMBULI,2018,3590,3270,6860,8
BULAMBULI,2019,3670,3350,7020,8
BULAMBULI,2020,3780,3440,7220,8
BULAMBULI,2021,3940,3590,7530,8
BULAMBULI,2022,4220,3810,8030,8
BULAMBULI,2023,4340,4140,8480,8
BULAMBULI,2024,4500,4290,8790,8
BULAMBULI,2025,4670,4450,9120,8
BULIISA,2015,1900,1750,3650,8
BULIISA,2016,2010,1820,3830,8
BULIISA,2017,2120,1900,4020,8
BULIISA,2018,2230,1990,4220,8
BULIISA,2019,2350,2070,4420,8
BULIISA,2020,2470,2160,4630,8
BULIISA,2021,2600,2250,4850,8
BULIISA,2022,2740,2350,5090,8
BULIISA,2023,2870,2450,5320,8
BULIISA,2024,3020,2540,5560,8
BULIISA,2025,3160,2640,5800,8
BUNDIBUGYO,2015,3620,3520,7140,8
BUNDIBUGYO,2016,3700,3560,7260,8
BUNDIBUGYO,2017,3770,3600,7370,8
BUNDIBUGYO,2018,3800,3580,7380,8
BUNDIBUGYO,2019,3820,3600,7420,8
BUNDIBUGYO,2020,3850,3620,7470,8
BUNDIBUGYO,2021,3940,3680,7620,8
BUNDIBUGYO,2022,4150,3840,7990,8
BUNDIBUGYO,2023,4180,4070,8250,8
BUNDIBUGYO,2024,4260,4150,8410,8
BUNDIBUGYO,2025,4330,4210,8540,8
BUNYANGABU,2015,2780,2700,5480,8
BUNYANGABU,2016,2830,2720,5550,8
BUNYANGABU,2017,2870,2740,5610,8
BUNYANGABU,2018,2880,2710,5590,8
BUNYANGABU,2019,2890,2700,5590,8
BUNYANGABU,2020,2900,2720,5620,8
BUNYANGABU,2021,2960,2750,5710,8
BUNYANGABU,2022,3090,2850,5940,8
BUNYANGABU,2023,3110,3010,6120,8
BUNYANGABU,2024,3140,3050,6190,8
BUNYANGABU,2025,3190,3080,6270,8
BUSHENYI,2015,3170,3040,6210,8
BUSHENYI,2016,3210,3060,6270,8
BUSHENYI,2017,3250,3090,6340,8
BUSHENYI,2018,3290,3120,6410,8
BUSHENYI,2019,3330,3140,6470,8
BUSHENYI,2020,3370,3170,6540,8
BUSHENYI,2021,3400,3190,6590,8
BUSHENYI,2022,3430,3210,6640,8
BUSHENYI,2023,3460,3230,6690,8
BUSHENYI,2024,3490,3240,6730,8
BUSHENYI,2025,3510,3260,6770,8
BUSIA,2015,5510,5300,10810,8
BUSIA,2016,5630,5370,11000,8
BUSIA,2017,5760,5450,11210,8
BUSIA,2018,5810,5420,11230,8
BUSIA,2019,5850,5450,11300,8
BUSIA,2020,5910,5500,11410,8
BUSIA,2021,6050,5600,11650,8
BUSIA,2022,6370,5850,12220,8
BUSIA,2023,6440,6220,12660,8
BUSIA,2024,6570,6330,12900,8
BUSIA,2025,6690,6440,13130,8
BUTALEJA,2015,4630,4130,8760,8
BUTALEJA,2016,4760,4220,8980,8
BUTALEJA,2017,4890,4310,9200,8
BUTALEJA,2018,4970,4310,9280,8
BUTALEJA,2019,5040,4370,9410,8
BUTALEJA,2020,5120,4430,9550,8
BUTALEJA,2021,5270,4540,9810,8
BUTALEJA,2022,5580,4770,10350,8
BUTALEJA,2023,5670,5110,10780,8
BUTALEJA,2024,5820,5230,11050,8
BUTALEJA,2025,5960,5360,11320,8
BUTAMBALA,2015,1790,1670,3460,8
BUTAMBALA,2016,1810,1670,3480,8
BUTAMBALA,2017,1810,1660,3470,8
BUTAMBALA,2018,1800,1630,3430,8
BUTAMBALA,2019,1770,1600,3370,8
BUTAMBALA,2020,1760,1590,3350,8
BUTAMBALA,2021,1780,1590,3370,8
BUTAMBALA,2022,1840,1630,3470,8
BUTAMBALA,2023,1820,1700,3520,8
BUTAMBALA,2024,1830,1700,3530,8
BUTAMBALA,2025,1830,1700,3530,8
BUTEBO,2015,2010,1870,3880,8
BUTEBO,2016,2020,1870,3890,8
BUTEBO,2017,2040,1870,3910,8
BUTEBO,2018,2020,1830,3850,8
BUTEBO,2019,2000,1810,3810,8
BUTEBO,2020,2000,1800,3800,8
BUTEBO,2021,2010,1810,3820,8
BUTEBO,2022,2090,1860,3950,8
BUTEBO,2023,2080,1950,4030,8
BUTEBO,2024,2090,1950,4040,8
BUTEBO,2025,2090,1960,4050,8
BUVUMA,2015,1250,1160,2410,8
BUVUMA,2016,1330,1240,2570,8
BUVUMA,2017,1410,1320,2730,8
BUVUMA,2018,1490,1410,2900,8
BUVUMA,2019,1590,1510,3100,8
BUVUMA,2020,1680,1600,3280,8
BUVUMA,2021,1780,1710,3490,8
BUVUMA,2022,1890,1820,3710,8
BUVUMA,2023,2000,1940,3940,8
BUVUMA,2024,2110,2060,4170,8
BUVUMA,2025,2230,2190,4420,8
BUYENDE,2015,6220,5760,11980,8
BUYENDE,2016,6440,5930,12370,8
BUYENDE,2017,6660,6100,12760,8
BUYENDE,2018,6830,6160,12990,8
BUYENDE,2019,6960,6270,13230,8
BUYENDE,2020,7110,6410,13520,8
BUYENDE,2021,7390,6630,14020,8
BUYENDE,2022,7880,7020,14900,8
BUYENDE,2023,8070,7570,15640,8
BUYENDE,2024,8320,7810,16130,8
BUYENDE,2025,8590,8050,16640,8
DOKOLO,2015,3290,3230,6520,8
DOKOLO,2016,3400,3320,6720,8
DOKOLO,2017,3500,3410,6910,8
DOKOLO,2018,3610,3500,7110,8
DOKOLO,2019,3710,3600,7310,8
DOKOLO,2020,3820,3690,7510,8
DOKOLO,2021,3930,3790,7720,8
DOKOLO,2022,4040,3880,7920,8
DOKOLO,2023,4150,3970,8120,8
DOKOLO,2024,4250,4070,8320,8
DOKOLO,2025,4360,4160,8520,8
GOMBA,2015,2590,2540,5130,8
GOMBA,2016,2620,2530,5150,8
GOMBA,2017,2640,2520,5160,8
GOMBA,2018,2630,2470,5100,8
GOMBA,2019,2610,2440,5050,8
GOMBA,2020,2590,2420,5010,8
GOMBA,2021,2620,2430,5050,8
GOMBA,2022,2730,2490,5220,8
GOMBA,2023,2720,2610,5330,8
GOMBA,2024,2730,2610,5340,8
GOMBA,2025,2750,2610,5360,8
GULU,2015,4240,4100,8340,8
GULU,2016,4370,4220,8590,8
GULU,2017,4500,4340,8840,8
GULU,2018,4630,4470,9100,8
GULU,2019,4770,4590,9360,8
GULU,2020,4900,4720,9620,8
GULU,2021,5040,4850,9890,8
GULU,2022,5180,4980,10160,8
GULU,2023,5310,5110,10420,8
GULU,2024,5450,5230,10680,8
GULU,2025,5590,5360,10950,8
HOIMA,2015,4770,4500,9270,8
HOIMA,2016,4950,4660,9610,8
HOIMA,2017,5140,4820,9960,8
HOIMA,2018,5330,4980,10310,8
HOIMA,2019,5520,5150,10670,8
HOIMA,2020,5720,5320,11040,8
HOIMA,2021,5930,5500,11430,8
HOIMA,2022,6130,5670,11800,8
HOIMA,2023,6340,5850,12190,8
HOIMA,2024,6550,6030,12580,8
HOIMA,2025,6760,6210,12970,8
IBANDA,2015,3900,3740,7640,8
IBANDA,2016,3980,3810,7790,8
IBANDA,2017,4050,3880,7930,8
IBANDA,2018,4130,3950,8080,8
IBANDA,2019,4210,4020,8230,8
IBANDA,2020,4290,4080,8370,8
IBANDA,2021,4360,4150,8510,8
IBANDA,2022,4440,4210,8650,8
IBANDA,2023,4510,4270,8780,8
IBANDA,2024,4580,4330,8910,8
IBANDA,2025,4640,4390,9030,8
IGANGA,2015,5420,5390,10810,8
IGANGA,2016,5540,5460,11000,8
IGANGA,2017,5660,5540,11200,8
IGANGA,2018,5720,5510,11230,8
IGANGA,2019,5760,5540,11300,8
IGANGA,2020,5810,5590,11400,8
IGANGA,2021,5960,5700,11660,8
IGANGA,2022,6270,5950,12220,8
IGANGA,2023,6340,6320,12660,8
IGANGA,2024,6460,6440,12900,8
IGANGA,2025,6580,6540,13120,8
ISINGIRO,2015,8210,8120,16330,8
ISINGIRO,2016,8520,8410,16930,8
ISINGIRO,2017,8830,8710,17540,8
ISINGIRO,2018,9160,9010,18170,8
ISINGIRO,2019,9490,9320,18810,8
ISINGIRO,2020,9830,9630,19460,8
ISINGIRO,2021,10180,9950,20130,8
ISINGIRO,2022,10530,10280,20810,8
ISINGIRO,2023,10880,10600,21480,8
ISINGIRO,2024,11240,10930,22170,8
ISINGIRO,2025,11600,11270,22870,8
JINJA,2015,7010,7040,14050,8
JINJA,2016,7130,7150,14280,8
JINJA,2017,7250,7260,14510,8
JINJA,2018,7370,7370,14740,8
JINJA,2019,7480,7480,14960,8
JINJA,2020,7600,7580,15180,8
JINJA,2021,7710,7680,15390,8
JINJA,2022,7820,7780,15600,8
JINJA,2023,7920,7870,15790,8
JINJA,2024,8020,7960,15980,8
JINJA,2025,8110,8050,16160,8
KAABONG,2015,1940,2040,3980,8
KAABONG,2016,1990,2090,4080,8
KAABONG,2017,2060,2150,4210,8
KAABONG,2018,2100,2190,4290,8
KAABONG,2019,2160,2240,4400,8
KAABONG,2020,2210,2300,4510,8
KAABONG,2021,2270,2350,4620,8
KAABONG,2022,2330,2400,4730,8
KAABONG,2023,2380,2450,4830,8
KAABONG,2024,2430,2500,4930,8
KAABONG,2025,2490,2550,5040,8
KABALE,2015,3230,3110,6340,8
KABALE,2016,3280,3150,6430,8
KABALE,2017,3330,3190,6520,8
KABALE,2018,3380,3230,6610,8
KABALE,2019,3430,3260,6690,8
KABALE,2020,3480,3300,6780,8
KABALE,2021,3520,3330,6850,8
KABALE,2022,3570,3360,6930,8
KABALE,2023,3610,3390,7000,8
KABALE,2024,3650,3420,7070,8
KABALE,2025,3690,3440,7130,8
KABAROLE,2015,4290,4140,8430,8
KABAROLE,2016,4390,4230,8620,8
KABAROLE,2017,4490,4330,8820,8
KABAROLE,2018,4580,4420,9000,8
KABAROLE,2019,4680,4510,9190,8
KABAROLE,2020,4770,4600,9370,8
KABAROLE,2021,4870,4690,9560,8
KABAROLE,2022,4960,4780,9740,8
KABAROLE,2023,5050,4870,9920,8
KABAROLE,2024,5140,4960,10100,8
KABAROLE,2025,5230,5040,10270,8
KABERAMAIDO,2015,1860,1750,3610,8
KABERAMAIDO,2016,1920,1790,3710,8
KABERAMAIDO,2017,1980,1830,3810,8
KABERAMAIDO,2018,2020,1840,3860,8
KABERAMAIDO,2019,2070,1870,3940,8
KABERAMAIDO,2020,2110,1910,4020,8
KABERAMAIDO,2021,2180,1970,4150,8
KABERAMAIDO,2022,2330,2070,4400,8
KABERAMAIDO,2023,2380,2230,4610,8
KABERAMAIDO,2024,2450,2290,4740,8
KABERAMAIDO,2025,2510,2350,4860,8
KAGADI,2015,5720,5690,11410,8
KAGADI,2016,5940,5890,11830,8
KAGADI,2017,6160,6100,12260,8
KAGADI,2018,6380,6310,12690,8
KAGADI,2019,6610,6530,13140,8
KAGADI,2020,6850,6750,13600,8
KAGADI,2021,7080,6980,14060,8
KAGADI,2022,7330,7200,14530,8
KAGADI,2023,7570,7440,15010,8
KAGADI,2024,7820,7670,15490,8
KAGADI,2025,8060,7900,15960,8
KAKUMIRO,2015,4900,4880,9780,8
KAKUMIRO,2016,5340,5290,10630,8
KAKUMIRO,2017,5810,5740,11550,8
KAKUMIRO,2018,6320,6220,12540,8
KAKUMIRO,2019,6870,6740,13610,8
KAKUMIRO,2020,7470,7300,14770,8
KAKUMIRO,2021,8110,7890,16000,8
KAKUMIRO,2022,8800,8540,17340,8
KAKUMIRO,2023,9550,9230,18780,8
KAKUMIRO,2024,10350,9960,20310,8
KAKUMIRO,2025,11200,10750,21950,8
KALAKI,2015,2010,1900,3910,8
KALAKI,2016,2100,1980,4080,8
KALAKI,2017,2190,2060,4250,8
KALAKI,2018,2290,2140,4430,8
KALAKI,2019,2380,2220,4600,8
KALAKI,2020,2480,2310,4790,8
KALAKI,2021,2590,2390,4980,8
KALAKI,2022,2690,2480,5170,8
KALAKI,2023,2790,2570,5360,8
KALAKI,2024,2900,2660,5560,8
KALAKI,2025,3010,2750,5760,8
KALANGALA,2015,420,400,820,8
KALANGALA,2016,430,420,850,8
KALANGALA,2017,450,440,890,8
KALANGALA,2018,460,460,920,8
KALANGALA,2019,480,470,950,8
KALANGALA,2020,500,490,990,8
KALANGALA,2021,510,510,1020,8
KALANGALA,2022,530,530,1060,8
KALANGALA,2023,550,550,1100,8
KALANGALA,2024,560,570,1130,8
KALANGALA,2025,580,590,1170,8
KALIRO,2015,4360,4000,8360,8
KALIRO,2016,4480,4070,8550,8
KALIRO,2017,4590,4160,8750,8
KALIRO,2018,4660,4160,8820,8
KALIRO,2019,4710,4210,8920,8
KALIRO,2020,4770,4260,9030,8
KALIRO,2021,4910,4380,9290,8
KALIRO,2022,5190,4600,9790,8
KALIRO,2023,5270,4910,10180,8
KALIRO,2024,5380,5030,10410,8
KALIRO,2025,5510,5140,10650,8
KALUNGU,2015,3130,2880,6010,8
KALUNGU,2016,3130,2870,6000,8
KALUNGU,2017,3130,2860,5990,8
KALUNGU,2018,3100,2790,5890,8
KALUNGU,2019,3060,2760,5820,8
KALUNGU,2020,3030,2720,5750,8
KALUNGU,2021,3040,2720,5760,8
KALUNGU,2022,3140,2800,5940,8
KALUNGU,2023,3110,2920,6030,8
KALUNGU,2024,3110,2910,6020,8
KALUNGU,2025,3100,2910,6010,8
KAMPALA,2015,15290,15590,30880,8
KAMPALA,2016,15590,15890,31480,8
KAMPALA,2017,15900,16200,32100,8
KAMPALA,2018,16210,16510,32720,8
KAMPALA,2019,16510,16810,33320,8
KAMPALA,2020,16810,17120,33930,8
KAMPALA,2021,17110,17410,34520,8
KAMPALA,2022,17400,17700,35100,8
KAMPALA,2023,17680,17990,35670,8
KAMPALA,2024,17950,18270,36220,8
KAMPALA,2025,18210,18530,36740,8
KAMULI,2015,8650,8120,16770,8
KAMULI,2016,8790,8180,16970,8
KAMULI,2017,8930,8260,17190,8
KAMULI,2018,8980,8160,17140,8
KAMULI,2019,8990,8160,17150,8
KAMULI,2020,9030,8170,17200,8
KAMULI,2021,9200,8290,17490,8
KAMULI,2022,9640,8600,18240,8
KAMULI,2023,9690,9090,18780,8
KAMULI,2024,9830,9200,19030,8
KAMULI,2025,9960,9300,19260,8
KAMWENGE,2015,4620,4580,9200,8
KAMWENGE,2016,4810,4750,9560,8
KAMWENGE,2017,5000,4910,9910,8
KAMWENGE,2018,5210,5080,10290,8
KAMWENGE,2019,5410,5260,10670,8
KAMWENGE,2020,5620,5440,11060,8
KAMWENGE,2021,5840,5620,11460,8
KAMWENGE,2022,6060,5800,11860,8
KAMWENGE,2023,6280,6000,12280,8
KAMWENGE,2024,6510,6190,12700,8
KAMWENGE,2025,6740,6370,13110,8
KANUNGU,2015,3950,3840,7790,8
KANUNGU,2016,4020,3910,7930,8
KANUNGU,2017,4090,3970,8060,8
KANUNGU,2018,4160,4030,8190,8
KANUNGU,2019,4230,4100,8330,8
KANUNGU,2020,4310,4160,8470,8
KANUNGU,2021,4370,4210,8580,8
KANUNGU,2022,4440,4270,8710,8
KANUNGU,2023,4500,4330,8830,8
KANUNGU,2024,4570,4380,8950,8
KANUNGU,2025,4620,4430,9050,8
KAPCHORWA,2015,1740,1610,3350,8
KAPCHORWA,2016,1790,1660,3450,8
KAPCHORWA,2017,1850,1710,3560,8
KAPCHORWA,2018,1910,1750,3660,8
KAPCHORWA,2019,1960,1800,3760,8
KAPCHORWA,2020,2020,1840,3860,8
KAPCHORWA,2021,2080,1890,3970,8
KAPCHORWA,2022,2130,1940,4070,8
KAPCHORWA,2023,2190,1990,4180,8
KAPCHORWA,2024,2250,2040,4290,8
KAPCHORWA,2025,2300,2080,4380,8
KAPELEBYONG,2015,1590,1510,3100,8
KAPELEBYONG,2016,1630,1520,3150,8
KAPELEBYONG,2017,1660,1550,3210,8
KAPELEBYONG,2018,1670,1540,3210,8
KAPELEBYONG,2019,1690,1550,3240,8
KAPELEBYONG,2020,1710,1550,3260,8
KAPELEBYONG,2021,1750,1590,3340,8
KAPELEBYONG,2022,1840,1650,3490,8
KAPELEBYONG,2023,1860,1760,3620,8
KAPELEBYONG,2024,1900,1780,3680,8
KAPELEBYONG,2025,1940,1810,3750,8
KASESE,2015,11250,10930,22180,8
KASESE,2016,11420,11010,22430,8
KASESE,2017,11590,11100,22690,8
KASESE,2018,11630,10970,22600,8
KASESE,2019,11630,10960,22590,8
KASESE,2020,11660,10970,22630,8
KASESE,2021,11860,11130,22990,8
KASESE,2022,12410,11540,23950,8
KASESE,2023,12460,12190,24650,8
KASESE,2024,12610,12320,24930,8
KASESE,2025,12760,12450,25210,8
KASSANDA,2015,4630,4410,9040,8
KASSANDA,2016,4760,4510,9270,8
KASSANDA,2017,4900,4610,9510,8
KASSANDA,2018,5030,4710,9740,8
KASSANDA,2019,5170,4800,9970,8
KASSANDA,2020,5310,4900,10210,8
KASSANDA,2021,5450,4990,10440,8
KASSANDA,2022,5590,5090,10680,8
KASSANDA,2023,5730,5180,10910,8
KASSANDA,2024,5870,5270,11140,8
KASSANDA,2025,6010,5360,11370,8
KATAKWI,2015,2930,2830,5760,8
KATAKWI,2016,3000,2870,5870,8
KATAKWI,2017,3050,2900,5950,8
KATAKWI,2018,3070,2870,5940,8
KATAKWI,2019,3090,2880,5970,8
KATAKWI,2020,3120,2900,6020,8
KATAKWI,2021,3180,2940,6120,8
KATAKWI,2022,3350,3060,6410,8
KATAKWI,2023,3380,3250,6630,8
KATAKWI,2024,3440,3290,6730,8
KATAKWI,2025,3500,3340,6840,8
KAYUNGA,2015,6720,6330,13050,8
KAYUNGA,2016,6790,6330,13120,8
KAYUNGA,2017,6860,6350,13210,8
KAYUNGA,2018,6850,6250,13100,8
KAYUNGA,2019,6810,6200,13010,8
KAYUNGA,2020,6800,6180,12980,8
KAYUNGA,2021,6880,6230,13110,8
KAYUNGA,2022,7160,6430,13590,8
KAYUNGA,2023,7150,6750,13900,8
KAYUNGA,2024,7210,6780,13990,8
KAYUNGA,2025,7260,6820,14080,8
KAZO,2015,2780,2730,5510,8
KAZO,2016,2890,2820,5710,8
KAZO,2017,3000,2930,5930,8
KAZO,2018,3110,3030,6140,8
KAZO,2019,3230,3140,6370,8
KAZO,2020,3340,3240,6580,8
KAZO,2021,3460,3340,6800,8
KAZO,2022,3580,3450,7030,8
KAZO,2023,3700,3570,7270,8
KAZO,2024,3830,3680,7510,8
KAZO,2025,3960,3790,7750,8
KIBAALE,2015,2400,2300,4700,8
KIBAALE,2016,2550,2430,4980,8
KIBAALE,2017,2710,2570,5280,8
KIBAALE,2018,2890,2720,5610,8
KIBAALE,2019,3070,2880,5950,8
KIBAALE,2020,3260,3040,6300,8
KIBAALE,2021,3450,3210,6660,8
KIBAALE,2022,3660,3380,7040,8
KIBAALE,2023,3890,3570,7460,8
KIBAALE,2024,4110,3760,7870,8
KIBAALE,2025,4350,3960,8310,8
KIBOGA,2015,2340,2280,4620,8
KIBOGA,2016,2380,2300,4680,8
KIBOGA,2017,2410,2320,4730,8
KIBOGA,2018,2430,2300,4730,8
KIBOGA,2019,2440,2300,4740,8
KIBOGA,2020,2450,2310,4760,8
KIBOGA,2021,2500,2340,4840,8
KIBOGA,2022,2620,2430,5050,8
KIBOGA,2023,2630,2570,5200,8
KIBOGA,2024,2670,2610,5280,8
KIBOGA,2025,2710,2640,5350,8
KIBUKU,2015,3820,3390,7210,8
KIBUKU,2016,3930,3470,7400,8
KIBUKU,2017,4050,3550,7600,8
KIBUKU,2018,4120,3550,7670,8
KIBUKU,2019,4180,3610,7790,8
KIBUKU,2020,4240,3660,7900,8
KIBUKU,2021,4380,3770,8150,8
KIBUKU,2022,4640,3960,8600,8
KIBUKU,2023,4720,4250,8970,8
KIBUKU,2024,4860,4350,9210,8
KIBUKU,2025,4980,4470,9450,8
KIKUUBE,2015,4510,4270,8780,8
KIKUUBE,2016,4750,4490,9240,8
KIKUUBE,2017,5010,4720,9730,8
KIKUUBE,2018,5270,4960,10230,8
KIKUUBE,2019,5550,5210,10760,8
KIKUUBE,2020,5840,5470,11310,8
KIKUUBE,2021,6130,5730,11860,8
KIKUUBE,2022,6450,6010,12460,8
KIKUUBE,2023,6770,6290,13060,8
KIKUUBE,2024,7100,6590,13690,8
KIKUUBE,2025,7430,6890,14320,8
KIRUHURA,2015,2150,2000,4150,8
KIRUHURA,2016,2230,2080,4310,8
KIRUHURA,2017,2320,2150,4470,8
KIRUHURA,2018,2410,2220,4630,8
KIRUHURA,2019,2490,2300,4790,8
KIRUHURA,2020,2590,2380,4970,8
KIRUHURA,2021,2680,2460,5140,8
KIRUHURA,2022,2770,2540,5310,8
KIRUHURA,2023,2870,2620,5490,8
KIRUHURA,2024,2960,2700,5660,8
KIRUHURA,2025,3060,2780,5840,8
KIRYANDONGO,2015,4600,4280,8880,8
KIRYANDONGO,2016,4690,4340,9030,8
KIRYANDONGO,2017,4790,4400,9190,8
KIRYANDONGO,2018,4830,4370,9200,8
KIRYANDONGO,2019,4860,4380,9240,8
KIRYANDONGO,2020,4910,4420,9330,8
KIRYANDONGO,2021,5020,4490,9510,8
KIRYANDONGO,2022,5280,4680,9960,8
KIRYANDONGO,2023,5330,4970,10300,8
KIRYANDONGO,2024,5430,5050,10480,8
KIRYANDONGO,2025,5520,5130,10650,8
KISORO,2015,4670,4630,9300,8
KISORO,2016,4720,4660,9380,8
KISORO,2017,4770,4680,9450,8
KISORO,2018,4770,4620,9390,8
KISORO,2019,4730,4600,9330,8
KISORO,2020,4730,4600,9330,8
KISORO,2021,4790,4660,9450,8
KISORO,2022,4990,4810,9800,8
KISORO,2023,4990,5070,10060,8
KISORO,2024,5030,5120,10150,8
KISORO,2025,5070,5160,10230,8
KITAGWENDA,2015,2420,2340,4760,8
KITAGWENDA,2016,2520,2420,4940,8
KITAGWENDA,2017,2630,2510,5140,8
KITAGWENDA,2018,2740,2600,5340,8
KITAGWENDA,2019,2840,2690,5530,8
KITAGWENDA,2020,2960,2790,5750,8
KITAGWENDA,2021,3060,2880,5940,8
KITAGWENDA,2022,3180,2980,6160,8
KITAGWENDA,2023,3300,3070,6370,8
KITAGWENDA,2024,3420,3170,6590,8
KITAGWENDA,2025,3540,3260,6800,8
KITGUM,2015,3680,3330,7010,8
KITGUM,2016,3700,3330,7030,8
KITGUM,2017,3730,3330,7060,8
KITGUM,2018,3720,3280,7000,8
KITGUM,2019,3680,3250,6930,8
KITGUM,2020,3660,3240,6900,8
KITGUM,2021,3690,3270,6960,8
KITGUM,2022,3830,3370,7200,8
KITGUM,2023,3820,3540,7360,8
KITGUM,2024,3830,3550,7380,8
KITGUM,2025,3860,3560,7420,8
KOBOKO,2015,3640,3530,7170,8
KOBOKO,2016,3750,3620,7370,8
KOBOKO,2017,3860,3700,7560,8
KOBOKO,2018,3930,3720,7650,8
KOBOKO,2019,3990,3760,7750,8
KOBOKO,2020,4070,3830,7900,8
KOBOKO,2021,4200,3950,8150,8
KOBOKO,2022,4460,4160,8620,8
KOBOKO,2023,4540,4470,9010,8
KOBOKO,2024,4670,4590,9260,8
KOBOKO,2025,4800,4710,9510,8
KOLE,2015,4180,4140,8320,8
KOLE,2016,4320,4260,8580,8
KOLE,2017,4450,4380,8830,8
KOLE,2018,4600,4510,9110,8
KOLE,2019,4750,4630,9380,8
KOLE,2020,4890,4760,9650,8
KOLE,2021,5040,4890,9930,8
KOLE,2022,5190,5010,10200,8
KOLE,2023,5340,5140,10480,8
KOLE,2024,5490,5270,10760,8
KOLE,2025,5640,5390,11030,8
KOTIDO,2015,3430,3900,7330,8
KOTIDO,2016,3490,3930,7420,8
KOTIDO,2017,3540,3960,7500,8
KOTIDO,2018,3560,3910,7470,8
KOTIDO,2019,3550,3910,7460,8
KOTIDO,2020,3560,3910,7470,8
KOTIDO,2021,3620,3970,7590,8
KOTIDO,2022,3790,4100,7890,8
KOTIDO,2023,3800,4340,8140,8
KOTIDO,2024,3850,4390,8240,8
KOTIDO,2025,3900,4430,8330,8
KUMI,2015,4290,4060,8350,8
KUMI,2016,4380,4120,8500,8
KUMI,2017,4480,4170,8650,8
KUMI,2018,4540,4160,8700,8
KUMI,2019,4570,4180,8750,8
KUMI,2020,4620,4220,8840,8
KUMI,2021,4740,4300,9040,8
KUMI,2022,4990,4490,9480,8
KUMI,2023,5050,4770,9820,8
KUMI,2024,5150,4860,10010,8
KUMI,2025,5240,4950,10190,8
KWANIA,2015,3250,3330,6580,8
KWANIA,2016,3350,3430,6780,8
KWANIA,2017,3450,3530,6980,8
KWANIA,2018,3560,3630,7190,8
KWANIA,2019,3670,3730,7400,8
KWANIA,2020,3780,3830,7610,8
KWANIA,2021,3880,3930,7810,8
KWANIA,2022,3990,4030,8020,8
KWANIA,2023,4100,4140,8240,8
KWANIA,2024,4210,4240,8450,8
KWANIA,2025,4320,4340,8660,8
KWEEN,2015,1640,1520,3160,8
KWEEN,2016,1690,1560,3250,8
KWEEN,2017,1740,1600,3340,8
KWEEN,2018,1790,1640,3430,8
KWEEN,2019,1850,1680,3530,8
KWEEN,2020,1900,1720,3620,8
KWEEN,2021,1960,1760,3720,8
KWEEN,2022,2010,1800,3810,8
KWEEN,2023,2070,1830,3900,8
KWEEN,2024,2120,1870,3990,8
KWEEN,2025,2180,1910,4090,8
KYANKWANZI,2015,3510,3360,6870,8
KYANKWANZI,2016,3690,3510,7200,8
KYANKWANZI,2017,3870,3680,7550,8
KYANKWANZI,2018,4070,3850,7920,8
KYANKWANZI,2019,4280,4020,8300,8
KYANKWANZI,2020,4490,4200,8690,8
KYANKWANZI,2021,4710,4390,9100,8
KYANKWANZI,2022,4940,4580,9520,8
KYANKWANZI,2023,5170,4780,9950,8
KYANKWANZI,2024,5410,4980,10390,8
KYANKWANZI,2025,5660,5190,10850,8
KYEGEGWA,2015,4640,4790,9430,8
KYEGEGWA,2016,5020,5170,10190,8
KYEGEGWA,2017,5430,5580,11010,8
KYEGEGWA,2018,5870,6010,11880,8
KYEGEGWA,2019,6350,6480,12830,8
KYEGEGWA,2020,6860,6990,13850,8
KYEGEGWA,2021,7410,7520,14930,8
KYEGEGWA,2022,7990,8090,16080,8
KYEGEGWA,2023,8620,8710,17330,8
KYEGEGWA,2024,9290,9360,18650,8
KYEGEGWA,2025,10000,10050,20050,8
KYENJOJO,2015,6880,6720,13600,8
KYENJOJO,2016,7170,6970,14140,8
KYENJOJO,2017,7460,7230,14690,8
KYENJOJO,2018,7770,7490,15260,8
KYENJOJO,2019,8080,7760,15840,8
KYENJOJO,2020,8390,8030,16420,8
KYENJOJO,2021,8720,8310,17030,8
KYENJOJO,2022,9050,8600,17650,8
KYENJOJO,2023,9390,8890,18280,8
KYENJOJO,2024,9730,9180,18910,8
KYENJOJO,2025,10080,9470,19550,8
KYOTERA,2015,4030,3670,7700,8
KYOTERA,2016,4060,3660,7720,8
KYOTERA,2017,4090,3670,7760,8
KYOTERA,2018,4080,3600,7680,8
KYOTERA,2019,4040,3560,7600,8
KYOTERA,2020,4020,3540,7560,8
KYOTERA,2021,4060,3550,7610,8
KYOTERA,2022,4210,3660,7870,8
KYOTERA,2023,4190,3830,8020,8
KYOTERA,2024,4220,3840,8060,8
KYOTERA,2025,4230,3850,8080,8
KARENGA,2015,1200,1240,2440,8
KARENGA,2016,1230,1260,2490,8
KARENGA,2017,1260,1300,2560,8
KARENGA,2018,1300,1330,2630,8
KARENGA,2019,1330,1360,2690,8
KARENGA,2020,1370,1390,2760,8
KARENGA,2021,1400,1420,2820,8
KARENGA,2022,1430,1450,2880,8
KARENGA,2023,1470,1480,2950,8
KARENGA,2024,1500,1520,3020,8
KARENGA,2025,1530,1540,3070,8
LAMWO,2015,2480,2270,4750,8
LAMWO,2016,2480,2260,4740,8
LAMWO,2017,2480,2270,4750,8
LAMWO,2018,2450,2220,4670,8
LAMWO,2019,2420,2200,4620,8
LAMWO,2020,2390,2190,4580,8
LAMWO,2021,2390,2210,4600,8
LAMWO,2022,2460,2270,4730,8
LAMWO,2023,2440,2370,4810,8
LAMWO,2024,2430,2380,4810,8
LAMWO,2025,2430,2400,4830,8
LIRA,2015,6640,6570,13210,8
LIRA,2016,6830,6760,13590,8
LIRA,2017,7020,6960,13980,8
LIRA,2018,7220,7150,14370,8
LIRA,2019,7410,7350,14760,8
LIRA,2020,7610,7550,15160,8
LIRA,2021,7810,7750,15560,8
LIRA,2022,8010,7950,15960,8
LIRA,2023,8200,8150,16350,8
LIRA,2024,8390,8350,16740,8
LIRA,2025,8580,8550,17130,8
LUUKA,2015,4140,4030,8170,8
LUUKA,2016,4190,4050,8240,8
LUUKA,2017,4240,4080,8320,8
LUUKA,2018,4240,4020,8260,8
LUUKA,2019,4220,4010,8230,8
LUUKA,2020,4220,4010,8230,8
LUUKA,2021,4280,4050,8330,8
LUUKA,2022,4450,4190,8640,8
LUUKA,2023,4450,4420,8870,8
LUUKA,2024,4490,4460,8950,8
LUUKA,2025,4530,4500,9030,8
LUWERO,2015,7440,7020,14460,8
LUWERO,2016,7550,7080,14630,8
LUWERO,2017,7670,7140,14810,8
LUWERO,2018,7710,7070,14780,8
LUWERO,2019,7710,7050,14760,8
LUWERO,2020,7740,7070,14810,8
LUWERO,2021,7880,7170,15050,8
LUWERO,2022,8250,7440,15690,8
LUWERO,2023,8280,7860,16140,8
LUWERO,2024,8390,7950,16340,8
LUWERO,2025,8500,8040,16540,8
LWENGO,2015,4810,4600,9410,8
LWENGO,2016,4820,4580,9400,8
LWENGO,2017,4830,4560,9390,8
LWENGO,2018,4770,4460,9230,8
LWENGO,2019,4710,4390,9100,8
LWENGO,2020,4660,4340,9000,8
LWENGO,2021,4670,4350,9020,8
LWENGO,2022,4830,4450,9280,8
LWENGO,2023,4780,4640,9420,8
LWENGO,2024,4770,4630,9400,8
LWENGO,2025,4760,4620,9380,8
LYANTONDE,2015,1400,1360,2760,8
LYANTONDE,2016,1420,1380,2800,8
LYANTONDE,2017,1460,1400,2860,8
LYANTONDE,2018,1470,1390,2860,8
LYANTONDE,2019,1480,1400,2880,8
LYANTONDE,2020,1490,1410,2900,8
LYANTONDE,2021,1530,1440,2970,8
LYANTONDE,2022,1600,1500,3100,8
LYANTONDE,2023,1620,1590,3210,8
LYANTONDE,2024,1650,1620,3270,8
LYANTONDE,2025,1680,1640,3320,8
MANAFWA,2015,2660,2600,5260,8
MANAFWA,2016,2730,2660,5390,8
MANAFWA,2017,2800,2720,5520,8
MANAFWA,2018,2870,2780,5650,8
MANAFWA,2019,2930,2840,5770,8
MANAFWA,2020,3000,2900,5900,8
MANAFWA,2021,3070,2960,6030,8
MANAFWA,2022,3140,3010,6150,8
MANAFWA,2023,3200,3070,6270,8
MANAFWA,2024,3270,3130,6400,8
MANAFWA,2025,3340,3180,6520,8
MARACHA,2015,3210,3130,6340,8
MARACHA,2016,3280,3190,6470,8
MARACHA,2017,3350,3250,6600,8
MARACHA,2018,3420,3320,6740,8
MARACHA,2019,3490,3380,6870,8
MARACHA,2020,3550,3440,6990,8
MARACHA,2021,3620,3500,7120,8
MARACHA,2022,3690,3560,7250,8
MARACHA,2023,3750,3620,7370,8
MARACHA,2024,3810,3670,7480,8
MARACHA,2025,3870,3720,7590,8
MASAKA,2015,4320,4250,8570,8
MASAKA,2016,4370,4290,8660,8
MASAKA,2017,4430,4310,8740,8
MASAKA,2018,4440,4260,8700,8
MASAKA,2019,4430,4240,8670,8
MASAKA,2020,4440,4250,8690,8
MASAKA,2021,4500,4290,8790,8
MASAKA,2022,4700,4450,9150,8
MASAKA,2023,4710,4690,9400,8
MASAKA,2024,4760,4730,9490,8
MASAKA,2025,4810,4780,9590,8
MASINDI,2015,4460,4430,8890,8
MASINDI,2016,4590,4550,9140,8
MASINDI,2017,4730,4670,9400,8
MASINDI,2018,4860,4790,9650,8
MASINDI,2019,5000,4920,9920,8
MASINDI,2020,5140,5040,10180,8
MASINDI,2021,5280,5170,10450,8
MASINDI,2022,5420,5290,10710,8
MASINDI,2023,5550,5410,10960,8
MASINDI,2024,5690,5540,11230,8
MASINDI,2025,5830,5660,11490,8
MAYUGE,2015,8590,8110,16700,8
MAYUGE,2016,8770,8240,17010,8
MAYUGE,2017,8970,8380,17350,8
MAYUGE,2018,9060,8350,17410,8
MAYUGE,2019,9130,8400,17530,8
MAYUGE,2020,9210,8490,17700,8
MAYUGE,2021,9440,8680,18120,8
MAYUGE,2022,9940,9080,19020,8
MAYUGE,2023,10050,9670,19720,8
MAYUGE,2024,10250,9860,20110,8
MAYUGE,2025,10440,10040,20480,8
MBALE,2015,7580,7500,15080,8
MBALE,2016,7750,7640,15390,8
MBALE,2017,7910,7790,15700,8
MBALE,2018,7980,7780,15760,8
MBALE,2019,8030,7860,15890,8
MBALE,2020,8100,7950,16050,8
MBALE,2021,8290,8160,16450,8
MBALE,2022,8720,8540,17260,8
MBALE,2023,8810,9120,17930,8
MBALE,2024,8970,9330,18300,8
MBALE,2025,9130,9530,18660,8
MBARARA,2015,4480,4470,8950,8
MBARARA,2016,4590,4570,9160,8
MBARARA,2017,4690,4670,9360,8
MBARARA,2018,4800,4770,9570,8
MBARARA,2019,4910,4870,9780,8
MBARARA,2020,5010,4970,9980,8
MBARARA,2021,5120,5060,10180,8
MBARARA,2022,5210,5160,10370,8
MBARARA,2023,5320,5250,10570,8
MBARARA,2024,5420,5340,10760,8
MBARARA,2025,5510,5430,10940,8
MITOOMA,2015,2840,2740,5580,8
MITOOMA,2016,2880,2770,5650,8
MITOOMA,2017,2910,2800,5710,8
MITOOMA,2018,2950,2820,5770,8
MITOOMA,2019,2980,2850,5830,8
MITOOMA,2020,3010,2870,5880,8
MITOOMA,2021,3040,2890,5930,8
MITOOMA,2022,3070,2910,5980,8
MITOOMA,2023,3090,2920,6010,8
MITOOMA,2024,3120,2940,6060,8
MITOOMA,2025,3140,2960,6100,8
MITYANA,2015,5120,4820,9940,8
MITYANA,2016,5160,4830,9990,8
MITYANA,2017,5210,4840,10050,8
MITYANA,2018,5200,4750,9950,8
MITYANA,2019,5160,4710,9870,8
MITYANA,2020,5140,4690,9830,8
MITYANA,2021,5200,4730,9930,8
MITYANA,2022,5420,4880,10300,8
MITYANA,2023,5400,5120,10520,8
MITYANA,2024,5440,5140,10580,8
MITYANA,2025,5460,5160,10620,8
MOROTO,2015,1900,1950,3850,8
MOROTO,2016,1920,1970,3890,8
MOROTO,2017,1950,1990,3940,8
MOROTO,2018,1960,1980,3940,8
MOROTO,2019,1950,1980,3930,8
MOROTO,2020,1950,1990,3940,8
MOROTO,2021,1990,2030,4020,8
MOROTO,2022,2070,2100,4170,8
MOROTO,2023,2070,2230,4300,8
MOROTO,2024,2100,2260,4360,8
MOROTO,2025,2110,2290,4400,8
MOYO,2015,1520,1530,3050,8
MOYO,2016,1550,1570,3120,8
MOYO,2017,1590,1600,3190,8
MOYO,2018,1630,1630,3260,8
MOYO,2019,1670,1670,3340,8
MOYO,2020,1710,1700,3410,8
MOYO,2021,1750,1730,3480,8
MOYO,2022,1790,1770,3560,8
MOYO,2023,1830,1800,3630,8
MOYO,2024,1870,1830,3700,8
MOYO,2025,1900,1870,3770,8
MPIGI,2015,3960,3670,7630,8
MPIGI,2016,4020,3700,7720,8
MPIGI,2017,4080,3730,7810,8
MPIGI,2018,4090,3690,7780,8
MPIGI,2019,4090,3690,7780,8
MPIGI,2020,4100,3700,7800,8
MPIGI,2021,4170,3750,7920,8
MPIGI,2022,4360,3890,8250,8
MPIGI,2023,4370,4120,8490,8
MPIGI,2024,4430,4160,8590,8
MPIGI,2025,4480,4220,8700,8
MUBENDE,2015,6520,6400,12920,8
MUBENDE,2016,6800,6640,13440,8
MUBENDE,2017,7100,6880,13980,8
MUBENDE,2018,7330,7000,14330,8
MUBENDE,2019,7530,7190,14720,8
MUBENDE,2020,7770,7400,15170,8
MUBENDE,2021,8120,7720,15840,8
MUBENDE,2022,8730,8230,16960,8
MUBENDE,2023,9010,8950,17960,8
MUBENDE,2024,9370,9300,18670,8
MUBENDE,2025,9750,9680,19430,8
MUKONO,2015,8900,8580,17480,8
MUKONO,2016,9050,8700,17750,8
MUKONO,2017,9210,8830,18040,8
MUKONO,2018,9270,8790,18060,8
MUKONO,2019,9290,8850,18140,8
MUKONO,2020,9350,8920,18270,8
MUKONO,2021,9540,9100,18640,8
MUKONO,2022,10000,9510,19510,8
MUKONO,2023,10060,10120,20180,8
MUKONO,2024,10220,10300,20520,8
MUKONO,2025,10370,10480,20850,8
MADI OKOLLO,2015,2250,2210,4460,8
MADI OKOLLO,2016,2310,2280,4590,8
MADI OKOLLO,2017,2390,2330,4720,8
MADI OKOLLO,2018,2450,2400,4850,8
MADI OKOLLO,2019,2520,2460,4980,8
MADI OKOLLO,2020,2590,2520,5110,8
MADI OKOLLO,2021,2650,2590,5240,8
MADI OKOLLO,2022,2730,2660,5390,8
MADI OKOLLO,2023,2800,2710,5510,8
MADI OKOLLO,2024,2860,2770,5630,8
MADI OKOLLO,2025,2930,2840,5770,8
NABILATUK,2015,1410,1490,2900,8
NABILATUK,2016,1460,1530,2990,8
NABILATUK,2017,1530,1590,3120,8
NABILATUK,2018,1580,1600,3180,8
NABILATUK,2019,1610,1630,3240,8
NABILATUK,2020,1660,1670,3330,8
NABILATUK,2021,1730,1730,3460,8
NABILATUK,2022,1870,1830,3700,8
NABILATUK,2023,1910,1980,3890,8
NABILATUK,2024,1990,2050,4040,8
NABILATUK,2025,2070,2120,4190,8
NAKAPIRIPIRIT,2015,1680,1760,3440,8
NAKAPIRIPIRIT,2016,1730,1810,3540,8
NAKAPIRIPIRIT,2017,1790,1860,3650,8
NAKAPIRIPIRIT,2018,1830,1880,3710,8
NAKAPIRIPIRIT,2019,1860,1920,3780,8
NAKAPIRIPIRIT,2020,1910,1960,3870,8
NAKAPIRIPIRIT,2021,1980,2030,4010,8
NAKAPIRIPIRIT,2022,2110,2150,4260,8
NAKAPIRIPIRIT,2023,2160,2320,4480,8
NAKAPIRIPIRIT,2024,2230,2390,4620,8
NAKAPIRIPIRIT,2025,2300,2470,4770,8
NAKASEKE,2015,3040,2860,5900,8
NAKASEKE,2016,3160,2930,6090,8
NAKASEKE,2017,3270,3000,6270,8
NAKASEKE,2018,3390,3070,6460,8
NAKASEKE,2019,3510,3140,6650,8
NAKASEKE,2020,3630,3210,6840,8
NAKASEKE,2021,3760,3290,7050,8
NAKASEKE,2022,3890,3360,7250,8
NAKASEKE,2023,4010,3420,7430,8
NAKASEKE,2024,4140,3490,7630,8
NAKASEKE,2025,4270,3560,7830,8
NAKASONGOLA,2015,3020,2790,5810,8
NAKASONGOLA,2016,3080,2820,5900,8
NAKASONGOLA,2017,3150,2860,6010,8
NAKASONGOLA,2018,3190,2840,6030,8
NAKASONGOLA,2019,3210,2850,6060,8
NAKASONGOLA,2020,3250,2860,6110,8
NAKASONGOLA,2021,3330,2920,6250,8
NAKASONGOLA,2022,3500,3040,6540,8
NAKASONGOLA,2023,3540,3230,6770,8
NAKASONGOLA,2024,3610,3280,6890,8
NAKASONGOLA,2025,3680,3330,7010,8
NAMAYINGO,2015,3930,3670,7600,8
NAMAYINGO,2016,3960,3670,7630,8
NAMAYINGO,2017,4000,3680,7680,8
NAMAYINGO,2018,3990,3610,7600,8
NAMAYINGO,2019,3970,3580,7550,8
NAMAYINGO,2020,3950,3560,7510,8
NAMAYINGO,2021,4000,3580,7580,8
NAMAYINGO,2022,4170,3680,7850,8
NAMAYINGO,2023,4160,3870,8030,8
NAMAYINGO,2024,4180,3880,8060,8
NAMAYINGO,2025,4210,3900,8110,8
NAMISINDWA,2015,3740,3540,7280,8
NAMISINDWA,2016,3850,3630,7480,8
NAMISINDWA,2017,3960,3710,7670,8
NAMISINDWA,2018,4070,3800,7870,8
NAMISINDWA,2019,4180,3890,8070,8
NAMISINDWA,2020,4280,3970,8250,8
NAMISINDWA,2021,4400,4060,8460,8
NAMISINDWA,2022,4510,4140,8650,8
NAMISINDWA,2023,4610,4230,8840,8
NAMISINDWA,2024,4720,4310,9030,8
NAMISINDWA,2025,4830,4390,9220,8
NAMUTUMBA,2015,4660,4270,8930,8
NAMUTUMBA,2016,4780,4360,9140,8
NAMUTUMBA,2017,4910,4440,9350,8
NAMUTUMBA,2018,4970,4430,9400,8
NAMUTUMBA,2019,5030,4470,9500,8
NAMUTUMBA,2020,5100,4520,9620,8
NAMUTUMBA,2021,5240,4630,9870,8
NAMUTUMBA,2022,5540,4850,10390,8
NAMUTUMBA,2023,5620,5170,10790,8
NAMUTUMBA,2024,5750,5290,11040,8
NAMUTUMBA,2025,5880,5400,11280,8
NAPAK,2015,2770,2690,5460,8
NAPAK,2016,2790,2710,5500,8
NAPAK,2017,2810,2730,5540,8
NAPAK,2018,2800,2690,5490,8
NAPAK,2019,2780,2690,5470,8
NAPAK,2020,2760,2690,5450,8
NAPAK,2021,2790,2720,5510,8
NAPAK,2022,2900,2820,5720,8
NAPAK,2023,2880,2970,5850,8
NAPAK,2024,2890,3000,5890,8
NAPAK,2025,2910,3030,5940,8
NEBBI,2015,4020,3860,7880,8
NEBBI,2016,4150,3970,8120,8
NEBBI,2017,4280,4090,8370,8
NEBBI,2018,4420,4200,8620,8
NEBBI,2019,4550,4320,8870,8
NEBBI,2020,4690,4430,9120,8
NEBBI,2021,4830,4550,9380,8
NEBBI,2022,4970,4670,9640,8
NEBBI,2023,5110,4790,9900,8
NEBBI,2024,5240,4900,10140,8
NEBBI,2025,5380,5010,10390,8
NGORA,2015,2500,2400,4900,8
NGORA,2016,2560,2430,4990,8
NGORA,2017,2610,2460,5070,8
NGORA,2018,2630,2440,5070,8
NGORA,2019,2630,2450,5080,8
NGORA,2020,2650,2460,5110,8
NGORA,2021,2710,2500,5210,8
NGORA,2022,2840,2600,5440,8
NGORA,2023,2860,2760,5620,8
NGORA,2024,2910,2810,5720,8
NGORA,2025,2960,2850,5810,8
NTOROKO,2015,1040,970,2010,8
NTOROKO,2016,1050,980,2030,8
NTOROKO,2017,1070,970,2040,8
NTOROKO,2018,1080,970,2050,8
NTOROKO,2019,1080,950,2030,8
NTOROKO,2020,1080,950,2030,8
NTOROKO,2021,1100,970,2070,8
NTOROKO,2022,1150,1000,2150,8
NTOROKO,2023,1160,1050,2210,8
NTOROKO,2024,1170,1060,2230,8
NTOROKO,2025,1180,1070,2250,8
NTUNGAMO,2015,7450,7410,14860,8
NTUNGAMO,2016,7610,7550,15160,8
NTUNGAMO,2017,7770,7690,15460,8
NTUNGAMO,2018,7940,7830,15770,8
NTUNGAMO,2019,8100,7970,16070,8
NTUNGAMO,2020,8260,8110,16370,8
NTUNGAMO,2021,8420,8240,16660,8
NTUNGAMO,2022,8570,8370,16940,8
NTUNGAMO,2023,8730,8500,17230,8
NTUNGAMO,2024,8880,8620,17500,8
NTUNGAMO,2025,9020,8740,17760,8
NWOYA,2015,2540,2340,4880,8
NWOYA,2016,2810,2580,5390,8
NWOYA,2017,3100,2840,5940,8
NWOYA,2018,3420,3130,6550,8
NWOYA,2019,3780,3440,7220,8
NWOYA,2020,4170,3790,7960,8
NWOYA,2021,4600,4170,8770,8
NWOYA,2022,5060,4580,9640,8
NWOYA,2023,5570,5030,10600,8
NWOYA,2024,6120,5520,11640,8
NWOYA,2025,6730,6050,12780,8
OBONGI,2015,820,690,1510,8
OBONGI,2016,840,690,1530,8
OBONGI,2017,850,700,1550,8
OBONGI,2018,850,700,1550,8
OBONGI,2019,850,690,1540,8
OBONGI,2020,850,690,1540,8
OBONGI,2021,860,710,1570,8
OBONGI,2022,910,730,1640,8
OBONGI,2023,910,770,1680,8
OBONGI,2024,910,780,1690,8
OBONGI,2025,930,780,1710,8
OMORO,2015,2770,2720,5490,8
OMORO,2016,2840,2770,5610,8
OMORO,2017,2920,2830,5750,8
OMORO,2018,2960,2840,5800,8
OMORO,2019,2990,2860,5850,8
OMORO,2020,3040,2910,5950,8
OMORO,2021,3120,2980,6100,8
OMORO,2022,3300,3130,6430,8
OMORO,2023,3350,3350,6700,8
OMORO,2024,3430,3420,6850,8
OMORO,2025,3510,3500,7010,8
OTUKE,2015,1940,1870,3810,8
OTUKE,2016,2020,1950,3970,8
OTUKE,2017,2110,2040,4150,8
OTUKE,2018,2210,2120,4330,8
OTUKE,2019,2310,2210,4520,8
OTUKE,2020,2410,2310,4720,8
OTUKE,2021,2510,2400,4910,8
OTUKE,2022,2610,2490,5100,8
OTUKE,2023,2720,2590,5310,8
OTUKE,2024,2830,2690,5520,8
OTUKE,2025,2940,2800,5740,8
OYAM,2015,6880,6770,13650,8
OYAM,2016,7090,6970,14060,8
OYAM,2017,7300,7170,14470,8
OYAM,2018,7520,7380,14900,8
OYAM,2019,7750,7590,15340,8
OYAM,2020,7970,7800,15770,8
OYAM,2021,8200,8010,16210,8
OYAM,2022,8420,8220,16640,8
OYAM,2023,8650,8430,17080,8
OYAM,2024,8880,8650,17530,8
OYAM,2025,9100,8860,17960,8
PADER,2015,3240,3060,6300,8
PADER,2016,3270,3090,6360,8
PADER,2017,3290,3100,6390,8
PADER,2018,3290,3060,6350,8
PADER,2019,3260,3040,6300,8
PADER,2020,3250,3040,6290,8
PADER,2021,3280,3070,6350,8
PADER,2022,3410,3170,6580,8
PADER,2023,3400,3340,6740,8
PADER,2024,3410,3370,6780,8
PADER,2025,3430,3390,6820,8
PAKWACH,2015,2640,2640,5280,8
PAKWACH,2016,2760,2740,5500,8
PAKWACH,2017,2870,2840,5710,8
PAKWACH,2018,2990,2940,5930,8
PAKWACH,2019,3110,3050,6160,8
PAKWACH,2020,3240,3150,6390,8
PAKWACH,2021,3370,3260,6630,8
PAKWACH,2022,3500,3370,6870,8
PAKWACH,2023,3630,3480,7110,8
PAKWACH,2024,3760,3590,7350,8
PAKWACH,2025,3900,3710,7610,8
PALLISA,2015,5070,4880,9950,8
PALLISA,2016,5250,5020,10270,8
PALLISA,2017,5430,5160,10590,8
PALLISA,2018,5560,5220,10780,8
PALLISA,2019,5670,5310,10980,8
PALLISA,2020,5800,5440,11240,8
PALLISA,2021,6020,5620,11640,8
PALLISA,2022,6430,5950,12380,8
PALLISA,2023,6580,6420,13000,8
PALLISA,2024,6790,6620,13410,8
PALLISA,2025,7010,6830,13840,8
RAKAI,2015,4970,4800,9770,8
RAKAI,2016,5040,4850,9890,8
RAKAI,2017,5130,4880,10010,8
RAKAI,2018,5150,4840,9990,8
RAKAI,2019,5160,4830,9990,8
RAKAI,2020,5180,4840,10020,8
RAKAI,2021,5280,4910,10190,8
RAKAI,2022,5520,5100,10620,8
RAKAI,2023,5550,5380,10930,8
RAKAI,2024,5630,5450,11080,8
RAKAI,2025,5700,5510,11210,8
RUBANDA,2015,3140,3150,6290,8
RUBANDA,2016,3180,3170,6350,8
RUBANDA,2017,3220,3200,6420,8
RUBANDA,2018,3260,3220,6480,8
RUBANDA,2019,3300,3240,6540,8
RUBANDA,2020,3350,3270,6620,8
RUBANDA,2021,3380,3290,6670,8
RUBANDA,2022,3420,3300,6720,8
RUBANDA,2023,3450,3320,6770,8
RUBANDA,2024,3480,3330,6810,8
RUBANDA,2025,3510,3340,6850,8
RUBIRIZI,2015,2120,2110,4230,8
RUBIRIZI,2016,2170,2150,4320,8
RUBIRIZI,2017,2210,2190,4400,8
RUBIRIZI,2018,2260,2230,4490,8
RUBIRIZI,2019,2300,2270,4570,8
RUBIRIZI,2020,2340,2310,4650,8
RUBIRIZI,2021,2390,2350,4740,8
RUBIRIZI,2022,2430,2390,4820,8
RUBIRIZI,2023,2470,2430,4900,8
RUBIRIZI,2024,2510,2460,4970,8
RUBIRIZI,2025,2540,2500,5040,8
RUKIGA,2015,1430,1460,2890,8
RUKIGA,2016,1440,1470,2910,8
RUKIGA,2017,1460,1480,2940,8
RUKIGA,2018,1470,1490,2960,8
RUKIGA,2019,1490,1500,2990,8
RUKIGA,2020,1500,1510,3010,8
RUKIGA,2021,1510,1510,3020,8
RUKIGA,2022,1520,1520,3040,8
RUKIGA,2023,1530,1530,3060,8
RUKIGA,2024,1540,1530,3070,8
RUKIGA,2025,1540,1530,3070,8
RUKUNGIRI,2015,4660,4650,9310,8
RUKUNGIRI,2016,4710,4690,9400,8
RUKUNGIRI,2017,4770,4740,9510,8
RUKUNGIRI,2018,4820,4780,9600,8
RUKUNGIRI,2019,4880,4820,9700,8
RUKUNGIRI,2020,4930,4860,9790,8
RUKUNGIRI,2021,4980,4900,9880,8
RUKUNGIRI,2022,5020,4930,9950,8
RUKUNGIRI,2023,5070,4970,10040,8
RUKUNGIRI,2024,5100,5000,10100,8
RUKUNGIRI,2025,5140,5020,10160,8
RWAMPARA,2015,2060,2040,4100,8
RWAMPARA,2016,2100,2080,4180,8
RWAMPARA,2017,2150,2130,4280,8
RWAMPARA,2018,2200,2170,4370,8
RWAMPARA,2019,2250,2220,4470,8
RWAMPARA,2020,2300,2260,4560,8
RWAMPARA,2021,2340,2300,4640,8
RWAMPARA,2022,2390,2350,4740,8
RWAMPARA,2023,2430,2390,4820,8
RWAMPARA,2024,2480,2440,4920,8
RWAMPARA,2025,2520,2480,5000,8
SERERE,2015,5360,5040,10400,8
SERERE,2016,5520,5170,10690,8
SERERE,2017,5700,5300,11000,8
SERERE,2018,5810,5330,11140,8
SERERE,2019,5900,5410,11310,8
SERERE,2020,6020,5510,11530,8
SERERE,2021,6220,5680,11900,8
SERERE,2022,6620,5990,12610,8
SERERE,2023,6750,6440,13190,8
SERERE,2024,6940,6620,13560,8
SERERE,2025,7140,6800,13940,8
SHEEMA,2015,2730,2960,5690,8
SHEEMA,2016,2760,2990,5750,8
SHEEMA,2017,2790,3020,5810,8
SHEEMA,2018,2830,3050,5880,8
SHEEMA,2019,2860,3080,5940,8
SHEEMA,2020,2890,3110,6000,8
SHEEMA,2021,2920,3130,6050,8
SHEEMA,2022,2950,3160,6110,8
SHEEMA,2023,2970,3180,6150,8
SHEEMA,2024,3000,3200,6200,8
SHEEMA,2025,3020,3220,6240,8
SIRONKO,2015,3880,3700,7580,8
SIRONKO,2016,3980,3770,7750,8
SIRONKO,2017,4070,3850,7920,8
SIRONKO,2018,4170,3930,8100,8
SIRONKO,2019,4270,4000,8270,8
SIRONKO,2020,4360,4080,8440,8
SIRONKO,2021,4450,4150,8600,8
SIRONKO,2022,4550,4230,8780,8
SIRONKO,2023,4640,4300,8940,8
SIRONKO,2024,4730,4370,9100,8
SIRONKO,2025,4820,4440,9260,8
SOROTI,2015,4970,4610,9580,8
SOROTI,2016,5100,4710,9810,8
SOROTI,2017,5240,4800,10040,8
SOROTI,2018,5320,4810,10130,8
SOROTI,2019,5380,4860,10240,8
SOROTI,2020,5460,4930,10390,8
SOROTI,2021,5630,5060,10690,8
SOROTI,2022,5950,5310,11260,8
SOROTI,2023,6040,5680,11720,8
SOROTI,2024,6190,5820,12010,8
SOROTI,2025,6340,5950,12290,8
SSEMBABULE,2015,4290,4090,8380,8
SSEMBABULE,2016,4370,4140,8510,8
SSEMBABULE,2017,4450,4190,8640,8
SSEMBABULE,2018,4490,4170,8660,8
SSEMBABULE,2019,4510,4180,8690,8
SSEMBABULE,2020,4550,4200,8750,8
SSEMBABULE,2021,4650,4280,8930,8
SSEMBABULE,2022,4880,4460,9340,8
SSEMBABULE,2023,4920,4730,9650,8
SSEMBABULE,2024,5010,4810,9820,8
SSEMBABULE,2025,5090,4870,9960,8
TORORO,2015,8760,8510,17270,8
TORORO,2016,9000,8730,17730,8
TORORO,2017,9230,8950,18180,8
TORORO,2018,9480,9170,18650,8
TORORO,2019,9720,9390,19110,8
TORORO,2020,9960,9610,19570,8
TORORO,2021,10210,9830,20040,8
TORORO,2022,10450,10050,20500,8
TORORO,2023,10690,10270,20960,8
TORORO,2024,10920,10480,21400,8
TORORO,2025,11160,10690,21850,8
WAKISO,2015,26340,26420,52760,8
WAKISO,2016,28110,28220,56330,8
WAKISO,2017,29990,30160,60150,8
WAKISO,2018,31980,32200,64180,8
WAKISO,2019,34110,34360,68470,8
WAKISO,2020,36330,36640,72970,8
WAKISO,2021,38660,39070,77730,8
WAKISO,2022,41140,41650,82790,8
WAKISO,2023,43750,44330,88080,8
WAKISO,2024,46480,47150,93630,8
WAKISO,2025,49340,50150,99490,8
YUMBE,2015,10130,11090,21220,8
YUMBE,2016,10560,11590,22150,8
YUMBE,2017,10990,12100,23090,8
YUMBE,2018,11320,12400,23720,8
YUMBE,2019,11620,12830,24450,8
YUMBE,2020,11960,13320,25280,8
YUMBE,2021,12490,13990,26480,8
YUMBE,2022,13410,15040,28450,8
YUMBE,2023,13810,16460,30270,8
YUMBE,2024,14350,17250,31600,8
YUMBE,2025,14910,18070,32980,8
ZOMBO,2015,4370,4100,8470,8
ZOMBO,2016,4510,4220,8730,8
ZOMBO,2017,4650,4330,8980,8
ZOMBO,2018,4790,4450,9240,8
ZOMBO,2019,4930,4570,9500,8
ZOMBO,2020,5080,4690,9770,8
ZOMBO,2021,5220,4810,10030,8
ZOMBO,2022,5370,4940,10310,8
ZOMBO,2023,5510,5060,10570,8
ZOMBO,2024,5660,5180,10840,8
ZOMBO,2025,5800,5300,11100,8
MADI OKOLLO,2015,310,470,780,80
MADI OKOLLO,2016,350,450,800,80
MADI OKOLLO,2017,340,440,780,80
MADI OKOLLO,2018,310,460,770,80
MADI OKOLLO,2019,360,480,840,80
MADI OKOLLO,2020,390,550,940,80
MADI OKOLLO,2021,400,560,960,80
MADI OKOLLO,2022,370,540,910,80
MADI OKOLLO,2023,400,500,900,80
MADI OKOLLO,2024,440,540,980,80
MADI OKOLLO,2025,430,590,1020,80
ABIM,2015,370,640,1010,80
ABIM,2016,450,690,1140,80
ABIM,2017,540,730,1270,80
ABIM,2018,550,820,1370,80
ABIM,2019,530,960,1490,80
ABIM,2020,710,1010,1720,80
ABIM,2021,720,1220,1940,80
ABIM,2022,880,1390,2270,80
ABIM,2023,990,1570,2560,80
ABIM,2024,1230,1710,2940,80
ABIM,2025,1430,1860,3290,80
ADJUMANI,2015,320,610,930,80
ADJUMANI,2016,300,620,920,80
ADJUMANI,2017,370,650,1020,80
ADJUMANI,2018,320,660,980,80
ADJUMANI,2019,300,600,900,80
ADJUMANI,2020,280,610,890,80
ADJUMANI,2021,300,670,970,80
ADJUMANI,2022,290,660,950,80
ADJUMANI,2023,290,680,970,80
ADJUMANI,2024,340,640,980,80
ADJUMANI,2025,290,630,920,80
AGAGO,2015,610,1030,1640,80
AGAGO,2016,630,970,1600,80
AGAGO,2017,630,1100,1730,80
AGAGO,2018,590,1110,1700,80
AGAGO,2019,650,1090,1740,80
AGAGO,2020,660,1170,1830,80
AGAGO,2021,740,1130,1870,80
AGAGO,2022,690,1110,1800,80
AGAGO,2023,680,1130,1810,80
AGAGO,2024,720,1160,1880,80
AGAGO,2025,680,1180,1860,80
ALEBTONG,2015,230,290,520,80
ALEBTONG,2016,220,270,490,80
ALEBTONG,2017,200,780,980,80
ALEBTONG,2018,10,760,770,80
ALEBTONG,2019,90,900,990,80
ALEBTONG,2020,190,950,1140,80
ALEBTONG,2021,300,1010,1310,80
ALEBTONG,2022,430,1120,1550,80
ALEBTONG,2023,570,1200,1770,80
ALEBTONG,2024,640,1240,1880,80
ALEBTONG,2025,750,1190,1940,80
AMOLATAR,2015,120,110,230,80
AMOLATAR,2016,110,100,210,80
AMOLATAR,2017,120,90,210,80
AMOLATAR,2018,110,80,190,80
AMOLATAR,2019,100,70,170,80
AMOLATAR,2020,100,80,180,80
AMOLATAR,2021,100,90,190,80
AMOLATAR,2022,120,90,210,80
AMOLATAR,2023,120,100,220,80
AMOLATAR,2024,130,110,240,80
AMOLATAR,2025,130,110,240,80
AMUDAT,2015,770,710,1480,80
AMUDAT,2016,710,860,1570,80
AMUDAT,2017,870,940,1810,80
AMUDAT,2018,890,1120,2010,80
AMUDAT,2019,960,1140,2100,80
AMUDAT,2020,1030,1360,2390,80
AMUDAT,2021,1150,1500,2650,80
AMUDAT,2022,1220,1570,2790,80
AMUDAT,2023,1320,1630,2950,80
AMUDAT,2024,1480,1780,3260,80
AMUDAT,2025,1580,1910,3490,80
AMURIA,2015,110,140,250,80
AMURIA,2016,120,140,260,80
AMURIA,2017,110,140,250,80
AMURIA,2018,110,130,240,80
AMURIA,2019,100,120,220,80
AMURIA,2020,110,110,220,80
AMURIA,2021,100,110,210,80
AMURIA,2022,110,120,230,80
AMURIA,2023,120,130,250,80
AMURIA,2024,130,150,280,80
AMURIA,2025,140,160,300,80
AMURU,2015,280,940,1220,80
AMURU,2016,290,930,1220,80
AMURU,2017,400,1000,1400,80
AMURU,2018,510,1060,1570,80
AMURU,2019,620,1140,1760,80
AMURU,2020,730,1270,2000,80
AMURU,2021,850,1320,2170,80
AMURU,2022,1040,1520,2560,80
AMURU,2023,1200,1460,2660,80
AMURU,2024,1280,1620,2900,80
AMURU,2025,1530,1540,3070,80
APAC,2015,630,800,1430,80
APAC,2016,690,860,1550,80
APAC,2017,720,830,1550,80
APAC,2018,750,910,1660,80
APAC,2019,770,930,1700,80
APAC,2020,840,980,1820,80
APAC,2021,810,1000,1810,80
APAC,2022,870,1030,1900,80
APAC,2023,850,1090,1940,80
APAC,2024,880,1100,1980,80
APAC,2025,960,1130,2090,80
ARUA,2015,1390,2050,3440,80
ARUA,2016,1520,2160,3680,80
ARUA,2017,1530,2210,3740,80
ARUA,2018,1560,2230,3790,80
ARUA,2019,1600,2270,3870,80
ARUA,2020,1690,2360,4050,80
ARUA,2021,1710,2480,4190,80
ARUA,2022,1790,2570,4360,80
ARUA,2023,1810,2560,4370,80
ARUA,2024,1880,2660,4540,80
ARUA,2025,1900,2720,4620,80
BUDAKA,2015,200,240,440,80
BUDAKA,2016,340,230,570,80
BUDAKA,2017,380,320,700,80
BUDAKA,2018,520,420,940,80
BUDAKA,2019,680,500,1180,80
BUDAKA,2020,860,610,1470,80
BUDAKA,2021,1090,730,1820,80
BUDAKA,2022,1330,750,2080,80
BUDAKA,2023,1600,880,2480,80
BUDAKA,2024,1940,820,2760,80
BUDAKA,2025,2170,950,3120,80
BUDUDA,2015,240,460,700,80
BUDUDA,2016,170,430,600,80
BUDUDA,2017,200,500,700,80
BUDUDA,2018,150,670,820,80
BUDUDA,2019,160,830,990,80
BUDUDA,2020,140,1030,1170,80
BUDUDA,2021,250,1220,1470,80
BUDUDA,2022,360,1490,1850,80
BUDUDA,2023,480,1600,2080,80
BUDUDA,2024,720,1940,2660,80
BUDUDA,2025,720,2010,2730,80
BUGIRI,2015,440,840,1280,80
BUGIRI,2016,570,950,1520,80
BUGIRI,2017,790,1040,1830,80
BUGIRI,2018,1060,1260,2320,80
BUGIRI,2019,1480,1360,2840,80
BUGIRI,2020,1810,1500,3310,80
BUGIRI,2021,2250,1600,3850,80
BUGIRI,2022,2700,1690,4390,80
BUGIRI,2023,3220,1870,5090,80
BUGIRI,2024,3740,1980,5720,80
BUGIRI,2025,4420,2180,6600,80
BUGWERI,2015,1050,1550,2600,80
BUGWERI,2016,1140,1600,2740,80
BUGWERI,2017,1170,1570,2740,80
BUGWERI,2018,1290,1660,2950,80
BUGWERI,2019,1400,1730,3130,80
BUGWERI,2020,1540,1860,3400,80
BUGWERI,2021,1670,1890,3560,80
BUGWERI,2022,1890,1940,3830,80
BUGWERI,2023,2120,2030,4150,80
BUGWERI,2024,2410,2190,4600,80
BUGWERI,2025,2570,2180,4750,80
BUHWEJU,2015,410,530,940,80
BUHWEJU,2016,460,540,1000,80
BUHWEJU,2017,440,570,1010,80
BUHWEJU,2018,490,590,1080,80
BUHWEJU,2019,490,620,1110,80
BUHWEJU,2020,470,600,1070,80
BUHWEJU,2021,540,660,1200,80
BUHWEJU,2022,510,670,1180,80
BUHWEJU,2023,550,670,1220,80
BUHWEJU,2024,540,730,1270,80
BUHWEJU,2025,590,700,1290,80
BUIKWE,2015,1750,2890,4640,80
BUIKWE,2016,1570,2760,4330,80
BUIKWE,2017,1450,2720,4170,80
BUIKWE,2018,1380,2570,3950,80
BUIKWE,2019,1260,2550,3810,80
BUIKWE,2020,1230,2480,3710,80
BUIKWE,2021,1160,2480,3640,80
BUIKWE,2022,1110,2570,3680,80
BUIKWE,2023,1110,2740,3850,80
BUIKWE,2024,1050,2670,3720,80
BUIKWE,2025,1140,2770,3910,80
BUKEDEA,2015,40,780,820,80
BUKEDEA,2016,80,800,880,80
BUKEDEA,2017,160,870,1030,80
BUKEDEA,2018,350,1060,1410,80
BUKEDEA,2019,460,1110,1570,80
BUKEDEA,2020,510,1290,1800,80
BUKEDEA,2021,760,1410,2170,80
BUKEDEA,2022,970,1560,2530,80
BUKEDEA,2023,1150,1640,2790,80
BUKEDEA,2024,1420,1800,3220,80
BUKEDEA,2025,1630,1770,3400,80
BUKOMANSIMBI,2015,580,720,1300,80
BUKOMANSIMBI,2016,610,770,1380,80
BUKOMANSIMBI,2017,670,720,1390,80
BUKOMANSIMBI,2018,630,790,1420,80
BUKOMANSIMBI,2019,730,760,1490,80
BUKOMANSIMBI,2020,900,780,1680,80
BUKOMANSIMBI,2021,920,750,1670,80
BUKOMANSIMBI,2022,1070,760,1830,80
BUKOMANSIMBI,2023,1090,720,1810,80
BUKOMANSIMBI,2024,1200,700,1900,80
BUKOMANSIMBI,2025,1380,650,2030,80
BUKWO,2015,220,370,590,80
BUKWO,2016,230,420,650,80
BUKWO,2017,290,380,670,80
BUKWO,2018,300,400,700,80
BUKWO,2019,290,420,710,80
BUKWO,2020,320,450,770,80
BUKWO,2021,340,490,830,80
BUKWO,2022,310,530,840,80
BUKWO,2023,320,540,860,80
BUKWO,2024,370,590,960,80
BUKWO,2025,390,590,980,80
BULAMBULI,2015,200,80,280,80
BULAMBULI,2016,130,130,260,80
BULAMBULI,2017,140,70,210,80
BULAMBULI,2018,140,110,250,80
BULAMBULI,2019,140,200,340,80
BULAMBULI,2020,160,210,370,80
BULAMBULI,2021,210,310,520,80
BULAMBULI,2022,280,280,560,80
BULAMBULI,2023,270,310,580,80
BULAMBULI,2024,210,230,440,80
BULAMBULI,2025,230,200,430,80
BULIISA,2015,320,460,780,80
BULIISA,2016,340,460,800,80
BULIISA,2017,330,460,790,80
BULIISA,2018,330,490,820,80
BULIISA,2019,390,550,940,80
BULIISA,2020,360,590,950,80
BULIISA,2021,380,560,940,80
BULIISA,2022,510,640,1150,80
BULIISA,2023,420,610,1030,80
BULIISA,2024,480,560,1040,80
BULIISA,2025,530,690,1220,80
BUNDIBUGYO,2015,920,2070,2990,80
BUNDIBUGYO,2016,880,2080,2960,80
BUNDIBUGYO,2017,950,2040,2990,80
BUNDIBUGYO,2018,980,2230,3210,80
BUNDIBUGYO,2019,990,2150,3140,80
BUNDIBUGYO,2020,1070,2330,3400,80
BUNDIBUGYO,2021,1100,2240,3340,80
BUNDIBUGYO,2022,1150,2370,3520,80
BUNDIBUGYO,2023,1270,2450,3720,80
BUNDIBUGYO,2024,1260,2660,3920,80
BUNDIBUGYO,2025,1410,2680,4090,80
BUNYANGABU,2015,370,800,1170,80
BUNYANGABU,2016,400,710,1110,80
BUNYANGABU,2017,430,750,1180,80
BUNYANGABU,2018,420,670,1090,80
BUNYANGABU,2019,390,760,1150,80
BUNYANGABU,2020,380,690,1070,80
BUNYANGABU,2021,430,710,1140,80
BUNYANGABU,2022,500,760,1260,80
BUNYANGABU,2023,490,760,1250,80
BUNYANGABU,2024,400,710,1110,80
BUNYANGABU,2025,530,760,1290,80
BUSHENYI,2015,1160,1610,2770,80
BUSHENYI,2016,1120,1560,2680,80
BUSHENYI,2017,1170,1590,2760,80
BUSHENYI,2018,1120,1610,2730,80
BUSHENYI,2019,1180,1660,2840,80
BUSHENYI,2020,1180,1630,2810,80
BUSHENYI,2021,1210,1660,2870,80
BUSHENYI,2022,1160,1660,2820,80
BUSHENYI,2023,1240,1600,2840,80
BUSHENYI,2024,1200,1650,2850,80
BUSHENYI,2025,1260,1690,2950,80
BUSIA,2015,190,330,520,80
BUSIA,2016,200,350,550,80
BUSIA,2017,200,340,540,80
BUSIA,2018,190,320,510,80
BUSIA,2019,180,290,470,80
BUSIA,2020,180,270,450,80
BUSIA,2021,180,260,440,80
BUSIA,2022,190,280,470,80
BUSIA,2023,200,300,500,80
BUSIA,2024,220,340,560,80
BUSIA,2025,240,370,610,80
BUTALEJA,2015,110,150,260,80
BUTALEJA,2016,130,170,300,80
BUTALEJA,2017,140,180,320,80
BUTALEJA,2018,130,180,310,80
BUTALEJA,2019,130,160,290,80
BUTALEJA,2020,130,150,280,80
BUTALEJA,2021,120,130,250,80
BUTALEJA,2022,120,130,250,80
BUTALEJA,2023,130,150,280,80
BUTALEJA,2024,150,170,320,80
BUTALEJA,2025,160,190,350,80
BUTAMBALA,2015,780,1180,1960,80
BUTAMBALA,2016,740,1220,1960,80
BUTAMBALA,2017,840,1220,2060,80
BUTAMBALA,2018,960,1260,2220,80
BUTAMBALA,2019,960,1220,2180,80
BUTAMBALA,2020,1020,1240,2260,80
BUTAMBALA,2021,1120,1390,2510,80
BUTAMBALA,2022,1180,1460,2640,80
BUTAMBALA,2023,1340,1450,2790,80
BUTAMBALA,2024,1420,1470,2890,80
BUTAMBALA,2025,1520,1490,3010,80
BUTEBO,2015,80,150,230,80
BUTEBO,2016,140,190,330,80
BUTEBO,2017,230,250,480,80
BUTEBO,2018,210,250,460,80
BUTEBO,2019,310,290,600,80
BUTEBO,2020,400,290,690,80
BUTEBO,2021,530,400,930,80
BUTEBO,2022,650,390,1040,80
BUTEBO,2023,660,490,1150,80
BUTEBO,2024,810,530,1340,80
BUTEBO,2025,1000,610,1610,80
BUVUMA,2015,210,180,390,80
BUVUMA,2016,200,120,320,80
BUVUMA,2017,180,200,380,80
BUVUMA,2018,250,140,390,80
BUVUMA,2019,200,210,410,80
BUVUMA,2020,280,190,470,80
BUVUMA,2021,240,220,460,80
BUVUMA,2022,270,230,500,80
BUVUMA,2023,340,260,600,80
BUVUMA,2024,310,280,590,80
BUVUMA,2025,330,250,580,80
BUYENDE,2015,1250,2070,3320,80
BUYENDE,2016,1560,2300,3860,80
BUYENDE,2017,1870,2630,4500,80
BUYENDE,2018,2240,2820,5060,80
BUYENDE,2019,2650,3050,5700,80
BUYENDE,2020,3160,3320,6480,80
BUYENDE,2021,3560,3550,7110,80
BUYENDE,2022,4110,3880,7990,80
BUYENDE,2023,4620,4320,8940,80
BUYENDE,2024,5310,4820,10130,80
BUYENDE,2025,6040,5400,11440,80
DOKOLO,2015,540,860,1400,80
DOKOLO,2016,580,960,1540,80
DOKOLO,2017,590,950,1540,80
DOKOLO,2018,590,950,1540,80
DOKOLO,2019,610,940,1550,80
DOKOLO,2020,640,970,1610,80
DOKOLO,2021,590,1040,1630,80
DOKOLO,2022,720,1030,1750,80
DOKOLO,2023,680,1060,1740,80
DOKOLO,2024,700,1050,1750,80
DOKOLO,2025,730,1050,1780,80
GOMBA,2015,400,730,1130,80
GOMBA,2016,370,700,1070,80
GOMBA,2017,430,840,1270,80
GOMBA,2018,440,830,1270,80
GOMBA,2019,320,840,1160,80
GOMBA,2020,450,910,1360,80
GOMBA,2021,510,840,1350,80
GOMBA,2022,570,840,1410,80
GOMBA,2023,600,860,1460,80
GOMBA,2024,640,830,1470,80
GOMBA,2025,690,810,1500,80
GULU,2015,880,1170,2050,80
GULU,2016,920,1190,2110,80
GULU,2017,890,1280,2170,80
GULU,2018,930,1300,2230,80
GULU,2019,970,1310,2280,80
GULU,2020,980,1330,2310,80
GULU,2021,1040,1340,2380,80
GULU,2022,1020,1430,2450,80
GULU,2023,1090,1480,2570,80
GULU,2024,1110,1500,2610,80
GULU,2025,1140,1490,2630,80
HOIMA,2015,1000,1230,2230,80
HOIMA,2016,990,1290,2280,80
HOIMA,2017,1050,1330,2380,80
HOIMA,2018,1080,1450,2530,80
HOIMA,2019,1120,1450,2570,80
HOIMA,2020,1160,1490,2650,80
HOIMA,2021,1210,1560,2770,80
HOIMA,2022,1220,1680,2900,80
HOIMA,2023,1250,1620,2870,80
HOIMA,2024,1330,1730,3060,80
HOIMA,2025,1350,1740,3090,80
IBANDA,2015,930,1400,2330,80
IBANDA,2016,960,1450,2410,80
IBANDA,2017,1020,1510,2530,80
IBANDA,2018,1010,1450,2460,80
IBANDA,2019,1040,1480,2520,80
IBANDA,2020,1060,1500,2560,80
IBANDA,2021,1080,1570,2650,80
IBANDA,2022,1060,1590,2650,80
IBANDA,2023,1020,1630,2650,80
IBANDA,2024,1120,1620,2740,80
IBANDA,2025,1160,1670,2830,80
IGANGA,2015,1840,2530,4370,80
IGANGA,2016,1910,2540,4450,80
IGANGA,2017,1820,2510,4330,80
IGANGA,2018,1950,2550,4500,80
IGANGA,2019,1990,2640,4630,80
IGANGA,2020,2230,2640,4870,80
IGANGA,2021,2340,2770,5110,80
IGANGA,2022,2570,2860,5430,80
IGANGA,2023,2800,3020,5820,80
IGANGA,2024,3020,3100,6120,80
IGANGA,2025,3310,3280,6590,80
ISINGIRO,2015,1720,2390,4110,80
ISINGIRO,2016,1770,2500,4270,80
ISINGIRO,2017,1850,2610,4460,80
ISINGIRO,2018,1920,2670,4590,80
ISINGIRO,2019,2000,2760,4760,80
ISINGIRO,2020,2080,2840,4920,80
ISINGIRO,2021,2130,2980,5110,80
ISINGIRO,2022,2200,3000,5200,80
ISINGIRO,2023,2300,3120,5420,80
ISINGIRO,2024,2390,3220,5610,80
ISINGIRO,2025,2450,3290,5740,80
JINJA,2015,1150,1790,2940,80
JINJA,2016,1110,1850,2960,80
JINJA,2017,1140,1880,3020,80
JINJA,2018,1130,1970,3100,80
JINJA,2019,1230,1940,3170,80
JINJA,2020,1210,2000,3210,80
JINJA,2021,1260,2020,3280,80
JINJA,2022,1270,2000,3270,80
JINJA,2023,1210,2020,3230,80
JINJA,2024,1240,2070,3310,80
JINJA,2025,1300,2080,3380,80
KAABONG,2015,160,110,270,80
KAABONG,2016,160,120,280,80
KAABONG,2017,160,120,280,80
KAABONG,2018,170,120,290,80
KAABONG,2019,170,120,290,80
KAABONG,2020,180,130,310,80
KAABONG,2021,180,130,310,80
KAABONG,2022,190,130,320,80
KAABONG,2023,190,140,330,80
KAABONG,2024,190,140,330,80
KAABONG,2025,200,140,340,80
KABALE,2015,1160,1860,3020,80
KABALE,2016,1120,1850,2970,80
KABALE,2017,1180,1860,3040,80
KABALE,2018,1200,1820,3020,80
KABALE,2019,1210,1880,3090,80
KABALE,2020,1230,1930,3160,80
KABALE,2021,1240,1910,3150,80
KABALE,2022,1250,1930,3180,80
KABALE,2023,1230,2010,3240,80
KABALE,2024,1250,2010,3260,80
KABALE,2025,1260,2030,3290,80
KABAROLE,2015,1260,1950,3210,80
KABAROLE,2016,1270,1990,3260,80
KABAROLE,2017,1260,2000,3260,80
KABAROLE,2018,1280,2080,3360,80
KABAROLE,2019,1330,2150,3480,80
KABAROLE,2020,1380,2210,3590,80
KABAROLE,2021,1400,2240,3640,80
KABAROLE,2022,1400,2290,3690,80
KABAROLE,2023,1410,2320,3730,80
KABAROLE,2024,1480,2350,3830,80
KABAROLE,2025,1470,2380,3850,80
KABERAMAIDO,2015,120,140,260,80
KABERAMAIDO,2016,110,120,230,80
KABERAMAIDO,2017,110,110,220,80
KABERAMAIDO,2018,120,120,240,80
KABERAMAIDO,2019,120,120,240,80
KABERAMAIDO,2020,130,130,260,80
KABERAMAIDO,2021,150,160,310,80
KABERAMAIDO,2022,150,170,320,80
KABERAMAIDO,2023,170,170,340,80
KABERAMAIDO,2024,160,190,350,80
KABERAMAIDO,2025,150,170,320,80
KAGADI,2015,760,1280,2040,80
KAGADI,2016,790,1310,2100,80
KAGADI,2017,770,1400,2170,80
KAGADI,2018,880,1450,2330,80
KAGADI,2019,900,1460,2360,80
KAGADI,2020,910,1500,2410,80
KAGADI,2021,920,1560,2480,80
KAGADI,2022,950,1620,2570,80
KAGADI,2023,980,1680,2660,80
KAGADI,2024,1070,1710,2780,80
KAGADI,2025,1050,1740,2790,80
KAKUMIRO,2015,580,830,1410,80
KAKUMIRO,2016,630,940,1570,80
KAKUMIRO,2017,670,1030,1700,80
KAKUMIRO,2018,800,1060,1860,80
KAKUMIRO,2019,820,1210,2030,80
KAKUMIRO,2020,890,1250,2140,80
KAKUMIRO,2021,960,1380,2340,80
KAKUMIRO,2022,1080,1470,2550,80
KAKUMIRO,2023,1140,1660,2800,80
KAKUMIRO,2024,1240,1720,2960,80
KAKUMIRO,2025,1450,1900,3350,80
KALAKI,2015,330,630,960,80
KALAKI,2016,380,630,1010,80
KALAKI,2017,410,660,1070,80
KALAKI,2018,390,640,1030,80
KALAKI,2019,400,710,1110,80
KALAKI,2020,420,760,1180,80
KALAKI,2021,440,780,1220,80
KALAKI,2022,470,760,1230,80
KALAKI,2023,490,810,1300,80
KALAKI,2024,480,800,1280,80
KALAKI,2025,510,900,1410,80
KALANGALA,2015,240,90,330,80
KALANGALA,2016,250,150,400,80
KALANGALA,2017,270,130,400,80
KALANGALA,2018,290,130,420,80
KALANGALA,2019,280,170,450,80
KALANGALA,2020,310,110,420,80
KALANGALA,2021,240,200,440,80
KALANGALA,2022,300,170,470,80
KALANGALA,2023,270,180,450,80
KALANGALA,2024,310,170,480,80
KALANGALA,2025,320,170,490,80
KALIRO,2015,460,1290,1750,80
KALIRO,2016,520,1380,1900,80
KALIRO,2017,730,1490,2220,80
KALIRO,2018,850,1710,2560,80
KALIRO,2019,950,1770,2720,80
KALIRO,2020,1130,1930,3060,80
KALIRO,2021,1350,2150,3500,80
KALIRO,2022,1520,2270,3790,80
KALIRO,2023,1850,2530,4380,80
KALIRO,2024,2070,2740,4810,80
KALIRO,2025,2350,2930,5280,80
KALUNGU,2015,680,1110,1790,80
KALUNGU,2016,670,1030,1700,80
KALUNGU,2017,730,1040,1770,80
KALUNGU,2018,830,1030,1860,80
KALUNGU,2019,840,1060,1900,80
KALUNGU,2020,930,1110,2040,80
KALUNGU,2021,1080,1070,2150,80
KALUNGU,2022,1170,1120,2290,80
KALUNGU,2023,1300,1130,2430,80
KALUNGU,2024,1360,1090,2450,80
KALUNGU,2025,1360,930,2290,80
KAMPALA,2015,2080,3410,5490,80
KAMPALA,2016,2140,3520,5660,80
KAMPALA,2017,2140,3590,5730,80
KAMPALA,2018,2230,3670,5900,80
KAMPALA,2019,2230,3670,5900,80
KAMPALA,2020,2340,3740,6080,80
KAMPALA,2021,2340,3840,6180,80
KAMPALA,2022,2350,3960,6310,80
KAMPALA,2023,2340,3910,6250,80
KAMPALA,2024,2410,4040,6450,80
KAMPALA,2025,2500,4050,6550,80
KAMULI,2015,1520,2950,4470,80
KAMULI,2016,1690,3090,4780,80
KAMULI,2017,1890,3220,5110,80
KAMULI,2018,2070,3490,5560,80
KAMULI,2019,2300,3520,5820,80
KAMULI,2020,2680,3610,6290,80
KAMULI,2021,3150,3780,6930,80
KAMULI,2022,3580,3920,7500,80
KAMULI,2023,4090,4340,8430,80
KAMULI,2024,4690,4590,9280,80
KAMULI,2025,5300,4850,10150,80
KAMWENGE,2015,660,940,1600,80
KAMWENGE,2016,680,940,1620,80
KAMWENGE,2017,720,1010,1730,80
KAMWENGE,2018,750,1040,1790,80
KAMWENGE,2019,790,1080,1870,80
KAMWENGE,2020,780,1110,1890,80
KAMWENGE,2021,800,1190,1990,80
KAMWENGE,2022,850,1230,2080,80
KAMWENGE,2023,840,1250,2090,80
KAMWENGE,2024,940,1280,2220,80
KAMWENGE,2025,920,1310,2230,80
KANUNGU,2015,940,1380,2320,80
KANUNGU,2016,920,1450,2370,80
KANUNGU,2017,860,1480,2340,80
KANUNGU,2018,940,1490,2430,80
KANUNGU,2019,970,1480,2450,80
KANUNGU,2020,1000,1580,2580,80
KANUNGU,2021,1010,1610,2620,80
KANUNGU,2022,1020,1630,2650,80
KANUNGU,2023,1030,1610,2640,80
KANUNGU,2024,1030,1640,2670,80
KANUNGU,2025,1020,1630,2650,80
KAPCHORWA,2015,460,650,1110,80
KAPCHORWA,2016,470,730,1200,80
KAPCHORWA,2017,460,720,1180,80
KAPCHORWA,2018,470,770,1240,80
KAPCHORWA,2019,480,770,1250,80
KAPCHORWA,2020,530,800,1330,80
KAPCHORWA,2021,580,820,1400,80
KAPCHORWA,2022,510,830,1340,80
KAPCHORWA,2023,530,880,1410,80
KAPCHORWA,2024,570,890,1460,80
KAPCHORWA,2025,590,920,1510,80
KAPELEBYONG,2015,20,510,530,80
KAPELEBYONG,2016,30,500,530,80
KAPELEBYONG,2017,80,570,650,80
KAPELEBYONG,2018,90,660,750,80
KAPELEBYONG,2019,170,650,820,80
KAPELEBYONG,2020,220,730,950,80
KAPELEBYONG,2021,300,690,990,80
KAPELEBYONG,2022,410,860,1270,80
KAPELEBYONG,2023,600,820,1420,80
KAPELEBYONG,2024,670,990,1660,80
KAPELEBYONG,2025,740,1000,1740,80
KASESE,2015,2820,4980,7800,80
KASESE,2016,2910,4910,7820,80
KASESE,2017,2900,4890,7790,80
KASESE,2018,2990,4890,7880,80
KASESE,2019,3080,4990,8070,80
KASESE,2020,3160,5130,8290,80
KASESE,2021,3230,5040,8270,80
KASESE,2022,3400,5160,8560,80
KASESE,2023,3570,5200,8770,80
KASESE,2024,3810,5300,9110,80
KASESE,2025,4040,5460,9500,80
KASSANDA,2015,900,1210,2110,80
KASSANDA,2016,930,1190,2120,80
KASSANDA,2017,910,1220,2130,80
KASSANDA,2018,970,1320,2290,80
KASSANDA,2019,980,1320,2300,80
KASSANDA,2020,1000,1320,2320,80
KASSANDA,2021,1060,1310,2370,80
KASSANDA,2022,1030,1360,2390,80
KASSANDA,2023,1120,1370,2490,80
KASSANDA,2024,1150,1410,2560,80
KASSANDA,2025,1150,1420,2570,80
KATAKWI,2015,60,780,840,80
KATAKWI,2016,70,730,800,80
KATAKWI,2017,50,640,690,80
KATAKWI,2018,70,730,800,80
KATAKWI,2019,160,860,1020,80
KATAKWI,2020,240,1010,1250,80
KATAKWI,2021,290,1240,1530,80
KATAKWI,2022,550,1370,1920,80
KATAKWI,2023,560,1490,2050,80
KATAKWI,2024,570,1470,2040,80
KATAKWI,2025,630,1190,1820,80
KAYUNGA,2015,1970,3060,5030,80
KAYUNGA,2016,2070,3170,5240,80
KAYUNGA,2017,2190,3200,5390,80
KAYUNGA,2018,2250,3280,5530,80
KAYUNGA,2019,2620,3410,6030,80
KAYUNGA,2020,2870,3380,6250,80
KAYUNGA,2021,3180,3410,6590,80
KAYUNGA,2022,3480,3600,7080,80
KAYUNGA,2023,3810,3780,7590,80
KAYUNGA,2024,4220,3930,8150,80
KAYUNGA,2025,4500,4020,8520,80
KAZO,2015,800,970,1770,80
KAZO,2016,840,1010,1850,80
KAZO,2017,850,1070,1920,80
KAZO,2018,850,1070,1920,80
KAZO,2019,940,1100,2040,80
KAZO,2020,940,1120,2060,80
KAZO,2021,990,1150,2140,80
KAZO,2022,1040,1240,2280,80
KAZO,2023,1020,1270,2290,80
KAZO,2024,1110,1320,2430,80
KAZO,2025,1140,1350,2490,80
KIBAALE,2015,400,510,910,80
KIBAALE,2016,380,500,880,80
KIBAALE,2017,360,590,950,80
KIBAALE,2018,450,570,1020,80
KIBAALE,2019,390,650,1040,80
KIBAALE,2020,500,650,1150,80
KIBAALE,2021,500,700,1200,80
KIBAALE,2022,550,750,1300,80
KIBAALE,2023,530,740,1270,80
KIBAALE,2024,630,820,1450,80
KIBAALE,2025,640,840,1480,80
KIBOGA,2015,120,130,250,80
KIBOGA,2016,130,130,260,80
KIBOGA,2017,130,130,260,80
KIBOGA,2018,130,130,260,80
KIBOGA,2019,140,140,280,80
KIBOGA,2020,140,140,280,80
KIBOGA,2021,140,150,290,80
KIBOGA,2022,150,150,300,80
KIBOGA,2023,150,150,300,80
KIBOGA,2024,150,160,310,80
KIBOGA,2025,160,160,320,80
KIBUKU,2015,120,110,230,80
KIBUKU,2016,200,170,370,80
KIBUKU,2017,290,270,560,80
KIBUKU,2018,610,410,1020,80
KIBUKU,2019,750,540,1290,80
KIBUKU,2020,910,670,1580,80
KIBUKU,2021,1160,760,1920,80
KIBUKU,2022,1400,840,2240,80
KIBUKU,2023,1730,960,2690,80
KIBUKU,2024,1970,1120,3090,80
KIBUKU,2025,2340,1180,3520,80
KIKUUBE,2015,690,990,1680,80
KIKUUBE,2016,730,1020,1750,80
KIKUUBE,2017,790,1080,1870,80
KIKUUBE,2018,860,1090,1950,80
KIKUUBE,2019,900,1130,2030,80
KIKUUBE,2020,880,1210,2090,80
KIKUUBE,2021,950,1280,2230,80
KIKUUBE,2022,990,1340,2330,80
KIKUUBE,2023,1050,1440,2490,80
KIKUUBE,2024,1080,1470,2550,80
KIKUUBE,2025,1180,1560,2740,80
KIRUHURA,2015,580,820,1400,80
KIRUHURA,2016,630,850,1480,80
KIRUHURA,2017,550,880,1430,80
KIRUHURA,2018,670,940,1610,80
KIRUHURA,2019,700,970,1670,80
KIRUHURA,2020,680,960,1640,80
KIRUHURA,2021,780,1030,1810,80
KIRUHURA,2022,760,1040,1800,80
KIRUHURA,2023,780,1090,1870,80
KIRUHURA,2024,800,1140,1940,80
KIRUHURA,2025,840,1160,2000,80
KIRYANDONGO,2015,240,470,710,80
KIRYANDONGO,2016,170,410,580,80
KIRYANDONGO,2017,160,410,570,80
KIRYANDONGO,2018,130,410,540,80
KIRYANDONGO,2019,130,490,620,80
KIRYANDONGO,2020,160,430,590,80
KIRYANDONGO,2021,410,540,950,80
KIRYANDONGO,2022,110,610,720,80
KIRYANDONGO,2023,120,710,830,80
KIRYANDONGO,2024,180,860,1040,80
KIRYANDONGO,2025,330,1000,1330,80
KISORO,2015,920,2190,3110,80
KISORO,2016,1010,2020,3030,80
KISORO,2017,1140,2060,3200,80
KISORO,2018,1360,2010,3370,80
KISORO,2019,1650,2130,3780,80
KISORO,2020,1910,2130,4040,80
KISORO,2021,2150,2140,4290,80
KISORO,2022,2370,2010,4380,80
KISORO,2023,2650,1790,4440,80
KISORO,2024,2910,1730,4640,80
KISORO,2025,3130,1610,4740,80
KITAGWENDA,2015,500,660,1160,80
KITAGWENDA,2016,430,710,1140,80
KITAGWENDA,2017,520,740,1260,80
KITAGWENDA,2018,490,790,1280,80
KITAGWENDA,2019,570,790,1360,80
KITAGWENDA,2020,560,780,1340,80
KITAGWENDA,2021,590,790,1380,80
KITAGWENDA,2022,630,840,1470,80
KITAGWENDA,2023,670,940,1610,80
KITAGWENDA,2024,670,900,1570,80
KITAGWENDA,2025,660,990,1650,80
KITGUM,2015,180,920,1100,80
KITGUM,2016,130,890,1020,80
KITGUM,2017,150,820,970,80
KITGUM,2018,170,840,1010,80
KITGUM,2019,210,820,1030,80
KITGUM,2020,230,870,1100,80
KITGUM,2021,270,870,1140,80
KITGUM,2022,380,880,1260,80
KITGUM,2023,460,870,1330,80
KITGUM,2024,500,850,1350,80
KITGUM,2025,500,770,1270,80
KOBOKO,2015,230,1020,1250,80
KOBOKO,2016,230,1040,1270,80
KOBOKO,2017,270,980,1250,80
KOBOKO,2018,220,980,1200,80
KOBOKO,2019,180,1070,1250,80
KOBOKO,2020,320,1140,1460,80
KOBOKO,2021,480,1290,1770,80
KOBOKO,2022,490,1430,1920,80
KOBOKO,2023,670,1570,2240,80
KOBOKO,2024,800,1720,2520,80
KOBOKO,2025,920,1810,2730,80
KOLE,2015,860,1270,2130,80
KOLE,2016,810,1230,2040,80
KOLE,2017,910,1290,2200,80
KOLE,2018,890,1300,2190,80
KOLE,2019,990,1370,2360,80
KOLE,2020,940,1380,2320,80
KOLE,2021,980,1440,2420,80
KOLE,2022,990,1480,2470,80
KOLE,2023,1060,1510,2570,80
KOLE,2024,1050,1560,2610,80
KOLE,2025,1120,1540,2660,80
KOTIDO,2015,1210,1200,2410,80
KOTIDO,2016,1180,1240,2420,80
KOTIDO,2017,1150,1130,2280,80
KOTIDO,2018,1170,1130,2300,80
KOTIDO,2019,1170,1200,2370,80
KOTIDO,2020,1170,1130,2300,80
KOTIDO,2021,1200,1120,2320,80
KOTIDO,2022,1240,1300,2540,80
KOTIDO,2023,1410,1280,2690,80
KOTIDO,2024,1400,1410,2810,80
KOTIDO,2025,1550,1490,3040,80
KUMI,2015,110,840,950,80
KUMI,2016,100,880,980,80
KUMI,2017,50,850,900,80
KUMI,2018,170,990,1160,80
KUMI,2019,300,1120,1420,80
KUMI,2020,460,1110,1570,80
KUMI,2021,560,1180,1740,80
KUMI,2022,690,1210,1900,80
KUMI,2023,1010,1320,2330,80
KUMI,2024,1160,1230,2390,80
KUMI,2025,1290,1340,2630,80
KWANIA,2015,620,950,1570,80
KWANIA,2016,630,1000,1630,80
KWANIA,2017,670,980,1650,80
KWANIA,2018,660,980,1640,80
KWANIA,2019,720,1000,1720,80
KWANIA,2020,740,1080,1820,80
KWANIA,2021,740,1080,1820,80
KWANIA,2022,750,1150,1900,80
KWANIA,2023,700,1160,1860,80
KWANIA,2024,870,1200,2070,80
KWANIA,2025,840,1150,1990,80
KWEEN,2015,270,510,780,80
KWEEN,2016,290,460,750,80
KWEEN,2017,290,480,770,80
KWEEN,2018,310,450,760,80
KWEEN,2019,320,530,850,80
KWEEN,2020,330,530,860,80
KWEEN,2021,320,460,780,80
KWEEN,2022,290,470,760,80
KWEEN,2023,390,560,950,80
KWEEN,2024,360,540,900,80
KWEEN,2025,390,590,980,80
KYANKWANZI,2015,580,810,1390,80
KYANKWANZI,2016,640,810,1450,80
KYANKWANZI,2017,660,890,1550,80
KYANKWANZI,2018,670,910,1580,80
KYANKWANZI,2019,720,970,1690,80
KYANKWANZI,2020,760,1010,1770,80
KYANKWANZI,2021,830,1050,1880,80
KYANKWANZI,2022,800,1110,1910,80
KYANKWANZI,2023,910,1200,2110,80
KYANKWANZI,2024,910,1220,2130,80
KYANKWANZI,2025,960,1270,2230,80
KYEGEGWA,2015,710,990,1700,80
KYEGEGWA,2016,800,1120,1920,80
KYEGEGWA,2017,810,1160,1970,80
KYEGEGWA,2018,880,1290,2170,80
KYEGEGWA,2019,1020,1410,2430,80
KYEGEGWA,2020,1070,1470,2540,80
KYEGEGWA,2021,1170,1580,2750,80
KYEGEGWA,2022,1200,1680,2880,80
KYEGEGWA,2023,1330,1840,3170,80
KYEGEGWA,2024,1430,1970,3400,80
KYEGEGWA,2025,1620,2110,3730,80
KYENJOJO,2015,1350,2220,3570,80
KYENJOJO,2016,1380,2280,3660,80
KYENJOJO,2017,1480,2390,3870,80
KYENJOJO,2018,1480,2440,3920,80
KYENJOJO,2019,1540,2540,4080,80
KYENJOJO,2020,1610,2640,4250,80
KYENJOJO,2021,1700,2740,4440,80
KYENJOJO,2022,1810,2820,4630,80
KYENJOJO,2023,1800,2880,4680,80
KYENJOJO,2024,1900,2990,4890,80
KYENJOJO,2025,1950,3120,5070,80
KYOTERA,2015,670,680,1350,80
KYOTERA,2016,780,560,1340,80
KYOTERA,2017,870,550,1420,80
KYOTERA,2018,920,470,1390,80
KYOTERA,2019,1030,500,1530,80
KYOTERA,2020,1120,390,1510,80
KYOTERA,2021,1190,460,1650,80
KYOTERA,2022,1210,470,1680,80
KYOTERA,2023,1330,300,1630,80
KYOTERA,2024,1370,210,1580,80
KYOTERA,2025,1340,60,1400,80
KARENGA,2015,110,150,260,80
KARENGA,2016,110,110,220,80
KARENGA,2017,140,130,270,80
KARENGA,2018,120,130,250,80
KARENGA,2019,140,140,280,80
KARENGA,2020,150,110,260,80
KARENGA,2021,120,130,250,80
KARENGA,2022,140,140,280,80
KARENGA,2023,170,150,320,80
KARENGA,2024,60,150,210,80
KARENGA,2025,110,210,320,80
LAMWO,2015,230,860,1090,80
LAMWO,2016,300,910,1210,80
LAMWO,2017,280,890,1170,80
LAMWO,2018,400,920,1320,80
LAMWO,2019,530,900,1430,80
LAMWO,2020,570,890,1460,80
LAMWO,2021,670,950,1620,80
LAMWO,2022,730,1000,1730,80
LAMWO,2023,870,1020,1890,80
LAMWO,2024,950,1020,1970,80
LAMWO,2025,1010,1040,2050,80
LIRA,2015,1180,1620,2800,80
LIRA,2016,1180,1710,2890,80
LIRA,2017,1220,1720,2940,80
LIRA,2018,1260,1800,3060,80
LIRA,2019,1350,1860,3210,80
LIRA,2020,1310,1900,3210,80
LIRA,2021,1380,1950,3330,80
LIRA,2022,1440,2040,3480,80
LIRA,2023,1410,2110,3520,80
LIRA,2024,1490,2130,3620,80
LIRA,2025,1550,2140,3690,80
LUUKA,2015,840,1540,2380,80
LUUKA,2016,880,1650,2530,80
LUUKA,2017,970,1800,2770,80
LUUKA,2018,1090,1920,3010,80
LUUKA,2019,1320,1970,3290,80
LUUKA,2020,1490,2070,3560,80
LUUKA,2021,1730,2150,3880,80
LUUKA,2022,1960,2210,4170,80
LUUKA,2023,2240,2280,4520,80
LUUKA,2024,2510,2450,4960,80
LUUKA,2025,2880,2560,5440,80
LUWERO,2015,1230,1980,3210,80
LUWERO,2016,1090,1890,2980,80
LUWERO,2017,1040,1800,2840,80
LUWERO,2018,970,1690,2660,80
LUWERO,2019,960,1740,2700,80
LUWERO,2020,870,1700,2570,80
LUWERO,2021,890,1690,2580,80
LUWERO,2022,1020,1770,2790,80
LUWERO,2023,1040,1810,2850,80
LUWERO,2024,1180,1880,3060,80
LUWERO,2025,1310,1970,3280,80
LWENGO,2015,410,450,860,80
LWENGO,2016,510,380,890,80
LWENGO,2017,630,430,1060,80
LWENGO,2018,810,410,1220,80
LWENGO,2019,950,460,1410,80
LWENGO,2020,1170,480,1650,80
LWENGO,2021,1410,410,1820,80
LWENGO,2022,1620,370,1990,80
LWENGO,2023,1760,300,2060,80
LWENGO,2024,1960,260,2220,80
LWENGO,2025,2040,130,2170,80
LYANTONDE,2015,120,140,260,80
LYANTONDE,2016,130,140,270,80
LYANTONDE,2017,120,130,250,80
LYANTONDE,2018,120,120,240,80
LYANTONDE,2019,120,130,250,80
LYANTONDE,2020,130,140,270,80
LYANTONDE,2021,150,160,310,80
LYANTONDE,2022,170,190,360,80
LYANTONDE,2023,190,210,400,80
LYANTONDE,2024,200,230,430,80
LYANTONDE,2025,210,230,440,80
MANAFWA,2015,580,800,1380,80
MANAFWA,2016,550,810,1360,80
MANAFWA,2017,640,840,1480,80
MANAFWA,2018,650,900,1550,80
MANAFWA,2019,630,870,1500,80
MANAFWA,2020,610,910,1520,80
MANAFWA,2021,670,910,1580,80
MANAFWA,2022,640,960,1600,80
MANAFWA,2023,670,940,1610,80
MANAFWA,2024,660,970,1630,80
MANAFWA,2025,700,1010,1710,80
MARACHA,2015,350,660,1010,80
MARACHA,2016,410,650,1060,80
MARACHA,2017,420,720,1140,80
MARACHA,2018,450,740,1190,80
MARACHA,2019,480,720,1200,80
MARACHA,2020,480,790,1270,80
MARACHA,2021,470,790,1260,80
MARACHA,2022,510,730,1240,80
MARACHA,2023,480,810,1290,80
MARACHA,2024,470,810,1280,80
MARACHA,2025,430,790,1220,80
MASAKA,2015,540,680,1220,80
MASAKA,2016,590,760,1350,80
MASAKA,2017,640,800,1440,80
MASAKA,2018,650,810,1460,80
MASAKA,2019,650,780,1430,80
MASAKA,2020,640,740,1380,80
MASAKA,2021,640,720,1360,80
MASAKA,2022,660,720,1380,80
MASAKA,2023,700,750,1450,80
MASAKA,2024,740,820,1560,80
MASAKA,2025,790,880,1670,80
MASINDI,2015,870,1130,2000,80
MASINDI,2016,870,1190,2060,80
MASINDI,2017,850,1140,1990,80
MASINDI,2018,900,1150,2050,80
MASINDI,2019,930,1220,2150,80
MASINDI,2020,960,1290,2250,80
MASINDI,2021,990,1300,2290,80
MASINDI,2022,1050,1290,2340,80
MASINDI,2023,1060,1370,2430,80
MASINDI,2024,1100,1370,2470,80
MASINDI,2025,1130,1390,2520,80
MAYUGE,2015,1650,2390,4040,80
MAYUGE,2016,1890,2540,4430,80
MAYUGE,2017,2020,2650,4670,80
MAYUGE,2018,2370,2720,5090,80
MAYUGE,2019,2650,2770,5420,80
MAYUGE,2020,3120,2950,6070,80
MAYUGE,2021,3490,3000,6490,80
MAYUGE,2022,3930,3120,7050,80
MAYUGE,2023,4440,3330,7770,80
MAYUGE,2024,4940,3640,8580,80
MAYUGE,2025,5570,3820,9390,80
MBALE,2015,150,190,340,80
MBALE,2016,160,220,380,80
MBALE,2017,170,270,440,80
MBALE,2018,190,310,500,80
MBALE,2019,180,310,490,80
MBALE,2020,210,360,570,80
MBALE,2021,210,390,600,80
MBALE,2022,210,390,600,80
MBALE,2023,200,350,550,80
MBALE,2024,190,320,510,80
MBALE,2025,180,300,480,80
MBARARA,2015,1210,1830,3040,80
MBARARA,2016,1250,1900,3150,80
MBARARA,2017,1320,1950,3270,80
MBARARA,2018,1350,1980,3330,80
MBARARA,2019,1370,2040,3410,80
MBARARA,2020,1400,2060,3460,80
MBARARA,2021,1420,2180,3600,80
MBARARA,2022,1460,2120,3580,80
MBARARA,2023,1490,2190,3680,80
MBARARA,2024,1520,2210,3730,80
MBARARA,2025,1480,2250,3730,80
MITOOMA,2015,880,1280,2160,80
MITOOMA,2016,890,1270,2160,80
MITOOMA,2017,880,1260,2140,80
MITOOMA,2018,860,1280,2140,80
MITOOMA,2019,940,1280,2220,80
MITOOMA,2020,920,1320,2240,80
MITOOMA,2021,920,1310,2230,80
MITOOMA,2022,920,1340,2260,80
MITOOMA,2023,970,1350,2320,80
MITOOMA,2024,1000,1350,2350,80
MITOOMA,2025,920,1370,2290,80
MITYANA,2015,1010,1170,2180,80
MITYANA,2016,890,1040,1930,80
MITYANA,2017,850,970,1820,80
MITYANA,2018,770,850,1620,80
MITYANA,2019,790,1000,1790,80
MITYANA,2020,680,990,1670,80
MITYANA,2021,710,830,1540,80
MITYANA,2022,600,890,1490,80
MITYANA,2023,650,810,1460,80
MITYANA,2024,700,780,1480,80
MITYANA,2025,540,670,1210,80
MOROTO,2015,610,710,1320,80
MOROTO,2016,750,670,1420,80
MOROTO,2017,790,760,1550,80
MOROTO,2018,710,770,1480,80
MOROTO,2019,730,690,1420,80
MOROTO,2020,770,740,1510,80
MOROTO,2021,750,700,1450,80
MOROTO,2022,760,750,1510,80
MOROTO,2023,740,670,1410,80
MOROTO,2024,680,770,1450,80
MOROTO,2025,760,790,1550,80
MOYO,2015,210,300,510,80
MOYO,2016,190,250,440,80
MOYO,2017,200,280,480,80
MOYO,2018,200,310,510,80
MOYO,2019,230,280,510,80
MOYO,2020,210,260,470,80
MOYO,2021,260,310,570,80
MOYO,2022,180,300,480,80
MOYO,2023,170,330,500,80
MOYO,2024,220,310,530,80
MOYO,2025,260,330,590,80
MPIGI,2015,610,1160,1770,80
MPIGI,2016,620,1170,1790,80
MPIGI,2017,640,1080,1720,80
MPIGI,2018,660,1100,1760,80
MPIGI,2019,640,1090,1730,80
MPIGI,2020,630,1110,1740,80
MPIGI,2021,540,1070,1610,80
MPIGI,2022,640,1220,1860,80
MPIGI,2023,600,1070,1670,80
MPIGI,2024,610,1200,1810,80
MPIGI,2025,610,1140,1750,80
MUBENDE,2015,1310,1750,3060,80
MUBENDE,2016,1280,1690,2970,80
MUBENDE,2017,1250,1580,2830,80
MUBENDE,2018,1170,1580,2750,80
MUBENDE,2019,1000,1420,2420,80
MUBENDE,2020,990,1470,2460,80
MUBENDE,2021,690,1450,2140,80
MUBENDE,2022,540,1550,2090,80
MUBENDE,2023,330,1460,1790,80
MUBENDE,2024,210,1630,1840,80
MUBENDE,2025,140,1950,2090,80
MUKONO,2015,2520,3350,5870,80
MUKONO,2016,2260,3020,5280,80
MUKONO,2017,2080,2740,4820,80
MUKONO,2018,1850,2420,4270,80
MUKONO,2019,1670,2170,3840,80
MUKONO,2020,1340,1940,3280,80
MUKONO,2021,1090,1800,2890,80
MUKONO,2022,930,1650,2580,80
MUKONO,2023,730,1640,2370,80
MUKONO,2024,470,1600,2070,80
MUKONO,2025,240,1520,1760,80
NABILATUK,2015,390,550,940,80
NABILATUK,2016,420,620,1040,80
NABILATUK,2017,460,620,1080,80
NABILATUK,2018,470,690,1160,80
NABILATUK,2019,570,720,1290,80
NABILATUK,2020,510,740,1250,80
NABILATUK,2021,650,830,1480,80
NABILATUK,2022,700,870,1570,80
NABILATUK,2023,780,950,1730,80
NABILATUK,2024,850,1100,1950,80
NABILATUK,2025,1090,1220,2310,80
NAKAPIRIPIRIT,2015,510,480,990,80
NAKAPIRIPIRIT,2016,580,540,1120,80
NAKAPIRIPIRIT,2017,630,490,1120,80
NAKAPIRIPIRIT,2018,580,540,1120,80
NAKAPIRIPIRIT,2019,660,540,1200,80
NAKAPIRIPIRIT,2020,560,520,1080,80
NAKAPIRIPIRIT,2021,570,500,1070,80
NAKAPIRIPIRIT,2022,560,390,950,80
NAKAPIRIPIRIT,2023,560,440,1000,80
NAKAPIRIPIRIT,2024,550,430,980,80
NAKAPIRIPIRIT,2025,550,510,1060,80
NAKASEKE,2015,850,1300,2150,80
NAKASEKE,2016,880,1320,2200,80
NAKASEKE,2017,920,1390,2310,80
NAKASEKE,2018,940,1400,2340,80
NAKASEKE,2019,990,1440,2430,80
NAKASEKE,2020,1030,1460,2490,80
NAKASEKE,2021,1040,1460,2500,80
NAKASEKE,2022,1100,1500,2600,80
NAKASEKE,2023,1110,1560,2670,80
NAKASEKE,2024,1160,1620,2780,80
NAKASEKE,2025,1160,1610,2770,80
NAKASONGOLA,2015,200,170,370,80
NAKASONGOLA,2016,210,180,390,80
NAKASONGOLA,2017,210,180,390,80
NAKASONGOLA,2018,200,160,360,80
NAKASONGOLA,2019,200,160,360,80
NAKASONGOLA,2020,200,140,340,80
NAKASONGOLA,2021,200,150,350,80
NAKASONGOLA,2022,220,170,390,80
NAKASONGOLA,2023,260,200,460,80
NAKASONGOLA,2024,280,230,510,80
NAKASONGOLA,2025,320,250,570,80
NAMAYINGO,2015,280,320,600,80
NAMAYINGO,2016,340,320,660,80
NAMAYINGO,2017,400,290,690,80
NAMAYINGO,2018,420,290,710,80
NAMAYINGO,2019,640,330,970,80
NAMAYINGO,2020,770,200,970,80
NAMAYINGO,2021,790,260,1050,80
NAMAYINGO,2022,920,280,1200,80
NAMAYINGO,2023,1010,200,1210,80
NAMAYINGO,2024,1140,360,1500,80
NAMAYINGO,2025,1250,380,1630,80
NAMISINDWA,2015,820,1120,1940,80
NAMISINDWA,2016,880,1160,2040,80
NAMISINDWA,2017,900,1180,2080,80
NAMISINDWA,2018,920,1160,2080,80
NAMISINDWA,2019,940,1140,2080,80
NAMISINDWA,2020,950,1280,2230,80
NAMISINDWA,2021,1000,1320,2320,80
NAMISINDWA,2022,970,1290,2260,80
NAMISINDWA,2023,1030,1310,2340,80
NAMISINDWA,2024,1030,1320,2350,80
NAMISINDWA,2025,1070,1380,2450,80
NAMUTUMBA,2015,580,1260,1840,80
NAMUTUMBA,2016,850,1300,2150,80
NAMUTUMBA,2017,960,1330,2290,80
NAMUTUMBA,2018,1150,1520,2670,80
NAMUTUMBA,2019,1400,1670,3070,80
NAMUTUMBA,2020,1610,1890,3500,80
NAMUTUMBA,2021,1960,1920,3880,80
NAMUTUMBA,2022,2160,2070,4230,80
NAMUTUMBA,2023,2560,2260,4820,80
NAMUTUMBA,2024,2950,2390,5340,80
NAMUTUMBA,2025,3360,2500,5860,80
NAPAK,2015,870,1010,1880,80
NAPAK,2016,1030,1050,2080,80
NAPAK,2017,1150,1060,2210,80
NAPAK,2018,1110,970,2080,80
NAPAK,2019,1240,910,2150,80
NAPAK,2020,1260,760,2020,80
NAPAK,2021,1380,600,1980,80
NAPAK,2022,1440,610,2050,80
NAPAK,2023,1540,660,2200,80
NAPAK,2024,1640,710,2350,80
NAPAK,2025,1800,730,2530,80
NEBBI,2015,740,1050,1790,80
NEBBI,2016,790,1060,1850,80
NEBBI,2017,770,1060,1830,80
NEBBI,2018,820,1120,1940,80
NEBBI,2019,810,1140,1950,80
NEBBI,2020,840,1240,2080,80
NEBBI,2021,860,1220,2080,80
NEBBI,2022,950,1270,2220,80
NEBBI,2023,930,1300,2230,80
NEBBI,2024,1000,1380,2380,80
NEBBI,2025,980,1350,2330,80
NGORA,2015,320,1170,1490,80
NGORA,2016,370,1220,1590,80
NGORA,2017,400,1210,1610,80
NGORA,2018,430,1340,1770,80
NGORA,2019,510,1420,1930,80
NGORA,2020,580,1380,1960,80
NGORA,2021,640,1530,2170,80
NGORA,2022,740,1560,2300,80
NGORA,2023,840,1620,2460,80
NGORA,2024,990,1840,2830,80
NGORA,2025,1040,1790,2830,80
NTOROKO,2015,290,460,750,80
NTOROKO,2016,250,470,720,80
NTOROKO,2017,260,560,820,80
NTOROKO,2018,180,460,640,80
NTOROKO,2019,230,500,730,80
NTOROKO,2020,200,580,780,80
NTOROKO,2021,160,480,640,80
NTOROKO,2022,90,530,620,80
NTOROKO,2023,70,470,540,80
NTOROKO,2024,100,500,600,80
NTOROKO,2025,50,560,610,80
NTUNGAMO,2015,1660,2890,4550,80
NTUNGAMO,2016,1690,2990,4680,80
NTUNGAMO,2017,1690,3020,4710,80
NTUNGAMO,2018,1760,3080,4840,80
NTUNGAMO,2019,1740,3090,4830,80
NTUNGAMO,2020,1800,3170,4970,80
NTUNGAMO,2021,1890,3240,5130,80
NTUNGAMO,2022,1920,3340,5260,80
NTUNGAMO,2023,1950,3390,5340,80
NTUNGAMO,2024,1950,3360,5310,80
NTUNGAMO,2025,2010,3450,5460,80
NWOYA,2015,400,630,1030,80
NWOYA,2016,440,640,1080,80
NWOYA,2017,480,760,1240,80
NWOYA,2018,510,820,1330,80
NWOYA,2019,580,920,1500,80
NWOYA,2020,620,1020,1640,80
NWOYA,2021,710,1150,1860,80
NWOYA,2022,740,1260,2000,80
NWOYA,2023,810,1350,2160,80
NWOYA,2024,870,1550,2420,80
NWOYA,2025,980,1680,2660,80
OBONGI,2015,70,70,140,80
OBONGI,2016,30,90,120,80
OBONGI,2017,40,30,70,80
OBONGI,2018,60,100,160,80
OBONGI,2019,140,140,280,80
OBONGI,2020,110,70,180,80
OBONGI,2021,110,40,150,80
OBONGI,2022,180,100,280,80
OBONGI,2023,130,70,200,80
OBONGI,2024,190,100,290,80
OBONGI,2025,180,110,290,80
OMORO,2015,120,410,530,80
OMORO,2016,20,390,410,80
OMORO,2017,0,380,380,80
OMORO,2018,70,370,440,80
OMORO,2019,140,450,590,80
OMORO,2020,210,530,740,80
OMORO,2021,290,520,810,80
OMORO,2022,360,560,920,80
OMORO,2023,500,600,1100,80
OMORO,2024,550,570,1120,80
OMORO,2025,700,580,1280,80
OTUKE,2015,320,500,820,80
OTUKE,2016,320,550,870,80
OTUKE,2017,320,520,840,80
OTUKE,2018,370,530,900,80
OTUKE,2019,320,600,920,80
OTUKE,2020,390,600,990,80
OTUKE,2021,360,610,970,80
OTUKE,2022,410,620,1030,80
OTUKE,2023,460,670,1130,80
OTUKE,2024,440,730,1170,80
OTUKE,2025,430,730,1160,80
OYAM,2015,1300,1880,3180,80
OYAM,2016,1340,1940,3280,80
OYAM,2017,1430,2020,3450,80
OYAM,2018,1470,2020,3490,80
OYAM,2019,1470,2080,3550,80
OYAM,2020,1520,2170,3690,80
OYAM,2021,1590,2200,3790,80
OYAM,2022,1650,2250,3900,80
OYAM,2023,1670,2330,4000,80
OYAM,2024,1730,2380,4110,80
OYAM,2025,1710,2440,4150,80
PADER,2015,410,1550,1960,80
PADER,2016,440,1440,1880,80
PADER,2017,420,1440,1860,80
PADER,2018,470,1450,1920,80
PADER,2019,510,1440,1950,80
PADER,2020,580,1560,2140,80
PADER,2021,790,1640,2430,80
PADER,2022,910,1790,2700,80
PADER,2023,950,1810,2760,80
PADER,2024,1140,1950,3090,80
PADER,2025,1290,1870,3160,80
PAKWACH,2015,410,610,1020,80
PAKWACH,2016,370,620,990,80
PAKWACH,2017,390,710,1100,80
PAKWACH,2018,420,650,1070,80
PAKWACH,2019,430,700,1130,80
PAKWACH,2020,470,750,1220,80
PAKWACH,2021,460,760,1220,80
PAKWACH,2022,460,760,1220,80
PAKWACH,2023,480,780,1260,80
PAKWACH,2024,480,860,1340,80
PAKWACH,2025,560,880,1440,80
PALLISA,2015,200,970,1170,80
PALLISA,2016,360,1000,1360,80
PALLISA,2017,270,1160,1430,80
PALLISA,2018,530,1350,1880,80
PALLISA,2019,720,1580,2300,80
PALLISA,2020,960,1710,2670,80
PALLISA,2021,1220,1930,3150,80
PALLISA,2022,1550,2170,3720,80
PALLISA,2023,1940,2360,4300,80
PALLISA,2024,2270,2710,4980,80
PALLISA,2025,2650,2980,5630,80
RAKAI,2015,610,800,1410,80
RAKAI,2016,760,920,1680,80
RAKAI,2017,840,920,1760,80
RAKAI,2018,1020,970,1990,80
RAKAI,2019,1230,1020,2250,80
RAKAI,2020,1490,1060,2550,80
RAKAI,2021,1670,1030,2700,80
RAKAI,2022,1920,1060,2980,80
RAKAI,2023,2090,1010,3100,80
RAKAI,2024,2310,1020,3330,80
RAKAI,2025,2440,850,3290,80
RUBANDA,2015,640,1240,1880,80
RUBANDA,2016,610,1280,1890,80
RUBANDA,2017,690,1250,1940,80
RUBANDA,2018,700,1290,1990,80
RUBANDA,2019,710,1290,2000,80
RUBANDA,2020,690,1270,1960,80
RUBANDA,2021,730,1320,2050,80
RUBANDA,2022,670,1390,2060,80
RUBANDA,2023,700,1390,2090,80
RUBANDA,2024,700,1320,2020,80
RUBANDA,2025,740,1390,2130,80
RUBIRIZI,2015,360,620,980,80
RUBIRIZI,2016,400,660,1060,80
RUBIRIZI,2017,390,590,980,80
RUBIRIZI,2018,420,610,1030,80
RUBIRIZI,2019,440,710,1150,80
RUBIRIZI,2020,440,650,1090,80
RUBIRIZI,2021,420,690,1110,80
RUBIRIZI,2022,430,720,1150,80
RUBIRIZI,2023,450,710,1160,80
RUBIRIZI,2024,470,780,1250,80
RUBIRIZI,2025,420,730,1150,80
RUKIGA,2015,470,890,1360,80
RUKIGA,2016,470,820,1290,80
RUKIGA,2017,460,880,1340,80
RUKIGA,2018,500,870,1370,80
RUKIGA,2019,470,850,1320,80
RUKIGA,2020,480,880,1360,80
RUKIGA,2021,460,890,1350,80
RUKIGA,2022,490,870,1360,80
RUKIGA,2023,500,860,1360,80
RUKIGA,2024,490,900,1390,80
RUKIGA,2025,490,910,1400,80
RUKUNGIRI,2015,1450,2340,3790,80
RUKUNGIRI,2016,1450,2360,3810,80
RUKUNGIRI,2017,1500,2320,3820,80
RUKUNGIRI,2018,1510,2420,3930,80
RUKUNGIRI,2019,1540,2390,3930,80
RUKUNGIRI,2020,1530,2440,3970,80
RUKUNGIRI,2021,1570,2460,4030,80
RUKUNGIRI,2022,1610,2450,4060,80
RUKUNGIRI,2023,1630,2450,4080,80
RUKUNGIRI,2024,1600,2540,4140,80
RUKUNGIRI,2025,1590,2500,4090,80
RWAMPARA,2015,550,880,1430,80
RWAMPARA,2016,540,910,1450,80
RWAMPARA,2017,500,960,1460,80
RWAMPARA,2018,540,960,1500,80
RWAMPARA,2019,560,960,1520,80
RWAMPARA,2020,560,1010,1570,80
RWAMPARA,2021,560,1040,1600,80
RWAMPARA,2022,650,1050,1700,80
RWAMPARA,2023,600,1100,1700,80
RWAMPARA,2024,620,1120,1740,80
RWAMPARA,2025,600,1100,1700,80
SERERE,2015,300,1590,1890,80
SERERE,2016,330,1650,1980,80
SERERE,2017,420,1730,2150,80
SERERE,2018,510,1930,2440,80
SERERE,2019,730,1940,2670,80
SERERE,2020,900,2250,3150,80
SERERE,2021,1110,2430,3540,80
SERERE,2022,1340,2680,4020,80
SERERE,2023,1660,3000,4660,80
SERERE,2024,1990,3210,5200,80
SERERE,2025,2280,3550,5830,80
SHEEMA,2015,1000,1530,2530,80
SHEEMA,2016,1060,1550,2610,80
SHEEMA,2017,1020,1560,2580,80
SHEEMA,2018,1080,1580,2660,80
SHEEMA,2019,1090,1550,2640,80
SHEEMA,2020,1080,1630,2710,80
SHEEMA,2021,1090,1660,2750,80
SHEEMA,2022,1080,1660,2740,80
SHEEMA,2023,1100,1680,2780,80
SHEEMA,2024,1070,1670,2740,80
SHEEMA,2025,1160,1650,2810,80
SIRONKO,2015,1090,1790,2880,80
SIRONKO,2016,1110,1860,2970,80
SIRONKO,2017,1140,1870,3010,80
SIRONKO,2018,1180,1910,3090,80
SIRONKO,2019,1170,2020,3190,80
SIRONKO,2020,1210,2010,3220,80
SIRONKO,2021,1250,2020,3270,80
SIRONKO,2022,1220,2010,3230,80
SIRONKO,2023,1280,2120,3400,80
SIRONKO,2024,1340,2180,3520,80
SIRONKO,2025,1320,2160,3480,80
SOROTI,2015,100,130,230,80
SOROTI,2016,110,150,260,80
SOROTI,2017,120,180,300,80
SOROTI,2018,120,190,310,80
SOROTI,2019,130,210,340,80
SOROTI,2020,140,230,370,80
SOROTI,2021,140,220,360,80
SOROTI,2022,140,210,350,80
SOROTI,2023,130,190,320,80
SOROTI,2024,130,170,300,80
SOROTI,2025,130,180,310,80
SSEMBABULE,2015,10,630,640,80
SSEMBABULE,2016,30,640,670,80
SSEMBABULE,2017,120,560,680,80
SSEMBABULE,2018,160,500,660,80
SSEMBABULE,2019,140,490,630,80
SSEMBABULE,2020,310,600,910,80
SSEMBABULE,2021,340,500,840,80
SSEMBABULE,2022,380,550,930,80
SSEMBABULE,2023,480,490,970,80
SSEMBABULE,2024,470,560,1030,80
SSEMBABULE,2025,500,370,870,80
TORORO,2015,1910,2780,4690,80
TORORO,2016,1920,2780,4700,80
TORORO,2017,2030,2880,4910,80
TORORO,2018,2080,2960,5040,80
TORORO,2019,2110,3030,5140,80
TORORO,2020,2170,3110,5280,80
TORORO,2021,2200,3200,5400,80
TORORO,2022,2250,3250,5500,80
TORORO,2023,2340,3290,5630,80
TORORO,2024,2340,3370,5710,80
TORORO,2025,2410,3480,5890,80
WAKISO,2015,3090,6140,9230,80
WAKISO,2016,3350,6600,9950,80
WAKISO,2017,3600,7060,10660,80
WAKISO,2018,3850,7520,11370,80
WAKISO,2019,4100,8040,12140,80
WAKISO,2020,4380,8550,12930,80
WAKISO,2021,4670,9120,13790,80
WAKISO,2022,5000,9710,14710,80
WAKISO,2023,5250,10360,15610,80
WAKISO,2024,5590,11040,16630,80
WAKISO,2025,5910,11690,17600,80
YUMBE,2015,1600,2550,4150,80
YUMBE,2016,1880,3060,4940,80
YUMBE,2017,2260,3690,5950,80
YUMBE,2018,2950,4490,7440,80
YUMBE,2019,3740,5620,9360,80
YUMBE,2020,4630,6970,11600,80
YUMBE,2021,5580,8410,13990,80
YUMBE,2022,6620,9720,16340,80
YUMBE,2023,7660,10890,18550,80
YUMBE,2024,8640,11910,20550,80
YUMBE,2025,9870,12630,22500,80
ZOMBO,2015,740,970,1710,80
ZOMBO,2016,810,1030,1840,80
ZOMBO,2017,750,1040,1790,80
ZOMBO,2018,750,1070,1820,80
ZOMBO,2019,800,1140,1940,80
ZOMBO,2020,820,1090,1910,80
ZOMBO,2021,900,1160,2060,80
ZOMBO,2022,820,1170,1990,80
ZOMBO,2023,920,1230,2150,80
ZOMBO,2024,920,1290,2210,80
ZOMBO,2025,1000,1290,2290,80
ABIM,2015,1780,1780,3560,9
ABIM,2016,1870,1860,3730,9
ABIM,2017,1980,1940,3920,9
ABIM,2018,2080,2040,4120,9
ABIM,2019,2170,2080,4250,9
ABIM,2020,2250,2160,4410,9
ABIM,2021,2350,2240,4590,9
ABIM,2022,2480,2360,4840,9
ABIM,2023,2700,2540,5240,9
ABIM,2024,2810,2780,5590,9
ABIM,2025,2960,2930,5890,9
ADJUMANI,2015,3660,3520,7180,9
ADJUMANI,2016,3690,3560,7250,9
ADJUMANI,2017,3720,3590,7310,9
ADJUMANI,2018,3740,3620,7360,9
ADJUMANI,2019,3770,3660,7430,9
ADJUMANI,2020,3790,3690,7480,9
ADJUMANI,2021,3810,3710,7520,9
ADJUMANI,2022,3820,3740,7560,9
ADJUMANI,2023,3840,3760,7600,9
ADJUMANI,2024,3850,3790,7640,9
ADJUMANI,2025,3860,3810,7670,9
AGAGO,2015,3790,3510,7300,9
AGAGO,2016,3860,3580,7440,9
AGAGO,2017,3920,3640,7560,9
AGAGO,2018,3990,3700,7690,9
AGAGO,2019,4060,3760,7820,9
AGAGO,2020,4120,3820,7940,9
AGAGO,2021,4180,3880,8060,9
AGAGO,2022,4250,3940,8190,9
AGAGO,2023,4310,4000,8310,9
AGAGO,2024,4360,4050,8410,9
AGAGO,2025,4410,4100,8510,9
ALEBTONG,2015,3920,3820,7740,9
ALEBTONG,2016,3990,3860,7850,9
ALEBTONG,2017,4060,3910,7970,9
ALEBTONG,2018,4140,3960,8100,9
ALEBTONG,2019,4160,3930,8090,9
ALEBTONG,2020,4180,3940,8120,9
ALEBTONG,2021,4210,3970,8180,9
ALEBTONG,2022,4290,4040,8330,9
ALEBTONG,2023,4500,4210,8710,9
ALEBTONG,2024,4540,4470,9010,9
ALEBTONG,2025,4610,4540,9150,9
AMOLATAR,2015,2690,2430,5120,9
AMOLATAR,2016,2730,2460,5190,9
AMOLATAR,2017,2780,2490,5270,9
AMOLATAR,2018,2820,2510,5330,9
AMOLATAR,2019,2850,2480,5330,9
AMOLATAR,2020,2850,2490,5340,9
AMOLATAR,2021,2860,2490,5350,9
AMOLATAR,2022,2910,2530,5440,9
AMOLATAR,2023,3060,2640,5700,9
AMOLATAR,2024,3070,2780,5850,9
AMOLATAR,2025,3120,2830,5950,9
AMUDAT,2015,1870,1750,3620,9
AMUDAT,2016,1930,1810,3740,9
AMUDAT,2017,1980,1870,3850,9
AMUDAT,2018,2040,1920,3960,9
AMUDAT,2019,2080,1940,4020,9
AMUDAT,2020,2110,1990,4100,9
AMUDAT,2021,2150,2040,4190,9
AMUDAT,2022,2210,2120,4330,9
AMUDAT,2023,2350,2250,4600,9
AMUDAT,2024,2400,2430,4830,9
AMUDAT,2025,2460,2510,4970,9
AMURIA,2015,3310,3180,6490,9
AMURIA,2016,3400,3230,6630,9
AMURIA,2017,3490,3300,6790,9
AMURIA,2018,3590,3370,6960,9
AMURIA,2019,3650,3370,7020,9
AMURIA,2020,3700,3400,7100,9
AMURIA,2021,3760,3460,7220,9
AMURIA,2022,3870,3540,7410,9
AMURIA,2023,4100,3720,7820,9
AMURIA,2024,4160,3980,8140,9
AMURIA,2025,4280,4070,8350,9
AMURU,2015,3310,3080,6390,9
AMURU,2016,3370,3110,6480,9
AMURU,2017,3420,3150,6570,9
AMURU,2018,3480,3190,6670,9
AMURU,2019,3500,3160,6660,9
AMURU,2020,3500,3170,6670,9
AMURU,2021,3520,3190,6710,9
AMURU,2022,3580,3250,6830,9
AMURU,2023,3750,3370,7120,9
AMURU,2024,3780,3580,7360,9
AMURU,2025,3830,3640,7470,9
APAC,2015,3140,3020,6160,9
APAC,2016,3260,3130,6390,9
APAC,2017,3380,3240,6620,9
APAC,2018,3500,3350,6850,9
APAC,2019,3630,3460,7090,9
APAC,2020,3760,3580,7340,9
APAC,2021,3890,3690,7580,9
APAC,2022,4020,3810,7830,9
APAC,2023,4150,3930,8080,9
APAC,2024,4280,4050,8330,9
APAC,2025,4420,4170,8590,9
ARUA,2015,9810,9460,19270,9
ARUA,2016,10100,9710,19810,9
ARUA,2017,10380,9980,20360,9
ARUA,2018,10680,10240,20920,9
ARUA,2019,10980,10520,21500,9
ARUA,2020,11270,10780,22050,9
ARUA,2021,11580,11050,22630,9
ARUA,2022,11880,11320,23200,9
ARUA,2023,12180,11600,23780,9
ARUA,2024,12480,11870,24350,9
ARUA,2025,12770,12130,24900,9
BUDAKA,2015,3470,3470,6940,9
BUDAKA,2016,3560,3530,7090,9
BUDAKA,2017,3660,3590,7250,9
BUDAKA,2018,3760,3670,7430,9
BUDAKA,2019,3810,3670,7480,9
BUDAKA,2020,3850,3700,7550,9
BUDAKA,2021,3910,3750,7660,9
BUDAKA,2022,4020,3840,7860,9
BUDAKA,2023,4250,4030,8280,9
BUDAKA,2024,4320,4310,8630,9
BUDAKA,2025,4410,4410,8820,9
BUDUDA,2015,3700,3620,7320,9
BUDUDA,2016,3830,3730,7560,9
BUDUDA,2017,3960,3840,7800,9
BUDUDA,2018,4110,3950,8060,9
BUDUDA,2019,4200,3990,8190,9
BUDUDA,2020,4290,4070,8360,9
BUDUDA,2021,4390,4170,8560,9
BUDUDA,2022,4550,4310,8860,9
BUDUDA,2023,4860,4570,9430,9
BUDUDA,2024,4970,4940,9910,9
BUDUDA,2025,5140,5100,10240,9
BUGIRI,2015,6740,6370,13110,9
BUGIRI,2016,6940,6510,13450,9
BUGIRI,2017,7150,6670,13820,9
BUGIRI,2018,7380,6830,14210,9
BUGIRI,2019,7530,6860,14390,9
BUGIRI,2020,7650,6960,14610,9
BUGIRI,2021,7800,7090,14890,9
BUGIRI,2022,8060,7310,15370,9
BUGIRI,2023,8570,7700,16270,9
BUGIRI,2024,8730,8260,16990,9
BUGIRI,2025,8980,8490,17470,9
BUGWERI,2015,2830,2640,5470,9
BUGWERI,2016,2870,2660,5530,9
BUGWERI,2017,2920,2680,5600,9
BUGWERI,2018,2980,2720,5700,9
BUGWERI,2019,3000,2700,5700,9
BUGWERI,2020,3000,2700,5700,9
BUGWERI,2021,3020,2720,5740,9
BUGWERI,2022,3080,2760,5840,9
BUGWERI,2023,3230,2880,6110,9
BUGWERI,2024,3250,3040,6290,9
BUGWERI,2025,3300,3090,6390,9
BUHWEJU,2015,1960,2000,3960,9
BUHWEJU,2016,2020,2060,4080,9
BUHWEJU,2017,2090,2130,4220,9
BUHWEJU,2018,2150,2190,4340,9
BUHWEJU,2019,2220,2260,4480,9
BUHWEJU,2020,2290,2320,4610,9
BUHWEJU,2021,2360,2390,4750,9
BUHWEJU,2022,2430,2450,4880,9
BUHWEJU,2023,2500,2520,5020,9
BUHWEJU,2024,2570,2590,5160,9
BUHWEJU,2025,2640,2650,5290,9
BUIKWE,2015,6390,6150,12540,9
BUIKWE,2016,6450,6180,12630,9
BUIKWE,2017,6520,6210,12730,9
BUIKWE,2018,6590,6250,12840,9
BUIKWE,2019,6590,6160,12750,9
BUIKWE,2020,6560,6140,12700,9
BUIKWE,2021,6550,6150,12700,9
BUIKWE,2022,6640,6220,12860,9
BUIKWE,2023,6910,6430,13340,9
BUIKWE,2024,6910,6780,13690,9
BUIKWE,2025,6960,6840,13800,9
BUKEDEA,2015,3600,3440,7040,9
BUKEDEA,2016,3730,3540,7270,9
BUKEDEA,2017,3860,3620,7480,9
BUKEDEA,2018,3990,3730,7720,9
BUKEDEA,2019,4080,3750,7830,9
BUKEDEA,2020,4160,3810,7970,9
BUKEDEA,2021,4250,3890,8140,9
BUKEDEA,2022,4410,4010,8420,9
BUKEDEA,2023,4710,4240,8950,9
BUKEDEA,2024,4810,4560,9370,9
BUKEDEA,2025,4960,4700,9660,9
BUKOMANSIMBI,2015,2740,2490,5230,9
BUKOMANSIMBI,2016,2730,2460,5190,9
BUKOMANSIMBI,2017,2740,2440,5180,9
BUKOMANSIMBI,2018,2730,2410,5140,9
BUKOMANSIMBI,2019,2690,2350,5040,9
BUKOMANSIMBI,2020,2650,2310,4960,9
BUKOMANSIMBI,2021,2620,2260,4880,9
BUKOMANSIMBI,2022,2610,2260,4870,9
BUKOMANSIMBI,2023,2700,2300,5000,9
BUKOMANSIMBI,2024,2660,2390,5050,9
BUKOMANSIMBI,2025,2650,2370,5020,9
BUKWO,2015,1560,1390,2950,9
BUKWO,2016,1640,1450,3090,9
BUKWO,2017,1730,1520,3250,9
BUKWO,2018,1820,1600,3420,9
BUKWO,2019,1920,1680,3600,9
BUKWO,2020,2020,1760,3780,9
BUKWO,2021,2120,1840,3960,9
BUKWO,2022,2230,1920,4150,9
BUKWO,2023,2340,2010,4350,9
BUKWO,2024,2450,2100,4550,9
BUKWO,2025,2570,2190,4760,9
BULAMBULI,2015,3170,3100,6270,9
BULAMBULI,2016,3290,3210,6500,9
BULAMBULI,2017,3420,3320,6740,9
BULAMBULI,2018,3550,3430,6980,9
BULAMBULI,2019,3650,3480,7130,9
BULAMBULI,2020,3740,3570,7310,9
BULAMBULI,2021,3840,3670,7510,9
BULAMBULI,2022,4000,3810,7810,9
BULAMBULI,2023,4290,4060,8350,9
BULAMBULI,2024,4410,4410,8820,9
BULAMBULI,2025,4570,4570,9140,9
BULIISA,2015,1670,1530,3200,9
BULIISA,2016,1760,1600,3360,9
BULIISA,2017,1850,1670,3520,9
BULIISA,2018,1950,1750,3700,9
BULIISA,2019,2050,1820,3870,9
BULIISA,2020,2160,1900,4060,9
BULIISA,2021,2280,1980,4260,9
BULIISA,2022,2390,2060,4450,9
BULIISA,2023,2510,2150,4660,9
BULIISA,2024,2640,2230,4870,9
BULIISA,2025,2760,2320,5080,9
BUNDIBUGYO,2015,3550,3320,6870,9
BUNDIBUGYO,2016,3610,3360,6970,9
BUNDIBUGYO,2017,3690,3410,7100,9
BUNDIBUGYO,2018,3770,3440,7210,9
BUNDIBUGYO,2019,3800,3420,7220,9
BUNDIBUGYO,2020,3810,3430,7240,9
BUNDIBUGYO,2021,3850,3460,7310,9
BUNDIBUGYO,2022,3940,3520,7460,9
BUNDIBUGYO,2023,4140,3670,7810,9
BUNDIBUGYO,2024,4170,3890,8060,9
BUNDIBUGYO,2025,4250,3950,8200,9
BUNYANGABU,2015,2730,2690,5420,9
BUNYANGABU,2016,2780,2700,5480,9
BUNYANGABU,2017,2810,2720,5530,9
BUNYANGABU,2018,2860,2750,5610,9
BUNYANGABU,2019,2880,2720,5600,9
BUNYANGABU,2020,2880,2720,5600,9
BUNYANGABU,2021,2890,2720,5610,9
BUNYANGABU,2022,2940,2760,5700,9
BUNYANGABU,2023,3080,2870,5950,9
BUNYANGABU,2024,3090,3020,6110,9
BUNYANGABU,2025,3140,3050,6190,9
BUSHENYI,2015,3210,3190,6400,9
BUSHENYI,2016,3250,3220,6470,9
BUSHENYI,2017,3290,3250,6540,9
BUSHENYI,2018,3330,3280,6610,9
BUSHENYI,2019,3370,3300,6670,9
BUSHENYI,2020,3400,3330,6730,9
BUSHENYI,2021,3440,3350,6790,9
BUSHENYI,2022,3470,3370,6840,9
BUSHENYI,2023,3500,3390,6890,9
BUSHENYI,2024,3530,3410,6940,9
BUSHENYI,2025,3550,3420,6970,9
BUSIA,2015,5510,5320,10830,9
BUSIA,2016,5610,5390,11000,9
BUSIA,2017,5740,5460,11200,9
BUSIA,2018,5870,5540,11410,9
BUSIA,2019,5920,5510,11430,9
BUSIA,2020,5970,5550,11520,9
BUSIA,2021,6020,5590,11610,9
BUSIA,2022,6170,5700,11870,9
BUSIA,2023,6500,5940,12440,9
BUSIA,2024,6560,6330,12890,9
BUSIA,2025,6690,6440,13130,9
BUTALEJA,2015,4160,4090,8250,9
BUTALEJA,2016,4270,4180,8450,9
BUTALEJA,2017,4400,4260,8660,9
BUTALEJA,2018,4520,4360,8880,9
BUTALEJA,2019,4590,4360,8950,9
BUTALEJA,2020,4650,4410,9060,9
BUTALEJA,2021,4730,4470,9200,9
BUTALEJA,2022,4860,4600,9460,9
BUTALEJA,2023,5160,4820,9980,9
BUTALEJA,2024,5240,5160,10400,9
BUTALEJA,2025,5370,5290,10660,9
BUTAMBALA,2015,1770,1510,3280,9
BUTAMBALA,2016,1770,1500,3270,9
BUTAMBALA,2017,1770,1500,3270,9
BUTAMBALA,2018,1790,1490,3280,9
BUTAMBALA,2019,1770,1460,3230,9
BUTAMBALA,2020,1750,1440,3190,9
BUTAMBALA,2021,1740,1420,3160,9
BUTAMBALA,2022,1750,1420,3170,9
BUTAMBALA,2023,1810,1460,3270,9
BUTAMBALA,2024,1800,1520,3320,9
BUTAMBALA,2025,1800,1520,3320,9
BUTEBO,2015,1910,1850,3760,9
BUTEBO,2016,1920,1840,3760,9
BUTEBO,2017,1930,1840,3770,9
BUTEBO,2018,1940,1830,3770,9
BUTEBO,2019,1930,1800,3730,9
BUTEBO,2020,1910,1780,3690,9
BUTEBO,2021,1910,1770,3680,9
BUTEBO,2022,1910,1780,3690,9
BUTEBO,2023,1990,1830,3820,9
BUTEBO,2024,1980,1910,3890,9
BUTEBO,2025,1980,1920,3900,9
BUVUMA,2015,1070,1020,2090,9
BUVUMA,2016,1140,1090,2230,9
BUVUMA,2017,1210,1160,2370,9
BUVUMA,2018,1280,1240,2520,9
BUVUMA,2019,1360,1320,2680,9
BUVUMA,2020,1440,1410,2850,9
BUVUMA,2021,1530,1500,3030,9
BUVUMA,2022,1620,1600,3220,9
BUVUMA,2023,1710,1700,3410,9
BUVUMA,2024,1810,1810,3620,9
BUVUMA,2025,1910,1920,3830,9
BUYENDE,2015,5610,5320,10930,9
BUYENDE,2016,5800,5450,11250,9
BUYENDE,2017,6010,5610,11620,9
BUYENDE,2018,6220,5770,11990,9
BUYENDE,2019,6360,5830,12190,9
BUYENDE,2020,6490,5930,12420,9
BUYENDE,2021,6640,6070,12710,9
BUYENDE,2022,6880,6270,13150,9
BUYENDE,2023,7340,6640,13980,9
BUYENDE,2024,7520,7160,14680,9
BUYENDE,2025,7770,7380,15150,9
DOKOLO,2015,3070,2870,5940,9
DOKOLO,2016,3170,2950,6120,9
DOKOLO,2017,3260,3030,6290,9
DOKOLO,2018,3360,3110,6470,9
DOKOLO,2019,3460,3200,6660,9
DOKOLO,2020,3560,3280,6840,9
DOKOLO,2021,3660,3360,7020,9
DOKOLO,2022,3760,3450,7210,9
DOKOLO,2023,3860,3530,7390,9
DOKOLO,2024,3960,3610,7570,9
DOKOLO,2025,4060,3690,7750,9
GOMBA,2015,2770,2380,5150,9
GOMBA,2016,2790,2370,5160,9
GOMBA,2017,2820,2360,5180,9
GOMBA,2018,2830,2360,5190,9
GOMBA,2019,2830,2310,5140,9
GOMBA,2020,2810,2280,5090,9
GOMBA,2021,2790,2260,5050,9
GOMBA,2022,2820,2270,5090,9
GOMBA,2023,2930,2330,5260,9
GOMBA,2024,2920,2440,5360,9
GOMBA,2025,2940,2430,5370,9
GULU,2015,3820,3780,7600,9
GULU,2016,3940,3900,7840,9
GULU,2017,4060,4010,8070,9
GULU,2018,4180,4120,8300,9
GULU,2019,4300,4240,8540,9
GULU,2020,4420,4360,8780,9
GULU,2021,4540,4480,9020,9
GULU,2022,4670,4590,9260,9
GULU,2023,4790,4710,9500,9
GULU,2024,4920,4830,9750,9
GULU,2025,5040,4950,9990,9
HOIMA,2015,4330,4090,8420,9
HOIMA,2016,4500,4230,8730,9
HOIMA,2017,4670,4380,9050,9
HOIMA,2018,4840,4530,9370,9
HOIMA,2019,5020,4680,9700,9
HOIMA,2020,5200,4840,10040,9
HOIMA,2021,5380,5000,10380,9
HOIMA,2022,5570,5150,10720,9
HOIMA,2023,5760,5320,11080,9
HOIMA,2024,5950,5480,11430,9
HOIMA,2025,6140,5640,11780,9
IBANDA,2015,3680,3580,7260,9
IBANDA,2016,3760,3640,7400,9
IBANDA,2017,3830,3710,7540,9
IBANDA,2018,3900,3780,7680,9
IBANDA,2019,3980,3840,7820,9
IBANDA,2020,4050,3910,7960,9
IBANDA,2021,4120,3970,8090,9
IBANDA,2022,4190,4030,8220,9
IBANDA,2023,4260,4090,8350,9
IBANDA,2024,4320,4150,8470,9
IBANDA,2025,4390,4200,8590,9
IGANGA,2015,5510,5340,10850,9
IGANGA,2016,5620,5400,11020,9
IGANGA,2017,5740,5480,11220,9
IGANGA,2018,5870,5560,11430,9
IGANGA,2019,5930,5530,11460,9
IGANGA,2020,5970,5570,11540,9
IGANGA,2021,6030,5610,11640,9
IGANGA,2022,6180,5720,11900,9
IGANGA,2023,6500,5960,12460,9
IGANGA,2024,6570,6350,12920,9
IGANGA,2025,6690,6460,13150,9
ISINGIRO,2015,7820,7720,15540,9
ISINGIRO,2016,8110,8000,16110,9
ISINGIRO,2017,8420,8280,16700,9
ISINGIRO,2018,8730,8570,17300,9
ISINGIRO,2019,9050,8860,17910,9
ISINGIRO,2020,9370,9160,18530,9
ISINGIRO,2021,9700,9470,19170,9
ISINGIRO,2022,10030,9770,19800,9
ISINGIRO,2023,10370,10080,20450,9
ISINGIRO,2024,10710,10400,21110,9
ISINGIRO,2025,11050,10720,21770,9
JINJA,2015,6510,6470,12980,9
JINJA,2016,6630,6570,13200,9
JINJA,2017,6740,6670,13410,9
JINJA,2018,6850,6770,13620,9
JINJA,2019,6960,6870,13830,9
JINJA,2020,7060,6960,14020,9
JINJA,2021,7170,7060,14230,9
JINJA,2022,7260,7150,14410,9
JINJA,2023,7360,7230,14590,9
JINJA,2024,7450,7310,14760,9
JINJA,2025,7530,7390,14920,9
KAABONG,2015,1360,1470,2830,9
KAABONG,2016,1400,1510,2910,9
KAABONG,2017,1440,1540,2980,9
KAABONG,2018,1470,1580,3050,9
KAABONG,2019,1520,1610,3130,9
KAABONG,2020,1550,1650,3200,9
KAABONG,2021,1600,1690,3290,9
KAABONG,2022,1630,1730,3360,9
KAABONG,2023,1670,1760,3430,9
KAABONG,2024,1710,1800,3510,9
KAABONG,2025,1750,1830,3580,9
KABALE,2015,3110,2930,6040,9
KABALE,2016,3160,2970,6130,9
KABALE,2017,3210,3010,6220,9
KABALE,2018,3250,3040,6290,9
KABALE,2019,3300,3070,6370,9
KABALE,2020,3350,3110,6460,9
KABALE,2021,3390,3140,6530,9
KABALE,2022,3430,3170,6600,9
KABALE,2023,3480,3200,6680,9
KABALE,2024,3520,3220,6740,9
KABALE,2025,3550,3240,6790,9
KABAROLE,2015,3960,3930,7890,9
KABAROLE,2016,4050,4020,8070,9
KABAROLE,2017,4140,4100,8240,9
KABAROLE,2018,4230,4190,8420,9
KABAROLE,2019,4320,4280,8600,9
KABAROLE,2020,4400,4360,8760,9
KABAROLE,2021,4490,4450,8940,9
KABAROLE,2022,4580,4530,9110,9
KABAROLE,2023,4660,4620,9280,9
KABAROLE,2024,4740,4700,9440,9
KABAROLE,2025,4820,4780,9600,9
KABERAMAIDO,2015,1860,1830,3690,9
KABERAMAIDO,2016,1930,1870,3800,9
KABERAMAIDO,2017,1990,1920,3910,9
KABERAMAIDO,2018,2050,1970,4020,9
KABERAMAIDO,2019,2100,1980,4080,9
KABERAMAIDO,2020,2140,2010,4150,9
KABERAMAIDO,2021,2180,2050,4230,9
KABERAMAIDO,2022,2260,2110,4370,9
KABERAMAIDO,2023,2400,2220,4620,9
KABERAMAIDO,2024,2460,2390,4850,9
KABERAMAIDO,2025,2520,2460,4980,9
KAGADI,2015,5250,5190,10440,9
KAGADI,2016,5450,5370,10820,9
KAGADI,2017,5650,5560,11210,9
KAGADI,2018,5860,5760,11620,9
KAGADI,2019,6070,5950,12020,9
KAGADI,2020,6280,6160,12440,9
KAGADI,2021,6500,6360,12860,9
KAGADI,2022,6720,6570,13290,9
KAGADI,2023,6950,6780,13730,9
KAGADI,2024,7170,6990,14160,9
KAGADI,2025,7400,7200,14600,9
KAKUMIRO,2015,4450,4350,8800,9
KAKUMIRO,2016,4840,4710,9550,9
KAKUMIRO,2017,5270,5110,10380,9
KAKUMIRO,2018,5740,5540,11280,9
KAKUMIRO,2019,6240,6000,12240,9
KAKUMIRO,2020,6780,6490,13270,9
KAKUMIRO,2021,7370,7030,14400,9
KAKUMIRO,2022,8000,7600,15600,9
KAKUMIRO,2023,8670,8210,16880,9
KAKUMIRO,2024,9400,8870,18270,9
KAKUMIRO,2025,10170,9570,19740,9
KALAKI,2015,1950,1800,3750,9
KALAKI,2016,2040,1870,3910,9
KALAKI,2017,2130,1950,4080,9
KALAKI,2018,2220,2020,4240,9
KALAKI,2019,2310,2100,4410,9
KALAKI,2020,2410,2180,4590,9
KALAKI,2021,2510,2260,4770,9
KALAKI,2022,2610,2340,4950,9
KALAKI,2023,2710,2430,5140,9
KALAKI,2024,2810,2520,5330,9
KALAKI,2025,2920,2600,5520,9
KALANGALA,2015,420,370,790,9
KALANGALA,2016,440,390,830,9
KALANGALA,2017,450,400,850,9
KALANGALA,2018,470,420,890,9
KALANGALA,2019,480,440,920,9
KALANGALA,2020,500,450,950,9
KALANGALA,2021,520,470,990,9
KALANGALA,2022,530,490,1020,9
KALANGALA,2023,550,510,1060,9
KALANGALA,2024,570,530,1100,9
KALANGALA,2025,580,550,1130,9
KALIRO,2015,4090,3910,8000,9
KALIRO,2016,4190,3990,8180,9
KALIRO,2017,4300,4070,8370,9
KALIRO,2018,4410,4150,8560,9
KALIRO,2019,4470,4150,8620,9
KALIRO,2020,4520,4200,8720,9
KALIRO,2021,4580,4260,8840,9
KALIRO,2022,4710,4370,9080,9
KALIRO,2023,4990,4590,9580,9
KALIRO,2024,5060,4900,9960,9
KALIRO,2025,5170,5020,10190,9
KALUNGU,2015,3230,2920,6150,9
KALUNGU,2016,3240,2910,6150,9
KALUNGU,2017,3240,2890,6130,9
KALUNGU,2018,3240,2880,6120,9
KALUNGU,2019,3220,2810,6030,9
KALUNGU,2020,3170,2770,5940,9
KALUNGU,2021,3140,2750,5890,9
KALUNGU,2022,3150,2750,5900,9
KALUNGU,2023,3250,2810,6060,9
KALUNGU,2024,3220,2930,6150,9
KALUNGU,2025,3220,2930,6150,9
KAMPALA,2015,14290,14480,28770,9
KAMPALA,2016,14580,14760,29340,9
KAMPALA,2017,14870,15050,29920,9
KAMPALA,2018,15150,15330,30480,9
KAMPALA,2019,15440,15620,31060,9
KAMPALA,2020,15720,15900,31620,9
KAMPALA,2021,16000,16170,32170,9
KAMPALA,2022,16260,16440,32700,9
KAMPALA,2023,16520,16710,33230,9
KAMPALA,2024,16780,16960,33740,9
KAMPALA,2025,17020,17210,34230,9
KAMULI,2015,8380,8170,16550,9
KAMULI,2016,8510,8230,16740,9
KAMULI,2017,8650,8290,16940,9
KAMULI,2018,8800,8360,17160,9
KAMULI,2019,8840,8270,17110,9
KAMULI,2020,8850,8270,17120,9
KAMULI,2021,8880,8290,17170,9
KAMULI,2022,9060,8400,17460,9
KAMULI,2023,9490,8710,18200,9
KAMULI,2024,9540,9210,18750,9
KAMULI,2025,9670,9310,18980,9
KAMWENGE,2015,4020,3940,7960,9
KAMWENGE,2016,4180,4080,8260,9
KAMWENGE,2017,4350,4220,8570,9
KAMWENGE,2018,4520,4370,8890,9
KAMWENGE,2019,4710,4530,9240,9
KAMWENGE,2020,4880,4680,9560,9
KAMWENGE,2021,5080,4830,9910,9
KAMWENGE,2022,5270,4990,10260,9
KAMWENGE,2023,5460,5160,10620,9
KAMWENGE,2024,5660,5320,10980,9
KAMWENGE,2025,5860,5480,11340,9
KANUNGU,2015,3720,3490,7210,9
KANUNGU,2016,3790,3550,7340,9
KANUNGU,2017,3860,3600,7460,9
KANUNGU,2018,3930,3660,7590,9
KANUNGU,2019,3990,3720,7710,9
KANUNGU,2020,4060,3770,7830,9
KANUNGU,2021,4120,3820,7940,9
KANUNGU,2022,4190,3880,8070,9
KANUNGU,2023,4250,3930,8180,9
KANUNGU,2024,4300,3980,8280,9
KANUNGU,2025,4360,4020,8380,9
KAPCHORWA,2015,1630,1560,3190,9
KAPCHORWA,2016,1680,1600,3280,9
KAPCHORWA,2017,1730,1640,3370,9
KAPCHORWA,2018,1790,1690,3480,9
KAPCHORWA,2019,1840,1730,3570,9
KAPCHORWA,2020,1890,1780,3670,9
KAPCHORWA,2021,1950,1820,3770,9
KAPCHORWA,2022,2000,1870,3870,9
KAPCHORWA,2023,2050,1920,3970,9
KAPCHORWA,2024,2110,1960,4070,9
KAPCHORWA,2025,2160,2000,4160,9
KAPELEBYONG,2015,1470,1480,2950,9
KAPELEBYONG,2016,1510,1500,3010,9
KAPELEBYONG,2017,1540,1520,3060,9
KAPELEBYONG,2018,1580,1540,3120,9
KAPELEBYONG,2019,1600,1530,3130,9
KAPELEBYONG,2020,1610,1530,3140,9
KAPELEBYONG,2021,1620,1540,3160,9
KAPELEBYONG,2022,1660,1570,3230,9
KAPELEBYONG,2023,1750,1640,3390,9
KAPELEBYONG,2024,1770,1740,3510,9
KAPELEBYONG,2025,1810,1770,3580,9
KASESE,2015,10830,10470,21300,9
KASESE,2016,10990,10540,21530,9
KASESE,2017,11150,10620,21770,9
KASESE,2018,11320,10700,22020,9
KASESE,2019,11360,10580,21940,9
KASESE,2020,11360,10560,21920,9
KASESE,2021,11400,10580,21980,9
KASESE,2022,11590,10730,22320,9
KASESE,2023,12120,11120,23240,9
KASESE,2024,12160,11750,23910,9
KASESE,2025,12310,11870,24180,9
KASSANDA,2015,4130,3710,7840,9
KASSANDA,2016,4250,3790,8040,9
KASSANDA,2017,4370,3870,8240,9
KASSANDA,2018,4490,3950,8440,9
KASSANDA,2019,4620,4030,8650,9
KASSANDA,2020,4740,4120,8860,9
KASSANDA,2021,4860,4200,9060,9
KASSANDA,2022,4990,4270,9260,9
KASSANDA,2023,5110,4350,9460,9
KASSANDA,2024,5240,4430,9670,9
KASSANDA,2025,5360,4500,9860,9
KATAKWI,2015,2770,2560,5330,9
KATAKWI,2016,2840,2600,5440,9
KATAKWI,2017,2890,2620,5510,9
KATAKWI,2018,2950,2650,5600,9
KATAKWI,2019,2980,2630,5610,9
KATAKWI,2020,2980,2630,5610,9
KATAKWI,2021,3010,2640,5650,9
KATAKWI,2022,3080,2690,5770,9
KATAKWI,2023,3230,2800,6030,9
KATAKWI,2024,3270,2960,6230,9
KATAKWI,2025,3320,3010,6330,9
KAYUNGA,2015,6320,5860,12180,9
KAYUNGA,2016,6380,5860,12240,9
KAYUNGA,2017,6450,5870,12320,9
KAYUNGA,2018,6510,5890,12400,9
KAYUNGA,2019,6490,5790,12280,9
KAYUNGA,2020,6470,5750,12220,9
KAYUNGA,2021,6460,5720,12180,9
KAYUNGA,2022,6530,5760,12290,9
KAYUNGA,2023,6800,5940,12740,9
KAYUNGA,2024,6790,6250,13040,9
KAYUNGA,2025,6850,6280,13130,9
KAZO,2015,2640,2550,5190,9
KAZO,2016,2730,2640,5370,9
KAZO,2017,2840,2730,5570,9
KAZO,2018,2940,2830,5770,9
KAZO,2019,3060,2930,5990,9
KAZO,2020,3160,3030,6190,9
KAZO,2021,3280,3120,6400,9
KAZO,2022,3390,3230,6620,9
KAZO,2023,3510,3330,6840,9
KAZO,2024,3630,3440,7070,9
KAZO,2025,3750,3550,7300,9
KIBAALE,2015,2120,2100,4220,9
KIBAALE,2016,2260,2230,4490,9
KIBAALE,2017,2400,2360,4760,9
KIBAALE,2018,2560,2490,5050,9
KIBAALE,2019,2720,2630,5350,9
KIBAALE,2020,2880,2780,5660,9
KIBAALE,2021,3060,2940,6000,9
KIBAALE,2022,3250,3100,6350,9
KIBAALE,2023,3440,3270,6710,9
KIBAALE,2024,3640,3440,7080,9
KIBAALE,2025,3860,3630,7490,9
KIBOGA,2015,2380,2190,4570,9
KIBOGA,2016,2420,2200,4620,9
KIBOGA,2017,2460,2220,4680,9
KIBOGA,2018,2500,2240,4740,9
KIBOGA,2019,2510,2220,4730,9
KIBOGA,2020,2520,2220,4740,9
KIBOGA,2021,2530,2230,4760,9
KIBOGA,2022,2590,2260,4850,9
KIBOGA,2023,2710,2350,5060,9
KIBOGA,2024,2730,2490,5220,9
KIBOGA,2025,2760,2520,5280,9
KIBUKU,2015,3450,3290,6740,9
KIBUKU,2016,3550,3360,6910,9
KIBUKU,2017,3650,3440,7090,9
KIBUKU,2018,3760,3510,7270,9
KIBUKU,2019,3830,3520,7350,9
KIBUKU,2020,3880,3570,7450,9
KIBUKU,2021,3950,3630,7580,9
KIBUKU,2022,4070,3730,7800,9
KIBUKU,2023,4310,3920,8230,9
KIBUKU,2024,4390,4210,8600,9
KIBUKU,2025,4500,4310,8810,9
KIKUUBE,2015,4150,3850,8000,9
KIKUUBE,2016,4380,4040,8420,9
KIKUUBE,2017,4610,4250,8860,9
KIKUUBE,2018,4850,4460,9310,9
KIKUUBE,2019,5110,4690,9800,9
KIKUUBE,2020,5370,4920,10290,9
KIKUUBE,2021,5650,5160,10810,9
KIKUUBE,2022,5930,5410,11340,9
KIKUUBE,2023,6230,5670,11900,9
KIKUUBE,2024,6530,5930,12460,9
KIKUUBE,2025,6840,6200,13040,9
KIRUHURA,2015,1990,1950,3940,9
KIRUHURA,2016,2070,2020,4090,9
KIRUHURA,2017,2150,2090,4240,9
KIRUHURA,2018,2230,2160,4390,9
KIRUHURA,2019,2310,2240,4550,9
KIRUHURA,2020,2400,2310,4710,9
KIRUHURA,2021,2480,2390,4870,9
KIRUHURA,2022,2570,2470,5040,9
KIRUHURA,2023,2660,2550,5210,9
KIRUHURA,2024,2740,2630,5370,9
KIRUHURA,2025,2830,2710,5540,9
KIRYANDONGO,2015,4410,4100,8510,9
KIRYANDONGO,2016,4490,4160,8650,9
KIRYANDONGO,2017,4590,4210,8800,9
KIRYANDONGO,2018,4680,4270,8950,9
KIRYANDONGO,2019,4730,4240,8970,9
KIRYANDONGO,2020,4750,4250,9000,9
KIRYANDONGO,2021,4790,4280,9070,9
KIRYANDONGO,2022,4900,4360,9260,9
KIRYANDONGO,2023,5170,4540,9710,9
KIRYANDONGO,2024,5210,4820,10030,9
KIRYANDONGO,2025,5310,4890,10200,9
KISORO,2015,4340,4420,8760,9
KISORO,2016,4380,4450,8830,9
KISORO,2017,4430,4470,8900,9
KISORO,2018,4480,4490,8970,9
KISORO,2019,4460,4440,8900,9
KISORO,2020,4450,4420,8870,9
KISORO,2021,4440,4410,8850,9
KISORO,2022,4500,4460,8960,9
KISORO,2023,4690,4620,9310,9
KISORO,2024,4670,4870,9540,9
KISORO,2025,4720,4910,9630,9
KITAGWENDA,2015,2320,2220,4540,9
KITAGWENDA,2016,2420,2290,4710,9
KITAGWENDA,2017,2510,2380,4890,9
KITAGWENDA,2018,2620,2460,5080,9
KITAGWENDA,2019,2720,2550,5270,9
KITAGWENDA,2020,2830,2640,5470,9
KITAGWENDA,2021,2930,2730,5660,9
KITAGWENDA,2022,3040,2820,5860,9
KITAGWENDA,2023,3160,2910,6070,9
KITAGWENDA,2024,3270,3000,6270,9
KITAGWENDA,2025,3380,3090,6470,9
KITGUM,2015,3300,3220,6520,9
KITGUM,2016,3320,3220,6540,9
KITGUM,2017,3350,3220,6570,9
KITGUM,2018,3370,3230,6600,9
KITGUM,2019,3350,3170,6520,9
KITGUM,2020,3330,3140,6470,9
KITGUM,2021,3310,3140,6450,9
KITGUM,2022,3340,3150,6490,9
KITGUM,2023,3460,3250,6710,9
KITGUM,2024,3450,3410,6860,9
KITGUM,2025,3460,3430,6890,9
KOBOKO,2015,3610,3470,7080,9
KOBOKO,2016,3730,3540,7270,9
KOBOKO,2017,3840,3620,7460,9
KOBOKO,2018,3950,3710,7660,9
KOBOKO,2019,4030,3730,7760,9
KOBOKO,2020,4080,3780,7860,9
KOBOKO,2021,4170,3850,8020,9
KOBOKO,2022,4300,3960,8260,9
KOBOKO,2023,4570,4170,8740,9
KOBOKO,2024,4650,4480,9130,9
KOBOKO,2025,4780,4600,9380,9
KOLE,2015,3780,3770,7550,9
KOLE,2016,3910,3880,7790,9
KOLE,2017,4030,3990,8020,9
KOLE,2018,4170,4110,8280,9
KOLE,2019,4300,4220,8520,9
KOLE,2020,4430,4340,8770,9
KOLE,2021,4560,4450,9010,9
KOLE,2022,4700,4570,9270,9
KOLE,2023,4840,4690,9530,9
KOLE,2024,4970,4800,9770,9
KOLE,2025,5110,4920,10030,9
KOTIDO,2015,2410,2490,4900,9
KOTIDO,2016,2450,2500,4950,9
KOTIDO,2017,2490,2520,5010,9
KOTIDO,2018,2530,2540,5070,9
KOTIDO,2019,2530,2500,5030,9
KOTIDO,2020,2530,2510,5040,9
KOTIDO,2021,2540,2510,5050,9
KOTIDO,2022,2590,2540,5130,9
KOTIDO,2023,2710,2640,5350,9
KOTIDO,2024,2710,2780,5490,9
KOTIDO,2025,2740,2810,5550,9
KUMI,2015,4170,3980,8150,9
KUMI,2016,4260,4030,8290,9
KUMI,2017,4360,4090,8450,9
KUMI,2018,4470,4140,8610,9
KUMI,2019,4510,4120,8630,9
KUMI,2020,4550,4150,8700,9
KUMI,2021,4590,4180,8770,9
KUMI,2022,4710,4270,8980,9
KUMI,2023,4960,4460,9420,9
KUMI,2024,5020,4730,9750,9
KUMI,2025,5120,4810,9930,9
KWANIA,2015,3140,2910,6050,9
KWANIA,2016,3240,2990,6230,9
KWANIA,2017,3340,3080,6420,9
KWANIA,2018,3450,3170,6620,9
KWANIA,2019,3550,3250,6800,9
KWANIA,2020,3650,3340,6990,9
KWANIA,2021,3760,3430,7190,9
KWANIA,2022,3860,3520,7380,9
KWANIA,2023,3970,3610,7580,9
KWANIA,2024,4070,3700,7770,9
KWANIA,2025,4180,3780,7960,9
KWEEN,2015,1530,1410,2940,9
KWEEN,2016,1580,1450,3030,9
KWEEN,2017,1630,1490,3120,9
KWEEN,2018,1680,1520,3200,9
KWEEN,2019,1730,1560,3290,9
KWEEN,2020,1780,1590,3370,9
KWEEN,2021,1830,1630,3460,9
KWEEN,2022,1880,1670,3550,9
KWEEN,2023,1930,1700,3630,9
KWEEN,2024,1980,1740,3720,9
KWEEN,2025,2030,1770,3800,9
KYANKWANZI,2015,3120,3020,6140,9
KYANKWANZI,2016,3280,3160,6440,9
KYANKWANZI,2017,3440,3310,6750,9
KYANKWANZI,2018,3620,3460,7080,9
KYANKWANZI,2019,3800,3620,7420,9
KYANKWANZI,2020,3990,3780,7770,9
KYANKWANZI,2021,4190,3950,8140,9
KYANKWANZI,2022,4390,4120,8510,9
KYANKWANZI,2023,4600,4300,8900,9
KYANKWANZI,2024,4810,4480,9290,9
KYANKWANZI,2025,5030,4670,9700,9
KYEGEGWA,2015,4400,4200,8600,9
KYEGEGWA,2016,4760,4530,9290,9
KYEGEGWA,2017,5150,4890,10040,9
KYEGEGWA,2018,5580,5280,10860,9
KYEGEGWA,2019,6030,5690,11720,9
KYEGEGWA,2020,6510,6130,12640,9
KYEGEGWA,2021,7030,6600,13630,9
KYEGEGWA,2022,7590,7100,14690,9
KYEGEGWA,2023,8180,7640,15820,9
KYEGEGWA,2024,8820,8210,17030,9
KYEGEGWA,2025,9490,8820,18310,9
KYENJOJO,2015,6300,5970,12270,9
KYENJOJO,2016,6560,6190,12750,9
KYENJOJO,2017,6830,6420,13250,9
KYENJOJO,2018,7110,6650,13760,9
KYENJOJO,2019,7400,6890,14290,9
KYENJOJO,2020,7690,7130,14820,9
KYENJOJO,2021,7980,7380,15360,9
KYENJOJO,2022,8290,7640,15930,9
KYENJOJO,2023,8600,7890,16490,9
KYENJOJO,2024,8910,8150,17060,9
KYENJOJO,2025,9220,8410,17630,9
KYOTERA,2015,4120,3650,7770,9
KYOTERA,2016,4140,3630,7770,9
KYOTERA,2017,4170,3630,7800,9
KYOTERA,2018,4200,3640,7840,9
KYOTERA,2019,4180,3560,7740,9
KYOTERA,2020,4150,3520,7670,9
KYOTERA,2021,4130,3500,7630,9
KYOTERA,2022,4160,3520,7680,9
KYOTERA,2023,4320,3620,7940,9
KYOTERA,2024,4310,3790,8100,9
KYOTERA,2025,4320,3810,8130,9
KARENGA,2015,730,760,1490,9
KARENGA,2016,750,780,1530,9
KARENGA,2017,760,800,1560,9
KARENGA,2018,790,820,1610,9
KARENGA,2019,810,840,1650,9
KARENGA,2020,830,850,1680,9
KARENGA,2021,850,870,1720,9
KARENGA,2022,870,890,1760,9
KARENGA,2023,890,910,1800,9
KARENGA,2024,910,930,1840,9
KARENGA,2025,930,950,1880,9
LAMWO,2015,2310,2240,4550,9
LAMWO,2016,2310,2240,4550,9
LAMWO,2017,2310,2240,4550,9
LAMWO,2018,2310,2240,4550,9
LAMWO,2019,2280,2200,4480,9
LAMWO,2020,2250,2180,4430,9
LAMWO,2021,2220,2170,4390,9
LAMWO,2022,2230,2180,4410,9
LAMWO,2023,2300,2240,4540,9
LAMWO,2024,2270,2350,4620,9
LAMWO,2025,2270,2360,4630,9
LIRA,2015,5710,5770,11480,9
LIRA,2016,5870,5930,11800,9
LIRA,2017,6040,6100,12140,9
LIRA,2018,6210,6270,12480,9
LIRA,2019,6370,6450,12820,9
LIRA,2020,6550,6620,13170,9
LIRA,2021,6710,6800,13510,9
LIRA,2022,6880,6970,13850,9
LIRA,2023,7050,7150,14200,9
LIRA,2024,7220,7320,14540,9
LIRA,2025,7380,7500,14880,9
LUUKA,2015,4090,4050,8140,9
LUUKA,2016,4140,4070,8210,9
LUUKA,2017,4180,4090,8270,9
LUUKA,2018,4230,4110,8340,9
LUUKA,2019,4220,4060,8280,9
LUUKA,2020,4210,4040,8250,9
LUUKA,2021,4210,4040,8250,9
LUUKA,2022,4260,4090,8350,9
LUUKA,2023,4440,4230,8670,9
LUUKA,2024,4440,4460,8900,9
LUUKA,2025,4480,4500,8980,9
LUWERO,2015,7590,6830,14420,9
LUWERO,2016,7710,6870,14580,9
LUWERO,2017,7830,6930,14760,9
LUWERO,2018,7950,6990,14940,9
LUWERO,2019,7990,6900,14890,9
LUWERO,2020,7990,6900,14890,9
LUWERO,2021,8030,6910,14940,9
LUWERO,2022,8170,7010,15180,9
LUWERO,2023,8550,7260,15810,9
LUWERO,2024,8590,7680,16270,9
LUWERO,2025,8690,7770,16460,9
LWENGO,2015,4830,4520,9350,9
LWENGO,2016,4840,4490,9330,9
LWENGO,2017,4840,4470,9310,9
LWENGO,2018,4840,4440,9280,9
LWENGO,2019,4800,4340,9140,9
LWENGO,2020,4720,4270,8990,9
LWENGO,2021,4680,4230,8910,9
LWENGO,2022,4690,4240,8930,9
LWENGO,2023,4840,4330,9170,9
LWENGO,2024,4790,4520,9310,9
LWENGO,2025,4780,4510,9290,9
LYANTONDE,2015,1510,1380,2890,9
LYANTONDE,2016,1550,1400,2950,9
LYANTONDE,2017,1580,1420,3000,9
LYANTONDE,2018,1610,1440,3050,9
LYANTONDE,2019,1630,1430,3060,9
LYANTONDE,2020,1640,1440,3080,9
LYANTONDE,2021,1650,1450,3100,9
LYANTONDE,2022,1690,1480,3170,9
LYANTONDE,2023,1770,1530,3300,9
LYANTONDE,2024,1790,1630,3420,9
LYANTONDE,2025,1830,1660,3490,9
MANAFWA,2015,2500,2430,4930,9
MANAFWA,2016,2560,2490,5050,9
MANAFWA,2017,2620,2540,5160,9
MANAFWA,2018,2690,2600,5290,9
MANAFWA,2019,2750,2650,5400,9
MANAFWA,2020,2820,2710,5530,9
MANAFWA,2021,2880,2760,5640,9
MANAFWA,2022,2940,2820,5760,9
MANAFWA,2023,3000,2870,5870,9
MANAFWA,2024,3070,2920,5990,9
MANAFWA,2025,3130,2970,6100,9
MARACHA,2015,3130,2900,6030,9
MARACHA,2016,3200,2960,6160,9
MARACHA,2017,3270,3020,6290,9
MARACHA,2018,3330,3080,6410,9
MARACHA,2019,3400,3130,6530,9
MARACHA,2020,3470,3190,6660,9
MARACHA,2021,3530,3240,6770,9
MARACHA,2022,3600,3300,6900,9
MARACHA,2023,3660,3350,7010,9
MARACHA,2024,3720,3400,7120,9
MARACHA,2025,3780,3450,7230,9
MASAKA,2015,4530,4260,8790,9
MASAKA,2016,4590,4280,8870,9
MASAKA,2017,4650,4300,8950,9
MASAKA,2018,4710,4340,9050,9
MASAKA,2019,4720,4280,9000,9
MASAKA,2020,4700,4260,8960,9
MASAKA,2021,4720,4260,8980,9
MASAKA,2022,4790,4310,9100,9
MASAKA,2023,4990,4470,9460,9
MASAKA,2024,5000,4710,9710,9
MASAKA,2025,5060,4760,9820,9
MASINDI,2015,4090,3870,7960,9
MASINDI,2016,4210,3980,8190,9
MASINDI,2017,4330,4080,8410,9
MASINDI,2018,4450,4190,8640,9
MASINDI,2019,4580,4300,8880,9
MASINDI,2020,4700,4410,9110,9
MASINDI,2021,4830,4520,9350,9
MASINDI,2022,4960,4620,9580,9
MASINDI,2023,5080,4730,9810,9
MASINDI,2024,5210,4840,10050,9
MASINDI,2025,5330,4950,10280,9
MAYUGE,2015,8030,7470,15500,9
MAYUGE,2016,8200,7590,15790,9
MAYUGE,2017,8380,7710,16090,9
MAYUGE,2018,8560,7830,16390,9
MAYUGE,2019,8660,7810,16470,9
MAYUGE,2020,8710,7860,16570,9
MAYUGE,2021,8800,7950,16750,9
MAYUGE,2022,9020,8120,17140,9
MAYUGE,2023,9500,8490,17990,9
MAYUGE,2024,9600,9040,18640,9
MAYUGE,2025,9780,9210,18990,9
MBALE,2015,7210,7240,14450,9
MBALE,2016,7350,7370,14720,9
MBALE,2017,7510,7500,15010,9
MBALE,2018,7670,7650,15320,9
MBALE,2019,7730,7640,15370,9
MBALE,2020,7790,7720,15510,9
MBALE,2021,7850,7810,15660,9
MBALE,2022,8030,8000,16030,9
MBALE,2023,8450,8390,16840,9
MBALE,2024,8540,8950,17490,9
MBALE,2025,8690,9150,17840,9
MBARARA,2015,4350,4330,8680,9
MBARARA,2016,4450,4420,8870,9
MBARARA,2017,4550,4520,9070,9
MBARARA,2018,4660,4610,9270,9
MBARARA,2019,4760,4710,9470,9
MBARARA,2020,4860,4810,9670,9
MBARARA,2021,4960,4900,9860,9
MBARARA,2022,5060,4990,10050,9
MBARARA,2023,5160,5080,10240,9
MBARARA,2024,5250,5170,10420,9
MBARARA,2025,5350,5260,10610,9
MITOOMA,2015,2780,2640,5420,9
MITOOMA,2016,2810,2660,5470,9
MITOOMA,2017,2850,2690,5540,9
MITOOMA,2018,2880,2710,5590,9
MITOOMA,2019,2910,2730,5640,9
MITOOMA,2020,2940,2750,5690,9
MITOOMA,2021,2970,2770,5740,9
MITOOMA,2022,3000,2790,5790,9
MITOOMA,2023,3030,2810,5840,9
MITOOMA,2024,3050,2820,5870,9
MITOOMA,2025,3070,2840,5910,9
MITYANA,2015,5320,4760,10080,9
MITYANA,2016,5360,4760,10120,9
MITYANA,2017,5410,4770,10180,9
MITYANA,2018,5460,4780,10240,9
MITYANA,2019,5440,4690,10130,9
MITYANA,2020,5410,4660,10070,9
MITYANA,2021,5390,4630,10020,9
MITYANA,2022,5460,4670,10130,9
MITYANA,2023,5670,4810,10480,9
MITYANA,2024,5660,5050,10710,9
MITYANA,2025,5690,5070,10760,9
MOROTO,2015,1320,1290,2610,9
MOROTO,2016,1330,1300,2630,9
MOROTO,2017,1350,1310,2660,9
MOROTO,2018,1370,1320,2690,9
MOROTO,2019,1370,1310,2680,9
MOROTO,2020,1370,1310,2680,9
MOROTO,2021,1370,1330,2700,9
MOROTO,2022,1390,1350,2740,9
MOROTO,2023,1450,1400,2850,9
MOROTO,2024,1460,1480,2940,9
MOROTO,2025,1470,1500,2970,9
MOYO,2015,1590,1450,3040,9
MOYO,2016,1630,1490,3120,9
MOYO,2017,1670,1520,3190,9
MOYO,2018,1710,1550,3260,9
MOYO,2019,1750,1580,3330,9
MOYO,2020,1790,1620,3410,9
MOYO,2021,1840,1640,3480,9
MOYO,2022,1880,1680,3560,9
MOYO,2023,1920,1710,3630,9
MOYO,2024,1960,1740,3700,9
MOYO,2025,1990,1770,3760,9
MPIGI,2015,3950,3760,7710,9
MPIGI,2016,4000,3790,7790,9
MPIGI,2017,4060,3820,7880,9
MPIGI,2018,4120,3860,7980,9
MPIGI,2019,4130,3820,7950,9
MPIGI,2020,4130,3810,7940,9
MPIGI,2021,4140,3830,7970,9
MPIGI,2022,4210,3880,8090,9
MPIGI,2023,4400,4030,8430,9
MPIGI,2024,4410,4260,8670,9
MPIGI,2025,4470,4310,8780,9
MUBENDE,2015,6510,5980,12490,9
MUBENDE,2016,6790,6180,12970,9
MUBENDE,2017,7080,6410,13490,9
MUBENDE,2018,7390,6640,14030,9
MUBENDE,2019,7620,6750,14370,9
MUBENDE,2020,7830,6930,14760,9
MUBENDE,2021,8070,7150,15220,9
MUBENDE,2022,8440,7450,15890,9
MUBENDE,2023,9080,7950,17030,9
MUBENDE,2024,9370,8630,18000,9
MUBENDE,2025,9760,8980,18740,9
MUKONO,2015,8830,8310,17140,9
MUKONO,2016,8990,8430,17420,9
MUKONO,2017,9140,8560,17700,9
MUKONO,2018,9300,8690,17990,9
MUKONO,2019,9360,8650,18010,9
MUKONO,2020,9390,8690,18080,9
MUKONO,2021,9440,8770,18210,9
MUKONO,2022,9630,8950,18580,9
MUKONO,2023,10100,9340,19440,9
MUKONO,2024,10170,9940,20110,9
MUKONO,2025,10320,10120,20440,9
MADI OKOLLO,2015,2080,1850,3930,9
MADI OKOLLO,2016,2130,1910,4040,9
MADI OKOLLO,2017,2210,1950,4160,9
MADI OKOLLO,2018,2260,2010,4270,9
MADI OKOLLO,2019,2330,2060,4390,9
MADI OKOLLO,2020,2400,2110,4510,9
MADI OKOLLO,2021,2450,2170,4620,9
MADI OKOLLO,2022,2520,2220,4740,9
MADI OKOLLO,2023,2590,2270,4860,9
MADI OKOLLO,2024,2640,2320,4960,9
MADI OKOLLO,2025,2710,2370,5080,9
NABILATUK,2015,980,1030,2010,9
NABILATUK,2016,1030,1060,2090,9
NABILATUK,2017,1070,1090,2160,9
NABILATUK,2018,1120,1120,2240,9
NABILATUK,2019,1150,1130,2280,9
NABILATUK,2020,1180,1160,2340,9
NABILATUK,2021,1210,1180,2390,9
NABILATUK,2022,1260,1230,2490,9
NABILATUK,2023,1350,1300,2650,9
NABILATUK,2024,1400,1410,2810,9
NABILATUK,2025,1440,1450,2890,9
NAKAPIRIPIRIT,2015,1050,1110,2160,9
NAKAPIRIPIRIT,2016,1090,1130,2220,9
NAKAPIRIPIRIT,2017,1130,1170,2300,9
NAKAPIRIPIRIT,2018,1170,1200,2370,9
NAKAPIRIPIRIT,2019,1200,1210,2410,9
NAKAPIRIPIRIT,2020,1220,1230,2450,9
NAKAPIRIPIRIT,2021,1240,1260,2500,9
NAKAPIRIPIRIT,2022,1290,1310,2600,9
NAKAPIRIPIRIT,2023,1370,1380,2750,9
NAKAPIRIPIRIT,2024,1410,1490,2900,9
NAKAPIRIPIRIT,2025,1450,1540,2990,9
NAKASEKE,2015,2890,2580,5470,9
NAKASEKE,2016,3000,2640,5640,9
NAKASEKE,2017,3110,2700,5810,9
NAKASEKE,2018,3220,2770,5990,9
NAKASEKE,2019,3330,2830,6160,9
NAKASEKE,2020,3450,2890,6340,9
NAKASEKE,2021,3570,2960,6530,9
NAKASEKE,2022,3690,3020,6710,9
NAKASEKE,2023,3810,3080,6890,9
NAKASEKE,2024,3930,3140,7070,9
NAKASEKE,2025,4060,3200,7260,9
NAKASONGOLA,2015,2920,2910,5830,9
NAKASONGOLA,2016,2990,2940,5930,9
NAKASONGOLA,2017,3060,2970,6030,9
NAKASONGOLA,2018,3120,3010,6130,9
NAKASONGOLA,2019,3160,3000,6160,9
NAKASONGOLA,2020,3180,3000,6180,9
NAKASONGOLA,2021,3210,3020,6230,9
NAKASONGOLA,2022,3290,3080,6370,9
NAKASONGOLA,2023,3470,3210,6680,9
NAKASONGOLA,2024,3510,3400,6910,9
NAKASONGOLA,2025,3580,3460,7040,9
NAMAYINGO,2015,3530,3360,6890,9
NAMAYINGO,2016,3560,3350,6910,9
NAMAYINGO,2017,3600,3350,6950,9
NAMAYINGO,2018,3620,3360,6980,9
NAMAYINGO,2019,3620,3290,6910,9
NAMAYINGO,2020,3590,3270,6860,9
NAMAYINGO,2021,3590,3250,6840,9
NAMAYINGO,2022,3630,3270,6900,9
NAMAYINGO,2023,3770,3360,7130,9
NAMAYINGO,2024,3770,3530,7300,9
NAMAYINGO,2025,3800,3540,7340,9
NAMISINDWA,2015,3340,3120,6460,9
NAMISINDWA,2016,3440,3200,6640,9
NAMISINDWA,2017,3540,3280,6820,9
NAMISINDWA,2018,3630,3350,6980,9
NAMISINDWA,2019,3730,3430,7160,9
NAMISINDWA,2020,3830,3500,7330,9
NAMISINDWA,2021,3930,3580,7510,9
NAMISINDWA,2022,4030,3660,7690,9
NAMISINDWA,2023,4120,3730,7850,9
NAMISINDWA,2024,4220,3800,8020,9
NAMISINDWA,2025,4310,3880,8190,9
NAMUTUMBA,2015,4440,4110,8550,9
NAMUTUMBA,2016,4550,4180,8730,9
NAMUTUMBA,2017,4670,4250,8920,9
NAMUTUMBA,2018,4780,4340,9120,9
NAMUTUMBA,2019,4860,4330,9190,9
NAMUTUMBA,2020,4910,4370,9280,9
NAMUTUMBA,2021,4980,4410,9390,9
NAMUTUMBA,2022,5110,4520,9630,9
NAMUTUMBA,2023,5400,4730,10130,9
NAMUTUMBA,2024,5480,5050,10530,9
NAMUTUMBA,2025,5610,5160,10770,9
NAPAK,2015,1750,1840,3590,9
NAPAK,2016,1760,1850,3610,9
NAPAK,2017,1770,1870,3640,9
NAPAK,2018,1790,1870,3660,9
NAPAK,2019,1780,1850,3630,9
NAPAK,2020,1770,1840,3610,9
NAPAK,2021,1750,1850,3600,9
NAPAK,2022,1770,1860,3630,9
NAPAK,2023,1830,1940,3770,9
NAPAK,2024,1830,2040,3870,9
NAPAK,2025,1840,2070,3910,9
NEBBI,2015,3870,3640,7510,9
NEBBI,2016,3990,3740,7730,9
NEBBI,2017,4120,3850,7970,9
NEBBI,2018,4250,3960,8210,9
NEBBI,2019,4380,4070,8450,9
NEBBI,2020,4510,4180,8690,9
NEBBI,2021,4640,4290,8930,9
NEBBI,2022,4780,4400,9180,9
NEBBI,2023,4910,4510,9420,9
NEBBI,2024,5040,4620,9660,9
NEBBI,2025,5180,4720,9900,9
NGORA,2015,2350,2310,4660,9
NGORA,2016,2390,2330,4720,9
NGORA,2017,2440,2350,4790,9
NGORA,2018,2480,2380,4860,9
NGORA,2019,2500,2370,4870,9
NGORA,2020,2510,2370,4880,9
NGORA,2021,2530,2390,4920,9
NGORA,2022,2590,2430,5020,9
NGORA,2023,2710,2530,5240,9
NGORA,2024,2730,2690,5420,9
NGORA,2025,2770,2720,5490,9
NTOROKO,2015,980,930,1910,9
NTOROKO,2016,1010,930,1940,9
NTOROKO,2017,1020,930,1950,9
NTOROKO,2018,1030,940,1970,9
NTOROKO,2019,1040,930,1970,9
NTOROKO,2020,1040,920,1960,9
NTOROKO,2021,1040,920,1960,9
NTOROKO,2022,1060,930,1990,9
NTOROKO,2023,1110,960,2070,9
NTOROKO,2024,1110,1010,2120,9
NTOROKO,2025,1130,1020,2150,9
NTUNGAMO,2015,7440,7140,14580,9
NTUNGAMO,2016,7600,7280,14880,9
NTUNGAMO,2017,7760,7410,15170,9
NTUNGAMO,2018,7920,7540,15460,9
NTUNGAMO,2019,8090,7680,15770,9
NTUNGAMO,2020,8250,7810,16060,9
NTUNGAMO,2021,8410,7940,16350,9
NTUNGAMO,2022,8560,8060,16620,9
NTUNGAMO,2023,8720,8190,16910,9
NTUNGAMO,2024,8860,8310,17170,9
NTUNGAMO,2025,9010,8420,17430,9
NWOYA,2015,2190,2120,4310,9
NWOYA,2016,2420,2340,4760,9
NWOYA,2017,2680,2580,5260,9
NWOYA,2018,2950,2840,5790,9
NWOYA,2019,3260,3130,6390,9
NWOYA,2020,3600,3440,7040,9
NWOYA,2021,3970,3780,7750,9
NWOYA,2022,4370,4160,8530,9
NWOYA,2023,4810,4570,9380,9
NWOYA,2024,5290,5010,10300,9
NWOYA,2025,5810,5500,11310,9
OBONGI,2015,710,670,1380,9
OBONGI,2016,720,670,1390,9
OBONGI,2017,740,680,1420,9
OBONGI,2018,750,680,1430,9
OBONGI,2019,740,680,1420,9
OBONGI,2020,750,680,1430,9
OBONGI,2021,750,680,1430,9
OBONGI,2022,770,690,1460,9
OBONGI,2023,790,710,1500,9
OBONGI,2024,800,750,1550,9
OBONGI,2025,810,750,1560,9
OMORO,2015,2770,2760,5530,9
OMORO,2016,2850,2820,5670,9
OMORO,2017,2920,2870,5790,9
OMORO,2018,3000,2920,5920,9
OMORO,2019,3040,2930,5970,9
OMORO,2020,3070,2960,6030,9
OMORO,2021,3120,3000,6120,9
OMORO,2022,3200,3080,6280,9
OMORO,2023,3390,3230,6620,9
OMORO,2024,3440,3460,6900,9
OMORO,2025,3520,3540,7060,9
OTUKE,2015,1590,1600,3190,9
OTUKE,2016,1660,1670,3330,9
OTUKE,2017,1740,1740,3480,9
OTUKE,2018,1810,1820,3630,9
OTUKE,2019,1900,1900,3800,9
OTUKE,2020,1980,1980,3960,9
OTUKE,2021,2060,2050,4110,9
OTUKE,2022,2150,2140,4290,9
OTUKE,2023,2240,2220,4460,9
OTUKE,2024,2330,2310,4640,9
OTUKE,2025,2420,2400,4820,9
OYAM,2015,6160,5920,12080,9
OYAM,2016,6350,6100,12450,9
OYAM,2017,6540,6270,12810,9
OYAM,2018,6740,6450,13190,9
OYAM,2019,6940,6640,13580,9
OYAM,2020,7140,6820,13960,9
OYAM,2021,7340,7010,14350,9
OYAM,2022,7550,7190,14740,9
OYAM,2023,7750,7380,15130,9
OYAM,2024,7950,7560,15510,9
OYAM,2025,8150,7750,15900,9
PADER,2015,3100,3020,6120,9
PADER,2016,3120,3030,6150,9
PADER,2017,3150,3040,6190,9
PADER,2018,3170,3050,6220,9
PADER,2019,3160,3020,6180,9
PADER,2020,3140,3000,6140,9
PADER,2021,3130,2990,6120,9
PADER,2022,3160,3020,6180,9
PADER,2023,3270,3120,6390,9
PADER,2024,3270,3290,6560,9
PADER,2025,3280,3320,6600,9
PAKWACH,2015,2410,2320,4730,9
PAKWACH,2016,2510,2400,4910,9
PAKWACH,2017,2620,2490,5110,9
PAKWACH,2018,2730,2580,5310,9
PAKWACH,2019,2840,2670,5510,9
PAKWACH,2020,2950,2760,5710,9
PAKWACH,2021,3070,2860,5930,9
PAKWACH,2022,3190,2950,6140,9
PAKWACH,2023,3310,3050,6360,9
PAKWACH,2024,3430,3150,6580,9
PAKWACH,2025,3560,3250,6810,9
PALLISA,2015,4600,4580,9180,9
PALLISA,2016,4770,4710,9480,9
PALLISA,2017,4920,4840,9760,9
PALLISA,2018,5100,4980,10080,9
PALLISA,2019,5230,5030,10260,9
PALLISA,2020,5320,5130,10450,9
PALLISA,2021,5450,5240,10690,9
PALLISA,2022,5660,5420,11080,9
PALLISA,2023,6040,5740,11780,9
PALLISA,2024,6180,6190,12370,9
PALLISA,2025,6380,6390,12770,9
RAKAI,2015,4700,4530,9230,9
RAKAI,2016,4780,4560,9340,9
RAKAI,2017,4850,4600,9450,9
RAKAI,2018,4930,4640,9570,9
RAKAI,2019,4960,4590,9550,9
RAKAI,2020,4960,4590,9550,9
RAKAI,2021,4980,4600,9580,9
RAKAI,2022,5060,4660,9720,9
RAKAI,2023,5310,4840,10150,9
RAKAI,2024,5330,5110,10440,9
RAKAI,2025,5400,5170,10570,9
RUBANDA,2015,2930,2780,5710,9
RUBANDA,2016,2970,2810,5780,9
RUBANDA,2017,3010,2830,5840,9
RUBANDA,2018,3050,2850,5900,9
RUBANDA,2019,3090,2870,5960,9
RUBANDA,2020,3130,2890,6020,9
RUBANDA,2021,3160,2910,6070,9
RUBANDA,2022,3190,2920,6110,9
RUBANDA,2023,3230,2940,6170,9
RUBANDA,2024,3250,2950,6200,9
RUBANDA,2025,3280,2960,6240,9
RUBIRIZI,2015,2030,1890,3920,9
RUBIRIZI,2016,2080,1920,4000,9
RUBIRIZI,2017,2120,1960,4080,9
RUBIRIZI,2018,2160,2000,4160,9
RUBIRIZI,2019,2200,2030,4230,9
RUBIRIZI,2020,2240,2070,4310,9
RUBIRIZI,2021,2280,2100,4380,9
RUBIRIZI,2022,2320,2140,4460,9
RUBIRIZI,2023,2360,2170,4530,9
RUBIRIZI,2024,2400,2210,4610,9
RUBIRIZI,2025,2440,2240,4680,9
RUKIGA,2015,1430,1480,2910,9
RUKIGA,2016,1440,1490,2930,9
RUKIGA,2017,1460,1500,2960,9
RUKIGA,2018,1470,1510,2980,9
RUKIGA,2019,1490,1520,3010,9
RUKIGA,2020,1500,1530,3030,9
RUKIGA,2021,1510,1540,3050,9
RUKIGA,2022,1520,1540,3060,9
RUKIGA,2023,1530,1550,3080,9
RUKIGA,2024,1540,1560,3100,9
RUKIGA,2025,1550,1560,3110,9
RUKUNGIRI,2015,4620,4380,9000,9
RUKUNGIRI,2016,4680,4420,9100,9
RUKUNGIRI,2017,4740,4470,9210,9
RUKUNGIRI,2018,4790,4510,9300,9
RUKUNGIRI,2019,4850,4550,9400,9
RUKUNGIRI,2020,4900,4590,9490,9
RUKUNGIRI,2021,4940,4620,9560,9
RUKUNGIRI,2022,4990,4650,9640,9
RUKUNGIRI,2023,5030,4680,9710,9
RUKUNGIRI,2024,5070,4710,9780,9
RUKUNGIRI,2025,5110,4730,9840,9
RWAMPARA,2015,1900,1930,3830,9
RWAMPARA,2016,1940,1970,3910,9
RWAMPARA,2017,1990,2020,4010,9
RWAMPARA,2018,2030,2060,4090,9
RWAMPARA,2019,2070,2100,4170,9
RWAMPARA,2020,2120,2140,4260,9
RWAMPARA,2021,2160,2180,4340,9
RWAMPARA,2022,2210,2230,4440,9
RWAMPARA,2023,2240,2270,4510,9
RWAMPARA,2024,2290,2310,4600,9
RWAMPARA,2025,2330,2350,4680,9
SERERE,2015,4970,4850,9820,9
SERERE,2016,5120,4960,10080,9
SERERE,2017,5290,5090,10380,9
SERERE,2018,5450,5220,10670,9
SERERE,2019,5560,5240,10800,9
SERERE,2020,5650,5320,10970,9
SERERE,2021,5760,5430,11190,9
SERERE,2022,5960,5590,11550,9
SERERE,2023,6320,5890,12210,9
SERERE,2024,6460,6340,12800,9
SERERE,2025,6640,6510,13150,9
SHEEMA,2015,2930,2760,5690,9
SHEEMA,2016,2960,2790,5750,9
SHEEMA,2017,3000,2820,5820,9
SHEEMA,2018,3030,2850,5880,9
SHEEMA,2019,3070,2880,5950,9
SHEEMA,2020,3100,2900,6000,9
SHEEMA,2021,3130,2930,6060,9
SHEEMA,2022,3160,2950,6110,9
SHEEMA,2023,3190,2970,6160,9
SHEEMA,2024,3220,2990,6210,9
SHEEMA,2025,3240,3010,6250,9
SIRONKO,2015,3480,3230,6710,9
SIRONKO,2016,3570,3290,6860,9
SIRONKO,2017,3650,3360,7010,9
SIRONKO,2018,3740,3430,7170,9
SIRONKO,2019,3820,3490,7310,9
SIRONKO,2020,3910,3560,7470,9
SIRONKO,2021,3990,3620,7610,9
SIRONKO,2022,4080,3690,7770,9
SIRONKO,2023,4160,3750,7910,9
SIRONKO,2024,4240,3810,8050,9
SIRONKO,2025,4320,3870,8190,9
SOROTI,2015,4780,4680,9460,9
SOROTI,2016,4900,4760,9660,9
SOROTI,2017,5030,4860,9890,9
SOROTI,2018,5160,4960,10120,9
SOROTI,2019,5240,4970,10210,9
SOROTI,2020,5300,5020,10320,9
SOROTI,2021,5380,5100,10480,9
SOROTI,2022,5540,5230,10770,9
SOROTI,2023,5860,5480,11340,9
SOROTI,2024,5960,5870,11830,9
SOROTI,2025,6090,6010,12100,9
SSEMBABULE,2015,4360,4070,8430,9
SSEMBABULE,2016,4440,4110,8550,9
SSEMBABULE,2017,4530,4170,8700,9
SSEMBABULE,2018,4620,4220,8840,9
SSEMBABULE,2019,4660,4190,8850,9
SSEMBABULE,2020,4670,4210,8880,9
SSEMBABULE,2021,4710,4220,8930,9
SSEMBABULE,2022,4820,4300,9120,9
SSEMBABULE,2023,5060,4480,9540,9
SSEMBABULE,2024,5100,4750,9850,9
SSEMBABULE,2025,5180,4830,10010,9
TORORO,2015,8080,8110,16190,9
TORORO,2016,8300,8310,16610,9
TORORO,2017,8520,8520,17040,9
TORORO,2018,8750,8730,17480,9
TORORO,2019,8970,8940,17910,9
TORORO,2020,9190,9150,18340,9
TORORO,2021,9420,9360,18780,9
TORORO,2022,9640,9570,19210,9
TORORO,2023,9860,9780,19640,9
TORORO,2024,10080,9980,20060,9
TORORO,2025,10290,10180,20470,9
WAKISO,2015,24220,23530,47750,9
WAKISO,2016,25840,25130,50970,9
WAKISO,2017,27570,26860,54430,9
WAKISO,2018,29400,28680,58080,9
WAKISO,2019,31350,30600,61950,9
WAKISO,2020,33390,32630,66020,9
WAKISO,2021,35540,34800,70340,9
WAKISO,2022,37820,37100,74920,9
WAKISO,2023,40220,39480,79700,9
WAKISO,2024,42720,42000,84720,9
WAKISO,2025,45350,44670,90020,9
YUMBE,2015,10840,12030,22870,9
YUMBE,2016,11290,12540,23830,9
YUMBE,2017,11770,13100,24870,9
YUMBE,2018,12260,13690,25950,9
YUMBE,2019,12620,14020,26640,9
YUMBE,2020,12950,14510,27460,9
YUMBE,2021,13330,15060,28390,9
YUMBE,2022,13910,15820,29730,9
YUMBE,2023,14940,16990,31930,9
YUMBE,2024,15390,18610,34000,9
YUMBE,2025,15990,19490,35480,9
ZOMBO,2015,4000,3700,7700,9
ZOMBO,2016,4120,3810,7930,9
ZOMBO,2017,4250,3910,8160,9
ZOMBO,2018,4380,4020,8400,9
ZOMBO,2019,4510,4130,8640,9
ZOMBO,2020,4640,4240,8880,9
ZOMBO,2021,4770,4340,9110,9
ZOMBO,2022,4910,4460,9370,9
ZOMBO,2023,5040,4560,9600,9
ZOMBO,2024,5180,4670,9850,9
ZOMBO,2025,5310,4780,10090,9
