id,year,male,female,total,childbearing_age,pregnants,not_pregnant,births,u1,u5,u15,suspect_tb
ABIM,2015,55200,58200,113400,26082,5670,20412,5499.9,4876.2,22906.8,52164,340.2
ABIM,2016,58900,61800,120700,27761,6035,21726,5853.95,5190.1,24381.4,55522,362.1
ABIM,2017,62700,65500,128200,29486,6410,23076,6217.7,5512.6,25896.4,58972,384.6
ABIM,2018,66700,69500,136200,31326,6810,24516,6605.7,5856.6,27512.4,62652,408.6
ABIM,2019,71000,73600,144600,33258,7230,26028,7013.1,6217.8,29209.2,66516,433.8
ABIM,2020,75500,78000,153500,35305,7675,27630,7444.75,6600.5,31007,70610,460.5
ABIM,2021,80300,82600,162900,37467,8145,29322,7900.65,7004.7,32905.8,74934,488.7
ABIM,2022,85300,87300,172600,39698,8630,31068,8371.1,7421.8,34865.2,79396,517.8
ABIM,2023,90500,92300,182800,42044,9140,32904,8865.8,7860.4,36925.6,84088,548.4
ABIM,2024,96000,97600,193600,44528,9680,34848,9389.6,8324.8,39107.2,89056,580.8
ABIM,2025,101700,103000,204700,47081,10235,36846,9927.95,8802.1,41349.4,94162,614.1
ADJUMANI,2015,108800,117700,226500,52095,11325,40770,10985.25,9739.5,45753,104190,679.5
ADJUMANI,2016,109700,118900,228600,52578,11430,41148,11087.1,9829.8,46177.2,105156,685.8
ADJUMANI,2017,110500,120000,230500,53015,11525,41490,11179.25,9911.5,46561,106030,691.5
ADJUMANI,2018,111200,121200,232400,53452,11620,41832,11271.4,9993.2,46944.8,106904,697.2
ADJUMANI,2019,112000,122300,234300,53889,11715,42174,11363.55,10074.9,47328.6,107778,702.9
ADJUMANI,2020,112600,123300,235900,54257,11795,42462,11441.15,10143.7,47651.8,108514,707.7
ADJUMANI,2021,113200,124200,237400,54602,11870,42732,11513.9,10208.2,47954.8,109204,712.2
ADJUMANI,2022,113700,125100,238800,54924,11940,42984,11581.8,10268.4,48237.6,109848,716.4
ADJUMANI,2023,114100,125900,240000,55200,12000,43200,11640,10320,48480,110400,720
ADJUMANI,2024,114500,126700,241200,55476,12060,43416,11698.2,10371.6,48722.4,110952,723.6
ADJUMANI,2025,114700,127300,242000,55660,12100,43560,11737,10406,48884,111320,726
AGAGO,2015,112000,118800,230800,53084,11540,41544,11193.8,9924.4,46621.6,106168,692.4
AGAGO,2016,114000,120900,234900,54027,11745,42282,11392.65,10100.7,47449.8,108054,704.7
AGAGO,2017,116000,123000,239000,54970,11950,43020,11591.5,10277,48278,109940,717
AGAGO,2018,118000,125200,243200,55936,12160,43776,11795.2,10457.6,49126.4,111872,729.6
AGAGO,2019,119900,127300,247200,56856,12360,44496,11989.2,10629.6,49934.4,113712,741.6
AGAGO,2020,121900,129300,251200,57776,12560,45216,12183.2,10801.6,50742.4,115552,753.6
AGAGO,2021,123700,131300,255000,58650,12750,45900,12367.5,10965,51510,117300,765
AGAGO,2022,125500,133300,258800,59524,12940,46584,12551.8,11128.4,52277.6,119048,776.4
AGAGO,2023,127300,135200,262500,60375,13125,47250,12731.25,11287.5,53025,120750,787.5
AGAGO,2024,129000,137000,266000,61180,13300,47880,12901,11438,53732,122360,798
AGAGO,2025,130500,138800,269300,61939,13465,48474,13061.05,11579.9,54398.6,123878,807.9
ALEBTONG,2015,113500,118900,232400,53452,11620,41832,11271.4,9993.2,46944.8,106904,697.2
ALEBTONG,2016,116900,122100,239000,54970,11950,43020,11591.5,10277,48278,109940,717
ALEBTONG,2017,120300,125400,245700,56511,12285,44226,11916.45,10565.1,49631.4,113022,737.1
ALEBTONG,2018,123700,128700,252400,58052,12620,45432,12241.4,10853.2,50984.8,116104,757.2
ALEBTONG,2019,127200,132000,259200,59616,12960,46656,12571.2,11145.6,52358.4,119232,777.6
ALEBTONG,2020,130700,135400,266100,61203,13305,47898,12905.85,11442.3,53752.2,122406,798.3
ALEBTONG,2021,134100,138700,272800,62744,13640,49104,13230.8,11730.4,55105.6,125488,818.4
ALEBTONG,2022,137600,142000,279600,64308,13980,50328,13560.6,12022.8,56479.2,128616,838.8
ALEBTONG,2023,141100,145300,286400,65872,14320,51552,13890.4,12315.2,57852.8,131744,859.2
ALEBTONG,2024,144600,148600,293200,67436,14660,52776,14220.2,12607.6,59226.4,134872,879.6
ALEBTONG,2025,148000,151900,299900,68977,14995,53982,14545.15,12895.7,60579.8,137954,899.7
AMOLATAR,2015,74600,75500,150100,34523,7505,27018,7279.85,6454.3,30320.2,69046,450.3
AMOLATAR,2016,76600,77400,154000,35420,7700,27720,7469,6622,31108,70840,462
AMOLATAR,2017,78700,79300,158000,36340,7900,28440,7663,6794,31916,72680,474
AMOLATAR,2018,80800,81200,162000,37260,8100,29160,7857,6966,32724,74520,486
AMOLATAR,2019,82900,83100,166000,38180,8300,29880,8051,7138,33532,76360,498
AMOLATAR,2020,85100,85000,170100,39123,8505,30618,8249.85,7314.3,34360.2,78246,510.3
AMOLATAR,2021,87200,86800,174000,40020,8700,31320,8439,7482,35148,80040,522
AMOLATAR,2022,89300,88700,178000,40940,8900,32040,8633,7654,35956,81880,534
AMOLATAR,2023,91400,90600,182000,41860,9100,32760,8827,7826,36764,83720,546
AMOLATAR,2024,93500,92400,185900,42757,9295,33462,9016.15,7993.7,37551.8,85514,557.7
AMOLATAR,2025,95500,94200,189700,43631,9485,34146,9200.45,8157.1,38319.4,87262,569.1
AMUDAT,2015,56000,53400,109400,25162,5470,19692,5305.9,4704.2,22098.8,50324,328.2
AMUDAT,2016,58300,55900,114200,26266,5710,20556,5538.7,4910.6,23068.4,52532,342.6
AMUDAT,2017,60600,58500,119100,27393,5955,21438,5776.35,5121.3,24058.2,54786,357.3
AMUDAT,2018,63100,61200,124300,28589,6215,22374,6028.55,5344.9,25108.6,57178,372.9
AMUDAT,2019,65500,63900,129400,29762,6470,23292,6275.9,5564.2,26138.8,59524,388.2
AMUDAT,2020,68100,66800,134900,31027,6745,24282,6542.65,5800.7,27249.8,62054,404.7
AMUDAT,2021,70700,69700,140400,32292,7020,25272,6809.4,6037.2,28360.8,64584,421.2
AMUDAT,2022,73300,72800,146100,33603,7305,26298,7085.85,6282.3,29512.2,67206,438.3
AMUDAT,2023,76000,75900,151900,34937,7595,27342,7367.15,6531.7,30683.8,69874,455.7
AMUDAT,2024,78700,79100,157800,36294,7890,28404,7653.3,6785.4,31875.6,72588,473.4
AMUDAT,2025,81500,82300,163800,37674,8190,29484,7944.3,7043.4,33087.6,75348,491.4
AMURIA,2015,92200,96400,188600,43378,9430,33948,9147.1,8109.8,38097.2,86756,565.8
AMURIA,2016,95800,99800,195600,44988,9780,35208,9486.6,8410.8,39511.2,89976,586.8
AMURIA,2017,99400,103200,202600,46598,10130,36468,9826.1,8711.8,40925.2,93196,607.8
AMURIA,2018,103200,106800,210000,48300,10500,37800,10185,9030,42420,96600,630
AMURIA,2019,107100,110400,217500,50025,10875,39150,10548.75,9352.5,43935,100050,652.5
AMURIA,2020,111000,114000,225000,51750,11250,40500,10912.5,9675,45450,103500,675
AMURIA,2021,115100,117700,232800,53544,11640,41904,11290.8,10010.4,47025.6,107088,698.4
AMURIA,2022,119100,121400,240500,55315,12025,43290,11664.25,10341.5,48581,110630,721.5
AMURIA,2023,123300,125200,248500,57155,12425,44730,12052.25,10685.5,50197,114310,745.5
AMURIA,2024,127400,129000,256400,58972,12820,46152,12435.4,11025.2,51792.8,117944,769.2
AMURIA,2025,131600,132900,264500,60835,13225,47610,12828.25,11373.5,53429,121670,793.5
AMURU,2015,93200,97300,190500,43815,9525,34290,9239.25,8191.5,38481,87630,571.5
AMURU,2016,95800,99900,195700,45011,9785,35226,9491.45,8415.1,39531.4,90022,587.1
AMURU,2017,98400,102500,200900,46207,10045,36162,9743.65,8638.7,40581.8,92414,602.7
AMURU,2018,101000,105100,206100,47403,10305,37098,9995.85,8862.3,41632.2,94806,618.3
AMURU,2019,103600,107800,211400,48622,10570,38052,10252.9,9090.2,42702.8,97244,634.2
AMURU,2020,106300,110500,216800,49864,10840,39024,10514.8,9322.4,43793.6,99728,650.4
AMURU,2021,108900,113100,222000,51060,11100,39960,10767,9546,44844,102120,666
AMURU,2022,111500,115800,227300,52279,11365,40914,11024.05,9773.9,45914.6,104558,681.9
AMURU,2023,114100,118400,232500,53475,11625,41850,11276.25,9997.5,46965,106950,697.5
AMURU,2024,116700,121000,237700,54671,11885,42786,11528.45,10221.1,48015.4,109342,713.1
AMURU,2025,119200,123600,242800,55844,12140,43704,11775.8,10440.4,49045.6,111688,728.4
APAC,2015,94000,96500,190500,43815,9525,34290,9239.25,8191.5,38481,87630,571.5
APAC,2016,97500,99900,197400,45402,9870,35532,9573.9,8488.2,39874.8,90804,592.2
APAC,2017,101100,103400,204500,47035,10225,36810,9918.25,8793.5,41309,94070,613.5
APAC,2018,104800,106900,211700,48691,10585,38106,10267.45,9103.1,42763.4,97382,635.1
APAC,2019,108500,110500,219000,50370,10950,39420,10621.5,9417,44238,100740,657
APAC,2020,112400,114200,226600,52118,11330,40788,10990.1,9743.8,45773.2,104236,679.8
APAC,2021,116200,117900,234100,53843,11705,42138,11353.85,10066.3,47288.2,107686,702.3
APAC,2022,120200,121700,241900,55637,12095,43542,11732.15,10401.7,48863.8,111274,725.7
APAC,2023,124100,125500,249600,57408,12480,44928,12105.6,10732.8,50419.2,114816,748.8
APAC,2024,128100,129400,257500,59225,12875,46350,12488.75,11072.5,52015,118450,772.5
APAC,2025,132200,133200,265400,61042,13270,47772,12871.9,11412.2,53610.8,122084,796.2
ARUA,2015,313500,342500,656000,150880,32800,118080,31816,28208,132512,301760,1968
ARUA,2016,322800,351700,674500,155135,33725,121410,32713.25,29003.5,136249,310270,2023.5
ARUA,2017,331800,361600,693400,159482,34670,124812,33629.9,29816.2,140066.8,318964,2080.2
ARUA,2018,341400,371000,712400,163852,35620,128232,34551.4,30633.2,143904.8,327704,2137.2
ARUA,2019,351000,380900,731900,168337,36595,131742,35497.15,31471.7,147843.8,336674,2195.7
ARUA,2020,360400,390600,751000,172730,37550,135180,36423.5,32293,151702,345460,2253
ARUA,2021,370300,400300,770600,177238,38530,138708,37374.1,33135.8,155661.2,354476,2311.8
ARUA,2022,379700,410100,789800,181654,39490,142164,38305.3,33961.4,159539.6,363308,2369.4
ARUA,2023,389300,420100,809400,186162,40470,145692,39255.9,34804.2,163498.8,372324,2428.2
ARUA,2024,398900,429800,828700,190601,41435,149166,40191.95,35634.1,167397.4,381202,2486.1
ARUA,2025,408300,439400,847700,194971,42385,152586,41113.45,36451.1,171235.4,389942,2543.1
BUDAKA,2015,103600,109800,213400,49082,10670,38412,10349.9,9176.2,43106.8,98164,640.2
BUDAKA,2016,107400,113500,220900,50807,11045,39762,10713.65,9498.7,44621.8,101614,662.7
BUDAKA,2017,111400,117300,228700,52601,11435,41166,11091.95,9834.1,46197.4,105202,686.1
BUDAKA,2018,115500,121200,236700,54441,11835,42606,11479.95,10178.1,47813.4,108882,710.1
BUDAKA,2019,119600,125200,244800,56304,12240,44064,11872.8,10526.4,49449.6,112608,734.4
BUDAKA,2020,123800,129300,253100,58213,12655,45558,12275.35,10883.3,51126.2,116426,759.3
BUDAKA,2021,128100,133300,261400,60122,13070,47052,12677.9,11240.2,52802.8,120244,784.2
BUDAKA,2022,132500,137500,270000,62100,13500,48600,13095,11610,54540,124200,810
BUDAKA,2023,136900,141700,278600,64078,13930,50148,13512.1,11979.8,56277.2,128156,835.8
BUDAKA,2024,141300,145800,287100,66033,14355,51678,13924.35,12345.3,57994.2,132066,861.3
BUDAKA,2025,145700,150100,295800,68034,14790,53244,14346.3,12719.4,59751.6,136068,887.4
BUDUDA,2015,109800,108000,217800,50094,10890,39204,10563.3,9365.4,43995.6,100188,653.4
BUDUDA,2016,114900,112900,227800,52394,11390,41004,11048.3,9795.4,46015.6,104788,683.4
BUDUDA,2017,120200,117900,238100,54763,11905,42858,11547.85,10238.3,48096.2,109526,714.3
BUDUDA,2018,125700,123100,248800,57224,12440,44784,12066.8,10698.4,50257.6,114448,746.4
BUDUDA,2019,131400,128400,259800,59754,12990,46764,12600.3,11171.4,52479.6,119508,779.4
BUDUDA,2020,137200,133900,271100,62353,13555,48798,13148.35,11657.3,54762.2,124706,813.3
BUDUDA,2021,143300,139600,282900,65067,14145,50922,13720.65,12164.7,57145.8,130134,848.7
BUDUDA,2022,149400,145400,294800,67804,14740,53064,14297.8,12676.4,59549.6,135608,884.4
BUDUDA,2023,155800,151400,307200,70656,15360,55296,14899.2,13209.6,62054.4,141312,921.6
BUDUDA,2024,162300,157500,319800,73554,15990,57564,15510.3,13751.4,64599.6,147108,959.4
BUDUDA,2025,168900,163700,332600,76498,16630,59868,16131.1,14301.8,67185.2,152996,997.8
BUGIRI,2015,192200,203000,395200,90896,19760,71136,19167.2,16993.6,79830.4,181792,1185.6
BUGIRI,2016,200300,210900,411200,94576,20560,74016,19943.2,17681.6,83062.4,189152,1233.6
BUGIRI,2017,208700,219100,427800,98394,21390,77004,20748.3,18395.4,86415.6,196788,1283.4
BUGIRI,2018,217400,227500,444900,102327,22245,80082,21577.65,19130.7,89869.8,204654,1334.7
BUGIRI,2019,226300,236100,462400,106352,23120,83232,22426.4,19883.2,93404.8,212704,1387.2
BUGIRI,2020,235500,244900,480400,110492,24020,86472,23299.4,20657.2,97040.8,220984,1441.2
BUGIRI,2021,244800,253900,498700,114701,24935,89766,24186.95,21444.1,100737.4,229402,1496.1
BUGIRI,2022,254400,263000,517400,119002,25870,93132,25093.9,22248.2,104514.8,238004,1552.2
BUGIRI,2023,264100,272300,536400,123372,26820,96552,26015.4,23065.2,108352.8,246744,1609.2
BUGIRI,2024,274000,281800,555800,127834,27790,100044,26956.3,23899.4,112271.6,255668,1667.4
BUGIRI,2025,284000,291300,575300,132319,28765,103554,27902.05,24737.9,116210.6,264638,1725.9
BUGWERI,2015,80500,87800,168300,38709,8415,30294,8162.55,7236.9,33996.6,77418,504.9
BUGWERI,2016,82800,90100,172900,39767,8645,31122,8385.65,7434.7,34925.8,79534,518.7
BUGWERI,2017,85100,92300,177400,40802,8870,31932,8603.9,7628.2,35834.8,81604,532.2
BUGWERI,2018,87500,94700,182200,41906,9110,32796,8836.7,7834.6,36804.4,83812,546.6
BUGWERI,2019,89900,97000,186900,42987,9345,33642,9064.65,8036.7,37753.8,85974,560.7
BUGWERI,2020,92300,99300,191600,44068,9580,34488,9292.6,8238.8,38703.2,88136,574.8
BUGWERI,2021,94700,101600,196300,45149,9815,35334,9520.55,8440.9,39652.6,90298,588.9
BUGWERI,2022,97100,103900,201000,46230,10050,36180,9748.5,8643,40602,92460,603
BUGWERI,2023,99400,106200,205600,47288,10280,37008,9971.6,8840.8,41531.2,94576,616.8
BUGWERI,2024,101800,108500,210300,48369,10515,37854,10199.55,9042.9,42480.6,96738,630.9
BUGWERI,2025,104100,110800,214900,49427,10745,38682,10422.65,9240.7,43409.8,98854,644.7
BUHWEJU,2015,60600,63100,123700,28451,6185,22266,5999.45,5319.1,24987.4,56902,371.1
BUHWEJU,2016,62600,65000,127600,29348,6380,22968,6188.6,5486.8,25775.2,58696,382.8
BUHWEJU,2017,64600,67000,131600,30268,6580,23688,6382.6,5658.8,26583.2,60536,394.8
BUHWEJU,2018,66700,69000,135700,31211,6785,24426,6581.45,5835.1,27411.4,62422,407.1
BUHWEJU,2019,68800,71100,139900,32177,6995,25182,6785.15,6015.7,28259.8,64354,419.7
BUHWEJU,2020,71000,73100,144100,33143,7205,25938,6988.85,6196.3,29108.2,66286,432.3
BUHWEJU,2021,73100,75200,148300,34109,7415,26694,7192.55,6376.9,29956.6,68218,444.9
BUHWEJU,2022,75300,77300,152600,35098,7630,27468,7401.1,6561.8,30825.2,70196,457.8
BUHWEJU,2023,77500,79400,156900,36087,7845,28242,7609.65,6746.7,31693.8,72174,470.7
BUHWEJU,2024,79600,81500,161100,37053,8055,28998,7813.35,6927.3,32542.2,74106,483.3
BUHWEJU,2025,81800,83600,165400,38042,8270,29772,8021.9,7112.2,33410.8,76084,496.2
BUIKWE,2015,210700,218600,429300,98739,21465,77274,20821.05,18459.9,86718.6,197478,1287.9
BUIKWE,2016,215200,223100,438300,100809,21915,78894,21257.55,18846.9,88536.6,201618,1314.9
BUIKWE,2017,219800,227500,447300,102879,22365,80514,21694.05,19233.9,90354.6,205758,1341.9
BUIKWE,2018,224300,232000,456300,104949,22815,82134,22130.55,19620.9,92172.6,209898,1368.9
BUIKWE,2019,228800,236400,465200,106996,23260,83736,22562.2,20003.6,93970.4,213992,1395.6
BUIKWE,2020,233300,240800,474100,109043,23705,85338,22993.85,20386.3,95768.2,218086,1422.3
BUIKWE,2021,237700,245200,482900,111067,24145,86922,23420.65,20764.7,97545.8,222134,1448.7
BUIKWE,2022,242000,249400,491400,113022,24570,88452,23832.9,21130.2,99262.8,226044,1474.2
BUIKWE,2023,246200,253600,499800,114954,24990,89964,24240.3,21491.4,100959.6,229908,1499.4
BUIKWE,2024,250300,257700,508000,116840,25400,91440,24638,21844,102616,233680,1524
BUIKWE,2025,254300,261600,515900,118657,25795,92862,25021.15,22183.7,104211.8,237314,1547.7
BUKEDEA,2015,102300,108300,210600,48438,10530,37908,10214.1,9055.8,42541.2,96876,631.8
BUKEDEA,2016,107000,112700,219700,50531,10985,39546,10655.45,9447.1,44379.4,101062,659.1
BUKEDEA,2017,111800,117300,229100,52693,11455,41238,11111.35,9851.3,46278.2,105386,687.3
BUKEDEA,2018,116800,122100,238900,54947,11945,43002,11586.65,10272.7,48257.8,109894,716.7
BUKEDEA,2019,122000,127000,249000,57270,12450,44820,12076.5,10707,50298,114540,747
BUKEDEA,2020,127300,132000,259300,59639,12965,46674,12576.05,11149.9,52378.6,119278,777.9
BUKEDEA,2021,132800,137100,269900,62077,13495,48582,13090.15,11605.7,54519.8,124154,809.7
BUKEDEA,2022,138400,142300,280700,64561,14035,50526,13613.95,12070.1,56701.4,129122,842.1
BUKEDEA,2023,144200,147600,291800,67114,14590,52524,14152.3,12547.4,58943.6,134228,875.4
BUKEDEA,2024,150000,153100,303100,69713,15155,54558,14700.35,13033.3,61226.2,139426,909.3
BUKEDEA,2025,156000,158600,314600,72358,15730,56628,15258.1,13527.8,63549.2,144716,943.8
BUKOMANSIMBI,2015,75600,76400,152000,34960,7600,27360,7372,6536,30704,69920,456
BUKOMANSIMBI,2016,76200,76800,153000,35190,7650,27540,7420.5,6579,30906,70380,459
BUKOMANSIMBI,2017,76900,77100,154000,35420,7700,27720,7469,6622,31108,70840,462
BUKOMANSIMBI,2018,77500,77400,154900,35627,7745,27882,7512.65,6660.7,31289.8,71254,464.7
BUKOMANSIMBI,2019,78100,77700,155800,35834,7790,28044,7556.3,6699.4,31471.6,71668,467.4
BUKOMANSIMBI,2020,78700,77900,156600,36018,7830,28188,7595.1,6733.8,31633.2,72036,469.8
BUKOMANSIMBI,2021,79200,78100,157300,36179,7865,28314,7629.05,6763.9,31774.6,72358,471.9
BUKOMANSIMBI,2022,79700,78200,157900,36317,7895,28422,7658.15,6789.7,31895.8,72634,473.7
BUKOMANSIMBI,2023,80100,78300,158400,36432,7920,28512,7682.4,6811.2,31996.8,72864,475.2
BUKOMANSIMBI,2024,80400,78300,158700,36501,7935,28566,7696.95,6824.1,32057.4,73002,476.1
BUKOMANSIMBI,2025,80700,78300,159000,36570,7950,28620,7711.5,6837,32118,73140,477
BUKWO,2015,47000,46000,93000,21390,4650,16740,4510.5,3999,18786,42780,279
BUKWO,2016,49500,48300,97800,22494,4890,17604,4743.3,4205.4,19755.6,44988,293.4
BUKWO,2017,52200,50600,102800,23644,5140,18504,4985.8,4420.4,20765.6,47288,308.4
BUKWO,2018,55000,53100,108100,24863,5405,19458,5242.85,4648.3,21836.2,49726,324.3
BUKWO,2019,57800,55700,113500,26105,5675,20430,5504.75,4880.5,22927,52210,340.5
BUKWO,2020,60800,58300,119100,27393,5955,21438,5776.35,5121.3,24058.2,54786,357.3
BUKWO,2021,63900,61000,124900,28727,6245,22482,6057.65,5370.7,25229.8,57454,374.7
BUKWO,2022,67200,63800,131000,30130,6550,23580,6353.5,5633,26462,60260,393
BUKWO,2023,70500,66700,137200,31556,6860,24696,6654.2,5899.6,27714.4,63112,411.6
BUKWO,2024,73900,69700,143600,33028,7180,25848,6964.6,6174.8,29007.2,66056,430.8
BUKWO,2025,77500,72800,150300,34569,7515,27054,7289.55,6462.9,30360.6,69138,450.9
BULAMBULI,2015,89600,91800,181400,41722,9070,32652,8797.9,7800.2,36642.8,83444,544.2
BULAMBULI,2016,94200,96400,190600,43838,9530,34308,9244.1,8195.8,38501.2,87676,571.8
BULAMBULI,2017,98900,101100,200000,46000,10000,36000,9700,8600,40400,92000,600
BULAMBULI,2018,103900,106000,209900,48277,10495,37782,10180.15,9025.7,42399.8,96554,629.7
BULAMBULI,2019,109000,111100,220100,50623,11005,39618,10674.85,9464.3,44460.2,101246,660.3
BULAMBULI,2020,114300,116300,230600,53038,11530,41508,11184.1,9915.8,46581.2,106076,691.8
BULAMBULI,2021,119800,121800,241600,55568,12080,43488,11717.6,10388.8,48803.2,111136,724.8
BULAMBULI,2022,125500,127400,252900,58167,12645,45522,12265.65,10874.7,51085.8,116334,758.7
BULAMBULI,2023,131300,133200,264500,60835,13225,47610,12828.25,11373.5,53429,121670,793.5
BULAMBULI,2024,137300,139200,276500,63595,13825,49770,13410.25,11889.5,55853,127190,829.5
BULAMBULI,2025,143500,145300,288800,66424,14440,51984,14006.8,12418.4,58337.6,132848,866.4
BULIISA,2015,60300,57300,117600,27048,5880,21168,5703.6,5056.8,23755.2,54096,352.8
BULIISA,2016,63600,59900,123500,28405,6175,22230,5989.75,5310.5,24947,56810,370.5
BULIISA,2017,67100,62500,129600,29808,6480,23328,6285.6,5572.8,26179.2,59616,388.8
BULIISA,2018,70700,65300,136000,31280,6800,24480,6596,5848,27472,62560,408
BULIISA,2019,74400,68100,142500,32775,7125,25650,6911.25,6127.5,28785,65550,427.5
BULIISA,2020,78300,71000,149300,34339,7465,26874,7241.05,6419.9,30158.6,68678,447.9
BULIISA,2021,82400,74000,156400,35972,7820,28152,7585.4,6725.2,31592.8,71944,469.2
BULIISA,2022,86600,77100,163700,37651,8185,29466,7939.45,7039.1,33067.4,75302,491.1
BULIISA,2023,91000,80300,171300,39399,8565,30834,8308.05,7365.9,34602.6,78798,513.9
BULIISA,2024,95500,83500,179000,41170,8950,32220,8681.5,7697,36158,82340,537
BULIISA,2025,100100,86800,186900,42987,9345,33642,9064.65,8036.7,37753.8,85974,560.7
BUNDIBUGYO,2015,111100,118300,229400,52762,11470,41292,11125.9,9864.2,46338.8,105524,688.2
BUNDIBUGYO,2016,114500,121600,236100,54303,11805,42498,11450.85,10152.3,47692.2,108606,708.3
BUNDIBUGYO,2017,118100,124900,243000,55890,12150,43740,11785.5,10449,49086,111780,729
BUNDIBUGYO,2018,121700,128200,249900,57477,12495,44982,12120.15,10745.7,50479.8,114954,749.7
BUNDIBUGYO,2019,125300,131500,256800,59064,12840,46224,12454.8,11042.4,51873.6,118128,770.4
BUNDIBUGYO,2020,128900,134900,263800,60674,13190,47484,12794.3,11343.4,53287.6,121348,791.4
BUNDIBUGYO,2021,132600,138200,270800,62284,13540,48744,13133.8,11644.4,54701.6,124568,812.4
BUNDIBUGYO,2022,136300,141600,277900,63917,13895,50022,13478.15,11949.7,56135.8,127834,833.7
BUNDIBUGYO,2023,140000,145000,285000,65550,14250,51300,13822.5,12255,57570,131100,855
BUNDIBUGYO,2024,143700,148300,292000,67160,14600,52560,14162,12556,58984,134320,876
BUNDIBUGYO,2025,147300,151600,298900,68747,14945,53802,14496.65,12852.7,60377.8,137494,896.7
BUNYANGABU,2015,85800,87700,173500,39905,8675,31230,8414.75,7460.5,35047,79810,520.5
BUNYANGABU,2016,88100,89600,177700,40871,8885,31986,8618.45,7641.1,35895.4,81742,533.1
BUNYANGABU,2017,90400,91600,182000,41860,9100,32760,8827,7826,36764,83720,546
BUNYANGABU,2018,92800,93600,186400,42872,9320,33552,9040.4,8015.2,37652.8,85744,559.2
BUNYANGABU,2019,95100,95600,190700,43861,9535,34326,9248.95,8200.1,38521.4,87722,572.1
BUNYANGABU,2020,97500,97600,195100,44873,9755,35118,9462.35,8389.3,39410.2,89746,585.3
BUNYANGABU,2021,99900,99600,199500,45885,9975,35910,9675.75,8578.5,40299,91770,598.5
BUNYANGABU,2022,102200,101600,203800,46874,10190,36684,9884.3,8763.4,41167.6,93748,611.4
BUNYANGABU,2023,104500,103500,208000,47840,10400,37440,10088,8944,42016,95680,624
BUNYANGABU,2024,106800,105400,212200,48806,10610,38196,10291.7,9124.6,42864.4,97612,636.6
BUNYANGABU,2025,109100,107200,216300,49749,10815,38934,10490.55,9300.9,43692.6,99498,648.9
BUSHENYI,2015,115200,120900,236100,54303,11805,42498,11450.85,10152.3,47692.2,108606,708.3
BUSHENYI,2016,116700,122000,238700,54901,11935,42966,11576.95,10264.1,48217.4,109802,716.1
BUSHENYI,2017,118100,123100,241200,55476,12060,43416,11698.2,10371.6,48722.4,110952,723.6
BUSHENYI,2018,119500,124200,243700,56051,12185,43866,11819.45,10479.1,49227.4,112102,731.1
BUSHENYI,2019,120900,125200,246100,56603,12305,44298,11935.85,10582.3,49712.2,113206,738.3
BUSHENYI,2020,122200,126100,248300,57109,12415,44694,12042.55,10676.9,50156.6,114218,744.9
BUSHENYI,2021,123400,127000,250400,57592,12520,45072,12144.4,10767.2,50580.8,115184,751.2
BUSHENYI,2022,124600,127800,252400,58052,12620,45432,12241.4,10853.2,50984.8,116104,757.2
BUSHENYI,2023,125700,128500,254200,58466,12710,45756,12328.7,10930.6,51348.4,116932,762.6
BUSHENYI,2024,126600,129200,255800,58834,12790,46044,12406.3,10999.4,51671.6,117668,767.4
BUSHENYI,2025,127500,129700,257200,59156,12860,46296,12474.2,11059.6,51954.4,118312,771.6
BUSIA,2015,160500,170900,331400,76222,16570,59652,16072.9,14250.2,66942.8,152444,994.2
BUSIA,2016,165700,175800,341500,78545,17075,61470,16562.75,14684.5,68983,157090,1024.5
BUSIA,2017,171100,180800,351900,80937,17595,63342,17067.15,15131.7,71083.8,161874,1055.7
BUSIA,2018,176600,185900,362500,83375,18125,65250,17581.25,15587.5,73225,166750,1087.5
BUSIA,2019,182100,191100,373200,85836,18660,67176,18100.2,16047.6,75386.4,171672,1119.6
BUSIA,2020,187700,196300,384000,88320,19200,69120,18624,16512,77568,176640,1152
BUSIA,2021,193400,201500,394900,90827,19745,71082,19152.65,16980.7,79769.8,181654,1184.7
BUSIA,2022,199100,206700,405800,93334,20290,73044,19681.3,17449.4,81971.6,186668,1217.4
BUSIA,2023,204800,211900,416700,95841,20835,75006,20209.95,17918.1,84173.4,191682,1250.1
BUSIA,2024,210500,217100,427600,98348,21380,76968,20738.6,18386.8,86375.2,196696,1282.8
BUSIA,2025,216200,222300,438500,100855,21925,78930,21267.25,18855.5,88577,201710,1315.5
BUTALEJA,2015,123200,128100,251300,57799,12565,45234,12188.05,10805.9,50762.6,115598,753.9
BUTALEJA,2016,128000,132700,260700,59961,13035,46926,12643.95,11210.1,52661.4,119922,782.1
BUTALEJA,2017,132900,137300,270200,62146,13510,48636,13104.7,11618.6,54580.4,124292,810.6
BUTALEJA,2018,138000,142100,280100,64423,14005,50418,13584.85,12044.3,56580.2,128846,840.3
BUTALEJA,2019,143200,147000,290200,66746,14510,52236,14074.7,12478.6,58620.4,133492,870.6
BUTALEJA,2020,148500,152000,300500,69115,15025,54090,14574.25,12921.5,60701,138230,901.5
BUTALEJA,2021,153900,157000,310900,71507,15545,55962,15078.65,13368.7,62801.8,143014,932.7
BUTALEJA,2022,159400,162100,321500,73945,16075,57870,15592.75,13824.5,64943,147890,964.5
BUTALEJA,2023,164900,167300,332200,76406,16610,59796,16111.7,14284.6,67104.4,152812,996.6
BUTALEJA,2024,170600,172500,343100,78913,17155,61758,16640.35,14753.3,69306.2,157826,1029.3
BUTALEJA,2025,176200,177800,354000,81420,17700,63720,17169,15222,71508,162840,1062
BUTAMBALA,2015,50600,51100,101700,23391,5085,18306,4932.45,4373.1,20543.4,46782,305.1
BUTAMBALA,2016,51400,51600,103000,23690,5150,18540,4995.5,4429,20806,47380,309
BUTAMBALA,2017,52100,52200,104300,23989,5215,18774,5058.55,4484.9,21068.6,47978,312.9
BUTAMBALA,2018,52800,52700,105500,24265,5275,18990,5116.75,4536.5,21311,48530,316.5
BUTAMBALA,2019,53500,53200,106700,24541,5335,19206,5174.95,4588.1,21553.4,49082,320.1
BUTAMBALA,2020,54200,53600,107800,24794,5390,19404,5228.3,4635.4,21775.6,49588,323.4
BUTAMBALA,2021,54900,54100,109000,25070,5450,19620,5286.5,4687,22018,50140,327
BUTAMBALA,2022,55500,54500,110000,25300,5500,19800,5335,4730,22220,50600,330
BUTAMBALA,2023,56100,54800,110900,25507,5545,19962,5378.65,4768.7,22401.8,51014,332.7
BUTAMBALA,2024,56700,55200,111900,25737,5595,20142,5427.15,4811.7,22603.8,51474,335.7
BUTAMBALA,2025,57200,55500,112700,25921,5635,20286,5465.95,4846.1,22765.4,51842,338.1
BUTEBO,2015,54900,58100,113000,25990,5650,20340,5480.5,4859,22826,51980,339
BUTEBO,2016,55800,58900,114700,26381,5735,20646,5562.95,4932.1,23169.4,52762,344.1
BUTEBO,2017,56700,59600,116300,26749,5815,20934,5640.55,5000.9,23492.6,53498,348.9
BUTEBO,2018,57600,60400,118000,27140,5900,21240,5723,5074,23836,54280,354
BUTEBO,2019,58500,61100,119600,27508,5980,21528,5800.6,5142.8,24159.2,55016,358.8
BUTEBO,2020,59400,61800,121200,27876,6060,21816,5878.2,5211.6,24482.4,55752,363.6
BUTEBO,2021,60300,62500,122800,28244,6140,22104,5955.8,5280.4,24805.6,56488,368.4
BUTEBO,2022,61100,63200,124300,28589,6215,22374,6028.55,5344.9,25108.6,57178,372.9
BUTEBO,2023,61900,63800,125700,28911,6285,22626,6096.45,5405.1,25391.4,57822,377.1
BUTEBO,2024,62600,64400,127000,29210,6350,22860,6159.5,5461,25654,58420,381
BUTEBO,2025,63300,64900,128200,29486,6410,23076,6217.7,5512.6,25896.4,58972,384.6
BUVUMA,2015,50800,43700,94500,21735,4725,17010,4583.25,4063.5,19089,43470,283.5
BUVUMA,2016,54000,46700,100700,23161,5035,18126,4883.95,4330.1,20341.4,46322,302.1
BUVUMA,2017,57300,49900,107200,24656,5360,19296,5199.2,4609.6,21654.4,49312,321.6
BUVUMA,2018,60800,53200,114000,26220,5700,20520,5529,4902,23028,52440,342
BUVUMA,2019,64500,56800,121300,27899,6065,21834,5883.05,5215.9,24502.6,55798,363.9
BUVUMA,2020,68400,60500,128900,29647,6445,23202,6251.65,5542.7,26037.8,59294,386.7
BUVUMA,2021,72500,64500,137000,31510,6850,24660,6644.5,5891,27674,63020,411
BUVUMA,2022,76700,68600,145300,33419,7265,26154,7047.05,6247.9,29350.6,66838,435.9
BUVUMA,2023,81200,73000,154200,35466,7710,27756,7478.7,6630.6,31148.4,70932,462.6
BUVUMA,2024,85800,77700,163500,37605,8175,29430,7929.75,7030.5,33027,75210,490.5
BUVUMA,2025,90600,82500,173100,39813,8655,31158,8395.35,7443.3,34966.2,79626,519.3
BUYENDE,2015,164500,170000,334500,76935,16725,60210,16223.25,14383.5,67569,153870,1003.5
BUYENDE,2016,172100,177400,349500,80385,17475,62910,16950.75,15028.5,70599,160770,1048.5
BUYENDE,2017,179900,185000,364900,83927,18245,65682,17697.65,15690.7,73709.8,167854,1094.7
BUYENDE,2018,188100,192900,381000,87630,19050,68580,18478.5,16383,76962,175260,1143
BUYENDE,2019,196500,201000,397500,91425,19875,71550,19278.75,17092.5,80295,182850,1192.5
BUYENDE,2020,205200,209400,414600,95358,20730,74628,20108.1,17827.8,83749.2,190716,1243.8
BUYENDE,2021,214100,218000,432100,99383,21605,77778,20956.85,18580.3,87284.2,198766,1296.3
BUYENDE,2022,223300,226800,450100,103523,22505,81018,21829.85,19354.3,90920.2,207046,1350.3
BUYENDE,2023,232600,235800,468400,107732,23420,84312,22717.4,20141.2,94616.8,215464,1405.2
BUYENDE,2024,242200,244900,487100,112033,24355,87678,23624.35,20945.3,98394.2,224066,1461.3
BUYENDE,2025,252000,254300,506300,116449,25315,91134,24555.55,21770.9,102272.6,232898,1518.9
DOKOLO,2015,91600,95600,187200,43056,9360,33696,9079.2,8049.6,37814.4,86112,561.6
DOKOLO,2016,94500,98300,192800,44344,9640,34704,9350.8,8290.4,38945.6,88688,578.4
DOKOLO,2017,97400,101000,198400,45632,9920,35712,9622.4,8531.2,40076.8,91264,595.2
DOKOLO,2018,100300,103700,204000,46920,10200,36720,9894,8772,41208,93840,612
DOKOLO,2019,103300,106500,209800,48254,10490,37764,10175.3,9021.4,42379.6,96508,629.4
DOKOLO,2020,106200,109300,215500,49565,10775,38790,10451.75,9266.5,43531,99130,646.5
DOKOLO,2021,109300,112100,221400,50922,11070,39852,10737.9,9520.2,44722.8,101844,664.2
DOKOLO,2022,112300,114800,227100,52233,11355,40878,11014.35,9765.3,45874.2,104466,681.3
DOKOLO,2023,115300,117600,232900,53567,11645,41922,11295.65,10014.7,47045.8,107134,698.7
DOKOLO,2024,118300,120400,238700,54901,11935,42966,11576.95,10264.1,48217.4,109802,716.1
DOKOLO,2025,121300,123100,244400,56212,12220,43992,11853.4,10509.2,49368.8,112424,733.2
GOMBA,2015,83300,78400,161700,37191,8085,29106,7842.45,6953.1,32663.4,74382,485.1
GOMBA,2016,84800,79300,164100,37743,8205,29538,7958.85,7056.3,33148.2,75486,492.3
GOMBA,2017,86400,80200,166600,38318,8330,29988,8080.1,7163.8,33653.2,76636,499.8
GOMBA,2018,87900,81200,169100,38893,8455,30438,8201.35,7271.3,34158.2,77786,507.3
GOMBA,2019,89400,82000,171400,39422,8570,30852,8312.9,7370.2,34622.8,78844,514.2
GOMBA,2020,90900,82900,173800,39974,8690,31284,8429.3,7473.4,35107.6,79948,521.4
GOMBA,2021,92400,83700,176100,40503,8805,31698,8540.85,7572.3,35572.2,81006,528.3
GOMBA,2022,93800,84400,178200,40986,8910,32076,8642.7,7662.6,35996.4,81972,534.6
GOMBA,2023,95100,85200,180300,41469,9015,32454,8744.55,7752.9,36420.6,82938,540.9
GOMBA,2024,96400,85800,182200,41906,9110,32796,8836.7,7834.6,36804.4,83812,546.6
GOMBA,2025,97700,86400,184100,42343,9205,33138,8928.85,7916.3,37188.2,84686,552.3
GULU,2015,137800,144200,282000,64860,14100,50760,13677,12126,56964,129720,846
GULU,2016,142000,148500,290500,66815,14525,52290,14089.25,12491.5,58681,133630,871.5
GULU,2017,146300,152800,299100,68793,14955,53838,14506.35,12861.3,60418.2,137586,897.3
GULU,2018,150600,157200,307800,70794,15390,55404,14928.3,13235.4,62175.6,141588,923.4
GULU,2019,155000,161600,316600,72818,15830,56988,15355.1,13613.8,63953.2,145636,949.8
GULU,2020,159500,166100,325600,74888,16280,58608,15791.6,14000.8,65771.2,149776,976.8
GULU,2021,163900,170600,334500,76935,16725,60210,16223.25,14383.5,67569,153870,1003.5
GULU,2022,168400,175100,343500,79005,17175,61830,16659.75,14770.5,69387,158010,1030.5
GULU,2023,172800,179700,352500,81075,17625,63450,17096.25,15157.5,71205,162150,1057.5
GULU,2024,177300,184200,361500,83145,18075,65070,17532.75,15544.5,73023,166290,1084.5
GULU,2025,181700,188600,370300,85169,18515,66654,17959.55,15922.9,74800.6,170338,1110.9
HOIMA,2015,156100,158200,314300,72289,15715,56574,15243.55,13514.9,63488.6,144578,942.9
HOIMA,2016,162000,163700,325700,74911,16285,58626,15796.45,14005.1,65791.4,149822,977.1
HOIMA,2017,168100,169400,337500,77625,16875,60750,16368.75,14512.5,68175,155250,1012.5
HOIMA,2018,174400,175200,349600,80408,17480,62928,16955.6,15032.8,70619.2,160816,1048.8
HOIMA,2019,180700,181100,361800,83214,18090,65124,17547.3,15557.4,73083.6,166428,1085.4
HOIMA,2020,187300,187200,374500,86135,18725,67410,18163.25,16103.5,75649,172270,1123.5
HOIMA,2021,193900,193300,387200,89056,19360,69696,18779.2,16649.6,78214.4,178112,1161.6
HOIMA,2022,200600,199400,400000,92000,20000,72000,19400,17200,80800,184000,1200
HOIMA,2023,207400,205700,413100,95013,20655,74358,20035.35,17763.3,83446.2,190026,1239.3
HOIMA,2024,214300,212000,426300,98049,21315,76734,20675.55,18330.9,86112.6,196098,1278.9
HOIMA,2025,221200,218300,439500,101085,21975,79110,21315.75,18898.5,88779,202170,1318.5
IBANDA,2015,123300,129900,253200,58236,12660,45576,12280.2,10887.6,51146.4,116472,759.6
IBANDA,2016,125800,132200,258000,59340,12900,46440,12513,11094,52116,118680,774
IBANDA,2017,128200,134600,262800,60444,13140,47304,12745.8,11300.4,53085.6,120888,788.4
IBANDA,2018,130700,137000,267700,61571,13385,48186,12983.45,11511.1,54075.4,123142,803.1
IBANDA,2019,133200,139400,272600,62698,13630,49068,13221.1,11721.8,55065.2,125396,817.8
IBANDA,2020,135600,141700,277300,63779,13865,49914,13449.05,11923.9,56014.6,127558,831.9
IBANDA,2021,138000,143900,281900,64837,14095,50742,13672.15,12121.7,56943.8,129674,845.7
IBANDA,2022,140300,146100,286400,65872,14320,51552,13890.4,12315.2,57852.8,131744,859.2
IBANDA,2023,142600,148300,290900,66907,14545,52362,14108.65,12508.7,58761.8,133814,872.7
IBANDA,2024,144700,150400,295100,67873,14755,53118,14312.35,12689.3,59610.2,135746,885.3
IBANDA,2025,146800,152400,299200,68816,14960,53856,14511.2,12865.6,60438.4,137632,897.6
IGANGA,2015,166600,180800,347400,79902,17370,62532,16848.9,14938.2,70174.8,159804,1042.2
IGANGA,2016,172100,186000,358100,82363,17905,64458,17367.85,15398.3,72336.2,164726,1074.3
IGANGA,2017,177600,191300,368900,84847,18445,66402,17891.65,15862.7,74517.8,169694,1106.7
IGANGA,2018,183300,196700,380000,87400,19000,68400,18430,16340,76760,174800,1140
IGANGA,2019,189100,202200,391300,89999,19565,70434,18978.05,16825.9,79042.6,179998,1173.9
IGANGA,2020,194900,207700,402600,92598,20130,72468,19526.1,17311.8,81325.2,185196,1207.8
IGANGA,2021,200800,213200,414000,95220,20700,74520,20079,17802,83628,190440,1242
IGANGA,2022,206700,218700,425400,97842,21270,76572,20631.9,18292.2,85930.8,195684,1276.2
IGANGA,2023,212600,224200,436800,100464,21840,78624,21184.8,18782.4,88233.6,200928,1310.4
IGANGA,2024,218500,229800,448300,103109,22415,80694,21742.55,19276.9,90556.6,206218,1344.9
IGANGA,2025,224400,235200,459600,105708,22980,82728,22290.6,19762.8,92839.2,211416,1378.8
ISINGIRO,2015,242700,257600,500300,115069,25015,90054,24264.55,21512.9,101060.6,230138,1500.9
ISINGIRO,2016,251800,266800,518600,119278,25930,93348,25152.1,22299.8,104757.2,238556,1555.8
ISINGIRO,2017,261200,276200,537400,123602,26870,96732,26063.9,23108.2,108554.8,247204,1612.2
ISINGIRO,2018,270900,285800,556700,128041,27835,100206,26999.95,23938.1,112453.4,256082,1670.1
ISINGIRO,2019,280700,295600,576300,132549,28815,103734,27950.55,24780.9,116412.6,265098,1728.9
ISINGIRO,2020,290800,305600,596400,137172,29820,107352,28925.4,25645.2,120472.8,274344,1789.2
ISINGIRO,2021,301000,315700,616700,141841,30835,111006,29909.95,26518.1,124573.4,283682,1850.1
ISINGIRO,2022,311300,326000,637300,146579,31865,114714,30909.05,27403.9,128734.6,293158,1911.9
ISINGIRO,2023,321800,336300,658100,151363,32905,118458,31917.85,28298.3,132936.2,302726,1974.3
ISINGIRO,2024,332400,346800,679200,156216,33960,122256,32941.2,29205.6,137198.4,312432,2037.6
ISINGIRO,2025,343000,357400,700400,161092,35020,126072,33969.4,30117.2,141480.8,322184,2101.2
JINJA,2015,233100,243700,476800,109664,23840,85824,23124.8,20502.4,96313.6,219328,1430.4
JINJA,2016,237100,247500,484600,111458,24230,87228,23503.1,20837.8,97889.2,222916,1453.8
JINJA,2017,241100,251300,492400,113252,24620,88632,23881.4,21173.2,99464.8,226504,1477.2
JINJA,2018,245000,255100,500100,115023,25005,90018,24254.85,21504.3,101020.2,230046,1500.3
JINJA,2019,248900,258800,507700,116771,25385,91386,24623.45,21831.1,102555.4,233542,1523.1
JINJA,2020,252700,262400,515100,118473,25755,92718,24982.35,22149.3,104050.2,236946,1545.3
JINJA,2021,256400,265900,522300,120129,26115,94014,25331.55,22458.9,105504.6,240258,1566.9
JINJA,2022,259900,269300,529200,121716,26460,95256,25666.2,22755.6,106898.4,243432,1587.6
JINJA,2023,263300,272500,535800,123234,26790,96444,25986.3,23039.4,108231.6,246468,1607.4
JINJA,2024,266600,275600,542200,124706,27110,97596,26296.7,23314.6,109524.4,249412,1626.6
JINJA,2025,269600,278500,548100,126063,27405,98658,26582.85,23568.3,110716.2,252126,1644.3
KAABONG,2015,51660,59410,111070,25546.1,5553.5,19992.6,5386.895,4776.01,22436.14,51092.2,333.21
KAABONG,2016,53060,61020,114080,26238.4,5704,20534.4,5532.88,4905.44,23044.16,52476.8,342.24
KAABONG,2017,54660,62520,117180,26951.4,5859,21092.4,5683.23,5038.74,23670.36,53902.8,351.54
KAABONG,2018,55870,63920,119790,27551.7,5989.5,21562.2,5809.815,5150.97,24197.58,55103.4,359.37
KAABONG,2019,57470,65320,122790,28241.7,6139.5,22102.2,5955.315,5279.97,24803.58,56483.4,368.37
KAABONG,2020,58780,66930,125710,28913.3,6285.5,22627.8,6096.935,5405.53,25393.42,57826.6,377.13
KAABONG,2021,60480,68430,128910,29649.3,6445.5,23203.8,6252.135,5543.13,26039.82,59298.6,386.73
KAABONG,2022,61890,70030,131920,30341.6,6596,23745.6,6398.12,5672.56,26647.84,60683.2,395.76
KAABONG,2023,63390,71340,134730,30987.9,6736.5,24251.4,6534.405,5793.39,27215.46,61975.8,404.19
KAABONG,2024,64690,72740,137430,31608.9,6871.5,24737.4,6665.355,5909.49,27760.86,63217.8,412.29
KAABONG,2025,66200,74240,140440,32301.2,7022,25279.2,6811.34,6038.92,28368.88,64602.4,421.32
KABALE,2015,111300,121500,232800,53544,11640,41904,11290.8,10010.4,47025.6,107088,698.4
KABALE,2016,113100,123000,236100,54303,11805,42498,11450.85,10152.3,47692.2,108606,708.3
KABALE,2017,114900,124500,239400,55062,11970,43092,11610.9,10294.2,48358.8,110124,718.2
KABALE,2018,116600,125900,242500,55775,12125,43650,11761.25,10427.5,48985,111550,727.5
KABALE,2019,118300,127300,245600,56488,12280,44208,11911.6,10560.8,49611.2,112976,736.8
KABALE,2020,120000,128700,248700,57201,12435,44766,12061.95,10694.1,50237.4,114402,746.1
KABALE,2021,121600,130000,251600,57868,12580,45288,12202.6,10818.8,50823.2,115736,754.8
KABALE,2022,123100,131200,254300,58489,12715,45774,12333.55,10934.9,51368.6,116978,762.9
KABALE,2023,124600,132300,256900,59087,12845,46242,12459.65,11046.7,51893.8,118174,770.7
KABALE,2024,126000,133400,259400,59662,12970,46692,12580.9,11154.2,52398.8,119324,778.2
KABALE,2025,127300,134300,261600,60168,13080,47088,12687.6,11248.8,52843.2,120336,784.8
KABAROLE,2015,152200,151800,304000,69920,15200,54720,14744,13072,61408,139840,912
KABAROLE,2016,155600,155100,310700,71461,15535,55926,15068.95,13360.1,62761.4,142922,932.1
KABAROLE,2017,159000,158500,317500,73025,15875,57150,15398.75,13652.5,64135,146050,952.5
KABAROLE,2018,162400,161900,324300,74589,16215,58374,15728.55,13944.9,65508.6,149178,972.9
KABAROLE,2019,165900,165200,331100,76153,16555,59598,16058.35,14237.3,66882.2,152306,993.3
KABAROLE,2020,169200,168600,337800,77694,16890,60804,16383.3,14525.4,68235.6,155388,1013.4
KABAROLE,2021,172600,171900,344500,79235,17225,62010,16708.25,14813.5,69589,158470,1033.5
KABAROLE,2022,175900,175100,351000,80730,17550,63180,17023.5,15093,70902,161460,1053
KABAROLE,2023,179100,178400,357500,82225,17875,64350,17338.75,15372.5,72215,164450,1072.5
KABAROLE,2024,182200,181500,363700,83651,18185,65466,17639.45,15639.1,73467.4,167302,1091.1
KABAROLE,2025,185300,184600,369900,85077,18495,66582,17940.15,15905.7,74719.8,170154,1109.7
KABERAMAIDO,2015,53700,55000,108700,25001,5435,19566,5271.95,4674.1,21957.4,50002,326.1
KABERAMAIDO,2016,56000,57100,113100,26013,5655,20358,5485.35,4863.3,22846.2,52026,339.3
KABERAMAIDO,2017,58300,59400,117700,27071,5885,21186,5708.45,5061.1,23775.4,54142,353.1
KABERAMAIDO,2018,60900,61800,122700,28221,6135,22086,5950.95,5276.1,24785.4,56442,368.1
KABERAMAIDO,2019,63600,64200,127800,29394,6390,23004,6198.3,5495.4,25815.6,58788,383.4
KABERAMAIDO,2020,66200,66500,132700,30521,6635,23886,6435.95,5706.1,26805.4,61042,398.1
KABERAMAIDO,2021,68900,69000,137900,31717,6895,24822,6688.15,5929.7,27855.8,63434,413.7
KABERAMAIDO,2022,71800,71600,143400,32982,7170,25812,6954.9,6166.2,28966.8,65964,430.2
KABERAMAIDO,2023,74600,74100,148700,34201,7435,26766,7211.95,6394.1,30037.4,68402,446.1
KABERAMAIDO,2024,77700,76800,154500,35535,7725,27810,7493.25,6643.5,31209,71070,463.5
KABERAMAIDO,2025,80500,79400,159900,36777,7995,28782,7755.15,6875.7,32299.8,73554,479.7
KAGADI,2015,176900,184200,361100,83053,18055,64998,17513.35,15527.3,72942.2,166106,1083.3
KAGADI,2016,183500,190700,374200,86066,18710,67356,18148.7,16090.6,75588.4,172132,1122.6
KAGADI,2017,190300,197500,387800,89194,19390,69804,18808.3,16675.4,78335.6,178388,1163.4
KAGADI,2018,197300,204400,401700,92391,20085,72306,19482.45,17273.1,81143.4,184782,1205.1
KAGADI,2019,204400,211400,415800,95634,20790,74844,20166.3,17879.4,83991.6,191268,1247.4
KAGADI,2020,211600,218600,430200,98946,21510,77436,20864.7,18498.6,86900.4,197892,1290.6
KAGADI,2021,219000,225900,444900,102327,22245,80082,21577.65,19130.7,89869.8,204654,1334.7
KAGADI,2022,226500,233200,459700,105731,22985,82746,22295.45,19767.1,92859.4,211462,1379.1
KAGADI,2023,234000,240700,474700,109181,23735,85446,23022.95,20412.1,95889.4,218362,1424.1
KAGADI,2024,241600,248200,489800,112654,24490,88164,23755.3,21061.4,98939.6,225308,1469.4
KAGADI,2025,249300,255800,505100,116173,25255,90918,24497.35,21719.3,102030.2,232346,1515.3
KAKUMIRO,2015,157800,155900,313700,72151,15685,56466,15214.45,13489.1,63367.4,144302,941.1
KAKUMIRO,2016,171800,169000,340800,78384,17040,61344,16528.8,14654.4,68841.6,156768,1022.4
KAKUMIRO,2017,187000,183300,370300,85169,18515,66654,17959.55,15922.9,74800.6,170338,1110.9
KAKUMIRO,2018,203500,198600,402100,92483,20105,72378,19501.85,17290.3,81224.2,184966,1206.3
KAKUMIRO,2019,221300,215200,436500,100395,21825,78570,21170.25,18769.5,88173,200790,1309.5
KAKUMIRO,2020,240500,232900,473400,108882,23670,85212,22959.9,20356.2,95626.8,217764,1420.2
KAKUMIRO,2021,261200,252000,513200,118036,25660,92376,24890.2,22067.6,103666.4,236072,1539.6
KAKUMIRO,2022,283500,272500,556000,127880,27800,100080,26966,23908,112312,255760,1668
KAKUMIRO,2023,307400,294500,601900,138437,30095,108342,29192.15,25881.7,121583.8,276874,1805.7
KAKUMIRO,2024,333200,318000,651200,149776,32560,117216,31583.2,28001.6,131542.4,299552,1953.6
KAKUMIRO,2025,360800,343200,704000,161920,35200,126720,34144,30272,142208,323840,2112
KALAKI,2015,56100,57400,113500,26105,5675,20430,5504.75,4880.5,22927,52210,340.5
KALAKI,2016,58600,59700,118300,27209,5915,21294,5737.55,5086.9,23896.6,54418,354.9
KALAKI,2017,61200,62000,123200,28336,6160,22176,5975.2,5297.6,24886.4,56672,369.6
KALAKI,2018,63800,64400,128200,29486,6410,23076,6217.7,5512.6,25896.4,58972,384.6
KALAKI,2019,66400,66900,133300,30659,6665,23994,6465.05,5731.9,26926.6,61318,399.9
KALAKI,2020,69200,69500,138700,31901,6935,24966,6726.95,5964.1,28017.4,63802,416.1
KALAKI,2021,72100,72100,144200,33166,7210,25956,6993.7,6200.6,29128.4,66332,432.6
KALAKI,2022,74900,74700,149600,34408,7480,26928,7255.6,6432.8,30219.2,68816,448.8
KALAKI,2023,77900,77500,155400,35742,7770,27972,7536.9,6682.2,31390.8,71484,466.2
KALAKI,2024,80800,80200,161000,37030,8050,28980,7808.5,6923,32522,74060,483
KALAKI,2025,84000,83000,167000,38410,8350,30060,8099.5,7181,33734,76820,501
KALANGALA,2015,32200,23700,55900,12857,2795,10062,2711.15,2403.7,11291.8,25714,167.7
KALANGALA,2016,33400,24700,58100,13363,2905,10458,2817.85,2498.3,11736.2,26726,174.3
KALANGALA,2017,34600,25700,60300,13869,3015,10854,2924.55,2592.9,12180.6,27738,180.9
KALANGALA,2018,35800,26700,62500,14375,3125,11250,3031.25,2687.5,12625,28750,187.5
KALANGALA,2019,37000,27800,64800,14904,3240,11664,3142.8,2786.4,13089.6,29808,194.4
KALANGALA,2020,38300,28900,67200,15456,3360,12096,3259.2,2889.6,13574.4,30912,201.6
KALANGALA,2021,39500,30000,69500,15985,3475,12510,3370.75,2988.5,14039,31970,208.5
KALANGALA,2022,40800,31200,72000,16560,3600,12960,3492,3096,14544,33120,216
KALANGALA,2023,42100,32400,74500,17135,3725,13410,3613.25,3203.5,15049,34270,223.5
KALANGALA,2024,43400,33600,77000,17710,3850,13860,3734.5,3311,15554,35420,231
KALANGALA,2025,44700,34800,79500,18285,3975,14310,3855.75,3418.5,16059,36570,238.5
KALIRO,2015,119400,123500,242900,55867,12145,43722,11780.65,10444.7,49065.8,111734,728.7
KALIRO,2016,123800,127800,251600,57868,12580,45288,12202.6,10818.8,50823.2,115736,754.8
KALIRO,2017,128300,132200,260500,59915,13025,46890,12634.25,11201.5,52621,119830,781.5
KALIRO,2018,133000,136700,269700,62031,13485,48546,13080.45,11597.1,54479.4,124062,809.1
KALIRO,2019,137700,141300,279000,64170,13950,50220,13531.5,11997,56358,128340,837
KALIRO,2020,142500,146000,288500,66355,14425,51930,13992.25,12405.5,58277,132710,865.5
KALIRO,2021,147400,150800,298200,68586,14910,53676,14462.7,12822.6,60236.4,137172,894.6
KALIRO,2022,152400,155600,308000,70840,15400,55440,14938,13244,62216,141680,924
KALIRO,2023,157400,160500,317900,73117,15895,57222,15418.15,13669.7,64215.8,146234,953.7
KALIRO,2024,162400,165400,327800,75394,16390,59004,15898.3,14095.4,66215.6,150788,983.4
KALIRO,2025,167500,170300,337800,77694,16890,60804,16383.3,14525.4,68235.6,155388,1013.4
KALUNGU,2015,90500,94100,184600,42458,9230,33228,8953.1,7937.8,37289.2,84916,553.8
KALUNGU,2016,91600,95000,186600,42918,9330,33588,9050.1,8023.8,37693.2,85836,559.8
KALUNGU,2017,92700,95900,188600,43378,9430,33948,9147.1,8109.8,38097.2,86756,565.8
KALUNGU,2018,93700,96800,190500,43815,9525,34290,9239.25,8191.5,38481,87630,571.5
KALUNGU,2019,94800,97600,192400,44252,9620,34632,9331.4,8273.2,38864.8,88504,577.2
KALUNGU,2020,95700,98400,194100,44643,9705,34938,9413.85,8346.3,39208.2,89286,582.3
KALUNGU,2021,96700,99100,195800,45034,9790,35244,9496.3,8419.4,39551.6,90068,587.4
KALUNGU,2022,97500,99800,197300,45379,9865,35514,9569.05,8483.9,39854.6,90758,591.9
KALUNGU,2023,98400,100400,198800,45724,9940,35784,9641.8,8548.4,40157.6,91448,596.4
KALUNGU,2024,99100,100900,200000,46000,10000,36000,9700,8600,40400,92000,600
KALUNGU,2025,99800,101400,201200,46276,10060,36216,9758.2,8651.6,40642.4,92552,603.6
KAMPALA,2015,723700,805700,1529400,351762,76470,275292,74175.9,65764.2,308938.8,703524,4588.2
KAMPALA,2016,738200,821500,1559700,358731,77985,280746,75645.45,67067.1,315059.4,717462,4679.1
KAMPALA,2017,752700,837400,1590100,365723,79505,286218,77119.85,68374.3,321200.2,731446,4770.3
KAMPALA,2018,767300,853300,1620600,372738,81030,291708,78599.1,69685.8,327361.2,745476,4861.8
KAMPALA,2019,781700,869100,1650800,379684,82540,297144,80063.8,70984.4,333461.6,759368,4952.4
KAMPALA,2020,795900,884700,1680600,386538,84030,302508,81509.1,72265.8,339481.2,773076,5041.8
KAMPALA,2021,809900,900000,1709900,393277,85495,307782,82930.15,73525.7,345399.8,786554,5129.7
KAMPALA,2022,823500,915100,1738600,399878,86930,312948,84322.1,74759.8,351197.2,799756,5215.8
KAMPALA,2023,836700,929800,1766500,406295,88325,317970,85675.25,75959.5,356833,812590,5299.5
KAMPALA,2024,849500,944100,1793600,412528,89680,322848,86989.6,77124.8,362307.2,825056,5380.8
KAMPALA,2025,861800,957900,1819700,418531,90985,327546,88255.45,78247.1,367579.4,837062,5459.1
KAMULI,2015,241400,254200,495600,113988,24780,89208,24036.6,21310.8,100111.2,227976,1486.8
KAMULI,2016,248000,260000,508000,116840,25400,91440,24638,21844,102616,233680,1524
KAMULI,2017,254700,265800,520500,119715,26025,93690,25244.25,22381.5,105141,239430,1561.5
KAMULI,2018,261500,271700,533200,122636,26660,95976,25860.2,22927.6,107706.4,245272,1599.6
KAMULI,2019,268300,277600,545900,125557,27295,98262,26476.15,23473.7,110271.8,251114,1637.7
KAMULI,2020,275100,283400,558500,128455,27925,100530,27087.25,24015.5,112817,256910,1675.5
KAMULI,2021,281900,289300,571200,131376,28560,102816,27703.2,24561.6,115382.4,262752,1713.6
KAMULI,2022,288700,295000,583700,134251,29185,105066,28309.45,25099.1,117907.4,268502,1751.1
KAMULI,2023,295400,300700,596100,137103,29805,107298,28910.85,25632.3,120412.2,274206,1788.3
KAMULI,2024,302100,306300,608400,139932,30420,109512,29507.4,26161.2,122896.8,279864,1825.2
KAMULI,2025,308600,311700,620300,142669,31015,111654,30084.55,26672.9,125300.6,285338,1860.9
KAMWENGE,2015,136900,142000,278900,64147,13945,50202,13526.65,11992.7,56337.8,128294,836.7
KAMWENGE,2016,142500,147200,289700,66631,14485,52146,14050.45,12457.1,58519.4,133262,869.1
KAMWENGE,2017,148200,152300,300500,69115,15025,54090,14574.25,12921.5,60701,138230,901.5
KAMWENGE,2018,154200,157700,311900,71737,15595,56142,15127.15,13411.7,63003.8,143474,935.7
KAMWENGE,2019,160400,163200,323600,74428,16180,58248,15694.6,13914.8,65367.2,148856,970.8
KAMWENGE,2020,166500,168700,335200,77096,16760,60336,16257.2,14413.6,67710.4,154192,1005.6
KAMWENGE,2021,173100,174300,347400,79902,17370,62532,16848.9,14938.2,70174.8,159804,1042.2
KAMWENGE,2022,179500,180000,359500,82685,17975,64710,17435.75,15458.5,72619,165370,1078.5
KAMWENGE,2023,186000,186000,372000,85560,18600,66960,18042,15996,75144,171120,1116
KAMWENGE,2024,192900,191900,384800,88504,19240,69264,18662.8,16546.4,77729.6,177008,1154.4
KAMWENGE,2025,199700,197700,397400,91402,19870,71532,19273.9,17088.2,80274.8,182804,1192.2
KANUNGU,2015,122800,132600,255400,58742,12770,45972,12386.9,10982.2,51590.8,117484,766.2
KANUNGU,2016,125000,134800,259800,59754,12990,46764,12600.3,11171.4,52479.6,119508,779.4
KANUNGU,2017,127300,137000,264300,60789,13215,47574,12818.55,11364.9,53388.6,121578,792.9
KANUNGU,2018,129500,139200,268700,61801,13435,48366,13031.95,11554.1,54277.4,123602,806.1
KANUNGU,2019,131700,141300,273000,62790,13650,49140,13240.5,11739,55146,125580,819
KANUNGU,2020,133900,143400,277300,63779,13865,49914,13449.05,11923.9,56014.6,127558,831.9
KANUNGU,2021,136000,145400,281400,64722,14070,50652,13647.9,12100.2,56842.8,129444,844.2
KANUNGU,2022,138100,147400,285500,65665,14275,51390,13846.75,12276.5,57671,131330,856.5
KANUNGU,2023,140100,149300,289400,66562,14470,52092,14035.9,12444.2,58458.8,133124,868.2
KANUNGU,2024,142000,151200,293200,67436,14660,52776,14220.2,12607.6,59226.4,134872,879.6
KANUNGU,2025,143800,152900,296700,68241,14835,53406,14389.95,12758.1,59933.4,136482,890.1
KAPCHORWA,2015,52900,54700,107600,24748,5380,19368,5218.6,4626.8,21735.2,49496,322.8
KAPCHORWA,2016,54500,56200,110700,25461,5535,19926,5368.95,4760.1,22361.4,50922,332.1
KAPCHORWA,2017,56200,57800,114000,26220,5700,20520,5529,4902,23028,52440,342
KAPCHORWA,2018,57900,59300,117200,26956,5860,21096,5684.2,5039.6,23674.4,53912,351.6
KAPCHORWA,2019,59600,60900,120500,27715,6025,21690,5844.25,5181.5,24341,55430,361.5
KAPCHORWA,2020,61300,62500,123800,28474,6190,22284,6004.3,5323.4,25007.6,56948,371.4
KAPCHORWA,2021,63100,64100,127200,29256,6360,22896,6169.2,5469.6,25694.4,58512,381.6
KAPCHORWA,2022,64800,65800,130600,30038,6530,23508,6334.1,5615.8,26381.2,60076,391.8
KAPCHORWA,2023,66500,67400,133900,30797,6695,24102,6494.15,5757.7,27047.8,61594,401.7
KAPCHORWA,2024,68300,69000,137300,31579,6865,24714,6659.05,5903.9,27734.6,63158,411.9
KAPCHORWA,2025,70000,70500,140500,32315,7025,25290,6814.25,6041.5,28381,64630,421.5
KAPELEBYONG,2015,44200,45400,89600,20608,4480,16128,4345.6,3852.8,18099.2,41216,268.8
KAPELEBYONG,2016,45700,46700,92400,21252,4620,16632,4481.4,3973.2,18664.8,42504,277.2
KAPELEBYONG,2017,47200,48000,95200,21896,4760,17136,4617.2,4093.6,19230.4,43792,285.6
KAPELEBYONG,2018,48700,49300,98000,22540,4900,17640,4753,4214,19796,45080,294
KAPELEBYONG,2019,50300,50600,100900,23207,5045,18162,4893.65,4338.7,20381.8,46414,302.7
KAPELEBYONG,2020,51900,51900,103800,23874,5190,18684,5034.3,4463.4,20967.6,47748,311.4
KAPELEBYONG,2021,53400,53200,106600,24518,5330,19188,5170.1,4583.8,21533.2,49036,319.8
KAPELEBYONG,2022,55000,54500,109500,25185,5475,19710,5310.75,4708.5,22119,50370,328.5
KAPELEBYONG,2023,56600,55900,112500,25875,5625,20250,5456.25,4837.5,22725,51750,337.5
KAPELEBYONG,2024,58300,57200,115500,26565,5775,20790,5601.75,4966.5,23331,53130,346.5
KAPELEBYONG,2025,59900,58500,118400,27232,5920,21312,5742.4,5091.2,23916.8,54464,355.2
KARENGA,2015,29400,31000,60400,13892,3020,10872,2929.4,2597.2,12200.8,27784,181.2
KARENGA,2016,30200,31600,61800,14214,3090,11124,2997.3,2657.4,12483.6,28428,185.4
KARENGA,2017,30900,32400,63300,14559,3165,11394,3070.05,2721.9,12786.6,29118,189.9
KARENGA,2018,32000,33200,65200,14996,3260,11736,3162.2,2803.6,13170.4,29992,195.6
KARENGA,2019,32700,34100,66800,15364,3340,12024,3239.8,2872.4,13493.6,30728,200.4
KARENGA,2020,33700,34800,68500,15755,3425,12330,3322.25,2945.5,13837,31510,205.5
KARENGA,2021,34300,35600,69900,16077,3495,12582,3390.15,3005.7,14119.8,32154,209.7
KARENGA,2022,35200,36200,71400,16422,3570,12852,3462.9,3070.2,14422.8,32844,214.2
KARENGA,2023,36000,37100,73100,16813,3655,13158,3545.35,3143.3,14766.2,33626,219.3
KARENGA,2024,36900,37900,74800,17204,3740,13464,3627.8,3216.4,15109.6,34408,224.4
KARENGA,2025,37600,38600,76200,17526,3810,13716,3695.7,3276.6,15392.4,35052,228.6
KASESE,2015,345000,362600,707600,162748,35380,127368,34318.6,30426.8,142935.2,325496,2122.8
KASESE,2016,353800,370700,724500,166635,36225,130410,35138.25,31153.5,146349,333270,2173.5
KASESE,2017,362800,378800,741600,170568,37080,133488,35967.6,31888.8,149803.2,341136,2224.8
KASESE,2018,371900,387000,758900,174547,37945,136602,36806.65,32632.7,153297.8,349094,2276.7
KASESE,2019,381000,395100,776100,178503,38805,139698,37640.85,33372.3,156772.2,357006,2328.3
KASESE,2020,390000,403200,793200,182436,39660,142776,38470.2,34107.6,160226.4,364872,2379.6
KASESE,2021,399100,411300,810400,186392,40520,145872,39304.4,34847.2,163700.8,372784,2431.2
KASESE,2022,408000,419200,827200,190256,41360,148896,40119.2,35569.6,167094.4,380512,2481.6
KASESE,2023,416900,427000,843900,194097,42195,151902,40929.15,36287.7,170467.8,388194,2531.7
KASESE,2024,425600,434700,860300,197869,43015,154854,41724.55,36992.9,173780.6,395738,2580.9
KASESE,2025,434100,442100,876200,201526,43810,157716,42495.7,37676.6,176992.4,403052,2628.6
KASSANDA,2015,142100,134700,276800,63664,13840,49824,13424.8,11902.4,55913.6,127328,830.4
KASSANDA,2016,146200,137700,283900,65297,14195,51102,13769.15,12207.7,57347.8,130594,851.7
KASSANDA,2017,150400,140600,291000,66930,14550,52380,14113.5,12513,58782,133860,873
KASSANDA,2018,154600,143600,298200,68586,14910,53676,14462.7,12822.6,60236.4,137172,894.6
KASSANDA,2019,158900,146500,305400,70242,15270,54972,14811.9,13132.2,61690.8,140484,916.2
KASSANDA,2020,163200,149500,312700,71921,15635,56286,15165.95,13446.1,63165.4,143842,938.1
KASSANDA,2021,167500,152400,319900,73577,15995,57582,15515.15,13755.7,64619.8,147154,959.7
KASSANDA,2022,171800,155200,327000,75210,16350,58860,15859.5,14061,66054,150420,981
KASSANDA,2023,176000,158100,334100,76843,16705,60138,16203.85,14366.3,67488.2,153686,1002.3
KASSANDA,2024,180300,160800,341100,78453,17055,61398,16543.35,14667.3,68902.2,156906,1023.3
KASSANDA,2025,184500,163500,348000,80040,17400,62640,16878,14964,70296,160080,1044
KATAKWI,2015,83700,86200,169900,39077,8495,30582,8240.15,7305.7,34319.8,78154,509.7
KATAKWI,2016,86300,88400,174700,40181,8735,31446,8472.95,7512.1,35289.4,80362,524.1
KATAKWI,2017,88900,90600,179500,41285,8975,32310,8705.75,7718.5,36259,82570,538.5
KATAKWI,2018,91600,92900,184500,42435,9225,33210,8948.25,7933.5,37269,84870,553.5
KATAKWI,2019,94300,95200,189500,43585,9475,34110,9190.75,8148.5,38279,87170,568.5
KATAKWI,2020,97100,97500,194600,44758,9730,35028,9438.1,8367.8,39309.2,89516,583.8
KATAKWI,2021,99800,99700,199500,45885,9975,35910,9675.75,8578.5,40299,91770,598.5
KATAKWI,2022,102600,102000,204600,47058,10230,36828,9923.1,8797.8,41329.2,94116,613.8
KATAKWI,2023,105400,104300,209700,48231,10485,37746,10170.45,9017.1,42359.4,96462,629.1
KATAKWI,2024,108100,106500,214600,49358,10730,38628,10408.1,9227.8,43349.2,98716,643.8
KATAKWI,2025,110800,108700,219500,50485,10975,39510,10645.75,9438.5,44339,100970,658.5
KAYUNGA,2015,183600,189600,373200,85836,18660,67176,18100.2,16047.6,75386.4,171672,1119.6
KAYUNGA,2016,187400,192700,380100,87423,19005,68418,18434.85,16344.3,76780.2,174846,1140.3
KAYUNGA,2017,191200,195900,387100,89033,19355,69678,18774.35,16645.3,78194.2,178066,1161.3
KAYUNGA,2018,195000,199000,394000,90620,19700,70920,19109,16942,79588,181240,1182
KAYUNGA,2019,198800,202100,400900,92207,20045,72162,19443.65,17238.7,80981.8,184414,1202.7
KAYUNGA,2020,202600,205100,407700,93771,20385,73386,19773.45,17531.1,82355.4,187542,1223.1
KAYUNGA,2021,206300,208000,414300,95289,20715,74574,20093.55,17814.9,83688.6,190578,1242.9
KAYUNGA,2022,209900,210900,420800,96784,21040,75744,20408.8,18094.4,85001.6,193568,1262.4
KAYUNGA,2023,213400,213700,427100,98233,21355,76878,20714.35,18365.3,86274.2,196466,1281.3
KAYUNGA,2024,216800,216300,433100,99613,21655,77958,21005.35,18623.3,87486.2,199226,1299.3
KAYUNGA,2025,220100,218800,438900,100947,21945,79002,21286.65,18872.7,88657.8,201894,1316.7
KAZO,2015,90800,91500,182300,41929,9115,32814,8841.55,7838.9,36824.6,83858,546.9
KAZO,2016,94200,94700,188900,43447,9445,34002,9161.65,8122.7,38157.8,86894,566.7
KAZO,2017,97900,98100,196000,45080,9800,35280,9506,8428,39592,90160,588
KAZO,2018,101400,101600,203000,46690,10150,36540,9845.5,8729,41006,93380,609
KAZO,2019,105300,105100,210400,48392,10520,37872,10204.4,9047.2,42500.8,96784,631.2
KAZO,2020,108900,108700,217600,50048,10880,39168,10553.6,9356.8,43955.2,100096,652.8
KAZO,2021,112900,112100,225000,51750,11250,40500,10912.5,9675,45450,103500,675
KAZO,2022,116800,115800,232600,53498,11630,41868,11281.1,10001.8,46985.2,106996,697.8
KAZO,2023,120800,119600,240400,55292,12020,43272,11659.4,10337.2,48560.8,110584,721.2
KAZO,2024,125000,123400,248400,57132,12420,44712,12047.4,10681.2,50176.8,114264,745.2
KAZO,2025,129100,127200,256300,58949,12815,46134,12430.55,11020.9,51772.6,117898,768.9
KIBAALE,2015,74500,73400,147900,34017,7395,26622,7173.15,6359.7,29875.8,68034,443.7
KIBAALE,2016,79300,77700,157000,36110,7850,28260,7614.5,6751,31714,72220,471
KIBAALE,2017,84300,82200,166500,38295,8325,29970,8075.25,7159.5,33633,76590,499.5
KIBAALE,2018,89700,86900,176600,40618,8830,31788,8565.1,7593.8,35673.2,81236,529.8
KIBAALE,2019,95300,91900,187200,43056,9360,33696,9079.2,8049.6,37814.4,86112,561.6
KIBAALE,2020,101200,97000,198200,45586,9910,35676,9612.7,8522.6,40036.4,91172,594.6
KIBAALE,2021,107400,102500,209900,48277,10495,37782,10180.15,9025.7,42399.8,96554,629.7
KIBAALE,2022,113900,108100,222000,51060,11100,39960,10767,9546,44844,102120,666
KIBAALE,2023,120800,114000,234800,54004,11740,42264,11387.8,10096.4,47429.6,108008,704.4
KIBAALE,2024,127900,120200,248100,57063,12405,44658,12032.85,10668.3,50116.2,114126,744.3
KIBAALE,2025,135300,126500,261800,60214,13090,47124,12697.3,11257.4,52883.6,120428,785.4
KIBOGA,2015,77500,73700,151200,34776,7560,27216,7333.2,6501.6,30542.4,69552,453.6
KIBOGA,2016,79700,75400,155100,35673,7755,27918,7522.35,6669.3,31330.2,71346,465.3
KIBOGA,2017,81900,77200,159100,36593,7955,28638,7716.35,6841.3,32138.2,73186,477.3
KIBOGA,2018,84100,79000,163100,37513,8155,29358,7910.35,7013.3,32946.2,75026,489.3
KIBOGA,2019,86300,80800,167100,38433,8355,30078,8104.35,7185.3,33754.2,76866,501.3
KIBOGA,2020,88600,82600,171200,39376,8560,30816,8303.2,7361.6,34582.4,78752,513.6
KIBOGA,2021,90800,84400,175200,40296,8760,31536,8497.2,7533.6,35390.4,80592,525.6
KIBOGA,2022,93100,86200,179300,41239,8965,32274,8696.05,7709.9,36218.6,82478,537.9
KIBOGA,2023,95300,88000,183300,42159,9165,32994,8890.05,7881.9,37026.6,84318,549.9
KIBOGA,2024,97500,89700,187200,43056,9360,33696,9079.2,8049.6,37814.4,86112,561.6
KIBOGA,2025,99700,91400,191100,43953,9555,34398,9268.35,8217.3,38602.2,87906,573.3
KIBUKU,2015,100600,107600,208200,47886,10410,37476,10097.7,8952.6,42056.4,95772,624.6
KIBUKU,2016,104600,111600,216200,49726,10810,38916,10485.7,9296.6,43672.4,99452,648.6
KIBUKU,2017,108800,115700,224500,51635,11225,40410,10888.25,9653.5,45349,103270,673.5
KIBUKU,2018,113100,119900,233000,53590,11650,41940,11300.5,10019,47066,107180,699
KIBUKU,2019,117500,124200,241700,55591,12085,43506,11722.45,10393.1,48823.4,111182,725.1
KIBUKU,2020,121900,128700,250600,57638,12530,45108,12154.1,10775.8,50621.2,115276,751.8
KIBUKU,2021,126500,133100,259600,59708,12980,46728,12590.6,11162.8,52439.2,119416,778.8
KIBUKU,2022,131200,137700,268900,61847,13445,48402,13041.65,11562.7,54317.8,123694,806.7
KIBUKU,2023,135900,142300,278200,63986,13910,50076,13492.7,11962.6,56196.4,127972,834.6
KIBUKU,2024,140700,147000,287700,66171,14385,51786,13953.45,12371.1,58115.4,132342,863.1
KIBUKU,2025,145500,151700,297200,68356,14860,53496,14414.2,12779.6,60034.4,136712,891.6
KIKUUBE,2015,142300,136400,278700,64101,13935,50166,13516.95,11984.1,56297.4,128202,836.1
KIKUUBE,2016,150000,143400,293400,67482,14670,52812,14229.9,12616.2,59266.8,134964,880.2
KIKUUBE,2017,158000,150700,308700,71001,15435,55566,14971.95,13274.1,62357.4,142002,926.1
KIKUUBE,2018,166400,158300,324700,74681,16235,58446,15747.95,13962.1,65589.4,149362,974.1
KIKUUBE,2019,175100,166200,341300,78499,17065,61434,16553.05,14675.9,68942.6,156998,1023.9
KIKUUBE,2020,184200,174500,358700,82501,17935,64566,17396.95,15424.1,72457.4,165002,1076.1
KIKUUBE,2021,193600,183000,376600,86618,18830,67788,18265.1,16193.8,76073.2,173236,1129.8
KIKUUBE,2022,203400,191800,395200,90896,19760,71136,19167.2,16993.6,79830.4,181792,1185.6
KIKUUBE,2023,213500,200900,414400,95312,20720,74592,20098.4,17819.2,83708.8,190624,1243.2
KIKUUBE,2024,223900,210400,434300,99889,21715,78174,21063.55,18674.9,87728.6,199778,1302.9
KIKUUBE,2025,234600,220000,454600,104558,22730,81828,22048.1,19547.8,91829.2,209116,1363.8
KIRUHURA,2015,80500,74800,155300,35719,7765,27954,7532.05,6677.9,31370.6,71438,465.9
KIRUHURA,2016,83600,77600,161200,37076,8060,29016,7818.2,6931.6,32562.4,74152,483.6
KIRUHURA,2017,86700,80300,167000,38410,8350,30060,8099.5,7181,33734,76820,501
KIRUHURA,2018,90100,83000,173100,39813,8655,31158,8395.35,7443.3,34966.2,79626,519.3
KIRUHURA,2019,93300,85900,179200,41216,8960,32256,8691.2,7705.6,36198.4,82432,537.6
KIRUHURA,2020,96900,88800,185700,42711,9285,33426,9006.45,7985.1,37511.4,85422,557.1
KIRUHURA,2021,100300,91900,192200,44206,9610,34596,9321.7,8264.6,38824.4,88412,576.6
KIRUHURA,2022,103800,94900,198700,45701,9935,35766,9636.95,8544.1,40137.4,91402,596.1
KIRUHURA,2023,107400,97900,205300,47219,10265,36954,9957.05,8827.9,41470.6,94438,615.9
KIRUHURA,2024,110800,100900,211700,48691,10585,38106,10267.45,9103.1,42763.4,97382,635.1
KIRUHURA,2025,114400,103900,218300,50209,10915,39294,10587.55,9386.9,44096.6,100418,654.9
KIRYANDONGO,2015,136100,136100,272200,62606,13610,48996,13201.7,11704.6,54984.4,125212,816.6
KIRYANDONGO,2016,140400,139900,280300,64469,14015,50454,13594.55,12052.9,56620.6,128938,840.9
KIRYANDONGO,2017,144900,143700,288600,66378,14430,51948,13997.1,12409.8,58297.2,132756,865.8
KIRYANDONGO,2018,149300,147500,296800,68264,14840,53424,14394.8,12762.4,59953.6,136528,890.4
KIRYANDONGO,2019,153900,151400,305300,70219,15265,54954,14807.05,13127.9,61670.6,140438,915.9
KIRYANDONGO,2020,158500,155300,313800,72174,15690,56484,15219.3,13493.4,63387.6,144348,941.4
KIRYANDONGO,2021,163280,159200,322480,74170.4,16124,58046.4,15640.28,13866.64,65140.96,148340.8,967.44
KIRYANDONGO,2022,167700,163100,330800,76084,16540,59544,16043.8,14224.4,66821.6,152168,992.4
KIRYANDONGO,2023,172300,166900,339200,78016,16960,61056,16451.2,14585.6,68518.4,156032,1017.6
KIRYANDONGO,2024,177000,170800,347800,79994,17390,62604,16868.3,14955.4,70255.6,159988,1043.4
KIRYANDONGO,2025,181500,174600,356100,81903,17805,64098,17270.85,15312.3,71932.2,163806,1068.3
KISORO,2015,128100,157900,286000,65780,14300,51480,13871,12298,57772,131560,858
KISORO,2016,130800,161100,291900,67137,14595,52542,14157.15,12551.7,58963.8,134274,875.7
KISORO,2017,133500,164300,297800,68494,14890,53604,14443.3,12805.4,60155.6,136988,893.4
KISORO,2018,136200,167500,303700,69851,15185,54666,14729.45,13059.1,61347.4,139702,911.1
KISORO,2019,138900,170700,309600,71208,15480,55728,15015.6,13312.8,62539.2,142416,928.8
KISORO,2020,141600,173800,315400,72542,15770,56772,15296.9,13562.2,63710.8,145084,946.2
KISORO,2021,144200,176900,321100,73853,16055,57798,15573.35,13807.3,64862.2,147706,963.3
KISORO,2022,146800,179900,326700,75141,16335,58806,15844.95,14048.1,65993.4,150282,980.1
KISORO,2023,149300,182900,332200,76406,16610,59796,16111.7,14284.6,67104.4,152812,996.6
KISORO,2024,151700,185800,337500,77625,16875,60750,16368.75,14512.5,68175,155250,1012.5
KISORO,2025,154100,188600,342700,78821,17135,61686,16620.95,14736.1,69225.4,157642,1028.1
KITAGWENDA,2015,72200,75800,148000,34040,7400,26640,7178,6364,29896,68080,444
KITAGWENDA,2016,75200,78500,153700,35351,7685,27666,7454.45,6609.1,31047.4,70702,461.1
KITAGWENDA,2017,78300,81400,159700,36731,7985,28746,7745.45,6867.1,32259.4,73462,479.1
KITAGWENDA,2018,81500,84300,165800,38134,8290,29844,8041.3,7129.4,33491.6,76268,497.4
KITAGWENDA,2019,84600,87200,171800,39514,8590,30924,8332.3,7387.4,34703.6,79028,515.4
KITAGWENDA,2020,88100,90200,178300,41009,8915,32094,8647.55,7666.9,36016.6,82018,534.9
KITAGWENDA,2021,91300,93300,184600,42458,9230,33228,8953.1,7937.8,37289.2,84916,553.8
KITAGWENDA,2022,94800,96400,191200,43976,9560,34416,9273.2,8221.6,38622.4,87952,573.6
KITAGWENDA,2023,98400,99400,197800,45494,9890,35604,9593.3,8505.4,39955.6,90988,593.4
KITAGWENDA,2024,101800,102500,204300,46989,10215,36774,9908.55,8784.9,41268.6,93978,612.9
KITAGWENDA,2025,105400,105700,211100,48553,10555,37998,10238.35,9077.3,42642.2,97106,633.3
KITGUM,2015,100600,106000,206600,47518,10330,37188,10020.1,8883.8,41733.2,95036,619.8
KITGUM,2016,102300,107700,210000,48300,10500,37800,10185,9030,42420,96600,630
KITGUM,2017,104100,109300,213400,49082,10670,38412,10349.9,9176.2,43106.8,98164,640.2
KITGUM,2018,105900,111000,216900,49887,10845,39042,10519.65,9326.7,43813.8,99774,650.7
KITGUM,2019,107600,112600,220200,50646,11010,39636,10679.7,9468.6,44480.4,101292,660.6
KITGUM,2020,109300,114300,223600,51428,11180,40248,10844.6,9614.8,45167.2,102856,670.8
KITGUM,2021,110900,115800,226700,52141,11335,40806,10994.95,9748.1,45793.4,104282,680.1
KITGUM,2022,112500,117300,229800,52854,11490,41364,11145.3,9881.4,46419.6,105708,689.4
KITGUM,2023,114100,118800,232900,53567,11645,41922,11295.65,10014.7,47045.8,107134,698.7
KITGUM,2024,115500,120200,235700,54211,11785,42426,11431.45,10135.1,47611.4,108422,707.1
KITGUM,2025,116900,121500,238400,54832,11920,42912,11562.4,10251.2,48156.8,109664,715.2
KOBOKO,2015,105600,107400,213000,48990,10650,38340,10330.5,9159,43026,97980,639
KOBOKO,2016,110000,111500,221500,50945,11075,39870,10742.75,9524.5,44743,101890,664.5
KOBOKO,2017,114500,115800,230300,52969,11515,41454,11169.55,9902.9,46520.6,105938,690.9
KOBOKO,2018,119200,120100,239300,55039,11965,43074,11606.05,10289.9,48338.6,110078,717.9
KOBOKO,2019,123900,124600,248500,57155,12425,44730,12052.25,10685.5,50197,114310,745.5
KOBOKO,2020,128800,129200,258000,59340,12900,46440,12513,11094,52116,118680,774
KOBOKO,2021,133800,133900,267700,61571,13385,48186,12983.45,11511.1,54075.4,123142,803.1
KOBOKO,2022,138900,138600,277500,63825,13875,49950,13458.75,11932.5,56055,127650,832.5
KOBOKO,2023,144100,143400,287500,66125,14375,51750,13943.75,12362.5,58075,132250,862.5
KOBOKO,2024,149300,148300,297600,68448,14880,53568,14433.6,12796.8,60115.2,136896,892.8
KOBOKO,2025,154600,153300,307900,70817,15395,55422,14933.15,13239.7,62195.8,141634,923.7
KOLE,2015,120200,124900,245100,56373,12255,44118,11887.35,10539.3,49510.2,112746,735.3
KOLE,2016,124200,128500,252700,58121,12635,45486,12255.95,10866.1,51045.4,116242,758.1
KOLE,2017,128200,132200,260400,59892,13020,46872,12629.4,11197.2,52600.8,119784,781.2
KOLE,2018,132400,135900,268300,61709,13415,48294,13012.55,11536.9,54196.6,123418,804.9
KOLE,2019,136600,139700,276300,63549,13815,49734,13400.55,11880.9,55812.6,127098,828.9
KOLE,2020,140800,143500,284300,65389,14215,51174,13788.55,12224.9,57428.6,130778,852.9
KOLE,2021,145100,147400,292500,67275,14625,52650,14186.25,12577.5,59085,134550,877.5
KOLE,2022,149400,151200,300600,69138,15030,54108,14579.1,12925.8,60721.2,138276,901.8
KOLE,2023,153700,155100,308800,71024,15440,55584,14976.8,13278.4,62377.6,142048,926.4
KOLE,2024,158100,158900,317000,72910,15850,57060,15374.5,13631,64034,145820,951
KOLE,2025,162400,162700,325100,74773,16255,58518,15767.35,13979.3,65670.2,149546,975.3
KOTIDO,2015,87900,96400,184300,42389,9215,33174,8938.55,7924.9,37228.6,84778,552.9
KOTIDO,2016,90200,98500,188700,43401,9435,33966,9151.95,8114.1,38117.4,86802,566.1
KOTIDO,2017,92500,100700,193200,44436,9660,34776,9370.2,8307.6,39026.4,88872,579.6
KOTIDO,2018,94800,102800,197600,45448,9880,35568,9583.6,8496.8,39915.2,90896,592.8
KOTIDO,2019,97100,105000,202100,46483,10105,36378,9801.85,8690.3,40824.2,92966,606.3
KOTIDO,2020,99400,107100,206500,47495,10325,37170,10015.25,8879.5,41713,94990,619.5
KOTIDO,2021,101700,109200,210900,48507,10545,37962,10228.65,9068.7,42601.8,97014,632.7
KOTIDO,2022,104000,111300,215300,49519,10765,38754,10442.05,9257.9,43490.6,99038,645.9
KOTIDO,2023,106300,113400,219700,50531,10985,39546,10655.45,9447.1,44379.4,101062,659.1
KOTIDO,2024,108500,115400,223900,51497,11195,40302,10859.15,9627.7,45227.8,102994,671.7
KOTIDO,2025,110700,117300,228000,52440,11400,41040,11058,9804,46056,104880,684
KUMI,2015,119500,125500,245000,56350,12250,44100,11882.5,10535,49490,112700,735
KUMI,2016,123500,129200,252700,58121,12635,45486,12255.95,10866.1,51045.4,116242,758.1
KUMI,2017,127600,132900,260500,59915,13025,46890,12634.25,11201.5,52621,119830,781.5
KUMI,2018,131800,136700,268500,61755,13425,48330,13022.25,11545.5,54237,123510,805.5
KUMI,2019,136100,140500,276600,63618,13830,49788,13415.1,11893.8,55873.2,127236,829.8
KUMI,2020,140400,144400,284800,65504,14240,51264,13812.8,12246.4,57529.6,131008,854.4
KUMI,2021,144700,148200,292900,67367,14645,52722,14205.65,12594.7,59165.8,134734,878.7
KUMI,2022,149100,152100,301200,69276,15060,54216,14608.2,12951.6,60842.4,138552,903.6
KUMI,2023,153500,156000,309500,71185,15475,55710,15010.75,13308.5,62519,142370,928.5
KUMI,2024,157900,159800,317700,73071,15885,57186,15408.45,13661.1,64175.4,146142,953.1
KUMI,2025,162200,163700,325900,74957,16295,58662,15806.15,14013.7,65831.8,149914,977.7
KWANIA,2015,91800,95700,187500,43125,9375,33750,9093.75,8062.5,37875,86250,562.5
KWANIA,2016,94700,98500,193200,44436,9660,34776,9370.2,8307.6,39026.4,88872,579.6
KWANIA,2017,97600,101300,198900,45747,9945,35802,9646.65,8552.7,40177.8,91494,596.7
KWANIA,2018,100600,104200,204800,47104,10240,36864,9932.8,8806.4,41369.6,94208,614.4
KWANIA,2019,103600,107000,210600,48438,10530,37908,10214.1,9055.8,42541.2,96876,631.8
KWANIA,2020,106700,109900,216600,49818,10830,38988,10505.1,9313.8,43753.2,99636,649.8
KWANIA,2021,109700,112900,222600,51198,11130,40068,10796.1,9571.8,44965.2,102396,667.8
KWANIA,2022,112800,115800,228600,52578,11430,41148,11087.1,9829.8,46177.2,105156,685.8
KWANIA,2023,115900,118700,234600,53958,11730,42228,11378.1,10087.8,47389.2,107916,703.8
KWANIA,2024,118900,121600,240500,55315,12025,43290,11664.25,10341.5,48581,110630,721.5
KWANIA,2025,122000,124500,246500,56695,12325,44370,11955.25,10599.5,49793,113390,739.5
KWEEN,2015,48600,47100,95700,22011,4785,17226,4641.45,4115.1,19331.4,44022,287.1
KWEEN,2016,50100,48300,98400,22632,4920,17712,4772.4,4231.2,19876.8,45264,295.2
KWEEN,2017,51600,49500,101100,23253,5055,18198,4903.35,4347.3,20422.2,46506,303.3
KWEEN,2018,53200,50700,103900,23897,5195,18702,5039.15,4467.7,20987.8,47794,311.7
KWEEN,2019,54800,51900,106700,24541,5335,19206,5174.95,4588.1,21553.4,49082,320.1
KWEEN,2020,56400,53100,109500,25185,5475,19710,5310.75,4708.5,22119,50370,328.5
KWEEN,2021,58000,54300,112300,25829,5615,20214,5446.55,4828.9,22684.6,51658,336.9
KWEEN,2022,59700,55500,115200,26496,5760,20736,5587.2,4953.6,23270.4,52992,345.6
KWEEN,2023,61300,56700,118000,27140,5900,21240,5723,5074,23836,54280,354
KWEEN,2024,62900,57900,120800,27784,6040,21744,5858.8,5194.4,24401.6,55568,362.4
KWEEN,2025,64500,59000,123500,28405,6175,22230,5989.75,5310.5,24947,56810,370.5
KYANKWANZI,2015,116200,107000,223200,51336,11160,40176,10825.2,9597.6,45086.4,102672,669.6
KYANKWANZI,2016,122200,112000,234200,53866,11710,42156,11358.7,10070.6,47308.4,107732,702.6
KYANKWANZI,2017,128400,117200,245600,56488,12280,44208,11911.6,10560.8,49611.2,112976,736.8
KYANKWANZI,2018,135000,122600,257600,59248,12880,46368,12493.6,11076.8,52035.2,118496,772.8
KYANKWANZI,2019,141800,128200,270000,62100,13500,48600,13095,11610,54540,124200,810
KYANKWANZI,2020,148800,134000,282800,65044,14140,50904,13715.8,12160.4,57125.6,130088,848.4
KYANKWANZI,2021,156100,140000,296100,68103,14805,53298,14360.85,12732.3,59812.2,136206,888.3
KYANKWANZI,2022,163600,146100,309700,71231,15485,55746,15020.45,13317.1,62559.4,142462,929.1
KYANKWANZI,2023,171400,152500,323900,74497,16195,58302,15709.15,13927.7,65427.8,148994,971.7
KYANKWANZI,2024,179400,158900,338300,77809,16915,60894,16407.55,14546.9,68336.6,155618,1014.9
KYANKWANZI,2025,187600,165600,353200,81236,17660,63576,17130.2,15187.6,71346.4,162472,1059.6
KYEGEGWA,2015,150100,150000,300100,69023,15005,54018,14554.85,12904.3,60620.2,138046,900.3
KYEGEGWA,2016,162400,161900,324300,74589,16215,58374,15728.55,13944.9,65508.6,149178,972.9
KYEGEGWA,2017,175800,174700,350500,80615,17525,63090,16999.25,15071.5,70801,161230,1051.5
KYEGEGWA,2018,190200,188400,378600,87078,18930,68148,18362.1,16279.8,76477.2,174156,1135.8
KYEGEGWA,2019,205600,203100,408700,94001,20435,73566,19821.95,17574.1,82557.4,188002,1226.1
KYEGEGWA,2020,222100,218900,441000,101430,22050,79380,21388.5,18963,89082,202860,1323
KYEGEGWA,2021,239900,235700,475600,109388,23780,85608,23066.6,20450.8,96071.2,218776,1426.8
KYEGEGWA,2022,258800,253600,512400,117852,25620,92232,24851.4,22033.2,103504.8,235704,1537.2
KYEGEGWA,2023,279100,272800,551900,126937,27595,99342,26767.15,23731.7,111483.8,253874,1655.7
KYEGEGWA,2024,300700,293200,593900,136597,29695,106902,28804.15,25537.7,119967.8,273194,1781.7
KYEGEGWA,2025,323700,314800,638500,146855,31925,114930,30967.25,27455.5,128977,293710,1915.5
KYENJOJO,2015,217500,217700,435200,100096,21760,78336,21107.2,18713.6,87910.4,200192,1305.6
KYENJOJO,2016,226500,225800,452300,104029,22615,81414,21936.55,19448.9,91364.6,208058,1356.9
KYENJOJO,2017,235800,234100,469900,108077,23495,84582,22790.15,20205.7,94919.8,216154,1409.7
KYENJOJO,2018,245400,242600,488000,112240,24400,87840,23668,20984,98576,224480,1464
KYENJOJO,2019,255200,251300,506500,116495,25325,91170,24565.25,21779.5,102313,232990,1519.5
KYENJOJO,2020,265200,260200,525400,120842,26270,94572,25481.9,22592.2,106130.8,241684,1576.2
KYENJOJO,2021,275500,269300,544800,125304,27240,98064,26422.8,23426.4,110049.6,250608,1634.4
KYENJOJO,2022,286000,278500,564500,129835,28225,101610,27378.25,24273.5,114029,259670,1693.5
KYENJOJO,2023,296600,287800,584400,134412,29220,105192,28343.4,25129.2,118048.8,268824,1753.2
KYENJOJO,2024,307400,297200,604600,139058,30230,108828,29323.1,25997.8,122129.2,278116,1813.8
KYENJOJO,2025,318300,306700,625000,143750,31250,112500,30312.5,26875,126250,287500,1875
KYOTERA,2015,119900,122400,242300,55729,12115,43614,11751.55,10418.9,48944.6,111458,726.9
KYOTERA,2016,122000,124100,246100,56603,12305,44298,11935.85,10582.3,49712.2,113206,738.3
KYOTERA,2017,124200,125800,250000,57500,12500,45000,12125,10750,50500,115000,750
KYOTERA,2018,126300,127400,253700,58351,12685,45666,12304.45,10909.1,51247.4,116702,761.1
KYOTERA,2019,128300,129100,257400,59202,12870,46332,12483.9,11068.2,51994.8,118404,772.2
KYOTERA,2020,130400,130600,261000,60030,13050,46980,12658.5,11223,52722,120060,783
KYOTERA,2021,132400,132100,264500,60835,13225,47610,12828.25,11373.5,53429,121670,793.5
KYOTERA,2022,134300,133600,267900,61617,13395,48222,12993.15,11519.7,54115.8,123234,803.7
KYOTERA,2023,136100,135000,271100,62353,13555,48798,13148.35,11657.3,54762.2,124706,813.3
KYOTERA,2024,137900,136300,274200,63066,13710,49356,13298.7,11790.6,55388.4,126132,822.6
KYOTERA,2025,139600,137500,277100,63733,13855,49878,13439.35,11915.3,55974.2,127466,831.3
LAMWO,2015,65600,70000,135600,31188,6780,24408,6576.6,5830.8,27391.2,62376,406.8
LAMWO,2016,66300,71000,137300,31579,6865,24714,6659.05,5903.9,27734.6,63158,411.9
LAMWO,2017,67000,72000,139000,31970,6950,25020,6741.5,5977,28078,63940,417
LAMWO,2018,67700,73000,140700,32361,7035,25326,6823.95,6050.1,28421.4,64722,422.1
LAMWO,2019,68300,74000,142300,32729,7115,25614,6901.55,6118.9,28744.6,65458,426.9
LAMWO,2020,68900,74900,143800,33074,7190,25884,6974.3,6183.4,29047.6,66148,431.4
LAMWO,2021,69500,75900,145400,33442,7270,26172,7051.9,6252.2,29370.8,66884,436.2
LAMWO,2022,70000,76800,146800,33764,7340,26424,7119.8,6312.4,29653.6,67528,440.4
LAMWO,2023,70500,77600,148100,34063,7405,26658,7182.85,6368.3,29916.2,68126,444.3
LAMWO,2024,70900,78400,149300,34339,7465,26874,7241.05,6419.9,30158.6,68678,447.9
LAMWO,2025,71300,79200,150500,34615,7525,27090,7299.25,6471.5,30401,69230,451.5
LIRA,2015,201000,216000,417000,95910,20850,75060,20224.5,17931,84234,191820,1251
LIRA,2016,206800,222200,429000,98670,21450,77220,20806.5,18447,86658,197340,1287
LIRA,2017,212600,228600,441200,101476,22060,79416,21398.2,18971.6,89122.4,202952,1323.6
LIRA,2018,218500,235000,453500,104305,22675,81630,21994.75,19500.5,91607,208610,1360.5
LIRA,2019,224400,241500,465900,107157,23295,83862,22596.15,20033.7,94111.8,214314,1397.7
LIRA,2020,230400,248100,478500,110055,23925,86130,23207.25,20575.5,96657,220110,1435.5
LIRA,2021,236300,254700,491000,112930,24550,88380,23813.5,21113,99182,225860,1473
LIRA,2022,242300,261300,503600,115828,25180,90648,24424.6,21654.8,101727.2,231656,1510.8
LIRA,2023,248200,267800,516000,118680,25800,92880,25026,22188,104232,237360,1548
LIRA,2024,254000,274400,528400,121532,26420,95112,25627.4,22721.2,106736.8,243064,1585.2
LIRA,2025,259800,280900,540700,124361,27035,97326,26223.95,23250.1,109221.4,248722,1622.1
LUUKA,2015,115500,126300,241800,55614,12090,43524,11727.3,10397.4,48843.6,111228,725.4
LUUKA,2016,118000,128800,246800,56764,12340,44424,11969.8,10612.4,49853.6,113528,740.4
LUUKA,2017,120600,131300,251900,57937,12595,45342,12217.15,10831.7,50883.8,115874,755.7
LUUKA,2018,123100,133900,257000,59110,12850,46260,12464.5,11051,51914,118220,771
LUUKA,2019,125700,136400,262100,60283,13105,47178,12711.85,11270.3,52944.2,120566,786.3
LUUKA,2020,128200,138900,267100,61433,13355,48078,12954.35,11485.3,53954.2,122866,801.3
LUUKA,2021,130700,141300,272000,62560,13600,48960,13192,11696,54944,125120,816
LUUKA,2022,133100,143700,276800,63664,13840,49824,13424.8,11902.4,55913.6,127328,830.4
LUUKA,2023,135500,146100,281600,64768,14080,50688,13657.6,12108.8,56883.2,129536,844.8
LUUKA,2024,137800,148400,286200,65826,14310,51516,13880.7,12306.6,57812.4,131652,858.6
LUUKA,2025,140000,150600,290600,66838,14530,52308,14094.1,12495.8,58701.2,133676,871.8
LUWERO,2015,231500,234000,465500,107065,23275,83790,22576.75,20016.5,94031,214130,1396.5
LUWERO,2016,237600,239300,476900,109687,23845,85842,23129.65,20506.7,96333.8,219374,1430.7
LUWERO,2017,243800,244700,488500,112355,24425,87930,23692.25,21005.5,98677,224710,1465.5
LUWERO,2018,250100,250100,500200,115046,25010,90036,24259.7,21508.6,101040.4,230092,1500.6
LUWERO,2019,256400,255500,511900,117737,25595,92142,24827.15,22011.7,103403.8,235474,1535.7
LUWERO,2020,262700,260900,523600,120428,26180,94248,25394.6,22514.8,105767.2,240856,1570.8
LUWERO,2021,269000,266200,535200,123096,26760,96336,25957.2,23013.6,108110.4,246192,1605.6
LUWERO,2022,275300,271400,546700,125741,27335,98406,26514.95,23508.1,110433.4,251482,1640.1
LUWERO,2023,281500,276600,558100,128363,27905,100458,27067.85,23998.3,112736.2,256726,1674.3
LUWERO,2024,287500,281700,569200,130916,28460,102456,27606.2,24475.6,114978.4,261832,1707.6
LUWERO,2025,293500,286700,580200,133446,29010,104436,28139.7,24948.6,117200.4,266892,1740.6
LWENGO,2015,134600,142300,276900,63687,13845,49842,13429.65,11906.7,55933.8,127374,830.7
LWENGO,2016,136200,143600,279800,64354,13990,50364,13570.3,12031.4,56519.6,128708,839.4
LWENGO,2017,137700,144900,282600,64998,14130,50868,13706.1,12151.8,57085.2,129996,847.8
LWENGO,2018,139200,146200,285400,65642,14270,51372,13841.9,12272.2,57650.8,131284,856.2
LWENGO,2019,140700,147400,288100,66263,14405,51858,13972.85,12388.3,58196.2,132526,864.3
LWENGO,2020,142000,148500,290500,66815,14525,52290,14089.25,12491.5,58681,133630,871.5
LWENGO,2021,143300,149600,292900,67367,14645,52722,14205.65,12594.7,59165.8,134734,878.7
LWENGO,2022,144600,150600,295200,67896,14760,53136,14317.2,12693.6,59630.4,135792,885.6
LWENGO,2023,145700,151500,297200,68356,14860,53496,14414.2,12779.6,60034.4,136712,891.6
LWENGO,2024,146700,152200,298900,68747,14945,53802,14496.65,12852.7,60377.8,137494,896.7
LWENGO,2025,147600,152900,300500,69115,15025,54090,14574.25,12921.5,60701,138230,901.5
LYANTONDE,2015,47900,48000,95900,22057,4795,17262,4651.15,4123.7,19371.8,44114,287.7
LYANTONDE,2016,49400,49400,98800,22724,4940,17784,4791.8,4248.4,19957.6,45448,296.4
LYANTONDE,2017,50900,50700,101600,23368,5080,18288,4927.6,4368.8,20523.2,46736,304.8
LYANTONDE,2018,52500,52100,104600,24058,5230,18828,5073.1,4497.8,21129.2,48116,313.8
LYANTONDE,2019,54000,53500,107500,24725,5375,19350,5213.75,4622.5,21715,49450,322.5
LYANTONDE,2020,55600,54900,110500,25415,5525,19890,5359.25,4751.5,22321,50830,331.5
LYANTONDE,2021,57200,56300,113500,26105,5675,20430,5504.75,4880.5,22927,52210,340.5
LYANTONDE,2022,58800,57700,116500,26795,5825,20970,5650.25,5009.5,23533,53590,349.5
LYANTONDE,2023,60500,59100,119600,27508,5980,21528,5800.6,5142.8,24159.2,55016,358.8
LYANTONDE,2024,62100,60500,122600,28198,6130,22068,5946.1,5271.8,24765.2,56396,367.8
LYANTONDE,2025,63700,61900,125600,28888,6280,22608,6091.6,5400.8,25371.2,57776,376.8
MADI OKOLLO,2015,69900,73300,143200,32936,7160,25776,6945.2,6157.6,28926.4,65872,429.6
MADI OKOLLO,2016,71800,75500,147300,33879,7365,26514,7144.05,6333.9,29754.6,67758,441.9
MADI OKOLLO,2017,74200,77200,151400,34822,7570,27252,7342.9,6510.2,30582.8,69644,454.2
MADI OKOLLO,2018,76200,79500,155700,35811,7785,28026,7551.45,6695.1,31451.4,71622,467.1
MADI OKOLLO,2019,78300,81500,159800,36754,7990,28764,7750.3,6871.4,32279.6,73508,479.4
MADI OKOLLO,2020,80600,83600,164200,37766,8210,29556,7963.7,7060.6,33168.4,75532,492.6
MADI OKOLLO,2021,82500,85800,168300,38709,8415,30294,8162.55,7236.9,33996.6,77418,504.9
MADI OKOLLO,2022,84800,88000,172800,39744,8640,31104,8380.8,7430.4,34905.6,79488,518.4
MADI OKOLLO,2023,87000,89800,176800,40664,8840,31824,8574.8,7602.4,35713.6,81328,530.4
MADI OKOLLO,2024,89000,91900,180900,41607,9045,32562,8773.65,7778.7,36541.8,83214,542.7
MADI OKOLLO,2025,91100,94000,185100,42573,9255,33318,8977.35,7959.3,37390.2,85146,555.3
MANAFWA,2015,76400,79800,156200,35926,7810,28116,7575.7,6716.6,31552.4,71852,468.6
MANAFWA,2016,78300,81700,160000,36800,8000,28800,7760,6880,32320,73600,480
MANAFWA,2017,80300,83500,163800,37674,8190,29484,7944.3,7043.4,33087.6,75348,491.4
MANAFWA,2018,82300,85300,167600,38548,8380,30168,8128.6,7206.8,33855.2,77096,502.8
MANAFWA,2019,84200,87100,171300,39399,8565,30834,8308.05,7365.9,34602.6,78798,513.9
MANAFWA,2020,86200,89000,175200,40296,8760,31536,8497.2,7533.6,35390.4,80592,525.6
MANAFWA,2021,88200,90800,179000,41170,8950,32220,8681.5,7697,36158,82340,537
MANAFWA,2022,90100,92600,182700,42021,9135,32886,8860.95,7856.1,36905.4,84042,548.1
MANAFWA,2023,92000,94300,186300,42849,9315,33534,9035.55,8010.9,37632.6,85698,558.9
MANAFWA,2024,93900,96100,190000,43700,9500,34200,9215,8170,38380,87400,570
MANAFWA,2025,95800,97700,193500,44505,9675,34830,9384.75,8320.5,39087,89010,580.5
MARACHA,2015,89300,99600,188900,43447,9445,34002,9161.65,8122.7,38157.8,86894,566.7
MARACHA,2016,91300,101600,192900,44367,9645,34722,9355.65,8294.7,38965.8,88734,578.7
MARACHA,2017,93200,103600,196800,45264,9840,35424,9544.8,8462.4,39753.6,90528,590.4
MARACHA,2018,95100,105600,200700,46161,10035,36126,9733.95,8630.1,40541.4,92322,602.1
MARACHA,2019,97000,107500,204500,47035,10225,36810,9918.25,8793.5,41309,94070,613.5
MARACHA,2020,98900,109400,208300,47909,10415,37494,10102.55,8956.9,42076.6,95818,624.9
MARACHA,2021,100800,111400,212200,48806,10610,38196,10291.7,9124.6,42864.4,97612,636.6
MARACHA,2022,102600,113200,215800,49634,10790,38844,10466.3,9279.4,43591.6,99268,647.4
MARACHA,2023,104400,115100,219500,50485,10975,39510,10645.75,9438.5,44339,100970,658.5
MARACHA,2024,106100,116800,222900,51267,11145,40122,10810.65,9584.7,45025.8,102534,668.7
MARACHA,2025,107800,118500,226300,52049,11315,40734,10975.55,9730.9,45712.6,104098,678.9
MASAKA,2015,148200,153700,301900,69437,15095,54342,14642.15,12981.7,60983.8,138874,905.7
MASAKA,2016,151700,156900,308600,70978,15430,55548,14967.1,13269.8,62337.2,141956,925.8
MASAKA,2017,155300,160100,315400,72542,15770,56772,15296.9,13562.2,63710.8,145084,946.2
MASAKA,2018,158900,163300,322200,74106,16110,57996,15626.7,13854.6,65084.4,148212,966.6
MASAKA,2019,162400,166500,328900,75647,16445,59202,15951.65,14142.7,66437.8,151294,986.7
MASAKA,2020,166000,169700,335700,77211,16785,60426,16281.45,14435.1,67811.4,154422,1007.1
MASAKA,2021,169500,172800,342300,78729,17115,61614,16601.55,14718.9,69144.6,157458,1026.9
MASAKA,2022,173000,175800,348800,80224,17440,62784,16916.8,14998.4,70457.6,160448,1046.4
MASAKA,2023,176400,178800,355200,81696,17760,63936,17227.2,15273.6,71750.4,163392,1065.6
MASAKA,2024,179700,181800,361500,83145,18075,65070,17532.75,15544.5,73023,166290,1084.5
MASAKA,2025,183000,184600,367600,84548,18380,66168,17828.6,15806.8,74255.2,169096,1102.8
MASINDI,2015,151600,145900,297500,68425,14875,53550,14428.75,12792.5,60095,136850,892.5
MASINDI,2016,156000,149800,305800,70334,15290,55044,14831.3,13149.4,61771.6,140668,917.4
MASINDI,2017,160600,153800,314400,72312,15720,56592,15248.4,13519.2,63508.8,144624,943.2
MASINDI,2018,165200,157900,323100,74313,16155,58158,15670.35,13893.3,65266.2,148626,969.3
MASINDI,2019,169800,162000,331800,76314,16590,59724,16092.3,14267.4,67023.6,152628,995.4
MASINDI,2020,174500,166000,340500,78315,17025,61290,16514.25,14641.5,68781,156630,1021.5
MASINDI,2021,179200,170100,349300,80339,17465,62874,16941.05,15019.9,70558.6,160678,1047.9
MASINDI,2022,183900,174200,358100,82363,17905,64458,17367.85,15398.3,72336.2,164726,1074.3
MASINDI,2023,188600,178300,366900,84387,18345,66042,17794.65,15776.7,74113.8,168774,1100.7
MASINDI,2024,193300,182300,375600,86388,18780,67608,18216.6,16150.8,75871.2,172776,1126.8
MASINDI,2025,197900,186300,384200,88366,19210,69156,18633.7,16520.6,77608.4,176732,1152.6
MAYUGE,2015,235200,249700,484900,111527,24245,87282,23517.65,20850.7,97949.8,223054,1454.7
MAYUGE,2016,243000,257500,500500,115115,25025,90090,24274.25,21521.5,101101,230230,1501.5
MAYUGE,2017,250900,265300,516200,118726,25810,92916,25035.7,22196.6,104272.4,237452,1548.6
MAYUGE,2018,258900,273300,532200,122406,26610,95796,25811.7,22884.6,107504.4,244812,1596.6
MAYUGE,2019,267100,281500,548600,126178,27430,98748,26607.1,23589.8,110817.2,252356,1645.8
MAYUGE,2020,275400,289700,565100,129973,28255,101718,27407.35,24299.3,114150.2,259946,1695.3
MAYUGE,2021,283800,297900,581700,133791,29085,104706,28212.45,25013.1,117503.4,267582,1745.1
MAYUGE,2022,292200,306200,598400,137632,29920,107712,29022.4,25731.2,120876.8,275264,1795.2
MAYUGE,2023,300600,314600,615200,141496,30760,110736,29837.2,26453.6,124270.4,282992,1845.6
MAYUGE,2024,309100,322900,632000,145360,31600,113760,30652,27176,127664,290720,1896
MAYUGE,2025,317500,331200,648700,149201,32435,116766,31461.95,27894.1,131037.4,298402,1946.1
MBALE,2015,239200,262200,501400,115322,25070,90252,24317.9,21560.2,101282.8,230644,1504.2
MBALE,2016,246800,270900,517700,119071,25885,93186,25108.45,22261.1,104575.4,238142,1553.1
MBALE,2017,254500,279900,534400,122912,26720,96192,25918.4,22979.2,107948.8,245824,1603.2
MBALE,2018,262400,289100,551500,126845,27575,99270,26747.75,23714.5,111403,253690,1654.5
MBALE,2019,270400,298400,568800,130824,28440,102384,27586.8,24458.4,114897.6,261648,1706.4
MBALE,2020,278500,307800,586300,134849,29315,105534,28435.55,25210.9,118432.6,269698,1758.9
MBALE,2021,286700,317400,604100,138943,30205,108738,29298.85,25976.3,122028.2,277886,1812.3
MBALE,2022,294800,327000,621800,143014,31090,111924,30157.3,26737.4,125603.6,286028,1865.4
MBALE,2023,303000,336700,639700,147131,31985,115146,31025.45,27507.1,129219.4,294262,1919.1
MBALE,2024,311200,346500,657700,151271,32885,118386,31898.45,28281.1,132855.4,302542,1973.1
MBALE,2025,319300,356300,675600,155388,33780,121608,32766.6,29050.8,136471.2,310776,2026.8
MBARARA,2015,170700,180000,350700,80661,17535,63126,17008.95,15080.1,70841.4,161322,1052.1
MBARARA,2016,174800,183900,358700,82501,17935,64566,17396.95,15424.1,72457.4,165002,1076.1
MBARARA,2017,178700,187900,366600,84318,18330,65988,17780.1,15763.8,74053.2,168636,1099.8
MBARARA,2018,182900,191800,374700,86181,18735,67446,18172.95,16112.1,75689.4,172362,1124.1
MBARARA,2019,186900,195900,382800,88044,19140,68904,18565.8,16460.4,77325.6,176088,1148.4
MBARARA,2020,190900,199800,390700,89861,19535,70326,18948.95,16800.1,78921.4,179722,1172.1
MBARARA,2021,194900,203700,398600,91678,19930,71748,19332.1,17139.8,80517.2,183356,1195.8
MBARARA,2022,198600,207500,406100,93403,20305,73098,19695.85,17462.3,82032.2,186806,1218.3
MBARARA,2023,202700,211300,414000,95220,20700,74520,20079,17802,83628,190440,1242
MBARARA,2024,206300,214800,421100,96853,21055,75798,20423.35,18107.3,85062.2,193706,1263.3
MBARARA,2025,210000,218500,428500,98555,21425,77130,20782.25,18425.5,86557,197110,1285.5
MITOOMA,2015,87300,97500,184800,42504,9240,33264,8962.8,7946.4,37329.6,85008,554.4
MITOOMA,2016,88300,98500,186800,42964,9340,33624,9059.8,8032.4,37733.6,85928,560.4
MITOOMA,2017,89400,99400,188800,43424,9440,33984,9156.8,8118.4,38137.6,86848,566.4
MITOOMA,2018,90500,100300,190800,43884,9540,34344,9253.8,8204.4,38541.6,87768,572.4
MITOOMA,2019,91500,101100,192600,44298,9630,34668,9341.1,8281.8,38905.2,88596,577.8
MITOOMA,2020,92400,101900,194300,44689,9715,34974,9423.55,8354.9,39248.6,89378,582.9
MITOOMA,2021,93300,102600,195900,45057,9795,35262,9501.15,8423.7,39571.8,90114,587.7
MITOOMA,2022,94200,103300,197500,45425,9875,35550,9578.75,8492.5,39895,90850,592.5
MITOOMA,2023,95000,103900,198900,45747,9945,35802,9646.65,8552.7,40177.8,91494,596.7
MITOOMA,2024,95700,104500,200200,46046,10010,36036,9709.7,8608.6,40440.4,92092,600.6
MITOOMA,2025,96400,105000,201400,46322,10070,36252,9767.9,8660.2,40682.8,92644,604.2
MITYANA,2015,168200,165100,333300,76659,16665,59994,16165.05,14331.9,67326.6,153318,999.9
MITYANA,2016,171500,167700,339200,78016,16960,61056,16451.2,14585.6,68518.4,156032,1017.6
MITYANA,2017,174800,170400,345200,79396,17260,62136,16742.2,14843.6,69730.4,158792,1035.6
MITYANA,2018,178100,173000,351100,80753,17555,63198,17028.35,15097.3,70922.2,161506,1053.3
MITYANA,2019,181300,175500,356800,82064,17840,64224,17304.8,15342.4,72073.6,164128,1070.4
MITYANA,2020,184500,178000,362500,83375,18125,65250,17581.25,15587.5,73225,166750,1087.5
MITYANA,2021,187700,180500,368200,84686,18410,66276,17857.7,15832.6,74376.4,169372,1104.6
MITYANA,2022,190800,182800,373600,85928,18680,67248,18119.6,16064.8,75467.2,171856,1120.8
MITYANA,2023,193700,185100,378800,87124,18940,68184,18371.8,16288.4,76517.6,174248,1136.4
MITYANA,2024,196600,187300,383900,88297,19195,69102,18619.15,16507.7,77547.8,176594,1151.7
MITYANA,2025,199300,189300,388600,89378,19430,69948,18847.1,16709.8,78497.2,178756,1165.8
MOROTO,2015,50700,54700,105400,24242,5270,18972,5111.9,4532.2,21290.8,48484,316.2
MOROTO,2016,51900,56100,108000,24840,5400,19440,5238,4644,21816,49680,324
MOROTO,2017,53100,57500,110600,25438,5530,19908,5364.1,4755.8,22341.2,50876,331.8
MOROTO,2018,54300,58900,113200,26036,5660,20376,5490.2,4867.6,22866.4,52072,339.6
MOROTO,2019,55500,60300,115800,26634,5790,20844,5616.3,4979.4,23391.6,53268,347.4
MOROTO,2020,56800,61700,118500,27255,5925,21330,5747.25,5095.5,23937,54510,355.5
MOROTO,2021,58000,63200,121200,27876,6060,21816,5878.2,5211.6,24482.4,55752,363.6
MOROTO,2022,59200,64600,123800,28474,6190,22284,6004.3,5323.4,25007.6,56948,371.4
MOROTO,2023,60300,66000,126300,29049,6315,22734,6125.55,5430.9,25512.6,58098,378.9
MOROTO,2024,61500,67300,128800,29624,6440,23184,6246.8,5538.4,26017.6,59248,386.4
MOROTO,2025,62600,68700,131300,30199,6565,23634,6368.05,5645.9,26522.6,60398,393.9
MOYO,2015,48200,49500,97700,22471,4885,17586,4738.45,4201.1,19735.4,44942,293.1
MOYO,2016,49300,50700,100000,23000,5000,18000,4850,4300,20200,46000,300
MOYO,2017,50600,51700,102300,23529,5115,18414,4961.55,4398.9,20664.6,47058,306.9
MOYO,2018,51800,52900,104700,24081,5235,18846,5077.95,4502.1,21149.4,48162,314.1
MOYO,2019,53200,53900,107100,24633,5355,19278,5194.35,4605.3,21634.2,49266,321.3
MOYO,2020,54400,55100,109500,25185,5475,19710,5310.75,4708.5,22119,50370,328.5
MOYO,2021,55700,56100,111800,25714,5590,20124,5422.3,4807.4,22583.6,51428,335.4
MOYO,2022,56900,57200,114100,26243,5705,20538,5533.85,4906.3,23048.2,52486,342.3
MOYO,2023,58200,58200,116400,26772,5820,20952,5645.4,5005.2,23512.8,53544,349.2
MOYO,2024,59500,59300,118800,27324,5940,21384,5761.8,5108.4,23997.6,54648,356.4
MOYO,2025,60500,60400,120900,27807,6045,21762,5863.65,5198.7,24421.8,55614,362.7
MPIGI,2015,127900,127300,255200,58696,12760,45936,12377.2,10973.6,51550.4,117392,765.6
MPIGI,2016,131100,130300,261400,60122,13070,47052,12677.9,11240.2,52802.8,120244,784.2
MPIGI,2017,134400,133200,267600,61548,13380,48168,12978.6,11506.8,54055.2,123096,802.8
MPIGI,2018,137700,136200,273900,62997,13695,49302,13284.15,11777.7,55327.8,125994,821.7
MPIGI,2019,141100,139200,280300,64469,14015,50454,13594.55,12052.9,56620.6,128938,840.9
MPIGI,2020,144400,142200,286600,65918,14330,51588,13900.1,12323.8,57893.2,131836,859.8
MPIGI,2021,147700,145200,292900,67367,14645,52722,14205.65,12594.7,59165.8,134734,878.7
MPIGI,2022,150900,148200,299100,68793,14955,53838,14506.35,12861.3,60418.2,137586,897.3
MPIGI,2023,154200,151100,305300,70219,15265,54954,14807.05,13127.9,61670.6,140438,915.9
MPIGI,2024,157300,153900,311200,71576,15560,56016,15093.2,13381.6,62862.4,143152,933.6
MPIGI,2025,160400,156700,317100,72933,15855,57078,15379.35,13635.3,64054.2,145866,951.3
MUBENDE,2015,216800,213400,430200,98946,21510,77436,20864.7,18498.6,86900.4,197892,1290.6
MUBENDE,2016,228600,224400,453000,104190,22650,81540,21970.5,19479,91506,208380,1359
MUBENDE,2017,241000,235900,476900,109687,23845,85842,23129.65,20506.7,96333.8,219374,1430.7
MUBENDE,2018,254000,247900,501900,115437,25095,90342,24342.15,21581.7,101383.8,230874,1505.7
MUBENDE,2019,267400,260400,527800,121394,26390,95004,25598.3,22695.4,106615.6,242788,1583.4
MUBENDE,2020,281500,273300,554800,127604,27740,99864,26907.8,23856.4,112069.6,255208,1664.4
MUBENDE,2021,296100,286800,582900,134067,29145,104922,28270.65,25064.7,117745.8,268134,1748.7
MUBENDE,2022,311200,300700,611900,140737,30595,110142,29677.15,26311.7,123603.8,281474,1835.7
MUBENDE,2023,326800,315000,641800,147614,32090,115524,31127.3,27597.4,129643.6,295228,1925.4
MUBENDE,2024,343000,329900,672900,154767,33645,121122,32635.65,28934.7,135925.8,309534,2018.7
MUBENDE,2025,359700,345100,704800,162104,35240,126864,34182.8,30306.4,142369.6,324208,2114.4
MUKONO,2015,296200,314000,610200,140346,30510,109836,29594.7,26238.6,123260.4,280692,1830.6
MUKONO,2016,304700,323200,627900,144417,31395,113022,30453.15,26999.7,126835.8,288834,1883.7
MUKONO,2017,313300,332700,646000,148580,32300,116280,31331,27778,130492,297160,1938
MUKONO,2018,322000,342300,664300,152789,33215,119574,32218.55,28564.9,134188.6,305578,1992.9
MUKONO,2019,330800,352000,682800,157044,34140,122904,33115.8,29360.4,137925.6,314088,2048.4
MUKONO,2020,339600,361800,701400,161322,35070,126252,34017.9,30160.2,141682.8,322644,2104.2
MUKONO,2021,348500,371600,720100,165623,36005,129618,34924.85,30964.3,145460.2,331246,2160.3
MUKONO,2022,357300,381500,738800,169924,36940,132984,35831.8,31768.4,149237.6,339848,2216.4
MUKONO,2023,366100,391400,757500,174225,37875,136350,36738.75,32572.5,153015,348450,2272.5
MUKONO,2024,374800,401200,776000,178480,38800,139680,37636,33368,156752,356960,2328
MUKONO,2025,383300,411000,794300,182689,39715,142974,38523.55,34154.9,160448.6,365378,2382.9
NABILATUK,2015,33400,37700,71100,16353,3555,12798,3448.35,3057.3,14362.2,32706,213.3
NABILATUK,2016,35100,39400,74500,17135,3725,13410,3613.25,3203.5,15049,34270,223.5
NABILATUK,2017,36900,41200,78100,17963,3905,14058,3787.85,3358.3,15776.2,35926,234.3
NABILATUK,2018,38900,43000,81900,18837,4095,14742,3972.15,3521.7,16543.8,37674,245.7
NABILATUK,2019,40800,44900,85700,19711,4285,15426,4156.45,3685.1,17311.4,39422,257.1
NABILATUK,2020,42900,46800,89700,20631,4485,16146,4350.45,3857.1,18119.4,41262,269.1
NABILATUK,2021,45000,48800,93800,21574,4690,16884,4549.3,4033.4,18947.6,43148,281.4
NABILATUK,2022,47300,50900,98200,22586,4910,17676,4762.7,4222.6,19836.4,45172,294.6
NABILATUK,2023,49500,53000,102500,23575,5125,18450,4971.25,4407.5,20705,47150,307.5
NABILATUK,2024,51900,55200,107100,24633,5355,19278,5194.35,4605.3,21634.2,49266,321.3
NABILATUK,2025,54300,57400,111700,25691,5585,20106,5417.45,4803.1,22563.4,51382,335.1
NAKAPIRIPIRIT,2015,44100,47300,91400,21022,4570,16452,4432.9,3930.2,18462.8,42044,274.2
NAKAPIRIPIRIT,2016,46100,49400,95500,21965,4775,17190,4631.75,4106.5,19291,43930,286.5
NAKAPIRIPIRIT,2017,48200,51500,99700,22931,4985,17946,4835.45,4287.1,20139.4,45862,299.1
NAKAPIRIPIRIT,2018,50400,53800,104200,23966,5210,18756,5053.7,4480.6,21048.4,47932,312.6
NAKAPIRIPIRIT,2019,52600,56100,108700,25001,5435,19566,5271.95,4674.1,21957.4,50002,326.1
NAKAPIRIPIRIT,2020,54900,58400,113300,26059,5665,20394,5495.05,4871.9,22886.6,52118,339.9
NAKAPIRIPIRIT,2021,57300,60800,118100,27163,5905,21258,5727.85,5078.3,23856.2,54326,354.3
NAKAPIRIPIRIT,2022,59700,63300,123000,28290,6150,22140,5965.5,5289,24846,56580,369
NAKAPIRIPIRIT,2023,62200,65900,128100,29463,6405,23058,6212.85,5508.3,25876.2,58926,384.3
NAKAPIRIPIRIT,2024,64700,68500,133200,30636,6660,23976,6460.2,5727.6,26906.4,61272,399.6
NAKAPIRIPIRIT,2025,67300,71100,138400,31832,6920,24912,6712.4,5951.2,27956.8,63664,415.2
NAKASEKE,2015,107900,94300,202200,46506,10110,36396,9806.7,8694.6,40844.4,93012,606.6
NAKASEKE,2016,111900,96500,208400,47932,10420,37512,10107.4,8961.2,42096.8,95864,625.2
NAKASEKE,2017,115900,98800,214700,49381,10735,38646,10412.95,9232.1,43369.4,98762,644.1
NAKASEKE,2018,120100,101200,221300,50899,11065,39834,10733.05,9515.9,44702.6,101798,663.9
NAKASEKE,2019,124400,103500,227900,52417,11395,41022,11053.15,9799.7,46035.8,104834,683.7
NAKASEKE,2020,128800,105800,234600,53958,11730,42228,11378.1,10087.8,47389.2,107916,703.8
NAKASEKE,2021,133200,108200,241400,55522,12070,43452,11707.9,10380.2,48762.8,111044,724.2
NAKASEKE,2022,137700,110500,248200,57086,12410,44676,12037.7,10672.6,50136.4,114172,744.6
NAKASEKE,2023,142200,112700,254900,58627,12745,45882,12362.65,10960.7,51489.8,117254,764.7
NAKASEKE,2024,146800,115000,261800,60214,13090,47124,12697.3,11257.4,52883.6,120428,785.4
NAKASEKE,2025,151300,117200,268500,61755,13425,48330,13022.25,11545.5,54237,123510,805.5
NAKASONGOLA,2015,95800,90300,186100,42803,9305,33498,9025.85,8002.3,37592.2,85606,558.3
NAKASONGOLA,2016,99000,92700,191700,44091,9585,34506,9297.45,8243.1,38723.4,88182,575.1
NAKASONGOLA,2017,102300,95200,197500,45425,9875,35550,9578.75,8492.5,39895,90850,592.5
NAKASONGOLA,2018,105600,97800,203400,46782,10170,36612,9864.9,8746.2,41086.8,93564,610.2
NAKASONGOLA,2019,109000,100300,209300,48139,10465,37674,10151.05,8999.9,42278.6,96278,627.9
NAKASONGOLA,2020,112400,102800,215200,49496,10760,38736,10437.2,9253.6,43470.4,98992,645.6
NAKASONGOLA,2021,115900,105400,221300,50899,11065,39834,10733.05,9515.9,44702.6,101798,663.9
NAKASONGOLA,2022,119400,107900,227300,52279,11365,40914,11024.05,9773.9,45914.6,104558,681.9
NAKASONGOLA,2023,122900,110500,233400,53682,11670,42012,11319.9,10036.2,47146.8,107364,700.2
NAKASONGOLA,2024,126400,113000,239400,55062,11970,43092,11610.9,10294.2,48358.8,110124,718.2
NAKASONGOLA,2025,129900,115500,245400,56442,12270,44172,11901.9,10552.2,49570.8,112884,736.2
NAMAYINGO,2015,107900,110300,218200,50186,10910,39276,10582.7,9382.6,44076.4,100372,654.6
NAMAYINGO,2016,110100,111900,222000,51060,11100,39960,10767,9546,44844,102120,666
NAMAYINGO,2017,112200,113600,225800,51934,11290,40644,10951.3,9709.4,45611.6,103868,677.4
NAMAYINGO,2018,114400,115200,229600,52808,11480,41328,11135.6,9872.8,46379.2,105616,688.8
NAMAYINGO,2019,116500,116800,233300,53659,11665,41994,11315.05,10031.9,47126.6,107318,699.9
NAMAYINGO,2020,118600,118400,237000,54510,11850,42660,11494.5,10191,47874,109020,711
NAMAYINGO,2021,120700,119900,240600,55338,12030,43308,11669.1,10345.8,48601.2,110676,721.8
NAMAYINGO,2022,122700,121300,244000,56120,12200,43920,11834,10492,49288,112240,732
NAMAYINGO,2023,124700,122700,247400,56902,12370,44532,11998.9,10638.2,49974.8,113804,742.2
NAMAYINGO,2024,126600,124000,250600,57638,12530,45108,12154.1,10775.8,50621.2,115276,751.8
NAMAYINGO,2025,128400,125300,253700,58351,12685,45666,12304.45,10909.1,51247.4,116702,761.1
NAMISINDWA,2015,100800,103500,204300,46989,10215,36774,9908.55,8784.9,41268.6,93978,612.9
NAMISINDWA,2016,103700,106000,209700,48231,10485,37746,10170.45,9017.1,42359.4,96462,629.1
NAMISINDWA,2017,106600,108500,215100,49473,10755,38718,10432.35,9249.3,43450.2,98946,645.3
NAMISINDWA,2018,109500,111000,220500,50715,11025,39690,10694.25,9481.5,44541,101430,661.5
NAMISINDWA,2019,112500,113600,226100,52003,11305,40698,10965.85,9722.3,45672.2,104006,678.3
NAMISINDWA,2020,115400,116100,231500,53245,11575,41670,11227.75,9954.5,46763,106490,694.5
NAMISINDWA,2021,118400,118600,237000,54510,11850,42660,11494.5,10191,47874,109020,711
NAMISINDWA,2022,121400,121100,242500,55775,12125,43650,11761.25,10427.5,48985,111550,727.5
NAMISINDWA,2023,124300,123600,247900,57017,12395,44622,12023.15,10659.7,50075.8,114034,743.7
NAMISINDWA,2024,127200,126000,253200,58236,12660,45576,12280.2,10887.6,51146.4,116472,759.6
NAMISINDWA,2025,130100,128400,258500,59455,12925,46530,12537.25,11115.5,52217,118910,775.5
NAMUTUMBA,2015,127500,131900,259400,59662,12970,46692,12580.9,11154.2,52398.8,119324,778.2
NAMUTUMBA,2016,132200,136200,268400,61732,13420,48312,13017.4,11541.2,54216.8,123464,805.2
NAMUTUMBA,2017,137000,140600,277600,63848,13880,49968,13463.6,11936.8,56075.2,127696,832.8
NAMUTUMBA,2018,141900,145200,287100,66033,14355,51678,13924.35,12345.3,57994.2,132066,861.3
NAMUTUMBA,2019,147000,149700,296700,68241,14835,53406,14389.95,12758.1,59933.4,136482,890.1
NAMUTUMBA,2020,152100,154400,306500,70495,15325,55170,14865.25,13179.5,61913,140990,919.5
NAMUTUMBA,2021,157300,159100,316400,72772,15820,56952,15345.4,13605.2,63912.8,145544,949.2
NAMUTUMBA,2022,162500,163800,326300,75049,16315,58734,15825.55,14030.9,65912.6,150098,978.9
NAMUTUMBA,2023,167800,168600,336400,77372,16820,60552,16315.4,14465.2,67952.8,154744,1009.2
NAMUTUMBA,2024,173200,173400,346600,79718,17330,62388,16810.1,14903.8,70013.2,159436,1039.8
NAMUTUMBA,2025,178500,178200,356700,82041,17835,64206,17299.95,15338.1,72053.4,164082,1070.1
NAPAK,2015,66400,77900,144300,33189,7215,25974,6998.55,6204.9,29148.6,66378,432.9
NAPAK,2016,67600,79500,147100,33833,7355,26478,7134.35,6325.3,29714.2,67666,441.3
NAPAK,2017,68800,81200,150000,34500,7500,27000,7275,6450,30300,69000,450
NAPAK,2018,69900,82800,152700,35121,7635,27486,7405.95,6566.1,30845.4,70242,458.1
NAPAK,2019,71100,84400,155500,35765,7775,27990,7541.75,6686.5,31411,71530,466.5
NAPAK,2020,72200,86100,158300,36409,7915,28494,7677.55,6806.9,31976.6,72818,474.9
NAPAK,2021,73300,87700,161000,37030,8050,28980,7808.5,6923,32522,74060,483
NAPAK,2022,74400,89200,163600,37628,8180,29448,7934.6,7034.8,33047.2,75256,490.8
NAPAK,2023,75400,90800,166200,38226,8310,29916,8060.7,7146.6,33572.4,76452,498.6
NAPAK,2024,76400,92300,168700,38801,8435,30366,8181.95,7254.1,34077.4,77602,506.1
NAPAK,2025,77300,93800,171100,39353,8555,30798,8298.35,7357.3,34562.2,78706,513.3
NEBBI,2015,117600,126700,244300,56189,12215,43974,11848.55,10504.9,49348.6,112378,732.9
NEBBI,2016,121400,130300,251700,57891,12585,45306,12207.45,10823.1,50843.4,115782,755.1
NEBBI,2017,125300,134000,259300,59639,12965,46674,12576.05,11149.9,52378.6,119278,777.9
NEBBI,2018,129200,137800,267000,61410,13350,48060,12949.5,11481,53934,122820,801
NEBBI,2019,133200,141600,274800,63204,13740,49464,13327.8,11816.4,55509.6,126408,824.4
NEBBI,2020,137200,145400,282600,64998,14130,50868,13706.1,12151.8,57085.2,129996,847.8
NEBBI,2021,141200,149200,290400,66792,14520,52272,14084.4,12487.2,58660.8,133584,871.2
NEBBI,2022,145300,153000,298300,68609,14915,53694,14467.55,12826.9,60256.6,137218,894.9
NEBBI,2023,149400,156900,306300,70449,15315,55134,14855.55,13170.9,61872.6,140898,918.9
NEBBI,2024,153400,160700,314100,72243,15705,56538,15233.85,13506.3,63448.2,144486,942.3
NEBBI,2025,157500,164400,321900,74037,16095,57942,15612.15,13841.7,65023.8,148074,965.7
NGORA,2015,70000,75000,145000,33350,7250,26100,7032.5,6235,29290,66700,435
NGORA,2016,72100,76900,149000,34270,7450,26820,7226.5,6407,30098,68540,447
NGORA,2017,74200,78900,153100,35213,7655,27558,7425.35,6583.3,30926.2,70426,459.3
NGORA,2018,76400,80900,157300,36179,7865,28314,7629.05,6763.9,31774.6,72358,471.9
NGORA,2019,78600,83000,161600,37168,8080,29088,7837.6,6948.8,32643.2,74336,484.8
NGORA,2020,80800,85000,165800,38134,8290,29844,8041.3,7129.4,33491.6,76268,497.4
NGORA,2021,83000,87000,170000,39100,8500,30600,8245,7310,34340,78200,510
NGORA,2022,85200,89100,174300,40089,8715,31374,8453.55,7494.9,35208.6,80178,522.9
NGORA,2023,87300,91100,178400,41032,8920,32112,8652.4,7671.2,36036.8,82064,535.2
NGORA,2024,89500,93100,182600,41998,9130,32868,8856.1,7851.8,36885.2,83996,547.8
NGORA,2025,91700,95100,186800,42964,9340,33624,9059.8,8032.4,37733.6,85928,560.4
NTOROKO,2015,34700,33400,68100,15663,3405,12258,3302.85,2928.3,13756.2,31326,204.3
NTOROKO,2016,35700,34100,69800,16054,3490,12564,3385.3,3001.4,14099.6,32108,209.4
NTOROKO,2017,36600,34700,71300,16399,3565,12834,3458.05,3065.9,14402.6,32798,213.9
NTOROKO,2018,37500,35400,72900,16767,3645,13122,3535.65,3134.7,14725.8,33534,218.7
NTOROKO,2019,38500,36000,74500,17135,3725,13410,3613.25,3203.5,15049,34270,223.5
NTOROKO,2020,39400,36600,76000,17480,3800,13680,3686,3268,15352,34960,228
NTOROKO,2021,40400,37300,77700,17871,3885,13986,3768.45,3341.1,15695.4,35742,233.1
NTOROKO,2022,41300,37900,79200,18216,3960,14256,3841.2,3405.6,15998.4,36432,237.6
NTOROKO,2023,42200,38500,80700,18561,4035,14526,3913.95,3470.1,16301.4,37122,242.1
NTOROKO,2024,43100,39000,82100,18883,4105,14778,3981.85,3530.3,16584.2,37766,246.3
NTOROKO,2025,44000,39600,83600,19228,4180,15048,4054.6,3594.8,16887.2,38456,250.8
NTUNGAMO,2015,236400,254800,491200,112976,24560,88416,23823.2,21121.6,99222.4,225952,1473.6
NTUNGAMO,2016,241500,259600,501100,115253,25055,90198,24303.35,21547.3,101222.2,230506,1503.3
NTUNGAMO,2017,246700,264400,511100,117553,25555,91998,24788.35,21977.3,103242.2,235106,1533.3
NTUNGAMO,2018,251900,269200,521100,119853,26055,93798,25273.35,22407.3,105262.2,239706,1563.3
NTUNGAMO,2019,257100,274000,531100,122153,26555,95598,25758.35,22837.3,107282.2,244306,1593.3
NTUNGAMO,2020,262200,278600,540800,124384,27040,97344,26228.8,23254.4,109241.6,248768,1622.4
NTUNGAMO,2021,267300,283200,550500,126615,27525,99090,26699.25,23671.5,111201,253230,1651.5
NTUNGAMO,2022,272200,287700,559900,128777,27995,100782,27155.15,24075.7,113099.8,257554,1679.7
NTUNGAMO,2023,277100,292100,569200,130916,28460,102456,27606.2,24475.6,114978.4,261832,1707.6
NTUNGAMO,2024,281800,296400,578200,132986,28910,104076,28042.7,24862.6,116796.4,265972,1734.6
NTUNGAMO,2025,286300,300500,586800,134964,29340,105624,28459.8,25232.4,118533.6,269928,1760.4
NWOYA,2015,71600,73100,144700,33281,7235,26046,7017.95,6222.1,29229.4,66562,434.1
NWOYA,2016,79100,80600,159700,36731,7985,28746,7745.45,6867.1,32259.4,73462,479.1
NWOYA,2017,87400,88800,176200,40526,8810,31716,8545.7,7576.6,35592.4,81052,528.6
NWOYA,2018,96500,97800,194300,44689,9715,34974,9423.55,8354.9,39248.6,89378,582.9
NWOYA,2019,106500,107700,214200,49266,10710,38556,10388.7,9210.6,43268.4,98532,642.6
NWOYA,2020,117500,118500,236000,54280,11800,42480,11446,10148,47672,108560,708
NWOYA,2021,129500,130300,259800,59754,12990,46764,12600.3,11171.4,52479.6,119508,779.4
NWOYA,2022,142600,143200,285800,65734,14290,51444,13861.3,12289.4,57731.6,131468,857.4
NWOYA,2023,157000,157300,314300,72289,15715,56574,15243.55,13514.9,63488.6,144578,942.9
NWOYA,2024,172600,172700,345300,79419,17265,62154,16747.05,14847.9,69750.6,158838,1035.9
NWOYA,2025,189700,189400,379100,87193,18955,68238,18386.35,16301.3,76578.2,174386,1137.3
OBONGI,2015,22100,21700,43800,10074,2190,7884,2124.3,1883.4,8847.6,20148,131.4
OBONGI,2016,22800,22100,44900,10327,2245,8082,2177.65,1930.7,9069.8,20654,134.7
OBONGI,2017,23400,22700,46100,10603,2305,8298,2235.85,1982.3,9312.2,21206,138.3
OBONGI,2018,24000,23100,47100,10833,2355,8478,2284.35,2025.3,9514.2,21666,141.3
OBONGI,2019,24500,23600,48100,11063,2405,8658,2332.85,2068.3,9716.2,22126,144.3
OBONGI,2020,25100,24000,49100,11293,2455,8838,2381.35,2111.3,9918.2,22586,147.3
OBONGI,2021,25700,24600,50300,11569,2515,9054,2439.55,2162.9,10160.6,23138,150.9
OBONGI,2022,26300,25000,51300,11799,2565,9234,2488.05,2205.9,10362.6,23598,153.9
OBONGI,2023,26800,25500,52300,12029,2615,9414,2536.55,2248.9,10564.6,24058,156.9
OBONGI,2024,27300,25900,53200,12236,2660,9576,2580.2,2287.6,10746.4,24472,159.6
OBONGI,2025,28000,26300,54300,12489,2715,9774,2633.55,2334.9,10968.6,24978,162.9
OMORO,2015,81200,84100,165300,38019,8265,29754,8017.05,7107.9,33390.6,76038,495.9
OMORO,2016,84200,87000,171200,39376,8560,30816,8303.2,7361.6,34582.4,78752,513.6
OMORO,2017,87300,90000,177300,40779,8865,31914,8599.05,7623.9,35814.6,81558,531.9
OMORO,2018,90400,93100,183500,42205,9175,33030,8899.75,7890.5,37067,84410,550.5
OMORO,2019,93700,96200,189900,43677,9495,34182,9210.15,8165.7,38359.8,87354,569.7
OMORO,2020,97000,99400,196400,45172,9820,35352,9525.4,8445.2,39672.8,90344,589.2
OMORO,2021,100300,102700,203000,46690,10150,36540,9845.5,8729,41006,93380,609
OMORO,2022,103700,105900,209600,48208,10480,37728,10165.6,9012.8,42339.2,96416,628.8
OMORO,2023,107200,109200,216400,49772,10820,38952,10495.4,9305.2,43712.8,99544,649.2
OMORO,2024,110600,112600,223200,51336,11160,40176,10825.2,9597.6,45086.4,102672,669.6
OMORO,2025,114100,115900,230000,52900,11500,41400,11155,9890,46460,105800,690
OTUKE,2015,53000,54900,107900,24817,5395,19422,5233.15,4639.7,21795.8,49634,323.7
OTUKE,2016,55400,57200,112600,25898,5630,20268,5461.1,4841.8,22745.2,51796,337.8
OTUKE,2017,57900,59700,117600,27048,5880,21168,5703.6,5056.8,23755.2,54096,352.8
OTUKE,2018,60500,62200,122700,28221,6135,22086,5950.95,5276.1,24785.4,56442,368.1
OTUKE,2019,63200,64900,128100,29463,6405,23058,6212.85,5508.3,25876.2,58926,384.3
OTUKE,2020,65900,67600,133500,30705,6675,24030,6474.75,5740.5,26967,61410,400.5
OTUKE,2021,68700,70300,139000,31970,6950,25020,6741.5,5977,28078,63940,417
OTUKE,2022,71600,73100,144700,33281,7235,26046,7017.95,6222.1,29229.4,66562,434.1
OTUKE,2023,74600,76000,150600,34638,7530,27108,7304.1,6475.8,30421.2,69276,451.8
OTUKE,2024,77600,79000,156600,36018,7830,28188,7595.1,6733.8,31633.2,72036,469.8
OTUKE,2025,80600,82000,162600,37398,8130,29268,7886.1,6991.8,32845.2,74796,487.8
OYAM,2015,191700,200900,392600,90298,19630,70668,19041.1,16881.8,79305.2,180596,1177.8
OYAM,2016,197600,206900,404500,93035,20225,72810,19618.25,17393.5,81709,186070,1213.5
OYAM,2017,203600,212900,416500,95795,20825,74970,20200.25,17909.5,84133,191590,1249.5
OYAM,2018,209800,219000,428800,98624,21440,77184,20796.8,18438.4,86617.6,197248,1286.4
OYAM,2019,216000,225300,441300,101499,22065,79434,21403.05,18975.9,89142.6,202998,1323.9
OYAM,2020,222200,231500,453700,104351,22685,81666,22004.45,19509.1,91647.4,208702,1361.1
OYAM,2021,228500,237800,466300,107249,23315,83934,22615.55,20050.9,94192.6,214498,1398.9
OYAM,2022,234900,244100,479000,110170,23950,86220,23231.5,20597,96758,220340,1437
OYAM,2023,241200,250400,491600,113068,24580,88488,23842.6,21138.8,99303.2,226136,1474.8
OYAM,2024,247500,256700,504200,115966,25210,90756,24453.7,21680.6,101848.4,231932,1512.6
OYAM,2025,253700,263000,516700,118841,25835,93006,25059.95,22218.1,104373.4,237682,1550.1
PADER,2015,87800,92600,180400,41492,9020,32472,8749.4,7757.2,36440.8,82984,541.2
PADER,2016,89400,94400,183800,42274,9190,33084,8914.3,7903.4,37127.6,84548,551.4
PADER,2017,91000,96200,187200,43056,9360,33696,9079.2,8049.6,37814.4,86112,561.6
PADER,2018,92700,98000,190700,43861,9535,34326,9248.95,8200.1,38521.4,87722,572.1
PADER,2019,94200,99800,194000,44620,9700,34920,9409,8342,39188,89240,582
PADER,2020,95800,101500,197300,45379,9865,35514,9569.05,8483.9,39854.6,90758,591.9
PADER,2021,97300,103200,200500,46115,10025,36090,9724.25,8621.5,40501,92230,601.5
PADER,2022,98800,104900,203700,46851,10185,36666,9879.45,8759.1,41147.4,93702,611.1
PADER,2023,100200,106500,206700,47541,10335,37206,10024.95,8888.1,41753.4,95082,620.1
PADER,2024,101500,108100,209600,48208,10480,37728,10165.6,9012.8,42339.2,96416,628.8
PADER,2025,102800,109600,212400,48852,10620,38232,10301.4,9133.2,42904.8,97704,637.2
PAKWACH,2015,78900,84000,162900,37467,8145,29322,7900.65,7004.7,32905.8,74934,488.7
PAKWACH,2016,82300,87100,169400,38962,8470,30492,8215.9,7284.2,34218.8,77924,508.2
PAKWACH,2017,85700,90200,175900,40457,8795,31662,8531.15,7563.7,35531.8,80914,527.7
PAKWACH,2018,89300,93500,182800,42044,9140,32904,8865.8,7860.4,36925.6,84088,548.4
PAKWACH,2019,92900,96800,189700,43631,9485,34146,9200.45,8157.1,38319.4,87262,569.1
PAKWACH,2020,96600,100200,196800,45264,9840,35424,9544.8,8462.4,39753.6,90528,590.4
PAKWACH,2021,100500,103600,204100,46943,10205,36738,9898.85,8776.3,41228.2,93886,612.3
PAKWACH,2022,104400,107100,211500,48645,10575,38070,10257.75,9094.5,42723,97290,634.5
PAKWACH,2023,108300,110700,219000,50370,10950,39420,10621.5,9417,44238,100740,657
PAKWACH,2024,112400,114200,226600,52118,11330,40788,10990.1,9743.8,45773.2,104236,679.8
PAKWACH,2025,116500,117900,234400,53912,11720,42192,11368.4,10079.2,47348.8,107824,703.2
PALLISA,2015,138900,146000,284900,65527,14245,51282,13817.65,12250.7,57549.8,131054,854.7
PALLISA,2016,145300,152400,297700,68471,14885,53586,14438.45,12801.1,60135.4,136942,893.1
PALLISA,2017,152000,158900,310900,71507,15545,55962,15078.65,13368.7,62801.8,143014,932.7
PALLISA,2018,158900,165700,324600,74658,16230,58428,15743.1,13957.8,65569.2,149316,973.8
PALLISA,2019,166100,172700,338800,77924,16940,60984,16431.8,14568.4,68437.6,155848,1016.4
PALLISA,2020,173400,180000,353400,81282,17670,63612,17139.9,15196.2,71386.8,162564,1060.2
PALLISA,2021,181000,187400,368400,84732,18420,66312,17867.4,15841.2,74416.8,169464,1105.2
PALLISA,2022,188800,194900,383700,88251,19185,69066,18609.45,16499.1,77507.4,176502,1151.1
PALLISA,2023,196800,202700,399500,91885,19975,71910,19375.75,17178.5,80699,183770,1198.5
PALLISA,2024,204900,210600,415500,95565,20775,74790,20151.75,17866.5,83931,191130,1246.5
PALLISA,2025,213200,218700,431900,99337,21595,77742,20947.15,18571.7,87243.8,198674,1295.7
RAKAI,2015,138900,143100,282000,64860,14100,50760,13677,12126,56964,129720,846
RAKAI,2016,142600,146400,289000,66470,14450,52020,14016.5,12427,58378,132940,867
RAKAI,2017,146400,149700,296100,68103,14805,53298,14360.85,12732.3,59812.2,136206,888.3
RAKAI,2018,150300,153000,303300,69759,15165,54594,14710.05,13041.9,61266.6,139518,909.9
RAKAI,2019,154100,156400,310500,71415,15525,55890,15059.25,13351.5,62721,142830,931.5
RAKAI,2020,158000,159700,317700,73071,15885,57186,15408.45,13661.1,64175.4,146142,953.1
RAKAI,2021,161800,163000,324800,74704,16240,58464,15752.8,13966.4,65609.6,149408,974.4
RAKAI,2022,165600,166300,331900,76337,16595,59742,16097.15,14271.7,67043.8,152674,995.7
RAKAI,2023,169400,169500,338900,77947,16945,61002,16436.65,14572.7,68457.8,155894,1016.7
RAKAI,2024,173100,172600,345700,79511,17285,62226,16766.45,14865.1,69831.4,159022,1037.1
RAKAI,2025,176800,175700,352500,81075,17625,63450,17096.25,15157.5,71205,162150,1057.5
RUBANDA,2015,92900,105400,198300,45609,9915,35694,9617.55,8526.9,40056.6,91218,594.9
RUBANDA,2016,94200,106300,200500,46115,10025,36090,9724.25,8621.5,40501,92230,601.5
RUBANDA,2017,95500,107100,202600,46598,10130,36468,9826.1,8711.8,40925.2,93196,607.8
RUBANDA,2018,96700,107900,204600,47058,10230,36828,9923.1,8797.8,41329.2,94116,613.8
RUBANDA,2019,97900,108700,206600,47518,10330,37188,10020.1,8883.8,41733.2,95036,619.8
RUBANDA,2020,99100,109400,208500,47955,10425,37530,10112.25,8965.5,42117,95910,625.5
RUBANDA,2021,100200,110100,210300,48369,10515,37854,10199.55,9042.9,42480.6,96738,630.9
RUBANDA,2022,101200,110700,211900,48737,10595,38142,10277.15,9111.7,42803.8,97474,635.7
RUBANDA,2023,102200,111200,213400,49082,10670,38412,10349.9,9176.2,43106.8,98164,640.2
RUBANDA,2024,103100,111700,214800,49404,10740,38664,10417.8,9236.4,43389.6,98808,644.4
RUBANDA,2025,104000,112000,216000,49680,10800,38880,10476,9288,43632,99360,648
RUBIRIZI,2015,62700,68300,131000,30130,6550,23580,6353.5,5633,26462,60260,393
RUBIRIZI,2016,64000,69700,133700,30751,6685,24066,6484.45,5749.1,27007.4,61502,401.1
RUBIRIZI,2017,65300,71000,136300,31349,6815,24534,6610.55,5860.9,27532.6,62698,408.9
RUBIRIZI,2018,66600,72300,138900,31947,6945,25002,6736.65,5972.7,28057.8,63894,416.7
RUBIRIZI,2019,67900,73600,141500,32545,7075,25470,6862.75,6084.5,28583,65090,424.5
RUBIRIZI,2020,69200,74900,144100,33143,7205,25938,6988.85,6196.3,29108.2,66286,432.3
RUBIRIZI,2021,70400,76200,146600,33718,7330,26388,7110.1,6303.8,29613.2,67436,439.8
RUBIRIZI,2022,71600,77500,149100,34293,7455,26838,7231.35,6411.3,30118.2,68586,447.3
RUBIRIZI,2023,72800,78700,151500,34845,7575,27270,7347.75,6514.5,30603,69690,454.5
RUBIRIZI,2024,74000,79900,153900,35397,7695,27702,7464.15,6617.7,31087.8,70794,461.7
RUBIRIZI,2025,75100,81000,156100,35903,7805,28098,7570.85,6712.3,31532.2,71806,468.3
RUKIGA,2015,48500,52700,101200,23276,5060,18216,4908.2,4351.6,20442.4,46552,303.6
RUKIGA,2016,49000,53100,102100,23483,5105,18378,4951.85,4390.3,20624.2,46966,306.3
RUKIGA,2017,49500,53500,103000,23690,5150,18540,4995.5,4429,20806,47380,309
RUKIGA,2018,50000,53800,103800,23874,5190,18684,5034.3,4463.4,20967.6,47748,311.4
RUKIGA,2019,50500,54200,104700,24081,5235,18846,5077.95,4502.1,21149.4,48162,314.1
RUKIGA,2020,50900,54500,105400,24242,5270,18972,5111.9,4532.2,21290.8,48484,316.2
RUKIGA,2021,51300,54700,106000,24380,5300,19080,5141,4558,21412,48760,318
RUKIGA,2022,51700,55000,106700,24541,5335,19206,5174.95,4588.1,21553.4,49082,320.1
RUKIGA,2023,52000,55200,107200,24656,5360,19296,5199.2,4609.6,21654.4,49312,321.6
RUKIGA,2024,52300,55400,107700,24771,5385,19386,5223.45,4631.1,21755.4,49542,323.1
RUKIGA,2025,52500,55500,108000,24840,5400,19440,5238,4644,21816,49680,324
RUKUNGIRI,2015,151400,165700,317100,72933,15855,57078,15379.35,13635.3,64054.2,145866,951.3
RUKUNGIRI,2016,153200,167300,320500,73715,16025,57690,15544.25,13781.5,64741,147430,961.5
RUKUNGIRI,2017,155100,169000,324100,74543,16205,58338,15718.85,13936.3,65468.2,149086,972.3
RUKUNGIRI,2018,156900,170500,327400,75302,16370,58932,15878.9,14078.2,66134.8,150604,982.2
RUKUNGIRI,2019,158700,172000,330700,76061,16535,59526,16038.95,14220.1,66801.4,152122,992.1
RUKUNGIRI,2020,160300,173500,333800,76774,16690,60084,16189.3,14353.4,67427.6,153548,1001.4
RUKUNGIRI,2021,161900,174800,336700,77441,16835,60606,16329.95,14478.1,68013.4,154882,1010.1
RUKUNGIRI,2022,163400,176000,339400,78062,16970,61092,16460.9,14594.2,68558.8,156124,1018.2
RUKUNGIRI,2023,164800,177200,342000,78660,17100,61560,16587,14706,69084,157320,1026
RUKUNGIRI,2024,166000,178200,344200,79166,17210,61956,16693.7,14800.6,69528.4,158332,1032.6
RUKUNGIRI,2025,167200,179100,346300,79649,17315,62334,16795.55,14890.9,69952.6,159298,1038.9
RWAMPARA,2015,63500,66500,130000,29900,6500,23400,6305,5590,26260,59800,390
RWAMPARA,2016,64900,67900,132800,30544,6640,23904,6440.8,5710.4,26825.6,61088,398.4
RWAMPARA,2017,66400,69400,135800,31234,6790,24444,6586.3,5839.4,27431.6,62468,407.4
RWAMPARA,2018,67800,70900,138700,31901,6935,24966,6726.95,5964.1,28017.4,63802,416.1
RWAMPARA,2019,69300,72300,141600,32568,7080,25488,6867.6,6088.8,28603.2,65136,424.8
RWAMPARA,2020,70800,73800,144600,33258,7230,26028,7013.1,6217.8,29209.2,66516,433.8
RWAMPARA,2021,72200,75200,147400,33902,7370,26532,7148.9,6338.2,29774.8,67804,442.2
RWAMPARA,2022,73800,76700,150500,34615,7525,27090,7299.25,6471.5,30401,69230,451.5
RWAMPARA,2023,75000,78100,153100,35213,7655,27558,7425.35,6583.3,30926.2,70426,459.3
RWAMPARA,2024,76500,79700,156200,35926,7810,28116,7575.7,6716.6,31552.4,71852,468.6
RWAMPARA,2025,77800,80900,158700,36501,7935,28566,7696.95,6824.1,32057.4,73002,476.1
SERERE,2015,144200,150900,295100,67873,14755,53118,14312.35,12689.3,59610.2,135746,885.3
SERERE,2016,150300,156900,307200,70656,15360,55296,14899.2,13209.6,62054.4,141312,921.6
SERERE,2017,156700,163100,319800,73554,15990,57564,15510.3,13751.4,64599.6,147108,959.4
SERERE,2018,163200,169500,332700,76521,16635,59886,16135.95,14306.1,67205.4,153042,998.1
SERERE,2019,169900,176000,345900,79557,17295,62262,16776.15,14873.7,69871.8,159114,1037.7
SERERE,2020,176800,182700,359500,82685,17975,64710,17435.75,15458.5,72619,165370,1078.5
SERERE,2021,183800,189500,373300,85859,18665,67194,18105.05,16051.9,75406.6,171718,1119.9
SERERE,2022,191000,196500,387500,89125,19375,69750,18793.75,16662.5,78275,178250,1162.5
SERERE,2023,198300,203500,401800,92414,20090,72324,19487.3,17277.4,81163.6,184828,1205.4
SERERE,2024,205800,210700,416500,95795,20825,74970,20200.25,17909.5,84133,191590,1249.5
SERERE,2025,213300,218000,431300,99199,21565,77634,20918.05,18545.9,87122.6,198398,1293.9
SHEEMA,2015,100100,108900,209000,48070,10450,37620,10136.5,8987,42218,96140,627
SHEEMA,2016,101400,110000,211400,48622,10570,38052,10252.9,9090.2,42702.8,97244,634.2
SHEEMA,2017,102600,111200,213800,49174,10690,38484,10369.3,9193.4,43187.6,98348,641.4
SHEEMA,2018,103800,112300,216100,49703,10805,38898,10480.85,9292.3,43652.2,99406,648.3
SHEEMA,2019,105000,113400,218400,50232,10920,39312,10592.4,9391.2,44116.8,100464,655.2
SHEEMA,2020,106100,114400,220500,50715,11025,39690,10694.25,9481.5,44541,101430,661.5
SHEEMA,2021,107200,115400,222600,51198,11130,40068,10796.1,9571.8,44965.2,102396,667.8
SHEEMA,2022,108200,116300,224500,51635,11225,40410,10888.25,9653.5,45349,103270,673.5
SHEEMA,2023,109100,117200,226300,52049,11315,40734,10975.55,9730.9,45712.6,104098,678.9
SHEEMA,2024,110000,117900,227900,52417,11395,41022,11053.15,9799.7,46035.8,104834,683.7
SHEEMA,2025,110700,118600,229300,52739,11465,41274,11121.05,9859.9,46318.6,105478,687.9
SIRONKO,2015,123100,123400,246500,56695,12325,44370,11955.25,10599.5,49793,113390,739.5
SIRONKO,2016,126100,125900,252000,57960,12600,45360,12222,10836,50904,115920,756
SIRONKO,2017,129100,128500,257600,59248,12880,46368,12493.6,11076.8,52035.2,118496,772.8
SIRONKO,2018,132100,131100,263200,60536,13160,47376,12765.2,11317.6,53166.4,121072,789.6
SIRONKO,2019,135200,133600,268800,61824,13440,48384,13036.8,11558.4,54297.6,123648,806.4
SIRONKO,2020,138200,136100,274300,63089,13715,49374,13303.55,11794.9,55408.6,126178,822.9
SIRONKO,2021,141100,138600,279700,64331,13985,50346,13565.45,12027.1,56499.4,128662,839.1
SIRONKO,2022,144100,141100,285200,65596,14260,51336,13832.2,12263.6,57610.4,131192,855.6
SIRONKO,2023,147000,143500,290500,66815,14525,52290,14089.25,12491.5,58681,133630,871.5
SIRONKO,2024,149800,145800,295600,67988,14780,53208,14336.6,12710.8,59711.2,135976,886.8
SIRONKO,2025,152600,148100,300700,69161,15035,54126,14583.95,12930.1,60741.4,138322,902.1
SOROTI,2015,149300,156000,305300,70219,15265,54954,14807.05,13127.9,61670.6,140438,915.9
SOROTI,2016,155000,161400,316400,72772,15820,56952,15345.4,13605.2,63912.8,145544,949.2
SOROTI,2017,160800,167100,327900,75417,16395,59022,15903.15,14099.7,66235.8,150834,983.7
SOROTI,2018,166700,172800,339500,78085,16975,61110,16465.75,14598.5,68579,156170,1018.5
SOROTI,2019,172800,178600,351400,80822,17570,63252,17042.9,15110.2,70982.8,161644,1054.2
SOROTI,2020,179000,184600,363600,83628,18180,65448,17634.6,15634.8,73447.2,167256,1090.8
SOROTI,2021,185300,190600,375900,86457,18795,67662,18231.15,16163.7,75931.8,172914,1127.7
SOROTI,2022,191700,196700,388400,89332,19420,69912,18837.4,16701.2,78456.8,178664,1165.2
SOROTI,2023,198100,202900,401000,92230,20050,72180,19448.5,17243,81002,184460,1203
SOROTI,2024,204700,209200,413900,95197,20695,74502,20074.15,17797.7,83607.8,190394,1241.7
SOROTI,2025,211200,215400,426600,98118,21330,76788,20690.1,18343.8,86173.2,196236,1279.8
SSEMBABULE,2015,129100,129100,258200,59386,12910,46476,12522.7,11102.6,52156.4,118772,774.6
SSEMBABULE,2016,133000,132500,265500,61065,13275,47790,12876.75,11416.5,53631,122130,796.5
SSEMBABULE,2017,137000,136100,273100,62813,13655,49158,13245.35,11743.3,55166.2,125626,819.3
SSEMBABULE,2018,141100,139600,280700,64561,14035,50526,13613.95,12070.1,56701.4,129122,842.1
SSEMBABULE,2019,145200,143200,288400,66332,14420,51912,13987.4,12401.2,58256.8,132664,865.2
SSEMBABULE,2020,149300,146800,296100,68103,14805,53298,14360.85,12732.3,59812.2,136206,888.3
SSEMBABULE,2021,153500,150400,303900,69897,15195,54702,14739.15,13067.7,61387.8,139794,911.7
SSEMBABULE,2022,157700,154000,311700,71691,15585,56106,15117.45,13403.1,62963.4,143382,935.1
SSEMBABULE,2023,161800,157500,319300,73439,15965,57474,15486.05,13729.9,64498.6,146878,957.9
SSEMBABULE,2024,165900,161100,327000,75210,16350,58860,15859.5,14061,66054,150420,981
SSEMBABULE,2025,170000,164600,334600,76958,16730,60228,16228.1,14387.8,67589.2,153916,1003.8
TORORO,2015,256100,271300,527400,121302,26370,94932,25578.9,22678.2,106534.8,242604,1582.2
TORORO,2016,263000,278200,541200,124476,27060,97416,26248.2,23271.6,109322.4,248952,1623.6
TORORO,2017,270000,285100,555100,127673,27755,99918,26922.35,23869.3,112130.2,255346,1665.3
TORORO,2018,277100,292100,569200,130916,28460,102456,27606.2,24475.6,114978.4,261832,1707.6
TORORO,2019,284200,299200,583400,134182,29170,105012,28294.9,25086.2,117846.8,268364,1750.2
TORORO,2020,291300,306200,597500,137425,29875,107550,28978.75,25692.5,120695,274850,1792.5
TORORO,2021,298400,313200,611600,140668,30580,110088,29662.6,26298.8,123543.2,281336,1834.8
TORORO,2022,305500,320200,625700,143911,31285,112626,30346.45,26905.1,126391.4,287822,1877.1
TORORO,2023,312500,327200,639700,147131,31985,115146,31025.45,27507.1,129219.4,294262,1919.1
TORORO,2024,319400,334000,653400,150282,32670,117612,31689.9,28096.2,131986.8,300564,1960.2
TORORO,2025,326200,340800,667000,153410,33350,120060,32349.5,28681,134734,306820,2001
WAKISO,2015,1001400,1106100,2107500,484725,105375,379350,102213.75,90622.5,425715,969450,6322.5
WAKISO,2016,1068400,1181600,2250000,517500,112500,405000,109125,96750,454500,1035000,6750
WAKISO,2017,1140100,1262700,2402800,552644,120140,432504,116535.8,103320.4,485365.6,1105288,7208.4
WAKISO,2018,1215700,1348100,2563800,589674,128190,461484,124344.3,110243.4,517887.6,1179348,7691.4
WAKISO,2019,1296500,1438600,2735100,629073,136755,492318,132652.35,117609.3,552490.2,1258146,8205.3
WAKISO,2020,1381000,1534200,2915200,670496,145760,524736,141387.2,125353.6,588870.4,1340992,8745.6
WAKISO,2021,1469700,1636000,3105700,714311,155285,559026,150626.45,133545.1,627351.4,1428622,9317.1
WAKISO,2022,1564000,1744000,3308000,760840,165400,595440,160438,142244,668216,1521680,9924
WAKISO,2023,1663200,1856100,3519300,809439,175965,633474,170686.05,151329.9,710898.6,1618878,10557.9
WAKISO,2024,1766700,1974300,3741000,860430,187050,673380,181438.5,160863,755682,1720860,11223
WAKISO,2025,1875400,2099900,3975300,914319,198765,715554,192802.05,170937.9,803010.6,1828638,11925.9
YUMBE,2015,240400,266200,506600,116518,25330,91188,24570.1,21783.8,102333.2,233036,1519.8
YUMBE,2016,253100,282000,535100,123073,26755,96318,25952.35,23009.3,108090.2,246146,1605.3
YUMBE,2017,266400,298700,565100,129973,28255,101718,27407.35,24299.3,114150.2,259946,1695.3
YUMBE,2018,280200,316300,596500,137195,29825,107370,28930.25,25649.5,120493,274390,1789.5
YUMBE,2019,294700,334700,629400,144762,31470,113292,30525.9,27064.2,127138.8,289524,1888.2
YUMBE,2020,309600,354000,663600,152628,33180,119448,32184.6,28534.8,134047.2,305256,1990.8
YUMBE,2021,325200,374100,699300,160839,34965,125874,33916.05,30069.9,141258.6,321678,2097.9
YUMBE,2022,341200,395200,736400,169372,36820,132552,35715.4,31665.2,148752.8,338744,2209.2
YUMBE,2023,357800,417200,775000,178250,38750,139500,37587.5,33325,156550,356500,2325
YUMBE,2024,375000,440200,815200,187496,40760,146736,39537.2,35053.6,164670.4,374992,2445.6
YUMBE,2025,392600,464000,856600,197018,42830,154188,41545.1,36833.8,173033.2,394036,2569.8
ZOMBO,2015,118700,126900,245600,56488,12280,44208,11911.6,10560.8,49611.2,112976,736.8
ZOMBO,2016,122400,130500,252900,58167,12645,45522,12265.65,10874.7,51085.8,116334,758.7
ZOMBO,2017,126100,134100,260200,59846,13010,46836,12619.7,11188.6,52560.4,119692,780.6
ZOMBO,2018,130000,137800,267800,61594,13390,48204,12988.3,11515.4,54095.6,123188,803.4
ZOMBO,2019,133900,141500,275400,63342,13770,49572,13356.9,11842.2,55630.8,126684,826.2
ZOMBO,2020,137800,145300,283100,65113,14155,50958,13730.35,12173.3,57186.2,130226,849.3
ZOMBO,2021,141700,149000,290700,66861,14535,52326,14098.95,12500.1,58721.4,133722,872.1
ZOMBO,2022,145700,152800,298500,68655,14925,53730,14477.25,12835.5,60297,137310,895.5
ZOMBO,2023,149600,156500,306100,70403,15305,55098,14845.85,13162.3,61832.2,140806,918.3
ZOMBO,2024,153600,160300,313900,72197,15695,56502,15224.15,13497.7,63407.8,144394,941.7
ZOMBO,2025,157500,164000,321500,73945,16075,57870,15592.75,13824.5,64943,147890,964.5
